terytP;obwod;nr;okr;obwod;lw;lkw;lko;lgw;lgnw
0201;10;4;4;10;2091;0;923;797;126
0201;10;47;4;10;557;0;223;186;37
0201;11;29;4;11;702;0;254;186;68
0201;11;46;4;11;1793;0;931;842;89
0201;1;19;4;1;1616;0;612;487;125
0201;1;20;4;1;1537;0;671;607;64
0201;12;30;4;12;2174;0;1089;965;124
0201;12;6;4;12;18;0;6;5;1
0201;1;35;4;1;570;0;291;253;38
0201;13;53;4;13;2220;0;1089;998;91
0201;1;36;4;1;798;0;385;283;102
0201;1;37;4;1;924;0;543;422;121
0201;14;38;4;14;2191;0;1112;1034;78
0201;1;44;4;1;1865;5;1206;1011;195
0201;15;11;4;15;2175;1;1093;1012;81
0201;16;39;4;16;2278;0;1150;1068;82
0201;17;49;4;17;22;0;7;6;1
0201;18;34;4;18;54;0;4;1;3
0201;2;12;4;2;1242;0;653;507;146
0201;2;15;4;2;927;0;477;295;182
0201;2;24;4;2;903;4;577;466;111
0201;2;45;4;2;2333;0;1023;798;225
0201;2;8;4;2;1328;0;627;542;85
0201;2;9;4;2;1779;0;870;797;73
0201;3;18;4;3;1191;1;656;559;97
0201;3;22;4;3;827;0;441;304;137
0201;3;26;4;3;1384;0;595;494;101
0201;3;31;4;3;443;0;150;124;26
0201;3;33;4;3;2414;0;1197;1068;129
0201;3;43;4;3;1963;2;984;748;236
0201;4;1;4;4;551;0;291;225;66
0201;4;25;4;4;1190;0;484;403;81
0201;4;27;4;4;597;0;273;211;62
0201;4;28;4;4;1326;0;669;505;164
0201;4;32;4;4;2325;0;1023;908;115
0201;4;7;4;4;1270;0;648;530;118
0201;5;13;4;5;2032;0;916;813;103
0201;5;17;4;5;1124;0;466;362;104
0201;5;3;4;5;1215;0;481;390;91
0201;5;40;4;5;883;0;378;304;74
0201;6;41;4;6;376;0;210;162;48
0201;6;42;4;6;2348;0;1139;1041;98
0201;6;48;4;6;1387;0;631;512;119
0201;6;54;4;6;368;0;98;76;22
0201;7;10;4;7;960;0;355;286;69
0201;7;14;4;7;1745;1;744;670;74
0201;7;23;4;7;1908;0;882;684;198
0201;7;5;4;7;1883;0;800;725;75
0201;8;16;4;8;763;0;353;283;70
0201;8;2;4;8;2115;0;995;860;135
0201;8;21;4;8;1689;0;667;552;115
0201;9;50;4;9;679;0;322;292;30
0201;9;51;4;9;930;0;358;287;71
0201;9;52;4;9;1624;0;703;620;83
0202;10;63;3;10;2103;1;813;702;111
0202;10;69;3;10;1004;0;422;390;32
0202;10;73;3;10;381;0;153;135;18
0202;1;105;3;1;1660;0;584;507;77
0202;1;111;3;1;1063;2;577;485;92
0202;11;112;3;11;1966;0;627;550;77
0202;1;119;3;1;1629;0;458;397;61
0202;1;124;3;1;891;0;471;393;78
0202;11;67;3;11;415;3;248;210;38
0202;11;84;3;11;1909;0;682;598;84
0202;12;108;3;12;1751;0;682;591;91
0202;12;109;3;12;1939;0;695;621;74
0202;12;86;3;12;392;0;219;177;42
0202;13;120;3;13;923;0;342;298;44
0202;13;71;3;13;1557;0;541;468;73
0202;14;110;3;14;1770;0;682;591;91
0202;14;121;3;14;1553;0;384;322;62
0202;1;55;3;1;1934;0;913;667;246
0202;15;80;3;15;1957;1;731;682;49
0202;15;94;3;15;1138;0;535;505;30
0202;1;61;3;1;908;3;418;360;58
0202;16;98;3;16;1769;0;653;579;74
0202;17;95;3;17;936;0;306;275;31
0202;18;125;3;18;1532;1;610;520;90
0202;1;88;3;1;887;1;434;372;62
0202;19;123;3;19;1855;0;730;686;44
0202;20;107;3;20;23;0;9;9;0
0202;21;103;3;21;23;0;3;2;1
0202;2;58;3;2;1554;0;503;394;109
0202;2;62;3;2;1831;0;882;673;209
0202;2;64;3;2;623;0;316;224;92
0202;2;70;3;2;796;0;476;404;72
0202;2;72;3;2;1912;0;734;734;0
0202;2;78;3;2;917;1;402;322;80
0202;2;90;3;2;1596;1;512;442;70
0202;3;115;3;3;859;1;425;379;46
0202;3;65;3;3;815;1;354;258;96
0202;3;66;3;3;1675;0;825;620;205
0202;3;81;3;3;1693;1;860;732;128
0202;3;82;3;3;2004;0;790;734;56
0202;3;83;3;3;1169;0;592;494;98
0202;3;92;3;3;1345;0;481;416;65
0202;4;104;3;4;566;0;295;229;66
0202;4;106;3;4;1428;0;712;600;112
0202;4;75;3;4;1912;0;789;701;88
0202;4;76;3;4;566;0;269;221;48
0202;4;89;3;4;1071;0;435;392;43
0202;4;91;3;4;983;1;504;421;83
0202;5;102;3;5;2129;0;872;775;97
0202;5;114;3;5;1269;0;562;438;124
0202;5;59;3;5;957;0;321;258;63
0202;5;60;3;5;415;0;237;194;43
0202;5;85;3;5;1376;2;781;658;123
0202;5;99;3;5;564;1;232;199;33
0202;6;100;3;6;1961;1;849;758;91
0202;6;113;3;6;1839;0;777;695;82
0202;6;118;3;6;654;0;366;312;54
0202;6;122;3;6;693;1;324;271;53
0202;6;57;3;6;1147;0;535;403;132
0202;6;96;3;6;1328;2;751;641;110
0202;7;101;3;7;576;0;308;241;67
0202;7;116;3;7;443;0;181;138;43
0202;7;77;3;7;1600;0;648;599;49
0202;7;97;3;7;2126;0;841;742;99
0202;8;56;3;8;2174;0;851;774;77
0202;8;79;3;8;967;0;366;323;43
0202;8;87;3;8;347;0;181;132;49
0202;8;93;3;8;2;0;2;2;0
0202;9;117;3;9;2093;0;862;796;66
0202;9;68;3;9;1339;0;513;458;55
0202;9;74;3;9;317;0;136;111;25
0203;10;135;5;10;1769;0;685;626;59
0203;11;179;5;11;2016;0;885;830;55
0203;1;131;5;1;1073;1;649;585;64
0203;1;145;5;1;1132;0;684;563;121
0203;1;148;5;1;1089;2;719;613;106
0203;1;157;5;1;1933;0;876;804;72
0203;1;163;5;1;1394;0;791;685;106
0203;1;170;5;1;1476;0;862;675;187
0203;12;169;5;12;1975;0;826;775;51
0203;13;155;5;13;1835;0;751;700;51
0203;14;172;5;14;1353;0;586;526;60
0203;15;126;5;15;1866;0;781;707;74
0203;16;128;5;16;832;0;328;304;24
0203;17;150;5;17;1379;0;677;631;46
0203;18;176;5;18;1426;0;671;626;45
0203;19;130;5;19;1955;0;873;789;84
0203;20;159;5;20;668;0;255;232;23
0203;21;139;5;21;1997;0;870;773;97
0203;2;141;5;2;1422;0;938;758;180
0203;2;146;5;2;591;0;302;241;61
0203;2;152;5;2;1928;0;848;768;80
0203;2;166;5;2;1032;0;641;472;169
0203;2;171;5;2;845;1;591;435;156
0203;2;178;5;2;688;0;462;365;97
0203;22;151;5;22;1651;0;731;666;65
0203;23;156;5;23;2024;0;877;796;81
0203;24;147;5;24;1371;0;602;574;28
0203;25;154;5;25;1263;0;549;480;69
0203;26;149;5;26;1307;1;528;477;51
0203;27;142;5;27;1078;0;505;434;71
0203;28;175;5;28;1785;1;873;784;89
0203;29;177;5;29;2055;0;1004;953;51
0203;30;161;5;30;1261;0;547;506;41
0203;31;164;5;31;1609;0;781;736;45
0203;3;129;5;3;1873;4;1094;902;192
0203;3;137;5;3;565;4;390;331;59
0203;3;165;5;3;534;0;330;292;38
0203;3;174;5;3;1861;0;794;727;67
0203;32;127;5;32;2180;0;1038;965;73
0203;33;144;5;33;1947;0;917;824;93
0203;34;136;5;34;2242;0;1161;1071;90
0203;35;160;5;35;68;0;8;8;0
0203;36;162;5;36;16;0;6;4;2
0203;37;153;5;37;129;0;59;46;13
0203;4;133;5;4;457;0;233;181;52
0203;4;143;5;4;823;0;503;373;130
0203;4;167;5;4;520;0;344;249;95
0203;4;168;5;4;1373;0;561;511;50
0203;5;134;5;5;1976;0;821;736;85
0203;5;158;5;5;272;0;152;103;49
0203;6;173;5;6;1039;1;429;399;30
0203;7;140;5;7;1756;0;770;714;56
0203;8;138;5;8;1191;0;510;462;48
0203;9;132;5;9;2133;0;986;914;72
0204;10;201;2;10;1487;0;825;659;166
0204;11;191;2;11;1194;0;583;491;92
0204;1;182;2;1;1259;0;605;489;116
0204;1;186;2;1;1088;0;504;405;99
0204;1;198;2;1;1008;0;572;435;137
0204;1;206;2;1;1298;0;614;519;95
0204;12;196;2;12;409;0;229;195;34
0204;13;180;2;13;783;0;409;354;55
0204;14;189;2;14;637;0;304;259;45
0204;15;193;2;15;23;0;8;6;2
0204;2;188;2;2;2260;4;1406;1118;288
0204;2;197;2;2;1049;0;673;557;116
0204;2;202;2;2;1117;0;541;466;75
0204;2;204;2;2;848;0;450;334;116
0204;3;183;2;3;1363;0;655;519;136
0204;3;187;2;3;659;0;363;251;112
0204;3;190;2;3;938;0;468;340;128
0204;3;195;2;3;928;0;514;429;85
0204;4;181;2;4;1895;0;875;722;153
0204;4;185;2;4;771;0;435;357;78
0204;4;203;2;4;755;0;415;325;90
0204;5;184;2;5;927;1;494;386;108
0204;5;200;2;5;1281;0;537;437;100
0204;6;194;2;6;1822;0;892;752;140
0204;7;199;2;7;1408;0;751;658;93
0204;8;192;2;8;842;0;303;223;80
0204;9;205;2;9;1076;0;405;351;54
0205;10;208;5;10;439;0;234;205;29
0205;10;220;5;10;1750;0;804;731;73
0205;11;234;5;11;1960;1;1003;908;95
0205;11;240;5;11;44;0;35;24;11
0205;1;210;5;1;2008;0;810;753;57
0205;1;222;5;1;1017;7;739;641;98
0205;12;238;5;12;1333;1;465;414;51
0205;1;229;5;1;1612;0;752;651;101
0205;1;235;5;1;1911;1;1038;739;299
0205;1;237;5;1;1354;0;816;667;149
0205;1;242;5;1;1429;0;819;691;128
0205;13;218;5;13;48;0;33;24;9
0205;14;241;5;14;26;0;9;8;1
0205;2;213;5;2;1229;0;693;599;94
0205;2;214;5;2;492;0;199;181;18
0205;2;221;5;2;1194;0;690;642;48
0205;2;231;5;2;1579;0;735;663;72
0205;2;233;5;2;2244;0;1159;1075;84
0205;2;243;5;2;1276;0;595;474;121
0205;3;209;5;3;1241;0;538;492;46
0205;3;219;5;3;1345;1;702;581;121
0205;3;224;5;3;49;0;37;29;8
0205;3;232;5;3;1113;8;713;612;101
0205;3;236;5;3;950;0;503;372;131
0205;4;215;5;4;1662;0;710;639;71
0205;4;226;5;4;1091;0;460;391;69
0205;4;239;5;4;794;0;418;326;92
0205;5;216;5;5;1177;0;514;421;93
0205;5;228;5;5;1364;1;548;474;74
0205;6;211;5;6;709;0;342;253;89
0205;6;227;5;6;1772;3;666;583;83
0205;7;225;5;7;1436;0;709;662;47
0205;7;230;5;7;670;0;369;309;60
0205;8;207;5;8;785;0;343;262;81
0205;8;212;5;8;1609;0;701;636;65
0205;9;217;5;9;1870;0;743;688;55
0205;9;223;5;9;368;1;238;168;70
0206;1;248;4;1;831;0;419;374;45
0206;1;250;4;1;1697;0;839;718;121
0206;1;268;4;1;2016;0;1052;967;85
0206;1;275;4;1;1755;1;907;778;129
0206;1;277;4;1;580;0;293;259;34
0206;1;281;4;1;1704;3;747;669;78
0206;1;283;4;1;663;2;347;270;77
0206;1;285;4;1;720;0;383;339;44
0206;1;289;4;1;1353;0;609;514;95
0206;2;253;4;2;1921;0;829;735;94
0206;2;255;4;2;1357;0;580;486;94
0206;2;261;4;2;1112;0;628;557;71
0206;2;264;4;2;438;1;193;176;17
0206;2;269;4;2;413;3;255;201;54
0206;2;273;4;2;1065;0;417;341;76
0206;2;278;4;2;1515;4;850;770;80
0206;2;279;4;2;603;0;275;251;24
0206;2;288;4;2;1010;0;504;460;44
0206;3;245;4;3;485;0;268;191;77
0206;3;258;4;3;1962;0;864;777;87
0206;3;266;4;3;1613;1;903;822;81
0206;3;271;4;3;1146;0;524;467;57
0206;3;274;4;3;1236;0;516;464;52
0206;3;276;4;3;925;0;401;322;79
0206;3;284;4;3;1551;0;703;629;74
0206;3;286;4;3;1165;0;627;576;51
0206;3;291;4;3;931;0;361;300;61
0206;4;246;4;4;1229;561;561;508;53
0206;4;247;4;4;1816;0;794;697;97
0206;4;251;4;4;1118;1;583;534;49
0206;4;252;4;4;1097;0;509;465;44
0206;4;254;4;4;1974;5;1031;829;202
0206;4;256;4;4;633;0;249;211;38
0206;4;257;4;4;561;1;334;285;49
0206;4;265;4;4;913;0;409;355;54
0206;4;267;4;4;1204;0;518;459;59
0206;5;244;4;5;889;0;398;352;46
0206;5;260;4;5;1228;1;635;563;72
0206;5;263;4;5;1108;0;537;484;53
0206;5;272;4;5;1776;0;686;576;110
0206;6;259;4;6;403;0;201;181;20
0206;6;280;4;6;1366;0;705;580;125
0206;6;282;4;6;843;1;367;335;32
0206;6;287;4;6;1208;0;615;513;102
0206;7;249;4;7;63;0;37;24;13
0206;7;270;4;7;557;0;260;223;37
0206;7;290;4;7;1241;1;555;481;74
0206;8;262;4;8;56;0;42;37;5
0207;10;307;4;10;2135;0;1127;1041;86
0207;11;312;4;11;1867;0;927;822;105
0207;12;319;4;12;111;0;52;48;4
0207;1;292;4;1;1353;0;705;645;60
0207;1;294;4;1;1232;0;609;521;88
0207;1;299;4;1;2191;1;1093;948;145
0207;1;320;4;1;1275;0;724;638;86
0207;13;303;4;13;39;0;10;9;1
0207;2;296;4;2;1965;0;968;839;129
0207;2;304;4;2;810;0;447;364;83
0207;2;315;4;2;1289;0;680;584;96
0207;2;325;4;2;876;0;441;350;91
0207;3;302;4;3;2002;2;1053;947;106
0207;3;321;4;3;781;1;466;433;33
0207;3;322;4;3;336;0;198;172;26
0207;3;323;4;3;1280;2;647;573;74
0207;4;295;4;4;210;0;130;105;25
0207;4;306;4;4;673;0;352;280;72
0207;4;311;4;4;1871;0;863;750;113
0207;4;326;4;4;2225;2;1079;958;121
0207;5;298;4;5;1827;0;1015;902;113
0207;5;305;4;5;247;0;137;112;25
0207;5;308;4;5;1038;1;467;412;55
0207;5;316;4;5;690;0;351;314;37
0207;6;301;4;6;597;0;328;272;56
0207;6;314;4;6;1903;0;916;822;94
0207;6;317;4;6;521;0;288;240;48
0207;6;318;4;6;514;0;240;192;48
0207;7;293;4;7;1570;0;850;769;81
0207;7;297;4;7;379;0;193;177;16
0207;7;300;4;7;588;0;337;302;35
0207;7;310;4;7;661;0;371;326;45
0207;8;313;4;8;25;0;20;5;15
0207;8;324;4;8;1421;0;716;661;55
0207;9;309;4;9;924;0;524;480;44
0208;10;329;3;10;383;3;251;218;33
0208;10;346;3;10;2119;0;936;856;80
0208;10;361;3;10;622;0;286;256;30
0208;10;416;3;10;1574;1;760;694;66
0208;10;418;3;10;1950;0;722;650;72
0208;11;348;3;11;1322;0;651;565;86
0208;11;393;3;11;456;0;235;192;43
0208;11;430;3;11;816;0;391;358;33
0208;11;434;3;11;396;0;187;163;24
0208;11;449;3;11;857;0;360;294;66
0208;12;333;3;12;1303;0;565;517;48
0208;12;376;3;12;769;0;427;359;68
0208;12;406;3;12;2042;0;925;813;112
0208;12;447;3;12;153;0;52;40;12
0208;12;455;3;12;2313;0;1067;922;145
0208;13;331;3;13;1395;0;574;520;54
0208;13;349;3;13;69;0;37;29;8
0208;13;350;3;13;451;0;262;171;91
0208;13;357;3;13;148;0;56;51;5
0208;13;395;3;13;75;0;29;25;4
0208;1;341;3;1;1715;1;841;651;190
0208;1;342;3;1;1253;1;605;518;87
0208;1;362;3;1;1982;2;953;745;208
0208;1;370;3;1;822;0;329;281;48
0208;1;374;3;1;1506;0;536;473;63
0208;1;378;3;1;1529;1;685;578;107
0208;1;379;3;1;1941;0;939;811;128
0208;1;381;3;1;1519;0;625;524;101
0208;1;404;3;1;2028;0;981;862;119
0208;1;422;3;1;1309;1;533;446;87
0208;1;432;3;1;1077;0;583;480;103
0208;14;334;3;14;1063;0;410;377;33
0208;14;335;3;14;1736;0;838;777;61
0208;1;435;3;1;2207;4;1016;814;202
0208;14;371;3;14;906;0;502;412;90
0208;14;411;3;14;33;0;11;10;1
0208;1;445;3;1;547;0;314;274;40
0208;1;452;3;1;928;1;549;418;131
0208;15;352;3;15;1751;0;832;765;67
0208;15;412;3;15;626;1;256;211;45
0208;16;332;3;16;489;2;214;182;32
0208;16;354;3;16;1538;0;732;680;52
0208;17;423;3;17;1906;0;824;739;85
0208;17;425;3;17;50;0;20;17;3
0208;18;397;3;18;39;0;33;32;1
0208;18;399;3;18;47;1;5;3;2
0208;19;392;3;19;35;0;32;25;7
0208;19;398;3;19;43;0;21;16;5
0208;2;351;3;2;1128;1;530;434;96
0208;2;380;3;2;1734;0;862;757;105
0208;2;385;3;2;1872;0;900;745;155
0208;2;387;3;2;1842;0;883;748;135
0208;2;389;3;2;589;1;314;245;69
0208;2;391;3;2;1219;0;538;418;120
0208;2;394;3;2;719;0;299;273;26
0208;2;426;3;2;1682;0;819;637;182
0208;2;429;3;2;720;0;396;302;94
0208;2;437;3;2;1852;0;751;693;58
0208;2;438;3;2;1207;1;650;554;96
0208;2;450;3;2;1524;0;752;620;132
0208;2;451;3;2;1389;4;684;596;88
0208;2;453;3;2;1555;4;812;706;106
0208;3;327;3;3;1047;0;544;470;74
0208;3;338;3;3;2040;0;900;720;180
0208;3;340;3;3;1201;0;555;485;70
0208;3;343;3;3;1341;0;521;462;59
0208;3;353;3;3;703;0;371;330;41
0208;3;356;3;3;830;2;444;408;36
0208;3;382;3;3;859;0;379;313;66
0208;3;402;3;3;980;1;397;313;84
0208;3;405;3;3;1281;2;665;562;103
0208;3;427;3;3;251;0;112;95;17
0208;3;428;3;3;1341;0;573;515;58
0208;3;433;3;3;705;1;398;340;58
0208;3;441;3;3;1949;0;941;809;132
0208;4;330;3;4;529;0;220;197;23
0208;4;337;3;4;1322;1;621;458;163
0208;4;355;3;4;1116;2;560;472;88
0208;4;373;3;4;1835;0;822;711;111
0208;4;384;3;4;1846;2;826;691;135
0208;4;388;3;4;788;1;395;350;45
0208;4;414;3;4;2187;0;1108;924;184
0208;4;439;3;4;528;0;226;194;32
0208;4;440;3;4;1946;0;699;630;69
0208;4;446;3;4;645;0;263;199;64
0208;4;456;3;4;403;0;133;107;26
0208;5;336;3;5;1210;0;504;448;56
0208;5;347;3;5;513;0;286;238;48
0208;5;358;3;5;622;0;249;186;63
0208;5;365;3;5;979;1;522;427;95
0208;5;368;3;5;643;0;264;174;90
0208;5;407;3;5;1455;0;536;481;55
0208;5;417;3;5;2335;5;1169;1000;169
0208;5;419;3;5;701;0;332;268;64
0208;5;431;3;5;825;0;436;355;81
0208;5;443;3;5;549;0;252;213;39
0208;5;448;3;5;1729;0;784;709;75
0208;6;345;3;6;1198;2;571;464;107
0208;6;363;3;6;1003;0;447;353;94
0208;6;364;3;6;869;0;446;374;72
0208;6;367;3;6;967;1;368;313;55
0208;6;372;3;6;908;0;440;396;44
0208;6;375;3;6;401;0;204;150;54
0208;6;383;3;6;657;3;388;330;58
0208;6;401;3;6;1050;0;489;384;105
0208;6;408;3;6;1273;0;549;478;71
0208;6;436;3;6;519;0;176;137;39
0208;6;442;3;6;824;1;438;389;49
0208;7;360;3;7;1717;0;675;605;70
0208;7;366;3;7;1257;1;538;495;43
0208;7;369;3;7;713;0;345;279;66
0208;7;386;3;7;460;0;252;202;50
0208;7;390;3;7;1184;0;558;499;59
0208;7;413;3;7;1203;0;544;499;45
0208;7;415;3;7;734;2;435;344;91
0208;7;421;3;7;1016;2;428;362;66
0208;7;454;3;7;41;0;30;19;11
0208;8;344;3;8;51;0;45;41;4
0208;8;359;3;8;1535;0;643;568;75
0208;8;377;3;8;1563;0;627;511;116
0208;8;396;3;8;561;0;203;174;29
0208;8;400;3;8;894;0;452;363;89
0208;8;403;3;8;560;0;159;130;29
0208;8;444;3;8;1169;0;461;436;25
0208;9;328;3;9;967;0;494;409;85
0208;9;339;3;9;597;0;296;264;32
0208;9;409;3;9;1697;0;633;562;71
0208;9;410;3;9;906;0;430;381;49
0208;9;420;3;9;365;0;161;127;34
0208;9;424;3;9;914;1;390;350;40
0209;1;462;5;1;1080;2;580;461;119
0209;1;465;5;1;637;0;274;230;44
0209;1;473;5;1;1661;0;694;610;84
0209;1;476;5;1;1222;0;704;612;92
0209;1;486;5;1;1158;0;721;617;104
0209;1;493;5;1;984;0;576;519;57
0209;1;495;5;1;351;0;173;159;14
0209;1;498;5;1;1108;1;715;589;126
0209;2;464;5;2;1429;0;417;324;93
0209;2;466;5;2;1209;2;725;573;152
0209;2;471;5;2;414;0;235;175;60
0209;2;475;5;2;2300;0;780;651;129
0209;2;479;5;2;1247;7;654;527;127
0209;2;481;5;2;1181;0;599;556;43
0209;2;482;5;2;457;0;193;185;8
0209;2;494;5;2;412;0;266;243;23
0209;3;461;5;3;1029;0;358;313;45
0209;3;470;5;3;84;0;54;48;6
0209;3;483;5;3;893;0;464;384;80
0209;3;484;5;3;552;0;271;230;41
0209;3;488;5;3;1119;2;616;549;67
0209;3;489;5;3;2255;1;757;607;150
0209;3;491;5;3;985;0;571;456;115
0209;3;500;5;3;907;1;496;411;85
0209;4;460;5;4;703;0;305;276;29
0209;4;463;5;4;1004;1;562;457;105
0209;4;467;5;4;1633;0;644;556;88
0209;4;478;5;4;928;0;627;482;145
0209;4;497;5;4;500;2;242;212;30
0209;4;499;5;4;1558;0;821;683;138
0209;5;468;5;5;790;0;359;296;63
0209;5;477;5;5;658;0;407;319;88
0209;5;480;5;5;1114;1;590;466;124
0209;5;490;5;5;613;1;299;288;11
0209;5;492;5;5;521;0;340;266;74
0209;5;496;5;5;2192;0;821;743;78
0209;6;458;5;6;1094;0;644;523;121
0209;6;459;5;6;570;0;204;178;26
0209;6;472;5;6;1104;0;637;478;159
0209;6;485;5;6;133;0;63;54;9
0209;6;487;5;6;1663;1;655;577;78
0209;7;469;5;7;434;0;228;194;34
0209;7;474;5;7;1070;2;635;503;132
0209;8;457;5;8;333;0;183;138;45
0210;10;504;4;10;2274;0;893;808;85
0210;11;518;4;11;1306;1;565;515;50
0210;12;517;4;12;984;1;438;382;56
0210;13;506;4;13;886;0;384;337;47
0210;14;535;4;14;23;0;5;3;2
0210;1;507;4;1;2254;1;1072;896;176
0210;1;508;4;1;1333;3;856;738;118
0210;1;510;4;1;959;0;430;366;64
0210;1;520;4;1;2112;2;1175;1033;142
0210;1;539;4;1;1691;0;880;713;167
0210;1;540;4;1;1672;0;751;676;75
0210;1;542;4;1;688;0;398;355;43
0210;15;525;4;15;13;0;7;5;2
0210;2;511;4;2;647;0;337;292;45
0210;2;512;4;2;1650;0;966;847;119
0210;2;521;4;2;1599;0;735;622;113
0210;2;522;4;2;1211;0;433;404;29
0210;2;531;4;2;1842;11;954;797;157
0210;2;534;4;2;1198;0;680;588;92
0210;3;503;4;3;1249;0;672;618;54
0210;3;505;4;3;378;0;172;152;20
0210;3;519;4;3;1297;0;485;441;44
0210;3;526;4;3;1015;0;524;416;108
0210;3;529;4;3;1080;2;568;471;97
0210;3;530;4;3;961;0;525;456;69
0210;4;502;4;4;354;4;184;148;36
0210;4;527;4;4;1422;0;560;526;34
0210;4;532;4;4;771;0;390;345;45
0210;4;536;4;4;1257;0;552;494;58
0210;4;541;4;4;804;0;400;313;87
0210;5;501;4;5;664;0;273;247;26
0210;5;515;4;5;1328;0;604;539;65
0210;5;533;4;5;539;0;217;190;27
0210;6;523;4;6;624;0;256;213;43
0210;6;524;4;6;659;0;366;298;68
0210;6;528;4;6;1503;0;661;610;51
0210;7;509;4;7;1276;0;556;512;44
0210;7;514;4;7;707;0;332;284;48
0210;7;537;4;7;288;0;175;143;32
0210;8;513;4;8;474;0;236;197;39
0210;8;538;4;8;1819;1;776;661;115
0210;9;516;4;9;1413;0;602;543;59
0211;10;597;5;10;969;1;433;403;30
0211;10;608;5;10;1484;0;871;735;136
0211;11;575;5;11;1428;1;604;564;40
0211;12;585;5;12;780;0;383;353;30
0211;13;560;5;13;1239;1;517;468;49
0211;14;555;5;14;1361;1;571;520;51
0211;15;548;5;15;819;0;312;284;28
0211;1;557;5;1;1089;0;614;514;100
0211;1;562;5;1;1636;2;1123;885;238
0211;1;596;5;1;1398;0;506;468;38
0211;1;615;5;1;1431;0;880;778;102
0211;16;543;5;16;1365;0;474;474;0
0211;17;564;5;17;1637;0;645;605;40
0211;18;609;5;18;1443;1;528;500;28
0211;19;601;5;19;899;0;354;337;17
0211;20;578;5;20;1389;1;551;530;21
0211;21;571;5;21;1415;1;619;593;26
0211;22;561;5;22;1018;0;417;397;20
0211;23;572;5;23;1215;0;442;423;19
0211;24;549;5;24;1713;0;909;876;33
0211;2;553;5;2;1760;0;1055;901;154
0211;25;573;5;25;1531;0;709;671;38
0211;2;567;5;2;2018;0;994;842;152
0211;2;589;5;2;880;1;382;360;22
0211;2;611;5;2;778;3;579;422;157
0211;26;591;5;26;767;0;328;307;21
0211;27;600;5;27;1207;0;515;471;44
0211;28;577;5;28;935;0;329;311;18
0211;29;588;5;29;1234;0;579;559;20
0211;30;551;5;30;1534;0;696;664;32
0211;31;552;5;31;1533;0;616;576;40
0211;32;576;5;32;1143;1;523;499;24
0211;33;606;5;33;1104;0;517;493;24
0211;34;602;5;34;1399;0;621;595;26
0211;3;556;5;3;2077;10;1454;1173;281
0211;35;579;5;35;1334;0;587;549;38
0211;3;582;5;3;1224;0;728;628;100
0211;3;583;5;3;627;0;276;257;19
0211;3;603;5;3;2286;0;1264;1052;212
0211;36;544;5;36;2131;0;969;925;44
0211;37;559;5;37;1059;0;519;508;11
0211;38;590;5;38;1053;1;527;495;32
0211;39;566;5;39;927;0;360;333;27
0211;40;607;5;40;1634;0;675;619;56
0211;41;569;5;41;1390;0;597;560;37
0211;42;605;5;42;1493;0;624;593;31
0211;43;563;5;43;2215;0;1071;1021;50
0211;44;584;5;44;1724;0;890;854;36
0211;4;547;5;4;722;0;445;360;85
0211;45;592;5;45;1430;0;662;633;29
0211;4;570;5;4;1277;0;564;533;31
0211;4;574;5;4;850;1;433;392;41
0211;4;586;5;4;1030;0;477;426;51
0211;46;598;5;46;1512;0;710;680;30
0211;47;554;5;47;1367;0;616;592;24
0211;48;610;5;48;1170;0;552;521;31
0211;49;599;5;49;658;0;357;336;21
0211;50;604;5;50;65;0;23;23;0
0211;51;595;5;51;33;0;16;12;4
0211;5;565;5;5;705;2;387;308;79
0211;5;568;5;5;721;0;466;367;99
0211;5;594;5;5;1422;0;616;590;26
0211;5;613;5;5;728;0;504;379;125
0211;6;550;5;6;737;0;407;342;65
0211;6;612;5;6;690;0;408;324;84
0211;6;614;5;6;1526;0;644;608;36
0211;7;558;5;7;749;0;414;343;71
0211;7;580;5;7;996;0;389;349;40
0211;7;581;5;7;511;0;312;276;36
0211;8;546;5;8;617;0;262;239;23
0211;8;593;5;8;746;0;431;346;85
0211;9;545;5;9;719;0;357;334;23
0211;9;587;5;9;878;1;382;359;23
0212;10;634;4;10;997;0;395;317;78
0212;11;645;4;11;873;0;352;293;59
0212;12;620;4;12;914;0;412;361;51
0212;13;630;4;13;976;0;422;344;78
0212;1;637;4;1;1612;0;910;760;150
0212;1;638;4;1;1774;2;865;766;99
0212;1;642;4;1;1591;0;739;598;141
0212;1;646;4;1;1976;0;873;792;81
0212;1;650;4;1;1586;3;975;860;115
0212;2;616;4;2;640;4;384;323;61
0212;2;617;4;2;1783;0;823;697;126
0212;2;618;4;2;877;0;422;348;74
0212;2;628;4;2;1195;1;533;484;49
0212;2;647;4;2;1004;0;407;353;54
0212;3;623;4;3;566;0;365;266;99
0212;3;624;4;3;1006;0;412;362;50
0212;3;625;4;3;1091;1;496;423;73
0212;3;627;4;3;971;2;554;467;87
0212;3;639;4;3;1841;0;865;749;116
0212;4;619;4;4;1175;0;489;430;59
0212;4;631;4;4;2211;2;1007;828;179
0212;4;632;4;4;1134;0;462;415;47
0212;4;635;4;4;761;4;377;303;74
0212;4;643;4;4;452;4;247;205;42
0212;5;626;4;5;483;0;230;185;45
0212;5;633;4;5;1481;0;604;604;0
0212;5;636;4;5;590;0;365;300;65
0212;5;641;4;5;2116;1;906;825;81
0212;5;644;4;5;65;0;40;28;12
0212;6;622;4;6;1002;0;479;413;66
0212;6;629;4;6;585;0;301;259;42
0212;6;649;4;6;72;0;54;25;29
0212;6;651;4;6;891;0;439;388;51
0212;7;621;4;7;919;0;407;338;69
0212;8;648;4;8;900;0;428;351;77
0212;9;640;4;9;846;0;327;271;56
0213;10;659;2;10;682;0;263;231;32
0213;11;677;2;11;502;0;235;203;32
0213;12;664;2;12;890;0;391;341;50
0213;13;658;2;13;623;0;310;230;80
0213;14;678;2;14;2317;0;1143;1005;138
0213;15;663;2;15;681;0;342;316;26
0213;1;655;2;1;2320;0;991;894;97
0213;16;654;2;16;528;0;264;228;36
0213;1;670;2;1;2268;3;1328;1161;167
0213;1;679;2;1;1797;0;1041;947;94
0213;17;666;2;17;386;0;215;184;31
0213;18;656;2;18;244;0;103;96;7
0213;19;661;2;19;743;0;251;232;19
0213;20;674;2;20;45;0;22;20;2
0213;2;657;2;2;2270;0;1146;1031;115
0213;2;665;2;2;2211;0;1085;978;107
0213;2;676;2;2;516;0;345;285;60
0213;3;652;2;3;971;0;551;460;91
0213;3;653;2;3;926;0;528;462;66
0213;3;671;2;3;1405;0;719;677;42
0213;4;668;2;4;2172;0;1017;942;75
0213;4;672;2;4;1261;0;623;561;62
0213;5;662;2;5;82;0;49;28;21
0213;5;667;2;5;1331;0;707;671;36
0213;6;673;2;6;552;0;200;162;38
0213;7;669;2;7;667;0;332;295;37
0213;8;660;2;8;686;0;369;296;73
0213;9;675;2;9;429;0;215;175;40
0214;10;708;2;10;1739;1;574;525;49
0214;10;717;2;10;33;0;5;4;1
0214;11;724;2;11;1975;0;813;775;38
0214;12;738;2;12;1477;0;589;551;38
0214;13;687;2;13;2001;1;898;848;50
0214;14;682;2;14;1833;0;589;552;37
0214;15;696;2;15;1978;0;913;851;62
0214;16;736;2;16;2035;0;809;772;37
0214;1;690;2;1;2143;1;1075;914;161
0214;1;695;2;1;2146;1;994;918;76
0214;1;697;2;1;2351;0;1254;1086;168
0214;1;703;2;1;1887;2;1219;1045;174
0214;1;707;2;1;1296;0;523;493;30
0214;1;716;2;1;1926;0;916;759;157
0214;1;731;2;1;2004;0;1212;992;220
0214;1;735;2;1;1354;0;699;578;121
0214;17;680;2;17;1079;0;474;453;21
0214;18;733;2;18;937;0;372;344;28
0214;19;704;2;19;28;0;10;10;0
0214;20;726;2;20;6;0;5;5;0
0214;2;692;2;2;2321;0;1091;1006;85
0214;2;693;2;2;1724;0;992;690;302
0214;2;699;2;2;1217;0;426;395;31
0214;2;702;2;2;2102;2;974;860;114
0214;2;705;2;2;1294;0;585;420;165
0214;2;715;2;2;2152;1;1042;721;321
0214;2;728;2;2;889;1;563;452;111
0214;2;732;2;2;1007;0;571;456;115
0214;3;681;2;3;1550;0;566;502;64
0214;3;684;2;3;2134;0;1147;890;257
0214;3;694;2;3;965;0;429;343;86
0214;3;698;2;3;1378;0;648;526;122
0214;3;713;2;3;1222;0;664;564;100
0214;3;719;2;3;1924;0;882;819;63
0214;3;729;2;3;1242;0;597;505;92
0214;3;730;2;3;1217;8;735;581;154
0214;4;683;2;4;869;0;397;273;124
0214;4;685;2;4;1696;1;723;660;63
0214;4;686;2;4;2174;0;946;829;117
0214;4;709;2;4;2193;0;636;527;109
0214;4;737;2;4;1319;0;596;487;109
0214;5;688;2;5;389;0;193;146;47
0214;5;706;2;5;1653;0;625;575;50
0214;5;714;2;5;1171;0;629;480;149
0214;5;718;2;5;1443;0;643;553;90
0214;5;727;2;5;1885;0;1004;801;203
0214;6;701;2;6;1265;0;420;398;22
0214;6;711;2;6;1327;0;549;445;104
0214;6;712;2;6;861;0;445;371;74
0214;6;722;2;6;640;0;274;234;40
0214;6;739;2;6;927;0;413;338;75
0214;7;691;2;7;958;0;396;313;83
0214;7;721;2;7;2163;0;937;854;83
0214;7;723;2;7;444;0;332;234;98
0214;7;725;2;7;464;1;252;210;42
0214;8;700;2;8;771;0;342;318;24
0214;8;710;2;8;128;0;27;16;11
0214;8;734;2;8;2153;0;894;823;71
0214;9;689;2;9;432;0;200;157;43
0214;9;720;2;9;2038;0;748;679;69
0215;10;754;2;10;552;0;270;249;21
0215;10;759;2;10;1804;1;788;719;69
0215;10;771;2;10;1427;0;714;633;81
0215;11;755;2;11;2100;0;1056;945;111
0215;11;774;2;11;1862;0;701;611;90
0215;12;764;2;12;2166;0;1003;941;62
0215;12;776;2;12;2122;0;968;884;84
0215;13;753;2;13;1118;0;492;436;56
0215;13;758;2;13;1530;0;742;681;61
0215;14;751;2;14;1790;1;855;791;64
0215;15;740;2;15;1937;0;851;802;49
0215;16;768;2;16;2026;0;842;770;72
0215;1;748;2;1;708;0;352;287;65
0215;1;769;2;1;1491;0;871;751;120
0215;1;770;2;1;1562;0;639;604;35
0215;1;773;2;1;1927;0;888;807;81
0215;17;757;2;17;12;0;2;2;0
0215;18;743;2;18;94;0;70;66;4
0215;2;746;2;2;1318;2;605;563;42
0215;2;749;2;2;580;0;287;238;49
0215;2;762;2;2;805;0;412;348;64
0215;2;780;2;2;2223;0;955;836;119
0215;3;767;2;3;1125;0;432;402;30
0215;3;772;2;3;568;0;285;212;73
0215;3;775;2;3;1241;0;662;594;68
0215;3;784;2;3;604;0;237;217;20
0215;4;741;2;4;1130;0;566;500;66
0215;4;756;2;4;820;1;428;361;67
0215;4;779;2;4;1250;0;491;468;23
0215;4;781;2;4;1274;0;685;570;115
0215;5;750;2;5;2001;0;939;807;132
0215;5;761;2;5;1761;0;772;697;75
0215;5;782;2;5;858;2;358;318;40
0215;6;742;2;6;1081;0;460;398;62
0215;6;745;2;6;1749;1;701;664;37
0215;6;766;2;6;671;0;294;259;35
0215;7;744;2;7;1248;1;723;603;120
0215;7;752;2;7;744;0;461;431;30
0215;7;778;2;7;1464;0;583;526;57
0215;8;760;2;8;2340;0;1060;975;85
0215;8;765;2;8;801;0;456;393;63
0215;8;783;2;8;1256;0;504;457;47
0215;9;747;2;9;534;0;268;233;35
0215;9;763;2;9;1833;1;813;752;61
0215;9;777;2;9;1711;0;819;764;55
0216;10;803;5;10;886;0;491;434;57
0216;10;807;5;10;1493;0;766;682;84
0216;11;823;5;11;1863;1;896;774;122
0216;12;787;5;12;1250;0;663;573;90
0216;13;788;5;13;1004;0;511;426;85
0216;14;824;5;14;917;0;469;363;106
0216;15;786;5;15;982;1;494;432;62
0216;1;792;5;1;1125;1;750;586;164
0216;1;793;5;1;1305;0;744;672;72
0216;1;809;5;1;1737;16;1148;1004;144
0216;1;820;5;1;1470;7;933;774;159
0216;1;825;5;1;1755;0;792;651;141
0216;1;826;5;1;1580;0;715;609;106
0216;2;791;5;2;1041;0;492;410;82
0216;2;797;5;2;1483;1;822;737;85
0216;2;800;5;2;1136;3;620;540;80
0216;2;808;5;2;1118;0;653;487;166
0216;2;816;5;2;423;1;259;235;24
0216;2;821;5;2;956;0;468;398;70
0216;3;785;5;3;2166;0;1094;995;99
0216;3;790;5;3;1318;0;732;612;120
0216;3;798;5;3;1008;0;538;471;67
0216;3;806;5;3;474;0;268;230;38
0216;3;812;5;3;1100;0;666;505;161
0216;3;815;5;3;434;0;236;211;25
0216;4;789;5;4;1204;0;637;561;76
0216;4;804;5;4;765;1;502;354;148
0216;4;811;5;4;438;0;250;212;38
0216;4;813;5;4;564;0;282;207;75
0216;4;819;5;4;1840;1;813;714;99
0216;5;794;5;5;810;0;412;336;76
0216;5;796;5;5;1344;0;747;650;97
0216;5;799;5;5;1336;0;687;558;129
0216;6;801;5;6;1232;1;627;533;94
0216;6;817;5;6;1069;1;517;396;121
0216;6;827;5;6;765;0;326;273;53
0216;7;805;5;7;1562;0;753;653;100
0216;7;810;5;7;762;3;536;485;51
0216;7;814;5;7;1603;0;786;662;124
0216;8;818;5;8;684;1;385;334;51
0216;8;822;5;8;1142;0;526;438;88
0216;9;795;5;9;627;0;323;288;35
0216;9;802;5;9;1308;1;719;652;67
0217;10;840;2;10;1298;0;696;646;50
0217;11;833;2;11;1122;0;487;411;76
0217;12;842;2;12;646;0;297;243;54
0217;13;855;2;13;2294;0;1001;910;91
0217;14;836;2;14;33;0;1;1;0
0217;1;835;2;1;647;0;327;279;48
0217;1;841;2;1;1669;1;761;714;47
0217;1;845;2;1;2136;2;1034;817;217
0217;1;857;2;1;1487;0;784;650;134
0217;1;860;2;1;1720;0;715;620;95
0217;2;830;2;2;1050;0;559;450;109
0217;2;838;2;2;1567;0;784;681;103
0217;2;848;2;2;1099;0;606;493;113
0217;2;850;2;2;1515;0;723;626;97
0217;2;854;2;2;631;0;323;276;47
0217;3;832;2;3;825;0;423;349;74
0217;3;834;2;3;959;0;496;410;86
0217;3;839;2;3;499;0;283;218;65
0217;3;844;2;3;489;2;282;232;50
0217;3;858;2;3;1617;0;788;738;50
0217;4;828;2;4;827;0;394;297;97
0217;4;829;2;4;1122;6;505;393;112
0217;4;851;2;4;219;0;110;92;18
0217;4;853;2;4;1801;0;879;775;104
0217;5;837;2;5;739;0;399;305;94
0217;5;852;2;5;823;0;401;328;73
0217;5;856;2;5;833;0;352;287;65
0217;5;859;2;5;1561;0;771;678;93
0217;6;843;2;6;510;1;281;224;57
0217;6;849;2;6;937;0;435;407;28
0217;7;846;2;7;1817;0;785;725;60
0217;8;847;2;8;1224;0;573;517;56
0217;9;831;2;9;447;4;195;169;26
0218;10;890;2;10;8;0;5;5;0
0218;1;868;2;1;2304;1;1181;965;216
0218;1;871;2;1;1619;2;923;748;175
0218;1;875;2;1;1558;0;743;670;73
0218;1;876;2;1;2177;1;1109;1109;0
0218;1;878;2;1;1385;0;781;642;139
0218;2;863;2;2;1474;0;606;526;80
0218;2;865;2;2;2020;7;816;724;92
0218;2;880;2;2;824;0;472;362;110
0218;2;884;2;2;1612;0;816;650;166
0218;2;886;2;2;1177;0;661;572;89
0218;3;861;2;3;1382;0;632;495;137
0218;3;862;2;3;1024;0;536;326;210
0218;3;864;2;3;1303;0;592;517;75
0218;3;870;2;3;2071;0;956;859;97
0218;3;888;2;3;801;0;478;379;99
0218;4;866;2;4;932;0;539;429;110
0218;4;872;2;4;779;3;508;431;77
0218;4;877;2;4;2259;0;1018;895;123
0218;4;881;2;4;1171;0;454;362;92
0218;4;885;2;4;1962;0;828;725;103
0218;5;869;2;5;1115;1;595;500;95
0218;5;873;2;5;1459;0;669;556;113
0218;5;887;2;5;18;0;13;8;5
0218;6;874;2;6;1271;0;524;471;53
0218;6;889;2;6;2136;1;1064;918;146
0218;7;867;2;7;764;0;261;223;38
0218;7;883;2;7;2221;0;1160;1000;160
0218;8;879;2;8;762;0;362;325;37
0218;9;882;2;9;1035;0;401;337;64
0219;10;903;3;10;1317;0;498;473;25
0219;10;973;3;10;973;0;479;420;59
0219;10;981;3;10;2017;0;805;732;73
0219;10;987;3;10;1360;1;763;645;118
0219;11;913;3;11;1316;0;600;539;61
0219;11;959;3;11;850;0;497;379;118
0219;11;969;3;11;2138;1;849;817;32
0219;12;906;3;12;1300;0;674;597;77
0219;12;979;3;12;1656;0;924;771;153
0219;12;985;3;12;1835;0;822;780;42
0219;13;908;3;13;1598;1;764;664;100
0219;13;912;3;13;826;0;494;391;103
0219;13;939;3;13;855;0;257;235;22
0219;14;915;3;14;1141;0;384;344;40
0219;14;918;3;14;444;1;261;211;50
0219;14;924;3;14;1422;1;652;509;143
0219;15;900;3;15;1757;0;618;564;54
0219;15;953;3;15;20;0;5;4;1
0219;15;986;3;15;569;0;382;321;61
0219;16;956;3;16;1142;0;369;337;32
0219;16;970;3;16;1594;2;929;639;290
0219;17;897;3;17;1622;2;611;567;44
0219;17;946;3;17;765;0;465;389;76
0219;1;894;3;1;2024;0;982;900;82
0219;18;950;3;18;625;2;394;320;74
0219;18;980;3;18;1896;0;676;640;36
0219;1;904;3;1;2027;1;1066;939;127
0219;1;923;3;1;1546;2;886;696;190
0219;1;938;3;1;2027;0;882;742;140
0219;1;943;3;1;949;0;351;332;19
0219;1;947;3;1;1259;2;571;492;79
0219;1;974;3;1;1777;3;1140;987;153
0219;1;978;3;1;996;0;569;467;102
0219;19;891;3;19;589;0;378;282;96
0219;19;965;3;19;1265;0;586;549;37
0219;20;933;3;20;317;0;184;147;37
0219;20;951;3;20;1881;0;831;777;54
0219;21;941;3;21;2101;0;917;878;39
0219;22;898;3;22;2003;0;796;754;42
0219;23;984;3;23;1824;1;806;763;43
0219;24;921;3;24;2129;0;954;906;48
0219;25;928;3;25;936;0;408;391;17
0219;26;949;3;26;1698;0;538;492;46
0219;27;988;3;27;1679;1;616;557;59
0219;28;922;3;28;2357;1;906;860;46
0219;2;907;3;2;1628;0;919;795;124
0219;2;929;3;2;1044;0;555;462;93
0219;2;930;3;2;705;0;268;220;48
0219;2;936;3;2;1737;0;1043;868;175
0219;2;937;3;2;2273;2;1251;965;286
0219;2;945;3;2;839;0;353;302;51
0219;2;960;3;2;1513;0;539;488;51
0219;2;966;3;2;1180;0;628;522;106
0219;29;952;3;29;1802;0;734;686;48
0219;30;989;3;30;43;0;22;22;0
0219;31;983;3;31;42;0;17;15;2
0219;3;901;3;3;1734;0;636;572;64
0219;3;916;3;3;1401;3;750;569;181
0219;3;925;3;3;1518;0;547;520;27
0219;3;931;3;3;1163;0;704;566;138
0219;3;934;3;3;324;0;203;147;56
0219;3;958;3;3;1576;3;703;582;121
0219;3;975;3;3;1360;0;547;470;77
0219;3;977;3;3;2004;0;905;696;209
0219;4;892;3;4;1743;0;734;669;65
0219;4;905;3;4;1190;0;522;446;76
0219;4;910;3;4;1352;5;643;568;75
0219;4;911;3;4;1726;0;705;584;121
0219;4;948;3;4;746;0;436;364;72
0219;4;967;3;4;1454;0;572;438;134
0219;4;982;3;4;323;0;149;113;36
0219;5;909;3;5;1382;1;733;588;145
0219;5;914;3;5;1177;0;465;396;69
0219;5;927;3;5;885;0;362;306;56
0219;5;935;3;5;1865;3;1091;880;211
0219;5;944;3;5;1413;0;553;465;88
0219;5;964;3;5;951;0;454;404;50
0219;5;968;3;5;2144;0;736;655;81
0219;6;896;3;6;2139;0;738;704;34
0219;6;919;3;6;793;0;401;332;69
0219;6;926;3;6;324;0;178;165;13
0219;6;942;3;6;881;0;333;281;52
0219;6;954;3;6;1498;0;707;593;114
0219;6;955;3;6;1184;0;784;696;88
0219;7;893;3;7;2243;1;891;828;63
0219;7;920;3;7;764;0;409;360;49
0219;7;940;3;7;1291;0;584;536;48
0219;7;962;3;7;1297;1;727;608;119
0219;7;963;3;7;1703;2;703;573;130
0219;7;976;3;7;1188;0;554;488;66
0219;8;895;3;8;753;0;350;321;29
0219;8;899;3;8;1885;0;1057;839;218
0219;8;917;3;8;1345;1;591;505;86
0219;8;932;3;8;1013;0;514;458;56
0219;8;957;3;8;1823;0;567;532;35
0219;9;902;3;9;928;0;457;381;76
0219;9;961;3;9;1855;0;827;799;28
0219;9;971;3;9;1332;0;566;497;69
0219;9;972;3;9;918;0;387;343;44
0220;10;1010;2;10;9;0;9;8;1
0220;10;1017;2;10;44;0;21;17;4
0220;10;1019;2;10;2079;2;1094;930;164
0220;1;1005;2;1;1702;0;803;674;129
0220;1;1006;2;1;1666;2;855;753;102
0220;1;1013;2;1;1921;1;1021;950;71
0220;1;1022;2;1;1797;9;1137;939;198
0220;1;1023;2;1;1555;8;773;714;59
0220;11;998;2;11;23;0;6;6;0
0220;1;991;2;1;2311;1;1070;977;93
0220;2;1001;2;2;1465;0;562;491;71
0220;2;1024;2;2;2261;0;1246;1177;69
0220;2;1028;2;2;1729;1;1224;973;251
0220;2;1031;2;2;1990;0;1087;1004;83
0220;2;993;2;2;1873;0;895;809;86
0220;2;995;2;2;2113;0;1195;1161;34
0220;3;1018;2;3;1287;0;482;436;46
0220;3;1026;2;3;959;2;555;425;130
0220;3;1027;2;3;2218;1;1218;1155;63
0220;3;1029;2;3;1961;0;1085;1017;68
0220;3;1030;2;3;1763;0;891;811;80
0220;3;990;2;3;1862;1;839;753;86
0220;4;1011;2;4;1818;0;1003;938;65
0220;4;1016;2;4;1812;1;954;900;54
0220;4;1021;2;4;2176;0;1137;1085;52
0220;4;1032;2;4;1295;0;560;469;91
0220;4;994;2;4;2145;0;1408;1109;299
0220;5;1009;2;5;1900;1;768;708;60
0220;5;1012;2;5;1668;1;938;938;0
0220;5;1014;2;5;688;0;436;370;66
0220;5;997;2;5;1632;0;698;619;79
0220;6;992;2;6;877;0;388;324;64
0220;6;996;2;6;1071;0;642;603;39
0220;6;999;2;6;2197;0;912;850;62
0220;7;1003;2;7;1449;0;607;558;49
0220;7;1015;2;7;1913;0;984;859;125
0220;7;1025;2;7;692;0;350;268;82
0220;8;1000;2;8;1416;0;740;663;77
0220;8;1007;2;8;1549;0;696;571;125
0220;8;1008;2;8;819;0;451;384;67
0220;9;1002;2;9;589;0;318;271;47
0220;9;1004;2;9;100;0;49;32;17
0220;9;1020;2;9;1427;0;761;657;104
0221;10;1068;3;10;1542;1;592;561;31
0221;1;1036;3;1;1160;0;587;465;122
0221;1;1038;3;1;1809;0;717;629;88
0221;1;1047;3;1;1053;0;539;406;133
0221;1;1083;3;1;2078;0;1011;843;168
0221;1;1096;3;1;1264;1;727;579;148
0221;1;1102;3;1;389;0;172;163;9
0221;11;1092;3;11;1344;0;589;559;30
0221;1;1121;3;1;1535;4;943;845;98
0221;1;1137;3;1;917;1;364;305;59
0221;1;1147;3;1;1002;0;404;362;42
0221;12;1065;3;12;815;0;356;337;19
0221;13;1084;3;13;1806;1;827;779;48
0221;14;1099;3;14;2068;4;701;650;51
0221;15;1110;3;15;1881;0;878;843;35
0221;16;1144;3;16;2232;1;1012;981;31
0221;17;1117;3;17;1882;0;805;764;41
0221;18;1120;3;18;1616;1;706;676;30
0221;19;1129;3;19;1911;0;819;779;40
0221;20;1100;3;20;1626;0;690;661;29
0221;2;1045;3;2;799;0;526;438;88
0221;2;1051;3;2;2142;1;1081;937;144
0221;2;1057;3;2;1498;0;635;593;42
0221;2;1078;3;2;1847;0;734;651;83
0221;2;1091;3;2;956;2;496;403;93
0221;21;1079;3;21;1782;0;760;697;63
0221;2;1112;3;2;942;0;383;293;90
0221;2;1123;3;2;634;0;281;237;44
0221;2;1126;3;2;1554;2;876;773;103
0221;2;1145;3;2;552;0;259;215;44
0221;22;1064;3;22;2114;0;927;872;55
0221;23;1146;3;23;2046;0;939;867;72
0221;24;1073;3;24;2231;0;947;893;54
0221;25;1080;3;25;1243;1;388;352;36
0221;26;1059;3;26;1409;3;449;397;52
0221;27;1125;3;27;1002;0;398;357;41
0221;28;1044;3;28;1672;1;639;596;43
0221;29;1072;3;29;1140;1;314;275;39
0221;30;1040;3;30;1397;1;494;451;43
0221;3;1048;3;3;1516;1;808;711;97
0221;3;1053;3;3;1620;1;617;535;82
0221;3;1077;3;3;982;1;415;356;59
0221;3;1088;3;3;1820;2;1088;904;184
0221;3;1105;3;3;1545;0;534;417;117
0221;3;1109;3;3;848;0;331;288;43
0221;31;1101;3;31;1315;2;480;453;27
0221;3;1128;3;3;1816;1;731;604;127
0221;3;1138;3;3;717;0;348;276;72
0221;3;1149;3;3;564;0;324;258;66
0221;32;1119;3;32;1794;1;673;602;71
0221;33;1042;3;33;2007;0;716;641;75
0221;34;1131;3;34;1955;1;593;549;44
0221;35;1133;3;35;1153;1;325;300;25
0221;36;1127;3;36;777;0;298;255;43
0221;37;1118;3;37;1102;0;376;365;11
0221;38;1066;3;38;1256;0;527;480;47
0221;39;1116;3;39;2095;0;799;707;92
0221;40;1075;3;40;1037;0;393;330;63
0221;4;1035;3;4;354;0;145;116;29
0221;4;1076;3;4;1584;0;547;476;71
0221;4;1098;3;4;736;0;344;287;57
0221;4;1103;3;4;1129;0;425;353;72
0221;41;1039;3;41;1273;0;528;430;98
0221;4;1108;3;4;862;1;414;348;66
0221;4;1114;3;4;367;0;259;180;79
0221;4;1141;3;4;641;0;230;187;43
0221;4;1148;3;4;1625;0;504;471;33
0221;42;1054;3;42;941;0;371;329;42
0221;43;1085;3;43;1031;0;485;415;70
0221;44;1081;3;44;1228;0;505;411;94
0221;45;1136;3;45;956;0;432;373;59
0221;46;1104;3;46;1614;1;745;692;53
0221;47;1115;3;47;955;1;370;339;31
0221;48;1132;3;48;1076;0;364;332;32
0221;49;1124;3;49;966;1;295;240;55
0221;50;1056;3;50;932;1;383;340;43
0221;5;1067;3;5;459;0;253;189;64
0221;5;1074;3;5;1000;0;378;298;80
0221;5;1087;3;5;1621;0;708;620;88
0221;5;1097;3;5;2219;0;1016;977;39
0221;51;1033;3;51;1032;0;304;304;0
0221;5;1122;3;5;866;1;546;449;97
0221;5;1135;3;5;514;0;260;230;30
0221;5;1143;3;5;977;0;438;402;36
0221;52;1095;3;52;1155;1;374;343;31
0221;53;1049;3;53;1010;0;387;297;90
0221;54;1107;3;54;1566;0;569;495;74
0221;55;1041;3;55;883;0;406;389;17
0221;56;1055;3;56;1945;0;671;525;146
0221;57;1050;3;57;1534;0;540;483;57
0221;58;1061;3;58;1919;0;779;710;69
0221;59;1037;3;59;1554;0;599;541;58
0221;60;1106;3;60;1713;0;648;581;67
0221;6;1043;3;6;1382;0;606;557;49
0221;6;1046;3;6;296;0;167;135;32
0221;6;1060;3;6;1877;0;765;666;99
0221;6;1090;3;6;663;1;314;257;57
0221;61;1052;3;61;1872;2;670;589;81
0221;6;1130;3;6;454;0;227;190;37
0221;62;1058;3;62;1800;0;828;756;72
0221;63;1062;3;63;1449;0;488;436;52
0221;64;1142;3;64;1413;0;471;425;46
0221;65;1071;3;65;2106;0;818;647;171
0221;66;1111;3;66;806;0;253;234;19
0221;67;1086;3;67;47;0;47;43;4
0221;68;1093;3;68;72;0;7;5;2
0221;69;1134;3;69;58;0;16;13;3
0221;70;1139;3;70;151;0;37;35;2
0221;7;1069;3;7;1392;0;712;571;141
0221;7;1070;3;7;693;0;346;299;47
0221;71;1063;3;71;51;0;30;26;4
0221;7;1113;3;7;2149;1;933;874;59
0221;8;1082;3;8;2032;0;918;867;51
0221;8;1089;3;8;642;3;320;290;30
0221;8;1140;3;8;17;0;4;3;1
0221;9;1034;3;9;974;0;367;315;52
0221;9;1094;3;9;2211;0;969;909;60
0222;10;1155;2;10;611;0;317;285;32
0222;10;1160;2;10;1723;0;751;680;71
0222;11;1175;2;11;1080;1;506;406;100
0222;11;1178;2;11;803;2;409;375;34
0222;1;1152;2;1;1865;9;1180;940;240
0222;1;1153;2;1;1667;4;869;804;65
0222;1;1159;2;1;2200;0;1159;1015;144
0222;12;1157;2;12;972;0;516;443;73
0222;13;1165;2;13;579;0;258;232;26
0222;14;1161;2;14;4;0;4;3;1
0222;15;1162;2;15;32;0;5;3;2
0222;16;1176;2;16;11;0;2;2;0
0222;2;1171;2;2;1644;0;759;671;88
0222;2;1172;2;2;968;0;523;414;109
0222;2;1180;2;2;1559;0;764;666;98
0222;3;1169;2;3;1711;0;810;743;67
0222;3;1170;2;3;877;0;438;336;102
0222;3;1174;2;3;2237;2;1164;1052;112
0222;4;1151;2;4;1693;2;759;687;72
0222;4;1154;2;4;1440;10;808;668;140
0222;4;1182;2;4;2012;1;1075;1002;73
0222;5;1163;2;5;1516;1;831;743;88
0222;5;1166;2;5;968;15;466;390;76
0222;5;1167;2;5;1277;1;593;555;38
0222;6;1156;2;6;1479;0;718;630;88
0222;6;1168;2;6;517;2;335;257;78
0222;6;1179;2;6;415;11;277;213;64
0222;7;1150;2;7;522;6;269;224;45
0222;7;1158;2;7;821;0;471;389;82
0222;7;1164;2;7;529;0;275;231;44
0222;8;1173;2;8;860;0;441;373;68
0222;8;1177;2;8;2286;0;1150;1012;138
0222;9;1181;2;9;887;1;329;273;56
0222;9;1183;2;9;1089;1;575;491;84
0223;10;1206;2;10;2098;2;1065;992;73
0223;10;1226;2;10;1755;0;697;646;51
0223;10;1228;2;10;1526;0;816;771;45
0223;11;1214;2;11;1177;2;729;654;75
0223;1;1191;2;1;2301;0;1302;1202;100
0223;1;1208;2;1;1822;0;837;770;67
0223;1;1210;2;1;1791;12;1217;1074;143
0223;1;1218;2;1;2051;1;1079;927;152
0223;1;1225;2;1;1893;0;917;805;112
0223;1;1230;2;1;2025;0;1030;975;55
0223;1;1233;2;1;2071;3;1278;1175;103
0223;1;1234;2;1;1947;0;707;643;64
0223;1;1239;2;1;1958;0;971;823;148
0223;12;1189;2;12;1116;0;643;598;45
0223;13;1215;2;13;687;0;419;363;56
0223;14;1244;2;14;1525;0;891;841;50
0223;15;1190;2;15;449;0;278;246;32
0223;16;1203;2;16;367;0;183;171;12
0223;2;1187;2;2;109;0;62;62;0
0223;2;1193;2;2;736;7;500;432;68
0223;2;1194;2;2;1762;2;961;926;35
0223;2;1213;2;2;615;1;298;266;32
0223;2;1221;2;2;2152;1;921;862;59
0223;2;1222;2;2;1805;0;960;821;139
0223;2;1229;2;2;1573;1;840;766;74
0223;2;1246;2;2;1283;0;731;649;82
0223;2;1250;2;2;873;0;395;305;90
0223;3;1184;2;3;1052;1;597;534;63
0223;3;1188;2;3;2278;5;995;874;121
0223;3;1205;2;3;435;0;220;176;44
0223;3;1220;2;3;1970;0;1025;908;117
0223;3;1223;2;3;1455;0;711;637;74
0223;3;1231;2;3;569;1;292;240;52
0223;3;1235;2;3;898;0;427;350;77
0223;3;1240;2;3;1737;0;946;886;60
0223;4;1192;2;4;1282;0;625;576;49
0223;4;1209;2;4;1649;0;910;820;90
0223;4;1227;2;4;1146;0;440;402;38
0223;4;1232;2;4;1147;0;643;610;33
0223;4;1241;2;4;940;0;456;386;70
0223;4;1243;2;4;1490;0;811;633;178
0223;4;1248;2;4;802;0;403;366;37
0223;5;1195;2;5;856;0;314;284;30
0223;5;1196;2;5;2312;0;1119;1036;83
0223;5;1207;2;5;1243;0;494;414;80
0223;5;1211;2;5;1355;0;660;523;137
0223;5;1212;2;5;967;0;495;433;62
0223;5;1238;2;5;742;0;432;397;35
0223;5;1249;2;5;557;0;255;228;27
0223;6;1185;2;6;1249;0;647;553;94
0223;6;1202;2;6;1860;0;808;745;63
0223;6;1204;2;6;1452;0;599;512;87
0223;6;1217;2;6;1069;0;660;600;60
0223;6;1219;2;6;1970;0;646;579;67
0223;6;1242;2;6;848;0;483;386;97
0223;6;1245;2;6;734;0;420;393;27
0223;7;1198;2;7;1117;0;441;395;46
0223;7;1200;2;7;1147;0;650;585;65
0223;7;1236;2;7;769;0;393;339;54
0223;7;1247;2;7;2153;0;1022;946;76
0223;8;1201;2;8;1606;0;580;500;80
0223;8;1224;2;8;1258;0;562;519;43
0223;8;1237;2;8;850;0;554;469;85
0223;8;1251;2;8;1145;0;535;509;26
0223;9;1186;2;9;1420;0;525;487;38
0223;9;1197;2;9;1068;0;325;272;53
0223;9;1199;2;9;716;0;353;285;68
0223;9;1216;2;9;528;0;303;258;45
0224;10;1272;3;10;426;0;205;181;24
0224;10;1283;3;10;811;1;461;413;48
0224;10;1293;3;10;342;3;203;164;39
0224;11;1271;3;11;862;0;454;386;68
0224;11;1288;3;11;597;0;298;247;51
0224;1;1255;3;1;1525;6;891;777;114
0224;1;1256;3;1;894;0;323;280;43
0224;1;1268;3;1;1158;0;568;504;64
0224;1;1284;3;1;817;3;433;357;76
0224;1;1290;3;1;607;0;360;333;27
0224;1;1297;3;1;926;0;453;409;44
0224;1;1303;3;1;1763;2;1094;893;201
0224;12;1280;3;12;501;0;238;183;55
0224;12;1287;3;12;468;0;152;152;0
0224;13;1258;3;13;530;0;218;155;63
0224;13;1313;3;13;678;0;320;259;61
0224;14;1253;3;14;1262;0;505;430;75
0224;14;1265;3;14;1217;0;655;548;107
0224;15;1279;3;15;1629;0;812;716;96
0224;15;1285;3;15;583;0;227;189;38
0224;16;1267;3;16;107;0;72;61;11
0224;16;1281;3;16;763;0;288;231;57
0224;17;1291;3;17;7;0;0;0;0
0224;17;1301;3;17;472;0;135;116;19
0224;18;1316;3;18;426;0;240;198;42
0224;19;1305;3;19;85;0;73;70;3
0224;20;1314;3;20;59;0;24;19;5
0224;2;1254;3;2;803;3;443;375;68
0224;2;1259;3;2;1064;0;422;335;87
0224;2;1263;3;2;1114;4;664;606;58
0224;2;1274;3;2;1434;1;651;511;140
0224;2;1295;3;2;1163;3;674;544;130
0224;2;1296;3;2;831;0;367;320;47
0224;2;1302;3;2;885;0;472;379;93
0224;3;1261;3;3;760;0;333;292;41
0224;3;1262;3;3;485;0;280;215;65
0224;3;1266;3;3;561;0;290;239;51
0224;3;1275;3;3;1971;0;904;750;154
0224;3;1299;3;3;843;0;391;339;52
0224;3;1311;3;3;1013;7;573;516;57
0224;4;1257;3;4;943;0;395;353;42
0224;4;1269;3;4;991;0;514;483;31
0224;4;1300;3;4;868;1;410;410;0
0224;4;1304;3;4;443;0;235;210;25
0224;4;1306;3;4;295;1;170;141;29
0224;4;1312;3;4;915;1;505;463;42
0224;5;1260;3;5;1782;0;948;832;116
0224;5;1264;3;5;1981;0;759;649;110
0224;5;1292;3;5;456;0;221;175;46
0224;5;1294;3;5;192;0;110;95;15
0224;5;1307;3;5;796;0;372;290;82
0224;6;1270;3;6;1860;0;703;553;150
0224;6;1273;3;6;274;0;156;128;28
0224;6;1278;3;6;536;0;276;196;80
0224;6;1282;3;6;247;0;132;118;14
0224;6;1286;3;6;1910;1;1081;955;126
0224;7;1276;3;7;1038;1;562;498;64
0224;7;1277;3;7;580;0;230;196;34
0224;7;1289;3;7;826;0;471;394;77
0224;7;1315;3;7;621;0;263;219;44
0224;8;1308;3;8;330;0;182;154;28
0224;8;1309;3;8;507;2;326;254;72
0224;8;1317;3;8;1568;3;835;756;79
0224;9;1252;3;9;1747;0;1029;898;131
0224;9;1298;3;9;475;1;221;176;45
0224;9;1310;3;9;1919;0;996;899;97
0225;10;1339;4;10;1033;1;685;577;108
0225;10;1345;4;10;1859;1;946;868;78
0225;10;1367;4;10;517;0;332;273;59
0225;11;1340;4;11;991;0;671;560;111
0225;11;1359;4;11;2149;0;1048;954;94
0225;1;1327;4;1;1022;0;589;507;82
0225;1;1337;4;1;1698;2;823;698;125
0225;1;1346;4;1;2057;3;1227;1038;189
0225;1;1368;4;1;1414;0;666;532;134
0225;1;1379;4;1;2041;0;955;830;125
0225;1;1381;4;1;262;0;187;169;18
0225;1;1385;4;1;1639;0;760;693;67
0225;12;1324;4;12;2114;0;997;907;90
0225;12;1341;4;12;1533;0;1029;927;102
0225;13;1318;4;13;1581;0;949;812;137
0225;13;1333;4;13;1561;0;740;656;84
0225;14;1326;4;14;1454;0;704;608;96
0225;14;1348;4;14;1785;1;1145;978;167
0225;15;1320;4;15;1942;0;1024;911;113
0225;15;1325;4;15;784;0;513;442;71
0225;16;1347;4;16;1958;0;1066;940;126
0225;16;1366;4;16;1158;0;788;697;91
0225;17;1375;4;17;62;0;22;19;3
0225;17;1377;4;17;1387;0;842;739;103
0225;18;1338;4;18;49;0;14;8;6
0225;18;1383;4;18;1016;0;662;572;90
0225;19;1365;4;19;1290;0;806;711;95
0225;20;1321;4;20;64;0;16;12;4
0225;21;1343;4;21;29;0;11;10;1
0225;2;1323;4;2;832;0;346;310;36
0225;2;1329;4;2;1156;0;569;471;98
0225;2;1349;4;2;1222;0;791;683;108
0225;2;1358;4;2;1873;0;911;767;144
0225;2;1361;4;2;692;0;341;246;95
0225;2;1362;4;2;1577;0;752;671;81
0225;2;1373;4;2;1181;0;515;515;0
0225;3;1334;4;3;1882;0;855;758;97
0225;3;1335;4;3;251;0;143;123;20
0225;3;1355;4;3;1333;0;583;497;86
0225;3;1360;4;3;871;6;534;446;88
0225;3;1364;4;3;840;2;456;379;77
0225;3;1374;4;3;708;0;404;333;71
0225;4;1332;4;4;509;0;286;224;62
0225;4;1354;4;4;836;1;434;381;53
0225;4;1369;4;4;815;0;393;339;54
0225;4;1372;4;4;1160;0;740;582;158
0225;4;1376;4;4;704;0;274;227;47
0225;4;1378;4;4;1362;0;536;405;131
0225;5;1328;4;5;514;0;273;199;74
0225;5;1357;4;5;764;0;368;289;79
0225;5;1363;4;5;813;0;520;419;101
0225;5;1370;4;5;1543;0;697;608;89
0225;5;1382;4;5;488;0;230;169;61
0225;6;1330;4;6;544;0;334;270;64
0225;6;1331;4;6;1752;0;671;570;101
0225;6;1342;4;6;839;1;425;381;44
0225;6;1350;4;6;574;0;276;238;38
0225;6;1352;4;6;401;0;189;154;35
0225;7;1322;4;7;834;0;514;402;112
0225;7;1336;4;7;2148;0;941;826;115
0225;7;1353;4;7;1301;0;550;455;95
0225;7;1380;4;7;811;0;362;294;68
0225;7;1384;4;7;589;0;280;220;60
0225;8;1319;4;8;1741;0;798;733;65
0225;8;1351;4;8;728;0;439;299;140
0225;8;1371;4;8;532;0;269;217;52
0225;8;1387;4;8;425;0;219;174;45
0225;9;1344;4;9;1161;0;722;580;142
0225;9;1356;4;9;1903;0;842;777;65
0225;9;1386;4;9;366;1;209;173;36
0226;1;1388;5;1;2241;0;836;836;0
0226;1;1390;5;1;255;0;147;125;22
0226;1;1394;5;1;772;0;338;296;42
0226;1;1395;5;1;1455;2;673;495;178
0226;1;1397;5;1;1186;0;558;457;101
0226;1;1413;5;1;776;0;366;286;80
0226;2;1391;5;2;2004;2;989;881;108
0226;2;1396;5;2;1154;0;431;361;70
0226;2;1400;5;2;830;0;454;376;78
0226;2;1409;5;2;741;0;387;324;63
0226;2;1410;5;2;846;1;425;292;133
0226;2;1424;5;2;1741;0;661;557;104
0226;3;1389;5;3;1150;0;501;392;109
0226;3;1392;5;3;876;0;438;312;126
0226;3;1401;5;3;470;0;223;194;29
0226;3;1414;5;3;421;0;183;155;28
0226;3;1416;5;3;2300;1;1040;891;149
0226;3;1417;5;3;651;0;289;237;52
0226;4;1393;5;4;1230;0;704;563;141
0226;4;1405;5;4;662;0;306;242;64
0226;4;1406;5;4;2067;0;1051;940;111
0226;4;1411;5;4;913;0;474;425;49
0226;4;1423;5;4;408;1;189;151;38
0226;5;1398;5;5;582;0;261;230;31
0226;5;1412;5;5;1846;2;843;739;104
0226;5;1415;5;5;1599;0;624;556;68
0226;5;1422;5;5;341;0;176;126;50
0226;5;1425;5;5;554;0;205;158;47
0226;6;1399;5;6;791;0;421;358;63
0226;6;1404;5;6;2235;0;1029;941;88
0226;6;1421;5;6;383;0;134;101;33
0226;7;1407;5;7;521;0;187;156;31
0226;7;1418;5;7;1787;0;878;795;83
0226;7;1419;5;7;465;0;213;182;31
0226;8;1408;5;8;31;0;6;6;0
0226;8;1420;5;8;389;0;177;141;36
0226;9;1402;5;9;348;0;180;136;44
0226;9;1403;5;9;8;0;5;5;0
0261;10;1468;4;10;2081;0;780;737;43
0261;11;1430;4;11;1849;0;677;646;31
0261;1;1444;4;1;372;0;198;177;21
0261;12;1438;4;12;833;0;346;306;40
0261;13;1440;4;13;1353;0;501;475;26
0261;14;1463;4;14;1415;0;587;553;34
0261;15;1461;4;15;1655;0;666;638;28
0261;16;1426;4;16;2096;0;816;761;55
0261;17;1465;4;17;2447;0;1015;968;47
0261;18;1453;4;18;2495;0;1075;1041;34
0261;19;1445;4;19;2267;0;968;940;28
0261;20;1436;4;20;2127;0;946;905;41
0261;21;1443;4;21;2261;0;1006;961;45
0261;2;1454;4;2;1827;1;819;757;62
0261;22;1456;4;22;2075;0;897;870;27
0261;23;1469;4;23;1706;0;627;611;16
0261;24;1452;4;24;1721;0;713;681;32
0261;25;1442;4;25;967;0;358;340;18
0261;26;1433;4;26;2189;1;1001;953;48
0261;27;1447;4;27;1814;0;676;621;55
0261;28;1427;4;28;1385;0;665;644;21
0261;29;1460;4;29;1789;0;694;661;33
0261;30;1437;4;30;1459;0;499;466;33
0261;31;1428;4;31;2276;1;899;845;54
0261;3;1467;4;3;1757;0;677;620;57
0261;32;1435;4;32;1324;0;484;458;26
0261;33;1457;4;33;2081;0;841;777;64
0261;34;1434;4;34;1565;0;698;666;32
0261;35;1466;4;35;2394;0;974;922;52
0261;36;1459;4;36;1924;0;793;745;48
0261;37;1450;4;37;1907;0;827;791;36
0261;38;1446;4;38;1561;0;541;512;29
0261;39;1449;4;39;2089;0;855;801;54
0261;40;1470;4;40;1397;0;530;490;40
0261;41;1441;4;41;552;0;324;290;34
0261;4;1439;4;4;1180;1;353;329;24
0261;42;1462;4;42;51;0;20;18;2
0261;43;1451;4;43;75;0;22;20;2
0261;44;1431;4;44;64;0;22;20;2
0261;45;1432;4;45;86;0;79;62;17
0261;5;1458;4;5;2076;0;715;661;54
0261;6;1448;4;6;1377;0;480;460;20
0261;7;1429;4;7;1961;0;643;602;41
0261;8;1464;4;8;888;0;254;232;22
0261;9;1455;4;9;505;0;212;193;19
0262;10;1502;5;10;1356;0;404;372;32
0262;11;1514;5;11;1552;0;397;345;52
0262;1;1492;5;1;2350;0;798;741;57
0262;12;1499;5;12;1999;0;453;416;37
0262;13;1472;5;13;2040;0;759;719;40
0262;14;1471;5;14;2145;0;875;828;47
0262;15;1481;5;15;1737;0;744;699;45
0262;16;1480;5;16;1979;0;941;901;40
0262;17;1496;5;17;1811;0;842;793;49
0262;18;1488;5;18;1759;0;834;801;33
0262;19;1503;5;19;1816;0;727;684;43
0262;20;1507;5;20;1733;0;774;731;43
0262;21;1512;5;21;1848;0;766;732;34
0262;2;1485;5;2;1584;0;489;463;26
0262;22;1490;5;22;1874;0;765;718;47
0262;23;1491;5;23;1595;1;675;636;39
0262;24;1487;5;24;1955;0;873;830;43
0262;25;1505;5;25;1336;0;593;565;28
0262;26;1500;5;26;1845;0;834;781;53
0262;27;1501;5;27;1420;0;676;638;38
0262;28;1493;5;28;1932;0;894;851;43
0262;29;1474;5;29;1510;1;681;659;22
0262;30;1483;5;30;1140;0;331;299;32
0262;31;1475;5;31;1537;0;453;406;47
0262;3;1510;5;3;2118;0;788;754;34
0262;32;1518;5;32;984;0;278;258;20
0262;33;1498;5;33;1326;0;612;568;44
0262;34;1473;5;34;885;0;438;408;30
0262;35;1484;5;35;1293;0;385;351;34
0262;36;1504;5;36;2081;0;686;596;90
0262;37;1478;5;37;2313;0;976;910;66
0262;38;1494;5;38;1710;0;549;489;60
0262;39;1517;5;39;1635;0;496;421;75
0262;40;1476;5;40;1838;0;570;513;57
0262;41;1495;5;41;1835;0;779;732;47
0262;4;1508;5;4;1788;0;626;598;28
0262;42;1479;5;42;1307;0;484;450;34
0262;43;1506;5;43;1915;0;595;545;50
0262;44;1516;5;44;1913;0;662;628;34
0262;45;1515;5;45;1629;0;709;671;38
0262;46;1519;5;46;1975;0;870;831;39
0262;47;1482;5;47;1986;1;837;790;47
0262;48;1486;5;48;142;0;47;43;4
0262;49;1497;5;49;58;0;27;26;1
0262;5;1489;5;5;1864;1;614;579;35
0262;6;1511;5;6;1555;0;498;464;34
0262;7;1509;5;7;2465;0;1069;1008;61
0262;8;1477;5;8;2039;0;788;726;62
0262;9;1513;5;9;1964;0;669;617;52
0264;100;1623;1;100;2163;0;955;915;40
0264;101;1602;1;101;2099;0;896;855;41
0264;10;1626;1;10;1401;1;368;356;12
0264;102;1613;1;102;2093;0;981;954;27
0264;103;1708;1;103;2245;0;1059;1024;35
0264;104;1735;1;104;1343;1;586;575;11
0264;105;1638;1;105;2067;3;845;821;24
0264;106;1734;1;106;2103;0;893;893;0
0264;107;1591;1;107;1927;0;891;861;30
0264;108;1732;1;108;2064;0;817;787;30
0264;109;1600;1;109;1784;0;599;571;28
0264;110;1582;1;110;2016;0;806;780;26
0264;111;1784;1;111;1823;0;694;675;19
0264;11;1769;1;11;1357;0;472;453;19
0264;112;1804;1;112;1707;0;648;626;22
0264;113;1668;1;113;1849;0;566;546;20
0264;114;1748;1;114;2091;0;741;712;29
0264;115;1639;1;115;1888;0;721;697;24
0264;116;1533;1;116;2018;0;823;791;32
0264;1;1683;1;1;1975;759;759;736;23
0264;117;1634;1;117;2026;0;830;806;24
0264;118;1592;1;118;1679;0;679;647;32
0264;119;1715;1;119;1822;0;750;736;14
0264;120;1649;1;120;2100;0;957;920;37
0264;121;1806;1;121;2130;0;816;766;50
0264;12;1594;1;12;2317;0;955;917;38
0264;122;1607;1;122;1802;0;810;800;10
0264;123;1669;1;123;1735;0;969;948;21
0264;124;1618;1;124;1702;0;564;543;21
0264;125;1520;1;125;1683;0;551;533;18
0264;126;1666;1;126;1845;0;424;396;28
0264;127;1739;1;127;2143;0;648;628;20
0264;128;1561;1;128;1886;0;523;505;18
0264;129;1651;1;129;1848;0;460;447;13
0264;130;1754;1;130;1355;0;457;425;32
0264;131;1580;1;131;1534;0;477;456;21
0264;13;1741;1;13;2054;0;725;691;34
0264;132;1782;1;132;1796;1;483;469;14
0264;133;1604;1;133;1460;0;427;415;12
0264;134;1629;1;134;2170;0;690;645;45
0264;135;1545;1;135;2092;0;768;747;21
0264;136;1679;1;136;1905;0;675;657;18
0264;137;1599;1;137;1955;1;653;631;22
0264;138;1724;1;138;2340;0;902;875;27
0264;139;1644;1;139;2321;0;765;736;29
0264;140;1749;1;140;1823;0;777;763;14
0264;141;1810;1;141;1462;0;537;520;17
0264;14;1771;1;14;2246;0;819;782;37
0264;142;1569;1;142;1589;0;408;379;29
0264;143;1733;1;143;1671;0;907;880;27
0264;144;1657;1;144;1793;0;957;939;18
0264;145;1737;1;145;2104;0;1064;1043;21
0264;146;1691;1;146;2121;0;1027;997;30
0264;147;1774;1;147;2128;1;974;946;28
0264;148;1794;1;148;1736;1;890;871;19
0264;149;1583;1;149;1802;1;865;844;21
0264;150;1767;1;150;1862;0;906;887;19
0264;151;1730;1;151;2040;0;1052;1028;24
0264;15;1742;1;15;1309;0;497;481;16
0264;152;1758;1;152;2022;0;870;855;15
0264;153;1588;1;153;2003;0;885;869;16
0264;154;1619;1;154;2075;0;841;841;0
0264;155;1652;1;155;1905;0;708;686;22
0264;156;1692;1;156;1119;0;450;434;16
0264;157;1719;1;157;1617;1;663;639;24
0264;158;1532;1;158;1515;0;747;732;15
0264;159;1537;1;159;1406;0;629;609;20
0264;160;1627;1;160;1408;0;610;585;25
0264;161;1609;1;161;2304;0;580;560;20
0264;16;1526;1;16;1769;0;649;622;27
0264;162;1617;1;162;1163;0;503;488;15
0264;163;1745;1;163;1486;0;691;665;26
0264;164;1764;1;164;1191;0;452;438;14
0264;165;1676;1;165;1447;0;613;590;23
0264;166;1793;1;166;1463;0;417;399;18
0264;167;1755;1;167;1487;0;475;439;36
0264;168;1597;1;168;1660;0;816;792;24
0264;169;1527;1;169;1902;0;947;926;21
0264;170;1791;1;170;2206;0;1025;1012;13
0264;171;1797;1;171;1972;0;872;854;18
0264;17;1672;1;17;2095;0;733;704;29
0264;172;1552;1;172;2190;0;895;880;15
0264;173;1788;1;173;2369;0;1000;981;19
0264;174;1612;1;174;2147;0;1011;990;21
0264;175;1704;1;175;1712;0;763;742;21
0264;176;1814;1;176;2400;0;977;952;25
0264;177;1700;1;177;1801;0;759;715;44
0264;178;1673;1;178;1725;0;707;707;0
0264;179;1567;1;179;1743;0;700;676;24
0264;180;1687;1;180;1560;0;571;546;25
0264;181;1768;1;181;2316;0;723;701;22
0264;18;1778;1;18;1687;0;581;567;14
0264;182;1736;1;182;2307;0;1036;1001;35
0264;183;1752;1;183;2402;0;897;870;27
0264;184;1799;1;184;2210;0;815;787;28
0264;185;1725;1;185;1736;0;764;731;33
0264;186;1608;1;186;2014;0;816;799;17
0264;187;1721;1;187;2081;0;993;948;45
0264;188;1593;1;188;1914;0;869;849;20
0264;189;1571;1;189;1702;0;774;758;16
0264;190;1543;1;190;1497;0;746;712;34
0264;191;1620;1;191;1348;0;678;666;12
0264;19;1729;1;19;1666;0;523;504;19
0264;192;1761;1;192;2091;0;896;874;22
0264;193;1802;1;193;1579;0;749;739;10
0264;194;1646;1;194;1942;1;856;825;31
0264;195;1702;1;195;2265;0;883;862;21
0264;196;1713;1;196;1721;1;620;593;27
0264;197;1786;1;197;1637;0;707;687;20
0264;198;1589;1;198;1767;0;766;747;19
0264;199;1601;1;199;2213;1;875;853;22
0264;200;1686;1;200;1897;0;771;750;21
0264;201;1566;1;201;1441;0;579;533;46
0264;20;1636;1;20;2076;1;681;653;28
0264;202;1762;1;202;2241;0;771;756;15
0264;203;1765;1;203;2365;0;889;849;40
0264;204;1529;1;204;1891;0;814;792;22
0264;205;1805;1;205;1579;0;563;554;9
0264;206;1728;1;206;1573;0;655;643;12
0264;207;1595;1;207;1651;0;770;751;19
0264;208;1674;1;208;1351;0;596;579;17
0264;209;1521;1;209;2077;0;1139;1117;22
0264;210;1766;1;210;1607;0;726;705;21
0264;211;1614;1;211;1848;0;833;808;25
0264;21;1631;1;21;2138;0;788;771;17
0264;212;1563;1;212;1814;0;835;811;24
0264;213;1542;1;213;2267;0;902;882;20
0264;214;1624;1;214;2245;0;934;915;19
0264;215;1811;1;215;2203;0;862;839;23
0264;216;1718;1;216;1404;0;524;515;9
0264;217;1535;1;217;1313;0;552;532;20
0264;2;1813;1;2;1545;0;586;557;29
0264;218;1777;1;218;1476;0;568;535;33
0264;219;1606;1;219;2141;0;654;634;20
0264;220;1743;1;220;1730;0;653;643;10
0264;221;1696;1;221;1866;0;666;640;26
0264;22;1706;1;22;2110;0;875;828;47
0264;222;1578;1;222;1797;0;564;564;0
0264;223;1621;1;223;2089;0;617;607;10
0264;224;1573;1;224;1530;0;641;623;18
0264;225;1770;1;225;2091;0;865;829;36
0264;226;1750;1;226;1858;0;737;713;24
0264;227;1523;1;227;2293;0;860;857;3
0264;228;1549;1;228;601;0;206;197;9
0264;229;1579;1;229;1458;0;531;520;11
0264;230;1682;1;230;2217;2;824;804;20
0264;231;1548;1;231;1578;0;691;669;22
0264;23;1789;1;23;1441;0;519;497;22
0264;232;1539;1;232;1115;0;332;321;11
0264;233;1808;1;233;1559;0;521;513;8
0264;234;1565;1;234;2171;0;819;786;33
0264;235;1654;1;235;2253;0;880;845;35
0264;236;1781;1;236;2163;0;969;934;35
0264;237;1722;1;237;2132;0;994;975;19
0264;238;1667;1;238;1791;0;698;679;19
0264;239;1605;1;239;1527;0;606;592;14
0264;240;1576;1;240;2042;0;878;853;25
0264;241;1586;1;241;2178;0;834;801;33
0264;24;1648;1;24;2164;0;806;774;32
0264;242;1522;1;242;1269;0;557;539;18
0264;243;1555;1;243;1712;1;544;525;19
0264;244;1665;1;244;1014;0;427;416;11
0264;245;1632;1;245;2312;0;929;899;30
0264;246;1756;1;246;2025;0;900;869;31
0264;247;1711;1;247;898;0;384;373;11
0264;248;1803;1;248;1717;0;694;687;7
0264;249;1540;1;249;1965;0;788;749;39
0264;250;1812;1;250;1107;1;470;447;23
0264;251;1694;1;251;690;0;220;207;13
0264;25;1712;1;25;2180;0;886;860;26
0264;252;1703;1;252;1295;0;543;530;13
0264;253;1720;1;253;1140;0;633;621;12
0264;254;1709;1;254;1555;0;744;722;22
0264;255;1671;1;255;1259;0;541;508;33
0264;256;1550;1;256;1852;0;815;790;25
0264;257;1701;1;257;1821;0;753;724;29
0264;258;1585;1;258;1853;0;767;716;51
0264;259;1530;1;259;2116;0;787;766;21
0264;260;1553;1;260;1354;0;353;332;21
0264;261;1538;1;261;1602;0;641;610;31
0264;26;1670;1;26;1701;0;626;594;32
0264;262;1795;1;262;1953;0;737;718;19
0264;263;1641;1;263;2324;1;908;866;42
0264;264;1693;1;264;2108;0;877;850;27
0264;265;1653;1;265;1904;0;577;560;17
0264;266;1528;1;266;1121;1;483;469;14
0264;267;1790;1;267;1664;0;824;778;46
0264;268;1757;1;268;2316;0;969;936;33
0264;269;1584;1;269;1629;0;630;590;40
0264;270;1556;1;270;1163;0;430;419;11
0264;271;1616;1;271;1100;0;381;360;21
0264;27;1816;1;27;2123;0;939;902;37
0264;272;1640;1;272;1068;0;259;252;7
0264;273;1817;1;273;1988;0;702;672;30
0264;274;1753;1;274;64;0;35;32;3
0264;275;1531;1;275;326;0;186;146;40
0264;276;1655;1;276;144;0;29;27;2
0264;277;1809;1;277;65;0;22;22;0
0264;278;1760;1;278;100;0;14;14;0
0264;279;1664;1;279;198;0;67;60;7
0264;280;1681;1;280;137;0;32;32;0
0264;281;1643;1;281;33;0;33;24;9
0264;28;1633;1;28;1582;0;396;378;18
0264;282;1660;1;282;32;0;3;3;0
0264;283;1685;1;283;106;0;12;12;0
0264;284;1662;1;284;146;0;30;25;5
0264;285;1647;1;285;220;0;33;30;3
0264;286;1661;1;286;55;0;16;13;3
0264;287;1798;1;287;114;0;15;14;1
0264;288;1818;1;288;129;0;33;31;2
0264;289;1726;1;289;56;0;18;16;2
0264;290;1615;1;290;99;0;56;53;3
0264;291;1792;1;291;89;0;7;7;0
0264;29;1551;1;29;1710;0;429;420;9
0264;292;1714;1;292;92;0;57;49;8
0264;293;1697;1;293;189;0;119;112;7
0264;294;1630;1;294;147;0;51;45;6
0264;295;1677;1;295;166;0;8;8;0
0264;296;1675;1;296;28;0;2;2;0
0264;297;1610;1;297;106;0;22;20;2
0264;298;1587;1;298;148;0;85;76;9
0264;299;1688;1;299;37;0;13;12;1
0264;30;1772;1;30;2019;0;573;536;37
0264;31;1658;1;31;1970;1;629;601;28
0264;3;1564;1;3;2016;0;801;783;18
0264;32;1815;1;32;2115;0;647;619;28
0264;33;1541;1;33;1276;1;335;327;8
0264;34;1689;1;34;2082;1;503;468;35
0264;35;1524;1;35;1469;0;419;396;23
0264;36;1738;1;36;1997;0;570;570;0
0264;37;1801;1;37;2304;1;742;712;30
0264;38;1751;1;38;2097;0;560;525;35
0264;39;1710;1;39;1862;0;554;518;36
0264;40;1800;1;40;2073;0;659;632;27
0264;41;1557;1;41;1663;0;484;451;33
0264;4;1577;1;4;1099;0;358;349;9
0264;42;1707;1;42;1716;0;433;415;18
0264;43;1727;1;43;1002;0;414;397;17
0264;44;1678;1;44;2068;0;620;599;21
0264;45;1680;1;45;2251;0;671;650;21
0264;46;1637;1;46;1986;0;494;474;20
0264;47;1603;1;47;1909;0;626;595;31
0264;48;1568;1;48;1659;0;496;473;23
0264;49;1625;1;49;1994;0;826;798;28
0264;50;1723;1;50;2007;1;921;898;23
0264;51;1699;1;51;2099;0;608;598;10
0264;5;1596;1;5;1711;0;464;462;2
0264;52;1598;1;52;1576;0;528;506;22
0264;53;1705;1;53;1726;0;571;550;21
0264;54;1773;1;54;1311;0;413;394;19
0264;55;1628;1;55;2089;0;719;680;39
0264;56;1570;1;56;2253;0;638;620;18
0264;57;1690;1;57;1989;0;719;703;16
0264;58;1731;1;58;1961;0;711;697;14
0264;59;1547;1;59;1897;1;756;730;26
0264;60;1807;1;60;1929;0;585;566;19
0264;61;1562;1;61;2225;0;872;833;39
0264;6;1744;1;6;1096;0;374;360;14
0264;62;1695;1;62;2194;0;825;803;22
0264;63;1611;1;63;2140;0;867;836;31
0264;64;1560;1;64;1920;1;779;753;26
0264;65;1645;1;65;2226;0;709;653;56
0264;66;1698;1;66;1594;0;868;854;14
0264;67;1684;1;67;1161;0;645;634;11
0264;68;1554;1;68;630;0;292;287;5
0264;69;1559;1;69;1642;0;796;774;22
0264;70;1783;1;70;1726;0;739;724;15
0264;71;1650;1;71;1747;0;752;738;14
0264;7;1780;1;7;881;0;348;345;3
0264;72;1622;1;72;2143;0;941;918;23
0264;73;1635;1;73;2596;0;1284;1246;38
0264;74;1572;1;74;2187;0;1148;1125;23
0264;75;1525;1;75;1525;0;735;719;16
0264;76;1785;1;76;2190;0;1107;1071;36
0264;77;1759;1;77;1662;0;827;780;47
0264;78;1740;1;78;1560;0;753;732;21
0264;79;1663;1;79;2068;0;956;924;32
0264;80;1581;1;80;1983;0;964;944;20
0264;81;1574;1;81;1667;0;723;704;19
0264;8;1717;1;8;2009;1;868;824;44
0264;82;1746;1;82;2175;0;1035;1012;23
0264;83;1544;1;83;2106;0;937;905;32
0264;84;1775;1;84;1460;0;629;600;29
0264;85;1575;1;85;2063;0;1063;1040;23
0264;86;1536;1;86;1944;1;893;893;0
0264;87;1558;1;87;1860;0;897;897;0
0264;88;1590;1;88;1550;2;613;592;21
0264;89;1546;1;89;1675;0;654;640;14
0264;90;1776;1;90;1634;0;555;524;31
0264;91;1656;1;91;1520;0;461;444;17
0264;9;1787;1;9;1564;0;579;568;11
0264;92;1659;1;92;1653;0;754;729;25
0264;93;1534;1;93;1618;0;637;617;20
0264;94;1763;1;94;2018;0;888;875;13
0264;95;1747;1;95;1844;0;842;801;41
0264;96;1779;1;96;2193;0;1046;993;53
0264;97;1796;1;97;2037;0;809;791;18
0264;98;1642;1;98;2185;0;777;759;18
0264;99;1716;1;99;2313;0;1013;976;37
0401;1;1825;6;1;980;0;488;406;82
0401;1;1830;6;1;1690;12;1198;1026;172
0401;1;1833;6;1;1133;2;659;542;117
0401;1;1835;6;1;1090;1;549;397;152
0401;1;1842;6;1;825;0;511;417;94
0401;1;1844;6;1;1245;2;718;593;125
0401;1;1847;6;1;1429;0;638;551;87
0401;1;1853;6;1;1340;0;600;505;95
0401;1;1855;6;1;1234;1;615;540;75
0401;2;1834;6;2;906;0;457;350;107
0401;2;1837;6;2;543;0;241;204;37
0401;2;1838;6;2;1246;2;825;682;143
0401;2;1839;6;2;1076;0;523;523;0
0401;2;1841;6;2;1104;0;544;453;91
0401;2;1848;6;2;410;0;216;187;29
0401;2;1850;6;2;966;0;550;330;220
0401;2;1861;6;2;1470;0;671;541;130
0401;3;1821;6;3;554;0;266;210;56
0401;3;1822;6;3;613;0;322;232;90
0401;3;1823;6;3;837;0;382;298;84
0401;3;1828;6;3;937;4;513;408;105
0401;3;1829;6;3;1824;0;795;685;110
0401;3;1831;6;3;143;0;51;36;15
0401;3;1840;6;3;1224;1;608;534;74
0401;3;1856;6;3;909;0;348;275;73
0401;4;1819;6;4;1248;0;621;550;71
0401;4;1827;6;4;1457;0;679;600;79
0401;4;1836;6;4;98;0;78;60;18
0401;4;1843;6;4;746;0;381;313;68
0401;4;1854;6;4;454;0;215;184;31
0401;4;1857;6;4;1243;0;455;381;74
0401;4;1860;6;4;1008;0;609;507;102
0401;5;1826;6;5;2166;0;963;812;151
0401;5;1849;6;5;1062;0;541;476;65
0401;5;1852;6;5;1941;0;962;860;102
0401;5;1859;6;5;274;0;111;99;12
0401;6;1820;6;6;1933;0;826;717;109
0401;6;1824;6;6;1330;1;662;587;75
0401;6;1845;6;6;748;0;326;246;80
0401;6;1851;6;6;475;0;216;169;47
0401;7;1832;6;7;1237;0;459;389;70
0401;7;1846;6;7;1847;0;867;751;116
0401;7;1858;6;7;33;0;5;5;0
0402;10;1914;3;10;898;0;438;399;39
0402;11;1897;3;11;1659;1;723;687;36
0402;1;1865;3;1;1485;1;712;658;54
0402;1;1869;3;1;1264;10;686;595;91
0402;1;1873;3;1;964;0;554;473;81
0402;1;1875;3;1;1387;0;666;544;122
0402;1;1891;3;1;1126;6;795;639;156
0402;1;1892;3;1;1376;0;652;552;100
0402;1;1896;3;1;1930;0;941;833;108
0402;1;1898;3;1;2093;1;1056;873;183
0402;1;1905;3;1;1261;0;543;453;90
0402;1;1907;3;1;1134;4;715;600;115
0402;12;1912;3;12;1733;1;850;783;67
0402;13;1895;3;13;1271;0;595;535;60
0402;14;1911;3;14;1372;0;659;602;57
0402;15;1878;3;15;1772;2;759;689;70
0402;16;1886;3;16;19;0;8;7;1
0402;2;1862;3;2;460;0;196;170;26
0402;2;1871;3;2;2262;2;1310;1075;235
0402;2;1872;3;2;736;1;415;361;54
0402;2;1874;3;2;1485;0;608;555;53
0402;2;1885;3;2;1329;4;840;664;176
0402;2;1890;3;2;543;0;240;175;65
0402;2;1893;3;2;1081;0;432;325;107
0402;2;1894;3;2;1103;1;637;495;142
0402;2;1901;3;2;1487;1;690;630;60
0402;2;1903;3;2;860;0;345;295;50
0402;3;1864;3;3;1706;0;820;761;59
0402;3;1867;3;3;819;3;504;411;93
0402;3;1868;3;3;1468;3;615;581;34
0402;3;1870;3;3;505;0;282;234;48
0402;3;1879;3;3;1400;0;554;488;66
0402;3;1883;3;3;1025;0;428;353;75
0402;3;1899;3;3;996;0;317;254;63
0402;3;1900;3;3;1401;4;735;644;91
0402;3;1910;3;3;931;0;339;272;67
0402;4;1877;3;4;478;0;248;205;43
0402;4;1884;3;4;1375;0;605;515;90
0402;4;1888;3;4;447;0;243;192;51
0402;4;1902;3;4;1071;1;466;410;56
0402;4;1904;3;4;898;0;415;324;91
0402;4;1908;3;4;570;0;243;219;24
0402;4;1909;3;4;471;1;296;250;46
0402;5;1866;3;5;702;1;327;252;75
0402;5;1876;3;5;1360;0;572;540;32
0402;5;1906;3;5;1380;1;616;584;32
0402;5;1913;3;5;389;0;164;120;44
0402;6;1880;3;6;456;0;158;142;16
0402;6;1881;3;6;1688;0;715;660;55
0402;6;1882;3;6;838;0;318;290;28
0402;7;1889;3;7;1085;0;490;441;49
0402;8;1887;3;8;1529;0;763;705;58
0402;9;1863;3;9;1200;0;481;427;54
0403;10;1960;2;10;602;0;280;230;50
0403;10;1974;2;10;775;0;236;204;32
0403;11;1954;2;11;1939;1;896;818;78
0403;1;1915;2;1;456;0;203;157;46
0403;1;1926;2;1;1373;0;643;577;66
0403;1;1928;2;1;1633;1;884;722;162
0403;1;1944;2;1;1421;0;626;535;91
0403;1;1958;2;1;1025;1;382;323;59
0403;1;1964;2;1;1756;1;755;640;115
0403;1;1971;2;1;1875;3;893;690;203
0403;1;1975;2;1;1661;0;850;676;174
0403;12;1979;2;12;875;0;402;340;62
0403;13;1963;2;13;630;1;305;255;50
0403;14;1972;2;14;1730;0;772;675;97
0403;15;1976;2;15;1249;0;430;365;65
0403;16;1933;2;16;560;1;312;274;38
0403;17;1949;2;17;465;0;208;173;35
0403;18;1973;2;18;37;0;23;19;4
0403;2;1918;2;2;488;0;264;194;70
0403;2;1919;2;2;2090;2;963;800;163
0403;2;1927;2;2;1204;0;410;351;59
0403;2;1930;2;2;670;0;376;297;79
0403;2;1942;2;2;1066;0;516;435;81
0403;2;1946;2;2;1474;0;724;555;169
0403;2;1965;2;2;2062;0;948;825;123
0403;2;1970;2;2;1069;0;439;382;57
0403;3;1917;2;3;1822;2;717;569;148
0403;3;1923;2;3;1609;1;808;652;156
0403;3;1929;2;3;1197;0;626;567;59
0403;3;1932;2;3;932;0;425;366;59
0403;3;1935;2;3;1130;0;484;431;53
0403;3;1940;2;3;1128;0;576;455;121
0403;3;1950;2;3;2257;0;841;740;101
0403;3;1980;2;3;1270;1;740;594;146
0403;4;1916;2;4;1892;0;994;814;180
0403;4;1943;2;4;326;0;153;122;31
0403;4;1948;2;4;1483;1;753;569;184
0403;4;1951;2;4;1287;1;556;464;92
0403;4;1955;2;4;1462;0;723;602;121
0403;4;1959;2;4;1084;0;481;411;70
0403;4;1968;2;4;1252;0;663;571;92
0403;4;1969;2;4;1110;0;498;427;71
0403;5;1925;2;5;1799;0;960;894;66
0403;5;1936;2;5;1117;0;466;401;65
0403;5;1956;2;5;405;0;218;188;30
0403;5;1961;2;5;1465;0;752;670;82
0403;5;1977;2;5;1151;0;505;423;82
0403;5;1978;2;5;1287;0;612;518;94
0403;5;1981;2;5;2343;1;1104;970;134
0403;6;1921;2;6;614;0;312;253;59
0403;6;1934;2;6;313;0;181;120;61
0403;6;1938;2;6;833;0;416;354;62
0403;6;1939;2;6;975;1;363;316;47
0403;6;1945;2;6;430;0;202;149;53
0403;6;1957;2;6;1271;0;668;560;108
0403;6;1967;2;6;793;3;347;278;69
0403;7;1920;2;7;1753;0;738;658;80
0403;7;1924;2;7;1340;0;657;585;72
0403;7;1947;2;7;293;0;160;124;36
0403;7;1953;2;7;568;0;285;246;39
0403;7;1966;2;7;1201;0;575;484;91
0403;8;1931;2;8;1633;0;767;684;83
0403;8;1937;2;8;1587;0;640;484;156
0403;8;1941;2;8;1542;0;678;574;104
0403;8;1962;2;8;591;0;287;232;55
0403;9;1922;2;9;1257;0;632;547;85
0403;9;1952;2;9;1711;0;724;605;119
0403;9;1982;2;9;533;0;190;165;25
0404;10;2022;4;10;1076;1;516;448;68
0404;11;2021;4;11;1417;0;579;511;68
0404;1;1986;4;1;1192;0;410;350;60
0404;1;1998;4;1;572;0;304;259;45
0404;1;2003;4;1;1923;0;1133;1002;131
0404;1;2004;4;1;794;0;354;275;79
0404;1;2014;4;1;1043;0;397;335;62
0404;1;2015;4;1;875;0;318;260;58
0404;1;2023;4;1;845;0;333;279;54
0404;12;2009;4;12;765;0;375;323;52
0404;13;1994;4;13;1305;1;552;471;81
0404;14;1990;4;14;761;1;310;284;26
0404;15;2007;4;15;881;1;326;276;50
0404;16;2010;4;16;38;0;22;15;7
0404;17;1993;4;17;11;0;8;5;3
0404;18;2006;4;18;27;0;15;15;0
0404;2;1985;4;2;1885;0;671;542;129
0404;2;1988;4;2;1116;0;288;247;41
0404;2;1991;4;2;1328;2;820;657;163
0404;2;1997;4;2;589;1;246;201;45
0404;2;2016;4;2;1569;1;647;545;102
0404;2;2017;4;2;976;0;347;293;54
0404;2;2020;4;2;1440;0;591;498;93
0404;3;1995;4;3;1115;1;363;312;51
0404;3;1999;4;3;1225;0;606;478;128
0404;3;2001;4;3;1100;2;616;499;117
0404;3;2005;4;3;1468;0;661;579;82
0404;3;2008;4;3;900;0;273;219;54
0404;3;2013;4;3;543;0;203;152;51
0404;3;2018;4;3;1093;4;544;485;59
0404;4;1987;4;4;618;0;285;245;40
0404;4;1989;4;4;470;0;161;123;38
0404;4;1992;4;4;580;0;309;241;68
0404;4;1996;4;4;1296;0;359;304;55
0404;4;2000;4;4;867;0;425;363;62
0404;4;2012;4;4;904;0;386;292;94
0404;5;2019;4;5;1253;0;508;452;56
0404;5;2024;4;5;584;0;315;250;65
0404;6;2002;4;6;1458;0;644;580;64
0404;7;1984;4;7;963;0;338;285;53
0404;8;2011;4;8;869;0;412;381;31
0404;9;1983;4;9;971;1;432;385;47
0405;1;2027;3;1;1532;4;920;794;126
0405;1;2032;3;1;2223;10;1541;1232;309
0405;1;2038;3;1;1479;2;885;718;167
0405;1;2039;3;1;1385;1;834;681;153
0405;1;2045;3;1;1453;0;803;703;100
0405;1;2052;3;1;1492;2;890;743;147
0405;2;2029;3;2;628;0;402;357;45
0405;2;2031;3;2;1334;1;854;731;123
0405;2;2035;3;2;854;6;609;438;171
0405;2;2037;3;2;1767;0;845;763;82
0405;2;2042;3;2;898;4;588;443;145
0405;2;2043;3;2;430;1;277;238;39
0405;3;2030;3;3;1154;0;642;524;118
0405;3;2040;3;3;1321;1;799;672;127
0405;3;2044;3;3;1671;1;1021;833;188
0405;3;2048;3;3;1202;1;628;534;94
0405;3;2051;3;3;2307;0;1256;1114;142
0405;4;2026;3;4;2207;0;1228;1106;122
0405;4;2041;3;4;1306;0;733;580;153
0405;4;2047;3;4;1480;1;886;712;174
0405;5;2025;3;5;505;0;277;233;44
0405;5;2033;3;5;1204;3;698;631;67
0405;5;2049;3;5;1473;4;915;762;153
0405;6;2034;3;6;685;0;322;275;47
0405;6;2050;3;6;1156;0;581;532;49
0405;7;2036;3;7;1133;4;604;518;86
0405;7;2046;3;7;35;0;10;10;0
0405;8;2028;3;8;1340;0;710;621;89
0406;10;2063;3;10;699;0;244;234;10
0406;1;2054;3;1;1686;1;939;695;244
0406;1;2058;3;1;966;2;455;329;126
0406;1;2064;3;1;1550;2;784;567;217
0406;1;2071;3;1;278;0;110;87;23
0406;1;2077;3;1;1520;2;868;735;133
0406;1;2079;3;1;654;0;293;262;31
0406;2;2056;3;2;1506;0;529;445;84
0406;2;2066;3;2;1405;1;639;500;139
0406;2;2069;3;2;496;0;244;196;48
0406;2;2072;3;2;1952;0;1045;868;177
0406;2;2076;3;2;1639;0;749;556;193
0406;2;2080;3;2;965;0;532;456;76
0406;3;2055;3;3;1332;1;737;605;132
0406;3;2057;3;3;804;0;441;341;100
0406;3;2060;3;3;1404;0;507;446;61
0406;3;2062;3;3;664;0;278;229;49
0406;3;2065;3;3;627;0;181;141;40
0406;3;2070;3;3;661;0;317;281;36
0406;4;2067;3;4;1132;0;445;389;56
0406;4;2068;3;4;608;0;324;277;47
0406;4;2081;3;4;584;0;321;287;34
0406;4;2085;3;4;571;0;168;96;72
0406;5;2053;3;5;542;0;241;201;40
0406;5;2078;3;5;727;0;364;314;50
0406;5;2083;3;5;1179;0;436;378;58
0406;5;2084;3;5;878;0;463;343;120
0406;6;2074;3;6;734;0;360;305;55
0406;6;2075;3;6;1298;0;471;439;32
0406;6;2082;3;6;703;0;322;271;51
0406;7;2061;3;7;584;0;185;165;20
0406;8;2073;3;8;511;0;224;185;39
0406;9;2059;3;9;317;0;104;85;19
0407;10;2101;5;10;676;0;374;316;58
0407;10;2111;5;10;63;0;30;27;3
0407;10;2117;5;10;1145;1;609;468;141
0407;10;2167;5;10;444;0;126;105;21
0407;10;2196;5;10;2258;1;847;783;64
0407;11;2110;5;11;2098;0;679;615;64
0407;11;2134;5;11;645;0;245;205;40
0407;11;2163;5;11;770;0;346;294;52
0407;1;2096;5;1;1617;2;969;777;192
0407;1;2126;5;1;1371;1;798;590;208
0407;1;2127;5;1;1235;0;637;573;64
0407;1;2131;5;1;881;0;498;415;83
0407;1;2137;5;1;1696;0;791;724;67
0407;1;2138;5;1;1511;1;603;508;95
0407;1;2164;5;1;1033;0;547;472;75
0407;1;2168;5;1;1878;0;599;541;58
0407;1;2186;5;1;933;1;352;275;77
0407;12;2146;5;12;629;0;293;246;47
0407;12;2161;5;12;57;0;48;40;8
0407;12;2169;5;12;1444;0;484;420;64
0407;13;2135;5;13;411;0;175;142;33
0407;13;2166;5;13;40;0;15;13;2
0407;13;2201;5;13;918;0;266;247;19
0407;14;2112;5;14;1683;0;399;351;48
0407;14;2192;5;14;456;0;202;185;17
0407;15;2118;5;15;848;0;174;159;15
0407;15;2132;5;15;736;0;344;255;89
0407;16;2120;5;16;743;0;350;291;59
0407;16;2180;5;16;76;0;49;48;1
0407;17;2102;5;17;650;1;418;371;47
0407;17;2195;5;17;747;0;300;285;15
0407;18;2100;5;18;247;0;165;126;39
0407;18;2172;5;18;1744;0;427;383;44
0407;19;2152;5;19;1621;0;587;525;62
0407;19;2182;5;19;488;0;269;239;30
0407;20;2129;5;20;1855;0;656;598;58
0407;21;2177;5;21;1048;0;405;372;33
0407;2;2097;5;2;954;0;352;255;97
0407;2;2109;5;2;1408;0;664;514;150
0407;2;2115;5;2;1451;2;606;536;70
0407;2;2116;5;2;1209;0;240;209;31
0407;2;2150;5;2;1267;0;566;474;92
0407;2;2175;5;2;1761;0;890;794;96
0407;2;2187;5;2;1459;0;800;617;183
0407;2;2188;5;2;1112;0;424;307;117
0407;2;2191;5;2;1428;0;778;611;167
0407;22;2194;5;22;1556;0;570;515;55
0407;23;2090;5;23;1630;1;625;556;69
0407;24;2158;5;24;1774;0;662;598;64
0407;25;2143;5;25;1277;1;552;516;36
0407;26;2088;5;26;2057;0;873;809;64
0407;27;2108;5;27;1157;0;275;243;32
0407;28;2156;5;28;706;0;297;252;45
0407;29;2103;5;29;1459;2;401;351;50
0407;30;2121;5;30;1176;0;366;324;42
0407;31;2179;5;31;1074;0;386;347;39
0407;3;2086;5;3;1412;1;725;573;152
0407;3;2104;5;3;569;0;220;160;60
0407;3;2119;5;3;1857;0;703;674;29
0407;3;2128;5;3;1784;0;668;567;101
0407;3;2130;5;3;701;0;335;275;60
0407;3;2139;5;3;1736;0;843;766;77
0407;3;2142;5;3;1381;0;647;546;101
0407;3;2153;5;3;1359;1;485;485;0
0407;3;2189;5;3;604;0;343;282;61
0407;32;2181;5;32;1726;0;652;608;44
0407;33;2095;5;33;2252;0;894;819;75
0407;34;2148;5;34;2167;1;899;822;77
0407;35;2140;5;35;2463;0;908;775;133
0407;36;2171;5;36;1595;0;614;550;64
0407;37;2165;5;37;1941;0;698;624;74
0407;38;2092;5;38;947;0;388;349;39
0407;39;2113;5;39;2324;0;851;761;90
0407;40;2106;5;40;2256;0;814;731;83
0407;41;2147;5;41;1604;0;672;593;79
0407;4;2093;5;4;393;0;211;164;47
0407;4;2123;5;4;1480;0;661;555;106
0407;4;2125;5;4;1679;0;671;607;64
0407;4;2151;5;4;538;0;270;221;49
0407;4;2154;5;4;2157;1;1113;1018;95
0407;4;2162;5;4;796;0;426;361;65
0407;4;2193;5;4;948;1;304;238;66
0407;4;2202;5;4;1293;0;557;448;109
0407;4;2203;5;4;1202;0;576;434;142
0407;42;2098;5;42;1378;0;463;406;57
0407;43;2185;5;43;159;0;23;18;5
0407;44;2091;5;44;83;0;19;14;5
0407;5;2114;5;5;1066;1;426;386;40
0407;5;2124;5;5;867;0;461;432;29
0407;5;2133;5;5;946;0;396;341;55
0407;5;2155;5;5;698;0;216;177;39
0407;5;2173;5;5;1390;1;773;611;162
0407;5;2190;5;5;492;0;239;167;72
0407;5;2197;5;5;1019;0;438;354;84
0407;5;2198;5;5;1584;0;536;469;67
0407;5;2200;5;5;458;0;239;187;52
0407;6;2087;5;6;1476;0;797;676;121
0407;6;2094;5;6;270;0;188;165;23
0407;6;2099;5;6;2039;0;814;616;198
0407;6;2105;5;6;1148;0;450;368;82
0407;6;2122;5;6;439;0;280;246;34
0407;6;2160;5;6;1023;0;302;266;36
0407;6;2174;5;6;546;0;201;166;35
0407;7;2141;5;7;651;0;332;288;44
0407;7;2145;5;7;635;0;377;314;63
0407;7;2159;5;7;899;0;369;344;25
0407;7;2170;5;7;397;0;205;162;43
0407;7;2176;5;7;542;0;255;205;50
0407;8;2107;5;8;434;0;206;174;32
0407;8;2136;5;8;634;0;298;247;51
0407;8;2178;5;8;832;0;213;178;35
0407;8;2184;5;8;643;0;383;285;98
0407;8;2199;5;8;1377;0;592;592;0
0407;9;2089;5;9;1038;0;326;278;48
0407;9;2144;5;9;346;6;206;151;55
0407;9;2149;5;9;900;0;399;344;55
0407;9;2157;5;9;1378;0;589;505;84
0407;9;2183;5;9;1624;1;560;470;90
0408;10;2244;6;10;30;0;11;6;5
0408;1;2205;6;1;1095;2;571;470;101
0408;1;2207;6;1;2157;5;1252;1011;241
0408;1;2210;6;1;1079;1;527;413;114
0408;1;2211;6;1;1280;0;616;464;152
0408;1;2212;6;1;1274;3;610;481;129
0408;1;2217;6;1;1214;0;728;602;126
0408;1;2224;6;1;1800;1;1123;937;186
0408;1;2234;6;1;1410;1;808;575;233
0408;1;2240;6;1;1828;1;1170;912;258
0408;2;2208;6;2;844;0;448;352;96
0408;2;2218;6;2;605;1;279;196;83
0408;2;2222;6;2;761;3;374;314;60
0408;2;2231;6;2;1236;2;658;544;114
0408;2;2236;6;2;1288;0;648;524;124
0408;2;2239;6;2;294;0;163;125;38
0408;2;2249;6;2;796;0;453;353;100
0408;2;2251;6;2;1870;13;1106;933;173
0408;2;2253;6;2;436;0;255;212;43
0408;3;2206;6;3;605;1;335;236;99
0408;3;2215;6;3;448;0;205;169;36
0408;3;2216;6;3;413;0;237;182;55
0408;3;2233;6;3;1133;2;608;518;90
0408;3;2242;6;3;1602;1;976;794;182
0408;3;2246;6;3;578;0;258;183;75
0408;3;2248;6;3;794;2;434;324;110
0408;3;2250;6;3;1272;1;515;397;118
0408;3;2256;6;3;287;0;144;116;28
0408;4;2214;6;4;634;0;371;310;61
0408;4;2219;6;4;1276;0;500;417;83
0408;4;2223;6;4;800;2;330;230;100
0408;4;2225;6;4;1420;0;636;491;145
0408;4;2226;6;4;473;0;229;179;50
0408;4;2247;6;4;1017;0;480;392;88
0408;4;2255;6;4;941;1;453;370;83
0408;5;2220;6;5;1525;3;783;672;111
0408;5;2227;6;5;464;2;212;162;50
0408;5;2228;6;5;914;1;466;358;108
0408;5;2232;6;5;1934;0;854;697;157
0408;5;2252;6;5;438;0;237;185;52
0408;5;2254;6;5;378;0;174;145;29
0408;6;2204;6;6;74;0;43;28;15
0408;6;2213;6;6;1194;0;430;350;80
0408;6;2230;6;6;857;0;440;348;92
0408;6;2238;6;6;335;0;149;118;31
0408;6;2241;6;6;2073;0;1062;945;117
0408;7;2209;6;7;1459;0;647;561;86
0408;7;2229;6;7;1180;0;572;428;144
0408;7;2237;6;7;747;0;405;334;71
0408;8;2221;6;8;1155;1;533;473;60
0408;8;2243;6;8;750;5;358;285;73
0408;8;2245;6;8;747;0;414;366;48
0408;9;2235;6;9;1370;2;761;671;90
0409;10;2273;5;10;1360;0;683;518;165
0409;10;2282;5;10;16;0;12;9;3
0409;11;2269;5;11;751;0;289;251;38
0409;12;2258;5;12;1279;0;657;561;96
0409;1;2260;5;1;1354;2;662;572;90
0409;1;2271;5;1;1096;0;646;520;126
0409;1;2274;5;1;1190;0;571;487;84
0409;1;2277;5;1;1792;0;1090;929;161
0409;13;2281;5;13;1384;1;636;543;93
0409;14;2285;5;14;1466;0;714;622;92
0409;15;2288;5;15;757;0;365;297;68
0409;16;2287;5;16;24;0;17;15;2
0409;2;2264;5;2;1898;0;949;805;144
0409;2;2275;5;2;1458;1;934;768;166
0409;2;2276;5;2;551;0;306;257;49
0409;2;2289;5;2;1543;2;864;783;81
0409;3;2259;5;3;673;0;314;269;45
0409;3;2266;5;3;1335;0;693;604;89
0409;3;2268;5;3;1526;0;955;785;170
0409;3;2290;5;3;716;0;386;337;49
0409;4;2257;5;4;737;0;368;308;60
0409;4;2262;5;4;1572;1;893;776;117
0409;4;2270;5;4;64;0;40;27;13
0409;4;2286;5;4;1468;1;729;584;145
0409;5;2267;5;5;1880;0;932;826;106
0409;5;2278;5;5;953;0;406;337;69
0409;5;2284;5;5;647;0;339;287;52
0409;6;2263;5;6;1721;1;904;777;127
0409;6;2280;5;6;539;0;342;302;40
0409;7;2261;5;7;1393;1;700;606;94
0409;7;2279;5;7;318;0;173;149;24
0409;8;2265;5;8;1089;0;587;517;70
0409;8;2283;5;8;793;0;423;362;61
0409;9;2272;5;9;845;0;434;382;52
0409;9;2291;5;9;1279;0;684;556;128
0410;10;2300;2;10;449;2;219;170;49
0410;10;2343;2;10;1513;1;533;441;92
0410;10;2353;2;10;1617;0;692;598;94
0410;11;2298;2;11;854;0;321;277;44
0410;11;2316;2;11;750;0;331;253;78
0410;12;2299;2;12;630;0;273;220;53
0410;12;2334;2;12;941;0;431;378;53
0410;1;2293;2;1;1912;4;1098;968;130
0410;1;2303;2;1;2202;0;1065;891;174
0410;1;2315;2;1;2196;1;970;860;110
0410;1;2328;2;1;1562;1;778;599;179
0410;1;2354;2;1;1352;0;588;434;154
0410;13;2310;2;13;980;0;411;372;39
0410;13;2345;2;13;2053;0;896;731;165
0410;14;2307;2;14;1179;0;444;386;58
0410;14;2332;2;14;1241;0;560;470;90
0410;15;2295;2;15;1449;0;609;519;90
0410;15;2309;2;15;508;0;275;219;56
0410;16;2323;2;16;1900;0;676;598;78
0410;16;2335;2;16;20;0;9;9;0
0410;17;2336;2;17;860;1;438;368;70
0410;18;2305;2;18;1029;0;473;428;45
0410;19;2331;2;19;22;0;5;5;0
0410;20;2340;2;20;12;0;2;2;0
0410;21;2326;2;21;61;0;46;32;14
0410;2;2297;2;2;1472;4;784;692;92
0410;2;2312;2;2;454;0;177;151;26
0410;2;2314;2;2;1854;0;1009;874;135
0410;2;2348;2;2;1186;1;526;455;71
0410;2;2351;2;2;1008;2;517;390;127
0410;3;2308;2;3;1709;3;829;689;140
0410;3;2327;2;3;506;0;219;180;39
0410;3;2333;2;3;1239;0;597;537;60
0410;3;2338;2;3;1454;0;592;491;101
0410;3;2350;2;3;991;0;435;378;57
0410;4;2301;2;4;868;0;299;208;91
0410;4;2302;2;4;1825;1;870;775;95
0410;4;2318;2;4;1273;0;530;451;79
0410;4;2321;2;4;684;0;346;263;83
0410;4;2349;2;4;613;0;301;234;67
0410;5;2304;2;5;1334;0;518;411;107
0410;5;2306;2;5;508;0;156;134;22
0410;5;2313;2;5;852;0;327;245;82
0410;5;2344;2;5;1034;2;582;475;107
0410;5;2352;2;5;1660;0;811;678;133
0410;6;2319;2;6;1161;0;394;347;47
0410;6;2322;2;6;1796;0;857;740;117
0410;6;2324;2;6;351;0;174;125;49
0410;6;2341;2;6;901;0;458;381;77
0410;6;2342;2;6;751;0;359;301;58
0410;7;2296;2;7;570;0;179;136;43
0410;7;2317;2;7;1273;0;567;475;92
0410;7;2320;2;7;1302;1;584;488;96
0410;7;2329;2;7;896;0;400;346;54
0410;7;2347;2;7;1785;1;709;606;103
0410;8;2292;2;8;486;0;159;136;23
0410;8;2325;2;8;1019;0;352;292;60
0410;8;2337;2;8;480;0;223;163;60
0410;8;2339;2;8;1020;0;349;298;51
0410;9;2294;2;9;527;0;158;139;19
0410;9;2311;2;9;2033;5;884;743;141
0410;9;2330;2;9;544;0;233;203;30
0410;9;2346;2;9;541;0;190;154;36
0411;10;2372;5;10;555;0;260;212;48
0411;11;2360;5;11;67;0;35;29;6
0411;1;2367;5;1;1914;0;1046;908;138
0411;1;2370;5;1;1555;8;879;611;268
0411;1;2376;5;1;489;1;316;204;112
0411;1;2377;5;1;1876;1;1018;834;184
0411;1;2385;5;1;1230;1;684;518;166
0411;1;2389;5;1;1568;2;931;709;222
0411;1;2391;5;1;596;0;339;275;64
0411;2;2356;5;2;549;0;334;270;64
0411;2;2357;5;2;410;0;228;172;56
0411;2;2363;5;2;1424;11;842;593;249
0411;2;2366;5;2;852;3;545;416;129
0411;2;2374;5;2;483;0;273;228;45
0411;2;2381;5;2;1729;0;1009;831;178
0411;2;2383;5;2;1948;0;1115;946;169
0411;3;2358;5;3;766;3;388;314;74
0411;3;2362;5;3;406;0;219;187;32
0411;3;2368;5;3;1722;5;1090;834;256
0411;3;2379;5;3;974;1;473;401;72
0411;3;2386;5;3;907;0;478;371;107
0411;3;2392;5;3;1194;0;740;576;164
0411;3;2396;5;3;1448;8;985;751;234
0411;4;2355;5;4;8;0;3;0;3
0411;4;2361;5;4;481;2;296;249;47
0411;4;2364;5;4;491;1;251;212;39
0411;4;2380;5;4;671;1;409;310;99
0411;4;2382;5;4;1167;5;668;505;163
0411;4;2390;5;4;536;0;344;250;94
0411;4;2393;5;4;756;0;415;352;63
0411;5;2359;5;5;203;0;126;107;19
0411;5;2365;5;5;444;4;313;223;90
0411;5;2369;5;5;535;0;263;225;38
0411;5;2371;5;5;637;0;319;253;66
0411;5;2388;5;5;785;8;418;316;102
0411;6;2378;5;6;244;0;143;112;31
0411;6;2384;5;6;335;2;231;203;28
0411;6;2394;5;6;570;0;284;220;64
0411;6;2395;5;6;488;0;265;210;55
0411;7;2375;5;7;555;0;302;242;60
0411;8;2373;5;8;500;0;285;233;52
0411;9;2387;5;9;552;0;272;231;41
0412;10;2427;6;10;13;0;7;5;2
0412;1;2401;6;1;1279;1;630;535;95
0412;1;2410;6;1;968;0;567;460;107
0412;1;2412;6;1;1349;0;684;537;147
0412;1;2422;6;1;1032;0;689;574;115
0412;1;2426;6;1;1053;0;569;440;129
0412;1;2428;6;1;1283;0;737;580;157
0412;2;2405;6;2;1242;1;677;549;128
0412;2;2409;6;2;1464;2;881;716;165
0412;2;2416;6;2;1092;5;751;608;143
0412;2;2418;6;2;515;1;198;168;30
0412;2;2429;6;2;1137;2;587;516;71
0412;2;2430;6;2;1442;2;753;635;118
0412;3;2402;6;3;782;4;537;432;105
0412;3;2403;6;3;429;0;210;166;44
0412;3;2411;6;3;606;1;232;186;46
0412;3;2414;6;3;1120;8;768;595;173
0412;3;2417;6;3;523;0;267;206;61
0412;3;2424;6;3;1475;1;814;712;102
0412;4;2397;6;4;1577;0;951;751;200
0412;4;2404;6;4;1050;1;773;636;137
0412;4;2406;6;4;955;3;423;335;88
0412;4;2408;6;4;1502;1;849;762;87
0412;4;2415;6;4;876;2;500;431;69
0412;4;2420;6;4;591;0;295;235;60
0412;5;2400;6;5;1890;1;933;816;117
0412;5;2407;6;5;737;1;379;329;50
0412;5;2413;6;5;498;0;239;187;52
0412;5;2423;6;5;33;0;23;9;14
0412;6;2421;6;6;1483;0;742;656;86
0412;6;2425;6;6;1011;0;485;414;71
0412;7;2399;6;7;1839;0;1029;910;119
0412;8;2398;6;8;1575;0;811;702;109
0412;9;2419;6;9;1316;0;660;568;92
0413;10;2441;2;10;805;0;229;188;41
0413;10;2458;2;10;6;0;6;5;1
0413;1;2432;2;1;676;0;224;170;54
0413;1;2439;2;1;2283;1;1033;870;163
0413;1;2448;2;1;2151;3;937;819;118
0413;1;2451;2;1;1796;1;1058;838;220
0413;2;2440;2;2;903;0;369;299;70
0413;2;2442;2;2;979;1;460;380;80
0413;2;2449;2;2;1956;0;887;779;108
0413;2;2452;2;2;75;0;54;51;3
0413;3;2435;2;3;1522;1;677;478;199
0413;3;2446;2;3;959;0;531;444;87
0413;3;2456;2;3;1502;0;781;685;96
0413;3;2460;2;3;1927;0;914;769;145
0413;4;2431;2;4;1528;3;605;518;87
0413;4;2436;2;4;1365;2;676;467;209
0413;4;2437;2;4;1055;0;377;292;85
0413;4;2454;2;4;1472;0;588;498;90
0413;5;2434;2;5;513;0;215;177;38
0413;5;2438;2;5;1213;0;516;434;82
0413;5;2447;2;5;724;0;349;299;50
0413;5;2450;2;5;782;0;351;309;42
0413;6;2433;2;6;1303;0;431;373;58
0413;6;2455;2;6;817;0;235;212;23
0413;7;2444;2;7;1729;0;791;705;86
0413;7;2459;2;7;1325;1;445;337;108
0413;8;2443;2;8;372;0;148;129;19
0413;8;2453;2;8;642;0;147;125;22
0413;9;2445;2;9;41;0;23;21;2
0413;9;2457;2;9;452;0;140;110;30
0414;10;2500;2;10;532;0;203;155;48
0414;10;2517;2;10;2004;0;1016;894;122
0414;11;2497;2;11;1539;1;462;381;81
0414;12;2508;2;12;1078;0;400;400;0
0414;1;2461;2;1;1771;1;817;553;264
0414;1;2463;2;1;1312;0;604;428;176
0414;1;2482;2;1;1034;0;536;442;94
0414;1;2484;2;1;571;0;202;162;40
0414;1;2496;2;1;1787;2;1014;701;313
0414;1;2498;2;1;2063;3;1180;989;191
0414;1;2501;2;1;1405;0;658;445;213
0414;1;2516;2;1;1540;0;732;526;206
0414;1;2519;2;1;2094;1;1221;991;230
0414;1;2522;2;1;811;0;273;196;77
0414;1;2523;2;1;2362;1;1031;1031;0
0414;13;2528;2;13;1749;0;636;636;0
0414;14;2492;2;14;1082;0;503;394;109
0414;15;2488;2;15;1155;0;474;400;74
0414;16;2514;2;16;1354;0;512;418;94
0414;17;2524;2;17;7;0;3;3;0
0414;18;2495;2;18;26;0;8;5;3
0414;19;2470;2;19;30;0;13;13;0
0414;2;2471;2;2;2064;1;827;627;200
0414;2;2472;2;2;663;0;285;224;61
0414;2;2485;2;2;2059;0;769;638;131
0414;2;2489;2;2;1383;0;677;507;170
0414;2;2491;2;2;1062;0;369;225;144
0414;2;2502;2;2;1266;0;484;439;45
0414;2;2504;2;2;611;0;215;160;55
0414;2;2509;2;2;710;0;343;232;111
0414;2;2510;2;2;747;0;310;238;72
0414;2;2527;2;2;645;0;297;228;69
0414;2;2529;2;2;1073;0;442;330;112
0414;3;2464;2;3;564;0;217;169;48
0414;3;2466;2;3;1177;0;284;233;51
0414;3;2476;2;3;1413;0;674;544;130
0414;3;2477;2;3;570;0;249;191;58
0414;3;2481;2;3;1811;0;585;478;107
0414;3;2490;2;3;838;0;378;291;87
0414;3;2499;2;3;831;0;188;149;39
0414;3;2505;2;3;599;0;208;157;51
0414;3;2512;2;3;715;0;292;241;51
0414;3;2515;2;3;666;2;271;237;34
0414;4;2467;2;4;511;0;208;150;58
0414;4;2468;2;4;1040;0;330;219;111
0414;4;2469;2;4;2349;1;1081;970;111
0414;4;2479;2;4;1046;1;383;273;110
0414;4;2486;2;4;956;2;498;416;82
0414;4;2493;2;4;1231;0;688;562;126
0414;4;2494;2;4;1226;0;536;383;153
0414;4;2506;2;4;676;0;294;234;60
0414;4;2507;2;4;1687;0;932;791;141
0414;4;2513;2;4;2121;0;873;714;159
0414;5;2473;2;5;817;0;383;321;62
0414;5;2474;2;5;1561;1;685;553;132
0414;5;2478;2;5;996;0;482;416;66
0414;5;2480;2;5;714;0;329;276;53
0414;5;2518;2;5;642;0;282;194;88
0414;6;2465;2;6;782;0;356;284;72
0414;6;2503;2;6;2043;0;939;693;246
0414;6;2521;2;6;1180;0;503;389;114
0414;6;2525;2;6;819;0;269;238;31
0414;7;2462;2;7;82;0;55;48;7
0414;7;2475;2;7;1396;0;649;565;84
0414;7;2520;2;7;637;0;161;134;27
0414;8;2483;2;8;1800;0;842;736;106
0414;8;2511;2;8;331;0;129;105;24
0414;9;2487;2;9;1836;0;746;653;93
0414;9;2526;2;9;558;0;180;141;39
0415;10;2578;4;10;1014;0;367;328;39
0415;11;2569;4;11;1545;0;891;811;80
0415;1;2548;4;1;1939;0;1013;945;68
0415;1;2552;4;1;2260;0;1184;1060;124
0415;1;2563;4;1;1982;0;806;721;85
0415;1;2566;4;1;1334;0;745;674;71
0415;1;2568;4;1;1079;0;626;514;112
0415;1;2572;4;1;2055;0;936;789;147
0415;1;2575;4;1;2146;1;796;698;98
0415;1;2576;4;1;1488;1;770;635;135
0415;1;2581;4;1;1085;1;642;538;104
0415;2;2532;4;2;1599;0;612;492;120
0415;2;2534;4;2;1677;0;648;570;78
0415;2;2537;4;2;1304;0;615;527;88
0415;2;2546;4;2;990;1;479;397;82
0415;2;2553;4;2;1974;2;908;730;178
0415;2;2558;4;2;898;0;411;371;40
0415;2;2561;4;2;1325;2;665;557;108
0415;2;2573;4;2;749;0;297;248;49
0415;2;2585;4;2;793;0;444;351;93
0415;3;2531;4;3;1007;4;547;409;138
0415;3;2540;4;3;1732;2;765;705;60
0415;3;2541;4;3;1524;0;742;660;82
0415;3;2542;4;3;1946;2;1215;815;400
0415;3;2547;4;3;125;0;67;53;14
0415;3;2549;4;3;1766;0;902;824;78
0415;3;2559;4;3;1408;0;776;642;134
0415;3;2560;4;3;954;0;545;455;90
0415;3;2565;4;3;2031;1;1006;844;162
0415;4;2535;4;4;2118;0;1208;1015;193
0415;4;2538;4;4;1183;1;580;491;89
0415;4;2539;4;4;79;0;61;43;18
0415;4;2545;4;4;1065;0;550;416;134
0415;4;2550;4;4;909;0;510;435;75
0415;4;2564;4;4;680;0;379;327;52
0415;4;2567;4;4;1993;0;1020;843;177
0415;4;2574;4;4;1266;2;720;578;142
0415;4;2579;4;4;2148;0;930;832;98
0415;5;2530;4;5;1896;0;998;930;68
0415;5;2544;4;5;1436;0;679;578;101
0415;5;2555;4;5;1009;2;560;470;90
0415;5;2557;4;5;497;4;290;235;55
0415;5;2577;4;5;792;0;321;266;55
0415;5;2583;4;5;1051;0;459;428;31
0415;5;2586;4;5;2364;1;1115;1028;87
0415;6;2533;4;6;1749;0;728;676;52
0415;6;2556;4;6;755;0;379;321;58
0415;6;2571;4;6;1359;2;697;575;122
0415;6;2580;4;6;1482;2;665;590;75
0415;6;2584;4;6;1027;0;555;465;90
0415;7;2536;4;7;613;0;342;291;51
0415;7;2551;4;7;27;0;7;7;0
0415;7;2562;4;7;956;0;473;391;82
0415;8;2543;4;8;455;0;261;218;43
0415;8;2554;4;8;1842;0;841;719;122
0415;9;2570;4;9;1032;0;461;373;88
0415;9;2582;4;9;104;0;62;32;30
0416;10;2594;2;10;475;0;221;189;32
0416;11;2623;2;11;554;0;213;189;24
0416;12;2602;2;12;664;1;257;223;34
0416;1;2599;2;1;1677;0;792;695;97
0416;1;2605;2;1;688;3;376;281;95
0416;1;2607;2;1;1194;2;749;585;164
0416;1;2613;2;1;573;0;276;225;51
0416;1;2619;2;1;2194;0;1320;920;400
0416;1;2621;2;1;1576;0;708;507;201
0416;13;2615;2;13;602;1;252;224;28
0416;14;2588;2;14;304;0;147;124;23
0416;15;2608;2;15;1013;0;526;487;39
0416;16;2603;2;16;40;0;33;31;2
0416;17;2590;2;17;14;0;11;9;2
0416;2;2591;2;2;1333;0;692;614;78
0416;2;2592;2;2;579;0;274;186;88
0416;2;2598;2;2;743;0;314;246;68
0416;2;2611;2;2;897;0;483;365;118
0416;2;2616;2;2;527;0;288;223;65
0416;2;2620;2;2;1429;1;855;673;182
0416;3;2589;2;3;816;2;500;402;98
0416;3;2593;2;3;1831;0;996;802;194
0416;3;2596;2;3;1204;0;581;398;183
0416;3;2600;2;3;1419;0;783;679;104
0416;3;2612;2;3;1085;0;555;513;42
0416;3;2622;2;3;542;0;340;252;88
0416;4;2595;2;4;912;0;449;383;66
0416;4;2597;2;4;1748;3;1073;860;213
0416;4;2606;2;4;1278;1;562;479;83
0416;4;2609;2;4;544;0;345;247;98
0416;4;2614;2;4;910;0;537;381;156
0416;5;2601;2;5;720;0;298;255;43
0416;5;2610;2;5;481;0;250;196;54
0416;5;2617;2;5;1640;0;795;724;71
0416;6;2624;2;6;1675;2;869;789;80
0416;7;2604;2;7;1475;1;692;618;74
0416;8;2587;2;8;1130;0;550;505;45
0416;9;2618;2;9;1082;0;452;392;60
0417;1;2625;3;1;608;0;222;180;42
0417;1;2628;3;1;1201;1;682;569;113
0417;1;2632;3;1;1587;7;915;712;203
0417;1;2642;3;1;769;0;379;278;101
0417;1;2645;3;1;1986;5;1030;878;152
0417;2;2626;3;2;1350;0;653;549;104
0417;2;2631;3;2;770;0;338;295;43
0417;2;2634;3;2;1277;1;724;511;213
0417;2;2637;3;2;2288;4;1317;1174;143
0417;2;2640;3;2;1742;0;795;666;129
0417;3;2627;3;3;1894;0;936;716;220
0417;3;2630;3;3;1087;1;633;439;194
0417;3;2638;3;3;1658;1;829;681;148
0417;3;2644;3;3;644;1;303;243;60
0417;4;2635;3;4;1017;0;515;439;76
0417;4;2639;3;4;2185;4;1073;907;166
0417;5;2629;3;5;1041;0;502;374;128
0417;5;2633;3;5;1447;1;662;578;84
0417;6;2636;3;6;449;0;190;148;42
0417;6;2646;3;6;1514;1;740;612;128
0417;7;2643;3;7;1362;1;758;646;112
0417;8;2641;3;8;23;0;8;8;0
0418;10;2708;6;10;26;0;26;18;8
0418;1;2648;6;1;970;0;436;311;125
0418;1;2650;6;1;2368;1;1205;1053;152
0418;1;2658;6;1;1243;0;773;631;142
0418;1;2661;6;1;2200;2;1114;880;234
0418;1;2673;6;1;1606;0;930;776;154
0418;1;2675;6;1;1927;1;970;648;322
0418;1;2676;6;1;1430;1;738;574;164
0418;1;2682;6;1;1633;2;999;828;171
0418;1;2693;6;1;1338;1;877;654;223
0418;1;2694;6;1;272;0;169;131;38
0418;1;2704;6;1;1292;1;831;666;165
0418;1;2705;6;1;1325;10;786;587;199
0418;1;2715;6;1;1166;1;764;592;172
0418;2;2649;6;2;1668;0;812;624;188
0418;2;2656;6;2;905;0;540;380;160
0418;2;2662;6;2;1487;0;751;624;127
0418;2;2664;6;2;1625;4;977;764;213
0418;2;2668;6;2;1651;0;957;827;130
0418;2;2672;6;2;1260;1;642;500;142
0418;2;2688;6;2;1533;5;1027;787;240
0418;2;2695;6;2;1021;0;422;327;95
0418;2;2697;6;2;1237;4;612;612;0
0418;2;2710;6;2;1884;0;990;772;218
0418;2;2717;6;2;731;0;393;303;90
0418;2;2718;6;2;759;0;414;313;101
0418;2;2719;6;2;475;0;272;227;45
0418;3;2655;6;3;818;0;436;374;62
0418;3;2667;6;3;53;0;40;38;2
0418;3;2679;6;3;796;0;437;322;115
0418;3;2680;6;3;606;0;320;241;79
0418;3;2683;6;3;1179;14;593;428;165
0418;3;2692;6;3;442;2;262;210;52
0418;3;2698;6;3;1649;2;822;657;165
0418;3;2700;6;3;828;0;346;255;91
0418;3;2703;6;3;428;0;238;173;65
0418;3;2711;6;3;755;8;480;321;159
0418;3;2713;6;3;678;0;441;314;127
0418;3;2714;6;3;401;0;204;170;34
0418;3;2720;6;3;1368;0;679;545;134
0418;4;2651;6;4;447;0;190;119;71
0418;4;2660;6;4;2076;0;1032;789;243
0418;4;2666;6;4;598;0;335;252;83
0418;4;2669;6;4;193;0;140;108;32
0418;4;2678;6;4;528;0;303;238;65
0418;4;2690;6;4;1453;4;555;489;66
0418;4;2691;6;4;439;0;277;198;79
0418;4;2696;6;4;1143;0;593;450;143
0418;4;2699;6;4;813;0;489;374;115
0418;4;2701;6;4;626;0;258;210;48
0418;4;2702;6;4;357;0;174;134;40
0418;4;2712;6;4;33;0;31;29;2
0418;5;2647;6;5;273;0;137;112;25
0418;5;2653;6;5;939;2;520;401;119
0418;5;2654;6;5;1326;0;712;547;165
0418;5;2677;6;5;420;0;210;133;77
0418;5;2689;6;5;1104;0;443;359;84
0418;5;2706;6;5;1487;2;836;684;152
0418;5;2709;6;5;424;0;240;181;59
0418;6;2657;6;6;1651;4;822;661;161
0418;6;2659;6;6;565;0;329;243;86
0418;6;2663;6;6;397;0;212;165;47
0418;6;2670;6;6;459;0;159;125;34
0418;6;2671;6;6;829;10;496;397;99
0418;6;2687;6;6;662;0;282;213;69
0418;6;2716;6;6;820;0;355;322;33
0418;7;2665;6;7;855;1;531;384;147
0418;7;2674;6;7;801;2;329;241;88
0418;7;2681;6;7;780;3;388;331;57
0418;7;2686;6;7;634;2;291;246;45
0418;8;2652;6;8;523;0;216;189;27
0418;8;2684;6;8;48;0;32;32;0
0418;8;2685;6;8;442;1;271;185;86
0418;9;2707;6;9;818;0;411;303;108
0419;10;2759;5;10;857;4;450;361;89
0419;10;2776;5;10;56;0;54;46;8
0419;11;2775;5;11;939;0;505;430;75
0419;12;2770;5;12;1072;0;557;433;124
0419;1;2721;5;1;1675;0;924;815;109
0419;1;2729;5;1;1039;0;513;418;95
0419;1;2737;5;1;1732;0;869;653;216
0419;1;2742;5;1;1059;0;458;405;53
0419;1;2757;5;1;1459;0;776;644;132
0419;1;2774;5;1;1912;0;1167;917;250
0419;13;2730;5;13;888;0;448;413;35
0419;14;2747;5;14;1187;1;650;585;65
0419;15;2733;5;15;911;0;442;344;98
0419;16;2734;5;16;1012;0;558;475;83
0419;17;2746;5;17;712;0;358;310;48
0419;18;2756;5;18;1030;0;507;452;55
0419;19;2762;5;19;69;0;49;47;2
0419;20;2771;5;20;15;0;6;6;0
0419;2;2723;5;2;1032;0;515;440;75
0419;2;2739;5;2;1951;0;990;730;260
0419;2;2741;5;2;613;0;292;235;57
0419;2;2743;5;2;404;0;181;139;42
0419;2;2753;5;2;2081;1;945;821;124
0419;2;2777;5;2;915;0;448;385;63
0419;3;2726;5;3;743;2;350;258;92
0419;3;2728;5;3;1024;0;427;342;85
0419;3;2745;5;3;1487;1;703;600;103
0419;3;2749;5;3;761;0;409;319;90
0419;3;2750;5;3;1875;1;845;746;99
0419;3;2764;5;3;1050;0;522;441;81
0419;4;2736;5;4;1856;0;795;698;97
0419;4;2751;5;4;1006;0;548;386;162
0419;4;2763;5;4;880;2;486;440;46
0419;4;2765;5;4;405;1;155;137;18
0419;4;2767;5;4;476;0;276;224;52
0419;4;2769;5;4;1105;0;573;458;115
0419;5;2722;5;5;1512;0;805;737;68
0419;5;2740;5;5;501;0;287;223;64
0419;5;2748;5;5;1050;0;556;400;156
0419;5;2752;5;5;777;0;387;292;95
0419;5;2768;5;5;1185;0;484;416;68
0419;6;2732;5;6;1106;0;625;569;56
0419;6;2755;5;6;1039;0;347;272;75
0419;6;2761;5;6;572;1;322;263;59
0419;6;2766;5;6;867;0;321;276;45
0419;6;2772;5;6;640;0;257;202;55
0419;7;2725;5;7;1386;1;781;684;97
0419;7;2731;5;7;428;0;228;196;32
0419;7;2744;5;7;1675;0;831;726;105
0419;7;2758;5;7;547;0;256;188;68
0419;8;2724;5;8;1551;0;797;737;60
0419;8;2738;5;8;413;0;199;165;34
0419;8;2760;5;8;1031;0;320;280;40
0419;8;2773;5;8;506;0;210;171;39
0419;9;2727;5;9;45;0;16;14;2
0419;9;2735;5;9;901;0;478;400;78
0419;9;2754;5;9;1404;0;635;519;116
0461;100;2783;1;100;1640;0;452;412;40
0461;101;2836;1;101;1196;0;296;280;16
0461;102;2875;1;102;1194;1;510;487;23
0461;10;2805;1;10;2077;1;814;785;29
0461;103;2825;1;103;2009;0;785;750;35
0461;104;2901;1;104;1263;0;500;475;25
0461;105;2827;1;105;1870;0;811;770;41
0461;106;2932;1;106;1712;0;676;632;44
0461;107;2859;1;107;1957;0;822;822;0
0461;108;2821;1;108;2232;0;989;927;62
0461;109;2863;1;109;2226;0;995;952;43
0461;110;2922;1;110;1490;0;458;431;27
0461;111;2785;1;111;1343;0;520;493;27
0461;112;2972;1;112;1253;0;495;479;16
0461;11;2899;1;11;891;0;354;342;12
0461;113;2789;1;113;1920;0;784;744;40
0461;114;2950;1;114;1604;0;485;460;25
0461;115;2870;1;115;1784;0;536;522;14
0461;116;2813;1;116;1022;0;404;392;12
0461;117;2796;1;117;1176;0;495;468;27
0461;118;2968;1;118;1650;0;719;694;25
0461;119;2844;1;119;1721;0;681;640;41
0461;120;2977;1;120;1882;0;765;736;29
0461;121;2896;1;121;1613;0;707;668;39
0461;122;2808;1;122;2222;2;918;869;49
0461;12;2822;1;12;1913;0;762;713;49
0461;123;2850;1;123;1205;0;529;494;35
0461;124;2815;1;124;1245;0;576;542;34
0461;125;2856;1;125;1038;0;342;323;19
0461;126;2912;1;126;1421;0;610;588;22
0461;127;2916;1;127;1379;0;522;493;29
0461;128;2846;1;128;2052;0;931;874;57
0461;1;2884;1;1;2192;0;1062;1026;36
0461;129;2947;1;129;1218;0;590;560;30
0461;130;2838;1;130;1817;0;921;876;45
0461;131;2881;1;131;1204;0;547;527;20
0461;132;2858;1;132;1970;1;836;810;26
0461;13;2954;1;13;1900;0;813;780;33
0461;133;2959;1;133;2006;0;816;778;38
0461;134;2939;1;134;1685;1;792;748;44
0461;135;2891;1;135;1785;0;734;706;28
0461;136;2833;1;136;1472;0;629;593;36
0461;137;2780;1;137;1302;0;338;323;15
0461;138;2949;1;138;1673;0;643;620;23
0461;139;2930;1;139;1824;1;846;805;41
0461;140;2900;1;140;1909;0;857;810;47
0461;141;2820;1;141;1491;0;663;637;26
0461;142;2810;1;142;1532;0;656;624;32
0461;14;2834;1;14;1403;0;651;624;27
0461;143;2811;1;143;1549;0;686;651;35
0461;144;2924;1;144;1717;0;741;688;53
0461;145;2926;1;145;1441;0;616;583;33
0461;146;2854;1;146;2020;0;879;841;38
0461;147;2890;1;147;1910;0;817;791;26
0461;148;2857;1;148;1932;0;835;771;64
0461;149;2940;1;149;1819;0;770;709;61
0461;150;2964;1;150;1910;0;736;688;48
0461;151;2864;1;151;1812;0;727;688;39
0461;152;2849;1;152;1301;1;555;513;42
0461;15;2914;1;15;2236;0;970;927;43
0461;153;2915;1;153;1786;0;778;752;26
0461;154;2975;1;154;1458;0;554;520;34
0461;155;2927;1;155;1671;0;542;499;43
0461;156;2909;1;156;1537;0;464;447;17
0461;157;2970;1;157;1674;0;629;597;32
0461;158;2843;1;158;1883;0;809;769;40
0461;159;2816;1;159;1685;0;676;649;27
0461;160;2787;1;160;1758;0;840;802;38
0461;161;2978;1;161;1098;0;307;286;21
0461;162;2848;1;162;1871;0;727;693;34
0461;16;2889;1;16;1875;0;953;912;41
0461;163;2893;1;163;1569;0;676;638;38
0461;164;2894;1;164;1291;0;550;528;22
0461;165;2903;1;165;1611;0;660;617;43
0461;166;2938;1;166;1305;0;486;462;24
0461;167;2847;1;167;1025;0;249;224;25
0461;168;2943;1;168;1635;0;445;384;61
0461;169;2807;1;169;648;0;153;142;11
0461;170;2873;1;170;1766;0;457;444;13
0461;171;2801;1;171;1774;0;432;402;30
0461;172;2897;1;172;1292;0;331;318;13
0461;17;2862;1;17;1602;0;623;591;32
0461;173;2779;1;173;1421;0;339;323;16
0461;174;2867;1;174;1387;0;345;318;27
0461;175;2946;1;175;890;0;177;168;9
0461;176;2831;1;176;1620;0;395;368;27
0461;177;2802;1;177;1283;0;371;351;20
0461;178;2920;1;178;1225;0;347;328;19
0461;179;2869;1;179;1449;0;399;368;31
0461;180;2918;1;180;1616;0;397;371;26
0461;181;2910;1;181;722;0;208;204;4
0461;182;2782;1;182;1362;0;536;519;17
0461;18;2841;1;18;1860;2;865;828;37
0461;183;2794;1;183;1843;0;693;652;41
0461;184;2906;1;184;1595;0;579;559;20
0461;185;2876;1;185;1290;0;421;397;24
0461;186;2935;1;186;1223;2;423;401;22
0461;187;2955;1;187;633;0;216;202;14
0461;188;2892;1;188;1695;1;566;541;25
0461;189;2818;1;189;1168;0;366;346;20
0461;190;2931;1;190;150;0;57;47;10
0461;191;2886;1;191;57;0;31;31;0
0461;192;2829;1;192;48;0;11;10;1
0461;19;2979;1;19;1340;0;652;626;26
0461;193;2928;1;193;245;0;39;36;3
0461;194;2877;1;194;45;0;8;8;0
0461;195;2904;1;195;92;0;44;41;3
0461;196;2824;1;196;40;0;15;14;1
0461;197;2809;1;197;41;0;21;18;3
0461;198;2951;1;198;22;0;7;7;0
0461;199;2830;1;199;166;0;19;19;0
0461;200;2865;1;200;28;0;16;15;1
0461;201;2799;1;201;135;0;62;49;13
0461;202;2866;1;202;143;0;49;38;11
0461;20;2965;1;20;1838;0;726;692;34
0461;21;2933;1;21;845;0;374;360;14
0461;22;2973;1;22;1577;1;768;742;26
0461;2;2819;1;2;1056;0;491;468;23
0461;23;2806;1;23;1616;0;618;592;26
0461;24;2948;1;24;2079;0;918;863;55
0461;25;2851;1;25;1133;0;592;569;23
0461;26;2797;1;26;1555;1;764;742;22
0461;27;2842;1;27;1096;0;497;475;22
0461;28;2887;1;28;1773;0;598;581;17
0461;29;2792;1;29;1605;0;642;615;27
0461;30;2878;1;30;836;0;410;394;16
0461;31;2793;1;31;1329;0;626;604;22
0461;32;2791;1;32;1206;0;541;518;23
0461;3;2840;1;3;1957;0;893;853;40
0461;33;2826;1;33;1061;1;440;422;18
0461;34;2790;1;34;2023;0;845;815;30
0461;35;2788;1;35;1448;0;640;613;27
0461;36;2937;1;36;1900;1;987;954;33
0461;37;2925;1;37;1047;0;497;485;12
0461;38;2961;1;38;1683;2;692;651;41
0461;39;2882;1;39;1089;1;556;538;18
0461;40;2804;1;40;1318;0;664;638;26
0461;41;2784;1;41;1787;0;885;853;32
0461;42;2786;1;42;1262;0;599;569;30
0461;4;2812;1;4;1229;0;441;422;19
0461;43;2967;1;43;1313;0;567;550;17
0461;44;2800;1;44;1576;0;683;651;32
0461;45;2879;1;45;2067;0;813;789;24
0461;46;2898;1;46;1733;0;808;790;18
0461;47;2814;1;47;1511;0;647;615;32
0461;48;2852;1;48;1686;0;760;735;25
0461;49;2969;1;49;740;0;233;225;8
0461;50;2839;1;50;1197;0;354;328;26
0461;51;2958;1;51;899;0;265;253;12
0461;52;2953;1;52;1206;0;440;421;19
0461;5;2919;1;5;1146;0;313;295;18
0461;53;2781;1;53;1625;0;687;659;28
0461;54;2871;1;54;872;0;394;376;18
0461;55;2944;1;55;1235;0;478;446;32
0461;56;2941;1;56;1525;0;585;552;33
0461;57;2861;1;57;1374;0;632;591;41
0461;58;2803;1;58;1164;0;472;447;25
0461;59;2883;1;59;1086;0;481;464;17
0461;60;2880;1;60;1129;0;466;447;19
0461;61;2921;1;61;2231;0;883;843;40
0461;62;2817;1;62;1484;1;444;434;10
0461;6;2929;1;6;1720;0;536;513;23
0461;63;2855;1;63;1359;0;492;457;35
0461;64;2962;1;64;1576;0;606;573;33
0461;65;2963;1;65;1507;0;566;537;29
0461;66;2971;1;66;1164;0;440;413;27
0461;67;2895;1;67;1719;0;695;663;32
0461;68;2795;1;68;1390;0;558;538;20
0461;69;2905;1;69;1525;0;597;564;33
0461;70;2837;1;70;948;0;318;297;21
0461;71;2860;1;71;1842;0;606;561;45
0461;72;2911;1;72;1914;0;666;614;52
0461;7;2778;1;7;1607;0;356;338;18
0461;73;2835;1;73;1579;0;578;544;34
0461;74;2936;1;74;1746;0;627;591;36
0461;75;2945;1;75;1999;0;720;688;32
0461;76;2823;1;76;1204;0;423;397;26
0461;77;2957;1;77;1047;0;392;371;21
0461;78;2942;1;78;1079;0;370;359;11
0461;79;2952;1;79;1068;0;448;433;15
0461;80;2872;1;80;1254;0;454;427;27
0461;81;2845;1;81;1822;0;717;673;44
0461;82;2832;1;82;1884;0;699;650;49
0461;8;2888;1;8;2063;0;692;644;48
0461;83;2868;1;83;1627;0;635;613;22
0461;84;2966;1;84;1308;0;478;457;21
0461;85;2885;1;85;1126;0;381;362;19
0461;86;2960;1;86;1192;0;450;437;13
0461;87;2956;1;87;1994;0;666;612;54
0461;88;2976;1;88;2301;1;659;659;0
0461;89;2828;1;89;1151;0;341;328;13
0461;90;2874;1;90;845;0;196;180;16
0461;91;2902;1;91;1877;0;859;813;46
0461;92;2923;1;92;1306;0;507;488;19
0461;9;2907;1;9;1156;0;255;244;11
0461;93;2913;1;93;882;0;434;416;18
0461;94;2917;1;94;1069;0;450;422;28
0461;95;2798;1;95;1648;1;563;549;14
0461;96;2974;1;96;1916;0;866;830;36
0461;97;2934;1;97;1963;0;781;746;35
0461;98;2853;1;98;1412;1;574;544;30
0461;99;2908;1;99;1544;0;594;560;34
0462;10;2998;3;10;2124;0;707;639;68
0462;11;3022;3;11;1487;0;468;435;33
0462;12;2984;3;12;641;0;238;220;18
0462;1;2981;3;1;1009;0;394;370;24
0462;13;3024;3;13;854;0;327;308;19
0462;14;2988;3;14;1997;1;810;767;43
0462;15;2980;3;15;740;0;302;286;16
0462;16;3002;3;16;911;0;432;412;20
0462;17;3021;3;17;2144;0;939;885;54
0462;18;3012;3;18;2015;0;671;610;61
0462;19;3020;3;19;1639;0;506;460;46
0462;20;3007;3;20;1171;1;376;355;21
0462;21;2983;3;21;942;0;320;296;24
0462;22;3004;3;22;797;0;230;201;29
0462;2;3000;3;2;1789;0;791;744;47
0462;23;3029;3;23;1087;1;310;264;46
0462;24;3003;3;24;1335;0;410;376;34
0462;25;2982;3;25;1629;1;756;708;48
0462;26;2991;3;26;1837;0;740;679;61
0462;27;3008;3;27;1478;0;524;471;53
0462;28;3013;3;28;1559;0;662;620;42
0462;29;3006;3;29;1558;0;717;674;43
0462;30;2995;3;30;2161;0;954;876;78
0462;31;2989;3;31;2104;1;850;798;52
0462;32;3015;3;32;2078;0;915;875;40
0462;3;3023;3;3;2048;0;821;769;52
0462;33;2999;3;33;1706;0;842;786;56
0462;34;3016;3;34;2099;0;887;849;38
0462;35;3027;3;35;2253;0;1000;935;65
0462;36;2997;3;36;825;0;234;218;16
0462;37;2994;3;37;1139;0;423;397;26
0462;38;3031;3;38;2073;0;868;826;42
0462;39;3001;3;39;1918;0;970;909;61
0462;40;3019;3;40;1387;0;654;617;37
0462;41;3014;3;41;1713;0;817;777;40
0462;42;2996;3;42;1904;0;836;788;48
0462;4;2990;3;4;1127;0;398;318;80
0462;43;3017;3;43;2192;1;1035;970;65
0462;44;2986;3;44;2184;1;963;878;85
0462;45;2993;3;45;1835;0;906;851;55
0462;46;3028;3;46;1687;0;779;728;51
0462;47;2985;3;47;1996;0;891;846;45
0462;48;3010;3;48;1558;0;595;551;44
0462;49;3033;3;49;2201;0;971;700;271
0462;50;2987;3;50;128;0;73;59;14
0462;51;3032;3;51;98;0;46;35;11
0462;52;3009;3;52;150;0;70;66;4
0462;5;3011;3;5;1123;0;451;410;41
0462;53;3030;3;53;30;0;19;12;7
0462;54;3005;3;54;72;0;30;29;1
0462;6;2992;3;6;1600;0;608;571;37
0462;7;3026;3;7;1107;0;396;370;26
0462;8;3018;3;8;1274;1;540;504;36
0462;9;3025;3;9;1892;0;713;669;44
0463;100;3104;4;100;1243;0;513;495;18
0463;101;3107;4;101;1413;0;541;522;19
0463;102;3073;4;102;797;0;349;340;9
0463;10;3066;4;10;1836;1;792;771;21
0463;103;3069;4;103;1527;0;617;598;19
0463;104;3053;4;104;1371;0;449;423;26
0463;105;3121;4;105;1407;0;544;528;16
0463;106;3077;4;106;2016;0;764;729;35
0463;107;3067;4;107;1478;0;385;372;13
0463;108;3080;4;108;1393;2;508;490;18
0463;109;3112;4;109;1383;0;498;484;14
0463;110;3148;4;110;1264;0;343;323;20
0463;111;3119;4;111;1646;1;473;442;31
0463;112;3090;4;112;2202;0;900;840;60
0463;11;3139;4;11;1749;0;851;816;35
0463;113;3102;4;113;11;0;11;9;2
0463;114;3150;4;114;15;0;15;13;2
0463;115;3038;4;115;25;0;6;3;3
0463;116;3106;4;116;60;0;50;38;12
0463;117;3070;4;117;155;0;52;48;4
0463;118;3109;4;118;108;0;61;54;7
0463;119;3088;4;119;93;0;53;50;3
0463;120;3049;4;120;18;0;3;2;1
0463;121;3141;4;121;38;0;18;15;3
0463;122;3098;4;122;19;0;19;12;7
0463;12;3093;4;12;1852;1;693;660;33
0463;1;3140;4;1;1563;0;601;567;34
0463;13;3115;4;13;1161;0;501;474;27
0463;14;3147;4;14;1159;0;401;377;24
0463;15;3100;4;15;1607;0;742;719;23
0463;16;3151;4;16;2172;0;958;915;43
0463;17;3111;4;17;1940;0;767;742;25
0463;18;3099;4;18;1821;0;843;806;37
0463;19;3126;4;19;1891;0;716;685;31
0463;20;3036;4;20;1120;0;418;387;31
0463;21;3061;4;21;1491;0;644;617;27
0463;22;3089;4;22;1412;0;582;542;40
0463;2;3094;4;2;2187;0;742;742;0
0463;23;3153;4;23;1232;0;505;489;16
0463;24;3152;4;24;1346;0;478;447;31
0463;25;3101;4;25;1206;0;474;441;33
0463;26;3078;4;26;1336;0;525;499;26
0463;27;3110;4;27;1771;0;612;581;31
0463;28;3052;4;28;1932;1;791;748;43
0463;29;3095;4;29;956;0;330;319;11
0463;30;3042;4;30;1763;0;744;710;34
0463;31;3045;4;31;1347;0;600;573;27
0463;32;3133;4;32;897;0;406;378;28
0463;3;3127;4;3;795;0;270;257;13
0463;33;3134;4;33;1877;0;703;666;37
0463;34;3114;4;34;928;0;354;342;12
0463;35;3039;4;35;1841;0;680;667;13
0463;36;3142;4;36;1143;0;385;373;12
0463;37;3044;4;37;973;0;379;365;14
0463;38;3144;4;38;1278;0;527;507;20
0463;39;3128;4;39;1141;0;443;429;14
0463;40;3105;4;40;1162;0;484;474;10
0463;41;3103;4;41;1548;1;472;455;17
0463;42;3060;4;42;1625;0;801;776;25
0463;4;3065;4;4;1811;0;657;632;25
0463;43;3130;4;43;1160;1;585;562;23
0463;44;3135;4;44;993;1;481;459;22
0463;45;3058;4;45;1035;0;574;557;17
0463;46;3057;4;46;1930;1;917;886;31
0463;47;3047;4;47;585;0;354;348;6
0463;48;3071;4;48;2223;3;926;899;27
0463;49;3086;4;49;1410;0;557;550;7
0463;50;3113;4;50;593;0;170;157;13
0463;51;3108;4;51;935;0;299;279;20
0463;52;3096;4;52;574;0;186;168;18
0463;5;3048;4;5;1187;0;438;413;25
0463;53;3118;4;53;808;0;268;248;20
0463;54;3079;4;54;766;0;160;160;0
0463;55;3120;4;55;965;0;256;235;21
0463;56;3037;4;56;755;0;224;211;13
0463;57;3074;4;57;436;0;125;120;5
0463;58;3040;4;58;451;2;220;213;7
0463;59;3149;4;59;1686;0;741;725;16
0463;60;3076;4;60;1750;0;720;686;34
0463;61;3129;4;61;1658;0;801;768;33
0463;62;3146;4;62;1045;0;431;420;11
0463;6;3124;4;6;1472;1;551;516;35
0463;63;3087;4;63;1266;0;554;534;20
0463;64;3136;4;64;1703;0;710;677;33
0463;65;3051;4;65;1800;0;741;719;22
0463;66;3155;4;66;1462;0;613;588;25
0463;67;3062;4;67;1777;0;747;731;16
0463;68;3143;4;68;2207;0;906;880;26
0463;69;3138;4;69;1870;0;883;862;21
0463;70;3145;4;70;1746;0;811;781;30
0463;71;3083;4;71;2349;0;1051;1006;45
0463;72;3043;4;72;2327;0;952;892;60
0463;7;3064;4;7;2188;0;999;950;49
0463;73;3137;4;73;2051;0;848;822;26
0463;74;3055;4;74;1967;0;863;841;22
0463;75;3085;4;75;2331;0;1031;989;42
0463;76;3050;4;76;1447;0;496;459;37
0463;77;3054;4;77;750;0;127;114;13
0463;78;3041;4;78;708;0;207;192;15
0463;79;3117;4;79;458;0;113;106;7
0463;80;3072;4;80;1658;0;744;721;23
0463;81;3125;4;81;1023;0;494;478;16
0463;82;3056;4;82;1788;0;790;749;41
0463;8;3116;4;8;2380;0;986;933;53
0463;83;3068;4;83;906;0;240;227;13
0463;84;3154;4;84;1156;0;536;509;27
0463;85;3035;4;85;1559;0;734;703;31
0463;86;3092;4;86;1491;0;638;614;24
0463;87;3081;4;87;1092;0;468;453;15
0463;88;3034;4;88;894;1;422;404;18
0463;89;3063;4;89;1681;0;609;588;21
0463;90;3091;4;90;1597;0;497;497;0
0463;91;3132;4;91;1435;0;629;606;23
0463;92;3123;4;92;1451;0;522;489;33
0463;9;3046;4;9;585;0;194;182;12
0463;93;3084;4;93;457;0;101;84;17
0463;94;3131;4;94;1483;0;686;674;12
0463;95;3075;4;95;1699;0;688;656;32
0463;96;3082;4;96;1436;0;558;531;27
0463;97;3059;4;97;1875;1;716;694;22
0463;98;3097;4;98;861;0;308;308;0
0463;99;3122;4;99;1696;0;665;634;31
0464;10;3185;6;10;1978;0;834;763;71
0464;11;3194;6;11;1959;0;859;808;51
0464;12;3210;6;12;1152;0;424;360;64
0464;1;3212;6;1;1372;0;595;517;78
0464;13;3170;6;13;1387;0;529;504;25
0464;14;3176;6;14;1549;0;523;464;59
0464;15;3161;6;15;1481;0;556;482;74
0464;16;3204;6;16;1805;0;670;606;64
0464;17;3186;6;17;1243;0;541;541;0
0464;18;3213;6;18;1548;1;601;536;65
0464;19;3184;6;19;1564;0;606;556;50
0464;20;3211;6;20;2198;0;909;852;57
0464;21;3198;6;21;2068;0;932;870;62
0464;22;3157;6;22;1858;0;757;678;79
0464;2;3164;6;2;1054;1;356;291;65
0464;23;3172;6;23;2005;1;854;748;106
0464;24;3214;6;24;1617;0;678;618;60
0464;25;3201;6;25;1866;0;760;692;68
0464;26;3167;6;26;1946;0;760;683;77
0464;27;3180;6;27;1274;0;559;513;46
0464;28;3171;6;28;1606;0;637;564;73
0464;29;3158;6;29;1192;0;491;435;56
0464;30;3206;6;30;2197;0;892;759;133
0464;31;3195;6;31;2226;0;893;817;76
0464;32;3200;6;32;1456;0;628;568;60
0464;3;3216;6;3;1461;0;536;451;85
0464;33;3159;6;33;1693;0;751;694;57
0464;34;3202;6;34;1613;1;721;668;53
0464;35;3190;6;35;1529;0;691;638;53
0464;36;3189;6;36;1653;0;704;661;43
0464;37;3199;6;37;1555;0;679;616;63
0464;38;3173;6;38;2132;0;885;816;69
0464;39;3215;6;39;2055;0;928;876;52
0464;40;3183;6;40;1187;0;355;313;42
0464;41;3193;6;41;1751;0;688;622;66
0464;42;3196;6;42;1867;0;716;659;57
0464;4;3177;6;4;1547;0;521;412;109
0464;43;3205;6;43;1228;0;582;538;44
0464;44;3181;6;44;1373;0;630;580;50
0464;45;3197;6;45;2106;0;941;906;35
0464;46;3169;6;46;1378;0;590;558;32
0464;47;3188;6;47;1431;0;640;587;53
0464;48;3207;6;48;1848;0;807;743;64
0464;49;3182;6;49;1334;0;512;479;33
0464;50;3162;6;50;1399;0;567;516;51
0464;51;3179;6;51;1578;0;569;518;51
0464;52;3160;6;52;807;0;183;160;23
0464;5;3187;6;5;2166;2;850;765;85
0464;53;3192;6;53;1952;0;804;748;56
0464;54;3203;6;54;2024;0;897;824;73
0464;55;3178;6;55;2186;0;954;896;58
0464;56;3163;6;56;1453;0;693;655;38
0464;57;3168;6;57;1357;0;503;453;50
0464;58;3175;6;58;57;0;33;23;10
0464;59;3166;6;59;65;0;33;29;4
0464;60;3165;6;60;108;0;42;42;0
0464;61;3156;6;61;161;0;39;29;10
0464;6;3174;6;6;1601;0;610;550;60
0464;7;3208;6;7;1578;0;553;490;63
0464;8;3209;6;8;1751;0;617;568;49
0464;9;3191;6;9;1933;1;864;783;81
0601;10;3264;3;10;2062;0;1181;1060;121
0601;10;3299;3;10;869;0;438;398;40
0601;10;3304;3;10;995;0;514;457;57
0601;11;3265;3;11;695;0;324;310;14
0601;12;3309;3;12;629;3;462;388;74
0601;1;3220;3;1;530;1;402;348;54
0601;1;3229;3;1;1337;0;819;690;129
0601;1;3232;3;1;464;5;259;220;39
0601;1;3238;3;1;734;0;407;358;49
0601;1;3241;3;1;1731;3;991;835;156
0601;1;3246;3;1;1488;2;949;847;102
0601;1;3251;3;1;563;1;308;249;59
0601;1;3253;3;1;1804;0;918;805;113
0601;1;3260;3;1;1763;9;1089;953;136
0601;1;3270;3;1;579;0;350;308;42
0601;1;3282;3;1;1676;1;959;858;101
0601;1;3283;3;1;1828;3;1163;1008;155
0601;1;3284;3;1;825;0;503;441;62
0601;1;3285;3;1;480;0;223;179;44
0601;1;3289;3;1;545;1;335;279;56
0601;1;3294;3;1;528;0;260;231;29
0601;13;3219;3;13;306;1;191;172;19
0601;1;3322;3;1;1631;0;950;810;140
0601;1;3323;3;1;432;2;229;206;23
0601;1;3324;3;1;2226;4;1338;1139;199
0601;14;3279;3;14;131;0;56;51;5
0601;15;3250;3;15;243;3;192;168;24
0601;2;3223;3;2;789;0;429;355;74
0601;2;3227;3;2;297;0;176;155;21
0601;2;3230;3;2;771;0;396;328;68
0601;2;3234;3;2;773;0;409;358;51
0601;2;3236;3;2;428;0;256;202;54
0601;2;3242;3;2;1503;1;787;696;91
0601;2;3257;3;2;443;0;230;208;22
0601;2;3261;3;2;655;0;328;282;46
0601;2;3262;3;2;395;0;167;138;29
0601;2;3271;3;2;1641;0;866;761;105
0601;2;3276;3;2;467;0;314;260;54
0601;2;3278;3;2;697;0;322;291;31
0601;2;3281;3;2;1084;2;752;644;108
0601;2;3296;3;2;636;1;311;253;58
0601;2;3301;3;2;578;0;226;187;39
0601;2;3303;3;2;747;0;404;363;41
0601;2;3312;3;2;691;0;416;359;57
0601;2;3317;3;2;331;0;178;148;30
0601;2;3320;3;2;505;1;226;206;20
0601;3;3221;3;3;310;0;171;149;22
0601;3;3233;3;3;353;0;207;189;18
0601;3;3239;3;3;884;0;528;468;60
0601;3;3240;3;3;815;0;419;342;77
0601;3;3245;3;3;744;0;389;323;66
0601;3;3254;3;3;395;0;197;168;29
0601;3;3256;3;3;1460;1;761;680;81
0601;3;3258;3;3;642;0;408;349;59
0601;3;3259;3;3;687;14;407;365;42
0601;3;3266;3;3;941;0;541;505;36
0601;3;3268;3;3;522;0;248;211;37
0601;3;3288;3;3;659;0;315;266;49
0601;3;3290;3;3;875;0;509;465;44
0601;3;3295;3;3;701;0;374;324;50
0601;3;3302;3;3;371;0;222;193;29
0601;3;3308;3;3;200;1;116;104;12
0601;3;3310;3;3;1567;0;648;583;65
0601;3;3321;3;3;2168;3;1319;1139;180
0601;4;3218;3;4;801;0;451;397;54
0601;4;3222;3;4;1473;2;904;789;115
0601;4;3224;3;4;2136;4;1273;1078;195
0601;4;3226;3;4;838;1;499;439;60
0601;4;3243;3;4;888;0;491;433;58
0601;4;3248;3;4;417;0;172;151;21
0601;4;3263;3;4;1752;0;1074;890;184
0601;4;3274;3;4;465;0;263;229;34
0601;4;3275;3;4;592;0;335;282;53
0601;4;3292;3;4;336;0;172;135;37
0601;4;3293;3;4;45;0;31;27;4
0601;4;3300;3;4;331;6;197;155;42
0601;4;3311;3;4;554;0;328;294;34
0601;4;3314;3;4;1554;0;818;722;96
0601;5;3235;3;5;775;0;380;324;56
0601;5;3237;3;5;171;0;117;106;11
0601;5;3244;3;5;1042;0;520;489;31
0601;5;3252;3;5;222;0;100;74;26
0601;5;3277;3;5;1124;0;560;505;55
0601;5;3280;3;5;1876;0;1019;927;92
0601;5;3286;3;5;791;1;381;340;41
0601;5;3291;3;5;723;0;430;360;70
0601;5;3298;3;5;417;0;232;192;40
0601;5;3306;3;5;823;0;448;426;22
0601;5;3315;3;5;461;0;277;247;30
0601;6;3228;3;6;2121;0;1116;1016;100
0601;6;3249;3;6;671;0;331;315;16
0601;6;3267;3;6;1306;0;584;444;140
0601;6;3273;3;6;261;5;164;150;14
0601;6;3305;3;6;447;0;223;213;10
0601;6;3307;3;6;703;0;306;235;71
0601;7;3225;3;7;297;0;133;111;22
0601;7;3255;3;7;217;0;109;91;18
0601;7;3269;3;7;1299;0;597;538;59
0601;7;3272;3;7;950;0;517;458;59
0601;7;3297;3;7;673;0;383;332;51
0601;8;3231;3;8;1910;0;1087;991;96
0601;8;3247;3;8;220;0;125;109;16
0601;8;3316;3;8;620;0;334;297;37
0601;8;3319;3;8;692;2;258;226;32
0601;9;3217;3;9;1000;0;564;495;69
0601;9;3287;3;9;910;0;506;468;38
0601;9;3313;3;9;1283;0;668;626;42
0601;9;3318;3;9;384;0;205;173;32
0602;10;3351;5;10;859;0;469;442;27
0602;10;3405;5;10;248;0;140;123;17
0602;10;3414;5;10;728;0;340;316;24
0602;11;3337;5;11;363;0;203;176;27
0602;11;3401;5;11;2301;0;1161;1077;84
0602;12;3366;5;12;1409;0;676;633;43
0602;12;3400;5;12;595;0;348;278;70
0602;1;3325;5;1;454;0;181;150;31
0602;1;3326;5;1;1220;2;698;547;151
0602;13;3376;5;13;847;0;423;383;40
0602;13;3384;5;13;1887;1;938;884;54
0602;1;3341;5;1;901;0;494;431;63
0602;1;3342;5;1;1908;1;1133;975;158
0602;1;3356;5;1;1120;0;549;500;49
0602;1;3360;5;1;1205;0;652;556;96
0602;1;3361;5;1;1758;0;948;801;147
0602;1;3371;5;1;644;0;378;314;64
0602;1;3386;5;1;952;0;335;276;59
0602;1;3393;5;1;1170;1;722;667;55
0602;1;3395;5;1;795;0;427;361;66
0602;1;3402;5;1;2074;1;1080;1009;71
0602;1;3411;5;1;1129;7;617;617;0
0602;1;3417;5;1;1000;0;527;390;137
0602;14;3329;5;14;1036;0;471;430;41
0602;14;3383;5;14;59;0;26;23;3
0602;15;3352;5;15;128;0;67;56;11
0602;2;3336;5;2;720;0;467;365;102
0602;2;3340;5;2;1445;0;827;648;179
0602;2;3345;5;2;629;0;349;300;49
0602;2;3346;5;2;685;0;393;314;79
0602;2;3354;5;2;631;0;322;291;31
0602;2;3357;5;2;997;0;592;478;114
0602;2;3364;5;2;1441;0;871;775;96
0602;2;3368;5;2;1220;0;579;558;21
0602;2;3369;5;2;242;0;125;100;25
0602;2;3372;5;2;752;2;454;414;40
0602;2;3388;5;2;1736;0;909;776;133
0602;2;3391;5;2;847;0;492;450;42
0602;2;3398;5;2;2017;0;988;889;99
0602;2;3415;5;2;924;5;538;458;80
0602;3;3330;5;3;800;2;370;326;44
0602;3;3331;5;3;285;0;188;166;22
0602;3;3344;5;3;867;0;461;409;52
0602;3;3349;5;3;715;0;406;317;89
0602;3;3362;5;3;895;0;538;332;206
0602;3;3365;5;3;1360;0;747;621;126
0602;3;3370;5;3;559;0;268;230;38
0602;3;3378;5;3;640;0;247;208;39
0602;3;3379;5;3;504;0;341;304;37
0602;3;3394;5;3;1213;0;681;555;126
0602;3;3404;5;3;602;1;316;238;78
0602;3;3407;5;3;854;0;452;413;39
0602;3;3410;5;3;333;2;191;170;21
0602;3;3412;5;3;1541;0;833;781;52
0602;4;3327;5;4;589;0;354;260;94
0602;4;3334;5;4;586;0;304;276;28
0602;4;3338;5;4;884;1;436;406;30
0602;4;3348;5;4;1989;0;942;873;69
0602;4;3350;5;4;509;0;301;260;41
0602;4;3353;5;4;1302;0;674;594;80
0602;4;3375;5;4;812;0;372;325;47
0602;4;3377;5;4;1112;3;725;643;82
0602;4;3385;5;4;603;0;241;210;31
0602;4;3389;5;4;421;0;210;198;12
0602;4;3396;5;4;851;0;422;381;41
0602;4;3403;5;4;1428;2;918;748;170
0602;4;3406;5;4;582;0;357;247;110
0602;5;3339;5;5;519;0;277;224;53
0602;5;3347;5;5;830;0;437;360;77
0602;5;3358;5;5;517;0;259;241;18
0602;5;3367;5;5;1996;1;1046;980;66
0602;5;3374;5;5;1183;0;514;478;36
0602;5;3380;5;5;289;0;127;111;16
0602;5;3397;5;5;450;0;244;202;42
0602;5;3413;5;5;584;0;285;249;36
0602;6;3335;5;6;437;0;273;225;48
0602;6;3359;5;6;682;0;378;313;65
0602;6;3363;5;6;2173;0;1052;1052;0
0602;6;3373;5;6;426;0;220;188;32
0602;6;3387;5;6;12;0;2;2;0
0602;6;3399;5;6;451;0;181;153;28
0602;7;3332;5;7;1302;1;643;607;36
0602;7;3343;5;7;530;0;253;230;23
0602;7;3382;5;7;1016;0;678;615;63
0602;7;3392;5;7;470;0;214;184;30
0602;7;3409;5;7;363;1;230;199;31
0602;8;3328;5;8;294;0;140;127;13
0602;8;3333;5;8;689;0;349;316;33
0602;8;3355;5;8;1378;0;674;623;51
0602;8;3381;5;8;520;0;317;274;43
0602;9;3390;5;9;1810;0;939;875;64
0602;9;3408;5;9;811;0;410;371;39
0602;9;3416;5;9;718;0;415;377;38
0603;10;3453;4;10;558;0;326;314;12
0603;11;3481;4;11;207;0;122;115;7
0603;12;3445;4;12;411;0;240;227;13
0603;13;3485;4;13;783;0;386;350;36
0603;1;3420;4;1;265;0;149;134;15
0603;1;3425;4;1;539;0;326;267;59
0603;1;3437;4;1;1017;4;529;424;105
0603;1;3448;4;1;1407;1;699;546;153
0603;1;3454;4;1;402;0;178;150;28
0603;1;3459;4;1;941;2;490;399;91
0603;1;3463;4;1;554;9;361;284;77
0603;1;3468;4;1;246;0;113;95;18
0603;1;3474;4;1;946;0;443;361;82
0603;1;3476;4;1;500;0;231;178;53
0603;1;3490;4;1;850;0;369;325;44
0603;1;3493;4;1;872;5;379;293;86
0603;1;3496;4;1;496;0;237;206;31
0603;1;3499;4;1;425;0;203;176;27
0603;1;3507;4;1;652;0;364;296;68
0603;14;3451;4;14;491;9;231;200;31
0603;15;3492;4;15;406;2;192;185;7
0603;16;3429;4;16;364;1;171;145;26
0603;17;3455;4;17;699;0;410;341;69
0603;18;3498;4;18;642;0;249;233;16
0603;2;3418;4;2;594;2;333;259;74
0603;2;3426;4;2;1264;1;627;569;58
0603;2;3436;4;2;1296;11;899;771;128
0603;2;3438;4;2;668;1;425;324;101
0603;2;3452;4;2;1218;1;532;442;90
0603;2;3461;4;2;443;0;276;233;43
0603;2;3465;4;2;568;0;275;229;46
0603;2;3469;4;2;1459;0;815;687;128
0603;2;3473;4;2;715;1;401;348;53
0603;2;3478;4;2;1775;0;1080;953;127
0603;2;3486;4;2;345;0;193;161;32
0603;2;3494;4;2;585;0;360;267;93
0603;2;3497;4;2;1995;2;998;877;121
0603;2;3502;4;2;1081;0;502;434;68
0603;2;3505;4;2;1248;4;738;564;174
0603;3;3419;4;3;602;0;334;285;49
0603;3;3421;4;3;1625;6;973;822;151
0603;3;3430;4;3;1498;0;743;649;94
0603;3;3440;4;3;808;0;486;389;97
0603;3;3443;4;3;357;1;194;152;42
0603;3;3449;4;3;787;0;473;425;48
0603;3;3450;4;3;661;7;390;349;41
0603;3;3457;4;3;823;6;464;382;82
0603;3;3460;4;3;630;1;354;321;33
0603;3;3467;4;3;376;2;206;189;17
0603;3;3470;4;3;405;0;254;191;63
0603;3;3471;4;3;271;0;126;105;21
0603;3;3482;4;3;696;0;353;275;78
0603;3;3489;4;3;297;0;184;161;23
0603;3;3495;4;3;962;0;497;376;121
0603;4;3422;4;4;507;0;300;241;59
0603;4;3423;4;4;660;0;344;295;49
0603;4;3434;4;4;1750;11;1010;887;123
0603;4;3441;4;4;1833;0;1137;846;291
0603;4;3442;4;4;488;0;231;191;40
0603;4;3480;4;4;213;0;71;61;10
0603;4;3483;4;4;564;0;299;269;30
0603;4;3488;4;4;2173;0;1214;1139;75
0603;4;3500;4;4;856;0;413;298;115
0603;4;3503;4;4;1246;0;730;592;138
0603;4;3506;4;4;277;0;171;145;26
0603;5;3424;4;5;286;0;187;178;9
0603;5;3432;4;5;1035;6;562;484;78
0603;5;3435;4;5;368;0;167;140;27
0603;5;3439;4;5;401;2;235;198;37
0603;5;3447;4;5;298;0;148;128;20
0603;5;3466;4;5;422;0;227;196;31
0603;5;3472;4;5;768;1;273;259;14
0603;5;3487;4;5;420;0;258;226;32
0603;5;3491;4;5;614;0;361;259;102
0603;5;3501;4;5;391;0;181;128;53
0603;5;3504;4;5;47;0;27;23;4
0603;6;3428;4;6;616;2;338;294;44
0603;6;3444;4;6;454;0;199;146;53
0603;6;3456;4;6;1749;4;1077;952;125
0603;6;3462;4;6;466;0;246;193;53
0603;6;3477;4;6;827;0;357;297;60
0603;6;3484;4;6;757;0;457;349;108
0603;7;3427;4;7;708;0;354;303;51
0603;7;3446;4;7;472;6;290;242;48
0603;7;3458;4;7;345;4;164;124;40
0603;7;3479;4;7;292;0;156;139;17
0603;8;3431;4;8;567;1;278;238;40
0603;8;3475;4;8;409;6;282;255;27
0603;9;3433;4;9;863;1;385;360;25
0603;9;3464;4;9;261;0;122;95;27
0604;10;3525;5;10;1567;0;708;638;70
0604;10;3545;5;10;1287;0;524;481;43
0604;10;3550;5;10;452;2;224;175;49
0604;11;3514;5;11;623;0;263;236;27
0604;11;3521;5;11;1248;1;649;575;74
0604;12;3512;5;12;347;0;237;201;36
0604;12;3516;5;12;49;0;11;10;1
0604;13;3543;5;13;16;0;16;13;3
0604;1;3518;5;1;1370;4;761;640;121
0604;1;3531;5;1;1036;0;594;504;90
0604;1;3539;5;1;1347;0;724;624;100
0604;1;3542;5;1;2431;0;1255;1024;231
0604;1;3553;5;1;1324;0;639;594;45
0604;1;3554;5;1;1201;0;539;484;55
0604;1;3558;5;1;1204;7;685;607;78
0604;1;3561;5;1;1336;0;688;588;100
0604;2;3513;5;2;1335;1;553;522;31
0604;2;3515;5;2;781;0;388;336;52
0604;2;3527;5;2;707;2;394;295;99
0604;2;3547;5;2;642;0;316;316;0
0604;2;3551;5;2;412;0;227;190;37
0604;2;3555;5;2;410;0;199;153;46
0604;2;3559;5;2;533;0;198;186;12
0604;2;3569;5;2;915;2;496;431;65
0604;3;3519;5;3;476;0;272;226;46
0604;3;3522;5;3;1899;0;905;743;162
0604;3;3526;5;3;315;0;141;114;27
0604;3;3534;5;3;884;0;442;376;66
0604;3;3538;5;3;613;0;216;195;21
0604;3;3540;5;3;625;0;305;266;39
0604;3;3564;5;3;564;0;353;241;112
0604;3;3570;5;3;1262;1;506;449;57
0604;4;3517;5;4;1111;2;494;414;80
0604;4;3529;5;4;647;8;332;273;59
0604;4;3530;5;4;429;1;250;201;49
0604;4;3533;5;4;443;0;209;182;27
0604;4;3566;5;4;426;0;186;161;25
0604;4;3568;5;4;940;0;546;453;93
0604;4;3572;5;4;1113;0;523;468;55
0604;5;3510;5;5;668;0;314;299;15
0604;5;3511;5;5;486;0;264;234;30
0604;5;3523;5;5;1640;1;867;704;163
0604;5;3537;5;5;815;1;375;318;57
0604;5;3546;5;5;397;0;159;132;27
0604;5;3560;5;5;1435;687;687;632;55
0604;5;3565;5;5;1090;0;597;513;84
0604;6;3520;5;6;799;0;247;223;24
0604;6;3535;5;6;579;1;241;221;20
0604;6;3536;5;6;1743;0;735;662;73
0604;6;3541;5;6;864;0;368;305;63
0604;6;3549;5;6;1076;0;476;385;91
0604;7;3508;5;7;751;0;280;244;36
0604;7;3532;5;7;679;0;265;227;38
0604;7;3548;5;7;504;0;252;215;37
0604;7;3552;5;7;1229;0;545;483;62
0604;7;3557;5;7;450;0;207;188;19
0604;8;3528;5;8;261;0;134;108;26
0604;8;3556;5;8;610;0;238;215;23
0604;8;3563;5;8;678;0;287;258;29
0604;8;3567;5;8;479;0;261;222;39
0604;8;3571;5;8;1916;0;923;839;84
0604;9;3509;5;9;558;0;214;176;38
0604;9;3524;5;9;1360;0;682;619;63
0604;9;3544;5;9;531;0;192;163;29
0604;9;3562;5;9;1007;0;461;411;50
0605;10;3575;2;10;30;0;14;14;0
0605;1;3578;2;1;1691;3;1140;1044;96
0605;1;3588;2;1;1561;3;895;734;161
0605;1;3589;2;1;1124;7;694;627;67
0605;1;3591;2;1;429;0;268;252;16
0605;1;3593;2;1;1932;0;1119;1024;95
0605;1;3597;2;1;2509;14;1577;1395;182
0605;1;3605;2;1;773;0;442;414;28
0605;2;3580;2;2;393;1;232;204;28
0605;2;3581;2;2;1501;1;716;698;18
0605;2;3582;2;2;1355;6;838;692;146
0605;2;3592;2;2;524;1;335;285;50
0605;2;3595;2;2;1529;0;794;715;79
0605;2;3596;2;2;597;0;316;301;15
0605;2;3601;2;2;1058;1;612;548;64
0605;3;3574;2;3;717;0;332;304;28
0605;3;3576;2;3;696;0;426;379;47
0605;3;3577;2;3;806;0;409;322;87
0605;3;3587;2;3;1742;0;1085;1011;74
0605;3;3598;2;3;228;0;124;101;23
0605;3;3602;2;3;263;0;206;195;11
0605;3;3606;2;3;1029;0;589;506;83
0605;4;3583;2;4;1632;2;853;753;100
0605;4;3584;2;4;1248;0;918;827;91
0605;4;3585;2;4;465;0;253;226;27
0605;4;3594;2;4;1776;0;861;793;68
0605;4;3599;2;4;536;0;230;204;26
0605;4;3609;2;4;442;1;272;235;37
0605;5;3603;2;5;1155;0;782;695;87
0605;5;3604;2;5;1989;0;1130;1012;118
0605;5;3607;2;5;890;4;511;437;74
0605;5;3608;2;5;437;0;247;221;26
0605;6;3579;2;6;1995;0;1156;1085;71
0605;6;3600;2;6;1479;6;842;706;136
0605;7;3586;2;7;1168;0;766;703;63
0605;8;3590;2;8;397;0;208;172;36
0605;9;3573;2;9;816;0;472;411;61
0606;10;3649;4;10;262;0;110;99;11
0606;10;3674;4;10;2148;0;817;764;53
0606;10;3692;4;10;457;1;245;204;41
0606;10;3693;4;10;49;0;44;35;9
0606;11;3617;4;11;71;0;44;34;10
0606;11;3679;4;11;391;0;163;127;36
0606;11;3686;4;11;1318;0;635;592;43
0606;12;3654;4;12;694;0;266;228;38
0606;12;3669;4;12;515;0;198;165;33
0606;13;3647;4;13;817;0;371;308;63
0606;13;3681;4;13;51;0;25;21;4
0606;1;3622;4;1;521;0;231;212;19
0606;1;3631;4;1;1259;0;647;537;110
0606;1;3635;4;1;1331;0;563;510;53
0606;1;3637;4;1;695;1;321;248;73
0606;1;3652;4;1;501;2;293;244;49
0606;1;3661;4;1;1588;28;992;829;163
0606;1;3666;4;1;395;0;204;161;43
0606;1;3672;4;1;1505;4;914;749;165
0606;1;3677;4;1;1071;16;667;597;70
0606;1;3685;4;1;220;0;110;100;10
0606;14;3653;4;14;113;0;43;22;21
0606;14;3690;4;14;469;0;174;144;30
0606;15;3660;4;15;3;0;2;2;0
0606;2;3610;4;2;751;0;369;344;25
0606;2;3616;4;2;549;0;281;235;46
0606;2;3618;4;2;845;1;321;286;35
0606;2;3641;4;2;1333;0;813;676;137
0606;2;3643;4;2;545;0;306;271;35
0606;2;3645;4;2;831;2;468;400;68
0606;2;3667;4;2;658;0;336;303;33
0606;2;3682;4;2;1298;0;808;668;140
0606;2;3688;4;2;472;5;249;224;25
0606;2;3694;4;2;1300;0;543;476;67
0606;3;3620;4;3;510;0;257;225;32
0606;3;3624;4;3;483;9;310;278;32
0606;3;3627;4;3;592;4;311;268;43
0606;3;3639;4;3;778;0;496;390;106
0606;3;3644;4;3;666;0;226;200;26
0606;3;3656;4;3;820;0;318;284;34
0606;3;3663;4;3;318;0;196;154;42
0606;3;3664;4;3;72;0;44;38;6
0606;3;3675;4;3;656;0;385;327;58
0606;3;3687;4;3;549;0;304;244;60
0606;4;3612;4;4;228;0;136;108;28
0606;4;3623;4;4;585;2;318;266;52
0606;4;3632;4;4;848;0;338;298;40
0606;4;3634;4;4;173;0;128;103;25
0606;4;3642;4;4;661;1;341;259;82
0606;4;3648;4;4;676;0;297;242;55
0606;4;3678;4;4;489;2;263;229;34
0606;4;3684;4;4;354;0;143;129;14
0606;4;3689;4;4;577;0;313;273;40
0606;4;3691;4;4;288;4;172;150;22
0606;5;3614;4;5;389;4;220;186;34
0606;5;3619;4;5;904;0;454;388;66
0606;5;3626;4;5;1070;0;469;433;36
0606;5;3629;4;5;221;0;108;90;18
0606;5;3640;4;5;387;1;227;186;41
0606;5;3651;4;5;337;0;122;88;34
0606;5;3657;4;5;484;8;296;256;40
0606;5;3658;4;5;477;0;209;169;40
0606;5;3680;4;5;688;0;217;195;22
0606;6;3655;4;6;390;0;192;171;21
0606;6;3659;4;6;137;9;104;81;23
0606;6;3668;4;6;578;0;314;255;59
0606;6;3670;4;6;1328;0;602;558;44
0606;6;3673;4;6;736;12;450;367;83
0606;6;3676;4;6;508;0;266;219;47
0606;6;3695;4;6;295;0;171;142;29
0606;7;3611;4;7;815;16;549;475;74
0606;7;3621;4;7;104;0;77;62;15
0606;7;3633;4;7;756;0;408;342;66
0606;7;3636;4;7;2308;0;1110;1000;110
0606;7;3638;4;7;598;0;273;213;60
0606;7;3683;4;7;351;0;186;151;35
0606;8;3615;4;8;775;7;494;435;59
0606;8;3628;4;8;185;4;144;134;10
0606;8;3646;4;8;598;0;310;258;52
0606;8;3662;4;8;77;0;72;72;0
0606;8;3665;4;8;1883;0;832;777;55
0606;8;3671;4;8;433;0;215;190;25
0606;9;3613;4;9;1766;0;796;737;59
0606;9;3625;4;9;838;2;454;392;62
0606;9;3630;4;9;147;0;102;85;17
0606;9;3650;4;9;828;0;332;303;29
0607;10;3723;2;10;1800;0;1026;940;86
0607;10;3736;2;10;351;3;212;180;32
0607;11;3779;2;11;1104;0;639;580;59
0607;12;3715;2;12;931;6;539;484;55
0607;13;3771;2;13;1936;1;1108;1018;90
0607;1;3709;2;1;881;0;402;368;34
0607;1;3714;2;1;1630;4;954;816;138
0607;1;3717;2;1;790;1;447;400;47
0607;1;3718;2;1;991;0;553;481;72
0607;1;3724;2;1;744;0;430;374;56
0607;1;3742;2;1;1030;0;517;465;52
0607;1;3745;2;1;963;0;560;475;85
0607;1;3754;2;1;1553;3;747;646;101
0607;1;3768;2;1;2169;2;1367;1134;233
0607;1;3778;2;1;657;1;317;284;33
0607;14;3732;2;14;1712;1;947;893;54
0607;15;3767;2;15;1845;2;1051;966;85
0607;16;3774;2;16;975;0;529;477;52
0607;17;3748;2;17;1684;1;886;828;58
0607;18;3772;2;18;1025;0;590;538;52
0607;19;3769;2;19;1234;2;666;621;45
0607;20;3726;2;20;987;1;529;479;50
0607;21;3727;2;21;1117;0;558;510;48
0607;22;3710;2;22;42;0;6;6;0
0607;23;3696;2;23;15;0;1;1;0
0607;2;3697;2;2;708;0;352;321;31
0607;2;3698;2;2;1237;3;711;593;118
0607;2;3702;2;2;287;0;183;159;24
0607;2;3733;2;2;1208;1;710;625;85
0607;2;3756;2;2;785;0;413;346;67
0607;2;3763;2;2;289;1;168;142;26
0607;2;3764;2;2;1204;3;731;653;78
0607;2;3765;2;2;721;0;374;329;45
0607;2;3770;2;2;701;1;379;343;36
0607;2;3777;2;2;1084;1;665;614;51
0607;3;3699;2;3;675;1;405;346;59
0607;3;3712;2;3;1265;0;646;587;59
0607;3;3716;2;3;1124;0;527;456;71
0607;3;3720;2;3;301;0;151;130;21
0607;3;3722;2;3;1301;0;671;603;68
0607;3;3734;2;3;465;0;267;244;23
0607;3;3735;2;3;463;0;254;211;43
0607;3;3758;2;3;932;0;370;332;38
0607;3;3762;2;3;1485;6;852;736;116
0607;3;3766;2;3;648;0;382;353;29
0607;4;3700;2;4;502;0;230;191;39
0607;4;3701;2;4;1260;0;660;588;72
0607;4;3703;2;4;1006;1;502;444;58
0607;4;3711;2;4;879;0;475;425;50
0607;4;3713;2;4;2376;1;1440;1324;116
0607;4;3725;2;4;1163;0;507;463;44
0607;4;3728;2;4;960;0;447;430;17
0607;4;3743;2;4;202;0;102;101;1
0607;4;3759;2;4;786;2;485;384;101
0607;4;3776;2;4;732;1;340;303;37
0607;5;3707;2;5;1061;0;449;413;36
0607;5;3737;2;5;719;0;318;260;58
0607;5;3740;2;5;552;0;264;207;57
0607;5;3744;2;5;1204;4;702;625;77
0607;5;3751;2;5;419;0;249;215;34
0607;5;3752;2;5;652;0;324;301;23
0607;5;3757;2;5;2119;1;1259;1145;114
0607;5;3761;2;5;158;0;106;93;13
0607;5;3775;2;5;784;0;374;334;40
0607;6;3705;2;6;2013;2;1064;924;140
0607;6;3730;2;6;1122;1;559;499;60
0607;6;3738;2;6;922;4;474;433;41
0607;6;3739;2;6;390;0;218;180;38
0607;6;3741;2;6;669;1;389;333;56
0607;6;3753;2;6;710;0;404;382;22
0607;6;3760;2;6;579;0;262;220;42
0607;7;3719;2;7;2223;2;1347;1255;92
0607;7;3721;2;7;489;3;276;237;39
0607;7;3729;2;7;766;0;433;359;74
0607;7;3746;2;7;1324;2;712;661;51
0607;7;3755;2;7;664;0;292;245;47
0607;8;3704;2;8;307;0;182;166;16
0607;8;3708;2;8;1104;1;578;530;48
0607;8;3731;2;8;386;0;235;215;20
0607;8;3749;2;8;1568;1;941;873;68
0607;8;3750;2;8;1116;0;529;454;75
0607;9;3706;2;9;565;0;309;241;68
0607;9;3747;2;9;410;0;259;211;48
0607;9;3773;2;9;1210;2;739;687;52
0608;10;3791;2;10;1650;0;888;807;81
0608;10;3821;2;10;290;0;169;148;21
0608;11;3853;2;11;94;0;59;49;10
0608;11;3865;2;11;1989;0;1208;1111;97
0608;12;3799;2;12;25;0;18;14;4
0608;1;3784;2;1;1342;1;807;625;182
0608;1;3788;2;1;1585;6;950;800;150
0608;1;3789;2;1;712;0;320;233;87
0608;1;3797;2;1;2104;3;1031;925;106
0608;1;3802;2;1;812;1;462;342;120
0608;1;3804;2;1;2114;0;1149;997;152
0608;1;3813;2;1;1181;1;770;627;143
0608;1;3817;2;1;1375;0;883;700;183
0608;1;3824;2;1;1409;4;911;755;156
0608;1;3832;2;1;2104;8;1285;1153;132
0608;1;3855;2;1;957;0;606;483;123
0608;1;3858;2;1;636;0;323;263;60
0608;1;3859;2;1;486;0;274;224;50
0608;2;3782;2;2;1238;0;638;545;93
0608;2;3786;2;2;1408;4;943;731;212
0608;2;3790;2;2;2244;3;1224;1105;119
0608;2;3793;2;2;383;0;233;200;33
0608;2;3801;2;2;1521;0;975;833;142
0608;2;3811;2;2;441;0;248;223;25
0608;2;3812;2;2;1114;0;536;414;122
0608;2;3820;2;2;1322;0;725;611;114
0608;2;3825;2;2;742;1;394;346;48
0608;2;3830;2;2;307;0;210;178;32
0608;2;3836;2;2;351;0;131;92;39
0608;2;3848;2;2;1030;15;575;490;85
0608;2;3849;2;2;757;0;501;435;66
0608;3;3780;2;3;1139;0;521;487;34
0608;3;3781;2;3;734;2;438;315;123
0608;3;3787;2;3;1725;0;865;772;93
0608;3;3800;2;3;1575;5;991;739;252
0608;3;3814;2;3;535;0;282;243;39
0608;3;3818;2;3;547;0;358;271;87
0608;3;3819;2;3;858;0;538;489;49
0608;3;3833;2;3;409;0;163;147;16
0608;3;3834;2;3;956;0;404;327;77
0608;3;3841;2;3;267;0;163;128;35
0608;3;3847;2;3;713;0;371;281;90
0608;3;3850;2;3;501;0;222;174;48
0608;3;3862;2;3;807;0;361;309;52
0608;4;3792;2;4;406;0;228;191;37
0608;4;3796;2;4;243;0;136;101;35
0608;4;3803;2;4;353;0;225;192;33
0608;4;3806;2;4;746;0;392;331;61
0608;4;3823;2;4;200;1;118;90;28
0608;4;3829;2;4;1660;1;884;790;94
0608;4;3831;2;4;804;0;428;348;80
0608;4;3842;2;4;458;0;306;224;82
0608;4;3845;2;4;871;2;495;373;122
0608;4;3854;2;4;1176;5;604;450;154
0608;4;3861;2;4;729;2;360;312;48
0608;5;3785;2;5;734;0;371;316;55
0608;5;3816;2;5;758;0;457;384;73
0608;5;3837;2;5;496;0;335;257;78
0608;5;3838;2;5;419;2;222;186;36
0608;5;3839;2;5;832;0;393;305;88
0608;5;3844;2;5;269;0;173;149;24
0608;5;3846;2;5;453;0;244;196;48
0608;5;3851;2;5;1254;0;610;557;53
0608;5;3864;2;5;469;0;271;240;31
0608;6;3798;2;6;802;0;372;279;93
0608;6;3807;2;6;530;1;322;237;85
0608;6;3809;2;6;563;0;295;233;62
0608;6;3827;2;6;409;0;254;212;42
0608;6;3843;2;6;1399;4;773;718;55
0608;6;3856;2;6;345;14;215;173;42
0608;6;3857;2;6;684;0;438;331;107
0608;6;3863;2;6;480;0;285;247;38
0608;7;3795;2;7;1520;0;777;699;78
0608;7;3808;2;7;403;1;212;194;18
0608;7;3828;2;7;410;0;186;129;57
0608;7;3835;2;7;593;0;417;340;77
0608;7;3840;2;7;547;0;282;254;28
0608;7;3860;2;7;385;0;142;110;32
0608;8;3805;2;8;549;0;248;191;57
0608;8;3810;2;8;725;0;379;268;111
0608;8;3815;2;8;89;0;45;25;20
0608;8;3826;2;8;434;1;291;228;63
0608;8;3852;2;8;1555;0;768;693;75
0608;9;3783;2;9;482;0;273;237;36
0608;9;3794;2;9;1522;2;859;790;69
0608;9;3822;2;9;588;0;285;213;72
0609;10;3887;2;10;748;1;357;298;59
0609;10;3981;2;10;413;0;194;171;23
0609;11;3917;2;11;25;0;3;1;2
0609;11;3918;2;11;862;0;445;410;35
0609;12;3950;2;12;799;0;409;358;51
0609;13;3900;2;13;466;0;219;203;16
0609;1;3877;2;1;1725;3;926;800;126
0609;1;3880;2;1;1122;0;557;480;77
0609;1;3902;2;1;933;1;490;463;27
0609;1;3904;2;1;763;6;470;400;70
0609;1;3905;2;1;2336;0;1126;973;153
0609;1;3915;2;1;1875;0;981;866;115
0609;1;3916;2;1;933;2;671;619;52
0609;1;3921;2;1;1100;0;517;439;78
0609;1;3923;2;1;1366;2;678;596;82
0609;1;3930;2;1;1123;0;643;568;75
0609;1;3932;2;1;973;0;586;502;84
0609;1;3935;2;1;1492;0;869;728;141
0609;1;3940;2;1;652;0;271;207;64
0609;1;3945;2;1;1059;0;529;433;96
0609;1;3963;2;1;273;0;174;144;30
0609;1;3976;2;1;989;0;475;407;68
0609;14;3956;2;14;12;0;0;0;0
0609;2;3866;2;2;1063;0;598;541;57
0609;2;3868;2;2;1057;3;521;435;86
0609;2;3869;2;2;1425;0;633;590;43
0609;2;3891;2;2;803;0;375;340;35
0609;2;3892;2;2;865;1;586;540;46
0609;2;3894;2;2;834;0;318;272;46
0609;2;3908;2;2;1281;0;649;532;117
0609;2;3911;2;2;1683;0;900;718;182
0609;2;3944;2;2;568;3;333;258;75
0609;2;3951;2;2;871;0;371;318;53
0609;2;3958;2;2;327;0;170;137;33
0609;2;3959;2;2;1739;0;864;715;149
0609;2;3965;2;2;993;4;531;412;119
0609;2;3966;2;2;912;0;476;386;90
0609;2;3972;2;2;1507;1;712;661;51
0609;2;3977;2;2;1000;0;531;430;101
0609;3;3867;2;3;995;0;378;338;40
0609;3;3870;2;3;1283;0;551;477;74
0609;3;3871;2;3;1352;1;738;646;92
0609;3;3875;2;3;548;0;330;269;61
0609;3;3881;2;3;1373;0;756;645;111
0609;3;3924;2;3;337;0;148;131;17
0609;3;3926;2;3;1812;1;921;798;123
0609;3;3933;2;3;1912;0;878;738;140
0609;3;3938;2;3;487;1;249;205;44
0609;3;3941;2;3;1766;0;905;821;84
0609;3;3949;2;3;1514;0;851;745;106
0609;3;3957;2;3;597;0;313;273;40
0609;3;3968;2;3;1339;0;705;620;85
0609;3;3975;2;3;568;0;355;315;40
0609;3;3982;2;3;1437;0;673;572;101
0609;3;3983;2;3;1736;0;867;812;55
0609;4;3882;2;4;1698;0;995;837;158
0609;4;3883;2;4;271;0;153;129;24
0609;4;3897;2;4;1433;0;551;444;107
0609;4;3906;2;4;1215;0;683;609;74
0609;4;3910;2;4;394;0;181;164;17
0609;4;3912;2;4;1435;3;761;643;118
0609;4;3920;2;4;763;0;358;327;31
0609;4;3927;2;4;1482;0;811;692;119
0609;4;3928;2;4;473;0;208;182;26
0609;4;3937;2;4;442;0;267;243;24
0609;4;3939;2;4;804;0;346;313;33
0609;4;3948;2;4;1291;0;620;574;46
0609;4;3955;2;4;933;0;517;462;55
0609;4;3960;2;4;1088;14;712;647;65
0609;4;3980;2;4;595;1;340;298;42
0609;4;3984;2;4;1087;0;593;507;86
0609;5;3878;2;5;235;0;154;136;18
0609;5;3888;2;5;828;0;427;356;71
0609;5;3890;2;5;1096;1;571;489;82
0609;5;3896;2;5;441;0;271;255;16
0609;5;3913;2;5;1047;0;477;373;104
0609;5;3919;2;5;923;1;519;442;77
0609;5;3925;2;5;1130;3;500;419;81
0609;5;3943;2;5;1011;1;463;415;48
0609;5;3961;2;5;959;0;440;402;38
0609;5;3962;2;5;826;0;368;317;51
0609;5;3964;2;5;1478;0;844;724;120
0609;5;3967;2;5;475;0;273;218;55
0609;5;3970;2;5;1090;0;590;537;53
0609;5;3973;2;5;1163;0;505;411;94
0609;5;3974;2;5;1301;0;625;592;33
0609;6;3876;2;6;356;0;210;183;27
0609;6;3885;2;6;423;0;194;172;22
0609;6;3886;2;6;786;0;446;407;39
0609;6;3903;2;6;591;0;389;334;55
0609;6;3907;2;6;966;2;422;344;78
0609;6;3914;2;6;403;0;220;185;35
0609;6;3922;2;6;957;1;603;502;101
0609;6;3931;2;6;146;0;97;82;15
0609;6;3946;2;6;383;0;197;171;26
0609;6;3969;2;6;332;0;166;149;17
0609;6;3971;2;6;1933;1;845;740;105
0609;6;3978;2;6;1455;0;747;651;96
0609;6;3979;2;6;319;0;160;139;21
0609;7;3872;2;7;1081;1;540;490;50
0609;7;3874;2;7;755;0;308;284;24
0609;7;3901;2;7;419;0;220;183;37
0609;7;3909;2;7;1018;0;440;367;73
0609;7;3936;2;7;351;0;221;184;37
0609;7;3942;2;7;1775;7;1197;935;262
0609;7;3947;2;7;954;0;544;458;86
0609;7;3952;2;7;622;0;294;267;27
0609;8;3879;2;8;1295;1;740;656;84
0609;8;3889;2;8;483;0;223;168;55
0609;8;3895;2;8;1801;2;855;747;108
0609;8;3898;2;8;1355;0;676;539;137
0609;8;3899;2;8;683;0;345;288;57
0609;8;3953;2;8;301;0;166;137;29
0609;8;3954;2;8;277;0;135;116;19
0609;9;3873;2;9;674;0;334;285;49
0609;9;3884;2;9;1167;4;697;558;139
0609;9;3893;2;9;1060;0;452;378;74
0609;9;3929;2;9;1370;0;590;528;62
0609;9;3934;2;9;465;0;249;204;45
0610;10;3988;4;10;311;0;153;125;28
0610;10;3995;4;10;1637;0;711;649;62
0610;11;4017;4;11;557;6;341;306;35
0610;11;4030;4;11;1491;0;704;639;65
0610;12;4010;4;12;1508;0;660;586;74
0610;13;4029;4;13;1464;0;664;615;49
0610;1;3989;4;1;1721;0;975;836;139
0610;1;3993;4;1;551;0;309;276;33
0610;1;3994;4;1;1470;3;1083;920;163
0610;1;3998;4;1;1245;0;662;580;82
0610;1;4002;4;1;559;0;308;263;45
0610;1;4024;4;1;663;1;394;333;61
0610;14;3987;4;14;1220;0;552;506;46
0610;15;4005;4;15;9;0;8;7;1
0610;2;3990;4;2;1095;0;681;592;89
0610;2;3996;4;2;571;0;301;262;39
0610;2;4008;4;2;579;0;154;132;22
0610;2;4012;4;2;993;0;410;381;29
0610;2;4018;4;2;492;0;318;283;35
0610;2;4021;4;2;1953;4;1132;969;163
0610;3;3986;4;3;1628;7;1130;923;207
0610;3;3992;4;3;1345;0;626;559;67
0610;3;3999;4;3;1352;0;648;544;104
0610;3;4007;4;3;335;0;206;184;22
0610;3;4019;4;3;1185;0;651;508;143
0610;3;4028;4;3;1052;0;426;341;85
0610;4;3997;4;4;641;0;293;248;45
0610;4;4011;4;4;339;0;170;161;9
0610;4;4013;4;4;1510;0;671;617;54
0610;4;4023;4;4;1413;1;784;700;84
0610;4;4026;4;4;558;5;366;309;57
0610;5;4000;4;5;715;1;315;265;50
0610;5;4001;4;5;955;1;427;378;49
0610;5;4016;4;5;463;0;230;199;31
0610;5;4025;4;5;1356;0;631;590;41
0610;6;4014;4;6;628;0;327;281;46
0610;6;4015;4;6;1587;0;750;690;60
0610;6;4031;4;6;543;0;285;247;38
0610;7;4004;4;7;933;0;466;366;100
0610;7;4006;4;7;1405;0;588;541;47
0610;7;4022;4;7;301;0;129;106;23
0610;8;3985;4;8;1921;0;1042;966;76
0610;8;4003;4;8;488;1;199;171;28
0610;8;4009;4;8;382;0;222;197;25
0610;9;3991;4;9;239;0;156;129;27
0610;9;4020;4;9;1683;1;771;704;67
0610;9;4027;4;9;576;0;284;236;48
0611;10;4044;3;10;378;0;231;186;45
0611;10;4066;3;10;2131;0;1053;972;81
0611;10;4096;3;10;592;0;273;217;56
0611;11;4092;3;11;979;0;542;516;26
0611;11;4110;3;11;2090;3;1198;1151;47
0611;12;4055;3;12;795;0;430;402;28
0611;12;4085;3;12;2329;1;1305;1230;75
0611;13;4059;3;13;1438;1;885;839;46
0611;13;4063;3;13;2432;0;1283;1212;71
0611;1;4037;3;1;1206;0;669;560;109
0611;1;4045;3;1;431;0;232;188;44
0611;1;4046;3;1;1821;10;1180;1023;157
0611;1;4052;3;1;1854;0;1275;946;329
0611;1;4067;3;1;1176;0;787;654;133
0611;1;4081;3;1;2202;0;1516;1293;223
0611;1;4095;3;1;969;0;591;464;127
0611;1;4098;3;1;682;0;429;379;50
0611;1;4101;3;1;867;0;475;383;92
0611;1;4117;3;1;1735;0;882;807;75
0611;1;4118;3;1;495;0;297;267;30
0611;14;4048;3;14;36;0;13;12;1
0611;14;4062;3;14;464;0;200;178;22
0611;15;4112;3;15;597;0;356;315;41
0611;16;4104;3;16;39;0;21;19;2
0611;2;4032;3;2;1018;0;592;526;66
0611;2;4038;3;2;1187;0;607;482;125
0611;2;4040;3;2;711;1;415;321;94
0611;2;4076;3;2;1355;1;854;701;153
0611;2;4086;3;2;565;0;282;241;41
0611;2;4094;3;2;553;0;277;189;88
0611;2;4097;3;2;720;0;441;395;46
0611;2;4109;3;2;2514;0;1352;1235;117
0611;2;4114;3;2;434;0;223;195;28
0611;2;4115;3;2;1411;4;886;748;138
0611;3;4035;3;3;1159;0;707;582;125
0611;3;4039;3;3;1560;0;769;707;62
0611;3;4056;3;3;947;4;588;560;28
0611;3;4058;3;3;480;4;360;288;72
0611;3;4061;3;3;444;0;281;229;52
0611;3;4069;3;3;394;0;291;232;59
0611;3;4071;3;3;1700;2;985;842;143
0611;3;4077;3;3;937;0;494;425;69
0611;3;4100;3;3;381;0;260;213;47
0611;3;4106;3;3;746;0;468;399;69
0611;4;4034;3;4;747;0;357;315;42
0611;4;4042;3;4;531;0;373;340;33
0611;4;4050;3;4;1240;4;720;565;155
0611;4;4070;3;4;1683;0;802;718;84
0611;4;4074;3;4;296;0;213;179;34
0611;4;4079;3;4;671;0;336;267;69
0611;4;4080;3;4;1769;0;999;908;91
0611;4;4093;3;4;934;1;562;469;93
0611;4;4099;3;4;946;0;549;429;120
0611;4;4102;3;4;712;2;502;419;83
0611;5;4033;3;5;227;0;149;118;31
0611;5;4043;3;5;785;0;495;433;62
0611;5;4057;3;5;907;9;554;443;111
0611;5;4064;3;5;2016;0;1107;1041;66
0611;5;4068;3;5;446;0;302;269;33
0611;5;4072;3;5;2348;1;1546;1232;314
0611;5;4090;3;5;1088;0;666;602;64
0611;5;4103;3;5;892;0;538;445;93
0611;5;4105;3;5;1062;0;530;454;76
0611;6;4041;3;6;305;0;188;121;67
0611;6;4083;3;6;752;0;393;358;35
0611;6;4088;3;6;319;0;207;163;44
0611;6;4089;3;6;459;0;272;241;31
0611;6;4091;3;6;1431;0;754;707;47
0611;6;4108;3;6;425;0;273;221;52
0611;6;4113;3;6;1694;0;1118;874;244
0611;6;4119;3;6;1132;0;799;669;130
0611;7;4036;3;7;912;0;611;512;99
0611;7;4051;3;7;297;1;169;138;31
0611;7;4053;3;7;523;0;321;249;72
0611;7;4065;3;7;842;0;479;442;37
0611;7;4075;3;7;1539;0;829;779;50
0611;7;4082;3;7;385;0;264;240;24
0611;7;4107;3;7;707;0;469;353;116
0611;7;4116;3;7;489;0;348;303;45
0611;8;4054;3;8;1251;0;740;602;138
0611;8;4060;3;8;382;0;196;168;28
0611;8;4073;3;8;1578;1;826;783;43
0611;8;4084;3;8;637;1;408;321;87
0611;8;4111;3;8;541;0;337;276;61
0611;9;4047;3;9;1777;0;863;777;86
0611;9;4049;3;9;856;0;505;473;32
0611;9;4078;3;9;580;9;409;315;94
0611;9;4087;3;9;377;2;238;195;43
0612;10;4128;2;10;449;0;156;144;12
0612;10;4146;2;10;1104;0;526;473;53
0612;11;4127;2;11;499;0;312;288;24
0612;11;4148;2;11;470;0;224;191;33
0612;12;4121;2;12;22;0;12;12;0
0612;12;4166;2;12;432;0;162;141;21
0612;13;4150;2;13;607;0;261;218;43
0612;1;4120;2;1;1771;0;771;669;102
0612;1;4122;2;1;1513;1;870;716;154
0612;1;4131;2;1;2117;0;1219;1080;139
0612;1;4149;2;1;644;0;336;302;34
0612;1;4155;2;1;1908;0;879;809;70
0612;1;4162;2;1;1457;0;938;773;165
0612;1;4170;2;1;1150;1;642;556;86
0612;14;4163;2;14;557;0;222;177;45
0612;15;4153;2;15;491;0;164;139;25
0612;16;4137;2;16;17;0;7;7;0
0612;2;4125;2;2;1990;0;930;845;85
0612;2;4136;2;2;1578;0;758;698;60
0612;2;4141;2;2;1350;3;698;608;90
0612;2;4143;2;2;519;1;247;212;35
0612;2;4145;2;2;760;0;326;292;34
0612;2;4171;2;2;804;1;412;352;60
0612;2;4174;2;2;297;0;226;160;66
0612;3;4123;2;3;2046;1;935;856;79
0612;3;4134;2;3;1037;0;457;416;41
0612;3;4147;2;3;1008;0;408;339;69
0612;3;4156;2;3;1244;0;648;577;71
0612;3;4165;2;3;1104;0;514;400;114
0612;3;4169;2;3;519;0;299;256;43
0612;3;4172;2;3;664;1;270;234;36
0612;4;4135;2;4;416;0;150;132;18
0612;4;4140;2;4;686;0;348;288;60
0612;4;4152;2;4;812;0;372;300;72
0612;4;4157;2;4;1097;0;620;579;41
0612;4;4161;2;4;729;0;387;320;67
0612;4;4173;2;4;1424;0;643;555;88
0612;4;4176;2;4;1595;0;700;609;91
0612;5;4126;2;5;1530;4;951;762;189
0612;5;4129;2;5;226;0;149;126;23
0612;5;4132;2;5;996;0;349;311;38
0612;5;4133;2;5;576;10;285;242;43
0612;5;4151;2;5;566;0;293;255;38
0612;5;4154;2;5;1153;0;478;425;53
0612;5;4175;2;5;412;0;193;163;30
0612;6;4124;2;6;540;0;288;253;35
0612;6;4130;2;6;349;0;160;140;20
0612;6;4159;2;6;1288;0;597;525;72
0612;6;4160;2;6;269;0;168;131;37
0612;6;4177;2;6;914;0;437;386;51
0612;6;4178;2;6;373;0;226;180;46
0612;7;4139;2;7;234;0;144;117;27
0612;7;4142;2;7;901;0;404;354;50
0612;7;4158;2;7;837;0;290;267;23
0612;8;4138;2;8;221;0;145;123;22
0612;8;4164;2;8;960;0;380;336;44
0612;8;4167;2;8;816;1;270;253;17
0612;9;4144;2;9;498;0;147;122;25
0612;9;4168;2;9;789;0;370;304;66
0613;10;4204;3;10;621;0;299;250;49
0613;11;4211;3;11;651;0;332;310;22
0613;12;4183;3;12;38;0;10;9;1
0613;1;4179;3;1;2012;0;1180;1097;83
0613;1;4180;3;1;1137;1;729;637;92
0613;1;4181;3;1;1147;3;770;658;112
0613;1;4186;3;1;506;0;369;289;80
0613;1;4191;3;1;1213;2;664;553;111
0613;1;4200;3;1;1309;1;805;700;105
0613;1;4212;3;1;1379;3;682;573;109
0613;2;4187;3;2;1286;3;954;781;173
0613;2;4188;3;2;431;0;211;178;33
0613;2;4189;3;2;1843;1;1021;964;57
0613;2;4201;3;2;613;0;364;305;59
0613;2;4206;3;2;1064;0;602;540;62
0613;2;4208;3;2;981;0;353;318;35
0613;2;4209;3;2;651;0;329;282;47
0613;3;4182;3;3;597;0;323;264;59
0613;3;4184;3;3;847;0;391;328;63
0613;3;4190;3;3;524;1;332;264;68
0613;3;4192;3;3;600;0;313;268;45
0613;3;4193;3;3;478;3;281;251;30
0613;3;4205;3;3;755;0;371;325;46
0613;4;4195;3;4;421;2;259;221;38
0613;4;4198;3;4;821;1;415;376;39
0613;4;4199;3;4;514;0;250;224;26
0613;4;4202;3;4;378;3;278;234;44
0613;4;4213;3;4;783;0;339;275;64
0613;5;4194;3;5;302;0;112;91;21
0613;5;4203;3;5;1784;1;954;887;67
0613;5;4210;3;5;349;0;208;183;25
0613;6;4197;3;6;596;0;305;264;41
0613;6;4207;3;6;354;0;240;215;25
0613;7;4185;3;7;1775;0;990;906;84
0613;8;4196;3;8;865;0;516;456;60
0613;9;4214;3;9;687;0;413;369;44
0614;10;4249;2;10;330;0;173;150;23
0614;10;4283;2;10;1613;0;695;638;57
0614;10;4291;2;10;598;0;329;263;66
0614;11;4220;2;11;455;0;214;192;22
0614;11;4224;2;11;2104;0;935;858;77
0614;12;4236;2;12;2114;1;983;903;80
0614;13;4254;2;13;1564;0;762;708;54
0614;1;4230;2;1;1448;2;765;642;123
0614;1;4237;2;1;999;3;675;536;139
0614;1;4243;2;1;1967;0;1237;1042;195
0614;1;4250;2;1;2013;3;1376;1172;204
0614;1;4252;2;1;1654;2;917;758;159
0614;1;4263;2;1;1738;2;950;827;123
0614;1;4269;2;1;2285;5;1311;1117;194
0614;1;4270;2;1;1787;4;1245;1067;178
0614;1;4284;2;1;1954;0;777;717;60
0614;1;4290;2;1;387;0;263;215;48
0614;1;4300;2;1;1500;0;832;745;87
0614;14;4260;2;14;2172;0;997;934;63
0614;15;4259;2;15;1408;0;637;590;47
0614;16;4287;2;16;1992;0;934;865;69
0614;17;4244;2;17;1860;0;685;637;48
0614;18;4292;2;18;1797;0;798;747;51
0614;19;4277;2;19;1541;0;673;608;65
0614;20;4240;2;20;2111;1;912;835;77
0614;21;4257;2;21;1836;1;755;686;69
0614;22;4273;2;22;1383;0;618;562;56
0614;23;4239;2;23;1399;0;639;580;59
0614;2;4215;2;2;1803;0;984;900;84
0614;2;4217;2;2;642;3;392;319;73
0614;2;4228;2;2;1556;0;685;591;94
0614;2;4234;2;2;753;3;395;318;77
0614;2;4238;2;2;1191;1;700;597;103
0614;2;4241;2;2;1281;0;721;583;138
0614;2;4247;2;2;1906;2;1005;946;59
0614;2;4264;2;2;1291;0;523;456;67
0614;2;4281;2;2;1085;0;638;548;90
0614;2;4282;2;2;1567;5;918;698;220
0614;2;4297;2;2;456;2;275;235;40
0614;24;4222;2;24;46;0;14;14;0
0614;3;4219;2;3;832;3;469;395;74
0614;3;4231;2;3;762;1;370;327;43
0614;3;4232;2;3;278;2;183;165;18
0614;3;4253;2;3;600;0;332;298;34
0614;3;4262;2;3;889;0;475;409;66
0614;3;4267;2;3;1954;0;941;800;141
0614;3;4274;2;3;2080;0;851;764;87
0614;3;4286;2;3;1081;1;545;435;110
0614;3;4288;2;3;483;8;345;286;59
0614;3;4289;2;3;1121;0;596;457;139
0614;4;4221;2;4;737;0;308;259;49
0614;4;4225;2;4;690;0;396;361;35
0614;4;4242;2;4;1829;0;876;823;53
0614;4;4246;2;4;691;1;403;339;64
0614;4;4256;2;4;610;0;210;136;74
0614;4;4261;2;4;1326;0;583;498;85
0614;4;4278;2;4;475;1;208;159;49
0614;4;4280;2;4;553;0;349;264;85
0614;4;4294;2;4;919;0;519;457;62
0614;5;4223;2;5;687;0;328;281;47
0614;5;4251;2;5;669;0;322;244;78
0614;5;4258;2;5;1910;0;904;842;62
0614;5;4266;2;5;670;0;315;274;41
0614;5;4268;2;5;593;0;341;304;37
0614;5;4271;2;5;109;0;31;28;3
0614;5;4295;2;5;565;0;317;271;46
0614;5;4298;2;5;597;2;264;239;25
0614;6;4235;2;6;422;0;206;170;36
0614;6;4245;2;6;651;0;302;268;34
0614;6;4255;2;6;522;0;237;203;34
0614;6;4272;2;6;326;0;205;171;34
0614;6;4299;2;6;1689;1;801;742;59
0614;7;4229;2;7;442;0;212;174;38
0614;7;4275;2;7;905;0;408;385;23
0614;7;4276;2;7;587;0;264;213;51
0614;7;4285;2;7;722;0;261;216;45
0614;7;4293;2;7;797;0;397;375;22
0614;8;4218;2;8;2164;0;1022;955;67
0614;8;4226;2;8;522;1;270;212;58
0614;8;4233;2;8;504;0;230;208;22
0614;8;4248;2;8;542;0;291;241;50
0614;8;4279;2;8;250;0;154;134;20
0614;9;4216;2;9;1950;0;838;780;58
0614;9;4227;2;9;340;0;190;166;24
0614;9;4265;2;9;719;0;294;257;37
0614;9;4296;2;9;719;0;323;294;29
0615;10;4332;3;10;25;0;8;8;0
0615;1;4304;3;1;1264;4;746;652;94
0615;1;4319;3;1;2199;1;1263;1164;99
0615;1;4323;3;1;1225;0;681;565;116
0615;1;4329;3;1;1667;0;1004;837;167
0615;1;4335;3;1;787;0;362;321;41
0615;1;4344;3;1;1856;3;885;783;102
0615;1;4347;3;1;1111;1;668;610;58
0615;1;4351;3;1;1903;0;1130;991;139
0615;2;4301;3;2;1926;0;1021;938;83
0615;2;4307;3;2;1000;0;528;498;30
0615;2;4316;3;2;434;0;247;220;27
0615;2;4322;3;2;528;0;326;271;55
0615;2;4333;3;2;1185;0;391;340;51
0615;2;4342;3;2;624;2;381;326;55
0615;2;4345;3;2;2349;0;1485;1303;182
0615;2;4349;3;2;568;0;328;290;38
0615;3;4310;3;3;1483;0;659;542;117
0615;3;4317;3;3;395;2;261;239;22
0615;3;4320;3;3;668;0;321;262;59
0615;3;4325;3;3;577;0;283;251;32
0615;3;4326;3;3;1628;0;942;824;118
0615;3;4338;3;3;881;0;469;426;43
0615;3;4343;3;3;642;0;396;316;80
0615;3;4350;3;3;1654;0;920;825;95
0615;4;4305;3;4;529;0;301;284;17
0615;4;4309;3;4;612;0;329;297;32
0615;4;4312;3;4;719;0;365;264;101
0615;4;4321;3;4;728;0;364;327;37
0615;4;4327;3;4;1267;3;827;743;84
0615;4;4328;3;4;722;0;498;409;89
0615;4;4334;3;4;611;0;338;293;45
0615;4;4336;3;4;1761;0;937;851;86
0615;5;4302;3;5;344;0;175;149;26
0615;5;4303;3;5;618;1;370;315;55
0615;5;4308;3;5;1093;1;619;556;63
0615;5;4313;3;5;416;0;246;197;49
0615;5;4314;3;5;920;0;513;417;96
0615;5;4318;3;5;1538;0;785;730;55
0615;5;4330;3;5;954;1;516;429;87
0615;6;4306;3;6;1554;0;825;774;51
0615;6;4324;3;6;400;0;205;159;46
0615;6;4340;3;6;653;0;389;338;51
0615;6;4346;3;6;517;0;303;255;48
0615;6;4348;3;6;811;1;415;360;55
0615;7;4331;3;7;6;0;4;3;1
0615;7;4337;3;7;404;0;232;182;50
0615;7;4339;3;7;992;0;567;506;61
0615;7;4341;3;7;454;0;249;212;37
0615;8;4315;3;8;1025;0;596;549;47
0615;9;4311;3;9;1435;4;758;681;77
0616;10;4379;2;10;1058;0;605;570;35
0616;10;4381;2;10;940;0;474;409;65
0616;11;4366;2;11;776;0;407;355;52
0616;11;4399;2;11;1049;0;565;525;40
0616;12;4392;2;12;535;0;297;271;26
0616;12;4395;2;12;307;0;170;149;21
0616;13;4359;2;13;460;0;262;223;39
0616;13;4405;2;13;585;0;349;333;16
0616;1;4357;2;1;917;0;527;484;43
0616;1;4362;2;1;1902;4;1099;991;108
0616;1;4387;2;1;1230;1;629;468;161
0616;1;4402;2;1;1413;0;882;743;139
0616;1;4411;2;1;1717;0;1010;923;87
0616;1;4415;2;1;658;3;451;380;71
0616;14;4365;2;14;1207;0;568;509;59
0616;14;4368;2;14;1077;0;600;549;51
0616;15;4352;2;15;405;0;212;196;16
0616;15;4378;2;15;1277;0;632;583;49
0616;16;4393;2;16;14;0;10;8;2
0616;16;4403;2;16;1138;2;646;532;114
0616;17;4360;2;17;360;0;237;213;24
0616;18;4414;2;18;39;0;23;20;3
0616;19;4400;2;19;8;0;4;4;0
0616;2;4356;2;2;767;0;461;362;99
0616;2;4361;2;2;397;0;222;214;8
0616;2;4371;2;2;434;0;209;184;25
0616;2;4374;2;2;293;0;165;154;11
0616;2;4383;2;2;577;0;275;249;26
0616;2;4390;2;2;1352;0;718;668;50
0616;3;4372;2;3;353;0;168;154;14
0616;3;4384;2;3;589;2;338;299;39
0616;3;4385;2;3;777;0;393;347;46
0616;3;4389;2;3;456;2;266;235;31
0616;3;4397;2;3;1547;1;849;791;58
0616;3;4413;2;3;627;0;389;356;33
0616;4;4354;2;4;332;0;159;140;19
0616;4;4367;2;4;236;0;155;135;20
0616;4;4370;2;4;388;0;187;159;28
0616;4;4373;2;4;1221;0;685;625;60
0616;4;4391;2;4;907;0;477;424;53
0616;4;4409;2;4;795;0;424;345;79
0616;5;4355;2;5;502;0;236;211;25
0616;5;4358;2;5;219;0;132;113;19
0616;5;4364;2;5;1399;4;701;622;79
0616;5;4375;2;5;331;0;185;147;38
0616;5;4407;2;5;1733;1;1077;1030;47
0616;5;4408;2;5;202;0;120;110;10
0616;6;4369;2;6;1243;0;727;618;109
0616;6;4377;2;6;472;0;274;248;26
0616;6;4382;2;6;275;0;159;137;22
0616;6;4394;2;6;636;0;387;355;32
0616;6;4396;2;6;341;0;191;178;13
0616;6;4398;2;6;341;0;221;206;15
0616;7;4363;2;7;362;0;191;166;25
0616;7;4386;2;7;423;1;244;220;24
0616;7;4388;2;7;1461;3;703;609;94
0616;7;4401;2;7;438;0;232;201;31
0616;7;4410;2;7;734;0;410;372;38
0616;7;4412;2;7;383;1;251;242;9
0616;8;4376;2;8;519;0;316;257;59
0616;8;4380;2;8;703;0;336;303;33
0616;8;4406;2;8;824;0;465;423;42
0616;9;4353;2;9;1398;0;782;732;50
0616;9;4404;2;9;1954;1;991;864;127
0617;10;4420;4;10;1101;1;588;510;78
0617;10;4456;4;10;1462;0;575;547;28
0617;11;4457;4;11;1578;0;583;552;31
0617;11;4461;4;11;1078;2;625;561;64
0617;12;4464;4;12;524;2;266;228;38
0617;12;4467;4;12;1221;0;483;462;21
0617;13;4419;4;13;762;0;280;272;8
0617;1;4422;4;1;720;0;299;262;37
0617;1;4426;4;1;722;0;454;360;94
0617;1;4428;4;1;640;0;344;313;31
0617;1;4441;4;1;1483;1;625;525;100
0617;14;4433;4;14;1620;0;608;588;20
0617;1;4448;4;1;2497;0;1086;1038;48
0617;15;4416;4;15;1524;0;578;549;29
0617;16;4424;4;16;2338;0;968;931;37
0617;17;4427;4;17;1549;0;705;673;32
0617;18;4447;4;18;1677;0;656;635;21
0617;19;4444;4;19;2023;0;847;810;37
0617;20;4462;4;20;507;0;178;169;9
0617;21;4439;4;21;1804;0;716;684;32
0617;22;4438;4;22;2132;1;836;793;43
0617;23;4468;4;23;110;0;36;35;1
0617;2;4436;4;2;677;0;268;233;35
0617;2;4445;4;2;698;0;232;200;32
0617;2;4451;4;2;387;0;224;156;68
0617;2;4458;4;2;1823;1;727;692;35
0617;2;4460;4;2;658;1;329;295;34
0617;3;4423;4;3;653;0;341;293;48
0617;3;4432;4;3;995;0;407;325;82
0617;3;4437;4;3;1064;0;507;452;55
0617;3;4443;4;3;1482;0;687;615;72
0617;3;4452;4;3;1229;0;564;542;22
0617;4;4425;4;4;839;0;413;352;61
0617;4;4430;4;4;1298;0;498;409;89
0617;4;4435;4;4;1480;0;643;620;23
0617;4;4442;4;4;751;0;393;347;46
0617;4;4453;4;4;463;0;180;150;30
0617;5;4417;4;5;1521;1;797;703;94
0617;5;4446;4;5;2265;1;1075;858;217
0617;5;4449;4;5;611;2;291;256;35
0617;5;4454;4;5;706;5;302;286;16
0617;5;4463;4;5;923;0;478;409;69
0617;6;4431;4;6;637;0;246;199;47
0617;6;4450;4;6;885;2;334;308;26
0617;6;4455;4;6;560;2;346;321;25
0617;6;4465;4;6;1504;4;646;600;46
0617;7;4418;4;7;513;0;303;253;50
0617;7;4440;4;7;759;0;375;347;28
0617;7;4459;4;7;1209;2;478;446;32
0617;8;4429;4;8;1753;0;818;757;61
0617;8;4466;4;8;674;0;259;226;33
0617;9;4421;4;9;1030;0;415;380;35
0617;9;4434;4;9;529;0;240;227;13
0618;10;4471;5;10;578;0;293;254;39
0618;10;4487;5;10;2293;0;1244;1116;128
0618;10;4530;5;10;392;8;232;203;29
0618;11;4509;5;11;420;0;171;143;28
0618;11;4512;5;11;44;0;18;13;5
0618;12;4491;5;12;728;0;338;298;40
0618;1;4477;5;1;1717;7;1033;875;158
0618;1;4494;5;1;1612;0;824;719;105
0618;1;4498;5;1;677;0;366;296;70
0618;1;4501;5;1;1685;24;895;704;191
0618;1;4502;5;1;931;1;502;412;90
0618;1;4517;5;1;823;0;360;314;46
0618;1;4518;5;1;597;0;341;280;61
0618;1;4533;5;1;2125;9;1352;1142;210
0618;1;4543;5;1;1074;0;638;545;93
0618;1;4544;5;1;1881;3;944;871;73
0618;1;4551;5;1;1087;15;677;609;68
0618;1;4556;5;1;939;0;478;478;0
0618;1;4557;5;1;1511;3;863;714;149
0618;2;4474;5;2;1943;0;966;787;179
0618;2;4475;5;2;287;2;179;144;35
0618;2;4484;5;2;807;1;351;272;79
0618;2;4489;5;2;361;0;201;153;48
0618;2;4495;5;2;1084;0;597;516;81
0618;2;4507;5;2;862;6;533;422;111
0618;2;4521;5;2;1490;0;712;642;70
0618;2;4526;5;2;663;0;366;307;59
0618;2;4541;5;2;860;0;523;419;104
0618;2;4553;5;2;261;0;113;94;19
0618;2;4554;5;2;312;0;193;159;34
0618;2;4555;5;2;148;1;78;60;18
0618;2;4559;5;2;757;0;415;333;82
0618;3;4472;5;3;299;0;173;127;46
0618;3;4476;5;3;470;4;264;228;36
0618;3;4481;5;3;1054;14;591;489;102
0618;3;4485;5;3;507;0;311;279;32
0618;3;4505;5;3;379;2;221;189;32
0618;3;4510;5;3;1162;2;591;529;62
0618;3;4516;5;3;1949;1;776;720;56
0618;3;4527;5;3;436;1;243;197;46
0618;3;4532;5;3;531;0;297;245;52
0618;3;4534;5;3;505;0;299;262;37
0618;3;4538;5;3;1025;0;589;493;96
0618;3;4539;5;3;344;0;171;146;25
0618;3;4550;5;3;701;0;308;260;48
0618;4;4478;5;4;1114;1;524;461;63
0618;4;4486;5;4;356;0;213;197;16
0618;4;4490;5;4;258;1;174;140;34
0618;4;4496;5;4;274;8;153;135;18
0618;4;4503;5;4;393;6;295;252;43
0618;4;4504;5;4;482;0;279;244;35
0618;4;4514;5;4;252;0;115;104;11
0618;4;4519;5;4;914;0;480;452;28
0618;4;4522;5;4;577;7;288;250;38
0618;4;4524;5;4;520;2;281;229;52
0618;4;4531;5;4;677;0;322;261;61
0618;4;4540;5;4;1159;2;632;521;111
0618;4;4549;5;4;808;1;356;323;33
0618;5;4482;5;5;525;0;267;216;51
0618;5;4483;5;5;365;3;219;185;34
0618;5;4492;5;5;1438;0;620;543;77
0618;5;4497;5;5;359;0;158;142;16
0618;5;4500;5;5;366;3;184;153;31
0618;5;4506;5;5;526;4;338;292;46
0618;5;4523;5;5;902;23;567;479;88
0618;5;4525;5;5;1422;6;720;618;102
0618;5;4548;5;5;657;0;377;316;61
0618;5;4552;5;5;520;0;301;241;60
0618;6;4469;5;6;372;1;223;187;36
0618;6;4470;5;6;1702;0;1016;816;200
0618;6;4508;5;6;429;0;196;170;26
0618;6;4515;5;6;591;2;305;253;52
0618;6;4520;5;6;277;13;191;160;31
0618;6;4545;5;6;937;1;447;377;70
0618;6;4546;5;6;1734;7;866;772;94
0618;7;4473;5;7;867;0;389;328;61
0618;7;4479;5;7;2284;7;1276;1088;188
0618;7;4488;5;7;833;5;442;405;37
0618;7;4529;5;7;473;0;255;211;44
0618;7;4536;5;7;316;2;125;118;7
0618;7;4537;5;7;356;0;198;133;65
0618;7;4558;5;7;472;0;267;204;63
0618;8;4499;5;8;236;2;166;128;38
0618;8;4511;5;8;1887;1;935;874;61
0618;8;4528;5;8;317;3;187;152;35
0618;8;4535;5;8;347;2;228;192;36
0618;8;4547;5;8;827;1;431;392;39
0618;9;4480;5;9;274;1;206;176;30
0618;9;4493;5;9;1678;0;923;835;88
0618;9;4513;5;9;343;1;207;182;25
0618;9;4542;5;9;321;0;150;138;12
0619;1;4561;4;1;688;0;266;227;39
0619;1;4564;4;1;935;5;606;508;98
0619;1;4570;4;1;861;0;353;281;72
0619;1;4572;4;1;232;0;145;113;32
0619;1;4579;4;1;931;4;621;532;89
0619;1;4581;4;1;533;1;261;207;54
0619;1;4584;4;1;891;0;604;524;80
0619;1;4589;4;1;2309;1;1168;1095;73
0619;2;4562;4;2;564;1;348;290;58
0619;2;4563;4;2;334;0;204;165;39
0619;2;4569;4;2;1888;3;978;866;112
0619;2;4573;4;2;377;0;244;199;45
0619;2;4582;4;2;258;0;95;68;27
0619;2;4590;4;2;1784;0;728;657;71
0619;2;4591;4;2;2201;1;1101;1059;42
0619;2;4600;4;2;335;0;182;142;40
0619;3;4566;4;3;2384;0;1197;1081;116
0619;3;4567;4;3;212;0;157;123;34
0619;3;4571;4;3;260;0;178;133;45
0619;3;4574;4;3;688;1;439;367;72
0619;3;4586;4;3;1556;1;863;775;88
0619;3;4592;4;3;451;0;216;181;35
0619;3;4597;4;3;1303;0;728;653;75
0619;3;4599;4;3;221;0;52;48;4
0619;4;4560;4;4;329;0;153;135;18
0619;4;4565;4;4;354;0;214;188;26
0619;4;4575;4;4;508;0;273;245;28
0619;4;4576;4;4;415;0;229;199;30
0619;4;4577;4;4;472;0;261;201;60
0619;4;4580;4;4;2136;0;1009;950;59
0619;4;4585;4;4;479;0;265;227;38
0619;4;4587;4;4;301;0;169;131;38
0619;5;4568;4;5;418;0;145;131;14
0619;5;4596;4;5;505;0;295;254;41
0619;5;4598;4;5;2322;1;1112;1057;55
0619;5;4601;4;5;832;0;446;385;61
0619;6;4593;4;6;209;0;94;70;24
0619;6;4594;4;6;27;0;9;9;0
0619;7;4578;4;7;354;0;156;119;37
0619;7;4588;4;7;40;0;22;20;2
0619;8;4595;4;8;318;0;148;127;21
0619;9;4583;4;9;828;0;442;387;55
0620;10;4647;5;10;51;0;48;44;4
0620;10;4665;5;10;50;0;45;36;9
0620;10;4698;5;10;711;0;289;238;51
0620;11;4682;5;11;2210;0;918;839;79
0620;12;4618;5;12;1503;0;635;582;53
0620;13;4611;5;13;605;0;329;281;48
0620;14;4704;5;14;439;0;210;176;34
0620;1;4612;5;1;453;0;260;225;35
0620;1;4614;5;1;1228;0;588;517;71
0620;1;4619;5;1;590;3;322;281;41
0620;1;4622;5;1;997;2;519;442;77
0620;1;4635;5;1;1418;0;766;681;85
0620;1;4642;5;1;2192;1;1041;946;95
0620;1;4660;5;1;1987;5;1129;883;246
0620;1;4662;5;1;1111;1;719;554;165
0620;1;4667;5;1;621;2;325;286;39
0620;1;4669;5;1;460;1;326;253;73
0620;1;4678;5;1;617;2;389;344;45
0620;1;4684;5;1;1470;0;628;518;110
0620;1;4686;5;1;1033;1;686;629;57
0620;1;4696;5;1;1243;3;772;710;62
0620;1;4701;5;1;1948;1;1218;1086;132
0620;15;4702;5;15;1035;0;424;373;51
0620;16;4629;5;16;678;0;324;271;53
0620;17;4651;5;17;423;9;254;227;27
0620;18;4655;5;18;318;0;101;85;16
0620;2;4617;5;2;532;1;326;295;31
0620;2;4621;5;2;1103;12;731;647;84
0620;2;4624;5;2;834;3;457;406;51
0620;2;4627;5;2;1253;4;674;588;86
0620;2;4628;5;2;611;0;335;272;63
0620;2;4630;5;2;770;0;491;457;34
0620;2;4631;5;2;1156;0;558;443;115
0620;2;4634;5;2;686;0;334;273;61
0620;2;4645;5;2;767;1;419;358;61
0620;2;4646;5;2;364;0;209;157;52
0620;2;4657;5;2;1679;3;899;799;100
0620;2;4668;5;2;492;6;289;229;60
0620;2;4671;5;2;1683;0;661;585;76
0620;2;4692;5;2;635;0;412;354;58
0620;2;4707;5;2;877;0;390;319;71
0620;3;4602;5;3;900;5;564;507;57
0620;3;4608;5;3;1571;3;721;675;46
0620;3;4613;5;3;580;3;294;262;32
0620;3;4625;5;3;1123;1;607;494;113
0620;3;4626;5;3;679;0;336;315;21
0620;3;4632;5;3;502;0;293;243;50
0620;3;4641;5;3;2064;3;1113;941;172
0620;3;4649;5;3;904;0;419;333;86
0620;3;4656;5;3;596;0;271;216;55
0620;3;4659;5;3;334;0;162;130;32
0620;3;4661;5;3;1015;3;668;479;189
0620;3;4663;5;3;865;5;466;394;72
0620;3;4679;5;3;230;0;119;103;16
0620;3;4706;5;3;1704;15;1102;966;136
0620;3;4710;5;3;1260;0;492;403;89
0620;4;4620;5;4;993;5;572;480;92
0620;4;4636;5;4;577;3;292;250;42
0620;4;4652;5;4;785;0;302;254;48
0620;4;4653;5;4;569;0;326;274;52
0620;4;4664;5;4;840;0;211;168;43
0620;4;4670;5;4;1082;0;618;534;84
0620;4;4675;5;4;637;0;359;314;45
0620;4;4683;5;4;595;1;337;276;61
0620;4;4687;5;4;728;0;411;358;53
0620;4;4688;5;4;546;0;279;240;39
0620;4;4689;5;4;629;2;428;395;33
0620;4;4693;5;4;436;3;221;196;25
0620;4;4695;5;4;774;0;464;379;85
0620;4;4703;5;4;491;0;286;242;44
0620;4;4705;5;4;1064;0;668;585;83
0620;5;4603;5;5;384;0;250;225;25
0620;5;4607;5;5;1053;4;569;522;47
0620;5;4609;5;5;691;0;287;240;47
0620;5;4610;5;5;1278;1;722;605;117
0620;5;4615;5;5;237;2;139;117;22
0620;5;4616;5;5;1106;2;462;396;66
0620;5;4638;5;5;858;2;473;407;66
0620;5;4658;5;5;1456;0;690;616;74
0620;5;4681;5;5;1123;0;716;645;71
0620;5;4685;5;5;572;0;233;209;24
0620;5;4691;5;5;428;0;243;200;43
0620;5;4694;5;5;437;0;203;180;23
0620;5;4697;5;5;442;0;277;241;36
0620;5;4709;5;5;670;0;176;148;28
0620;6;4604;5;6;422;0;249;216;33
0620;6;4605;5;6;745;0;390;315;75
0620;6;4606;5;6;548;0;282;212;70
0620;6;4623;5;6;472;0;243;205;38
0620;6;4639;5;6;512;1;278;236;42
0620;6;4648;5;6;749;0;441;398;43
0620;6;4654;5;6;692;1;333;286;47
0620;6;4672;5;6;519;0;365;310;55
0620;6;4676;5;6;1193;1;575;498;77
0620;6;4677;5;6;299;0;138;126;12
0620;6;4700;5;6;373;0;166;155;11
0620;7;4637;5;7;542;0;338;290;48
0620;7;4640;5;7;13;0;1;1;0
0620;7;4650;5;7;272;0;187;160;27
0620;7;4666;5;7;322;0;221;182;39
0620;7;4673;5;7;1728;0;772;652;120
0620;7;4708;5;7;1279;0;552;518;34
0620;7;4711;5;7;424;5;290;231;59
0620;8;4633;5;8;577;0;283;253;30
0620;8;4644;5;8;954;0;478;375;103
0620;8;4674;5;8;935;0;501;419;82
0620;8;4680;5;8;325;0;232;184;48
0620;9;4643;5;9;1027;0;515;452;63
0620;9;4690;5;9;117;0;46;41;5
0620;9;4699;5;9;15;0;14;14;0
0661;10;4738;3;10;1225;0;514;486;28
0661;11;4722;3;11;925;2;404;369;35
0661;12;4720;3;12;2200;0;863;810;53
0661;13;4724;3;13;2388;0;1139;1080;59
0661;14;4735;3;14;1879;0;828;794;34
0661;1;4734;3;1;1719;0;760;714;46
0661;15;4713;3;15;1564;0;721;699;22
0661;16;4739;3;16;2088;0;929;867;62
0661;17;4732;3;17;2089;0;966;908;58
0661;18;4716;3;18;2094;0;974;932;42
0661;19;4731;3;19;2076;2;1086;1038;48
0661;20;4740;3;20;2298;0;1229;1179;50
0661;21;4725;3;21;2386;0;1115;1064;51
0661;22;4714;3;22;2111;0;968;940;28
0661;23;4721;3;23;2168;0;994;950;44
0661;24;4717;3;24;1236;0;557;528;29
0661;2;4726;3;2;1660;0;585;558;27
0661;25;4723;3;25;1175;2;523;496;27
0661;26;4729;3;26;1060;0;442;419;23
0661;27;4737;3;27;1520;0;553;513;40
0661;28;4733;3;28;56;0;20;17;3
0661;29;4712;3;29;50;0;29;25;4
0661;3;4715;3;3;1563;0;618;577;41
0661;4;4728;3;4;1495;0;673;652;21
0661;5;4719;3;5;1760;0;799;752;47
0661;6;4718;3;6;1577;0;677;637;40
0661;7;4736;3;7;1692;0;769;727;42
0661;8;4730;3;8;960;0;356;338;18
0661;9;4727;3;9;985;0;407;368;39
0662;10;4767;4;10;1785;1;828;790;38
0662;11;4763;4;11;2181;0;1028;978;50
0662;12;4769;4;12;1650;0;771;736;35
0662;13;4743;4;13;1563;0;624;576;48
0662;14;4772;4;14;1675;0;692;656;36
0662;1;4748;4;1;1470;0;772;742;30
0662;15;4758;4;15;1544;1;690;648;42
0662;16;4751;4;16;1847;0;763;709;54
0662;17;4744;4;17;1041;1;465;428;37
0662;18;4756;4;18;1110;0;468;435;33
0662;19;4759;4;19;1992;0;946;886;60
0662;20;4752;4;20;471;0;204;188;16
0662;21;4746;4;21;1911;0;963;907;56
0662;22;4764;4;22;982;1;458;437;21
0662;23;4774;4;23;1602;0;823;783;40
0662;24;4765;4;24;1403;0;654;613;41
0662;2;4761;4;2;2045;0;900;859;41
0662;25;4776;4;25;1946;1;881;840;41
0662;26;4747;4;26;2110;0;1059;981;78
0662;27;4773;4;27;1653;0;700;700;0
0662;28;4742;4;28;2147;1;1000;967;33
0662;29;4749;4;29;1774;0;805;752;53
0662;30;4768;4;30;1779;0;806;769;37
0662;31;4741;4;31;1973;0;862;827;35
0662;32;4745;4;32;1668;0;778;735;43
0662;33;4757;4;33;1675;0;786;762;24
0662;34;4771;4;34;770;0;353;324;29
0662;3;4753;4;3;2211;1;1000;941;59
0662;35;4766;4;35;91;0;37;29;8
0662;36;4770;4;36;139;0;35;34;1
0662;4;4760;4;4;1596;0;696;647;49
0662;5;4775;4;5;1646;0;724;687;37
0662;6;4762;4;6;613;0;296;282;14
0662;7;4750;4;7;1517;0;620;581;39
0662;8;4755;4;8;2227;0;1042;979;63
0662;9;4754;4;9;1540;0;784;740;44
0663;100;4849;1;100;1670;0;693;676;17
0663;101;4880;1;101;1914;0;744;722;22
0663;102;4970;1;102;1310;0;534;513;21
0663;103;4942;1;103;1397;0;568;558;10
0663;104;4801;1;104;2064;0;956;945;11
0663;10;4949;1;10;1276;0;559;541;18
0663;105;4887;1;105;2014;0;803;754;49
0663;106;4922;1;106;1631;0;669;653;16
0663;107;4869;1;107;798;0;321;319;2
0663;108;4823;1;108;2071;0;863;844;19
0663;109;4799;1;109;2253;1;916;895;21
0663;110;4809;1;110;1978;0;1073;1043;30
0663;111;4945;1;111;1862;0;717;698;19
0663;112;4872;1;112;1591;0;679;665;14
0663;113;4871;1;113;1734;0;653;633;20
0663;114;4979;1;114;1666;0;648;635;13
0663;11;4868;1;11;1614;1;561;542;19
0663;115;4839;1;115;1654;0;638;617;21
0663;116;4985;1;116;1504;0;573;561;12
0663;117;4934;1;117;1917;0;731;703;28
0663;118;4933;1;118;630;0;235;231;4
0663;119;4983;1;119;2002;0;890;870;20
0663;120;4986;1;120;1370;0;551;537;14
0663;121;4866;1;121;1376;669;668;655;13
0663;122;4826;1;122;1757;0;784;753;31
0663;123;4853;1;123;1066;0;411;397;14
0663;124;4812;1;124;503;0;116;108;8
0663;12;4968;1;12;1539;0;592;584;8
0663;125;4810;1;125;2315;0;1016;983;33
0663;126;4956;1;126;1907;0;715;694;21
0663;127;4873;1;127;1452;0;687;671;16
0663;128;4915;1;128;1606;0;709;687;22
0663;129;4884;1;129;1574;0;657;635;22
0663;130;4921;1;130;1515;0;568;543;25
0663;131;4900;1;131;2063;0;742;716;26
0663;132;4953;1;132;1690;0;650;633;17
0663;133;4848;1;133;1561;2;715;700;15
0663;134;4844;1;134;1002;0;309;293;16
0663;13;4908;1;13;815;0;281;275;6
0663;135;4976;1;135;933;0;353;342;11
0663;136;4877;1;136;1259;0;551;530;21
0663;137;4959;1;137;1895;0;822;787;35
0663;138;4859;1;138;82;0;55;54;1
0663;139;4962;1;139;1493;0;364;347;17
0663;140;4838;1;140;437;0;81;79;2
0663;141;4813;1;141;1179;0;417;396;21
0663;142;4932;1;142;1220;0;525;504;21
0663;143;4906;1;143;865;0;245;239;6
0663;144;4831;1;144;1326;0;384;369;15
0663;14;4817;1;14;661;0;287;274;13
0663;145;4912;1;145;1022;0;309;300;9
0663;146;4843;1;146;1313;0;417;404;13
0663;147;4978;1;147;885;0;254;237;17
0663;1;4835;1;1;814;0;150;147;3
0663;148;4890;1;148;1168;0;392;381;11
0663;149;4836;1;149;963;0;267;252;15
0663;150;4790;1;150;790;0;154;150;4
0663;151;4830;1;151;617;0;204;198;6
0663;152;4851;1;152;1070;0;279;273;6
0663;153;4824;1;153;2027;0;806;767;39
0663;154;4821;1;154;1979;0;699;667;32
0663;15;4943;1;15;471;0;188;184;4
0663;155;4982;1;155;716;0;123;118;5
0663;156;4924;1;156;775;0;306;293;13
0663;157;4787;1;157;1349;0;439;428;11
0663;158;4784;1;158;2081;0;681;645;36
0663;159;4865;1;159;1910;0;759;718;41
0663;160;4786;1;160;853;0;222;217;5
0663;161;4911;1;161;1638;0;641;626;15
0663;162;4834;1;162;2191;0;789;750;39
0663;163;4987;1;163;1463;0;490;481;9
0663;164;4903;1;164;1619;0;347;337;10
0663;16;4846;1;16;824;0;292;286;6
0663;165;4794;1;165;1655;0;715;696;19
0663;166;4958;1;166;1618;0;601;574;27
0663;167;4899;1;167;73;0;32;30;2
0663;168;4891;1;168;1781;0;776;757;19
0663;169;4795;1;169;997;0;345;314;31
0663;170;4935;1;170;1988;1;720;694;26
0663;171;4947;1;171;1591;0;599;570;29
0663;172;4783;1;172;1191;0;509;491;18
0663;173;4952;1;173;1222;0;324;317;7
0663;174;4893;1;174;396;0;125;124;1
0663;17;4806;1;17;474;0;240;238;2
0663;175;4889;1;175;1849;0;793;775;18
0663;176;4875;1;176;1486;0;580;563;17
0663;177;4917;1;177;2196;0;767;754;13
0663;178;4793;1;178;1566;0;597;585;12
0663;179;4971;1;179;1062;0;442;430;12
0663;180;4940;1;180;1922;0;847;819;28
0663;181;4901;1;181;1958;0;824;800;24
0663;182;4939;1;182;957;1;298;290;8
0663;183;4840;1;183;1972;0;475;448;27
0663;184;4909;1;184;1229;0;423;413;10
0663;18;4867;1;18;687;1;266;258;8
0663;185;4852;1;185;784;0;301;257;44
0663;186;4905;1;186;902;0;182;175;7
0663;187;4854;1;187;721;0;139;132;7
0663;188;4897;1;188;782;0;233;217;16
0663;189;4973;1;189;2222;0;829;804;25
0663;190;4931;1;190;2163;1;855;827;28
0663;191;4923;1;191;1892;1;768;738;30
0663;192;4930;1;192;1955;1;718;699;19
0663;193;4965;1;193;1973;0;705;682;23
0663;194;4966;1;194;1411;0;585;575;10
0663;19;4811;1;19;889;0;283;282;1
0663;195;4937;1;195;625;0;211;203;8
0663;196;4856;1;196;1616;0;609;577;32
0663;197;4777;1;197;391;0;169;139;30
0663;198;4802;1;198;26;0;8;7;1
0663;199;4896;1;199;93;0;13;11;2
0663;200;4828;1;200;8;0;1;1;0
0663;201;4818;1;201;14;0;4;4;0
0663;202;4984;1;202;96;0;21;20;1
0663;203;4874;1;203;21;0;6;5;1
0663;204;4842;1;204;234;0;54;51;3
0663;20;4798;1;20;408;0;111;107;4
0663;205;4803;1;205;24;0;8;8;0
0663;206;4860;1;206;22;0;5;5;0
0663;207;4955;1;207;52;0;39;35;4
0663;208;4936;1;208;158;0;82;79;3
0663;209;4925;1;209;53;0;26;25;1
0663;210;4781;1;210;49;0;24;24;0
0663;211;4950;1;211;164;0;37;36;1
0663;21;4975;1;21;883;0;179;169;10
0663;22;4800;1;22;1632;1;431;421;10
0663;23;4894;1;23;752;0;281;264;17
0663;24;4948;1;24;1733;0;631;615;16
0663;2;4951;1;2;748;0;177;170;7
0663;25;4804;1;25;1342;0;457;435;22
0663;26;4850;1;26;1151;0;482;468;14
0663;27;4902;1;27;89;0;46;42;4
0663;28;4944;1;28;1408;0;553;542;11
0663;29;4885;1;29;2169;0;978;954;24
0663;30;4967;1;30;2362;1;1065;1021;44
0663;31;4808;1;31;1818;0;720;693;27
0663;32;4977;1;32;712;0;345;336;9
0663;33;4879;1;33;830;0;331;318;13
0663;34;4832;1;34;661;0;343;337;6
0663;3;4980;1;3;434;0;117;113;4
0663;35;4961;1;35;800;0;328;315;13
0663;36;4964;1;36;1931;0;696;680;16
0663;37;4822;1;37;1622;1;666;647;19
0663;38;4954;1;38;1675;0;719;704;15
0663;39;4963;1;39;492;0;208;208;0
0663;40;4881;1;40;1357;0;640;628;12
0663;41;4969;1;41;1354;0;725;695;30
0663;42;4898;1;42;1133;0;634;623;11
0663;43;4910;1;43;1400;1;731;715;16
0663;44;4841;1;44;867;0;427;421;6
0663;4;4907;1;4;62;0;38;37;1
0663;45;4833;1;45;1151;0;607;590;17
0663;46;4883;1;46;1144;0;523;511;12
0663;47;4960;1;47;774;0;363;357;6
0663;48;4892;1;48;1266;0;552;525;27
0663;49;4827;1;49;1120;0;500;493;7
0663;50;4904;1;50;1283;0;588;574;14
0663;51;4820;1;51;1339;0;616;603;13
0663;52;4858;1;52;2107;0;1035;1009;26
0663;53;4788;1;53;1930;0;847;824;23
0663;54;4972;1;54;2143;0;1037;1015;22
0663;5;4779;1;5;313;0;74;70;4
0663;55;4974;1;55;2016;0;862;844;18
0663;56;4864;1;56;2217;879;879;857;22
0663;57;4878;1;57;2031;0;851;838;13
0663;58;4920;1;58;2144;0;802;782;20
0663;59;4815;1;59;1611;0;707;690;17
0663;60;4929;1;60;1084;0;464;453;11
0663;61;4805;1;61;2205;0;853;830;23
0663;62;4914;1;62;2088;0;879;856;23
0663;63;4785;1;63;1850;0;774;756;18
0663;64;4928;1;64;1480;0;583;565;18
0663;6;4855;1;6;795;0;247;229;18
0663;65;4957;1;65;1765;0;755;736;19
0663;66;4876;1;66;1888;0;664;653;11
0663;67;4913;1;67;2035;0;815;792;23
0663;68;4857;1;68;1880;0;811;736;75
0663;69;4919;1;69;1347;0;627;614;13
0663;70;4797;1;70;1150;0;482;474;8
0663;71;4814;1;71;862;0;386;375;11
0663;72;4837;1;72;2031;0;828;803;25
0663;73;4916;1;73;1346;0;606;588;18
0663;74;4825;1;74;1028;0;472;456;16
0663;7;4927;1;7;807;0;215;210;5
0663;75;4816;1;75;2168;0;809;777;32
0663;76;4938;1;76;1006;0;421;403;18
0663;77;4819;1;77;1504;0;555;539;16
0663;78;4870;1;78;1400;1;698;681;17
0663;79;4888;1;79;1859;0;1044;1013;31
0663;80;4780;1;80;84;0;45;39;6
0663;81;4863;1;81;2207;0;909;896;13
0663;82;4829;1;82;1964;0;744;725;19
0663;83;4791;1;83;2179;0;1119;1076;43
0663;84;4886;1;84;1061;0;536;517;19
0663;8;4946;1;8;946;1;295;289;6
0663;85;4882;1;85;1654;0;840;821;19
0663;86;4792;1;86;1735;0;888;864;24
0663;87;4782;1;87;917;0;418;412;6
0663;88;4796;1;88;1499;0;614;576;38
0663;89;4918;1;89;1034;0;476;454;22
0663;90;4778;1;90;1916;0;935;910;25
0663;91;4789;1;91;1713;0;784;756;28
0663;92;4941;1;92;1956;0;912;888;24
0663;93;4862;1;93;1760;0;672;664;8
0663;94;4895;1;94;1187;0;442;433;9
0663;9;4847;1;9;974;0;423;411;12
0663;95;4926;1;95;1862;0;819;805;14
0663;96;4807;1;96;2113;0;977;958;19
0663;97;4861;1;97;1584;0;619;592;27
0663;98;4845;1;98;1686;1;692;673;19
0663;99;4981;1;99;1819;0;713;690;23
0664;10;4995;5;10;2390;0;863;805;58
0664;11;4999;5;11;1791;0;747;703;44
0664;12;5010;5;12;2277;2;918;858;60
0664;13;5017;5;13;2054;0;758;721;37
0664;14;4997;5;14;1656;0;575;525;50
0664;1;5015;5;1;1659;0;486;461;25
0664;15;5004;5;15;1131;0;496;471;25
0664;16;5019;5;16;2349;0;854;802;52
0664;17;4996;5;17;2302;0;917;867;50
0664;18;5007;5;18;2355;2;900;848;52
0664;19;4998;5;19;1868;0;797;723;74
0664;20;5009;5;20;990;0;377;353;24
0664;21;5013;5;21;705;0;301;278;23
0664;22;5014;5;22;1893;0;792;749;43
0664;23;5012;5;23;2273;0;866;801;65
0664;24;5018;5;24;2425;0;798;755;43
0664;2;4989;5;2;1281;3;487;458;29
0664;25;5005;5;25;2450;0;798;748;50
0664;26;5002;5;26;1917;0;748;712;36
0664;27;4988;5;27;1848;0;620;585;35
0664;28;4994;5;28;2229;0;819;761;58
0664;29;4991;5;29;48;0;24;23;1
0664;30;5006;5;30;26;0;18;16;2
0664;31;4993;5;31;44;0;12;10;2
0664;32;5000;5;32;68;0;14;12;2
0664;3;5008;5;3;1776;0;771;716;55
0664;4;4992;5;4;1947;0;857;814;43
0664;5;4990;5;5;1704;0;691;649;42
0664;6;5011;5;6;1963;1;780;742;38
0664;7;5003;5;7;1835;0;667;632;35
0664;8;5016;5;8;2372;0;1016;825;191
0664;9;5001;5;9;2385;0;916;873;43
0801;10;5020;1;10;370;0;152;145;7
0801;10;5054;1;10;15;0;6;5;1
0801;11;5036;1;11;61;0;7;7;0
0801;11;5049;1;11;52;0;46;40;6
0801;1;5028;1;1;1912;0;929;827;102
0801;1;5029;1;1;1936;0;875;749;126
0801;1;5035;1;1;1025;0;438;389;49
0801;1;5039;1;1;1966;0;754;611;143
0801;1;5057;1;1;657;0;368;321;47
0801;1;5058;1;1;1730;0;928;805;123
0801;1;5059;1;1;1504;0;687;628;59
0801;2;5025;1;2;833;0;379;250;129
0801;2;5027;1;2;1291;0;584;507;77
0801;2;5032;1;2;932;0;492;429;63
0801;2;5048;1;2;1440;0;586;586;0
0801;2;5060;1;2;1177;0;723;618;105
0801;2;5061;1;2;2177;0;827;706;121
0801;2;5069;1;2;841;0;249;206;43
0801;3;5030;1;3;900;0;352;294;58
0801;3;5034;1;3;657;0;351;298;53
0801;3;5041;1;3;897;0;457;386;71
0801;3;5045;1;3;1240;0;555;476;79
0801;3;5046;1;3;2199;0;866;762;104
0801;3;5051;1;3;1477;0;591;476;115
0801;3;5053;1;3;186;0;108;90;18
0801;4;5031;1;4;1154;0;446;368;78
0801;4;5042;1;4;467;0;249;214;35
0801;4;5052;1;4;1677;1;710;584;126
0801;4;5062;1;4;2003;0;809;662;147
0801;4;5063;1;4;737;0;363;305;58
0801;4;5066;1;4;832;0;417;347;70
0801;4;5068;1;4;771;0;239;215;24
0801;5;5022;1;5;488;0;243;198;45
0801;5;5037;1;5;345;0;145;128;17
0801;5;5040;1;5;785;0;267;267;0
0801;5;5044;1;5;2239;1;958;830;128
0801;5;5050;1;5;610;0;320;250;70
0801;5;5065;1;5;691;0;231;189;42
0801;6;5024;1;6;1520;0;628;491;137
0801;6;5026;1;6;1192;0;558;482;76
0801;6;5033;1;6;530;0;189;168;21
0801;6;5038;1;6;581;0;377;333;44
0801;6;5055;1;6;1371;0;596;512;84
0801;7;5021;1;7;838;0;355;315;40
0801;7;5043;1;7;748;0;393;361;32
0801;7;5064;1;7;1704;0;774;679;95
0801;7;5071;1;7;545;0;267;205;62
0801;8;5056;1;8;220;0;128;97;31
0801;8;5067;1;8;507;0;194;141;53
0801;8;5070;1;8;990;0;459;368;91
0801;9;5023;1;9;1137;0;426;354;72
0801;9;5047;1;9;996;0;322;271;51
0802;10;5085;3;10;727;0;313;255;58
0802;10;5100;3;10;10;0;4;4;0
0802;10;5101;3;10;808;0;352;294;58
0802;11;5086;3;11;402;0;245;191;54
0802;11;5111;3;11;1441;1;825;740;85
0802;12;5117;3;12;1094;0;550;451;99
0802;13;5097;3;13;9;0;3;2;1
0802;1;5074;3;1;867;0;377;303;74
0802;1;5075;3;1;1101;0;488;401;87
0802;1;5081;3;1;1336;0;804;574;230
0802;1;5082;3;1;1066;1;663;509;154
0802;1;5102;3;1;1762;1;735;644;91
0802;1;5105;3;1;390;0;218;182;36
0802;1;5107;3;1;1299;0;687;584;103
0802;2;5077;3;2;357;1;215;182;33
0802;2;5084;3;2;331;0;198;166;32
0802;2;5092;3;2;1040;0;522;470;52
0802;2;5094;3;2;804;1;358;310;48
0802;2;5108;3;2;1804;0;936;813;123
0802;2;5115;3;2;979;0;641;533;108
0802;2;5118;3;2;1016;0;538;416;122
0802;3;5076;3;3;1820;1;779;657;122
0802;3;5080;3;3;560;2;352;288;64
0802;3;5089;3;3;408;0;232;183;49
0802;3;5090;3;3;716;0;373;261;112
0802;3;5112;3;3;1724;0;852;786;66
0802;4;5078;3;4;401;0;200;160;40
0802;4;5083;3;4;1048;0;605;553;52
0802;4;5093;3;4;1224;0;493;422;71
0802;4;5103;3;4;1079;0;463;356;107
0802;5;5087;3;5;1100;0;650;517;133
0802;5;5095;3;5;2138;0;959;832;127
0802;5;5098;3;5;534;0;282;229;53
0802;5;5119;3;5;1057;0;567;475;92
0802;6;5096;3;6;389;1;231;184;47
0802;6;5099;3;6;1813;0;936;818;118
0802;6;5109;3;6;777;0;410;313;97
0802;6;5113;3;6;1202;1;431;375;56
0802;7;5072;3;7;2095;0;1167;1056;111
0802;7;5088;3;7;411;2;266;200;66
0802;7;5104;3;7;1011;0;332;282;50
0802;7;5116;3;7;61;0;51;41;10
0802;8;5091;3;8;805;0;473;390;83
0802;8;5106;3;8;450;0;276;214;62
0802;8;5114;3;8;1575;0;706;628;78
0802;9;5073;3;9;1154;0;444;369;75
0802;9;5079;3;9;1093;0;493;420;73
0802;9;5110;3;9;440;0;238;182;56
0803;10;5145;2;10;527;0;265;230;35
0803;10;5163;2;10;1397;0;623;623;0
0803;11;5130;2;11;13;0;2;0;2
0803;11;5147;2;11;813;0;418;367;51
0803;12;5124;2;12;895;0;465;398;67
0803;13;5160;2;13;989;0;546;464;82
0803;14;5165;2;14;942;0;427;355;72
0803;1;5120;2;1;1998;2;1178;1073;105
0803;1;5122;2;1;1764;0;912;751;161
0803;1;5131;2;1;1381;0;720;644;76
0803;1;5137;2;1;1206;0;630;571;59
0803;1;5138;2;1;1779;1;1039;857;182
0803;1;5139;2;1;384;0;198;165;33
0803;15;5133;2;15;743;0;331;289;42
0803;16;5125;2;16;665;0;391;310;81
0803;17;5128;2;17;47;0;13;11;2
0803;18;5148;2;18;18;0;17;15;2
0803;2;5123;2;2;848;0;514;437;77
0803;2;5129;2;2;1131;0;584;518;66
0803;2;5149;2;2;1626;0;708;594;114
0803;2;5151;2;2;1973;0;1044;866;178
0803;2;5153;2;2;1121;0;604;554;50
0803;2;5164;2;2;350;0;201;152;49
0803;3;5127;2;3;458;0;207;164;43
0803;3;5135;2;3;1706;0;915;823;92
0803;3;5144;2;3;1010;0;515;465;50
0803;3;5159;2;3;1484;0;725;669;56
0803;3;5166;2;3;2111;0;1362;1196;166
0803;4;5136;2;4;384;0;201;157;44
0803;4;5140;2;4;350;0;251;221;30
0803;4;5156;2;4;1058;0;415;368;47
0803;4;5161;2;4;690;0;370;325;45
0803;4;5168;2;4;1591;0;765;641;124
0803;5;5152;2;5;409;0;243;203;40
0803;5;5154;2;5;1740;0;857;753;104
0803;5;5158;2;5;1628;0;798;702;96
0803;5;5167;2;5;362;0;228;196;32
0803;6;5142;2;6;1910;0;919;811;108
0803;6;5143;2;6;406;0;229;190;39
0803;6;5157;2;6;57;0;53;53;0
0803;6;5162;2;6;1511;0;830;718;112
0803;7;5126;2;7;1682;0;728;621;107
0803;7;5146;2;7;47;0;31;16;15
0803;7;5155;2;7;1082;0;469;392;77
0803;8;5132;2;8;350;0;206;163;43
0803;8;5141;2;8;68;0;28;19;9
0803;8;5150;2;8;1328;0;708;646;62
0803;9;5121;2;9;217;0;96;82;14
0803;9;5134;2;9;987;0;508;480;28
0804;10;5198;5;10;1019;0;534;434;100
0804;10;5214;5;10;2235;1;1030;935;95
0804;11;5175;5;11;1070;0;349;279;70
0804;11;5188;5;11;2253;0;865;775;90
0804;12;5179;5;12;789;0;325;287;38
0804;13;5174;5;13;1702;0;657;577;80
0804;14;5172;5;14;2089;0;770;686;84
0804;1;5173;5;1;1340;1;570;481;89
0804;1;5176;5;1;1990;0;714;624;90
0804;1;5192;5;1;1515;3;780;535;245
0804;1;5200;5;1;1138;0;397;357;40
0804;1;5203;5;1;1709;0;844;685;159
0804;1;5206;5;1;2315;0;1405;1271;134
0804;1;5208;5;1;1009;5;592;456;136
0804;1;5212;5;1;2235;0;1052;955;97
0804;15;5209;5;15;1925;0;829;722;107
0804;16;5194;5;16;1874;0;928;827;101
0804;17;5201;5;17;1867;1;772;689;83
0804;18;5202;5;18;88;0;23;22;1
0804;19;5207;5;19;30;0;19;12;7
0804;2;5169;5;2;995;0;422;338;84
0804;2;5170;5;2;1079;3;514;408;106
0804;2;5171;5;2;1882;0;1026;910;116
0804;2;5177;5;2;1752;1;1136;921;215
0804;2;5178;5;2;1795;0;917;803;114
0804;2;5182;5;2;2011;0;1016;938;78
0804;2;5183;5;2;1047;0;552;475;77
0804;2;5187;5;2;2349;0;933;806;127
0804;3;5180;5;3;1343;0;579;496;83
0804;3;5190;5;3;2014;0;937;858;79
0804;3;5191;5;3;1518;0;839;628;211
0804;3;5215;5;3;521;0;256;213;43
0804;3;5217;5;3;1586;1;702;567;135
0804;4;5186;5;4;1850;0;800;685;115
0804;4;5193;5;4;561;0;240;183;57
0804;4;5204;5;4;1913;0;907;820;87
0804;4;5213;5;4;276;0;130;99;31
0804;5;5189;5;5;2058;0;1008;905;103
0804;5;5195;5;5;1228;0;578;505;73
0804;5;5196;5;5;1769;0;843;724;119
0804;5;5211;5;5;283;0;139;113;26
0804;6;5199;5;6;89;0;40;35;5
0804;6;5210;5;6;1072;0;438;396;42
0804;7;5185;5;7;2206;0;804;726;78
0804;7;5205;5;7;843;0;252;216;36
0804;8;5184;5;8;2072;0;1012;930;82
0804;8;5197;5;8;663;0;358;270;88
0804;9;5181;5;9;2082;0;994;902;92
0804;9;5216;5;9;860;0;300;234;66
0805;10;5237;2;10;969;8;592;508;84
0805;11;5236;2;11;376;0;219;187;32
0805;12;5230;2;12;851;0;483;418;65
0805;13;5226;2;13;19;0;19;18;1
0805;1;5218;2;1;1439;1;689;571;118
0805;1;5223;2;1;1525;0;748;582;166
0805;1;5227;2;1;1240;9;822;690;132
0805;1;5228;2;1;2271;1;1274;1052;222
0805;1;5246;2;1;1129;0;556;514;42
0805;2;5225;2;2;1258;5;851;671;180
0805;2;5229;2;2;680;0;307;253;54
0805;2;5239;2;2;1919;1;990;846;144
0805;2;5242;2;2;2045;2;1041;813;228
0805;2;5243;2;2;1281;0;632;588;44
0805;3;5219;2;3;1824;6;1264;985;279
0805;3;5224;2;3;989;0;535;473;62
0805;3;5231;2;3;479;0;246;168;78
0805;3;5233;2;3;509;1;214;167;47
0805;3;5235;2;3;2171;1;996;933;63
0805;4;5220;2;4;1379;1;690;587;103
0805;4;5221;2;4;881;5;583;425;158
0805;4;5222;2;4;1323;0;642;573;69
0805;4;5240;2;4;627;0;297;235;62
0805;4;5244;2;4;674;0;301;252;49
0805;5;5232;2;5;1067;1;470;424;46
0805;5;5245;2;5;2071;0;1092;830;262
0805;6;5238;2;6;1594;0;807;730;77
0805;7;5241;2;7;1477;0;779;703;76
0805;8;5234;2;8;2162;4;1033;951;82
0805;9;5247;2;9;967;0;479;418;61
0806;10;5266;1;10;638;0;140;120;20
0806;10;5279;1;10;657;0;365;309;56
0806;11;5271;1;11;606;0;226;188;38
0806;12;5275;1;12;7;0;3;3;0
0806;1;5248;1;1;768;0;326;263;63
0806;1;5252;1;1;1895;0;954;805;149
0806;1;5260;1;1;1990;0;1201;1035;166
0806;1;5273;1;1;1745;0;838;731;107
0806;1;5281;1;1;1911;0;901;786;115
0806;2;5249;1;2;1029;0;490;396;94
0806;2;5254;1;2;585;0;278;207;71
0806;2;5261;1;2;1605;0;780;655;125
0806;2;5268;1;2;2174;1;1017;889;128
0806;2;5274;1;2;2189;0;885;790;95
0806;3;5255;1;3;1358;0;724;593;131
0806;3;5257;1;3;1680;0;715;623;92
0806;3;5267;1;3;478;0;208;172;36
0806;3;5269;1;3;478;0;241;201;40
0806;3;5270;1;3;1807;1;827;714;113
0806;4;5251;1;4;297;0;138;112;26
0806;4;5258;1;4;299;0;153;117;36
0806;4;5272;1;4;634;0;268;237;31
0806;4;5280;1;4;2001;0;825;704;121
0806;4;5282;1;4;1802;0;793;708;85
0806;5;5253;1;5;2010;0;871;716;155
0806;5;5278;1;5;1958;0;1020;853;167
0806;5;5283;1;5;448;0;225;192;33
0806;6;5250;1;6;457;0;161;121;40
0806;6;5256;1;6;49;0;40;39;1
0806;6;5259;1;6;1171;0;537;430;107
0806;7;5262;1;7;1201;0;516;425;91
0806;7;5276;1;7;609;0;227;201;26
0806;8;5263;1;8;1100;0;396;328;68
0806;8;5277;1;8;523;0;240;204;36
0806;9;5264;1;9;1684;0;778;684;94
0806;9;5265;1;9;610;0;189;167;22
0807;10;5302;2;10;711;0;325;268;57
0807;11;5304;2;11;441;1;254;209;45
0807;12;5315;2;12;1085;1;523;452;71
0807;13;5305;2;13;462;0;239;211;28
0807;14;5294;2;14;8;0;6;4;2
0807;1;5285;2;1;979;0;532;450;82
0807;1;5288;2;1;2042;1;983;840;143
0807;1;5295;2;1;1555;0;998;835;163
0807;1;5310;2;1;1338;1;692;629;63
0807;1;5314;2;1;1861;1;1135;990;145
0807;15;5297;2;15;158;0;88;67;21
0807;2;5284;2;2;427;0;166;123;43
0807;2;5290;2;2;971;0;475;439;36
0807;2;5301;2;2;717;0;448;350;98
0807;2;5308;2;2;1640;0;1023;841;182
0807;2;5313;2;2;158;1;90;60;30
0807;3;5286;2;3;709;0;387;332;55
0807;3;5287;2;3;1256;0;635;587;48
0807;3;5289;2;3;251;0;134;120;14
0807;3;5300;2;3;709;0;264;199;65
0807;3;5312;2;3;1152;3;686;551;135
0807;4;5293;2;4;622;1;384;321;63
0807;4;5298;2;4;1512;2;748;680;68
0807;4;5299;2;4;480;0;216;181;35
0807;4;5309;2;4;1091;0;478;372;106
0807;5;5291;2;5;1190;3;531;456;75
0807;5;5311;2;5;367;0;177;117;60
0807;6;5303;2;6;954;1;430;388;42
0807;6;5307;2;6;785;1;313;256;57
0807;7;5296;2;7;997;0;534;484;50
0807;8;5292;2;8;920;0;471;432;39
0807;9;5306;2;9;823;0;406;341;65
0808;10;5320;2;10;2344;0;1109;1057;52
0808;11;5341;2;11;1009;0;372;336;36
0808;12;5316;2;12;910;0;332;296;36
0808;13;5325;2;13;600;0;285;245;40
0808;14;5332;2;14;952;0;388;343;45
0808;1;5326;2;1;1839;0;1234;1010;224
0808;1;5331;2;1;2087;0;1141;970;171
0808;1;5335;2;1;2223;0;901;855;46
0808;1;5342;2;1;1184;0;584;480;104
0808;1;5345;2;1;2290;2;1145;980;165
0808;1;5349;2;1;1520;0;891;677;214
0808;15;5346;2;15;692;0;236;206;30
0808;16;5340;2;16;739;0;260;224;36
0808;17;5334;2;17;1339;0;646;590;56
0808;18;5339;2;18;18;0;5;4;1
0808;2;5327;2;2;2294;1;1011;931;80
0808;2;5328;2;2;1155;0;637;471;166
0808;2;5343;2;2;1310;0;630;532;98
0808;2;5344;2;2;1815;0;926;768;158
0808;2;5347;2;2;599;0;257;191;66
0808;2;5348;2;2;891;0;458;376;82
0808;3;5317;2;3;1457;0;570;570;0
0808;3;5319;2;3;954;0;557;467;90
0808;3;5322;2;3;1064;0;535;415;120
0808;3;5333;2;3;1466;0;696;557;139
0808;3;5338;2;3;1392;0;602;561;41
0808;4;5324;2;4;70;0;30;29;1
0808;4;5336;2;4;1126;1;522;439;83
0808;4;5337;2;4;1510;0;568;530;38
0808;5;5321;2;5;1814;0;709;649;60
0808;6;5329;2;6;975;0;453;422;31
0808;7;5318;2;7;1557;0;723;667;56
0808;8;5330;2;8;1760;0;738;668;70
0808;9;5323;2;9;1728;0;734;694;40
0809;10;5354;4;10;1157;0;403;335;68
0809;11;5391;4;11;696;0;332;273;59
0809;12;5390;4;12;798;0;293;250;43
0809;13;5385;4;13;497;0;223;198;25
0809;14;5379;4;14;676;0;329;258;71
0809;1;5352;4;1;1680;1;928;798;130
0809;1;5355;4;1;1712;5;1031;905;126
0809;1;5367;4;1;2360;0;1244;1002;242
0809;1;5371;4;1;1713;1;939;683;256
0809;1;5374;4;1;2183;0;987;884;103
0809;1;5386;4;1;1129;1;634;477;157
0809;1;5387;4;1;1503;9;923;675;248
0809;1;5392;4;1;1566;0;921;799;122
0809;1;5404;4;1;1755;11;1093;945;148
0809;1;5405;4;1;2186;0;1022;884;138
0809;15;5369;4;15;602;0;172;140;32
0809;16;5397;4;16;1947;0;964;799;165
0809;17;5372;4;17;25;0;8;8;0
0809;2;5363;4;2;1850;0;896;772;124
0809;2;5364;4;2;54;0;23;12;11
0809;2;5370;4;2;931;1;552;349;203
0809;2;5388;4;2;1772;0;745;661;84
0809;2;5393;4;2;1995;0;942;836;106
0809;2;5394;4;2;2296;0;966;891;75
0809;2;5395;4;2;1499;4;890;763;127
0809;2;5398;4;2;2157;3;1264;1097;167
0809;2;5403;4;2;564;0;309;256;53
0809;2;5406;4;2;1618;0;716;625;91
0809;3;5350;4;3;2266;0;1107;984;123
0809;3;5356;4;3;664;0;400;316;84
0809;3;5357;4;3;1253;1;583;481;102
0809;3;5362;4;3;1036;0;480;383;97
0809;3;5365;4;3;632;0;355;306;49
0809;3;5377;4;3;1127;3;654;533;121
0809;3;5384;4;3;1908;0;845;750;95
0809;3;5396;4;3;275;0;171;116;55
0809;3;5400;4;3;477;0;246;174;72
0809;3;5407;4;3;730;1;440;362;78
0809;4;5353;4;4;423;0;184;146;38
0809;4;5359;4;4;1824;0;788;706;82
0809;4;5376;4;4;746;0;347;251;96
0809;4;5378;4;4;2085;0;1101;940;161
0809;4;5389;4;4;684;4;451;358;93
0809;4;5402;4;4;619;0;313;245;68
0809;5;5360;4;5;672;0;292;202;90
0809;5;5366;4;5;1027;0;353;253;100
0809;5;5380;4;5;1963;0;1015;842;173
0809;5;5381;4;5;1119;0;462;422;40
0809;5;5383;4;5;485;0;199;128;71
0809;6;5351;4;6;1835;0;1057;908;149
0809;6;5361;4;6;1084;0;502;442;60
0809;6;5368;4;6;1280;0;730;555;175
0809;6;5401;4;6;1480;0;690;623;67
0809;7;5373;4;7;418;0;223;163;60
0809;7;5382;4;7;1728;0;744;648;96
0809;7;5399;4;7;1271;0;534;487;47
0809;8;5358;4;8;2151;0;938;831;107
0809;9;5375;4;9;625;0;273;233;40
0810;10;5428;5;10;1255;0;545;498;47
0810;10;5450;5;10;1537;0;646;561;85
0810;11;5441;5;11;2253;0;1126;1042;84
0810;11;5457;5;11;1657;0;742;627;115
0810;12;5429;5;12;17;0;8;7;1
0810;12;5433;5;12;1848;0;798;695;103
0810;13;5448;5;13;1304;1;594;531;63
0810;14;5455;5;14;1242;1;537;495;42
0810;1;5413;5;1;2399;0;1016;905;111
0810;1;5415;5;1;2045;0;1000;755;245
0810;1;5416;5;1;1247;0;725;548;177
0810;1;5422;5;1;2101;2;1016;873;143
0810;1;5423;5;1;1241;0;634;518;116
0810;1;5426;5;1;909;7;457;344;113
0810;1;5446;5;1;1239;0;597;498;99
0810;1;5454;5;1;1049;0;630;495;135
0810;1;5460;5;1;713;0;264;232;32
0810;2;5418;5;2;1491;0;743;543;200
0810;2;5421;5;2;585;0;169;138;31
0810;2;5425;5;2;867;0;423;362;61
0810;2;5431;5;2;1235;0;625;456;169
0810;2;5434;5;2;912;4;452;316;136
0810;2;5436;5;2;1656;0;762;681;81
0810;2;5437;5;2;756;0;356;281;75
0810;2;5447;5;2;1025;2;536;429;107
0810;2;5451;5;2;1593;2;716;640;76
0810;3;5438;5;3;1408;0;611;496;115
0810;3;5439;5;3;972;7;510;371;139
0810;3;5440;5;3;872;0;462;380;82
0810;3;5444;5;3;954;0;566;497;69
0810;3;5445;5;3;1675;0;728;667;61
0810;3;5449;5;3;1742;0;845;755;90
0810;3;5453;5;3;1041;0;362;299;63
0810;3;5456;5;3;580;0;308;262;46
0810;4;5409;5;4;607;0;271;229;42
0810;4;5417;5;4;1215;0;606;503;103
0810;4;5442;5;4;501;0;272;223;49
0810;4;5443;5;4;1884;0;809;753;56
0810;4;5459;5;4;2326;1;1112;1012;100
0810;5;5410;5;5;1732;1;708;629;79
0810;5;5411;5;5;704;0;356;261;95
0810;5;5427;5;5;657;0;346;288;58
0810;5;5435;5;5;1186;0;590;525;65
0810;6;5414;5;6;777;0;285;250;35
0810;6;5424;5;6;1634;1;773;681;92
0810;6;5458;5;6;618;0;240;175;65
0810;6;5461;5;6;715;0;363;316;47
0810;7;5412;5;7;1180;0;518;470;48
0810;7;5432;5;7;1096;0;458;397;61
0810;7;5452;5;7;2310;0;1071;973;98
0810;8;5408;5;8;1024;0;509;448;61
0810;8;5420;5;8;1366;2;637;589;48
0810;9;5419;5;9;7;0;7;6;1
0810;9;5430;5;9;1476;0;610;521;89
0811;10;5490;3;10;131;0;39;26;13
0811;10;5496;3;10;1156;0;541;509;32
0811;11;5464;3;11;1378;0;508;450;58
0811;11;5513;3;11;15;0;15;12;3
0811;12;5489;3;12;1173;0;563;502;61
0811;12;5495;3;12;9;0;4;4;0
0811;13;5477;3;13;1433;0;561;495;66
0811;14;5474;3;14;2349;1;1150;1060;90
0811;1;5467;3;1;1770;0;934;731;203
0811;1;5472;3;1;1571;0;577;501;76
0811;1;5482;3;1;1136;0;530;438;92
0811;1;5493;3;1;2015;0;1041;838;203
0811;1;5497;3;1;2038;0;905;728;177
0811;1;5500;3;1;2155;0;775;648;127
0811;1;5504;3;1;688;0;368;294;74
0811;1;5509;3;1;2154;0;1044;881;163
0811;1;5510;3;1;1942;0;945;798;147
0811;1;5516;3;1;1706;1;963;799;164
0811;15;5463;3;15;1248;0;446;390;56
0811;16;5485;3;16;1179;0;534;488;46
0811;17;5486;3;17;2106;0;848;783;65
0811;18;5506;3;18;2046;0;793;728;65
0811;19;5517;3;19;1783;0;763;693;70
0811;20;5521;3;20;1278;0;523;478;45
0811;21;5480;3;21;19;0;13;12;1
0811;22;5503;3;22;16;0;8;8;0
0811;2;5469;3;2;403;0;180;152;28
0811;2;5478;3;2;1132;0;554;474;80
0811;2;5483;3;2;1045;0;525;360;165
0811;2;5484;3;2;639;0;285;215;70
0811;2;5488;3;2;388;0;191;145;46
0811;2;5498;3;2;1009;0;481;385;96
0811;2;5501;3;2;1268;0;449;408;41
0811;2;5508;3;2;1954;3;917;769;148
0811;2;5522;3;2;1141;0;373;321;52
0811;3;5462;3;3;987;0;549;430;119
0811;3;5471;3;3;2206;0;839;755;84
0811;3;5473;3;3;899;0;401;351;50
0811;3;5476;3;3;1539;0;668;621;47
0811;3;5492;3;3;300;0;144;108;36
0811;3;5511;3;3;1513;1;622;535;87
0811;3;5514;3;3;816;0;343;242;101
0811;4;5466;3;4;1841;1;772;693;79
0811;4;5468;3;4;958;0;463;397;66
0811;4;5479;3;4;1736;2;841;685;156
0811;4;5512;3;4;2171;0;734;661;73
0811;4;5518;3;4;831;0;429;340;89
0811;5;5465;3;5;611;0;338;286;52
0811;5;5470;3;5;887;0;353;315;38
0811;5;5507;3;5;2110;0;833;744;89
0811;5;5520;3;5;1878;0;621;538;83
0811;6;5481;3;6;1471;0;495;447;48
0811;6;5487;3;6;2148;1;760;658;102
0811;6;5502;3;6;1414;0;479;412;67
0811;7;5499;3;7;853;0;307;266;41
0811;7;5515;3;7;2070;0;923;849;74
0811;7;5523;3;7;966;0;343;282;61
0811;8;5494;3;8;1567;0;648;598;50
0811;8;5505;3;8;1695;0;629;556;73
0811;8;5519;3;8;714;0;368;325;43
0811;9;5475;3;9;952;0;394;347;47
0811;9;5491;3;9;1183;0;444;392;52
0812;10;5536;5;10;370;0;173;138;35
0812;10;5540;5;10;375;0;204;171;33
0812;11;5541;5;11;353;0;188;166;22
0812;11;5548;5;11;858;2;523;437;86
0812;12;5530;5;12;612;0;338;304;34
0812;12;5532;5;12;718;4;402;336;66
0812;13;5527;5;13;688;0;358;307;51
0812;14;5537;5;14;882;0;474;378;96
0812;1;5524;5;1;1930;0;1016;952;64
0812;1;5542;5;1;2163;1;1265;1019;246
0812;1;5552;5;1;1963;0;907;756;151
0812;15;5549;5;15;366;0;204;161;43
0812;16;5547;5;16;31;0;10;7;3
0812;2;5528;5;2;1821;0;986;820;166
0812;2;5529;5;2;1159;0;504;425;79
0812;2;5551;5;2;1200;1;660;614;46
0812;3;5534;5;3;759;2;388;356;32
0812;3;5538;5;3;1980;0;1030;870;160
0812;3;5543;5;3;695;0;352;285;67
0812;4;5525;5;4;1165;0;402;355;47
0812;4;5539;5;4;2071;3;1049;904;145
0812;5;5533;5;5;558;0;228;198;30
0812;5;5546;5;5;2013;1;1023;896;127
0812;6;5550;5;6;761;0;312;259;53
0812;6;5553;5;6;1707;1;946;837;109
0812;7;5535;5;7;861;0;422;394;28
0812;7;5545;5;7;760;0;345;285;60
0812;8;5526;5;8;522;8;361;293;68
0812;8;5554;5;8;501;0;251;220;31
0812;9;5531;5;9;635;0;349;279;70
0812;9;5544;5;9;382;0;237;196;41
0861;10;5572;1;10;1015;0;293;267;26
0861;11;5603;1;11;1188;0;491;445;46
0861;12;5618;1;12;1669;1;506;471;35
0861;13;5609;1;13;2093;0;787;741;46
0861;14;5615;1;14;1685;0;661;622;39
0861;15;5595;1;15;1552;0;559;524;35
0861;1;5564;1;1;1192;0;558;520;38
0861;16;5570;1;16;2019;0;837;780;57
0861;17;5585;1;17;2044;0;785;745;40
0861;18;5611;1;18;2006;0;767;728;39
0861;19;5614;1;19;1773;0;786;750;36
0861;20;5620;1;20;2069;0;910;871;39
0861;21;5582;1;21;1426;0;670;638;32
0861;22;5569;1;22;1508;0;555;525;30
0861;23;5610;1;23;1476;3;608;585;23
0861;24;5562;1;24;1350;0;526;506;20
0861;25;5617;1;25;788;1;349;339;10
0861;2;5568;1;2;1258;0;474;461;13
0861;26;5578;1;26;483;0;137;128;9
0861;27;5612;1;27;1223;0;403;384;19
0861;28;5596;1;28;1480;1;587;552;35
0861;29;5600;1;29;808;2;325;293;32
0861;30;5574;1;30;949;0;271;239;32
0861;31;5599;1;31;1665;0;545;516;29
0861;32;5555;1;32;1290;1;342;318;24
0861;33;5593;1;33;1593;0;412;388;24
0861;34;5606;1;34;2030;0;721;683;38
0861;35;5592;1;35;1768;0;766;725;41
0861;3;5604;1;3;1251;0;486;457;29
0861;36;5619;1;36;1811;0;768;742;26
0861;37;5591;1;37;1660;0;703;670;33
0861;38;5584;1;38;1740;0;773;739;34
0861;39;5598;1;39;1347;0;564;543;21
0861;40;5571;1;40;2077;2;805;769;36
0861;41;5581;1;41;1947;0;709;679;30
0861;42;5573;1;42;1710;0;652;616;36
0861;43;5594;1;43;1309;0;514;493;21
0861;44;5557;1;44;1395;1;548;514;34
0861;45;5590;1;45;1673;0;741;719;22
0861;4;5580;1;4;1325;0;371;350;21
0861;46;5588;1;46;1322;0;457;431;26
0861;47;5577;1;47;1150;0;442;442;0
0861;48;5556;1;48;2040;0;811;776;35
0861;49;5565;1;49;1992;0;754;712;42
0861;50;5607;1;50;1799;769;769;735;34
0861;51;5589;1;51;2066;0;781;723;58
0861;52;5576;1;52;1045;0;396;378;18
0861;53;5567;1;53;1650;1;618;582;36
0861;54;5621;1;54;2249;0;770;732;38
0861;55;5561;1;55;1804;0;743;706;37
0861;5;5560;1;5;1435;0;515;468;47
0861;56;5613;1;56;1420;0;487;456;31
0861;57;5583;1;57;2024;0;854;816;38
0861;58;5575;1;58;1249;0;442;442;0
0861;59;5566;1;59;1738;0;722;676;46
0861;60;5616;1;60;1113;0;458;430;28
0861;61;5563;1;61;1884;0;690;646;44
0861;62;5579;1;62;1927;0;836;802;34
0861;63;5559;1;63;1517;1;525;487;38
0861;64;5586;1;64;124;0;30;28;2
0861;65;5587;1;65;101;0;20;20;0
0861;6;5622;1;6;1123;0;295;255;40
0861;66;5608;1;66;82;0;23;17;6
0861;67;5605;1;67;209;0;59;47;12
0861;68;5597;1;68;63;0;12;9;3
0861;7;5601;1;7;2285;0;786;735;51
0861;8;5558;1;8;2031;1;614;575;39
0861;9;5602;1;9;1521;0;724;672;52
0862;10;5648;4;10;1845;0;895;861;34
0862;11;5665;4;11;2049;1;904;876;28
0862;12;5682;4;12;2147;0;999;935;64
0862;13;5671;4;13;1939;0;915;875;40
0862;14;5632;4;14;1987;0;1126;1084;42
0862;15;5633;4;15;1479;0;763;736;27
0862;1;5637;4;1;1439;0;637;604;33
0862;16;5635;4;16;1669;0;715;678;37
0862;17;5662;4;17;2047;0;914;875;39
0862;18;5623;4;18;1239;0;481;454;27
0862;19;5636;4;19;2045;0;807;766;41
0862;20;5658;4;20;1395;0;477;447;30
0862;21;5660;4;21;1725;1;650;628;22
0862;22;5678;4;22;1549;1;646;614;32
0862;23;5661;4;23;1711;2;834;806;28
0862;24;5631;4;24;950;0;292;279;13
0862;25;5645;4;25;883;0;318;303;15
0862;2;5647;4;2;1235;0;520;502;18
0862;26;5674;4;26;1859;0;549;507;42
0862;27;5677;4;27;1200;1;567;557;10
0862;28;5629;4;28;1871;0;786;756;30
0862;29;5630;4;29;1932;1;975;946;29
0862;30;5666;4;30;1259;0;497;475;22
0862;31;5641;4;31;1944;0;918;862;56
0862;32;5680;4;32;964;484;484;470;14
0862;33;5676;4;33;2086;0;909;860;49
0862;34;5657;4;34;1346;0;618;591;27
0862;35;5653;4;35;1883;0;762;723;39
0862;3;5625;4;3;1509;0;670;640;30
0862;36;5628;4;36;1365;0;521;493;28
0862;37;5651;4;37;1395;0;598;573;25
0862;38;5673;4;38;1092;0;449;432;17
0862;39;5644;4;39;1450;0;633;591;42
0862;40;5675;4;40;1779;1;797;761;36
0862;41;5642;4;41;1369;0;548;518;30
0862;42;5646;4;42;1573;0;780;722;58
0862;43;5659;4;43;1864;0;810;778;32
0862;44;5638;4;44;1635;0;542;514;28
0862;45;5681;4;45;1884;1;839;803;36
0862;4;5664;4;4;1991;0;904;853;51
0862;46;5668;4;46;2321;0;869;814;55
0862;47;5672;4;47;1284;0;368;338;30
0862;48;5679;4;48;1479;0;606;578;28
0862;49;5627;4;49;2327;0;1096;1035;61
0862;50;5655;4;50;1870;0;858;858;0
0862;51;5667;4;51;1951;0;852;782;70
0862;52;5654;4;52;1905;0;820;793;27
0862;53;5652;4;53;1374;0;559;533;26
0862;54;5683;4;54;62;0;30;28;2
0862;55;5663;4;55;152;0;87;66;21
0862;5;5649;4;5;1546;1;748;706;42
0862;56;5669;4;56;1511;1;668;635;33
0862;57;5656;4;57;1191;0;489;460;29
0862;58;5639;4;58;1491;0;770;741;29
0862;59;5626;4;59;1188;0;528;508;20
0862;60;5634;4;60;197;0;22;20;2
0862;61;5624;4;61;78;0;29;24;5
0862;6;5650;4;6;1480;1;709;684;25
0862;7;5670;4;7;1909;1;782;735;47
0862;8;5640;4;8;1887;0;872;826;46
0862;9;5643;4;9;1625;0;678;642;36
1001;10;5696;5;10;48;0;35;28;7
1001;10;5744;5;10;1475;0;580;524;56
1001;11;5729;5;11;2312;0;993;866;127
1001;12;5704;5;12;1580;0;804;731;73
1001;13;5716;5;13;1706;0;952;832;120
1001;14;5712;5;14;1645;0;687;632;55
1001;15;5705;5;15;2249;0;935;852;83
1001;1;5684;5;1;1413;3;863;734;129
1001;1;5687;5;1;1702;3;1058;935;123
1001;1;5698;5;1;1644;0;714;664;50
1001;1;5721;5;1;1396;0;754;591;163
1001;1;5731;5;1;1429;0;872;693;179
1001;1;5741;5;1;675;2;526;382;144
1001;1;5749;5;1;1201;4;854;684;170
1001;1;5752;5;1;1684;0;923;747;176
1001;16;5718;5;16;1630;0;734;664;70
1001;17;5723;5;17;1425;0;639;587;52
1001;18;5707;5;18;1566;0;660;605;55
1001;19;5738;5;19;1313;0;560;527;33
1001;20;5685;5;20;2001;0;830;764;66
1001;21;5720;5;21;1502;1;725;656;69
1001;22;5708;5;22;1673;0;738;673;65
1001;23;5732;5;23;2339;0;1007;915;92
1001;24;5691;5;24;2329;0;1207;1100;107
1001;25;5719;5;25;1110;2;478;430;48
1001;2;5693;5;2;1109;0;724;497;227
1001;2;5694;5;2;1942;1;1418;1056;362
1001;2;5695;5;2;1196;0;547;494;53
1001;2;5700;5;2;1594;1;1093;890;203
1001;2;5711;5;2;1564;2;766;669;97
1001;2;5713;5;2;977;5;713;617;96
1001;2;5725;5;2;502;0;330;270;60
1001;2;5747;5;2;976;0;494;398;96
1001;26;5742;5;26;1339;0;515;470;45
1001;27;5709;5;27;1374;0;580;526;54
1001;28;5688;5;28;1431;1;627;570;57
1001;29;5748;5;29;1597;0;864;808;56
1001;30;5728;5;30;1434;0;502;442;60
1001;31;5745;5;31;89;0;23;20;3
1001;32;5717;5;32;67;0;34;34;0
1001;3;5689;5;3;1143;9;834;714;120
1001;3;5697;5;3;1326;0;666;606;60
1001;3;5706;5;3;1031;0;765;509;256
1001;3;5726;5;3;871;1;485;420;65
1001;3;5735;5;3;795;1;434;366;68
1001;3;5740;5;3;1821;0;787;729;58
1001;3;5750;5;3;768;0;476;364;112
1001;3;5751;5;3;1549;0;1020;838;182
1001;4;5690;5;4;868;0;458;414;44
1001;4;5699;5;4;1281;0;705;558;147
1001;4;5703;5;4;440;0;276;239;37
1001;4;5710;5;4;926;0;624;509;115
1001;4;5722;5;4;485;2;332;275;57
1001;4;5746;5;4;1839;0;802;747;55
1001;5;5686;5;5;1075;0;409;409;0
1001;5;5701;5;5;1729;5;1011;877;134
1001;5;5702;5;5;1339;0;821;564;257
1001;5;5739;5;5;476;1;315;270;45
1001;5;5753;5;5;1064;1;570;504;66
1001;6;5715;5;6;1100;1;617;541;76
1001;6;5727;5;6;1785;1;989;850;139
1001;6;5730;5;6;1978;0;800;740;60
1001;7;5692;5;7;1376;2;687;605;82
1001;7;5714;5;7;1694;0;672;626;46
1001;7;5743;5;7;366;0;170;131;39
1001;8;5724;5;8;1473;0;585;537;48
1001;8;5734;5;8;636;0;380;348;32
1001;8;5736;5;8;1116;0;593;499;94
1001;9;5733;5;9;1882;0;734;660;74
1001;9;5737;5;9;1307;0;709;540;169
1002;10;5779;3;10;1003;3;404;342;62
1002;11;5815;3;11;1653;0;558;452;106
1002;12;5766;3;12;1990;2;864;748;116
1002;13;5814;3;13;747;0;291;237;54
1002;14;5823;3;14;1442;0;683;568;115
1002;15;5824;3;15;1952;1;829;697;132
1002;1;5759;3;1;1682;3;1038;738;300
1002;1;5773;3;1;1280;0;593;505;88
1002;1;5790;3;1;1218;1;675;487;188
1002;1;5793;3;1;1340;2;855;670;185
1002;1;5798;3;1;1625;0;912;744;168
1002;1;5800;3;1;1169;1;446;378;68
1002;1;5817;3;1;1156;0;613;452;161
1002;1;5821;3;1;526;0;221;183;38
1002;1;5826;3;1;1993;2;1082;873;209
1002;1;5829;3;1;1143;0;561;420;141
1002;1;5830;3;1;1247;0;866;680;186
1002;16;5805;3;16;1920;0;808;736;72
1002;17;5807;3;17;1586;0;720;613;107
1002;18;5789;3;18;1757;2;791;679;112
1002;19;5763;3;19;1993;0;858;777;81
1002;20;5791;3;20;1554;0;616;547;69
1002;21;5765;3;21;2238;0;879;792;87
1002;22;5808;3;22;1417;1;629;594;35
1002;23;5770;3;23;1730;0;688;615;73
1002;24;5820;3;24;1320;1;544;485;59
1002;25;5795;3;25;458;0;143;114;29
1002;2;5758;3;2;1514;0;769;683;86
1002;2;5767;3;2;1375;0;674;551;123
1002;2;5775;3;2;1011;0;489;330;159
1002;2;5782;3;2;545;0;356;263;93
1002;2;5784;3;2;627;0;330;272;58
1002;2;5792;3;2;1020;0;660;518;142
1002;2;5797;3;2;1781;0;705;603;102
1002;2;5812;3;2;1326;3;740;548;192
1002;2;5813;3;2;1056;0;546;415;131
1002;2;5828;3;2;724;1;291;212;79
1002;26;5781;3;26;88;0;55;41;14
1002;27;5825;3;27;62;0;36;24;12
1002;28;5783;3;28;69;0;42;40;2
1002;29;5754;3;29;78;0;32;27;5
1002;3;5757;3;3;44;0;32;25;7
1002;3;5760;3;3;507;0;223;176;47
1002;3;5761;3;3;945;0;544;423;121
1002;3;5778;3;3;2051;1;856;856;0
1002;3;5786;3;3;479;0;209;166;43
1002;3;5796;3;3;613;0;331;282;49
1002;3;5803;3;3;652;0;382;318;64
1002;3;5811;3;3;2162;3;1136;844;292
1002;3;5819;3;3;733;0;375;265;110
1002;4;5769;3;4;769;0;409;346;63
1002;4;5772;3;4;924;0;478;423;55
1002;4;5774;3;4;1623;0;806;644;162
1002;4;5794;3;4;394;1;223;167;56
1002;4;5802;3;4;2215;1;1138;908;230
1002;4;5806;3;4;456;0;280;225;55
1002;4;5810;3;4;766;0;199;179;20
1002;4;5827;3;4;1211;0;552;482;70
1002;5;5771;3;5;1429;0;662;523;139
1002;5;5776;3;5;1413;0;518;427;91
1002;5;5785;3;5;1353;1;657;575;82
1002;5;5799;3;5;631;0;309;252;57
1002;5;5818;3;5;603;1;327;255;72
1002;6;5755;3;6;61;0;30;21;9
1002;6;5762;3;6;480;0;236;188;48
1002;6;5777;3;6;525;0;243;202;41
1002;6;5788;3;6;1474;0;532;450;82
1002;6;5801;3;6;1734;3;773;666;107
1002;7;5764;3;7;83;0;45;32;13
1002;7;5787;3;7;956;1;419;318;101
1002;7;5804;3;7;1716;1;747;645;102
1002;7;5809;3;7;320;0;162;134;28
1002;7;5816;3;7;782;0;287;245;42
1002;8;5756;3;8;717;0;356;300;56
1002;8;5780;3;8;1846;0;764;688;76
1002;8;5822;3;8;609;0;237;172;65
1002;9;5768;3;9;1585;1;717;616;101
1003;10;5848;4;10;1141;0;487;417;70
1003;11;5831;4;11;488;0;258;197;61
1003;12;5842;4;12;760;0;336;234;102
1003;13;5836;4;13;772;0;362;319;43
1003;14;5851;4;14;1202;0;617;530;87
1003;15;5869;4;15;329;0;149;114;35
1003;1;5834;4;1;1880;0;1032;833;199
1003;1;5837;4;1;1270;9;846;683;163
1003;1;5846;4;1;1402;7;926;763;163
1003;1;5857;4;1;920;0;514;446;68
1003;1;5865;4;1;1681;0;865;779;86
1003;16;5855;4;16;2044;0;933;753;180
1003;17;5847;4;17;1231;2;612;495;117
1003;18;5833;4;18;102;0;37;31;6
1003;2;5840;4;2;1164;3;736;625;111
1003;2;5853;4;2;568;0;219;162;57
1003;2;5856;4;2;443;0;213;176;37
1003;2;5860;4;2;806;2;538;466;72
1003;2;5861;4;2;1090;0;483;430;53
1003;3;5835;4;3;631;0;273;208;65
1003;3;5849;4;3;1239;1;618;521;97
1003;3;5859;4;3;1583;0;738;629;109
1003;3;5868;4;3;1035;2;607;473;134
1003;4;5839;4;4;877;5;550;418;132
1003;4;5850;4;4;1798;0;881;770;111
1003;4;5854;4;4;591;0;281;241;40
1003;4;5866;4;4;435;0;222;162;60
1003;5;5832;4;5;481;0;231;178;53
1003;5;5838;4;5;1724;0;929;831;98
1003;5;5864;4;5;482;9;306;236;70
1003;5;5867;4;5;382;0;233;198;35
1003;6;5841;4;6;2007;0;1003;882;121
1003;6;5845;4;6;611;4;348;277;71
1003;6;5858;4;6;816;0;428;365;63
1003;7;5843;4;7;1559;0;724;627;97
1003;7;5852;4;7;1394;5;1031;840;191
1003;7;5862;4;7;860;0;436;365;71
1003;8;5863;4;8;1974;0;786;678;108
1003;9;5844;4;9;1790;0;901;794;107
1004;10;5880;3;10;33;0;14;12;2
1004;11;5897;3;11;46;0;33;18;15
1004;1;5881;3;1;1838;2;986;776;210
1004;1;5882;3;1;1751;0;1192;890;302
1004;1;5883;3;1;765;0;401;341;60
1004;1;5908;3;1;324;0;168;117;51
1004;1;5910;3;1;525;1;303;233;70
1004;1;5912;3;1;760;0;428;335;93
1004;1;5913;3;1;771;1;439;368;71
1004;1;5915;3;1;1426;0;639;571;68
1004;2;5870;3;2;1469;0;817;614;203
1004;2;5896;3;2;623;1;353;268;85
1004;2;5898;3;2;1410;2;858;761;97
1004;2;5899;3;2;1334;0;744;575;169
1004;2;5905;3;2;1456;0;791;715;76
1004;2;5907;3;2;1595;0;781;599;182
1004;2;5909;3;2;1113;1;513;407;106
1004;2;5911;3;2;886;0;407;364;43
1004;3;5875;3;3;343;0;169;138;31
1004;3;5884;3;3;938;0;368;298;70
1004;3;5885;3;3;1035;0;485;425;60
1004;3;5892;3;3;905;0;421;322;99
1004;3;5900;3;3;1454;0;682;536;146
1004;3;5903;3;3;279;1;146;130;16
1004;3;5904;3;3;428;0;247;188;59
1004;4;5871;3;4;736;0;352;265;87
1004;4;5872;3;4;736;2;410;348;62
1004;4;5888;3;4;671;0;397;340;57
1004;4;5893;3;4;438;0;219;168;51
1004;4;5894;3;4;653;1;324;240;84
1004;4;5895;3;4;957;0;440;369;71
1004;4;5906;3;4;499;2;267;237;30
1004;5;5874;3;5;1414;1;774;611;163
1004;5;5876;3;5;441;0;147;110;37
1004;5;5879;3;5;637;1;352;286;66
1004;5;5902;3;5;1736;0;939;767;172
1004;5;5916;3;5;310;0;199;175;24
1004;6;5877;3;6;1966;3;1156;1037;119
1004;6;5890;3;6;35;0;19;10;9
1004;6;5891;3;6;1071;1;611;473;138
1004;6;5901;3;6;943;0;403;346;57
1004;7;5878;3;7;676;0;389;319;70
1004;7;5886;3;7;410;0;205;158;47
1004;7;5889;3;7;1680;3;895;768;127
1004;8;5887;3;8;993;0;464;384;80
1004;8;5914;3;8;1782;0;885;763;122
1004;9;5873;3;9;853;0;389;312;77
1005;10;5966;3;10;1366;0;629;568;61
1005;11;5927;3;11;1864;0;914;808;106
1005;12;5923;3;12;1383;1;673;565;108
1005;13;5972;3;13;1241;1;600;510;90
1005;14;5955;3;14;2005;0;954;834;120
1005;15;5922;3;15;1503;0;699;640;59
1005;1;5917;3;1;1318;6;769;670;99
1005;1;5918;3;1;1880;0;821;727;94
1005;1;5928;3;1;1502;0;850;700;150
1005;1;5932;3;1;1858;0;723;669;54
1005;1;5942;3;1;463;0;189;173;16
1005;1;5943;3;1;1573;0;684;541;143
1005;1;5948;3;1;1748;0;931;762;169
1005;1;5949;3;1;1062;0;365;328;37
1005;1;5952;3;1;1361;0;644;555;89
1005;1;5961;3;1;753;0;367;324;43
1005;16;5977;3;16;1883;0;891;786;105
1005;17;5946;3;17;27;0;11;9;2
1005;18;5973;3;18;37;0;35;24;11
1005;2;5920;3;2;1249;0;498;409;89
1005;2;5934;3;2;1345;0;527;421;106
1005;2;5936;3;2;439;0;166;135;31
1005;2;5941;3;2;662;0;154;137;17
1005;2;5947;3;2;809;1;402;358;44
1005;2;5950;3;2;987;0;302;258;44
1005;2;5962;3;2;1306;1;669;543;126
1005;2;5964;3;2;749;0;383;289;94
1005;2;5965;3;2;858;0;306;258;48
1005;2;5968;3;2;743;0;263;249;14
1005;3;5926;3;3;1001;0;501;422;79
1005;3;5930;3;3;647;0;327;275;52
1005;3;5935;3;3;1450;0;559;477;82
1005;3;5939;3;3;753;0;356;322;34
1005;3;5953;3;3;1325;0;520;414;106
1005;3;5960;3;3;471;0;205;167;38
1005;3;5969;3;3;679;0;328;240;88
1005;3;5970;3;3;946;0;431;369;62
1005;3;5971;3;3;1036;0;509;445;64
1005;3;5975;3;3;355;0;184;164;20
1005;4;5924;3;4;873;0;354;328;26
1005;4;5931;3;4;936;0;373;343;30
1005;4;5958;3;4;1517;0;762;689;73
1005;4;5967;3;4;1067;0;359;296;63
1005;4;5974;3;4;768;1;454;419;35
1005;4;5979;3;4;766;0;305;261;44
1005;5;5940;3;5;1321;0;618;546;72
1005;5;5944;3;5;917;0;349;301;48
1005;5;5956;3;5;1015;0;366;280;86
1005;5;5959;3;5;604;0;288;257;31
1005;5;5980;3;5;496;0;154;130;24
1005;6;5921;3;6;406;0;172;134;38
1005;6;5937;3;6;565;0;326;269;57
1005;6;5945;3;6;908;0;389;334;55
1005;6;5954;3;6;951;0;308;239;69
1005;6;5957;3;6;2008;2;903;777;126
1005;7;5925;3;7;606;0;184;151;33
1005;7;5929;3;7;1663;0;781;649;132
1005;7;5933;3;7;74;0;37;25;12
1005;7;5951;3;7;1607;0;676;564;112
1005;7;5976;3;7;512;0;272;230;42
1005;8;5919;3;8;381;0;134;112;22
1005;8;5963;3;8;1869;0;876;763;113
1005;8;5978;3;8;547;0;166;119;47
1005;9;5938;3;9;1273;0;568;509;59
1006;10;5999;5;10;2257;0;1173;1007;166
1006;10;6028;5;10;16;0;11;6;5
1006;11;6003;5;11;2011;0;1031;910;121
1006;12;6014;5;12;456;0;262;218;44
1006;13;5985;5;13;457;0;266;227;39
1006;14;6021;5;14;347;1;173;140;33
1006;15;5989;5;15;248;0;162;138;24
1006;1;5988;5;1;1999;1;888;765;123
1006;1;5990;5;1;1733;0;748;615;133
1006;1;5995;5;1;1346;1;805;732;73
1006;1;6010;5;1;758;0;480;426;54
1006;1;6012;5;1;1431;0;706;585;121
1006;1;6025;5;1;1474;0;852;730;122
1006;16;6026;5;16;839;0;428;383;45
1006;17;5994;5;17;265;0;154;127;27
1006;18;5996;5;18;40;0;34;34;0
1006;2;5981;5;2;1295;1;565;471;94
1006;2;5991;5;2;1456;1;781;699;82
1006;2;6013;5;2;1395;0;902;757;145
1006;2;6022;5;2;1885;0;912;757;155
1006;2;6030;5;2;959;0;455;395;60
1006;2;6031;5;2;1075;0;584;494;90
1006;3;5984;5;3;776;1;483;417;66
1006;3;5987;5;3;1295;0;586;487;99
1006;3;6000;5;3;1113;2;563;479;84
1006;3;6001;5;3;1969;0;1092;934;158
1006;3;6008;5;3;1335;0;464;394;70
1006;3;6019;5;3;591;0;285;226;59
1006;4;5993;5;4;354;0;185;167;18
1006;4;5998;5;4;1293;0;543;469;74
1006;4;6009;5;4;1589;0;627;536;91
1006;4;6020;5;4;706;0;407;347;60
1006;4;6029;5;4;1215;0;666;568;98
1006;5;6015;5;5;1048;0;457;377;80
1006;5;6016;5;5;1812;0;748;660;88
1006;5;6018;5;5;2111;0;1233;1048;185
1006;5;6023;5;5;548;1;317;276;41
1006;6;5982;5;6;1896;0;1038;834;204
1006;6;6004;5;6;703;0;332;305;27
1006;6;6006;5;6;1062;0;443;364;79
1006;6;6017;5;6;555;0;337;263;74
1006;7;5983;5;7;466;0;167;146;21
1006;7;5997;5;7;708;0;332;297;35
1006;7;6005;5;7;1341;1;733;612;121
1006;7;6011;5;7;550;0;232;184;48
1006;8;5992;5;8;342;0;147;117;30
1006;8;6024;5;8;2105;7;991;837;154
1006;8;6027;5;8;637;0;285;249;36
1006;9;5986;5;9;1418;0;651;558;93
1006;9;6002;5;9;673;0;298;253;45
1006;9;6007;5;9;82;0;74;74;0
1007;10;6042;6;10;50;0;35;28;7
1007;10;6097;6;10;467;0;304;273;31
1007;11;6041;6;11;2304;0;1298;1188;110
1007;12;6057;6;12;2192;1;1378;1245;133
1007;13;6056;6;13;1701;0;979;890;89
1007;14;6052;6;14;1696;0;984;861;123
1007;15;6077;6;15;1566;0;870;794;76
1007;1;6038;6;1;1071;0;674;577;97
1007;1;6046;6;1;1397;0;852;747;105
1007;1;6058;6;1;1579;3;1003;900;103
1007;1;6064;6;1;1750;0;1311;1225;86
1007;1;6066;6;1;2317;9;1608;1398;210
1007;1;6073;6;1;1187;1;715;654;61
1007;1;6074;6;1;1154;0;736;691;45
1007;1;6076;6;1;1489;4;1014;899;115
1007;16;6040;6;16;576;0;406;355;51
1007;17;6037;6;17;1646;1;993;939;54
1007;18;6048;6;18;1418;2;808;719;89
1007;19;6090;6;19;2052;0;1161;1050;111
1007;20;6092;6;20;705;0;379;332;47
1007;21;6045;6;21;582;0;347;317;30
1007;22;6071;6;22;979;0;602;526;76
1007;23;6067;6;23;643;0;334;298;36
1007;24;6098;6;24;525;0;361;328;33
1007;25;6083;6;25;18;0;18;17;1
1007;2;6034;6;2;500;0;293;244;49
1007;2;6043;6;2;1856;3;1181;966;215
1007;2;6051;6;2;377;0;220;184;36
1007;2;6059;6;2;1316;1;823;755;68
1007;2;6065;6;2;365;0;146;130;16
1007;2;6070;6;2;758;0;461;408;53
1007;2;6079;6;2;530;0;364;320;44
1007;2;6089;6;2;894;0;515;440;75
1007;3;6033;6;3;1768;0;1026;904;122
1007;3;6047;6;3;1081;0;651;531;120
1007;3;6050;6;3;933;0;528;455;73
1007;3;6053;6;3;915;0;652;582;70
1007;3;6055;6;3;785;0;454;354;100
1007;3;6078;6;3;1806;3;1087;990;97
1007;3;6084;6;3;857;3;450;390;60
1007;3;6093;6;3;644;0;450;363;87
1007;4;6039;6;4;953;1;539;434;105
1007;4;6063;6;4;352;0;231;200;31
1007;4;6080;6;4;920;0;634;572;62
1007;4;6081;6;4;328;0;212;180;32
1007;4;6085;6;4;750;1;471;374;97
1007;4;6086;6;4;356;0;265;216;49
1007;4;6087;6;4;504;0;344;298;46
1007;4;6094;6;4;453;0;289;233;56
1007;5;6032;6;5;447;0;302;272;30
1007;5;6036;6;5;800;0;548;495;53
1007;5;6049;6;5;40;0;26;16;10
1007;5;6054;6;5;850;0;492;435;57
1007;5;6075;6;5;554;0;358;296;62
1007;6;6044;6;6;767;0;470;435;35
1007;6;6068;6;6;595;1;382;323;59
1007;6;6072;6;6;765;0;549;484;65
1007;6;6088;6;6;617;1;395;350;45
1007;7;6035;6;7;420;0;229;199;30
1007;7;6091;6;7;788;0;529;468;61
1007;7;6096;6;7;1066;1;728;664;64
1007;8;6061;6;8;1516;9;1027;945;82
1007;8;6082;6;8;826;0;520;469;51
1007;8;6095;6;8;973;0;683;547;136
1007;9;6060;6;9;542;3;370;302;68
1007;9;6062;6;9;383;0;248;222;26
1007;9;6069;6;9;617;0;382;349;33
1008;10;6110;4;10;1381;0;734;663;71
1008;10;6159;4;10;1638;0;720;664;56
1008;11;6104;4;11;113;0;8;5;3
1008;11;6111;4;11;1747;0;726;674;52
1008;12;6150;4;12;1332;0;617;574;43
1008;13;6121;4;13;1092;0;497;459;38
1008;14;6135;4;14;1758;0;792;738;54
1008;15;6140;4;15;1998;1;816;757;59
1008;1;6107;4;1;1216;0;715;647;68
1008;1;6113;4;1;1562;2;836;643;193
1008;1;6119;4;1;1133;4;625;570;55
1008;1;6124;4;1;2441;3;1438;1286;152
1008;1;6128;4;1;1554;1;850;711;139
1008;1;6144;4;1;970;0;522;458;64
1008;1;6157;4;1;2289;0;958;889;69
1008;16;6132;4;16;1445;1;602;542;60
1008;17;6160;4;17;2213;0;917;848;69
1008;18;6118;4;18;1239;1;463;431;32
1008;19;6155;4;19;1376;0;579;531;48
1008;20;6143;4;20;1611;1;488;438;50
1008;21;6102;4;21;1612;1;438;398;40
1008;22;6154;4;22;1771;0;582;532;50
1008;23;6126;4;23;2044;1;680;613;67
1008;24;6117;4;24;2097;0;839;784;55
1008;25;6133;4;25;785;0;283;263;20
1008;2;6109;4;2;874;0;510;464;46
1008;2;6114;4;2;811;3;497;385;112
1008;2;6139;4;2;1664;3;893;785;108
1008;2;6145;4;2;992;0;534;460;74
1008;2;6148;4;2;874;1;456;405;51
1008;2;6164;4;2;1482;0;705;600;105
1008;2;6166;4;2;2196;0;709;647;62
1008;26;6131;4;26;2064;0;867;815;52
1008;27;6112;4;27;1967;0;806;752;54
1008;28;6152;4;28;2215;0;895;826;69
1008;29;6163;4;29;2181;0;850;778;72
1008;30;6123;4;30;2022;0;800;745;55
1008;31;6116;4;31;2112;0;767;714;53
1008;32;6120;4;32;2207;1;836;778;58
1008;33;6105;4;33;1231;0;426;390;36
1008;34;6134;4;34;67;0;30;25;5
1008;35;6153;4;35;299;0;13;12;1
1008;3;6103;4;3;1250;3;711;621;90
1008;3;6115;4;3;591;4;349;294;55
1008;3;6129;4;3;1446;0;505;461;44
1008;3;6141;4;3;1034;2;507;394;113
1008;3;6142;4;3;1276;3;726;670;56
1008;3;6151;4;3;2123;1;1059;939;120
1008;3;6156;4;3;1528;0;705;630;75
1008;4;6100;4;4;745;6;399;335;64
1008;4;6108;4;4;600;0;291;258;33
1008;4;6137;4;4;1565;0;910;833;77
1008;4;6149;4;4;1536;1;838;779;59
1008;4;6162;4;4;741;0;360;309;51
1008;4;6165;4;4;1661;1;620;577;43
1008;5;6099;4;5;1369;2;684;619;65
1008;5;6130;4;5;948;0;409;360;49
1008;5;6136;4;5;929;0;498;434;64
1008;5;6147;4;5;1221;0;371;338;33
1008;6;6138;4;6;722;0;371;326;45
1008;6;6146;4;6;2128;0;1160;1046;114
1008;6;6161;4;6;1406;1;379;348;31
1008;7;6106;4;7;2312;0;797;748;49
1008;7;6122;4;7;1561;1;842;712;130
1008;8;6101;4;8;1747;0;661;605;56
1008;8;6127;4;8;2187;0;1172;1036;136
1008;9;6125;4;9;1430;1;637;593;44
1008;9;6158;4;9;584;0;287;256;31
1009;10;6194;4;10;616;2;481;343;138
1009;1;6167;4;1;1525;0;928;732;196
1009;1;6168;4;1;1811;0;1117;897;220
1009;1;6176;4;1;2060;1;1076;949;127
1009;1;6179;4;1;1497;11;921;741;180
1009;1;6183;4;1;2089;19;1611;1245;366
1009;1;6197;4;1;1501;16;1218;958;260
1009;1;6201;4;1;764;0;472;390;82
1009;1;6203;4;1;1001;3;720;533;187
1009;2;6169;4;2;1311;0;667;537;130
1009;2;6173;4;2;1559;1;960;817;143
1009;2;6185;4;2;596;5;443;355;88
1009;2;6189;4;2;768;1;581;477;104
1009;2;6191;4;2;702;0;447;365;82
1009;2;6195;4;2;1188;0;536;517;19
1009;2;6198;4;2;612;0;336;267;69
1009;2;6200;4;2;1566;7;892;738;154
1009;3;6170;4;3;1842;1;1281;999;282
1009;3;6171;4;3;784;0;438;359;79
1009;3;6177;4;3;880;10;644;512;132
1009;3;6182;4;3;1022;2;714;557;157
1009;3;6188;4;3;2037;2;1068;902;166
1009;3;6190;4;3;367;5;292;268;24
1009;3;6199;4;3;2065;2;1154;932;222
1009;3;6202;4;3;959;5;499;361;138
1009;4;6172;4;4;770;2;493;405;88
1009;4;6178;4;4;354;3;282;232;50
1009;4;6184;4;4;754;1;430;289;141
1009;4;6186;4;4;557;0;335;272;63
1009;4;6193;4;4;1898;4;946;861;85
1009;4;6205;4;4;2001;0;1184;1025;159
1009;5;6174;4;5;889;3;708;582;126
1009;5;6181;4;5;392;1;241;200;41
1009;5;6187;4;5;2039;7;1131;956;175
1009;6;6175;4;6;6;0;5;5;0
1009;6;6196;4;6;349;6;254;196;58
1009;7;6180;4;7;685;2;530;414;116
1009;8;6204;4;8;670;3;495;418;77
1009;9;6192;4;9;777;1;454;356;98
1010;10;6231;5;10;959;0;482;426;56
1010;1;6213;5;1;714;0;494;396;98
1010;1;6220;5;1;403;0;280;197;83
1010;1;6224;5;1;1806;0;1051;849;202
1010;1;6230;5;1;1919;3;1194;1079;115
1010;1;6237;5;1;1837;0;1128;949;179
1010;1;6241;5;1;1127;0;719;575;144
1010;1;6248;5;1;942;0;487;406;81
1010;1;6249;5;1;1918;0;1002;809;193
1010;1;6265;5;1;1059;7;765;567;198
1010;1;6267;5;1;2169;3;1233;1050;183
1010;1;6269;5;1;1350;0;776;679;97
1010;2;6207;5;2;1206;3;820;661;159
1010;2;6214;5;2;1612;3;968;781;187
1010;2;6219;5;2;1315;0;647;583;64
1010;2;6228;5;2;1128;0;545;464;81
1010;2;6232;5;2;388;0;243;213;30
1010;2;6233;5;2;958;1;696;509;187
1010;2;6236;5;2;1214;0;580;454;126
1010;2;6243;5;2;818;0;386;319;67
1010;2;6244;5;2;1827;0;865;750;115
1010;2;6252;5;2;1304;0;674;615;59
1010;2;6253;5;2;1924;6;1332;1160;172
1010;3;6215;5;3;510;0;199;164;35
1010;3;6216;5;3;405;0;268;228;40
1010;3;6217;5;3;1247;0;587;522;65
1010;3;6218;5;3;465;1;289;233;56
1010;3;6221;5;3;835;0;377;336;41
1010;3;6222;5;3;1310;1;838;686;152
1010;3;6239;5;3;1309;0;625;540;85
1010;3;6246;5;3;559;3;393;277;116
1010;3;6256;5;3;673;7;379;330;49
1010;3;6263;5;3;809;3;472;393;79
1010;3;6270;5;3;665;0;436;339;97
1010;4;6223;5;4;1277;8;714;518;196
1010;4;6225;5;4;1360;4;929;831;98
1010;4;6226;5;4;1404;1;662;617;45
1010;4;6229;5;4;1135;1;597;544;53
1010;4;6235;5;4;387;0;141;106;35
1010;4;6245;5;4;555;4;406;292;114
1010;4;6258;5;4;546;0;303;251;52
1010;4;6259;5;4;962;0;423;359;64
1010;5;6238;5;5;1209;0;689;594;95
1010;5;6240;5;5;597;0;410;318;92
1010;5;6247;5;5;1252;0;725;612;113
1010;5;6250;5;5;2243;0;1069;912;157
1010;5;6251;5;5;1732;5;861;742;119
1010;5;6260;5;5;1235;1;622;534;88
1010;5;6261;5;5;1427;2;974;847;127
1010;5;6262;5;5;903;0;408;361;47
1010;6;6208;5;6;1855;0;951;780;171
1010;6;6211;5;6;1359;0;689;595;94
1010;6;6212;5;6;1037;0;628;494;134
1010;6;6254;5;6;810;0;403;348;55
1010;6;6271;5;6;515;0;281;232;49
1010;7;6206;5;7;1177;0;674;589;85
1010;7;6209;5;7;505;0;313;268;45
1010;7;6210;5;7;706;0;394;334;60
1010;7;6257;5;7;1538;0;774;700;74
1010;7;6264;5;7;1147;0;674;590;84
1010;8;6255;5;8;941;11;634;474;160
1010;8;6266;5;8;1139;0;577;532;45
1010;8;6268;5;8;774;0;422;336;86
1010;9;6227;5;9;950;2;640;522;118
1010;9;6234;5;9;921;0;544;480;64
1010;9;6242;5;9;66;0;54;42;12
1011;10;6284;4;10;71;0;24;13;11
1011;10;6294;4;10;661;0;320;250;70
1011;11;6281;4;11;480;0;245;177;68
1011;12;6280;4;12;635;9;338;274;64
1011;13;6279;4;13;412;4;227;155;72
1011;14;6295;4;14;371;0;127;118;9
1011;15;6306;4;15;526;0;254;207;47
1011;1;6276;4;1;1871;0;995;852;143
1011;1;6300;4;1;1359;2;817;658;159
1011;1;6303;4;1;1323;0;905;756;149
1011;1;6308;4;1;1128;0;487;414;73
1011;1;6314;4;1;1063;0;646;589;57
1011;1;6318;4;1;1201;0;793;657;136
1011;16;6292;4;16;17;0;8;5;3
1011;2;6272;4;2;393;1;245;217;28
1011;2;6273;4;2;433;0;171;137;34
1011;2;6291;4;2;2002;0;1020;880;140
1011;2;6301;4;2;862;0;422;351;71
1011;2;6316;4;2;565;0;369;297;72
1011;2;6317;4;2;616;2;392;328;64
1011;3;6274;4;3;380;5;232;184;48
1011;3;6282;4;3;495;0;265;215;50
1011;3;6304;4;3;665;0;305;249;56
1011;3;6305;4;3;771;2;467;408;59
1011;3;6311;4;3;776;0;473;376;97
1011;3;6319;4;3;1355;0;714;616;98
1011;4;6278;4;4;1160;1;633;551;82
1011;4;6287;4;4;894;0;425;352;73
1011;4;6290;4;4;393;0;260;219;41
1011;4;6309;4;4;684;0;310;261;49
1011;4;6310;4;4;488;1;348;280;68
1011;4;6313;4;4;439;0;262;191;71
1011;5;6277;4;5;290;0;182;139;43
1011;5;6286;4;5;458;0;224;188;36
1011;5;6288;4;5;398;0;228;183;45
1011;5;6293;4;5;1246;0;592;521;71
1011;5;6296;4;5;418;3;290;228;62
1011;5;6315;4;5;762;0;421;355;66
1011;6;6275;4;6;1303;1;670;538;132
1011;6;6283;4;6;539;1;276;251;25
1011;6;6302;4;6;415;0;172;138;34
1011;6;6312;4;6;523;0;248;192;56
1011;7;6285;4;7;330;0;169;118;51
1011;7;6307;4;7;769;0;396;323;73
1011;8;6289;4;8;1016;0;449;357;92
1011;8;6297;4;8;615;0;335;276;59
1011;9;6298;4;9;862;0;478;401;77
1011;9;6299;4;9;297;0;151;103;48
1012;10;6341;5;10;2202;1;920;825;95
1012;11;6351;5;11;2120;1;954;804;150
1012;12;6365;5;12;1597;3;784;667;117
1012;13;6378;5;13;1473;1;481;425;56
1012;14;6350;5;14;1879;0;923;855;68
1012;15;6383;5;15;1199;1;621;545;76
1012;1;6321;5;1;553;0;233;188;45
1012;1;6322;5;1;1636;0;772;697;75
1012;1;6333;5;1;1875;3;1099;897;202
1012;1;6343;5;1;2303;0;1640;1350;290
1012;1;6356;5;1;1334;2;798;590;208
1012;1;6362;5;1;1373;0;849;683;166
1012;1;6364;5;1;596;0;362;301;61
1012;1;6371;5;1;1407;7;807;591;216
1012;1;6388;5;1;1057;6;653;533;120
1012;1;6391;5;1;1622;0;1014;822;192
1012;1;6393;5;1;1830;3;1198;1068;130
1012;1;6396;5;1;926;0;638;477;161
1012;1;6397;5;1;1779;19;1303;1022;281
1012;1;6398;5;1;793;0;490;414;76
1012;16;6394;5;16;2125;0;1024;950;74
1012;17;6323;5;17;1424;2;634;555;79
1012;18;6327;5;18;1803;0;935;835;100
1012;19;6330;5;19;2059;0;935;847;88
1012;20;6342;5;20;992;0;450;398;52
1012;21;6326;5;21;526;0;236;209;27
1012;22;6353;5;22;1710;1;909;782;127
1012;23;6360;5;23;1368;0;654;597;57
1012;24;6370;5;24;2184;0;1105;1012;93
1012;25;6395;5;25;1059;0;501;463;38
1012;2;6329;5;2;1374;0;917;724;193
1012;2;6332;5;2;951;1;522;417;105
1012;2;6345;5;2;1156;2;769;574;195
1012;2;6352;5;2;1162;2;701;562;139
1012;2;6358;5;2;406;0;270;200;70
1012;2;6361;5;2;1476;0;714;656;58
1012;2;6363;5;2;1496;1;994;887;107
1012;2;6366;5;2;763;0;404;357;47
1012;2;6368;5;2;843;0;497;427;70
1012;2;6375;5;2;925;5;609;522;87
1012;2;6376;5;2;1029;0;487;407;80
1012;2;6385;5;2;576;0;397;335;62
1012;2;6386;5;2;704;0;277;214;63
1012;2;6402;5;2;597;0;342;291;51
1012;26;6344;5;26;48;0;26;21;5
1012;27;6346;5;27;42;0;14;13;1
1012;3;6324;5;3;542;0;375;259;116
1012;3;6328;5;3;1219;2;690;477;213
1012;3;6334;5;3;1224;1;775;612;163
1012;3;6335;5;3;1090;0;436;388;48
1012;3;6337;5;3;1140;2;675;570;105
1012;3;6354;5;3;1112;0;582;492;90
1012;3;6369;5;3;1362;1;883;755;128
1012;3;6373;5;3;517;0;313;262;51
1012;3;6377;5;3;723;3;535;418;117
1012;3;6380;5;3;526;3;348;286;62
1012;3;6382;5;3;608;0;329;262;67
1012;3;6384;5;3;617;0;358;280;78
1012;3;6390;5;3;836;0;519;432;87
1012;3;6392;5;3;542;0;418;337;81
1012;4;6320;5;4;871;2;600;419;181
1012;4;6325;5;4;1691;0;898;769;129
1012;4;6336;5;4;667;0;456;380;76
1012;4;6338;5;4;1593;1;787;694;93
1012;4;6340;5;4;1510;2;736;642;94
1012;4;6349;5;4;786;0;490;361;129
1012;4;6357;5;4;840;2;506;427;79
1012;4;6367;5;4;894;0;556;429;127
1012;4;6372;5;4;1094;0;571;423;148
1012;4;6379;5;4;708;0;441;373;68
1012;4;6387;5;4;787;0;459;371;88
1012;4;6399;5;4;1170;0;713;612;101
1012;5;6331;5;5;1783;0;964;736;228
1012;5;6347;5;5;790;0;561;533;28
1012;5;6355;5;5;542;1;320;274;46
1012;5;6374;5;5;966;1;638;544;94
1012;5;6389;5;5;398;0;277;237;40
1012;5;6400;5;5;1172;1;572;502;70
1012;5;6401;5;5;82;0;35;20;15
1012;6;6339;5;6;1857;1;935;847;88
1012;7;6359;5;7;2035;0;936;843;93
1012;8;6348;5;8;1766;0;850;758;92
1012;9;6381;5;9;1589;2;659;602;57
1013;10;6415;6;10;10;0;5;4;1
1013;1;6403;6;1;1485;0;727;622;105
1013;1;6406;6;1;1034;1;570;525;45
1013;1;6414;6;1;2090;2;1189;971;218
1013;1;6418;6;1;1921;0;889;712;177
1013;1;6423;6;1;1842;0;639;544;95
1013;1;6424;6;1;1066;0;668;568;100
1013;2;6419;6;2;1663;0;613;562;51
1013;2;6421;6;2;811;0;443;370;73
1013;2;6425;6;2;1900;1;811;728;83
1013;2;6429;6;2;1383;0;613;516;97
1013;2;6430;6;2;1332;0;830;694;136
1013;3;6404;6;3;1023;1;450;364;86
1013;3;6411;6;3;1370;0;691;616;75
1013;3;6412;6;3;899;0;398;351;47
1013;3;6416;6;3;409;0;218;176;42
1013;3;6427;6;3;1819;0;1029;848;181
1013;4;6407;6;4;286;0;162;132;30
1013;4;6408;6;4;1873;0;974;818;156
1013;4;6413;6;4;1437;0;622;548;74
1013;4;6432;6;4;1874;1;835;702;133
1013;5;6409;6;5;757;0;402;344;58
1013;5;6422;6;5;1924;0;814;725;89
1013;5;6428;6;5;1021;0;377;322;55
1013;6;6417;6;6;2018;3;870;708;162
1013;6;6420;6;6;615;0;370;306;64
1013;7;6405;6;7;1779;0;706;616;90
1013;7;6426;6;7;1954;1;1188;869;319
1013;8;6431;6;8;1868;0;763;672;91
1013;9;6410;6;9;908;0;342;297;45
1014;10;6444;4;10;1633;0;803;699;104
1014;10;6452;4;10;870;0;473;412;61
1014;10;6480;4;10;1441;7;963;827;136
1014;11;6448;4;11;677;0;320;265;55
1014;11;6450;4;11;1831;0;828;752;76
1014;12;6470;4;12;1854;0;781;700;81
1014;13;6491;4;13;1068;0;586;554;32
1014;14;6501;4;14;1261;0;651;585;66
1014;15;6474;4;15;1571;0;936;895;41
1014;1;6436;4;1;1195;0;711;568;143
1014;1;6440;4;1;1119;0;656;558;98
1014;1;6445;4;1;1114;0;651;516;135
1014;1;6454;4;1;1459;1;915;709;206
1014;1;6458;4;1;1794;0;910;760;150
1014;1;6467;4;1;1155;0;743;623;120
1014;1;6481;4;1;1444;10;1013;743;270
1014;1;6497;4;1;1549;0;712;636;76
1014;1;6505;4;1;1994;8;1219;1072;147
1014;1;6520;4;1;1482;7;896;790;106
1014;1;6521;4;1;1536;1;925;765;160
1014;16;6512;4;16;2040;2;1065;968;97
1014;17;6477;4;17;474;0;253;205;48
1014;18;6503;4;18;1648;0;856;697;159
1014;19;6435;4;19;2059;0;968;845;123
1014;20;6485;4;20;1068;0;499;428;71
1014;21;6453;4;21;1265;1;635;565;70
1014;22;6516;4;22;830;0;418;354;64
1014;23;6496;4;23;1407;0;629;530;99
1014;24;6442;4;24;119;0;29;26;3
1014;25;6504;4;25;31;0;7;6;1
1014;2;6433;4;2;1250;0;601;505;96
1014;2;6437;4;2;1557;0;992;761;231
1014;2;6438;4;2;638;0;380;283;97
1014;2;6439;4;2;457;1;333;228;105
1014;2;6447;4;2;1230;3;689;577;112
1014;2;6461;4;2;830;9;539;442;97
1014;2;6464;4;2;345;0;178;153;25
1014;2;6488;4;2;979;0;641;484;157
1014;2;6492;4;2;1755;0;985;807;178
1014;2;6493;4;2;1114;0;491;432;59
1014;2;6519;4;2;612;0;382;308;74
1014;26;6482;4;26;56;0;16;16;0
1014;3;6465;4;3;235;0;130;118;12
1014;3;6473;4;3;810;1;434;372;62
1014;3;6475;4;3;961;3;662;526;136
1014;3;6489;4;3;1308;0;496;402;94
1014;3;6506;4;3;1718;0;784;696;88
1014;3;6508;4;3;915;0;592;471;121
1014;3;6509;4;3;1005;10;709;598;111
1014;3;6514;4;3;381;0;221;175;46
1014;3;6515;4;3;795;0;417;356;61
1014;3;6517;4;3;1779;0;1122;864;258
1014;3;6522;4;3;1714;2;901;750;151
1014;4;6441;4;4;570;1;394;307;87
1014;4;6443;4;4;706;0;291;240;51
1014;4;6456;4;4;339;0;182;162;20
1014;4;6462;4;4;1525;1;732;531;201
1014;4;6468;4;4;771;0;444;365;79
1014;4;6483;4;4;753;0;514;390;124
1014;4;6484;4;4;1135;0;507;440;67
1014;4;6486;4;4;888;0;497;415;82
1014;4;6494;4;4;636;0;374;278;96
1014;4;6500;4;4;524;0;345;255;90
1014;4;6513;4;4;387;0;214;161;53
1014;5;6434;4;5;1137;5;618;456;162
1014;5;6446;4;5;444;0;239;174;65
1014;5;6451;4;5;547;0;310;232;78
1014;5;6455;4;5;1116;0;639;455;184
1014;5;6463;4;5;2114;0;1038;949;89
1014;5;6469;4;5;1212;1;795;683;112
1014;5;6490;4;5;884;1;412;338;74
1014;5;6498;4;5;673;0;412;324;88
1014;6;6449;4;6;738;0;319;259;60
1014;6;6460;4;6;888;2;451;404;47
1014;6;6479;4;6;796;0;442;336;106
1014;6;6499;4;6;858;0;485;360;125
1014;6;6502;4;6;627;0;286;205;81
1014;6;6507;4;6;1277;0;700;579;121
1014;6;6511;4;6;2157;0;997;890;107
1014;7;6457;4;7;984;0;430;357;73
1014;7;6471;4;7;2176;0;929;823;106
1014;7;6472;4;7;49;0;25;18;7
1014;7;6487;4;7;704;0;330;264;66
1014;7;6510;4;7;680;0;431;330;101
1014;8;6476;4;8;2216;0;954;840;114
1014;8;6478;4;8;1006;0;416;391;25
1014;8;6495;4;8;692;0;409;347;62
1014;9;6459;4;9;1600;0;671;597;74
1014;9;6466;4;9;1425;1;694;546;148
1014;9;6518;4;9;847;0;381;326;55
1015;1;6523;6;1;799;3;470;346;124
1015;1;6529;6;1;1367;1;842;693;149
1015;1;6537;6;1;2106;0;1265;1030;235
1015;1;6541;6;1;1317;1;749;641;108
1015;1;6544;6;1;1799;0;1044;829;215
1015;1;6548;6;1;1654;6;1034;861;173
1015;1;6555;6;1;763;0;330;277;53
1015;1;6557;6;1;1765;0;1033;790;243
1015;1;6558;6;1;689;2;401;335;66
1015;2;6530;6;2;1665;6;1138;963;175
1015;2;6531;6;2;574;0;329;260;69
1015;2;6545;6;2;708;1;491;381;110
1015;2;6546;6;2;368;0;172;146;26
1015;2;6549;6;2;881;2;475;392;83
1015;2;6550;6;2;401;0;143;114;29
1015;2;6553;6;2;457;0;326;243;83
1015;2;6554;6;2;814;0;429;345;84
1015;3;6524;6;3;468;0;255;225;30
1015;3;6526;6;3;630;3;430;376;54
1015;3;6528;6;3;379;0;201;157;44
1015;3;6536;6;3;1284;0;433;372;61
1015;3;6547;6;3;761;1;339;278;61
1015;3;6551;6;3;477;0;281;200;81
1015;3;6556;6;3;547;0;360;303;57
1015;4;6525;6;4;569;0;369;300;69
1015;4;6532;6;4;775;0;325;267;58
1015;4;6534;6;4;1887;0;1154;1008;146
1015;4;6535;6;4;493;0;245;210;35
1015;4;6543;6;4;244;0;150;122;28
1015;4;6552;6;4;535;0;251;187;64
1015;5;6538;6;5;584;0;230;202;28
1015;5;6539;6;5;574;0;336;262;74
1015;6;6527;6;6;498;1;256;226;30
1015;6;6533;6;6;653;0;335;261;74
1015;7;6540;6;7;527;0;207;164;43
1015;8;6542;6;8;627;0;241;198;43
1016;10;6635;6;10;1008;1;362;330;32
1016;11;6587;6;11;652;0;216;203;13
1016;12;6610;6;12;970;0;323;300;23
1016;13;6632;6;13;1351;0;551;496;55
1016;14;6625;6;14;937;1;322;303;19
1016;15;6631;6;15;2328;0;1098;984;114
1016;1;6562;6;1;1714;0;1092;977;115
1016;1;6567;6;1;2017;0;1078;970;108
1016;1;6570;6;1;1902;0;1204;1034;170
1016;1;6576;6;1;1085;8;775;605;170
1016;1;6581;6;1;1239;3;813;686;127
1016;1;6584;6;1;1361;0;881;709;172
1016;1;6589;6;1;1803;11;1348;1129;219
1016;1;6612;6;1;852;0;327;297;30
1016;1;6615;6;1;908;0;488;407;81
1016;1;6624;6;1;1194;1;519;462;57
1016;1;6642;6;1;2132;0;1287;1072;215
1016;16;6591;6;16;1966;2;935;833;102
1016;17;6599;6;17;1453;0;683;629;54
1016;18;6639;6;18;1749;0;796;756;40
1016;19;6572;6;19;1830;0;852;813;39
1016;20;6586;6;20;1805;0;814;764;50
1016;21;6574;6;21;960;0;428;402;26
1016;22;6638;6;22;1870;2;843;802;41
1016;23;6609;6;23;1777;0;915;880;35
1016;24;6621;6;24;1536;0;737;691;46
1016;25;6597;6;25;1119;0;585;559;26
1016;2;6561;6;2;376;0;206;174;32
1016;2;6565;6;2;350;0;201;170;31
1016;2;6568;6;2;1331;0;812;656;156
1016;2;6569;6;2;660;0;451;373;78
1016;2;6583;6;2;1811;0;1214;963;251
1016;2;6593;6;2;561;0;309;236;73
1016;2;6603;6;2;1364;5;838;742;96
1016;2;6627;6;2;1488;4;907;755;152
1016;2;6630;6;2;1890;0;942;876;66
1016;2;6633;6;2;945;0;485;416;69
1016;2;6640;6;2;539;0;365;322;43
1016;26;6619;6;26;1129;0;380;361;19
1016;27;6617;6;27;1684;3;727;678;49
1016;28;6613;6;28;1753;1;817;768;49
1016;29;6594;6;29;1456;1;576;529;47
1016;30;6578;6;30;2205;0;938;880;58
1016;31;6626;6;31;1065;0;468;439;29
1016;32;6614;6;32;1763;0;883;840;43
1016;33;6595;6;33;2461;0;1187;1097;90
1016;34;6605;6;34;492;0;194;176;18
1016;35;6606;6;35;1836;0;788;736;52
1016;3;6560;6;3;346;0;184;149;35
1016;3;6564;6;3;485;0;316;227;89
1016;3;6566;6;3;807;0;535;436;99
1016;3;6571;6;3;391;0;236;205;31
1016;3;6588;6;3;608;2;428;361;67
1016;3;6600;6;3;377;0;232;185;47
1016;3;6608;6;3;2033;0;896;847;49
1016;3;6611;6;3;735;3;495;416;79
1016;3;6622;6;3;703;1;364;291;73
1016;3;6636;6;3;1234;0;572;511;61
1016;3;6637;6;3;505;0;295;247;48
1016;36;6604;6;36;70;0;38;29;9
1016;37;6579;6;37;86;0;44;41;3
1016;38;6577;6;38;72;0;55;53;2
1016;39;6601;6;39;112;0;64;60;4
1016;4;6563;6;4;928;0;467;391;76
1016;4;6575;6;4;2195;0;946;891;55
1016;4;6598;6;4;354;0;269;210;59
1016;4;6602;6;4;1711;0;865;787;78
1016;4;6607;6;4;1080;5;756;613;143
1016;4;6616;6;4;614;0;394;355;39
1016;4;6623;6;4;1648;0;935;825;110
1016;5;6559;6;5;829;0;446;392;54
1016;5;6585;6;5;600;1;302;273;29
1016;5;6620;6;5;746;0;332;280;52
1016;5;6628;6;5;2162;0;1004;945;59
1016;6;6580;6;6;1125;0;778;619;159
1016;6;6582;6;6;696;0;382;315;67
1016;6;6592;6;6;572;2;272;230;42
1016;6;6641;6;6;1216;0;455;416;39
1016;7;6596;6;7;489;0;297;262;35
1016;7;6618;6;7;1004;0;466;400;66
1016;7;6634;6;7;1161;0;408;378;30
1016;8;6573;6;8;1354;1;484;448;36
1016;8;6629;6;8;1033;0;549;501;48
1016;9;6590;6;9;1343;0;568;525;43
1017;10;6685;4;10;314;0;218;180;38
1017;10;6709;4;10;2013;0;921;825;96
1017;11;6654;4;11;1970;0;873;780;93
1017;12;6679;4;12;1831;0;836;749;87
1017;13;6675;4;13;1280;0;562;504;58
1017;14;6658;4;14;722;0;348;301;47
1017;15;6712;4;15;987;0;517;436;81
1017;1;6649;4;1;1279;0;709;580;129
1017;1;6661;4;1;1568;0;776;676;100
1017;1;6666;4;1;428;0;276;205;71
1017;1;6669;4;1;1543;0;804;618;186
1017;16;6696;4;16;707;1;471;359;112
1017;1;6676;4;1;961;0;609;517;92
1017;1;6677;4;1;1256;1;709;590;119
1017;1;6678;4;1;801;1;451;367;84
1017;1;6691;4;1;1315;0;808;625;183
1017;1;6692;4;1;718;0;380;322;58
1017;1;6699;4;1;648;1;433;357;76
1017;17;6718;4;17;665;0;395;321;74
1017;18;6672;4;18;960;0;482;397;85
1017;19;6717;4;19;920;0;495;420;75
1017;20;6690;4;20;1443;0;631;526;105
1017;21;6714;4;21;728;0;435;370;65
1017;22;6682;4;22;442;0;297;246;51
1017;23;6684;4;23;46;0;17;17;0
1017;2;6646;4;2;503;1;302;225;77
1017;2;6656;4;2;1624;0;796;713;83
1017;2;6659;4;2;391;0;191;141;50
1017;2;6664;4;2;877;2;428;315;113
1017;2;6667;4;2;634;3;396;318;78
1017;2;6668;4;2;993;0;420;341;79
1017;2;6670;4;2;519;0;295;250;45
1017;2;6686;4;2;527;0;345;258;87
1017;2;6707;4;2;747;1;447;396;51
1017;2;6719;4;2;201;0;145;127;18
1017;3;6651;4;3;992;0;531;436;95
1017;3;6671;4;3;1299;0;680;587;93
1017;3;6673;4;3;685;0;378;263;115
1017;3;6680;4;3;709;0;375;309;66
1017;3;6694;4;3;495;4;350;271;79
1017;3;6695;4;3;609;0;359;333;26
1017;3;6700;4;3;827;0;533;409;124
1017;3;6703;4;3;818;0;463;364;99
1017;3;6705;4;3;436;0;252;205;47
1017;3;6715;4;3;721;5;428;357;71
1017;4;6644;4;4;401;0;202;182;20
1017;4;6645;4;4;564;0;328;251;77
1017;4;6650;4;4;905;0;487;404;83
1017;4;6652;4;4;797;0;416;346;70
1017;4;6655;4;4;272;1;154;133;21
1017;4;6660;4;4;142;0;92;65;27
1017;4;6665;4;4;1047;0;549;504;45
1017;4;6683;4;4;190;0;106;85;21
1017;4;6706;4;4;783;0;470;392;78
1017;4;6711;4;4;207;0;125;111;14
1017;5;6648;4;5;790;2;454;373;81
1017;5;6663;4;5;592;1;396;309;87
1017;5;6681;4;5;698;0;311;253;58
1017;5;6688;4;5;1512;1;753;659;94
1017;5;6689;4;5;270;0;142;117;25
1017;5;6693;4;5;527;0;194;194;0
1017;5;6697;4;5;477;0;306;216;90
1017;5;6713;4;5;623;0;267;223;44
1017;6;6653;4;6;294;0;192;169;23
1017;6;6687;4;6;1686;0;852;784;68
1017;6;6701;4;6;587;0;358;290;68
1017;6;6704;4;6;1056;0;686;596;90
1017;6;6710;4;6;357;0;217;182;35
1017;6;6716;4;6;792;0;451;384;67
1017;6;6720;4;6;507;0;320;234;86
1017;7;6647;4;7;1305;0;616;547;69
1017;7;6662;4;7;376;0;261;210;51
1017;7;6702;4;7;1037;0;620;456;164
1017;7;6708;4;7;470;0;287;239;48
1017;8;6643;4;8;970;0;450;397;53
1017;8;6698;4;8;1128;0;621;450;171
1017;9;6657;4;9;1632;0;725;603;122
1017;9;6674;4;9;649;0;500;389;111
1018;10;6737;4;10;453;0;265;220;45
1018;11;6739;4;11;522;1;269;238;31
1018;12;6754;4;12;6;0;1;1;0
1018;1;6721;4;1;1795;1;941;768;173
1018;1;6725;4;1;1010;0;518;458;60
1018;1;6726;4;1;1874;0;1010;871;139
1018;1;6729;4;1;1484;2;749;556;193
1018;1;6731;4;1;1908;0;1073;841;232
1018;1;6735;4;1;1164;3;738;607;131
1018;1;6745;4;1;1185;0;633;541;92
1018;2;6722;4;2;1162;1;715;575;140
1018;2;6734;4;2;668;0;322;264;58
1018;2;6738;4;2;729;2;473;377;96
1018;2;6740;4;2;809;1;424;352;72
1018;2;6742;4;2;1507;0;800;698;102
1018;2;6749;4;2;893;2;484;399;85
1018;2;6753;4;2;554;1;265;213;52
1018;3;6730;4;3;710;0;371;295;76
1018;3;6732;4;3;602;0;264;221;43
1018;3;6736;4;3;861;0;403;344;59
1018;3;6744;4;3;2019;1;936;876;60
1018;3;6747;4;3;639;6;395;328;67
1018;3;6755;4;3;458;0;275;229;46
1018;3;6756;4;3;929;0;463;376;87
1018;4;6727;4;4;732;0;370;285;85
1018;4;6741;4;4;1251;0;491;427;64
1018;4;6743;4;4;456;0;281;212;69
1018;4;6746;4;4;1140;1;537;437;100
1018;4;6748;4;4;528;0;246;217;29
1018;5;6728;4;5;392;0;213;157;56
1018;5;6750;4;5;807;7;522;417;105
1018;5;6751;4;5;1376;0;581;532;49
1018;6;6733;4;6;864;0;399;349;50
1018;7;6752;4;7;777;0;367;284;83
1018;8;6724;4;8;837;0;415;357;58
1018;9;6723;4;9;888;3;399;355;44
1019;10;6778;4;10;1515;0;712;647;65
1019;11;6777;4;11;1455;0;650;562;88
1019;12;6768;4;12;2127;0;976;878;98
1019;13;6781;4;13;1823;0;863;805;58
1019;14;6767;4;14;2089;0;1052;922;130
1019;15;6796;4;15;1479;1;795;711;84
1019;16;6774;4;16;2049;0;923;814;109
1019;1;6775;4;1;2009;0;1007;902;105
1019;1;6785;4;1;932;0;428;336;92
1019;1;6789;4;1;1923;0;1145;1001;144
1019;1;6798;4;1;1680;2;1014;842;172
1019;17;6763;4;17;2146;0;993;881;112
1019;18;6791;4;18;2107;0;999;904;95
1019;19;6758;4;19;1772;0;759;670;89
1019;20;6799;4;20;1458;2;594;549;45
1019;21;6797;4;21;2232;0;1071;955;116
1019;22;6788;4;22;917;0;401;346;55
1019;23;6769;4;23;1061;0;511;446;65
1019;24;6761;4;24;1254;0;567;506;61
1019;2;6760;4;2;784;3;366;299;67
1019;2;6762;4;2;1134;0;629;565;64
1019;2;6773;4;2;1370;0;602;512;90
1019;2;6792;4;2;863;0;398;346;52
1019;3;6757;4;3;1333;0;553;466;87
1019;3;6759;4;3;760;0;461;363;98
1019;3;6776;4;3;783;0;492;425;67
1019;3;6783;4;3;2102;0;1064;946;118
1019;4;6770;4;4;340;0;215;166;49
1019;4;6779;4;4;579;0;342;285;57
1019;4;6790;4;4;1026;0;390;348;42
1019;4;6795;4;4;870;0;426;358;68
1019;5;6771;4;5;2132;0;916;854;62
1019;5;6772;4;5;1173;0;568;512;56
1019;5;6782;4;5;495;0;320;275;45
1019;6;6765;4;6;1360;0;737;640;97
1019;6;6784;4;6;346;0;188;155;33
1019;6;6787;4;6;1741;1;641;558;83
1019;7;6764;4;7;1255;0;765;688;77
1019;7;6786;4;7;1027;0;474;397;77
1019;7;6793;4;7;1187;0;399;351;48
1019;8;6766;4;8;52;0;19;16;3
1019;8;6780;4;8;51;0;23;17;6
1019;9;6794;4;9;49;0;12;9;3
1020;10;6822;3;10;27;0;11;11;0
1020;10;6829;3;10;1958;2;979;860;119
1020;10;6857;3;10;1629;1;690;623;67
1020;10;6887;3;10;1567;1;770;665;105
1020;11;6818;3;11;1458;0;551;504;47
1020;11;6832;3;11;65;0;33;16;17
1020;11;6873;3;11;1685;0;669;610;59
1020;12;6851;3;12;1355;0;575;507;68
1020;12;6879;3;12;802;0;413;364;49
1020;13;6810;3;13;1129;0;422;382;40
1020;13;6871;3;13;2053;0;1183;1079;104
1020;14;6826;3;14;1853;0;567;464;103
1020;14;6889;3;14;1172;0;640;587;53
1020;15;6819;3;15;1315;0;470;443;27
1020;15;6888;3;15;1940;0;760;695;65
1020;16;6896;3;16;1906;0;918;844;74
1020;1;6812;3;1;2032;1;987;857;130
1020;1;6825;3;1;1378;1;719;656;63
1020;1;6838;3;1;912;0;457;403;54
1020;1;6839;3;1;1692;1;928;805;123
1020;1;6842;3;1;1261;0;626;532;94
1020;1;6858;3;1;1215;0;447;396;51
1020;1;6862;3;1;1480;0;762;625;137
1020;1;6894;3;1;1401;0;653;556;97
1020;1;6897;3;1;1555;8;991;817;174
1020;17;6869;3;17;927;0;418;378;40
1020;18;6886;3;18;814;0;347;326;21
1020;19;6884;3;19;968;1;379;355;24
1020;20;6890;3;20;899;0;328;296;32
1020;21;6902;3;21;569;0;205;184;21
1020;22;6865;3;22;1682;0;767;696;71
1020;23;6861;3;23;1277;1;594;550;44
1020;24;6867;3;24;1367;1;549;501;48
1020;25;6815;3;25;1563;1;710;666;44
1020;26;6804;3;26;1380;0;660;615;45
1020;2;6805;3;2;300;3;205;177;28
1020;2;6809;3;2;1737;0;751;666;85
1020;2;6813;3;2;750;2;407;359;48
1020;2;6830;3;2;1455;1;778;634;144
1020;2;6834;3;2;1815;1;712;629;83
1020;2;6836;3;2;700;0;233;195;38
1020;2;6849;3;2;1771;0;884;792;92
1020;2;6863;3;2;1061;0;431;384;47
1020;2;6877;3;2;821;8;470;432;38
1020;27;6801;3;27;1595;0;724;675;49
1020;28;6821;3;28;1546;0;670;636;34
1020;29;6807;3;29;1214;0;552;490;62
1020;30;6856;3;30;1402;0;626;563;63
1020;31;6820;3;31;1630;0;760;693;67
1020;32;6895;3;32;1629;0;713;628;85
1020;33;6891;3;33;1347;0;503;442;61
1020;34;6840;3;34;1034;0;563;507;56
1020;35;6800;3;35;97;0;34;28;6
1020;36;6802;3;36;15;0;10;10;0
1020;3;6814;3;3;674;1;359;290;69
1020;3;6837;3;3;1462;0;739;661;78
1020;3;6850;3;3;1099;3;700;586;114
1020;3;6859;3;3;643;0;317;240;77
1020;3;6872;3;3;2046;2;905;828;77
1020;3;6880;3;3;1319;0;523;422;101
1020;3;6881;3;3;2134;4;943;798;145
1020;3;6882;3;3;1524;3;897;807;90
1020;3;6904;3;3;1649;1;690;601;89
1020;37;6866;3;37;14;0;2;2;0
1020;38;6878;3;38;73;0;34;29;5
1020;4;6808;3;4;642;0;379;325;54
1020;4;6811;3;4;1516;0;783;783;0
1020;4;6823;3;4;1891;1;700;605;95
1020;4;6827;3;4;2382;0;1263;1138;125
1020;4;6835;3;4;334;0;158;125;33
1020;4;6870;3;4;1616;3;747;582;165
1020;4;6883;3;4;1310;0;623;546;77
1020;4;6885;3;4;1209;0;480;420;60
1020;4;6899;3;4;861;0;550;468;82
1020;5;6817;3;5;1440;0;709;650;59
1020;5;6831;3;5;2357;2;996;855;141
1020;5;6846;3;5;548;0;270;233;37
1020;5;6848;3;5;1317;1;639;548;91
1020;5;6854;3;5;1224;0;629;539;90
1020;5;6860;3;5;1392;1;598;519;79
1020;5;6900;3;5;656;1;386;330;56
1020;5;6903;3;5;1690;1;850;737;113
1020;6;6803;3;6;2062;6;1024;877;147
1020;6;6841;3;6;704;0;377;322;55
1020;6;6853;3;6;1745;1;818;818;0
1020;6;6855;3;6;1593;1;727;637;90
1020;6;6876;3;6;971;0;455;386;69
1020;6;6898;3;6;831;1;434;369;65
1020;7;6806;3;7;1890;0;847;696;151
1020;7;6824;3;7;1822;1;960;863;97
1020;7;6843;3;7;1605;1;643;603;40
1020;7;6852;3;7;1728;0;898;792;106
1020;7;6864;3;7;1490;0;636;545;91
1020;7;6901;3;7;1552;1;719;611;108
1020;8;6816;3;8;1404;2;746;692;54
1020;8;6828;3;8;1657;2;714;611;103
1020;8;6833;3;8;626;0;359;315;44
1020;8;6847;3;8;806;0;348;308;40
1020;8;6868;3;8;1469;0;716;661;55
1020;8;6875;3;8;1084;0;591;495;96
1020;9;6844;3;9;60;2;42;35;7
1020;9;6845;3;9;1033;1;579;498;81
1020;9;6874;3;9;1039;0;469;399;70
1020;9;6892;3;9;1191;0;453;408;45
1020;9;6893;3;9;1102;0;467;429;38
1021;1;6912;6;1;1077;0;708;590;118
1021;1;6914;6;1;893;4;505;406;99
1021;1;6915;6;1;1464;4;955;811;144
1021;1;6916;6;1;1932;3;926;822;104
1021;1;6922;6;1;1323;5;890;746;144
1021;2;6905;6;2;412;0;261;231;30
1021;2;6908;6;2;2129;0;996;856;140
1021;2;6913;6;2;479;4;301;243;58
1021;2;6917;6;2;1263;5;671;574;97
1021;2;6925;6;2;256;0;160;127;33
1021;3;6906;6;3;533;0;332;246;86
1021;3;6924;6;3;599;0;396;328;68
1021;3;6926;6;3;550;1;278;237;41
1021;3;6927;6;3;915;14;556;453;103
1021;3;6930;6;3;1948;0;961;837;124
1021;4;6907;6;4;471;0;285;240;45
1021;4;6911;6;4;1226;0;694;575;119
1021;4;6920;6;4;689;0;428;360;68
1021;4;6928;6;4;622;0;345;296;49
1021;4;6929;6;4;2067;0;998;902;96
1021;5;6909;6;5;61;0;48;48;0
1021;5;6910;6;5;490;3;298;232;66
1021;5;6931;6;5;979;0;583;472;111
1021;5;6932;6;5;1146;0;613;521;92
1021;6;6919;6;6;496;0;290;246;44
1021;6;6921;6;6;896;0;427;382;45
1021;7;6918;6;7;86;0;50;29;21
1021;8;6923;6;8;11;0;9;6;3
1061;100;7192;1;100;882;0;236;232;4
1061;101;7244;2;101;1467;0;564;552;12
1061;102;6968;2;102;1523;0;681;665;16
1061;103;7033;2;103;1209;0;452;428;24
1061;104;7121;2;104;947;0;303;296;7
1061;105;7210;2;105;728;0;308;306;2
1061;106;7148;1;106;2226;0;926;897;29
1061;10;7217;1;10;2141;0;797;755;42
1061;107;7251;1;107;2202;0;868;852;16
1061;108;7078;1;108;2170;0;882;852;30
1061;109;6974;1;109;1715;0;566;549;17
1061;110;7189;1;110;2406;0;942;933;9
1061;111;7159;2;111;1695;0;340;317;23
1061;112;7221;2;112;1927;0;431;381;50
1061;113;7037;2;113;1633;0;341;322;19
1061;114;7023;2;114;1852;0;332;310;22
1061;115;7184;2;115;1952;0;557;557;0
1061;116;7161;2;116;2030;0;561;537;24
1061;11;7300;1;11;2195;0;881;850;31
1061;117;7006;2;117;1998;0;423;390;33
1061;118;7008;2;118;2096;0;626;587;39
1061;119;7238;2;119;2139;1;793;741;52
1061;120;7130;2;120;2176;0;864;843;21
1061;121;7158;2;121;1591;0;427;410;17
1061;122;7152;2;122;1522;0;400;373;27
1061;123;6950;2;123;1085;0;338;325;13
1061;124;7097;2;124;1804;0;545;545;0
1061;125;7180;2;125;1835;0;607;581;26
1061;126;6952;2;126;1641;0;676;637;39
1061;12;7074;1;12;2108;0;858;831;27
1061;127;7186;2;127;1189;0;447;420;27
1061;128;7028;2;128;2066;0;649;625;24
1061;129;7112;2;129;2123;0;626;593;33
1061;130;7190;2;130;1872;0;572;527;45
1061;131;6978;2;131;1530;0;444;431;13
1061;132;7129;2;132;2124;0;771;720;51
1061;133;7051;2;133;2077;0;769;738;31
1061;134;6948;2;134;1144;0;403;383;20
1061;135;7286;2;135;1764;0;494;455;39
1061;136;7199;2;136;1913;0;586;546;40
1061;13;6996;1;13;1916;0;758;735;23
1061;137;7101;2;137;1546;0;591;576;15
1061;138;7009;2;138;2181;0;709;685;24
1061;139;7005;2;139;1935;0;741;709;32
1061;140;7155;2;140;2141;1;825;797;28
1061;141;7022;2;141;2183;0;821;791;30
1061;142;7061;2;142;1965;0;718;697;21
1061;143;7143;2;143;1823;0;650;626;24
1061;144;7196;2;144;801;0;248;242;6
1061;145;7124;2;145;939;0;338;315;23
1061;146;7178;2;146;1753;0;516;497;19
1061;14;7126;1;14;2018;0;814;790;24
1061;147;6967;2;147;2030;0;774;750;24
1061;148;7136;2;148;1873;0;576;555;21
1061;149;7310;2;149;2121;0;831;805;26
1061;150;7257;2;150;1660;0;625;603;22
1061;151;7208;2;151;2100;5;725;691;34
1061;152;7236;2;152;1787;0;606;606;0
1061;153;7117;2;153;2252;0;587;567;20
1061;154;7303;2;154;2112;0;543;522;21
1061;155;7250;2;155;2150;0;728;707;21
1061;156;7308;2;156;2018;0;709;696;13
1061;15;7132;1;15;1877;0;618;592;26
1061;157;7090;2;157;2286;0;893;864;29
1061;158;7041;2;158;2229;0;906;859;47
1061;159;7088;2;159;1225;0;375;364;11
1061;160;7120;2;160;2260;0;985;943;42
1061;161;6963;2;161;2402;0;876;838;38
1061;162;7154;2;162;1507;0;571;549;22
1061;163;7108;2;163;1294;0;300;288;12
1061;164;7231;2;164;2159;0;745;716;29
1061;165;7273;2;165;841;0;247;247;0
1061;166;6947;2;166;1272;0;428;422;6
1061;16;7206;1;16;1734;0;700;680;20
1061;167;7036;2;167;2266;0;807;783;24
1061;168;6953;2;168;1466;0;543;530;13
1061;1;6944;1;1;853;0;375;370;5
1061;169;7064;2;169;1511;0;611;594;17
1061;170;7325;2;170;1801;0;476;467;9
1061;171;7050;2;171;2117;0;701;679;22
1061;172;7169;2;172;1885;1;554;534;20
1061;173;6998;2;173;1316;0;520;486;34
1061;174;6981;2;174;1838;0;680;662;18
1061;175;6957;2;175;849;0;115;109;6
1061;176;7254;2;176;1440;1;512;484;28
1061;17;7007;1;17;1301;0;499;482;17
1061;177;7179;2;177;1497;0;567;546;21
1061;178;7324;2;178;2146;0;728;709;19
1061;179;7139;2;179;1830;0;483;454;29
1061;180;7307;2;180;1799;1;470;453;17
1061;181;7226;2;181;2092;0;837;802;35
1061;182;7100;2;182;1509;0;561;534;27
1061;183;7127;2;183;1196;1;460;439;21
1061;184;7077;2;184;1693;4;665;637;28
1061;185;6975;2;185;1518;0;626;613;13
1061;186;7141;2;186;1553;1;604;587;17
1061;18;7235;1;18;1585;0;572;557;15
1061;187;6980;2;187;651;0;84;84;0
1061;188;7065;2;188;1088;0;128;120;8
1061;189;7135;2;189;2214;1;593;560;33
1061;190;7062;1;190;2311;0;952;929;23
1061;191;7012;1;191;1542;0;676;661;15
1061;192;7243;1;192;1953;0;759;744;15
1061;193;7291;1;193;1705;0;716;695;21
1061;194;7170;1;194;1203;0;444;430;14
1061;195;7262;1;195;1299;1;500;479;21
1061;196;7240;1;196;1673;2;583;565;18
1061;19;7048;1;19;1768;0;686;664;22
1061;197;7075;1;197;1395;0;520;501;19
1061;198;7045;1;198;1866;0;686;668;18
1061;199;7203;1;199;1562;0;568;550;18
1061;200;7232;1;200;1714;0;559;531;28
1061;201;7242;1;201;1706;0;607;577;30
1061;202;7207;1;202;1869;0;454;428;26
1061;203;7067;1;203;1734;0;326;319;7
1061;204;7029;1;204;1397;0;346;333;13
1061;205;7142;1;205;1761;0;414;401;13
1061;206;7071;1;206;1622;0;314;302;12
1061;20;6971;1;20;1774;0;629;619;10
1061;207;6964;1;207;1752;0;506;481;25
1061;208;7223;1;208;1837;0;407;393;14
1061;209;7137;1;209;1868;0;487;458;29
1061;210;7058;1;210;1586;0;367;354;13
1061;211;7144;1;211;1551;0;383;371;12
1061;212;7069;1;212;1168;0;312;300;12
1061;213;7259;1;213;1537;0;377;374;3
1061;214;7059;1;214;1450;0;342;326;16
1061;215;7053;1;215;1598;0;340;315;25
1061;216;6995;1;216;1617;0;397;377;20
1061;21;7072;1;21;1488;0;570;560;10
1061;217;7252;1;217;1441;1;345;331;14
1061;218;7177;1;218;1671;0;409;394;15
1061;219;7181;1;219;2211;1;784;760;24
1061;220;7056;1;220;1360;0;702;687;15
1061;221;7157;1;221;1112;0;618;602;16
1061;222;6984;1;222;1463;0;601;578;23
1061;223;7237;1;223;1113;0;461;448;13
1061;224;7209;1;224;1200;0;510;493;17
1061;225;7027;1;225;1733;1;790;775;15
1061;226;7195;1;226;1835;0;669;649;20
1061;22;7249;1;22;1556;0;606;595;11
1061;227;7227;1;227;1618;0;732;705;27
1061;228;7319;1;228;2144;1;844;824;20
1061;229;7018;1;229;1399;0;478;465;13
1061;230;7187;1;230;1069;1;591;569;22
1061;231;6986;1;231;1707;0;686;664;22
1061;232;7103;1;232;1577;0;639;627;12
1061;233;7296;1;233;1830;0;704;678;26
1061;234;7182;1;234;1099;1;532;517;15
1061;235;6960;1;235;1370;0;519;507;12
1061;236;7290;1;236;1731;0;687;670;17
1061;23;7261;1;23;1854;0;730;714;16
1061;237;7030;1;237;2080;0;702;668;34
1061;238;6954;1;238;1063;0;336;330;6
1061;239;7024;1;239;979;0;368;358;10
1061;240;7057;1;240;2052;0;829;817;12
1061;241;7165;1;241;1453;0;587;568;19
1061;242;7079;1;242;1710;0;689;669;20
1061;243;7000;1;243;2300;0;840;816;24
1061;244;7167;1;244;1730;1;685;663;22
1061;245;7173;1;245;1685;0;620;597;23
1061;246;7281;1;246;1723;0;611;602;9
1061;24;7131;1;24;1602;0;569;541;28
1061;247;7191;1;247;1856;0;709;689;20
1061;248;7213;1;248;1775;0;743;727;16
1061;249;7156;1;249;1899;0;737;723;14
1061;250;7098;1;250;2412;0;934;905;29
1061;251;6958;1;251;2067;0;831;798;33
1061;252;7201;1;252;2049;0;741;723;18
1061;253;7123;1;253;1803;0;741;716;25
1061;254;7258;1;254;2084;0;767;746;21
1061;255;7314;1;255;2088;0;823;810;13
1061;256;7171;1;256;2089;1;800;762;38
1061;25;6949;1;25;1694;0;798;777;21
1061;257;6966;1;257;601;0;190;185;5
1061;258;7272;1;258;1258;0;361;347;14
1061;259;6955;1;259;963;0;256;249;7
1061;260;7282;1;260;1910;0;642;628;14
1061;261;7106;1;261;1341;0;441;424;17
1061;262;7305;1;262;1854;0;856;829;27
1061;263;7138;1;263;1433;0;310;302;8
1061;264;7225;1;264;1671;0;776;762;14
1061;265;7283;1;265;1395;0;523;509;14
1061;266;7260;1;266;1532;0;458;458;0
1061;26;6938;1;26;1274;0;446;432;14
1061;267;7280;1;267;1809;0;706;689;17
1061;268;7326;1;268;1839;1;670;643;27
1061;269;6999;1;269;1114;0;247;239;8
1061;270;7034;1;270;1227;0;280;270;10
1061;2;7162;1;2;812;0;359;345;14
1061;271;7263;1;271;1159;0;309;297;12
1061;272;7218;1;272;1297;1;331;314;17
1061;273;7111;1;273;1677;0;447;433;14
1061;274;7220;1;274;2039;0;432;418;14
1061;275;7255;1;275;2025;0;437;422;15
1061;276;7318;1;276;1870;0;413;398;15
1061;27;6940;1;27;1284;0;461;446;15
1061;277;7265;1;277;1871;0;362;349;13
1061;278;7068;1;278;1888;0;380;366;14
1061;279;7052;1;279;1669;0;324;311;13
1061;280;7066;1;280;2146;0;446;427;19
1061;281;7297;1;281;2126;0;439;427;12
1061;282;7115;2;282;937;0;247;238;9
1061;283;7205;2;283;1759;0;499;466;33
1061;284;7320;2;284;1586;1;387;370;17
1061;285;6956;2;285;1452;0;523;513;10
1061;286;6961;2;286;1548;0;508;488;20
1061;28;7092;1;28;1555;0;451;439;12
1061;287;7264;2;287;1790;0;642;630;12
1061;288;6937;2;288;1902;0;760;714;46
1061;289;7080;2;289;1945;0;756;749;7
1061;290;7153;2;290;1631;0;861;837;24
1061;291;7214;2;291;1372;0;670;646;24
1061;292;7304;2;292;1453;0;706;667;39
1061;293;7266;2;293;915;0;363;348;15
1061;294;6972;2;294;1647;0;522;495;27
1061;295;7313;2;295;1865;0;746;714;32
1061;296;7311;2;296;2053;0;695;665;30
1061;29;6992;1;29;1449;0;422;409;13
1061;297;7160;2;297;1739;0;640;615;25
1061;298;7284;2;298;2166;0;873;824;49
1061;299;7134;2;299;2020;1;761;721;40
1061;300;7197;2;300;1447;0;532;499;33
1061;301;6973;2;301;1380;0;567;550;17
1061;302;7003;2;302;1271;0;430;420;10
1061;303;7042;2;303;1203;0;462;444;18
1061;304;6989;2;304;1418;0;554;539;15
1061;305;7096;2;305;2506;0;837;837;0
1061;306;7289;2;306;1871;0;672;672;0
1061;30;6933;1;30;1927;1;735;711;24
1061;307;7089;2;307;1265;0;414;397;17
1061;308;7163;2;308;1605;0;535;535;0
1061;309;6959;2;309;1575;0;543;525;18
1061;310;6982;2;310;1711;0;679;654;25
1061;311;7084;2;311;1693;0;647;624;23
1061;312;7285;2;312;1409;0;658;636;22
1061;313;7301;2;313;1993;0;894;866;28
1061;314;7234;2;314;1632;0;639;605;34
1061;315;7176;2;315;1425;0;583;565;18
1061;316;7038;2;316;1312;0;584;563;21
1061;31;7095;1;31;1632;0;659;640;19
1061;317;7116;2;317;2061;0;858;831;27
1061;318;7110;2;318;1778;0;732;701;31
1061;319;7016;2;319;1889;0;803;767;36
1061;320;7020;2;320;1787;0;676;653;23
1061;321;7330;2;321;1099;0;451;435;16
1061;322;6942;2;322;963;0;378;361;17
1061;323;7277;2;323;903;0;323;314;9
1061;324;7219;2;324;1520;0;620;602;18
1061;325;7174;2;325;2015;0;732;705;27
1061;326;7105;2;326;1697;0;637;611;26
1061;32;7298;1;32;1642;0;674;656;18
1061;327;7035;2;327;1508;0;529;513;16
1061;328;7271;2;328;651;0;202;192;10
1061;329;7122;2;329;1559;0;566;540;26
1061;330;7017;2;330;2625;0;1110;1057;53
1061;331;7245;2;331;1023;0;410;388;22
1061;332;7315;2;332;2148;1;889;855;34
1061;333;7128;2;333;1681;0;805;781;24
1061;334;7040;2;334;2339;0;964;917;47
1061;335;7317;2;335;1748;1;654;654;0
1061;336;7172;2;336;1744;0;700;700;0
1061;33;7288;1;33;1910;0;762;734;28
1061;337;7070;2;337;2229;0;1058;1007;51
1061;338;7010;2;338;1406;0;460;460;0
1061;339;7164;2;339;1689;0;624;597;27
1061;340;7185;2;340;1895;1;555;529;26
1061;341;7168;2;341;1682;0;663;633;30
1061;342;7295;2;342;1526;0;406;386;20
1061;343;7047;2;343;1733;0;548;525;23
1061;344;7253;2;344;1255;0;448;423;25
1061;345;7014;2;345;1284;0;455;426;29
1061;346;7015;2;346;1274;0;382;363;19
1061;34;7274;1;34;1888;0;755;723;32
1061;347;7049;2;347;1305;0;500;465;35
1061;348;7270;2;348;1689;0;358;337;21
1061;349;7229;2;349;1666;0;325;301;24
1061;350;7150;2;350;1930;0;370;353;17
1061;351;7268;2;351;1543;0;405;386;19
1061;352;7140;2;352;1338;0;543;524;19
1061;353;7248;2;353;1111;0;242;241;1
1061;354;7267;2;354;1797;0;264;250;14
1061;355;7302;2;355;1615;0;486;449;37
1061;356;7211;2;356;1478;1;448;424;24
1061;35;7060;1;35;2055;0;586;566;20
1061;357;7011;2;357;1745;0;598;576;22
1061;358;7133;2;358;834;0;310;303;7
1061;359;6934;2;359;1272;0;443;443;0
1061;360;7019;2;360;1285;0;294;281;13
1061;361;7032;2;361;1630;0;513;483;30
1061;362;6991;2;362;1618;0;521;496;25
1061;363;7224;1;363;83;0;17;15;2
1061;364;7309;1;364;68;0;35;30;5
1061;365;7230;2;365;39;0;32;30;2
1061;366;7107;2;366;78;0;52;40;12
1061;36;7021;1;36;2012;0;691;670;21
1061;367;7145;2;367;159;0;63;57;6
1061;368;7202;1;368;38;0;25;25;0
1061;369;7149;1;369;51;0;13;11;2
1061;370;7193;1;370;147;0;47;47;0
1061;3;7146;1;3;1667;0;564;547;17
1061;371;7114;1;371;325;0;53;46;7
1061;372;6977;2;372;66;0;14;13;1
1061;373;6979;1;373;466;0;225;185;40
1061;374;7025;2;374;87;0;54;51;3
1061;375;7316;2;375;57;0;17;16;1
1061;376;7241;2;376;57;0;28;24;4
1061;37;7233;1;37;1319;0;436;410;26
1061;377;6987;2;377;67;0;23;20;3
1061;378;6965;2;378;44;0;24;24;0
1061;379;6985;2;379;203;0;48;44;4
1061;380;7118;2;380;26;0;5;5;0
1061;381;6990;2;381;45;0;16;15;1
1061;382;7194;1;382;122;0;24;24;0
1061;383;7104;1;383;113;0;21;20;1
1061;384;7026;1;384;114;0;36;31;5
1061;385;7002;1;385;74;0;49;49;0
1061;386;7200;1;386;99;0;76;65;11
1061;38;6945;1;38;980;0;304;281;23
1061;387;7094;1;387;9;0;9;9;0
1061;388;7183;1;388;63;0;24;23;1
1061;389;7293;1;389;66;0;21;21;0
1061;390;6941;2;390;74;0;45;43;2
1061;391;7083;2;391;145;0;43;42;1
1061;392;7204;2;392;45;0;16;15;1
1061;393;7222;2;393;33;0;5;5;0
1061;394;7001;2;394;531;0;158;158;0
1061;395;7256;2;395;193;0;21;21;0
1061;396;7113;2;396;75;0;23;23;0
1061;39;7004;1;39;1047;1;465;450;15
1061;397;6993;2;397;59;0;24;24;0
1061;398;6962;2;398;142;0;35;32;3
1061;40;7119;1;40;1531;0;595;574;21
1061;41;7312;1;41;1148;0;370;365;5
1061;42;7085;1;42;1539;0;577;559;18
1061;43;7102;1;43;1771;0;601;586;15
1061;44;7044;1;44;1574;0;673;657;16
1061;45;7328;1;45;1808;0;760;723;37
1061;46;7306;1;46;751;0;246;239;7
1061;4;7216;1;4;337;0;96;88;8
1061;47;7292;1;47;2043;0;753;717;36
1061;48;7013;1;48;1695;1;619;585;34
1061;49;7275;1;49;1584;0;599;584;15
1061;50;7147;1;50;761;0;191;189;2
1061;51;7294;1;51;1235;0;276;264;12
1061;52;7082;1;52;1304;0;375;355;20
1061;53;7055;1;53;1948;0;455;439;16
1061;54;7198;1;54;736;0;125;121;4
1061;55;7212;1;55;1921;0;589;574;15
1061;56;7246;1;56;1958;1;608;586;22
1061;5;7081;1;5;668;0;230;214;16
1061;57;7054;1;57;1337;0;378;366;12
1061;58;6946;1;58;852;1;385;374;11
1061;59;7039;2;59;1807;0;831;812;19
1061;60;7215;2;60;1879;1;908;885;23
1061;61;7091;1;61;2063;0;703;679;24
1061;62;7086;1;62;1673;0;607;587;20
1061;63;7269;1;63;1375;0;472;445;27
1061;64;7327;1;64;1528;0;596;581;15
1061;65;7073;1;65;1532;0;640;615;25
1061;66;6976;1;66;1934;2;837;809;28
1061;6;7046;1;6;1934;0;1058;1035;23
1061;67;7099;1;67;1089;0;415;403;12
1061;68;7228;1;68;1182;0;437;416;21
1061;69;7323;1;69;1682;1;738;719;19
1061;70;6936;1;70;2066;1;846;816;30
1061;71;7063;1;71;1846;0;725;704;21
1061;72;7043;1;72;1594;0;671;658;13
1061;73;7279;1;73;1029;0;388;380;8
1061;74;7247;1;74;1875;1;821;809;12
1061;75;7076;1;75;2021;0;667;644;23
1061;76;7175;1;76;1639;0;570;547;23
1061;7;7239;1;7;1762;0;670;639;31
1061;77;7109;1;77;1359;1;482;476;6
1061;78;6994;1;78;1620;0;617;600;17
1061;79;7087;1;79;1325;1;544;526;18
1061;80;6939;1;80;1500;0;580;566;14
1061;81;7299;1;81;916;0;125;123;2
1061;82;7031;1;82;1875;0;413;401;12
1061;83;6943;1;83;1337;0;437;419;18
1061;84;7287;1;84;1463;0;456;433;23
1061;85;7278;1;85;1212;0;282;265;17
1061;86;6997;1;86;1307;1;305;300;5
1061;8;7093;1;8;1866;0;702;685;17
1061;87;6988;1;87;1633;0;521;498;23
1061;88;7151;1;88;1642;0;543;525;18
1061;89;7322;1;89;2062;0;671;638;33
1061;90;7166;1;90;703;0;126;120;6
1061;91;7188;2;91;1656;0;587;568;19
1061;92;7125;2;92;1172;0;487;479;8
1061;93;7321;1;93;2036;0;872;840;32
1061;94;6935;1;94;609;0;162;156;6
1061;95;7329;1;95;1989;2;705;670;35
1061;96;6983;1;96;2089;0;813;784;29
1061;9;6970;1;9;1850;0;776;754;22
1061;97;6969;1;97;1915;1;672;652;20
1061;98;7276;1;98;1161;0;531;520;11
1061;99;6951;1;99;1644;0;746;736;10
1062;10;7353;5;10;1318;0;681;615;66
1062;11;7357;5;11;1825;2;856;784;72
1062;12;7345;5;12;2096;1;1029;943;86
1062;13;7360;5;13;2008;0;961;866;95
1062;14;7331;5;14;1179;1;563;517;46
1062;15;7362;5;15;1872;0;1024;922;102
1062;16;7338;5;16;1520;2;783;710;73
1062;1;7341;5;1;1154;1;568;515;53
1062;17;7355;5;17;1626;0;725;658;67
1062;18;7349;5;18;786;0;370;340;30
1062;19;7333;5;19;1785;0;826;751;75
1062;20;7335;5;20;1656;2;774;705;69
1062;21;7336;5;21;2053;4;922;843;79
1062;22;7346;5;22;2125;0;995;923;72
1062;23;7369;5;23;1609;0;801;751;50
1062;24;7340;5;24;2320;0;1173;1076;97
1062;25;7368;5;25;1904;0;866;807;59
1062;26;7363;5;26;2142;1;1153;1083;70
1062;2;7334;5;2;1039;0;496;442;54
1062;27;7350;5;27;2075;0;975;897;78
1062;28;7356;5;28;2306;1;1071;1006;65
1062;29;7342;5;29;1893;0;811;732;79
1062;30;7366;5;30;2243;1;1025;956;69
1062;31;7332;5;31;1413;0;666;630;36
1062;32;7352;5;32;1649;1;728;650;78
1062;33;7337;5;33;2361;1;1279;1179;100
1062;34;7347;5;34;1908;0;891;827;64
1062;35;7367;5;35;1607;1;747;664;83
1062;36;7343;5;36;1777;2;841;772;69
1062;3;7351;5;3;1840;0;798;693;105
1062;37;7365;5;37;1200;2;541;496;45
1062;38;7348;5;38;52;0;18;16;2
1062;39;7370;5;39;39;0;19;19;0
1062;40;7361;5;40;79;0;24;18;6
1062;41;7364;5;41;95;0;66;53;13
1062;4;7359;5;4;1689;1;762;657;105
1062;5;7344;5;5;952;1;357;321;36
1062;6;7358;5;6;1684;2;813;741;72
1062;7;7339;5;7;1725;2;845;747;98
1062;8;7371;5;8;1107;1;415;356;59
1062;9;7354;5;9;936;0;364;309;55
1063;10;7379;6;10;1485;0;689;629;60
1063;11;7393;6;11;1455;0;666;599;67
1063;12;7396;6;12;2030;2;904;824;80
1063;13;7386;6;13;1268;0;609;531;78
1063;14;7385;6;14;1167;1;571;528;43
1063;15;7382;6;15;1752;0;758;664;94
1063;16;7383;6;16;1034;0;466;406;60
1063;1;7395;6;1;1948;0;816;690;126
1063;17;7377;6;17;2193;0;1024;880;144
1063;18;7374;6;18;2178;3;1019;944;75
1063;19;7372;6;19;2158;0;960;890;70
1063;20;7389;6;20;1847;0;875;791;84
1063;21;7375;6;21;1652;0;743;643;100
1063;22;7388;6;22;1940;0;1056;969;87
1063;23;7392;6;23;994;0;375;332;43
1063;24;7387;6;24;1638;1;793;718;75
1063;25;7394;6;25;64;0;21;17;4
1063;2;7373;6;2;1867;0;889;816;73
1063;3;7384;6;3;1914;0;873;777;96
1063;4;7376;6;4;1526;0;798;731;67
1063;5;7391;6;5;573;0;242;194;48
1063;6;7381;6;6;1379;2;571;508;63
1063;7;7378;6;7;1371;0;626;568;58
1063;8;7390;6;8;2402;1;1050;942;108
1063;9;7380;6;9;1523;0;788;729;59
1201;10;7406;5;10;680;0;375;336;39
1201;10;7430;5;10;808;0;347;296;51
1201;11;7429;5;11;918;0;484;420;64
1201;11;7450;5;11;1139;0;627;587;40
1201;12;7415;5;12;2209;0;1166;1061;105
1201;12;7457;5;12;369;0;237;209;28
1201;13;7424;5;13;686;0;323;282;41
1201;13;7451;5;13;677;0;309;284;25
1201;14;7397;5;14;1968;2;997;934;63
1201;14;7442;5;14;724;0;347;320;27
1201;15;7403;5;15;818;0;436;379;57
1201;15;7456;5;15;2070;0;1017;918;99
1201;16;7411;5;16;6;0;0;0;0
1201;16;7431;5;16;1107;0;507;455;52
1201;1;7401;5;1;1201;0;645;531;114
1201;1;7423;5;1;1424;0;684;626;58
1201;1;7425;5;1;1288;0;678;615;63
1201;1;7427;5;1;806;0;521;448;73
1201;1;7443;5;1;2101;0;1070;960;110
1201;1;7444;5;1;1576;0;930;776;154
1201;1;7453;5;1;1045;0;657;555;102
1201;1;7454;5;1;1548;0;893;733;160
1201;1;7458;5;1;2287;1;1508;1219;289
1201;17;7426;5;17;101;0;63;52;11
1201;2;7407;5;2;681;0;334;297;37
1201;2;7412;5;2;1370;0;638;519;119
1201;2;7419;5;2;1748;1;1074;828;246
1201;2;7428;5;2;1385;0;651;592;59
1201;2;7437;5;2;2129;5;1426;1147;279
1201;2;7438;5;2;1156;1;775;670;105
1201;2;7447;5;2;542;0;247;208;39
1201;2;7448;5;2;666;0;316;289;27
1201;2;7464;5;2;644;0;407;353;54
1201;3;7404;5;3;270;0;151;109;42
1201;3;7413;5;3;2187;0;1255;1089;166
1201;3;7414;5;3;2037;1;970;880;90
1201;3;7420;5;3;520;0;226;196;30
1201;3;7433;5;3;1092;0;592;404;188
1201;3;7434;5;3;430;0;286;224;62
1201;3;7440;5;3;589;0;334;276;58
1201;3;7449;5;3;1629;0;763;666;97
1201;3;7452;5;3;1545;2;818;680;138
1201;4;7400;5;4;521;0;252;216;36
1201;4;7405;5;4;940;0;512;422;90
1201;4;7408;5;4;1002;1;457;363;94
1201;4;7410;5;4;1196;0;559;486;73
1201;4;7439;5;4;761;0;521;442;79
1201;4;7441;5;4;754;0;523;450;73
1201;4;7461;5;4;701;0;434;370;64
1201;4;7465;5;4;803;0;336;288;48
1201;5;7398;5;5;1975;3;1152;1069;83
1201;5;7399;5;5;780;0;372;302;70
1201;5;7421;5;5;1026;0;526;426;100
1201;5;7422;5;5;1101;0;558;497;61
1201;5;7435;5;5;1204;0;802;666;136
1201;5;7463;5;5;1143;0;460;407;53
1201;6;7409;5;6;994;0;578;500;78
1201;6;7455;5;6;2359;0;1175;1060;115
1201;6;7466;5;6;1001;0;509;435;74
1201;6;7467;5;6;1258;0;656;553;103
1201;7;7402;5;7;1094;0;511;455;56
1201;7;7416;5;7;295;0;127;108;19
1201;7;7417;5;7;2618;0;1271;1174;97
1201;7;7462;5;7;349;3;206;169;37
1201;8;7418;5;8;639;1;236;210;26
1201;8;7432;5;8;1834;0;1138;966;172
1201;8;7436;5;8;2110;0;1107;999;108
1201;8;7446;5;8;496;0;214;182;32
1201;9;7445;5;9;1061;0;473;441;32
1201;9;7459;5;9;895;1;537;498;39
1201;9;7460;5;9;976;0;488;413;75
1202;10;7471;5;10;1261;0;718;653;65
1202;10;7506;5;10;535;0;183;145;38
1202;10;7513;5;10;1637;1;703;602;101
1202;11;7517;5;11;1506;0;679;590;89
1202;11;7520;5;11;350;0;162;118;44
1202;11;7521;5;11;416;0;241;216;25
1202;12;7485;5;12;28;0;24;20;4
1202;12;7510;5;12;1853;2;1015;924;91
1202;13;7487;5;13;2081;1;921;848;73
1202;14;7479;5;14;2412;0;1118;1013;105
1202;15;7495;5;15;1029;0;460;411;49
1202;16;7515;5;16;735;0;369;321;48
1202;1;7490;5;1;393;0;152;112;40
1202;1;7498;5;1;1824;3;1079;913;166
1202;1;7503;5;1;1783;1;988;826;162
1202;1;7507;5;1;1268;0;767;681;86
1202;1;7519;5;1;1301;1;706;599;107
1202;1;7529;5;1;2060;3;988;899;89
1202;1;7532;5;1;1193;3;707;613;94
1202;17;7504;5;17;1147;0;536;536;0
1202;18;7512;5;18;38;0;11;9;2
1202;2;7472;5;2;1464;3;797;679;118
1202;2;7475;5;2;803;0;291;233;58
1202;2;7492;5;2;882;1;570;493;77
1202;2;7496;5;2;2236;1;1214;1100;114
1202;2;7508;5;2;474;0;252;209;43
1202;2;7528;5;2;1639;1;647;590;57
1202;2;7530;5;2;1216;0;706;611;95
1202;3;7473;5;3;661;0;185;149;36
1202;3;7474;5;3;958;0;501;440;61
1202;3;7476;5;3;771;3;393;334;59
1202;3;7483;5;3;1293;1;654;623;31
1202;3;7489;5;3;733;0;363;318;45
1202;3;7501;5;3;909;0;452;402;50
1202;3;7525;5;3;1309;0;781;609;172
1202;4;7477;5;4;774;0;354;301;53
1202;4;7480;5;4;1074;2;572;488;84
1202;4;7484;5;4;2118;0;995;906;89
1202;4;7497;5;4;1181;0;673;613;60
1202;4;7500;5;4;1666;0;626;535;91
1202;4;7502;5;4;1268;1;740;615;125
1202;4;7516;5;4;500;1;249;211;38
1202;5;7486;5;5;1486;0;706;618;88
1202;5;7493;5;5;2129;0;1033;963;70
1202;5;7499;5;5;681;0;377;299;78
1202;5;7518;5;5;1430;0;623;505;118
1202;5;7524;5;5;1174;0;543;446;97
1202;5;7527;5;5;670;0;198;154;44
1202;6;7469;5;6;366;0;224;195;29
1202;6;7470;5;6;408;0;228;204;24
1202;6;7478;5;6;1277;0;694;657;37
1202;6;7488;5;6;808;1;383;323;60
1202;6;7491;5;6;1132;0;468;411;57
1202;6;7526;5;6;1002;0;324;252;72
1202;7;7482;5;7;1235;0;589;523;66
1202;7;7514;5;7;559;0;326;273;53
1202;7;7522;5;7;811;0;355;301;54
1202;7;7523;5;7;1058;0;521;472;49
1202;8;7468;5;8;361;0;98;87;11
1202;8;7509;5;8;355;0;175;142;33
1202;8;7511;5;8;2241;1;1103;1031;72
1202;8;7531;5;8;555;0;291;225;66
1202;9;7481;5;9;2281;0;1019;930;89
1202;9;7494;5;9;474;0;268;223;45
1202;9;7505;5;9;571;0;300;259;41
1203;10;7554;1;10;1406;0;754;643;111
1203;10;7595;1;10;2204;1;894;801;93
1203;10;7609;1;10;1332;0;603;501;102
1203;11;7544;1;11;1511;0;576;528;48
1203;11;7587;1;11;1252;0;609;535;74
1203;11;7607;1;11;1620;0;715;715;0
1203;12;7548;1;12;1267;0;693;605;88
1203;12;7579;1;12;1228;0;548;505;43
1203;12;7585;1;12;1194;0;522;440;82
1203;13;7540;1;13;1406;0;743;580;163
1203;13;7563;1;13;2149;0;791;719;72
1203;14;7561;1;14;2013;0;778;708;70
1203;14;7601;1;14;1534;7;794;676;118
1203;15;7543;1;15;1739;0;737;678;59
1203;15;7602;1;15;1150;1;640;560;80
1203;16;7558;1;16;1116;0;532;457;75
1203;16;7594;1;16;1070;0;379;347;32
1203;1;7552;1;1;1788;0;794;731;63
1203;1;7559;1;1;1205;0;756;656;100
1203;1;7569;1;1;1040;0;534;476;58
1203;1;7570;1;1;1352;0;566;478;88
1203;1;7599;1;1;1185;0;608;535;73
1203;17;7577;1;17;1434;0;636;572;64
1203;17;7605;1;17;2218;0;1139;991;148
1203;18;7547;1;18;2101;0;1024;914;110
1203;18;7572;1;18;534;1;290;258;32
1203;19;7575;1;19;1351;1;651;546;105
1203;19;7596;1;19;567;0;387;328;59
1203;20;7546;1;20;601;0;228;187;41
1203;20;7584;1;20;756;0;394;284;110
1203;21;7582;1;21;1767;3;1110;942;168
1203;21;7606;1;21;1463;0;497;423;74
1203;22;7565;1;22;788;0;460;400;60
1203;22;7576;1;22;1208;0;434;388;46
1203;23;7541;1;23;1522;0;565;481;84
1203;23;7550;1;23;1182;0;663;581;82
1203;24;7533;1;24;1439;0;583;510;73
1203;25;7573;1;25;1356;0;497;429;68
1203;26;7600;1;26;1228;0;521;453;68
1203;2;7542;1;2;578;1;362;300;62
1203;2;7556;1;2;1148;0;544;477;67
1203;2;7580;1;2;1615;0;679;611;68
1203;2;7589;1;2;1376;0;788;665;123
1203;2;7598;1;2;1562;0;955;823;132
1203;27;7611;1;27;80;0;58;53;5
1203;28;7590;1;28;69;0;42;42;0
1203;29;7583;1;29;117;0;57;49;8
1203;3;7538;1;3;824;0;377;292;85
1203;3;7574;1;3;1475;0;684;610;74
1203;3;7578;1;3;1616;1;768;689;79
1203;3;7581;1;3;608;0;376;280;96
1203;3;7591;1;3;1685;0;838;677;161
1203;4;7551;1;4;1229;1;519;457;62
1203;4;7560;1;4;1026;0;553;486;67
1203;4;7567;1;4;2278;0;1141;1028;113
1203;4;7571;1;4;620;2;394;310;84
1203;4;7604;1;4;2014;0;851;747;104
1203;5;7537;1;5;1526;0;908;791;117
1203;5;7545;1;5;1822;0;793;684;109
1203;5;7553;1;5;1379;0;548;476;72
1203;5;7597;1;5;1085;0;443;377;66
1203;5;7608;1;5;1174;0;601;472;129
1203;6;7549;1;6;1376;0;734;605;129
1203;6;7562;1;6;1195;0;493;442;51
1203;6;7564;1;6;625;0;372;314;58
1203;6;7610;1;6;1566;2;927;787;140
1203;6;7612;1;6;1806;0;761;671;90
1203;7;7536;1;7;1530;0;656;562;94
1203;7;7555;1;7;990;0;568;521;47
1203;7;7566;1;7;928;0;471;356;115
1203;7;7592;1;7;1714;0;790;727;63
1203;7;7603;1;7;1237;0;480;377;103
1203;8;7534;1;8;2423;0;1341;1180;161
1203;8;7535;1;8;844;0;381;358;23
1203;8;7539;1;8;1156;0;529;435;94
1203;8;7568;1;8;797;0;327;281;46
1203;8;7586;1;8;1948;0;931;846;85
1203;9;7557;1;9;1764;0;917;824;93
1203;9;7588;1;9;1318;0;561;485;76
1203;9;7593;1;9;1187;0;676;625;51
1204;10;7619;5;10;483;0;194;157;37
1204;11;7636;5;11;1065;0;468;384;84
1204;12;7621;5;12;1019;0;406;344;62
1204;13;7630;5;13;333;0;182;160;22
1204;14;7637;5;14;721;0;411;363;48
1204;15;7614;5;15;461;6;342;287;55
1204;16;7659;5;16;923;0;441;403;38
1204;1;7623;5;1;1041;12;545;498;47
1204;1;7633;5;1;1831;21;936;912;24
1204;1;7634;5;1;2211;0;958;786;172
1204;1;7639;5;1;1730;0;867;751;116
1204;1;7641;5;1;1415;2;763;676;87
1204;1;7646;5;1;1032;0;537;434;103
1204;1;7649;5;1;827;0;489;457;32
1204;17;7624;5;17;523;0;348;317;31
1204;18;7638;5;18;286;0;135;124;11
1204;19;7656;5;19;23;0;9;7;2
1204;20;7654;5;20;33;0;9;9;0
1204;2;7617;5;2;645;4;338;309;29
1204;2;7618;5;2;547;1;271;223;48
1204;2;7620;5;2;600;1;283;259;24
1204;2;7625;5;2;680;0;365;314;51
1204;2;7648;5;2;2301;0;1350;1187;163
1204;2;7652;5;2;1244;0;700;634;66
1204;2;7661;5;2;1648;6;935;847;88
1204;3;7632;5;3;1867;0;1033;826;207
1204;3;7642;5;3;665;0;331;304;27
1204;3;7645;5;3;491;0;286;255;31
1204;3;7651;5;3;2370;1;1170;1044;126
1204;3;7657;5;3;701;1;423;379;44
1204;3;7662;5;3;438;0;192;157;35
1204;4;7613;5;4;630;4;308;301;7
1204;4;7615;5;4;794;0;413;361;52
1204;4;7626;5;4;39;0;28;26;2
1204;4;7631;5;4;1439;1;866;820;46
1204;4;7655;5;4;583;0;206;174;32
1204;4;7658;5;4;436;0;245;197;48
1204;5;7635;5;5;1901;0;944;845;99
1204;5;7660;5;5;529;0;216;188;28
1204;5;7663;5;5;2703;0;1576;1471;105
1204;6;7616;5;6;617;0;269;226;43
1204;6;7643;5;6;1112;1;573;521;52
1204;6;7647;5;6;805;0;422;353;69
1204;7;7622;5;7;552;0;246;217;29
1204;7;7627;5;7;526;0;216;196;20
1204;7;7650;5;7;1244;0;681;605;76
1204;8;7629;5;8;505;0;238;213;25
1204;8;7640;5;8;596;0;281;247;34
1204;8;7644;5;8;434;0;212;168;44
1204;9;7628;5;9;1285;0;684;599;85
1204;9;7653;5;9;526;0;250;219;31
1205;10;7671;6;10;363;0;169;147;22
1205;10;7686;6;10;314;0;156;130;26
1205;10;7710;6;10;1240;1;581;548;33
1205;10;7719;6;10;1062;0;404;306;98
1205;11;7691;6;11;1933;0;723;615;108
1205;11;7698;6;11;1362;1;579;530;49
1205;11;7715;6;11;497;0;226;196;30
1205;12;7736;6;12;756;0;349;323;26
1205;12;7750;6;12;389;0;178;145;33
1205;13;7690;6;13;1428;0;635;566;69
1205;13;7709;6;13;1471;0;735;672;63
1205;14;7678;6;14;2169;1;1022;917;105
1205;15;7741;6;15;1116;0;494;467;27
1205;16;7724;6;16;1258;0;617;577;40
1205;1;7664;6;1;168;0;63;43;20
1205;1;7670;6;1;1167;0;548;453;95
1205;1;7675;6;1;1150;0;575;512;63
1205;1;7680;6;1;1395;0;690;570;120
1205;1;7685;6;1;517;0;249;223;26
1205;1;7687;6;1;1640;0;845;729;116
1205;1;7711;6;1;1879;0;1161;1045;116
1205;1;7722;6;1;618;0;337;277;60
1205;1;7727;6;1;616;0;340;308;32
1205;1;7735;6;1;696;0;442;357;85
1205;17;7753;6;17;1612;0;678;624;54
1205;18;7701;6;18;1622;0;778;687;91
1205;19;7705;6;19;1056;0;501;456;45
1205;20;7689;6;20;97;0;39;24;15
1205;21;7729;6;21;77;0;51;43;8
1205;22;7747;6;22;84;0;14;13;1
1205;2;7666;6;2;1256;0;749;611;138
1205;2;7669;6;2;1686;0;1011;924;87
1205;2;7692;6;2;1163;0;396;319;77
1205;2;7695;6;2;996;0;369;340;29
1205;2;7697;6;2;1311;0;669;528;141
1205;2;7721;6;2;990;0;424;378;46
1205;2;7723;6;2;1280;0;622;491;131
1205;2;7726;6;2;625;0;289;263;26
1205;2;7751;6;2;2240;0;1141;989;152
1205;2;7752;6;2;1776;1;931;729;202
1205;3;7672;6;3;1295;0;615;512;103
1205;3;7677;6;3;757;1;436;376;60
1205;3;7679;6;3;210;0;110;93;17
1205;3;7688;6;3;653;0;424;343;81
1205;3;7693;6;3;1627;0;703;593;110
1205;3;7699;6;3;802;0;425;366;59
1205;3;7730;6;3;1116;0;447;354;93
1205;3;7734;6;3;1660;0;904;700;204
1205;3;7742;6;3;1476;0;693;635;58
1205;3;7748;6;3;1347;0;635;523;112
1205;4;7667;6;4;637;3;337;305;32
1205;4;7673;6;4;1242;0;588;552;36
1205;4;7683;6;4;242;0;74;55;19
1205;4;7700;6;4;554;0;251;220;31
1205;4;7713;6;4;1139;0;435;359;76
1205;4;7716;6;4;769;0;360;291;69
1205;4;7733;6;4;565;0;250;190;60
1205;4;7745;6;4;605;0;307;267;40
1205;4;7746;6;4;1441;0;742;650;92
1205;5;7665;6;5;268;0;131;118;13
1205;5;7676;6;5;1972;0;748;631;117
1205;5;7703;6;5;1268;0;603;526;77
1205;5;7704;6;5;724;0;357;320;37
1205;5;7707;6;5;767;0;365;315;50
1205;5;7708;6;5;296;0;133;102;31
1205;5;7737;6;5;878;0;365;329;36
1205;5;7749;6;5;432;0;230;196;34
1205;6;7684;6;6;963;1;465;441;24
1205;6;7702;6;6;1140;0;533;475;58
1205;6;7706;6;6;157;0;48;37;11
1205;6;7720;6;6;692;0;320;259;61
1205;6;7725;6;6;344;0;222;165;57
1205;6;7728;6;6;786;1;410;343;67
1205;6;7739;6;6;502;0;219;191;28
1205;6;7740;6;6;133;0;89;65;24
1205;7;7668;6;7;213;0;103;88;15
1205;7;7681;6;7;768;2;466;412;54
1205;7;7682;6;7;1669;0;605;519;86
1205;7;7712;6;7;1580;0;704;602;102
1205;7;7718;6;7;1590;0;699;645;54
1205;7;7731;6;7;294;0;149;127;22
1205;7;7754;6;7;131;0;94;83;11
1205;8;7696;6;8;1615;0;701;622;79
1205;8;7714;6;8;1304;0;473;439;34
1205;8;7732;6;8;345;0;188;142;46
1205;8;7743;6;8;662;0;316;296;20
1205;8;7744;6;8;391;0;182;167;15
1205;9;7674;6;9;1288;0;551;450;101
1205;9;7694;6;9;453;0;209;170;39
1205;9;7717;6;9;910;0;398;367;31
1205;9;7738;6;9;1119;0;531;467;64
1206;10;7769;2;10;2237;0;1001;820;181
1206;10;7782;2;10;1121;0;503;414;89
1206;10;7860;2;10;1211;0;462;417;45
1206;10;7868;2;10;632;0;370;313;57
1206;10;7880;2;10;570;0;249;207;42
1206;10;7887;2;10;1474;0;731;671;60
1206;10;7902;2;10;1182;1;528;471;57
1206;10;7913;2;10;760;0;387;321;66
1206;11;7789;2;11;1169;4;419;419;0
1206;11;7801;2;11;1335;0;609;535;74
1206;11;7805;2;11;527;0;336;257;79
1206;11;7848;2;11;900;0;614;524;90
1206;11;7904;2;11;614;0;262;211;51
1206;12;7784;2;12;541;0;340;298;42
1206;12;7800;2;12;463;0;189;149;40
1206;12;7828;2;12;1826;0;973;793;180
1206;12;7879;2;12;1839;0;982;848;134
1206;12;7921;2;12;359;0;242;180;62
1206;13;7768;2;13;1153;0;528;420;108
1206;13;7854;2;13;1583;0;740;659;81
1206;13;7878;2;13;2349;1;1212;1061;151
1206;14;7780;2;14;1861;0;860;712;148
1206;14;7825;2;14;1429;0;662;613;49
1206;14;7882;2;14;1963;0;941;834;107
1206;15;7842;2;15;550;0;325;286;39
1206;15;7871;2;15;1238;10;634;515;119
1206;15;7922;2;15;1018;0;511;418;93
1206;16;7766;2;16;1346;3;743;586;157
1206;16;7855;2;16;1170;0;433;352;81
1206;16;7875;2;16;467;0;248;205;43
1206;1;7758;2;1;811;0;361;314;47
1206;1;7763;2;1;1446;1;627;490;137
1206;1;7764;2;1;2365;6;1166;867;299
1206;1;7776;2;1;1411;0;878;670;208
1206;17;7859;2;17;1024;0;467;403;64
1206;17;7891;2;17;278;0;148;122;26
1206;17;7894;2;17;1426;0;603;514;89
1206;1;7795;2;1;1074;1;697;590;107
1206;1;7797;2;1;1745;0;815;752;63
1206;1;7818;2;1;722;6;497;408;89
1206;1;7820;2;1;1647;0;695;535;160
1206;1;7841;2;1;1850;1;1337;1220;117
1206;1;7846;2;1;1302;0;612;449;163
1206;1;7869;2;1;1502;0;756;665;91
1206;1;7872;2;1;1396;0;705;618;87
1206;1;7883;2;1;1296;0;571;487;84
1206;1;7890;2;1;2146;0;1140;1026;114
1206;1;7908;2;1;1184;0;542;497;45
1206;1;7912;2;1;2153;0;1297;959;338
1206;1;7916;2;1;441;0;270;229;41
1206;18;7778;2;18;1393;0;670;616;54
1206;18;7865;2;18;1387;0;682;548;134
1206;18;7901;2;18;276;0;158;139;19
1206;19;7773;2;19;1006;1;492;393;99
1206;19;7845;2;19;64;0;44;35;9
1206;20;7790;2;20;1282;0;577;500;77
1206;20;7873;2;20;5;0;3;2;1
1206;21;7837;2;21;1023;0;486;373;113
1206;22;7864;2;22;713;0;361;292;69
1206;23;7867;2;23;1357;0;607;519;88
1206;2;7757;2;2;1580;1;843;727;116
1206;2;7762;2;2;972;1;633;582;51
1206;2;7788;2;2;492;0;264;207;57
1206;2;7796;2;2;1831;0;801;724;77
1206;2;7810;2;2;1949;0;945;824;121
1206;2;7811;2;2;2157;2;1083;956;127
1206;2;7823;2;2;2487;0;1238;1154;84
1206;2;7830;2;2;1794;0;822;660;162
1206;2;7835;2;2;1419;7;914;699;215
1206;2;7836;2;2;302;0;129;91;38
1206;2;7840;2;2;509;0;321;284;37
1206;2;7862;2;2;823;0;409;311;98
1206;2;7886;2;2;1930;0;1163;962;201
1206;2;7896;2;2;628;0;288;236;52
1206;2;7898;2;2;1835;0;728;658;70
1206;2;7910;2;2;1432;0;626;572;54
1206;2;7923;2;2;1391;0;652;565;87
1206;3;7759;2;3;2292;1;1246;1083;163
1206;3;7779;2;3;841;0;340;258;82
1206;3;7783;2;3;1836;1;912;736;176
1206;3;7785;2;3;393;0;213;170;43
1206;3;7808;2;3;1405;1;568;520;48
1206;3;7813;2;3;1953;6;960;783;177
1206;3;7815;2;3;821;0;352;302;50
1206;3;7833;2;3;492;0;157;138;19
1206;3;7834;2;3;1388;0;684;603;81
1206;3;7847;2;3;1101;0;710;573;137
1206;3;7853;2;3;625;5;379;331;48
1206;3;7893;2;3;1238;0;737;568;169
1206;3;7899;2;3;807;0;494;449;45
1206;3;7900;2;3;2051;0;1088;957;131
1206;3;7915;2;3;1596;0;749;630;119
1206;3;7918;2;3;2144;0;1028;850;178
1206;3;7919;2;3;1154;1;694;550;144
1206;4;7755;2;4;1335;0;706;526;180
1206;4;7767;2;4;1021;0;403;357;46
1206;4;7792;2;4;1506;2;777;691;86
1206;4;7794;2;4;2079;0;1166;957;209
1206;4;7799;2;4;1045;0;553;463;90
1206;4;7809;2;4;1106;0;604;479;125
1206;4;7817;2;4;1519;6;776;661;115
1206;4;7821;2;4;2164;1;1051;953;98
1206;4;7826;2;4;804;0;408;326;82
1206;4;7838;2;4;1763;0;883;778;105
1206;4;7844;2;4;1949;0;1057;883;174
1206;4;7852;2;4;515;0;266;196;70
1206;4;7870;2;4;1617;0;619;515;104
1206;4;7874;2;4;1048;6;505;392;113
1206;4;7884;2;4;1336;0;521;440;81
1206;4;7895;2;4;613;0;238;194;44
1206;4;7906;2;4;1740;1;748;687;61
1206;5;7765;2;5;2121;2;1276;1158;118
1206;5;7774;2;5;944;0;544;468;76
1206;5;7791;2;5;1580;0;777;705;72
1206;5;7793;2;5;1184;0;275;198;77
1206;5;7807;2;5;1314;0;560;496;64
1206;5;7814;2;5;1264;0;667;580;87
1206;5;7827;2;5;1956;0;948;840;108
1206;5;7839;2;5;1057;1;565;462;103
1206;5;7843;2;5;199;0;103;77;26
1206;5;7849;2;5;933;0;454;396;58
1206;5;7856;2;5;1015;1;524;447;77
1206;5;7857;2;5;523;0;322;275;47
1206;5;7866;2;5;371;0;165;138;27
1206;5;7877;2;5;1259;0;494;407;87
1206;5;7885;2;5;333;2;207;133;74
1206;5;7909;2;5;1996;2;840;746;94
1206;6;7756;2;6;980;0;339;266;73
1206;6;7760;2;6;1052;0;546;471;75
1206;6;7761;2;6;1290;0;599;533;66
1206;6;7772;2;6;1213;0;638;536;102
1206;6;7775;2;6;942;1;304;241;63
1206;6;7786;2;6;1273;2;703;562;141
1206;6;7798;2;6;2268;0;1332;1100;232
1206;6;7812;2;6;723;0;412;348;64
1206;6;7829;2;6;1121;0;678;595;83
1206;6;7863;2;6;1886;1;844;749;95
1206;6;7876;2;6;1850;0;1045;799;246
1206;6;7897;2;6;549;0;281;242;39
1206;6;7914;2;6;499;0;305;254;51
1206;7;7802;2;7;1517;0;718;651;67
1206;7;7806;2;7;522;0;280;253;27
1206;7;7822;2;7;1960;0;774;625;149
1206;7;7858;2;7;887;0;474;364;110
1206;7;7861;2;7;886;0;498;439;59
1206;7;7888;2;7;777;1;356;256;100
1206;7;7892;2;7;91;0;26;24;2
1206;7;7905;2;7;816;0;442;370;72
1206;7;7907;2;7;1201;0;551;453;98
1206;7;7911;2;7;1356;1;538;455;83
1206;7;7920;2;7;1005;0;518;432;86
1206;8;7781;2;8;653;0;246;201;45
1206;8;7787;2;8;1145;0;540;490;50
1206;8;7803;2;8;1948;0;776;696;80
1206;8;7819;2;8;554;0;199;165;34
1206;8;7824;2;8;1553;0;629;552;77
1206;8;7832;2;8;917;0;439;377;62
1206;8;7850;2;8;437;0;146;112;34
1206;8;7851;2;8;83;0;15;15;0
1206;8;7889;2;8;1210;0;684;488;196
1206;8;7903;2;8;713;0;382;309;73
1206;9;7770;2;9;1099;1;579;485;94
1206;9;7771;2;9;1210;1;571;497;74
1206;9;7777;2;9;1728;0;836;693;143
1206;9;7804;2;9;695;15;350;295;55
1206;9;7816;2;9;346;1;181;149;32
1206;9;7831;2;9;1021;0;432;356;76
1206;9;7881;2;9;836;0;319;260;59
1206;9;7917;2;9;2075;0;1064;977;87
1207;10;7926;6;10;1163;0;675;578;97
1207;10;7934;6;10;1213;0;624;553;71
1207;10;7982;6;10;1480;0;696;608;88
1207;11;7948;6;11;861;0;507;474;33
1207;11;7957;6;11;734;2;388;328;60
1207;11;7963;6;11;48;0;28;25;3
1207;12;7975;6;12;1199;0;679;594;85
1207;12;7989;6;12;8;0;2;2;0
1207;13;8000;6;13;523;9;307;283;24
1207;14;7998;6;14;572;0;305;261;44
1207;15;7956;6;15;991;0;442;390;52
1207;16;7986;6;16;259;0;156;131;25
1207;17;7935;6;17;636;0;358;301;57
1207;1;7930;6;1;1042;2;746;659;87
1207;1;7933;6;1;1220;0;649;578;71
1207;1;7949;6;1;1443;0;592;476;116
1207;1;7964;6;1;1743;0;957;870;87
1207;1;7967;6;1;1151;4;656;535;121
1207;1;7976;6;1;1115;0;606;552;54
1207;1;7983;6;1;1015;0;478;464;14
1207;1;7985;6;1;1195;0;677;550;127
1207;1;7993;6;1;232;0;128;121;7
1207;1;7994;6;1;1602;4;941;724;217
1207;1;7996;6;1;791;0;494;330;164
1207;1;8001;6;1;867;0;517;418;99
1207;18;8016;6;18;469;0;225;187;38
1207;19;7960;6;19;560;0;317;284;33
1207;2;7925;6;2;2101;0;1206;1090;116
1207;2;7928;6;2;1837;0;996;921;75
1207;2;7932;6;2;683;0;400;345;55
1207;2;7938;6;2;1344;2;770;657;113
1207;2;7941;6;2;2223;4;1475;1301;174
1207;2;7946;6;2;486;0;296;260;36
1207;2;7958;6;2;755;0;424;392;32
1207;2;7961;6;2;2198;0;1414;1194;220
1207;2;7977;6;2;815;0;496;396;100
1207;2;7990;6;2;768;1;378;297;81
1207;2;7991;6;2;1355;0;748;658;90
1207;2;8002;6;2;1074;0;510;444;66
1207;3;7931;6;3;429;0;240;206;34
1207;3;7942;6;3;750;0;410;362;48
1207;3;7944;6;3;1744;0;841;712;129
1207;3;7951;6;3;891;0;487;442;45
1207;3;7953;6;3;1678;0;974;787;187
1207;3;7955;6;3;992;0;557;486;71
1207;3;7962;6;3;937;0;615;513;102
1207;3;7969;6;3;1158;0;602;561;41
1207;3;7971;6;3;1109;0;685;626;59
1207;3;7984;6;3;722;0;392;321;71
1207;3;7987;6;3;1155;2;623;576;47
1207;3;7992;6;3;1501;1;805;627;178
1207;4;7936;6;4;660;0;375;301;74
1207;4;7937;6;4;852;2;483;432;51
1207;4;7939;6;4;976;0;510;477;33
1207;4;7947;6;4;566;0;370;299;71
1207;4;7952;6;4;1345;0;647;594;53
1207;4;7954;6;4;736;0;430;351;79
1207;4;7959;6;4;1753;1;1004;879;125
1207;4;7972;6;4;878;0;410;305;105
1207;4;7997;6;4;796;0;397;345;52
1207;4;8007;6;4;466;0;254;230;24
1207;4;8015;6;4;1258;0;714;646;68
1207;4;8017;6;4;654;0;431;375;56
1207;5;7927;6;5;1490;0;706;672;34
1207;5;7945;6;5;531;2;343;277;66
1207;5;7970;6;5;1270;0;580;512;68
1207;5;7974;6;5;727;0;443;386;57
1207;5;7978;6;5;838;0;434;383;51
1207;5;7979;6;5;365;0;239;226;13
1207;5;8004;6;5;977;0;595;490;105
1207;5;8011;6;5;1164;0;633;541;92
1207;5;8018;6;5;446;0;267;221;46
1207;6;7924;6;6;437;1;290;237;53
1207;6;7950;6;6;1904;2;935;842;93
1207;6;7968;6;6;1490;0;710;622;88
1207;6;7995;6;6;427;0;240;205;35
1207;6;8003;6;6;493;1;329;285;44
1207;6;8009;6;6;894;0;475;441;34
1207;6;8012;6;6;765;4;472;378;94
1207;6;8014;6;6;754;0;406;321;85
1207;7;7940;6;7;462;2;255;232;23
1207;7;7943;6;7;1585;1;1030;897;133
1207;7;7981;6;7;878;0;489;455;34
1207;7;7988;6;7;1572;0;861;778;83
1207;7;8005;6;7;263;0;167;143;24
1207;7;8006;6;7;847;0;501;474;27
1207;8;7929;6;8;960;0;383;334;49
1207;8;7966;6;8;1811;1;1034;913;121
1207;8;7973;6;8;10;0;5;5;0
1207;8;7999;6;8;1538;0;879;817;62
1207;8;8008;6;8;1068;0;434;404;30
1207;9;7965;6;9;1956;1;978;924;54
1207;9;7980;6;9;1379;0;758;677;81
1207;9;8010;6;9;650;0;315;251;64
1207;9;8013;6;9;764;0;437;379;58
1208;10;8025;2;10;1043;0;433;363;70
1208;11;8024;2;11;687;0;261;231;30
1208;12;8071;2;12;1102;0;565;452;113
1208;13;8027;2;13;757;0;342;281;61
1208;14;8040;2;14;781;0;388;333;55
1208;15;8066;2;15;50;0;10;10;0
1208;16;8026;2;16;47;0;30;23;7
1208;17;8057;2;17;55;0;13;13;0
1208;1;8022;2;1;803;1;465;402;63
1208;1;8028;2;1;1262;1;684;532;152
1208;1;8029;2;1;1786;2;884;811;73
1208;1;8036;2;1;1132;0;599;525;74
1208;1;8038;2;1;535;0;344;270;74
1208;1;8044;2;1;1104;0;585;519;66
1208;1;8075;2;1;1304;0;806;703;103
1208;2;8023;2;2;689;0;300;260;40
1208;2;8042;2;2;424;0;246;212;34
1208;2;8043;2;2;954;3;582;459;123
1208;2;8055;2;2;346;0;238;193;45
1208;2;8059;2;2;1036;1;636;551;85
1208;2;8064;2;2;392;0;220;188;32
1208;2;8072;2;2;1772;4;1007;885;122
1208;3;8019;2;3;660;2;450;348;102
1208;3;8020;2;3;1242;0;715;583;132
1208;3;8021;2;3;547;0;277;268;9
1208;3;8033;2;3;612;0;384;343;41
1208;3;8045;2;3;817;0;343;306;37
1208;3;8060;2;3;439;0;232;194;38
1208;3;8063;2;3;2139;1;1186;1054;132
1208;4;8035;2;4;485;0;216;173;43
1208;4;8039;2;4;279;0;178;139;39
1208;4;8046;2;4;1367;0;683;599;84
1208;4;8048;2;4;1289;0;612;534;78
1208;4;8056;2;4;546;0;319;251;68
1208;4;8073;2;4;422;0;246;217;29
1208;5;8037;2;5;1286;0;770;666;104
1208;5;8053;2;5;834;2;343;274;69
1208;5;8062;2;5;447;0;248;204;44
1208;5;8067;2;5;820;0;489;395;94
1208;5;8074;2;5;723;2;436;372;64
1208;6;8041;2;6;591;0;243;192;51
1208;6;8047;2;6;1841;0;1085;969;116
1208;6;8050;2;6;477;0;312;253;59
1208;6;8054;2;6;279;0;145;124;21
1208;6;8061;2;6;547;4;251;206;45
1208;7;8031;2;7;461;0;240;204;36
1208;7;8032;2;7;434;0;264;215;49
1208;7;8049;2;7;705;0;340;277;63
1208;7;8052;2;7;257;0;174;149;25
1208;7;8070;2;7;331;0;139;124;15
1208;8;8034;2;8;32;0;17;14;3
1208;8;8051;2;8;974;0;531;436;95
1208;8;8058;2;8;211;0;120;94;26
1208;8;8068;2;8;229;0;157;137;20
1208;9;8030;2;9;666;3;334;268;66
1208;9;8065;2;9;214;0;138;114;24
1208;9;8069;2;9;74;0;27;27;0
1209;10;8080;4;10;751;0;347;279;68
1209;11;8136;4;11;1000;0;529;488;41
1209;12;8125;4;12;1309;0;500;422;78
1209;13;8123;4;13;2216;0;1036;911;125
1209;14;8095;4;14;1221;2;639;563;76
1209;15;8149;4;15;2147;0;1008;907;101
1209;16;8114;4;16;1660;0;780;668;112
1209;17;8134;4;17;775;0;444;396;48
1209;1;8089;4;1;332;0;218;176;42
1209;1;8093;4;1;2185;0;765;658;107
1209;1;8102;4;1;2076;13;1267;1095;172
1209;1;8113;4;1;1793;0;1121;1010;111
1209;1;8118;4;1;1043;2;577;489;88
1209;1;8119;4;1;1799;0;1132;892;240
1209;1;8126;4;1;1449;2;754;665;89
1209;1;8138;4;1;1432;0;877;738;139
1209;1;8143;4;1;1423;1;775;640;135
1209;18;8124;4;18;850;0;568;482;86
1209;19;8091;4;19;861;0;511;459;52
1209;20;8147;4;20;1304;0;720;644;76
1209;21;8117;4;21;918;0;580;506;74
1209;22;8131;4;22;1899;0;993;850;143
1209;23;8082;4;23;596;0;358;285;73
1209;24;8100;4;24;580;0;360;324;36
1209;25;8078;4;25;38;0;4;3;1
1209;26;8139;4;26;54;0;25;23;2
1209;2;8088;4;2;946;6;497;431;66
1209;2;8092;4;2;1676;0;727;647;80
1209;2;8104;4;2;2026;0;1083;973;110
1209;2;8108;4;2;1452;1;928;787;141
1209;2;8110;4;2;1363;0;719;550;169
1209;2;8135;4;2;355;1;238;189;49
1209;2;8140;4;2;1317;0;632;494;138
1209;2;8141;4;2;2207;1;1252;1127;125
1209;2;8151;4;2;1142;0;656;523;133
1209;3;8077;4;3;824;0;335;275;60
1209;3;8079;4;3;1050;0;664;584;80
1209;3;8083;4;3;1617;0;776;654;122
1209;3;8094;4;3;1460;0;723;526;197
1209;3;8099;4;3;1160;4;560;461;99
1209;3;8101;4;3;1446;0;858;767;91
1209;3;8107;4;3;1598;2;1008;859;149
1209;3;8109;4;3;1393;0;666;603;63
1209;3;8148;4;3;1198;0;839;582;257
1209;4;8076;4;4;783;2;424;388;36
1209;4;8106;4;4;1323;1;660;508;152
1209;4;8111;4;4;382;1;282;246;36
1209;4;8132;4;4;660;0;308;240;68
1209;4;8133;4;4;1049;0;654;551;103
1209;4;8142;4;4;1097;0;679;638;41
1209;4;8144;4;4;617;5;335;281;54
1209;4;8145;4;4;1542;0;589;455;134
1209;4;8146;4;4;1577;0;744;680;64
1209;5;8084;4;5;2157;0;940;828;112
1209;5;8086;4;5;332;0;165;132;33
1209;5;8097;4;5;1328;0;823;722;101
1209;5;8115;4;5;1403;0;887;845;42
1209;5;8122;4;5;1196;0;683;625;58
1209;5;8128;4;5;931;2;527;442;85
1209;5;8129;4;5;1383;0;536;413;123
1209;6;8081;4;6;1318;0;597;532;65
1209;6;8085;4;6;1249;0;613;467;146
1209;6;8096;4;6;519;0;262;234;28
1209;6;8105;4;6;491;4;323;265;58
1209;6;8116;4;6;1490;0;921;857;64
1209;6;8130;4;6;1779;0;947;791;156
1209;7;8087;4;7;1366;0;751;588;163
1209;7;8090;4;7;1648;2;1099;910;189
1209;7;8103;4;7;67;0;35;31;4
1209;7;8127;4;7;1988;1;1247;1145;102
1209;7;8137;4;7;1234;0;522;437;85
1209;8;8098;4;8;790;0;388;334;54
1209;8;8112;4;8;1183;1;687;632;55
1209;8;8150;4;8;722;0;382;303;79
1209;9;8120;4;9;2124;3;1185;1066;119
1209;9;8121;4;9;1219;0;594;510;84
1210;10;8158;6;10;387;0;207;169;38
1210;10;8162;6;10;336;0;157;131;26
1210;10;8193;6;10;1082;0;576;531;45
1210;10;8237;6;10;296;0;165;137;28
1210;10;8244;6;10;979;2;580;533;47
1210;10;8258;6;10;1192;0;637;564;73
1210;10;8279;6;10;59;0;59;51;8
1210;11;8165;6;11;510;0;275;221;54
1210;11;8206;6;11;1502;0;836;717;119
1210;11;8212;6;11;511;0;311;252;59
1210;11;8257;6;11;700;0;409;338;71
1210;11;8262;6;11;561;0;345;282;63
1210;11;8273;6;11;1183;0;718;585;133
1210;11;8288;6;11;931;0;488;432;56
1210;12;8211;6;12;509;1;272;251;21
1210;12;8223;6;12;1102;0;556;485;71
1210;12;8272;6;12;665;0;459;409;50
1210;12;8275;6;12;753;1;362;303;59
1210;12;8301;6;12;413;0;237;186;51
1210;12;8303;6;12;487;0;279;237;42
1210;13;8189;6;13;592;0;339;295;44
1210;13;8198;6;13;197;0;142;121;21
1210;13;8207;6;13;1913;0;1069;939;130
1210;13;8229;6;13;885;0;483;399;84
1210;13;8285;6;13;637;0;311;280;31
1210;14;8181;6;14;512;0;279;250;29
1210;14;8218;6;14;260;0;151;120;31
1210;14;8250;6;14;212;0;111;82;29
1210;14;8286;6;14;465;0;245;201;44
1210;14;8307;6;14;290;0;178;161;17
1210;15;8182;6;15;481;0;265;224;41
1210;15;8234;6;15;239;0;145;92;53
1210;15;8260;6;15;576;0;382;349;33
1210;15;8267;6;15;511;0;269;236;33
1210;16;8289;6;16;337;1;184;164;20
1210;16;8305;6;16;347;0;254;217;37
1210;17;8224;6;17;442;0;238;211;27
1210;17;8245;6;17;686;0;441;410;31
1210;1;8153;6;1;1053;0;645;597;48
1210;1;8156;6;1;1064;1;574;504;70
1210;1;8161;6;1;1148;1;606;540;66
1210;1;8163;6;1;1735;5;1121;864;257
1210;1;8184;6;1;965;0;513;463;50
1210;1;8191;6;1;1371;0;608;539;69
1210;1;8213;6;1;1400;0;849;635;214
1210;1;8238;6;1;529;0;317;252;65
1210;1;8239;6;1;2050;4;1438;1171;267
1210;1;8243;6;1;1327;0;729;676;53
1210;1;8254;6;1;2141;0;1079;892;187
1210;1;8255;6;1;1439;1;968;808;160
1210;1;8274;6;1;1498;0;794;720;74
1210;1;8278;6;1;1094;0;679;549;130
1210;1;8291;6;1;1988;1;1038;922;116
1210;1;8314;6;1;1937;8;1222;1052;170
1210;18;8247;6;18;11;0;8;8;0
1210;18;8283;6;18;1172;0;733;634;99
1210;19;8152;6;19;122;0;85;72;13
1210;20;8169;6;20;362;0;244;165;79
1210;21;8199;6;21;1335;0;794;735;59
1210;2;8154;6;2;1423;3;789;679;110
1210;2;8168;6;2;1427;0;863;808;55
1210;2;8176;6;2;908;0;372;323;49
1210;2;8186;6;2;1680;0;904;826;78
1210;2;8196;6;2;471;0;244;183;61
1210;2;8202;6;2;905;0;412;346;66
1210;2;8219;6;2;1189;3;777;642;135
1210;2;8222;6;2;911;0;401;352;49
1210;2;8231;6;2;599;0;355;295;60
1210;2;8236;6;2;1303;7;830;680;150
1210;2;8248;6;2;1935;0;983;870;113
1210;2;8295;6;2;1351;0;706;618;88
1210;2;8296;6;2;842;0;375;340;35
1210;2;8299;6;2;1617;0;660;545;115
1210;2;8310;6;2;564;0;365;307;58
1210;2;8315;6;2;2025;0;1053;985;68
1210;3;8166;6;3;1086;1;663;525;138
1210;3;8177;6;3;1202;2;778;615;163
1210;3;8178;6;3;1093;0;656;612;44
1210;3;8183;6;3;1419;0;724;600;124
1210;3;8185;6;3;757;0;444;394;50
1210;3;8187;6;3;1394;1;769;654;115
1210;3;8188;6;3;1248;0;819;649;170
1210;3;8192;6;3;786;0;329;277;52
1210;3;8194;6;3;1378;1;749;692;57
1210;3;8195;6;3;1652;5;1089;846;243
1210;3;8208;6;3;631;0;298;263;35
1210;3;8209;6;3;1367;0;674;611;63
1210;3;8217;6;3;959;0;415;354;61
1210;3;8220;6;3;1200;0;642;542;100
1210;3;8270;6;3;1730;0;889;806;83
1210;4;8157;6;4;592;0;315;264;51
1210;4;8159;6;4;49;0;32;27;5
1210;4;8172;6;4;979;3;479;411;68
1210;4;8173;6;4;1045;0;545;470;75
1210;4;8175;6;4;1010;0;566;487;79
1210;4;8190;6;4;820;0;550;436;114
1210;4;8204;6;4;788;0;354;299;55
1210;4;8210;6;4;378;0;142;115;27
1210;4;8232;6;4;1103;0;541;435;106
1210;4;8259;6;4;677;0;329;295;34
1210;4;8264;6;4;766;2;465;370;95
1210;4;8271;6;4;1169;0;629;519;110
1210;4;8294;6;4;1613;0;967;815;152
1210;4;8298;6;4;316;0;156;144;12
1210;4;8309;6;4;2164;2;1130;1004;126
1210;5;8160;6;5;784;0;262;226;36
1210;5;8170;6;5;1226;0;707;601;106
1210;5;8205;6;5;361;0;141;122;19
1210;5;8233;6;5;1272;0;719;599;120
1210;5;8235;6;5;830;0;454;415;39
1210;5;8241;6;5;481;0;172;152;20
1210;5;8251;6;5;828;0;483;404;79
1210;5;8252;6;5;809;0;443;382;61
1210;5;8261;6;5;1190;0;756;649;107
1210;5;8263;6;5;676;0;361;300;61
1210;5;8265;6;5;963;0;556;477;79
1210;5;8277;6;5;456;0;231;190;41
1210;5;8290;6;5;225;3;111;83;28
1210;5;8306;6;5;446;0;302;269;33
1210;5;8308;6;5;833;0;540;489;51
1210;6;8164;6;6;1402;0;660;581;79
1210;6;8174;6;6;408;0;131;115;16
1210;6;8179;6;6;642;0;292;267;25
1210;6;8180;6;6;576;0;349;314;35
1210;6;8203;6;6;1345;0;712;621;91
1210;6;8214;6;6;1557;1;865;807;58
1210;6;8216;6;6;944;0;594;484;110
1210;6;8230;6;6;1442;4;913;773;140
1210;6;8240;6;6;1565;0;826;738;88
1210;6;8249;6;6;427;0;251;228;23
1210;6;8268;6;6;451;0;236;198;38
1210;6;8287;6;6;1454;0;871;731;140
1210;6;8304;6;6;614;2;362;335;27
1210;7;8197;6;7;546;0;311;272;39
1210;7;8215;6;7;1759;0;906;773;133
1210;7;8225;6;7;574;0;265;234;31
1210;7;8226;6;7;1353;0;797;730;67
1210;7;8227;6;7;1295;2;695;665;30
1210;7;8253;6;7;1012;1;420;377;43
1210;7;8256;6;7;1913;1;1116;975;141
1210;7;8266;6;7;793;0;410;349;61
1210;7;8276;6;7;1269;0;741;567;174
1210;7;8280;6;7;63;0;49;45;4
1210;7;8281;6;7;634;0;339;277;62
1210;7;8292;6;7;1133;1;711;607;104
1210;7;8312;6;7;1562;0;727;622;105
1210;8;8155;6;8;1060;1;591;545;46
1210;8;8167;6;8;861;0;629;555;74
1210;8;8171;6;8;1285;0;771;627;144
1210;8;8201;6;8;782;0;369;310;59
1210;8;8221;6;8;801;0;490;420;70
1210;8;8246;6;8;623;0;365;307;58
1210;8;8282;6;8;517;0;200;200;0
1210;8;8300;6;8;1950;2;937;801;136
1210;8;8302;6;8;287;0;132;106;26
1210;8;8313;6;8;1214;0;683;575;108
1210;9;8200;6;9;440;1;308;249;59
1210;9;8228;6;9;885;0;557;468;89
1210;9;8242;6;9;1492;1;835;764;71
1210;9;8269;6;9;1667;0;943;828;115
1210;9;8284;6;9;1506;0;810;723;87
1210;9;8293;6;9;573;0;332;276;56
1210;9;8297;6;9;1458;3;682;611;71
1210;9;8311;6;9;165;0;68;57;11
1211;10;8344;4;10;50;0;35;20;15
1211;10;8372;4;10;846;0;259;235;24
1211;10;8393;4;10;1109;0;501;415;86
1211;10;8402;4;10;881;0;457;369;88
1211;10;8403;4;10;1461;0;644;582;62
1211;10;8435;4;10;1987;0;959;888;71
1211;10;8442;4;10;1089;1;543;428;115
1211;11;8317;4;11;1118;0;645;544;101
1211;11;8378;4;11;1478;0;591;547;44
1211;11;8388;4;11;749;0;267;246;21
1211;11;8413;4;11;1125;0;502;416;86
1211;11;8432;4;11;847;0;337;277;60
1211;12;8316;4;12;512;0;133;119;14
1211;12;8355;4;12;1294;0;512;447;65
1211;12;8450;4;12;29;0;17;14;3
1211;12;8455;4;12;756;0;278;249;29
1211;13;8330;4;13;816;0;323;270;53
1211;13;8349;4;13;695;0;257;244;13
1211;13;8377;4;13;38;0;20;18;2
1211;13;8440;4;13;1736;1;835;749;86
1211;14;8429;4;14;811;0;270;261;9
1211;14;8430;4;14;546;0;195;175;20
1211;14;8431;4;14;1546;0;605;553;52
1211;15;8367;4;15;411;0;118;94;24
1211;15;8405;4;15;1775;1;849;798;51
1211;15;8441;4;15;661;0;178;152;26
1211;16;8329;4;16;2061;0;925;862;63
1211;16;8359;4;16;691;0;240;212;28
1211;16;8395;4;16;1850;0;593;498;95
1211;17;8333;4;17;1675;0;669;602;67
1211;17;8357;4;17;616;0;208;186;22
1211;17;8365;4;17;740;0;194;169;25
1211;1;8318;4;1;1351;0;505;410;95
1211;1;8340;4;1;960;0;548;475;73
1211;1;8342;4;1;1393;0;732;596;136
1211;1;8346;4;1;1299;0;626;525;101
1211;1;8354;4;1;477;0;279;229;50
1211;1;8382;4;1;1604;0;548;435;113
1211;1;8386;4;1;441;0;237;189;48
1211;1;8387;4;1;1595;2;752;634;118
1211;1;8392;4;1;654;0;290;229;61
1211;1;8404;4;1;1078;5;468;414;54
1211;1;8409;4;1;843;0;448;386;62
1211;1;8414;4;1;835;0;403;287;116
1211;1;8419;4;1;1110;0;470;422;48
1211;1;8454;4;1;903;0;256;228;28
1211;18;8324;4;18;585;0;247;217;30
1211;18;8328;4;18;577;0;209;158;51
1211;18;8408;4;18;57;0;9;9;0
1211;19;8331;4;19;937;0;390;349;41
1211;19;8335;4;19;386;1;177;149;28
1211;20;8338;4;20;434;0;204;157;47
1211;20;8410;4;20;311;0;143;121;22
1211;21;8373;4;21;447;0;220;195;25
1211;21;8383;4;21;1417;0;560;459;101
1211;2;8322;4;2;249;0;149;127;22
1211;2;8343;4;2;1701;4;808;634;174
1211;2;8371;4;2;1812;0;808;655;153
1211;2;8376;4;2;1758;1;952;771;181
1211;2;8381;4;2;486;0;219;170;49
1211;2;8390;4;2;654;0;359;314;45
1211;2;8398;4;2;973;0;407;352;55
1211;2;8400;4;2;424;0;214;180;34
1211;2;8411;4;2;1017;0;593;457;136
1211;2;8420;4;2;1066;1;519;427;92
1211;2;8422;4;2;778;0;187;167;20
1211;2;8445;4;2;1432;3;841;698;143
1211;2;8447;4;2;2024;0;894;807;87
1211;2;8452;4;2;1403;0;752;669;83
1211;3;8319;4;3;1230;0;610;531;79
1211;3;8323;4;3;357;0;107;88;19
1211;3;8358;4;3;374;0;160;132;28
1211;3;8379;4;3;792;0;498;457;41
1211;3;8391;4;3;1063;0;502;432;70
1211;3;8394;4;3;2065;0;943;845;98
1211;3;8397;4;3;735;0;443;319;124
1211;3;8417;4;3;1295;0;658;564;94
1211;3;8427;4;3;1302;0;823;685;138
1211;3;8437;4;3;975;0;455;401;54
1211;3;8444;4;3;2200;1;888;715;173
1211;3;8446;4;3;347;0;132;109;23
1211;3;8456;4;3;1275;0;684;489;195
1211;3;8457;4;3;1376;0;663;548;115
1211;4;8320;4;4;674;0;286;211;75
1211;4;8337;4;4;1405;0;619;490;129
1211;4;8339;4;4;1019;0;557;494;63
1211;4;8366;4;4;818;0;265;220;45
1211;4;8384;4;4;1085;0;537;412;125
1211;4;8385;4;4;1277;0;685;574;111
1211;4;8389;4;4;972;3;418;328;90
1211;4;8412;4;4;615;0;233;184;49
1211;4;8416;4;4;946;0;502;441;61
1211;4;8421;4;4;1025;0;445;379;66
1211;4;8426;4;4;909;0;502;445;57
1211;4;8436;4;4;810;0;496;417;79
1211;4;8449;4;4;1198;0;518;458;60
1211;5;8326;4;5;210;0;140;118;22
1211;5;8336;4;5;1123;0;521;452;69
1211;5;8345;4;5;693;0;388;296;92
1211;5;8348;4;5;765;0;312;240;72
1211;5;8356;4;5;300;0;171;149;22
1211;5;8380;4;5;639;0;225;203;22
1211;5;8399;4;5;1172;0;612;443;169
1211;5;8401;4;5;1496;1;726;638;88
1211;5;8406;4;5;1695;0;906;848;58
1211;5;8418;4;5;758;0;440;324;116
1211;5;8424;4;5;604;0;301;252;49
1211;5;8434;4;5;1857;0;903;739;164
1211;6;8332;4;6;542;0;315;238;77
1211;6;8341;4;6;1381;2;775;733;42
1211;6;8351;4;6;721;0;296;254;42
1211;6;8360;4;6;775;0;266;217;49
1211;6;8361;4;6;434;0;218;190;28
1211;6;8363;4;6;814;0;400;325;75
1211;6;8364;4;6;1309;0;469;389;80
1211;6;8396;4;6;1487;0;829;691;138
1211;6;8423;4;6;1874;0;799;685;114
1211;6;8443;4;6;1278;0;630;585;45
1211;6;8451;4;6;430;0;232;198;34
1211;7;8325;4;7;1317;0;463;376;87
1211;7;8347;4;7;1130;0;534;479;55
1211;7;8350;4;7;1615;0;881;803;78
1211;7;8352;4;7;1024;0;407;357;50
1211;7;8370;4;7;177;0;101;83;18
1211;7;8374;4;7;661;0;259;222;37
1211;7;8415;4;7;308;0;187;144;43
1211;7;8458;4;7;1323;0;355;301;54
1211;8;8327;4;8;1075;0;495;402;93
1211;8;8353;4;8;1262;0;338;291;47
1211;8;8362;4;8;657;0;220;192;28
1211;8;8368;4;8;996;0;520;429;91
1211;8;8407;4;8;1885;0;669;610;59
1211;8;8433;4;8;1768;0;731;613;118
1211;8;8438;4;8;1718;0;770;710;60
1211;8;8448;4;8;1651;0;938;820;118
1211;9;8321;4;9;407;0;191;161;30
1211;9;8334;4;9;657;0;271;271;0
1211;9;8369;4;9;197;0;109;92;17
1211;9;8375;4;9;1006;0;353;310;43
1211;9;8425;4;9;792;0;317;274;43
1211;9;8428;4;9;2026;0;1137;1032;105
1211;9;8439;4;9;1453;0;495;431;64
1211;9;8453;4;9;1266;0;580;503;77
1212;10;8468;1;10;2390;0;995;910;85
1212;10;8472;1;10;451;4;339;304;35
1212;10;8503;1;10;738;0;377;335;42
1212;11;8480;1;11;1974;1;912;835;77
1212;11;8482;1;11;503;0;325;303;22
1212;11;8516;1;11;823;2;529;467;62
1212;12;8474;1;12;1701;0;670;606;64
1212;12;8526;1;12;404;0;187;174;13
1212;13;8463;1;13;1960;2;880;793;87
1212;13;8532;1;13;1221;0;565;504;61
1212;14;8490;1;14;1819;0;709;645;64
1212;14;8497;1;14;1431;0;818;766;52
1212;15;8494;1;15;2071;0;940;871;69
1212;15;8528;1;15;1606;0;897;849;48
1212;16;8475;1;16;1138;0;610;551;59
1212;16;8530;1;16;1883;0;853;768;85
1212;17;8517;1;17;2085;0;877;800;77
1212;17;8522;1;17;890;0;545;495;50
1212;1;8465;1;1;942;0;461;412;49
1212;1;8478;1;1;2233;0;1246;1037;209
1212;1;8483;1;1;742;0;391;331;60
1212;1;8485;1;1;2100;0;1191;985;206
1212;1;8487;1;1;713;0;381;345;36
1212;1;8498;1;1;2313;4;1298;1115;183
1212;18;8461;1;18;1005;0;601;550;51
1212;18;8467;1;18;715;0;437;402;35
1212;19;8493;1;19;637;0;325;304;21
1212;19;8534;1;19;1254;1;752;714;38
1212;20;8501;1;20;1556;0;859;800;59
1212;20;8513;1;20;374;0;214;190;24
1212;21;8531;1;21;942;0;525;438;87
1212;22;8529;1;22;1363;1;756;656;100
1212;23;8491;1;23;800;0;486;432;54
1212;24;8464;1;24;443;0;258;203;55
1212;25;8537;1;25;822;0;445;393;52
1212;26;8466;1;26;875;0;532;473;59
1212;27;8504;1;27;1117;0;744;666;78
1212;2;8470;1;2;878;0;530;440;90
1212;2;8476;1;2;432;0;289;263;26
1212;2;8506;1;2;1216;1;723;612;111
1212;2;8508;1;2;1502;3;845;800;45
1212;2;8511;1;2;1694;0;863;753;110
1212;2;8514;1;2;1840;1;981;894;87
1212;28;8460;1;28;470;0;289;214;75
1212;29;8459;1;29;501;0;315;267;48
1212;30;8512;1;30;567;0;385;320;65
1212;31;8495;1;31;1125;0;631;542;89
1212;32;8505;1;32;85;0;29;25;4
1212;33;8502;1;33;59;0;17;17;0
1212;3;8469;1;3;1639;2;961;819;142
1212;3;8473;1;3;2187;1;993;819;174
1212;3;8481;1;3;2144;1;1221;1146;75
1212;3;8492;1;3;1366;5;761;672;89
1212;3;8525;1;3;627;0;434;418;16
1212;3;8527;1;3;1124;0;648;508;140
1212;4;8462;1;4;770;0;395;348;47
1212;4;8484;1;4;1456;0;731;595;136
1212;4;8489;1;4;1599;1;962;711;251
1212;4;8500;1;4;1552;1;811;762;49
1212;4;8520;1;4;796;0;453;418;35
1212;4;8535;1;4;2210;1;1095;922;173
1212;5;8471;1;5;1182;1;758;690;68
1212;5;8499;1;5;1473;0;703;649;54
1212;5;8509;1;5;622;0;326;285;41
1212;5;8510;1;5;48;0;29;22;7
1212;5;8515;1;5;962;1;501;459;42
1212;6;8496;1;6;1289;0;525;475;50
1212;6;8518;1;6;1305;0;678;588;90
1212;6;8521;1;6;816;0;414;404;10
1212;6;8533;1;6;1926;3;803;731;72
1212;7;8477;1;7;777;0;430;398;32
1212;7;8486;1;7;1211;5;568;492;76
1212;7;8507;1;7;869;0;522;498;24
1212;8;8479;1;8;1387;0;757;706;51
1212;8;8488;1;8;1638;0;747;701;46
1212;8;8524;1;8;1253;0;745;710;35
1212;9;8519;1;9;588;4;391;356;35
1212;9;8523;1;9;455;0;321;280;41
1212;9;8536;1;9;2351;0;972;909;63
1213;10;8539;1;10;1218;0;601;530;71
1213;10;8555;1;10;1936;0;784;699;85
1213;10;8588;1;10;723;0;388;342;46
1213;10;8603;1;10;1762;0;856;764;92
1213;10;8633;1;10;2174;0;1163;1058;105
1213;11;8546;1;11;1279;0;476;426;50
1213;11;8576;1;11;1409;0;636;581;55
1213;11;8596;1;11;1405;0;722;654;68
1213;11;8619;1;11;35;0;20;13;7
1213;11;8620;1;11;1787;1;892;751;141
1213;12;8544;1;12;880;0;422;384;38
1213;12;8573;1;12;949;0;461;393;68
1213;12;8594;1;12;1068;0;547;449;98
1213;12;8609;1;12;299;0;161;140;21
1213;13;8553;1;13;1030;2;534;424;110
1213;13;8574;1;13;1327;0;684;612;72
1213;13;8587;1;13;373;0;251;206;45
1213;13;8589;1;13;229;0;165;148;17
1213;14;8568;1;14;1527;0;789;687;102
1213;14;8572;1;14;663;0;335;280;55
1213;14;8582;1;14;1815;1;1010;942;68
1213;14;8613;1;14;25;0;13;10;3
1213;15;8547;1;15;1168;0;578;491;87
1213;15;8627;1;15;623;0;318;249;69
1213;15;8628;1;15;1047;0;473;414;59
1213;16;8570;1;16;1700;0;783;673;110
1213;16;8614;1;16;1579;0;758;694;64
1213;17;8577;1;17;33;0;29;26;3
1213;17;8581;1;17;1769;0;877;827;50
1213;1;8543;1;1;1451;0;673;634;39
1213;1;8556;1;1;2023;0;877;762;115
1213;1;8571;1;1;1773;0;829;721;108
1213;1;8575;1;1;2346;0;1279;959;320
1213;1;8611;1;1;1526;2;878;698;180
1213;1;8615;1;1;972;0;449;399;50
1213;1;8617;1;1;1387;0;598;500;98
1213;1;8625;1;1;1435;0;838;741;97
1213;1;8637;1;1;2100;1;1001;902;99
1213;18;8566;1;18;1424;0;675;619;56
1213;19;8561;1;19;1760;0;893;837;56
1213;20;8563;1;20;1713;0;788;721;67
1213;21;8569;1;21;778;0;357;322;35
1213;22;8629;1;22;1662;0;751;677;74
1213;23;8595;1;23;1087;0;596;521;75
1213;24;8540;1;24;1812;0;993;894;99
1213;25;8551;1;25;61;0;40;34;6
1213;2;8542;1;2;357;0;201;146;55
1213;2;8583;1;2;968;0;483;426;57
1213;2;8584;1;2;1316;0;755;598;157
1213;2;8585;1;2;919;3;609;479;130
1213;2;8590;1;2;1681;0;800;652;148
1213;2;8592;1;2;1803;0;885;813;72
1213;2;8608;1;2;1622;4;684;603;81
1213;2;8618;1;2;486;0;295;249;46
1213;2;8622;1;2;2030;0;950;846;104
1213;3;8538;1;3;1585;0;731;627;104
1213;3;8545;1;3;1400;0;704;565;139
1213;3;8552;1;3;1181;0;571;538;33
1213;3;8562;1;3;1420;0;599;544;55
1213;3;8591;1;3;1966;0;858;763;95
1213;3;8601;1;3;587;0;236;186;50
1213;3;8604;1;3;1797;0;1123;737;386
1213;3;8605;1;3;908;2;659;521;138
1213;3;8610;1;3;2188;0;1108;979;129
1213;4;8557;1;4;1057;0;450;374;76
1213;4;8598;1;4;750;2;441;363;78
1213;4;8606;1;4;1485;0;708;637;71
1213;4;8607;1;4;1937;0;995;914;81
1213;4;8616;1;4;2252;0;1016;876;140
1213;4;8635;1;4;1728;1;980;888;92
1213;4;8636;1;4;1753;0;777;696;81
1213;5;8550;1;5;1463;0;788;702;86
1213;5;8558;1;5;527;0;240;210;30
1213;5;8600;1;5;1141;0;553;474;79
1213;5;8626;1;5;1382;1;743;676;67
1213;5;8630;1;5;1639;0;915;838;77
1213;5;8631;1;5;562;1;217;204;13
1213;6;8541;1;6;1584;0;798;697;101
1213;6;8559;1;6;1197;1;585;508;77
1213;6;8579;1;6;1166;0;506;456;50
1213;6;8580;1;6;1491;0;831;733;98
1213;6;8586;1;6;601;0;243;199;44
1213;6;8602;1;6;1933;1;944;829;115
1213;7;8554;1;7;396;0;207;148;59
1213;7;8560;1;7;1546;0;674;614;60
1213;7;8597;1;7;1174;0;578;482;96
1213;7;8621;1;7;1200;0;594;538;56
1213;7;8624;1;7;583;0;315;262;53
1213;7;8634;1;7;2434;0;1312;1181;131
1213;8;8548;1;8;2110;0;1019;919;100
1213;8;8564;1;8;38;0;23;20;3
1213;8;8565;1;8;1221;0;709;605;104
1213;8;8578;1;8;1804;0;944;838;106
1213;8;8623;1;8;358;0;169;133;36
1213;8;8632;1;8;1360;0;597;504;93
1213;9;8549;1;9;1100;15;468;420;48
1213;9;8567;1;9;1508;0;636;534;102
1213;9;8593;1;9;527;0;295;216;79
1213;9;8599;1;9;273;0;174;145;29
1213;9;8612;1;9;933;0;406;360;46
1214;10;8653;2;10;872;0;430;357;73
1214;11;8669;2;11;16;0;3;3;0
1214;1;8639;2;1;1032;0;603;548;55
1214;1;8647;2;1;1344;2;892;801;91
1214;1;8654;2;1;1735;3;779;710;69
1214;1;8660;2;1;1113;0;587;492;95
1214;1;8671;2;1;971;0;438;379;59
1214;1;8672;2;1;2073;16;1012;865;147
1214;2;8641;2;2;785;0;432;373;59
1214;2;8643;2;2;682;0;358;331;27
1214;2;8656;2;2;1834;13;868;707;161
1214;2;8659;2;2;578;0;311;274;37
1214;2;8664;2;2;782;0;311;254;57
1214;2;8665;2;2;1179;0;585;547;38
1214;3;8651;2;3;1610;3;903;833;70
1214;3;8655;2;3;478;0;146;135;11
1214;3;8657;2;3;541;0;150;121;29
1214;3;8658;2;3;480;0;285;255;30
1214;3;8661;2;3;850;4;456;363;93
1214;3;8670;2;3;1199;0;681;565;116
1214;4;8638;2;4;1193;0;445;362;83
1214;4;8640;2;4;836;0;412;378;34
1214;4;8644;2;4;397;0;254;213;41
1214;4;8652;2;4;332;0;148;118;30
1214;4;8662;2;4;2366;1;1231;1094;137
1214;5;8646;2;5;1563;2;692;606;86
1214;5;8648;2;5;1024;0;594;501;93
1214;5;8650;2;5;365;0;212;186;26
1214;5;8674;2;5;655;0;354;316;38
1214;6;8668;2;6;919;0;417;363;54
1214;6;8673;2;6;918;1;424;378;46
1214;7;8645;2;7;1101;0;515;458;57
1214;7;8649;2;7;85;0;57;51;6
1214;8;8663;2;8;832;0;384;334;50
1214;8;8667;2;8;409;0;164;142;22
1214;9;8642;2;9;1129;0;490;419;71
1214;9;8666;2;9;959;0;472;406;66
1215;1;8676;4;1;1914;0;1046;875;171
1215;1;8677;4;1;2054;0;1081;864;217
1215;1;8682;4;1;1012;0;500;427;73
1215;1;8683;4;1;1627;0;924;791;133
1215;1;8696;4;1;1363;0;675;507;168
1215;1;8699;4;1;546;0;343;236;107
1215;1;8711;4;1;2001;0;769;664;105
1215;1;8721;4;1;1516;0;729;520;209
1215;1;8725;4;1;1634;0;646;467;179
1215;2;8679;4;2;1174;1;729;552;177
1215;2;8689;4;2;1018;0;528;339;189
1215;2;8693;4;2;327;0;200;167;33
1215;2;8695;4;2;2013;0;736;557;179
1215;2;8706;4;2;1056;0;559;435;124
1215;2;8708;4;2;1512;0;624;518;106
1215;2;8715;4;2;1004;0;530;444;86
1215;2;8717;4;2;1735;0;911;803;108
1215;2;8726;4;2;2301;0;1381;1099;282
1215;3;8680;4;3;2123;0;1035;888;147
1215;3;8688;4;3;671;5;416;300;116
1215;3;8698;4;3;1349;0;731;559;172
1215;3;8701;4;3;245;0;141;113;28
1215;3;8703;4;3;2052;0;1080;863;217
1215;3;8707;4;3;1115;0;421;341;80
1215;3;8720;4;3;781;0;316;284;32
1215;3;8723;4;3;1057;0;510;435;75
1215;4;8675;4;4;1801;1;1125;866;259
1215;4;8700;4;4;1971;0;828;679;149
1215;4;8702;4;4;1207;0;736;515;221
1215;4;8704;4;4;977;0;467;402;65
1215;4;8712;4;4;2169;1;1213;1021;192
1215;4;8714;4;4;1240;0;457;356;101
1215;4;8719;4;4;950;1;585;471;114
1215;4;8722;4;4;670;0;208;176;32
1215;5;8685;4;5;1844;0;1005;762;243
1215;5;8687;4;5;1691;0;870;684;186
1215;5;8691;4;5;283;1;179;128;51
1215;5;8692;4;5;908;0;234;176;58
1215;5;8705;4;5;1670;1;934;778;156
1215;5;8709;4;5;1597;0;893;760;133
1215;5;8727;4;5;1603;0;563;474;89
1215;6;8678;4;6;494;0;265;208;57
1215;6;8686;4;6;635;0;238;210;28
1215;6;8697;4;6;1060;0;610;483;127
1215;6;8710;4;6;408;0;188;145;43
1215;6;8713;4;6;468;0;256;216;40
1215;6;8716;4;6;1944;0;935;807;128
1215;7;8681;4;7;504;0;275;226;49
1215;7;8690;4;7;637;0;425;305;120
1215;7;8694;4;7;704;0;432;355;77
1215;7;8728;4;7;49;0;42;20;22
1215;8;8684;4;8;428;5;288;201;87
1215;8;8724;4;8;1124;0;688;575;113
1215;9;8718;4;9;1036;0;552;455;97
1216;10;8748;5;10;24;0;21;21;0
1216;10;8779;5;10;433;0;217;186;31
1216;10;8793;5;10;891;0;489;402;87
1216;10;8821;5;10;636;0;200;173;27
1216;10;8836;5;10;465;0;230;202;28
1216;10;8841;5;10;1275;0;695;611;84
1216;11;8789;5;11;380;0;234;192;42
1216;11;8795;5;11;632;0;301;257;44
1216;11;8819;5;11;18;0;18;17;1
1216;11;8839;5;11;385;0;181;125;56
1216;12;8777;5;12;797;0;479;432;47
1216;12;8828;5;12;370;0;118;89;29
1216;12;8858;5;12;1187;0;636;546;90
1216;13;8815;5;13;1833;7;944;791;153
1216;13;8820;5;13;529;0;311;252;59
1216;14;8735;5;14;598;0;360;316;44
1216;14;8823;5;14;1724;1;895;793;102
1216;15;8826;5;15;33;0;25;15;10
1216;15;8854;5;15;1655;3;756;633;123
1216;1;8730;5;1;1201;0;606;489;117
1216;1;8740;5;1;1441;0;829;696;133
1216;1;8751;5;1;2235;0;1225;981;244
1216;1;8762;5;1;1749;0;739;608;131
1216;1;8763;5;1;1692;0;930;816;114
1216;1;8764;5;1;2053;0;1130;934;196
1216;1;8767;5;1;756;0;377;307;70
1216;1;8769;5;1;2532;0;1493;1330;163
1216;1;8805;5;1;1746;0;1107;995;112
1216;1;8830;5;1;2137;1;1140;947;193
1216;1;8837;5;1;2218;1;1349;1032;317
1216;1;8842;5;1;790;0;388;322;66
1216;1;8845;5;1;1733;0;952;765;187
1216;1;8847;5;1;546;0;197;169;28
1216;1;8848;5;1;1589;0;930;853;77
1216;1;8861;5;1;1839;0;1045;899;146
1216;2;8746;5;2;507;0;307;253;54
1216;2;8752;5;2;639;0;324;266;58
1216;2;8757;5;2;1658;0;932;845;87
1216;2;8768;5;2;972;1;495;420;75
1216;2;8772;5;2;654;0;354;290;64
1216;2;8785;5;2;1436;1;851;741;110
1216;2;8790;5;2;1478;1;927;821;106
1216;2;8794;5;2;416;0;222;176;46
1216;2;8796;5;2;1970;0;1072;959;113
1216;2;8808;5;2;985;0;465;348;117
1216;2;8812;5;2;1549;1;797;678;119
1216;2;8832;5;2;1353;0;782;697;85
1216;2;8838;5;2;1888;0;1039;871;168
1216;2;8840;5;2;2100;0;1152;1017;135
1216;2;8855;5;2;663;0;317;274;43
1216;2;8864;5;2;1930;0;814;569;245
1216;3;8729;5;3;652;0;381;307;74
1216;3;8732;5;3;1278;0;675;590;85
1216;3;8744;5;3;1318;5;708;645;63
1216;3;8745;5;3;1043;0;534;455;79
1216;3;8755;5;3;1717;0;941;706;235
1216;3;8770;5;3;2001;3;1254;1098;156
1216;3;8773;5;3;877;0;379;333;46
1216;3;8780;5;3;736;0;360;256;104
1216;3;8787;5;3;982;0;442;382;60
1216;3;8791;5;3;1660;0;803;682;121
1216;3;8797;5;3;882;0;596;488;108
1216;3;8798;5;3;2005;0;649;544;105
1216;3;8804;5;3;1299;0;554;455;99
1216;3;8811;5;3;864;0;363;305;58
1216;3;8834;5;3;1396;0;638;502;136
1216;3;8859;5;3;1388;0;731;631;100
1216;4;8737;5;4;819;0;431;388;43
1216;4;8738;5;4;398;0;220;201;19
1216;4;8743;5;4;875;0;494;451;43
1216;4;8750;5;4;733;0;298;256;42
1216;4;8758;5;4;1304;0;703;628;75
1216;4;8761;5;4;1488;0;861;659;202
1216;4;8765;5;4;2214;0;1168;953;215
1216;4;8774;5;4;2052;0;992;888;104
1216;4;8776;5;4;567;0;311;223;88
1216;4;8782;5;4;652;0;400;341;59
1216;4;8784;5;4;1748;0;972;818;154
1216;4;8807;5;4;1682;0;649;534;115
1216;4;8822;5;4;1412;0;644;556;88
1216;4;8852;5;4;527;0;295;246;49
1216;4;8856;5;4;814;3;476;393;83
1216;4;8862;5;4;1066;0;365;296;69
1216;5;8731;5;5;738;0;337;283;54
1216;5;8733;5;5;980;3;465;386;79
1216;5;8734;5;5;2147;0;731;653;78
1216;5;8736;5;5;1185;0;616;528;88
1216;5;8741;5;5;636;0;435;347;88
1216;5;8756;5;5;671;0;223;187;36
1216;5;8781;5;5;1305;0;693;584;109
1216;5;8783;5;5;1187;1;524;457;67
1216;5;8786;5;5;78;0;63;54;9
1216;5;8803;5;5;1128;0;636;560;76
1216;5;8809;5;5;483;0;198;142;56
1216;5;8813;5;5;903;4;462;388;74
1216;5;8824;5;5;1429;1;703;592;111
1216;5;8827;5;5;1701;0;981;737;244
1216;5;8850;5;5;1747;2;975;863;112
1216;5;8853;5;5;937;0;455;418;37
1216;6;8742;5;6;536;0;266;229;37
1216;6;8759;5;6;1610;0;904;776;128
1216;6;8771;5;6;621;0;334;280;54
1216;6;8775;5;6;1263;2;697;541;156
1216;6;8778;5;6;2369;1;1316;1014;302
1216;6;8788;5;6;980;1;608;463;145
1216;6;8816;5;6;1202;6;620;510;110
1216;6;8831;5;6;950;0;566;483;83
1216;6;8835;5;6;1030;0;374;303;71
1216;6;8844;5;6;1138;0;644;553;91
1216;6;8846;5;6;318;0;202;167;35
1216;6;8849;5;6;143;5;116;92;24
1216;6;8865;5;6;1381;0;746;671;75
1216;7;8753;5;7;1222;0;834;740;94
1216;7;8760;5;7;725;0;226;188;38
1216;7;8792;5;7;1262;1;734;631;103
1216;7;8799;5;7;429;0;221;182;39
1216;7;8800;5;7;986;1;467;391;76
1216;7;8802;5;7;766;0;395;328;67
1216;7;8817;5;7;1611;0;891;781;110
1216;7;8818;5;7;1710;0;633;536;97
1216;7;8825;5;7;1038;2;542;457;85
1216;7;8857;5;7;705;0;366;309;57
1216;7;8860;5;7;900;0;482;413;69
1216;8;8747;5;8;562;0;291;258;33
1216;8;8749;5;8;518;0;216;185;31
1216;8;8766;5;8;1296;0;462;414;48
1216;8;8806;5;8;1083;0;587;490;97
1216;8;8829;5;8;1739;0;630;574;56
1216;8;8833;5;8;1562;2;862;738;124
1216;8;8863;5;8;763;0;362;334;28
1216;9;8739;5;9;276;0;160;132;28
1216;9;8754;5;9;849;0;390;345;45
1216;9;8801;5;9;661;1;347;301;46
1216;9;8810;5;9;1364;0;753;671;82
1216;9;8814;5;9;1560;0;678;574;104
1216;9;8843;5;9;321;0;89;75;14
1216;9;8851;5;9;56;0;45;31;14
1217;10;8876;4;10;268;0;141;112;29
1217;10;8890;4;10;1049;0;559;505;54
1217;11;8883;4;11;1313;0;706;641;65
1217;12;8897;4;12;860;0;368;307;61
1217;13;8907;4;13;1427;0;678;595;83
1217;14;8912;4;14;1264;0;651;605;46
1217;15;8906;4;15;1209;0;534;495;39
1217;16;8874;4;16;921;0;457;424;33
1217;17;8885;4;17;965;1;458;433;25
1217;1;8882;4;1;1831;0;681;611;70
1217;18;8880;4;18;701;0;341;316;25
1217;1;8889;4;1;2325;1;1377;1150;227
1217;1;8896;4;1;1605;0;841;788;53
1217;1;8904;4;1;1854;3;862;680;182
1217;1;8911;4;1;1623;0;868;738;130
1217;19;8870;4;19;33;0;8;8;0
1217;20;8908;4;20;4;0;4;4;0
1217;21;8900;4;21;5;0;3;2;1
1217;22;8910;4;22;15;0;10;9;1
1217;23;8872;4;23;62;0;44;42;2
1217;2;8866;4;2;1276;2;651;615;36
1217;2;8879;4;2;1148;0;573;483;90
1217;2;8881;4;2;1766;0;748;682;66
1217;2;8884;4;2;1813;1;972;842;130
1217;2;8898;4;2;1592;0;762;665;97
1217;3;8868;4;3;411;0;183;170;13
1217;3;8886;4;3;1710;0;626;506;120
1217;3;8901;4;3;358;0;234;194;40
1217;3;8902;4;3;896;0;466;440;26
1217;3;8909;4;3;562;0;253;224;29
1217;4;8867;4;4;1032;0;505;427;78
1217;4;8877;4;4;712;1;349;304;45
1217;4;8887;4;4;1081;0;540;493;47
1217;4;8895;4;4;621;0;288;269;19
1217;4;8915;4;4;1322;0;555;521;34
1217;5;8871;4;5;300;0;138;112;26
1217;5;8891;4;5;1438;0;750;683;67
1217;5;8899;4;5;960;0;421;379;42
1217;5;8905;4;5;777;0;342;308;34
1217;6;8873;4;6;438;0;133;118;15
1217;6;8878;4;6;1093;1;555;504;51
1217;6;8888;4;6;494;0;169;158;11
1217;6;8903;4;6;1818;0;868;725;143
1217;7;8869;4;7;987;0;422;370;52
1217;7;8875;4;7;1431;1;476;431;45
1217;7;8892;4;7;1835;1;904;817;87
1217;8;8893;4;8;482;0;240;209;31
1217;8;8913;4;8;2174;0;989;874;115
1217;8;8914;4;8;1284;0;410;371;39
1217;9;8894;4;9;282;0;154;126;28
1217;9;8916;4;9;1310;0;682;607;75
1218;10;8974;4;10;1204;0;549;457;92
1218;10;8995;4;10;2299;0;1049;978;71
1218;10;8999;4;10;1576;0;724;662;62
1218;11;8927;4;11;448;0;183;152;31
1218;11;8932;4;11;1790;0;794;730;64
1218;11;8948;4;11;1686;0;773;712;61
1218;12;8921;4;12;390;0;194;169;25
1218;12;8987;4;12;1455;0;564;525;39
1218;12;9005;4;12;1587;0;836;754;82
1218;13;8953;4;13;1426;0;702;607;95
1218;13;8959;4;13;1570;0;834;751;83
1218;13;8984;4;13;285;0;110;99;11
1218;14;8977;4;14;85;0;37;37;0
1218;14;9000;4;14;994;0;438;331;107
1218;14;9015;4;14;2182;0;1146;982;164
1218;15;8960;4;15;1080;1;551;508;43
1218;15;8969;4;15;1398;0;663;593;70
1218;16;8922;4;16;1673;0;738;676;62
1218;16;8962;4;16;1247;0;468;404;64
1218;17;8938;4;17;1792;0;748;684;64
1218;17;8961;4;17;1145;0;582;485;97
1218;18;8941;4;18;606;0;288;259;29
1218;18;8951;4;18;1275;0;612;517;95
1218;1;8926;4;1;1719;1;905;764;141
1218;1;8930;4;1;1708;0;829;703;126
1218;1;8971;4;1;792;0;374;313;61
1218;1;8978;4;1;903;0;386;316;70
1218;1;8993;4;1;1602;0;843;710;133
1218;1;8996;4;1;1340;0;652;556;96
1218;1;9002;4;1;1893;0;1106;962;144
1218;1;9009;4;1;1080;0;618;517;101
1218;1;9016;4;1;1256;0;533;444;89
1218;1;9019;4;1;1506;0;664;587;77
1218;19;8931;4;19;583;0;266;226;40
1218;19;8988;4;19;1235;0;507;436;71
1218;20;8937;4;20;889;0;380;323;57
1218;20;8939;4;20;1159;0;513;437;76
1218;21;8967;4;21;1729;0;883;743;140
1218;21;9001;4;21;1465;0;697;620;77
1218;22;8989;4;22;1283;0;636;550;86
1218;22;9014;4;22;843;0;381;327;54
1218;23;8936;4;23;82;0;42;37;5
1218;23;8945;4;23;1291;0;548;509;39
1218;24;8946;4;24;20;0;8;4;4
1218;24;8973;4;24;72;0;39;33;6
1218;25;8986;4;25;30;0;12;10;2
1218;26;8943;4;26;12;0;10;8;2
1218;2;8919;4;2;1941;3;864;814;50
1218;2;8947;4;2;1800;0;907;793;114
1218;2;8949;4;2;1185;0;490;419;71
1218;2;8952;4;2;2045;3;1120;784;336
1218;2;8992;4;2;1938;1;957;872;85
1218;2;8994;4;2;1330;0;685;572;113
1218;2;8997;4;2;1693;0;717;622;95
1218;2;8998;4;2;1341;0;549;460;89
1218;2;9012;4;2;1203;1;595;511;84
1218;2;9018;4;2;671;0;293;246;47
1218;3;8917;4;3;1915;0;811;683;128
1218;3;8925;4;3;523;0;324;256;68
1218;3;8934;4;3;1076;0;419;344;75
1218;3;8940;4;3;373;0;220;180;40
1218;3;8954;4;3;2121;0;1171;1064;107
1218;3;8965;4;3;1655;0;902;722;180
1218;3;8976;4;3;1180;1;524;491;33
1218;3;8979;4;3;1323;0;671;515;156
1218;3;8980;4;3;823;0;361;318;43
1218;3;9003;4;3;1088;0;421;351;70
1218;4;8920;4;4;1494;0;783;723;60
1218;4;8929;4;4;991;0;435;353;82
1218;4;8933;4;4;1051;0;494;398;96
1218;4;8935;4;4;1673;1;770;692;78
1218;4;8956;4;4;500;0;277;243;34
1218;4;8958;4;4;1327;0;574;522;52
1218;4;8982;4;4;535;0;200;155;45
1218;4;8985;4;4;1114;0;483;366;117
1218;4;8990;4;4;916;2;509;444;65
1218;4;9010;4;4;1036;1;444;349;95
1218;5;8924;4;5;1477;0;710;660;50
1218;5;8928;4;5;755;0;349;291;58
1218;5;8957;4;5;473;0;289;232;57
1218;5;8968;4;5;2198;0;1007;799;208
1218;5;8972;4;5;708;0;357;316;41
1218;5;8983;4;5;1272;0;503;408;95
1218;5;9011;4;5;1806;7;853;778;75
1218;5;9013;4;5;2126;0;952;832;120
1218;6;8918;4;6;1620;1;828;776;52
1218;6;8923;4;6;1145;0;465;392;73
1218;6;8963;4;6;873;0;375;269;106
1218;6;8964;4;6;1525;0;715;642;73
1218;6;8966;4;6;424;0;216;172;44
1218;6;9008;4;6;1255;0;684;555;129
1218;7;8955;4;7;1415;1;774;667;107
1218;7;8975;4;7;1975;0;810;731;79
1218;7;8991;4;7;1157;0;511;475;36
1218;7;9007;4;7;1150;1;492;459;33
1218;7;9017;4;7;718;0;319;251;68
1218;8;8944;4;8;1188;0;508;430;78
1218;8;8970;4;8;1211;0;734;618;116
1218;8;9004;4;8;1459;0;625;571;54
1218;8;9006;4;8;1242;1;570;493;77
1218;9;8942;4;9;1251;0;533;473;60
1218;9;8950;4;9;1490;0;695;634;61
1218;9;8981;4;9;793;0;384;329;55
1219;10;9044;2;10;1041;0;578;481;97
1219;10;9046;2;10;1077;0;408;364;44
1219;10;9053;2;10;1383;0;799;650;149
1219;10;9084;2;10;477;0;193;173;20
1219;11;9024;2;11;698;0;304;256;48
1219;11;9078;2;11;1066;0;592;532;60
1219;11;9094;2;11;1024;0;512;450;62
1219;12;9023;2;12;1148;0;480;396;84
1219;12;9061;2;12;590;0;305;271;34
1219;12;9066;2;12;1187;0;578;503;75
1219;13;9047;2;13;1208;0;544;494;50
1219;13;9081;2;13;1252;0;668;564;104
1219;14;9050;2;14;1275;7;585;518;67
1219;14;9074;2;14;1224;0;640;595;45
1219;15;9029;2;15;2380;0;930;833;97
1219;16;9070;2;16;933;0;477;433;44
1219;17;9088;2;17;757;0;452;392;60
1219;18;9065;2;18;1381;0;573;522;51
1219;1;9021;2;1;746;0;340;280;60
1219;1;9026;2;1;1342;0;707;640;67
1219;1;9040;2;1;1576;0;900;780;120
1219;1;9056;2;1;1364;0;676;631;45
1219;1;9082;2;1;1152;0;659;550;109
1219;19;9025;2;19;1354;0;667;590;77
1219;20;9051;2;20;1416;0;631;580;51
1219;21;9052;2;21;2255;0;922;845;77
1219;22;9092;2;22;1122;1;602;544;58
1219;23;9041;2;23;1493;0;811;732;79
1219;24;9067;2;24;991;0;590;506;84
1219;25;9033;2;25;1648;0;659;597;62
1219;26;9059;2;26;726;1;370;341;29
1219;27;9058;2;27;766;0;371;345;26
1219;28;9080;2;28;1013;0;372;346;26
1219;2;9022;2;2;2319;0;1375;1154;221
1219;2;9031;2;2;804;0;448;383;65
1219;2;9032;2;2;2134;1;1117;995;122
1219;2;9045;2;2;1803;0;769;731;38
1219;2;9054;2;2;1300;0;766;649;117
1219;29;9042;2;29;913;1;507;469;38
1219;30;9039;2;30;1022;0;522;467;55
1219;31;9079;2;31;846;0;474;407;67
1219;3;9038;2;3;1041;0;578;508;70
1219;3;9062;2;3;330;0;209;163;46
1219;3;9063;2;3;1615;0;876;745;131
1219;3;9073;2;3;1799;0;842;778;64
1219;3;9086;2;3;1001;0;590;518;72
1219;4;9036;2;4;307;0;143;112;31
1219;4;9043;2;4;1042;0;612;520;92
1219;4;9048;2;4;723;0;383;340;43
1219;4;9064;2;4;2207;0;1095;1026;69
1219;4;9083;2;4;563;0;371;308;63
1219;5;9035;2;5;347;0;181;152;29
1219;5;9037;2;5;1087;0;563;495;68
1219;5;9085;2;5;1013;0;524;490;34
1219;5;9090;2;5;997;0;514;452;62
1219;5;9091;2;5;1388;0;750;646;104
1219;6;9020;2;6;1390;0;763;637;126
1219;6;9027;2;6;1122;0;538;471;67
1219;6;9028;2;6;1310;1;582;549;33
1219;6;9060;2;6;698;0;428;334;94
1219;6;9069;2;6;496;3;250;210;40
1219;7;9030;2;7;1228;0;672;553;119
1219;7;9057;2;7;688;1;331;282;49
1219;7;9075;2;7;1665;0;785;698;87
1219;7;9076;2;7;1251;3;575;527;48
1219;7;9087;2;7;654;1;356;311;45
1219;8;9049;2;8;418;0;234;184;50
1219;8;9055;2;8;94;0;74;54;20
1219;8;9072;2;8;1806;0;721;674;47
1219;8;9077;2;8;1088;0;527;475;52
1219;8;9093;2;8;1622;0;888;750;138
1219;9;9034;2;9;1092;0;614;526;88
1219;9;9068;2;9;976;0;456;383;73
1219;9;9071;2;9;2211;2;1112;967;145
1219;9;9089;2;9;1436;0;585;543;42
1261;100;9343;3;100;817;0;411;392;19
1261;101;9505;3;101;2032;0;1027;1009;18
1261;102;9339;3;102;2146;0;1054;1025;29
1261;103;9218;3;103;1611;0;816;787;29
1261;104;9126;3;104;1086;0;516;497;19
1261;105;9249;3;105;1985;0;944;904;40
1261;106;9131;3;106;2018;0;950;905;45
1261;107;9377;3;107;1830;0;903;880;23
1261;108;9190;3;108;1731;0;850;819;31
1261;10;9247;3;10;844;0;381;372;9
1261;109;9413;3;109;2034;1;956;916;40
1261;110;9297;3;110;1238;0;459;437;22
1261;111;9244;3;111;1646;1;791;767;24
1261;112;9243;3;112;1681;0;826;811;15
1261;113;9318;3;113;1495;1;612;573;39
1261;114;9469;3;114;1294;0;650;623;27
1261;115;9484;3;115;1589;0;537;519;18
1261;116;9128;3;116;2087;0;825;794;31
1261;117;9471;3;117;1816;0;922;895;27
1261;118;9101;3;118;818;0;377;372;5
1261;11;9269;3;11;1043;0;429;412;17
1261;119;9149;3;119;1344;1;659;628;31
1261;120;9417;3;120;949;0;401;379;22
1261;121;9333;3;121;655;0;405;396;9
1261;122;9108;3;122;1577;0;766;748;18
1261;123;9254;3;123;1528;0;732;703;29
1261;124;9221;3;124;1855;0;958;927;31
1261;125;9480;3;125;807;0;451;441;10
1261;126;9372;3;126;1033;1;437;415;22
1261;127;9317;3;127;1334;0;724;694;30
1261;128;9421;3;128;930;1;484;462;22
1261;12;9482;3;12;927;0;439;419;20
1261;129;9169;3;129;794;2;395;378;17
1261;130;9409;3;130;847;0;386;370;16
1261;131;9525;3;131;1081;0;525;506;19
1261;132;9122;3;132;1208;1;603;584;19
1261;133;9385;3;133;1424;0;718;693;25
1261;134;9522;3;134;1364;0;616;597;19
1261;135;9253;3;135;1407;0;627;607;20
1261;136;9158;3;136;1188;1;616;602;14
1261;137;9216;3;137;1080;0;509;492;17
1261;138;9099;3;138;1631;0;893;872;21
1261;13;9211;3;13;1385;1;624;594;30
1261;139;9239;3;139;1386;0;723;695;28
1261;140;9129;3;140;1295;0;670;646;24
1261;141;9151;3;141;1024;0;532;511;21
1261;142;9290;3;142;1781;0;982;955;27
1261;143;9476;3;143;1125;0;569;551;18
1261;144;9206;3;144;1030;0;581;562;19
1261;145;9408;3;145;1659;1;916;882;34
1261;146;9109;3;146;1395;0;765;743;22
1261;147;9456;3;147;1681;0;764;736;28
1261;148;9371;3;148;2048;2;1049;1015;34
1261;14;9320;3;14;721;0;313;300;13
1261;149;9391;3;149;643;1;300;291;9
1261;150;9222;3;150;2146;0;1137;1106;31
1261;151;9544;3;151;1080;0;547;525;22
1261;152;9359;3;152;958;0;535;518;17
1261;153;9102;3;153;1058;0;540;523;17
1261;154;9182;3;154;1304;0;630;613;17
1261;155;9360;3;155;1790;0;830;789;41
1261;156;9287;3;156;1680;0;864;839;25
1261;157;9380;3;157;1172;0;365;337;28
1261;158;9319;3;158;918;0;494;470;24
1261;15;9328;3;15;1059;0;534;514;20
1261;159;9219;3;159;799;0;436;415;21
1261;160;9454;3;160;993;0;542;519;23
1261;161;9337;3;161;721;0;351;343;8
1261;162;9543;3;162;1039;0;565;552;13
1261;163;9315;3;163;608;0;273;257;16
1261;164;9259;3;164;836;0;412;404;8
1261;165;9309;3;165;897;0;408;393;15
1261;166;9441;3;166;1753;0;1000;972;28
1261;167;9331;3;167;597;0;310;295;15
1261;168;9230;3;168;1424;0;756;739;17
1261;16;9388;3;16;1264;1;640;626;14
1261;169;9523;3;169;1623;0;951;933;18
1261;170;9418;3;170;1182;0;584;566;18
1261;171;9133;3;171;1118;0;474;452;22
1261;172;9407;3;172;1707;0;822;810;12
1261;173;9306;3;173;2063;0;957;943;14
1261;174;9386;3;174;1470;0;576;558;18
1261;175;9462;3;175;1578;0;701;683;18
1261;176;9183;3;176;1093;0;509;479;30
1261;177;9516;3;177;1507;0;663;625;38
1261;178;9481;3;178;1537;0;645;618;27
1261;17;9455;3;17;877;0;420;397;23
1261;179;9550;3;179;2319;0;863;823;40
1261;180;9284;3;180;1765;0;619;583;36
1261;181;9504;3;181;1221;0;464;424;40
1261;182;9373;3;182;1746;0;610;592;18
1261;183;9464;3;183;2132;0;730;678;52
1261;184;9187;3;184;1404;0;605;557;48
1261;185;9356;3;185;1726;0;873;828;45
1261;186;9438;3;186;1138;0;469;449;20
1261;187;9526;3;187;1492;0;812;790;22
1261;188;9203;3;188;1647;0;768;729;39
1261;18;9223;3;18;1026;0;515;507;8
1261;189;9444;3;189;1777;0;899;874;25
1261;190;9531;3;190;1106;0;484;457;27
1261;191;9493;3;191;1302;0;410;391;19
1261;1;9250;3;1;1103;0;467;445;22
1261;192;9227;3;192;1840;0;816;787;29
1261;193;9494;3;193;2253;0;961;918;43
1261;194;9468;3;194;1459;0;726;682;44
1261;195;9432;3;195;1614;0;800;750;50
1261;196;9506;3;196;1521;0;826;790;36
1261;197;9443;3;197;1074;0;517;493;24
1261;198;9398;3;198;1221;0;658;651;7
1261;19;9143;3;19;931;0;479;461;18
1261;199;9434;3;199;1378;0;617;591;26
1261;200;9521;3;200;1145;1;501;469;32
1261;201;9450;3;201;1212;0;549;540;9
1261;202;9241;3;202;1436;0;550;518;32
1261;203;9166;3;203;733;0;268;253;15
1261;204;9511;3;204;2388;0;1155;1106;49
1261;205;9300;3;205;1356;0;635;620;15
1261;206;9245;3;206;1151;0;516;499;17
1261;207;9107;3;207;1768;0;743;721;22
1261;208;9429;3;208;581;0;234;220;14
1261;20;9162;3;20;694;2;312;308;4
1261;209;9193;3;209;657;0;205;189;16
1261;210;9529;3;210;758;0;308;298;10
1261;211;9349;3;211;583;0;174;157;17
1261;212;9491;3;212;1217;0;418;399;19
1261;213;9430;3;213;1113;0;371;355;16
1261;214;9458;3;214;1642;0;706;679;27
1261;215;9138;3;215;1903;0;845;799;46
1261;216;9246;3;216;1693;0;980;943;37
1261;217;9519;3;217;1319;0;503;483;20
1261;218;9425;3;218;1249;0;632;620;12
1261;21;9117;3;21;1156;0;516;502;14
1261;219;9325;3;219;1997;0;981;946;35
1261;220;9134;3;220;2059;0;783;743;40
1261;221;9167;3;221;2038;0;916;887;29
1261;222;9294;3;222;691;0;296;285;11
1261;223;9112;3;223;1680;0;813;787;26
1261;224;9188;3;224;1465;0;626;600;26
1261;225;9232;3;225;1185;2;522;505;17
1261;226;9542;3;226;1227;0;452;427;25
1261;227;9106;3;227;1378;0;608;584;24
1261;228;9266;3;228;1461;0;678;645;33
1261;22;9344;3;22;846;0;367;354;13
1261;229;9524;3;229;829;0;344;330;14
1261;230;9433;3;230;1739;0;636;611;25
1261;231;9119;3;231;1305;0;498;488;10
1261;232;9514;3;232;1045;0;429;399;30
1261;233;9262;3;233;2006;0;786;761;25
1261;234;9196;3;234;1053;1;316;316;0
1261;235;9135;3;235;2069;0;796;764;32
1261;236;9336;3;236;1535;0;631;615;16
1261;237;9340;3;237;1054;0;439;425;14
1261;238;9298;3;238;1112;0;498;478;20
1261;23;9369;3;23;624;1;321;314;7
1261;239;9159;3;239;1933;0;823;768;55
1261;240;9451;3;240;1628;0;607;577;30
1261;241;9226;3;241;1034;0;483;472;11
1261;242;9208;3;242;2222;0;972;937;35
1261;243;9500;3;243;2081;0;852;807;45
1261;244;9330;3;244;2153;0;781;740;41
1261;245;9532;3;245;1806;1;761;716;45
1261;246;9305;3;246;1435;0;593;563;30
1261;247;9097;3;247;1727;0;703;674;29
1261;248;9411;3;248;2266;0;954;920;34
1261;24;9110;3;24;1414;1;674;657;17
1261;249;9381;3;249;1959;0;668;636;32
1261;250;9533;3;250;1756;0;747;699;48
1261;251;9426;3;251;1430;0;646;627;19
1261;252;9479;3;252;1471;0;713;670;43
1261;253;9503;3;253;1276;0;583;554;29
1261;254;9111;3;254;1450;0;563;536;27
1261;255;9396;3;255;1527;0;693;661;32
1261;256;9164;3;256;1171;0;448;430;18
1261;257;9192;3;257;1992;0;816;785;31
1261;258;9397;3;258;1102;1;486;463;23
1261;25;9379;3;25;1181;0;540;526;14
1261;259;9147;3;259;1043;0;432;422;10
1261;260;9205;3;260;990;0;410;393;17
1261;261;9177;3;261;1916;0;807;786;21
1261;262;9114;3;262;1019;0;479;463;16
1261;263;9395;3;263;1179;0;556;524;32
1261;264;9288;3;264;1027;1;390;371;19
1261;265;9304;3;265;2094;0;875;845;30
1261;266;9323;3;266;1728;0;677;647;30
1261;267;9202;3;267;1182;0;507;497;10
1261;268;9402;3;268;1719;0;555;506;49
1261;26;9220;3;26;1141;0;572;545;27
1261;269;9376;3;269;1066;1;464;443;21
1261;270;9473;3;270;1258;0;576;562;14
1261;271;9095;3;271;1300;1;517;494;23
1261;272;9217;3;272;896;0;425;403;22
1261;273;9207;3;273;2058;0;761;714;47
1261;274;9358;3;274;1755;0;750;721;29
1261;275;9334;3;275;1374;0;655;637;18
1261;276;9103;3;276;623;0;295;285;10
1261;277;9472;3;277;293;0;133;129;4
1261;278;9474;3;278;1923;1;1001;932;69
1261;27;9296;3;27;1438;0;701;685;16
1261;279;9463;3;279;1511;0;557;518;39
1261;280;9436;3;280;1744;1;653;617;36
1261;281;9515;3;281;1400;0;482;458;24
1261;282;9118;3;282;1442;1;396;381;15
1261;283;9271;3;283;1436;0;562;526;36
1261;284;9499;3;284;1933;0;856;810;46
1261;285;9283;3;285;1289;0;529;493;36
1261;286;9291;3;286;2199;0;949;902;47
1261;287;9351;3;287;1520;0;599;578;21
1261;288;9383;3;288;1435;0;664;621;43
1261;28;9405;3;28;877;0;444;428;16
1261;289;9113;3;289;1792;0;809;763;46
1261;290;9184;3;290;910;0;446;417;29
1261;291;9286;3;291;1216;0;520;487;33
1261;292;9535;3;292;1106;0;412;388;24
1261;293;9357;3;293;1069;0;327;290;37
1261;2;9486;3;2;998;0;387;365;22
1261;294;9370;3;294;945;0;386;365;21
1261;295;9501;3;295;1161;0;518;494;24
1261;296;9210;3;296;671;0;250;232;18
1261;297;9279;3;297;884;0;344;334;10
1261;298;9144;3;298;971;0;410;394;16
1261;29;9252;3;29;660;0;298;288;10
1261;299;9275;3;299;506;0;249;243;6
1261;300;9375;3;300;460;0;142;136;6
1261;301;9240;3;301;1230;0;481;470;11
1261;302;9520;3;302;824;0;317;299;18
1261;303;9507;3;303;1101;0;460;449;11
1261;304;9447;3;304;1367;2;499;479;20
1261;305;9461;3;305;534;0;173;159;14
1261;306;9198;3;306;1441;0;595;579;16
1261;307;9546;3;307;1457;0;505;484;21
1261;308;9449;3;308;658;0;294;289;5
1261;30;9282;3;30;1125;13;549;531;18
1261;309;9512;3;309;1225;0;450;438;12
1261;310;9553;3;310;1164;0;423;400;23
1261;311;9295;3;311;1087;0;499;470;29
1261;312;9130;3;312;2116;0;769;729;40
1261;313;9237;3;313;1946;0;944;905;39
1261;314;9366;3;314;2319;0;971;921;50
1261;315;9324;3;315;2102;0;1035;1004;31
1261;316;9204;3;316;1110;0;482;462;20
1261;317;9179;3;317;1314;0;589;570;19
1261;318;9551;3;318;1269;0;610;592;18
1261;31;9270;3;31;1441;0;599;579;20
1261;319;9194;3;319;1085;0;456;436;20
1261;320;9420;3;320;1098;0;480;452;28
1261;321;9374;3;321;1213;0;538;531;7
1261;322;9495;3;322;619;0;220;210;10
1261;323;9353;3;323;1823;0;739;716;23
1261;324;9470;3;324;2093;0;838;788;50
1261;325;9191;3;325;1589;0;670;641;29
1261;326;9361;3;326;1368;0;610;574;36
1261;327;9410;3;327;1589;0;835;812;23
1261;328;9255;3;328;1606;0;747;720;27
1261;32;9189;3;32;912;1;313;305;8
1261;329;9401;3;329;1420;0;617;589;28
1261;330;9489;3;330;1394;0;677;655;22
1261;331;9392;3;331;1246;0;476;434;42
1261;332;9403;3;332;1376;0;478;453;25
1261;333;9277;3;333;1223;0;510;485;25
1261;334;9399;3;334;1318;0;581;541;40
1261;335;9181;3;335;1573;0;637;602;35
1261;336;9387;3;336;1926;0;841;806;35
1261;337;9120;3;337;1291;0;560;536;24
1261;338;9161;3;338;1674;0;565;544;21
1261;33;9517;3;33;1382;0;720;690;30
1261;339;9228;3;339;1687;0;831;802;29
1261;340;9498;3;340;1642;0;730;701;29
1261;341;9125;3;341;1304;0;555;527;28
1261;342;9316;3;342;1144;0;349;329;20
1261;343;9346;3;343;1520;0;653;620;33
1261;344;9096;3;344;1132;0;452;425;27
1261;345;9475;3;345;1336;0;498;472;26
1261;346;9367;3;346;1910;0;793;763;30
1261;347;9459;3;347;2187;0;672;635;37
1261;348;9467;3;348;1833;0;603;562;41
1261;34;9453;3;34;1319;0;682;643;39
1261;349;9136;3;349;2092;0;784;737;47
1261;350;9299;3;350;1923;0;792;765;27
1261;351;9390;3;351;2240;0;903;884;19
1261;352;9098;3;352;1099;0;511;476;35
1261;353;9224;3;353;1187;0;496;470;26
1261;354;9508;3;354;1076;0;355;336;19
1261;355;9538;3;355;1287;0;398;366;32
1261;356;9236;3;356;1446;0;484;455;29
1261;357;9536;3;357;1848;0;785;746;39
1261;358;9209;3;358;1434;0;574;550;24
1261;35;9321;3;35;1353;0;670;647;23
1261;359;9160;3;359;1505;0;549;521;28
1261;360;9285;3;360;1211;0;387;363;24
1261;361;9105;3;361;1096;0;314;272;42
1261;362;9552;3;362;1812;0;624;579;45
1261;363;9248;3;363;1137;0;516;471;45
1261;364;9212;3;364;1130;0;476;451;25
1261;365;9115;3;365;1412;0;559;530;29
1261;366;9197;3;366;1658;0;609;579;30
1261;367;9176;3;367;984;0;408;386;22
1261;368;9132;3;368;1339;0;572;540;32
1261;36;9281;3;36;911;0;389;377;12
1261;369;9261;3;369;1064;0;421;394;27
1261;370;9264;3;370;1365;0;482;454;28
1261;371;9442;3;371;508;0;196;186;10
1261;372;9368;3;372;2213;0;1004;939;65
1261;373;9124;3;373;1930;0;751;705;46
1261;374;9178;3;374;2191;0;799;751;48
1261;375;9483;3;375;1654;0;542;514;28
1261;376;9263;3;376;1881;0;688;644;44
1261;377;9302;3;377;1468;1;532;509;23
1261;378;9437;3;378;592;0;260;247;13
1261;37;9549;3;37;1356;0;537;513;24
1261;379;9154;3;379;1772;0;581;555;26
1261;380;9200;3;380;953;0;301;284;17
1261;381;9530;3;381;1409;0;347;331;16
1261;382;9541;3;382;1846;0;719;680;39
1261;383;9195;3;383;1761;0;658;625;33
1261;384;9303;3;384;2098;0;1008;979;29
1261;385;9214;3;385;1064;0;432;402;30
1261;386;9423;3;386;1402;0;603;577;26
1261;387;9201;3;387;759;0;293;275;18
1261;388;9327;3;388;1873;0;726;687;39
1261;38;9389;3;38;1079;0;526;503;23
1261;389;9127;3;389;1117;0;386;340;46
1261;390;9165;3;390;1365;0;441;375;66
1261;391;9350;3;391;2092;0;859;816;43
1261;3;9257;3;3;1239;1;408;386;22
1261;392;9234;3;392;1676;0;649;619;30
1261;393;9384;3;393;1311;0;507;475;32
1261;394;9406;3;394;1349;0;575;535;40
1261;395;9539;3;395;1682;0;640;614;26
1261;396;9225;3;396;1690;0;755;719;36
1261;397;9477;3;397;1648;1;678;642;36
1261;398;9274;3;398;1144;0;403;379;24
1261;39;9341;3;39;1676;2;862;824;38
1261;399;9307;3;399;1612;0;543;512;31
1261;400;9440;3;400;2020;0;847;801;46
1261;401;9233;3;401;775;0;310;298;12
1261;402;9150;3;402;1542;0;606;572;34
1261;403;9439;3;403;1647;0;654;625;29
1261;404;9378;3;404;1034;0;365;343;22
1261;405;9157;3;405;1849;0;680;653;27
1261;406;9488;3;406;1057;0;378;355;23
1261;407;9345;3;407;1603;0;659;600;59
1261;408;9352;3;408;1525;0;616;598;18
1261;40;9431;3;40;1409;1;639;613;26
1261;409;9148;3;409;1692;0;600;572;28
1261;410;9487;3;410;1315;1;537;511;26
1261;411;9293;3;411;1118;0;394;370;24
1261;412;9313;3;412;1176;0;482;461;21
1261;413;9478;3;413;1576;0;592;541;51
1261;414;9400;3;414;978;0;371;351;20
1261;415;9485;3;415;1305;2;547;523;24
1261;416;9335;3;416;1114;0;536;504;32
1261;417;9510;3;417;1731;0;783;743;40
1261;418;9310;3;418;1714;0;795;753;42
1261;41;9362;3;41;1536;0;594;562;32
1261;419;9186;3;419;1234;2;528;506;22
1261;420;9427;3;420;1572;0;687;640;47
1261;421;9518;3;421;721;0;277;240;37
1261;422;9174;3;422;1240;0;512;455;57
1261;423;9492;3;423;944;0;401;348;53
1261;424;9466;3;424;345;0;121;117;4
1261;425;9185;3;425;45;0;17;14;3
1261;426;9448;3;426;21;0;8;8;0
1261;427;9465;3;427;20;0;8;7;1
1261;428;9422;3;428;120;0;39;33;6
1261;42;9537;3;42;1316;0;559;530;29
1261;429;9363;3;429;9;0;6;6;0
1261;430;9116;3;430;168;0;144;140;4
1261;431;9100;3;431;353;0;110;102;8
1261;432;9142;3;432;203;0;108;99;9
1261;433;9268;3;433;302;0;42;39;3
1261;434;9342;3;434;67;0;43;43;0
1261;435;9231;3;435;90;0;26;24;2
1261;436;9137;3;436;109;0;40;37;3
1261;437;9394;3;437;86;0;37;32;5
1261;438;9446;3;438;65;0;9;9;0
1261;43;9382;3;43;1244;0;566;539;27
1261;439;9419;3;439;16;0;7;6;1
1261;440;9496;3;440;90;0;35;32;3
1261;441;9332;3;441;33;0;18;17;1
1261;442;9364;3;442;32;0;27;24;3
1261;443;9242;3;443;241;0;43;42;1
1261;444;9140;3;444;72;0;27;21;6
1261;445;9180;3;445;158;0;58;54;4
1261;446;9276;3;446;64;0;50;50;0
1261;447;9199;3;447;11;0;10;10;0
1261;448;9527;3;448;5;0;3;3;0
1261;44;9272;3;44;1552;0;742;719;23
1261;449;9139;3;449;211;0;68;60;8
1261;450;9424;3;450;55;0;36;31;5
1261;451;9229;3;451;159;0;27;23;4
1261;452;9153;3;452;189;0;77;63;14
1261;453;9292;3;453;65;0;48;44;4
1261;454;9404;3;454;94;0;51;46;5
1261;455;9497;3;455;255;0;52;47;5
1261;456;9415;3;456;115;0;26;26;0
1261;457;9156;3;457;26;0;20;19;1
1261;458;9534;3;458;28;0;28;26;2
1261;45;9435;3;45;1529;1;750;730;20
1261;459;9235;3;459;85;0;28;25;3
1261;46;9311;3;46;1098;0;465;442;23
1261;47;9414;3;47;1018;0;447;425;22
1261;48;9490;3;48;1184;0;612;598;14
1261;4;9355;3;4;1063;0;382;361;21
1261;49;9238;3;49;1213;0;453;436;17
1261;50;9548;3;50;1140;0;476;465;11
1261;51;9267;3;51;1230;0;586;561;25
1261;52;9329;3;52;1428;0;667;636;31
1261;53;9502;3;53;732;0;426;402;24
1261;54;9412;3;54;1621;0;774;738;36
1261;55;9213;3;55;1617;0;616;589;27
1261;56;9251;3;56;1430;0;653;632;21
1261;57;9301;3;57;1987;1;942;914;28
1261;58;9545;3;58;1341;0;649;622;27
1261;5;9152;3;5;1158;0;419;405;14
1261;59;9175;3;59;1149;0;580;560;20
1261;60;9457;3;60;776;0;403;400;3
1261;61;9428;3;61;1417;0;656;628;28
1261;62;9312;3;62;1550;0;563;540;23
1261;63;9460;3;63;2217;0;960;927;33
1261;64;9273;3;64;1181;0;450;431;19
1261;65;9452;3;65;2110;0;976;943;33
1261;66;9141;3;66;1496;0;677;665;12
1261;67;9509;3;67;999;0;456;421;35
1261;68;9322;3;68;1953;0;1038;1018;20
1261;6;9168;3;6;704;1;265;248;17
1261;69;9348;3;69;1171;0;542;529;13
1261;70;9326;3;70;1053;0;530;516;14
1261;71;9155;3;71;1177;0;464;430;34
1261;72;9265;3;72;1531;0;678;631;47
1261;73;9513;3;73;1143;0;525;504;21
1261;74;9121;3;74;1897;0;980;943;37
1261;75;9104;3;75;1743;0;849;849;0
1261;76;9354;3;76;907;0;391;391;0
1261;77;9146;3;77;1254;0;549;515;34
1261;78;9547;3;78;1294;0;565;539;26
1261;7;9258;3;7;1498;1;647;620;27
1261;79;9445;3;79;1611;0;751;717;34
1261;80;9260;3;80;892;0;430;416;14
1261;81;9163;3;81;1617;0;738;699;39
1261;82;9416;3;82;1259;0;572;546;26
1261;83;9171;3;83;1194;0;552;525;27
1261;84;9280;3;84;1225;0;512;483;29
1261;85;9170;3;85;1642;0;661;617;44
1261;86;9289;3;86;1772;0;631;598;33
1261;87;9347;3;87;1989;0;907;865;42
1261;88;9393;3;88;1172;0;484;464;20
1261;8;9123;3;8;1464;1;618;584;34
1261;89;9172;3;89;1015;0;349;331;18
1261;90;9314;3;90;994;0;359;339;20
1261;91;9173;3;91;2167;0;787;749;38
1261;92;9365;3;92;872;0;330;320;10
1261;93;9278;3;93;1155;0;386;363;23
1261;94;9528;3;94;1125;0;442;427;15
1261;95;9338;3;95;1694;0;604;576;28
1261;96;9256;3;96;1633;0;767;740;27
1261;97;9215;3;97;1091;0;573;555;18
1261;98;9145;3;98;1121;0;541;527;14
1261;9;9308;3;9;785;0;299;294;5
1261;99;9540;3;99;1984;0;916;881;35
1262;10;9560;6;10;2085;0;1012;940;72
1262;11;9588;6;11;1229;0;567;539;28
1262;12;9573;6;12;1493;1;762;723;39
1262;13;9561;6;13;1569;0;751;685;66
1262;14;9558;6;14;1415;1;654;622;32
1262;15;9602;6;15;1584;0;817;787;30
1262;16;9587;6;16;1192;0;733;690;43
1262;17;9574;6;17;1805;0;966;921;45
1262;18;9567;6;18;908;0;507;474;33
1262;1;9581;6;1;1427;0;707;680;27
1262;19;9585;6;19;1994;1;977;940;37
1262;20;9578;6;20;1106;0;516;501;15
1262;21;9598;6;21;1702;0;894;862;32
1262;22;9597;6;22;2157;0;1044;995;49
1262;23;9592;6;23;1899;0;897;853;44
1262;24;9568;6;24;1821;0;858;801;57
1262;25;9582;6;25;817;0;356;345;11
1262;26;9565;6;26;1544;0;795;752;43
1262;27;9575;6;27;1844;1;923;853;70
1262;28;9557;6;28;1238;0;572;537;35
1262;2;9599;6;2;1897;0;908;858;50
1262;29;9600;6;29;1875;0;903;869;34
1262;30;9590;6;30;1891;0;883;838;45
1262;31;9554;6;31;982;0;477;450;27
1262;32;9591;6;32;1251;0;634;614;20
1262;33;9595;6;33;1650;0;806;745;61
1262;34;9589;6;34;962;0;459;436;23
1262;35;9603;6;35;1147;0;601;566;35
1262;36;9571;6;36;1573;0;819;742;77
1262;37;9577;6;37;91;0;55;55;0
1262;38;9601;6;38;70;0;33;31;2
1262;3;9569;6;3;1155;1;520;490;30
1262;39;9583;6;39;37;0;37;32;5
1262;40;9580;6;40;60;0;24;20;4
1262;41;9593;6;41;83;0;36;21;15
1262;42;9563;6;42;958;0;443;429;14
1262;43;9596;6;43;1811;0;812;765;47
1262;44;9562;6;44;1023;0;469;448;21
1262;45;9572;6;45;1436;0;774;751;23
1262;46;9564;6;46;1173;0;560;550;10
1262;47;9584;6;47;1145;0;511;491;20
1262;48;9594;6;48;1261;0;633;606;27
1262;4;9576;6;4;1002;0;438;416;22
1262;49;9559;6;49;1057;0;534;511;23
1262;50;9566;6;50;867;0;525;467;58
1262;51;9579;6;51;1351;0;655;623;32
1262;5;9604;6;5;1470;1;685;661;24
1262;6;9556;6;6;1371;0;809;768;41
1262;7;9586;6;7;2036;0;1078;1028;50
1262;8;9555;6;8;2009;0;965;912;53
1262;9;9570;6;9;1463;0;853;814;39
1263;10;9651;5;10;1299;0;600;564;36
1263;11;9661;5;11;1323;0;574;535;39
1263;12;9615;5;12;922;1;360;344;16
1263;13;9630;5;13;1177;0;561;531;30
1263;14;9621;5;14;2039;0;883;840;43
1263;15;9646;5;15;2031;1;924;871;53
1263;16;9641;5;16;1537;1;596;566;30
1263;17;9642;5;17;2139;1;1010;985;25
1263;18;9640;5;18;1517;0;606;579;27
1263;1;9619;5;1;977;0;294;280;14
1263;19;9606;5;19;1370;2;623;597;26
1263;20;9627;5;20;1182;1;520;507;13
1263;21;9637;5;21;1506;0;758;734;24
1263;22;9653;5;22;1044;0;459;447;12
1263;23;9668;5;23;1065;0;382;365;17
1263;24;9636;5;24;139;0;55;47;8
1263;25;9635;5;25;1112;0;478;452;26
1263;26;9622;5;26;1434;0;561;531;30
1263;27;9618;5;27;1089;0;513;480;33
1263;28;9670;5;28;1112;0;450;432;18
1263;2;9672;5;2;1688;2;588;568;20
1263;29;9613;5;29;1268;0;555;515;40
1263;30;9658;5;30;1251;0;509;463;46
1263;31;9652;5;31;1391;0;537;503;34
1263;32;9654;5;32;1012;0;429;391;38
1263;33;9614;5;33;1331;0;596;559;37
1263;34;9660;5;34;1191;0;521;495;26
1263;35;9669;5;35;1886;0;896;874;22
1263;36;9610;5;36;1089;0;440;432;8
1263;37;9633;5;37;1004;0;377;369;8
1263;38;9631;5;38;1991;0;800;756;44
1263;3;9649;5;3;799;1;311;301;10
1263;39;9647;5;39;1711;0;683;645;38
1263;40;9665;5;40;1628;1;669;625;44
1263;41;9634;5;41;1402;0;545;528;17
1263;42;9643;5;42;1153;0;447;432;15
1263;43;9675;5;43;1447;0;570;539;31
1263;44;9648;5;44;1219;0;450;429;21
1263;45;9625;5;45;752;0;257;240;17
1263;46;9632;5;46;1677;0;758;723;35
1263;47;9659;5;47;1584;0;695;655;40
1263;48;9657;5;48;1127;1;510;490;20
1263;4;9620;5;4;609;2;243;238;5
1263;49;9655;5;49;964;0;342;332;10
1263;50;9623;5;50;1435;0;677;642;35
1263;51;9674;5;51;1227;0;469;446;23
1263;52;9664;5;52;1325;0;507;464;43
1263;53;9667;5;53;2000;0;1009;961;48
1263;54;9624;5;54;1815;0;837;804;33
1263;55;9671;5;55;2278;2;1234;1171;63
1263;56;9629;5;56;1297;0;710;671;39
1263;57;9628;5;57;1437;2;717;677;40
1263;58;9639;5;58;1482;1;678;612;66
1263;5;9638;5;5;1271;1;481;461;20
1263;59;9666;5;59;1506;0;677;641;36
1263;60;9645;5;60;1979;0;848;766;82
1263;61;9611;5;61;2262;0;977;932;45
1263;62;9673;5;62;2133;0;970;921;49
1263;63;9663;5;63;2379;0;1028;977;51
1263;64;9612;5;64;1733;0;783;731;52
1263;65;9617;5;65;1926;1;793;764;29
1263;66;9662;5;66;122;0;41;37;4
1263;67;9607;5;67;142;0;34;33;1
1263;68;9650;5;68;73;0;44;41;3
1263;6;9656;5;6;903;1;354;340;14
1263;69;9609;5;69;9;0;9;9;0
1263;70;9608;5;70;71;0;29;17;12
1263;71;9616;5;71;29;0;15;14;1
1263;7;9605;5;7;1375;0;579;542;37
1263;8;9626;5;8;1741;1;782;754;28
1263;9;9644;5;9;2035;0;818;786;32
1401;1;9676;5;1;1667;8;998;834;164
1401;1;9682;5;1;2105;0;1395;1043;352
1401;1;9686;5;1;477;0;312;242;70
1401;1;9687;5;1;1799;5;1199;1006;193
1401;1;9690;5;1;1821;2;1030;869;161
1401;1;9694;5;1;1460;5;1043;792;251
1401;2;9677;5;2;1482;0;819;639;180
1401;2;9680;5;2;373;0;272;208;64
1401;2;9681;5;2;883;0;547;419;128
1401;2;9684;5;2;1360;1;769;661;108
1401;2;9693;5;2;1752;2;1045;851;194
1401;2;9697;5;2;678;0;304;207;97
1401;3;9678;5;3;771;0;502;374;128
1401;3;9685;5;3;459;0;280;232;48
1401;3;9688;5;3;1843;0;1027;796;231
1401;3;9689;5;3;948;0;426;274;152
1401;3;9695;5;3;563;2;394;315;79
1401;4;9683;5;4;903;0;521;392;129
1401;4;9691;5;4;1973;1;1183;915;268
1401;4;9696;5;4;593;0;243;163;80
1401;5;9679;5;5;1702;0;931;709;222
1401;5;9692;5;5;1240;0;740;558;182
1402;10;9748;4;10;2242;1;911;814;97
1402;11;9707;4;11;1896;0;876;790;86
1402;12;9723;4;12;1505;0;720;614;106
1402;13;9735;4;13;1971;1;900;746;154
1402;14;9718;4;14;1139;0;396;311;85
1402;15;9724;4;15;2086;1;1038;939;99
1402;16;9721;4;16;984;0;433;382;51
1402;17;9737;4;17;1707;2;836;721;115
1402;18;9727;4;18;1509;0;805;686;119
1402;1;9701;4;1;1050;0;572;530;42
1402;1;9705;4;1;1951;5;1357;1027;330
1402;1;9710;4;1;2332;1;1316;1057;259
1402;1;9728;4;1;2154;0;1077;919;158
1402;1;9734;4;1;1863;0;1034;827;207
1402;1;9736;4;1;2101;7;948;724;224
1402;1;9738;4;1;1957;0;1202;983;219
1402;1;9740;4;1;1417;5;985;606;379
1402;1;9753;4;1;2055;0;1121;864;257
1402;19;9714;4;19;1544;0;640;496;144
1402;20;9712;4;20;1257;0;569;497;72
1402;21;9739;4;21;2478;0;1319;1132;187
1402;22;9708;4;22;2185;0;1216;1038;178
1402;23;9720;4;23;161;0;89;50;39
1402;24;9725;4;24;70;0;13;10;3
1402;2;9702;4;2;1289;2;769;571;198
1402;2;9703;4;2;900;0;537;396;141
1402;2;9715;4;2;1641;0;843;757;86
1402;2;9719;4;2;917;0;533;376;157
1402;2;9729;4;2;790;3;426;341;85
1402;2;9731;4;2;1107;0;567;460;107
1402;2;9732;4;2;704;0;480;340;140
1402;2;9747;4;2;733;2;461;358;103
1402;2;9749;4;2;2482;1;1117;815;302
1402;3;9700;4;3;709;0;424;291;133
1402;3;9713;4;3;603;0;312;244;68
1402;3;9730;4;3;830;0;491;391;100
1402;3;9733;4;3;1458;0;840;632;208
1402;3;9741;4;3;1473;0;738;664;74
1402;3;9745;4;3;493;0;364;270;94
1402;3;9750;4;3;812;0;423;295;128
1402;4;9699;4;4;1692;2;946;769;177
1402;4;9704;4;4;952;0;440;326;114
1402;4;9716;4;4;1770;0;907;795;112
1402;4;9722;4;4;865;1;535;358;177
1402;4;9742;4;4;461;0;327;216;111
1402;4;9744;4;4;1074;0;533;390;143
1402;4;9746;4;4;901;0;494;352;142
1402;5;9698;4;5;1304;1;699;591;108
1402;5;9706;4;5;756;0;425;348;77
1402;5;9751;4;5;746;4;423;322;101
1402;6;9709;4;6;591;0;332;254;78
1402;6;9726;4;6;1973;0;1011;861;150
1402;6;9743;4;6;8;0;6;6;0
1402;7;9711;4;7;1659;2;760;633;127
1402;8;9752;4;8;1771;1;826;738;88
1402;9;9717;4;9;724;0;336;302;34
1403;10;9786;6;10;523;1;225;172;53
1403;10;9829;6;10;1341;0;682;604;78
1403;11;9766;6;11;4;0;0;0;0
1403;1;9758;6;1;969;0;326;326;0
1403;1;9761;6;1;1199;1;750;569;181
1403;1;9776;6;1;1378;1;941;743;198
1403;1;9795;6;1;1220;2;570;437;133
1403;1;9798;6;1;1923;1;986;834;152
1403;1;9801;6;1;1892;0;1001;856;145
1403;1;9802;6;1;1034;2;718;595;123
1403;1;9808;6;1;1291;0;681;545;136
1403;1;9828;6;1;2151;0;1356;889;467
1403;1;9835;6;1;1511;4;1128;773;355
1403;1;9839;6;1;878;5;681;500;181
1403;1;9840;6;1;1018;0;622;513;109
1403;1;9841;6;1;1531;3;949;767;182
1403;1;9844;6;1;795;0;389;310;79
1403;2;9754;6;2;1824;0;1000;820;180
1403;2;9767;6;2;1726;0;787;635;152
1403;2;9772;6;2;672;1;347;285;62
1403;2;9777;6;2;1181;0;646;552;94
1403;2;9780;6;2;512;0;324;205;119
1403;2;9783;6;2;1555;5;1077;767;310
1403;2;9799;6;2;1181;0;618;474;144
1403;2;9810;6;2;1210;0;711;505;206
1403;2;9818;6;2;1249;3;758;598;160
1403;2;9819;6;2;786;0;468;340;128
1403;2;9824;6;2;614;0;348;265;83
1403;2;9825;6;2;530;4;302;258;44
1403;2;9836;6;2;699;0;295;236;59
1403;2;9843;6;2;455;0;192;173;19
1403;3;9765;6;3;431;0;246;168;78
1403;3;9770;6;3;1685;0;736;630;106
1403;3;9771;6;3;389;0;223;187;36
1403;3;9782;6;3;800;1;450;323;127
1403;3;9784;6;3;1002;0;589;482;107
1403;3;9790;6;3;546;2;352;282;70
1403;3;9796;6;3;499;0;253;191;62
1403;3;9800;6;3;1151;1;720;514;206
1403;3;9805;6;3;897;3;668;417;251
1403;3;9809;6;3;1360;0;669;582;87
1403;3;9812;6;3;548;0;281;249;32
1403;3;9821;6;3;1530;0;980;732;248
1403;3;9822;6;3;1241;0;595;520;75
1403;3;9842;6;3;463;0;262;205;57
1403;4;9759;6;4;589;1;361;267;94
1403;4;9760;6;4;553;4;353;249;104
1403;4;9763;6;4;832;0;444;373;71
1403;4;9773;6;4;1632;1;796;691;105
1403;4;9778;6;4;617;5;370;298;72
1403;4;9781;6;4;466;0;204;166;38
1403;4;9785;6;4;923;0;444;388;56
1403;4;9791;6;4;686;0;375;277;98
1403;4;9823;6;4;484;0;245;200;45
1403;4;9826;6;4;756;0;391;302;89
1403;4;9827;6;4;620;2;414;293;121
1403;4;9832;6;4;467;1;282;223;59
1403;4;9833;6;4;366;0;227;175;52
1403;5;9755;6;5;1341;0;747;592;155
1403;5;9756;6;5;692;1;422;341;81
1403;5;9762;6;5;1497;0;897;679;218
1403;5;9768;6;5;614;0;334;293;41
1403;5;9797;6;5;568;0;381;289;92
1403;5;9807;6;5;2021;0;1167;883;284
1403;5;9814;6;5;1022;0;517;451;66
1403;5;9816;6;5;1021;0;612;430;182
1403;5;9820;6;5;539;0;213;180;33
1403;5;9838;6;5;619;0;376;302;74
1403;6;9757;6;6;646;1;389;308;81
1403;6;9764;6;6;502;0;229;162;67
1403;6;9775;6;6;1352;5;768;651;117
1403;6;9794;6;6;486;0;220;173;47
1403;6;9804;6;6;691;5;497;385;112
1403;6;9806;6;6;485;0;281;208;73
1403;6;9813;6;6;441;0;275;203;72
1403;6;9815;6;6;2290;2;1416;1100;316
1403;6;9817;6;6;1172;0;560;490;70
1403;7;9779;6;7;394;0;258;170;88
1403;7;9788;6;7;1340;3;705;587;118
1403;7;9789;6;7;370;0;234;172;62
1403;7;9792;6;7;1026;1;590;474;116
1403;7;9803;6;7;377;0;232;158;74
1403;7;9834;6;7;548;1;332;288;44
1403;8;9769;6;8;475;1;269;228;41
1403;8;9774;6;8;1039;0;519;383;136
1403;8;9787;6;8;1679;0;842;730;112
1403;8;9811;6;8;403;0;192;161;31
1403;9;9793;6;9;1320;2;588;475;113
1403;9;9830;6;9;142;0;95;75;20
1403;9;9831;6;9;283;0;187;150;37
1403;9;9837;6;9;1239;0;617;532;85
1404;10;9881;4;10;1188;1;593;467;126
1404;10;9882;4;10;16;0;10;8;2
1404;11;9863;4;11;811;0;427;357;70
1404;11;9867;4;11;20;0;16;13;3
1404;12;9879;4;12;18;0;9;7;2
1404;1;9847;4;1;1792;32;1246;919;327
1404;1;9876;4;1;385;1;200;157;43
1404;1;9878;4;1;1830;0;799;650;149
1404;1;9880;4;1;1582;0;949;740;209
1404;1;9883;4;1;749;0;434;343;91
1404;2;9860;4;2;346;2;168;138;30
1404;2;9862;4;2;614;0;343;252;91
1404;2;9864;4;2;496;2;291;171;120
1404;2;9871;4;2;1622;0;786;656;130
1404;2;9874;4;2;733;6;488;331;157
1404;3;9845;4;3;649;7;499;353;146
1404;3;9857;4;3;1829;1;916;765;151
1404;3;9868;4;3;1255;0;668;511;157
1404;3;9869;4;3;1149;8;760;557;203
1404;3;9873;4;3;2247;13;1297;1047;250
1404;4;9846;4;4;681;0;357;247;110
1404;4;9852;4;4;2011;0;1006;859;147
1404;4;9854;4;4;248;1;158;140;18
1404;4;9855;4;4;981;0;605;427;178
1404;4;9875;4;4;71;0;52;42;10
1404;5;9856;4;5;1427;0;784;662;122
1404;5;9859;4;5;677;3;405;363;42
1404;5;9866;4;5;1624;0;811;685;126
1404;6;9850;4;6;1598;1;779;617;162
1404;6;9865;4;6;1162;0;652;487;165
1404;6;9877;4;6;322;0;178;150;28
1404;7;9851;4;7;652;0;362;288;74
1404;7;9861;4;7;618;1;309;279;30
1404;7;9872;4;7;2411;1;1152;927;225
1404;8;9849;4;8;560;0;380;303;77
1404;8;9853;4;8;2220;0;1012;863;149
1404;8;9870;4;8;441;0;224;193;31
1404;9;9848;4;9;579;0;355;286;69
1404;9;9858;4;9;430;0;206;175;31
1405;10;9905;7;10;1883;0;920;838;82
1405;11;9931;7;11;2134;1;1131;1008;123
1405;12;9918;7;12;2237;0;1181;1101;80
1405;13;9911;7;13;1595;0;782;732;50
1405;14;9914;7;14;1110;0;639;589;50
1405;15;9919;7;15;2227;1;1140;1038;102
1405;16;9897;7;16;1899;0;1043;945;98
1405;17;9921;7;17;1902;0;919;792;127
1405;18;9923;7;18;1403;0;672;618;54
1405;1;9891;7;1;1459;0;672;500;172
1405;1;9894;7;1;1260;0;531;473;58
1405;1;9896;7;1;1650;4;1050;991;59
1405;1;9899;7;1;1382;4;723;602;121
1405;1;9928;7;1;1213;0;627;520;107
1405;1;9929;7;1;1426;1;751;679;72
1405;19;9884;7;19;1184;0;480;427;53
1405;20;9890;7;20;699;0;334;326;8
1405;21;9886;7;21;5;0;5;2;3
1405;22;9926;7;22;61;0;7;6;1
1405;23;9903;7;23;18;0;16;16;0
1405;24;9920;7;24;17;0;15;12;3
1405;2;9895;7;2;1306;5;533;423;110
1405;2;9900;7;2;1754;1;832;716;116
1405;2;9901;7;2;1862;0;741;661;80
1405;2;9908;7;2;1621;1;1029;937;92
1405;2;9912;7;2;1302;0;552;443;109
1405;2;9924;7;2;2057;0;1186;1006;180
1405;3;9887;7;3;794;0;402;336;66
1405;3;9893;7;3;561;0;267;184;83
1405;3;9898;7;3;2457;0;1381;1250;131
1405;3;9913;7;3;405;0;148;127;21
1405;3;9916;7;3;1411;0;554;437;117
1405;4;9888;7;4;1509;0;733;646;87
1405;4;9907;7;4;1736;1;885;800;85
1405;4;9910;7;4;391;0;170;124;46
1405;4;9922;7;4;1756;4;823;662;161
1405;5;9885;7;5;711;1;375;289;86
1405;5;9892;7;5;1666;0;781;643;138
1405;5;9925;7;5;1046;0;485;442;43
1405;5;9927;7;5;2087;2;961;848;113
1405;6;9902;7;6;1526;0;662;573;89
1405;6;9904;7;6;1135;0;646;517;129
1405;6;9915;7;6;1837;2;950;809;141
1405;7;9889;7;7;1750;1;800;725;75
1405;7;9909;7;7;1138;0;520;434;86
1405;7;9930;7;7;1762;0;883;800;83
1405;8;9917;7;8;2372;2;1038;951;87
1405;9;9906;7;9;1456;1;685;609;76
1406;10;9949;5;10;600;0;348;278;70
1406;10;9967;5;10;1490;0;751;592;159
1406;1;10003;5;1;1650;3;880;701;179
1406;11;9939;5;11;627;0;433;293;140
1406;11;9956;5;11;1385;0;659;584;75
1406;12;9948;5;12;1080;0;676;603;73
1406;12;9968;5;12;562;0;311;263;48
1406;13;9940;5;13;566;0;287;242;45
1406;13;9964;5;13;744;0;455;365;90
1406;14;9978;5;14;626;0;321;241;80
1406;15;9962;5;15;29;0;21;15;6
1406;16;9938;5;16;27;0;5;5;0
1406;1;9942;5;1;1008;0;723;554;169
1406;1;9955;5;1;1823;4;1152;934;218
1406;1;9973;5;1;1990;0;1015;759;256
1406;1;9975;5;1;1324;0;741;595;146
1406;1;9986;5;1;2044;1;1270;1110;160
1406;1;9990;5;1;1334;0;785;678;107
1406;1;9991;5;1;1347;0;689;506;183
1406;1;9993;5;1;2067;0;1231;1047;184
1406;1;9995;5;1;1879;1;1136;998;138
1406;2;10000;5;2;1684;0;972;761;211
1406;2;9935;5;2;782;0;436;334;102
1406;2;9941;5;2;692;0;378;288;90
1406;2;9944;5;2;1724;0;925;766;159
1406;2;9945;5;2;1015;1;566;396;170
1406;2;9957;5;2;778;0;430;356;74
1406;2;9958;5;2;672;0;279;229;50
1406;2;9969;5;2;647;0;504;371;133
1406;2;9981;5;2;1548;2;1008;839;169
1406;2;9985;5;2;805;0;485;385;100
1406;3;9933;5;3;2189;0;1260;1068;192
1406;3;9946;5;3;1780;0;699;699;0
1406;3;9953;5;3;1414;1;639;497;142
1406;3;9971;5;3;610;1;276;200;76
1406;3;9979;5;3;1326;0;822;629;193
1406;3;9980;5;3;2077;0;1233;1061;172
1406;3;9989;5;3;639;0;323;244;79
1406;3;9994;5;3;769;2;562;430;132
1406;3;9997;5;3;837;0;538;467;71
1406;4;10001;5;4;335;0;211;177;34
1406;4;9947;5;4;718;0;308;216;92
1406;4;9952;5;4;508;0;287;214;73
1406;4;9965;5;4;912;1;648;428;220
1406;4;9972;5;4;2265;0;1283;1081;202
1406;4;9974;5;4;1389;0;653;536;117
1406;4;9982;5;4;1291;0;919;712;207
1406;4;9987;5;4;863;2;446;357;89
1406;4;9999;5;4;1290;0;687;563;124
1406;5;10004;5;5;1479;1;904;727;177
1406;5;9936;5;5;722;0;356;275;81
1406;5;9951;5;5;1652;1;940;771;169
1406;5;9954;5;5;1062;0;505;428;77
1406;5;9961;5;5;668;6;430;355;75
1406;5;9984;5;5;497;0;261;215;46
1406;5;9998;5;5;1743;0;930;773;157
1406;6;9932;5;6;1482;2;858;673;185
1406;6;9934;5;6;628;0;247;180;67
1406;6;9937;5;6;49;0;37;26;11
1406;6;9943;5;6;671;0;300;235;65
1406;6;9992;5;6;1441;0;783;636;147
1406;6;9996;5;6;504;0;270;217;53
1406;7;10005;5;7;1886;0;993;762;231
1406;7;10006;5;7;743;1;325;257;68
1406;7;9950;5;7;1222;0;597;494;103
1406;7;9963;5;7;468;1;297;226;71
1406;7;9970;5;7;10;0;5;3;2
1406;7;9983;5;7;1076;0;540;455;85
1406;8;9960;5;8;564;0;271;205;66
1406;8;9966;5;8;1431;0;799;668;131
1406;8;9976;5;8;597;0;261;208;53
1406;8;9988;5;8;584;0;313;266;47
1406;9;10002;5;9;1168;0;638;520;118
1406;9;9959;5;9;674;0;385;327;58
1406;9;9977;5;9;326;0;98;72;26
1407;10;10033;5;10;1330;0;658;528;130
1407;1;10010;5;1;2127;7;1497;1234;263
1407;1;10011;5;1;762;0;404;308;96
1407;1;10019;5;1;600;0;373;315;58
1407;1;10021;5;1;1016;2;748;596;152
1407;1;10049;5;1;1818;0;981;812;169
1407;1;10053;5;1;1577;2;1037;753;284
1407;1;10057;5;1;555;1;351;255;96
1407;11;10058;5;11;782;0;423;359;64
1407;12;10043;5;12;1032;6;575;497;78
1407;13;10016;5;13;1442;0;738;626;112
1407;14;10007;5;14;967;0;464;464;0
1407;15;10008;5;15;1406;0;722;605;117
1407;16;10014;5;16;802;0;435;279;156
1407;17;10038;5;17;1120;0;563;419;144
1407;18;10037;5;18;812;0;466;364;102
1407;19;10024;5;19;842;0;530;415;115
1407;20;10060;5;20;732;0;442;340;102
1407;2;10022;5;2;727;0;347;295;52
1407;2;10029;5;2;581;7;439;347;92
1407;2;10031;5;2;1591;0;1011;831;180
1407;2;10034;5;2;599;0;402;261;141
1407;2;10048;5;2;1305;2;803;615;188
1407;2;10052;5;2;1158;0;689;459;230
1407;2;10059;5;2;898;4;601;439;162
1407;21;10026;5;21;578;0;303;244;59
1407;22;10012;5;22;495;1;231;175;56
1407;23;10020;5;23;54;0;29;25;4
1407;24;10032;5;24;69;0;21;16;5
1407;3;10013;5;3;1602;1;855;725;130
1407;3;10015;5;3;597;0;429;289;140
1407;3;10025;5;3;1307;1;734;528;206
1407;3;10028;5;3;1075;0;601;443;158
1407;3;10039;5;3;1239;2;740;556;184
1407;3;10040;5;3;1588;18;1082;847;235
1407;3;10055;5;3;459;1;261;191;70
1407;4;10023;5;4;574;5;393;277;116
1407;4;10044;5;4;1510;0;946;802;144
1407;4;10045;5;4;490;0;251;164;87
1407;4;10050;5;4;355;0;208;142;66
1407;4;10056;5;4;647;0;392;278;114
1407;5;10017;5;5;509;1;275;205;70
1407;5;10027;5;5;1198;0;727;630;97
1407;5;10035;5;5;1273;0;829;655;174
1407;5;10051;5;5;391;1;271;215;56
1407;6;10030;5;6;584;1;406;308;98
1407;6;10036;5;6;663;4;494;356;138
1407;6;10046;5;6;1584;0;883;730;153
1407;7;10047;5;7;584;0;323;254;69
1407;7;10054;5;7;1456;0;827;701;126
1407;8;10009;5;8;817;6;641;441;200
1407;8;10042;5;8;1771;0;971;808;163
1407;9;10018;5;9;1382;0;772;672;100
1407;9;10041;5;9;304;1;243;148;95
1408;10;10111;7;10;2263;0;1101;966;135
1408;1;10068;7;1;1155;0;604;498;106
1408;1;10093;7;1;1840;0;1062;784;278
1408;1;10095;7;1;2104;0;1306;1066;240
1408;1;10108;7;1;1525;1;778;647;131
1408;1;10112;7;1;1859;0;890;759;131
1408;11;10080;7;11;2204;1;1144;1012;132
1408;12;10086;7;12;1590;0;754;650;104
1408;13;10090;7;13;1381;0;655;584;71
1408;14;10085;7;14;1756;0;822;660;162
1408;15;10084;7;15;1667;0;805;682;123
1408;16;10089;7;16;1597;1;772;674;98
1408;17;10088;7;17;1959;0;900;768;132
1408;18;10073;7;18;2073;0;1022;879;143
1408;19;10098;7;19;1339;1;647;561;86
1408;20;10062;7;20;1653;1;785;703;82
1408;2;10063;7;2;1964;1;969;760;209
1408;2;10067;7;2;993;0;578;511;67
1408;2;10069;7;2;1804;0;729;587;142
1408;2;10079;7;2;1651;0;1074;693;381
1408;2;10102;7;2;1497;1;602;538;64
1408;21;10107;7;21;1885;1;868;746;122
1408;22;10076;7;22;2138;0;1099;996;103
1408;23;10099;7;23;83;0;55;45;10
1408;3;10075;7;3;1123;0;572;443;129
1408;3;10097;7;3;1324;0;771;610;161
1408;3;10103;7;3;1842;0;835;707;128
1408;3;10106;7;3;1251;2;753;599;154
1408;3;10109;7;3;2327;0;1095;891;204
1408;4;10064;7;4;2183;0;883;697;186
1408;4;10065;7;4;1486;0;877;657;220
1408;4;10071;7;4;1170;1;658;497;161
1408;4;10078;7;4;2165;0;913;770;143
1408;4;10083;7;4;1932;2;1118;831;287
1408;5;10061;7;5;752;0;452;351;101
1408;5;10077;7;5;2044;1;922;639;283
1408;5;10087;7;5;1558;0;742;666;76
1408;5;10092;7;5;1256;0;701;554;147
1408;5;10105;7;5;2407;0;1454;1170;284
1408;6;10066;7;6;2161;0;1111;1006;105
1408;6;10074;7;6;927;0;544;429;115
1408;6;10082;7;6;1184;0;633;537;96
1408;6;10091;7;6;947;0;472;409;63
1408;6;10110;7;6;905;0;462;404;58
1408;7;10072;7;7;2302;0;1064;897;167
1408;7;10081;7;7;1270;1;721;622;99
1408;7;10101;7;7;829;0;407;283;124
1408;7;10104;7;7;602;0;350;259;91
1408;8;10070;7;8;2030;0;968;862;106
1408;8;10094;7;8;673;0;337;283;54
1408;9;10096;7;9;779;0;408;317;91
1408;9;10100;7;9;2182;0;988;863;125
1409;10;10139;5;10;765;0;459;398;61
1409;1;10132;5;1;511;1;348;290;58
1409;1;10134;5;1;1226;0;801;559;242
1409;1;10136;5;1;1415;0;826;608;218
1409;1;10143;5;1;365;0;213;143;70
1409;1;10146;5;1;2042;0;1153;888;265
1409;1;10153;5;1;1220;0;620;545;75
1409;11;10150;5;11;90;0;30;14;16
1409;12;10124;5;12;32;0;13;10;3
1409;2;10114;5;2;903;2;599;418;181
1409;2;10117;5;2;521;1;251;192;59
1409;2;10126;5;2;379;0;221;158;63
1409;2;10128;5;2;288;0;164;110;54
1409;2;10135;5;2;1954;0;1042;828;214
1409;2;10137;5;2;496;0;232;169;63
1409;3;10113;5;3;542;0;297;199;98
1409;3;10118;5;3;1753;0;923;756;167
1409;3;10120;5;3;1087;0;597;425;172
1409;3;10129;5;3;681;0;296;204;92
1409;3;10130;5;3;2203;1;1095;772;323
1409;3;10147;5;3;744;0;388;299;89
1409;4;10116;5;4;695;0;430;313;117
1409;4;10123;5;4;490;0;247;203;44
1409;4;10125;5;4;260;0;101;72;29
1409;4;10148;5;4;389;0;163;122;41
1409;4;10152;5;4;555;0;191;191;0
1409;5;10122;5;5;722;1;411;309;102
1409;5;10127;5;5;979;1;555;458;97
1409;5;10133;5;5;617;0;290;237;53
1409;5;10138;5;5;442;0;280;197;83
1409;5;10140;5;5;1042;0;449;365;84
1409;6;10115;5;6;891;0;449;377;72
1409;6;10144;5;6;778;0;467;295;172
1409;6;10145;5;6;342;0;162;119;43
1409;6;10151;5;6;573;0;352;240;112
1409;7;10119;5;7;263;0;101;84;17
1409;7;10142;5;7;369;0;211;163;48
1409;7;10149;5;7;233;0;143;109;34
1409;8;10121;5;8;410;0;229;163;66
1409;8;10141;5;8;843;0;402;309;93
1409;9;10131;5;9;463;0;272;218;54
1410;1;10155;6;1;2072;0;1063;932;131
1410;1;10161;6;1;1297;0;719;597;122
1410;1;10179;6;1;914;0;503;403;100
1410;1;10181;6;1;752;2;461;376;85
1410;1;10182;6;1;294;0;143;137;6
1410;1;10183;6;1;1698;0;979;762;217
1410;2;10154;6;2;410;0;244;197;47
1410;2;10156;6;2;326;0;153;127;26
1410;2;10158;6;2;313;0;152;123;29
1410;2;10162;6;2;998;3;506;410;96
1410;2;10180;6;2;1478;0;704;604;100
1410;2;10187;6;2;1139;0;509;423;86
1410;3;10165;6;3;1202;1;574;510;64
1410;3;10169;6;3;663;0;385;320;65
1410;3;10170;6;3;1020;0;446;362;84
1410;3;10171;6;3;907;0;429;364;65
1410;3;10173;6;3;286;0;168;145;23
1410;3;10175;6;3;1048;0;579;427;152
1410;4;10163;6;4;665;0;257;211;46
1410;4;10168;6;4;1782;0;842;724;118
1410;4;10174;6;4;458;0;294;266;28
1410;4;10176;6;4;945;2;614;521;93
1410;4;10186;6;4;583;0;285;225;60
1410;4;10188;6;4;390;1;251;197;54
1410;5;10157;6;5;781;0;441;336;105
1410;5;10166;6;5;328;0;165;124;41
1410;5;10167;6;5;267;0;119;95;24
1410;5;10185;6;5;435;0;201;174;27
1410;6;10159;6;6;370;0;165;150;15
1410;6;10160;6;6;1186;2;579;450;129
1410;6;10178;6;6;210;0;123;96;27
1410;7;10172;6;7;584;0;228;162;66
1410;7;10177;6;7;251;0;73;67;6
1410;8;10164;6;8;217;0;103;96;7
1410;8;10184;6;8;515;0;244;194;50
1411;1;10200;6;1;1163;0;779;649;130
1411;1;10201;6;1;1035;0;875;561;314
1411;1;10211;6;1;1264;1;934;640;294
1411;1;10214;6;1;1899;0;1078;812;266
1411;1;10216;6;1;1057;1;740;554;186
1411;1;10220;6;1;633;0;322;245;77
1411;1;10225;6;1;1453;2;884;651;233
1411;1;10230;6;1;770;2;538;455;83
1411;1;10234;6;1;1179;0;638;538;100
1411;1;10236;6;1;1889;1;950;780;170
1411;2;10191;6;2;249;0;167;129;38
1411;2;10194;6;2;1066;3;663;518;145
1411;2;10195;6;2;223;0;113;94;19
1411;2;10203;6;2;318;0;213;169;44
1411;2;10205;6;2;672;0;339;291;48
1411;2;10212;6;2;568;1;340;270;70
1411;2;10217;6;2;741;13;582;323;259
1411;2;10219;6;2;2102;0;1019;817;202
1411;2;10223;6;2;1139;1;775;537;238
1411;2;10237;6;2;310;0;217;144;73
1411;3;10189;6;3;1420;3;917;679;238
1411;3;10197;6;3;183;1;117;88;29
1411;3;10202;6;3;840;0;473;361;112
1411;3;10204;6;3;762;0;441;351;90
1411;3;10207;6;3;353;0;254;173;81
1411;3;10209;6;3;1968;0;1022;857;165
1411;3;10221;6;3;328;3;206;168;38
1411;3;10229;6;3;595;4;365;274;91
1411;3;10231;6;3;228;0;160;122;38
1411;3;10235;6;3;255;0;155;138;17
1411;4;10193;6;4;379;0;298;198;100
1411;4;10196;6;4;263;0;167;113;54
1411;4;10199;6;4;435;0;249;197;52
1411;4;10213;6;4;1229;0;555;463;92
1411;4;10224;6;4;191;1;131;80;51
1411;4;10226;6;4;920;5;580;448;132
1411;4;10227;6;4;552;0;359;266;93
1411;4;10232;6;4;2153;0;1159;907;252
1411;5;10190;6;5;31;0;13;9;4
1411;5;10192;6;5;384;0;270;180;90
1411;5;10198;6;5;1141;0;459;350;109
1411;5;10222;6;5;1326;1;726;545;181
1411;6;10206;6;6;198;0;160;116;44
1411;6;10210;6;6;470;0;285;210;75
1411;6;10215;6;6;465;0;255;197;58
1411;6;10233;6;6;20;0;11;8;3
1411;7;10208;6;7;225;0;146;117;29
1411;7;10228;6;7;571;0;267;231;36
1411;8;10218;6;8;308;0;130;95;35
1412;10;10300;6;10;784;0;319;265;54
1412;10;10327;6;10;1797;0;937;864;73
1412;1;10243;6;1;715;0;305;242;63
1412;1;10259;6;1;2288;0;1338;956;382
1412;1;10261;6;1;2167;0;1122;991;131
1412;1;10274;6;1;1936;0;1097;878;219
1412;1;10277;6;1;1400;0;879;682;197
1412;1;10283;6;1;543;0;163;106;57
1412;1;10292;6;1;1215;0;569;425;144
1412;1;10295;6;1;1544;1;669;454;215
1412;1;10297;6;1;1720;1;1084;818;266
1412;1;10307;6;1;1424;1;827;670;157
1412;1;10308;6;1;1115;0;447;397;50
1412;1;10313;6;1;1410;0;817;597;220
1412;1;10324;6;1;1645;0;870;653;217
1412;11;10251;6;11;2076;0;1071;1004;67
1412;11;10329;6;11;595;0;267;221;46
1412;12;10249;6;12;377;0;200;154;46
1412;12;10296;6;12;1635;0;723;652;71
1412;13;10252;6;13;1639;0;674;574;100
1412;14;10240;6;14;1833;0;717;664;53
1412;15;10268;6;15;1818;0;594;508;86
1412;16;10304;6;16;1815;0;786;720;66
1412;17;10265;6;17;1907;0;800;746;54
1412;18;10272;6;18;26;0;13;10;3
1412;2;10247;6;2;1308;0;636;492;144
1412;2;10248;6;2;1392;0;633;587;46
1412;2;10262;6;2;1333;0;725;660;65
1412;2;10263;6;2;684;0;236;173;63
1412;2;10267;6;2;1225;0;596;447;149
1412;2;10279;6;2;1692;1;812;539;273
1412;2;10281;6;2;534;0;332;256;76
1412;2;10287;6;2;1247;2;712;545;167
1412;2;10293;6;2;901;0;421;351;70
1412;2;10305;6;2;841;0;395;305;90
1412;2;10317;6;2;744;0;388;303;85
1412;2;10319;6;2;911;0;371;275;96
1412;2;10325;6;2;543;0;247;173;74
1412;3;10238;6;3;498;0;314;251;63
1412;3;10244;6;3;751;0;355;283;72
1412;3;10256;6;3;1425;0;581;439;142
1412;3;10266;6;3;763;0;329;216;113
1412;3;10275;6;3;628;0;237;170;67
1412;3;10284;6;3;475;0;189;160;29
1412;3;10301;6;3;2274;0;1289;1080;209
1412;3;10302;6;3;1520;0;746;585;161
1412;3;10303;6;3;1391;0;623;503;120
1412;3;10310;6;3;1808;0;857;771;86
1412;3;10312;6;3;816;0;474;324;150
1412;3;10322;6;3;942;0;442;335;107
1412;3;10330;6;3;846;1;367;244;123
1412;4;10239;6;4;1275;0;708;513;195
1412;4;10241;6;4;693;0;294;199;95
1412;4;10246;6;4;489;1;265;202;63
1412;4;10254;6;4;615;0;329;265;64
1412;4;10260;6;4;901;2;467;350;117
1412;4;10264;6;4;2140;0;1017;817;200
1412;4;10269;6;4;1248;1;476;383;93
1412;4;10273;6;4;1771;0;681;524;157
1412;4;10276;6;4;1602;0;677;449;228
1412;4;10278;6;4;1974;0;931;828;103
1412;4;10286;6;4;1086;0;357;357;0
1412;4;10311;6;4;404;0;168;128;40
1412;4;10316;6;4;1711;0;774;552;222
1412;5;10242;6;5;1510;3;855;671;184
1412;5;10250;6;5;1494;0;737;585;152
1412;5;10257;6;5;1941;0;987;897;90
1412;5;10270;6;5;632;1;287;228;59
1412;5;10294;6;5;1160;1;583;460;123
1412;5;10306;6;5;2003;0;990;761;229
1412;5;10309;6;5;362;0;172;95;77
1412;5;10315;6;5;717;0;301;200;101
1412;5;10320;6;5;715;0;280;190;90
1412;6;10245;6;6;355;0;151;128;23
1412;6;10253;6;6;908;0;290;205;85
1412;6;10280;6;6;2112;0;810;711;99
1412;6;10285;6;6;2135;0;1138;744;394
1412;6;10298;6;6;1161;0;748;568;180
1412;6;10321;6;6;1704;0;807;637;170
1412;6;10323;6;6;716;0;239;187;52
1412;6;10326;6;6;1863;0;861;714;147
1412;7;10271;6;7;425;0;187;143;44
1412;7;10282;6;7;685;0;289;205;84
1412;7;10289;6;7;131;0;64;50;14
1412;7;10291;6;7;1535;0;755;620;135
1412;7;10314;6;7;1010;0;577;490;87
1412;7;10328;6;7;1581;0;708;639;69
1412;8;10255;6;8;2059;0;997;915;82
1412;8;10258;6;8;1386;0;630;478;152
1412;8;10288;6;8;763;0;324;261;63
1412;9;10290;6;9;1788;0;983;849;134
1412;9;10299;6;9;1939;0;867;815;52
1412;9;10318;6;9;645;0;343;288;55
1413;10;10365;4;10;2064;0;955;762;193
1413;1;10331;4;1;2231;2;1519;1147;372
1413;1;10340;4;1;417;4;285;186;99
1413;1;10344;4;1;1469;9;875;627;248
1413;1;10363;4;1;1194;3;776;564;212
1413;1;10364;4;1;1403;1;612;491;121
1413;1;10370;4;1;1117;0;716;555;161
1413;1;10371;4;1;1690;0;1143;851;292
1413;1;10374;4;1;2185;0;1176;880;296
1413;1;10375;4;1;1041;0;548;396;152
1413;1;10377;4;1;565;0;329;246;83
1413;11;10357;4;11;2396;1;1318;1140;178
1413;12;10358;4;12;2432;2;1031;872;159
1413;13;10346;4;13;2036;0;1091;923;168
1413;14;10354;4;14;51;0;27;23;4
1413;2;10334;4;2;691;0;321;321;0
1413;2;10338;4;2;1421;0;756;638;118
1413;2;10339;4;2;772;0;374;267;107
1413;2;10341;4;2;333;0;168;126;42
1413;2;10342;4;2;175;1;129;97;32
1413;2;10347;4;2;1089;0;652;462;190
1413;2;10348;4;2;1510;0;1035;751;284
1413;2;10349;4;2;611;0;327;231;96
1413;2;10353;4;2;1434;4;919;704;215
1413;2;10356;4;2;1111;0;594;434;160
1413;3;10332;4;3;857;2;489;339;150
1413;3;10343;4;3;844;0;596;423;173
1413;3;10345;4;3;1015;2;569;398;171
1413;3;10350;4;3;1565;2;1120;804;316
1413;3;10352;4;3;622;0;401;308;93
1413;3;10359;4;3;867;7;566;434;132
1413;3;10360;4;3;487;0;216;173;43
1413;3;10361;4;3;1181;0;616;520;96
1413;3;10372;4;3;1254;0;601;464;137
1413;3;10376;4;3;1337;5;797;599;198
1413;4;10333;4;4;757;2;420;333;87
1413;4;10336;4;4;699;3;494;347;147
1413;4;10337;4;4;540;1;390;281;109
1413;4;10362;4;4;1727;2;912;763;149
1413;4;10367;4;4;1266;0;701;535;166
1413;4;10368;4;4;488;0;269;194;75
1413;4;10378;4;4;762;0;352;244;108
1413;5;10351;4;5;1704;0;884;659;225
1413;5;10373;4;5;2355;1;1162;1025;137
1413;6;10369;4;6;2250;0;1174;1080;94
1413;7;10335;4;7;2164;0;1015;869;146
1413;8;10366;4;8;1291;1;601;535;66
1413;9;10355;4;9;2095;2;917;715;202
1414;10;10389;7;10;1130;0;545;415;130
1414;10;10408;7;10;2256;0;1010;794;216
1414;1;10392;7;1;1666;1;929;754;175
1414;1;10393;7;1;1430;2;741;509;232
1414;1;10395;7;1;479;0;309;206;103
1414;1;10406;7;1;1819;1;1116;884;232
1414;1;10410;7;1;918;4;606;516;90
1414;1;10414;7;1;1685;0;782;689;93
1414;11;10385;7;11;78;0;65;49;16
1414;11;10409;7;11;2106;0;1104;961;143
1414;12;10387;7;12;2235;0;1275;957;318
1414;13;10413;7;13;8;0;7;6;1
1414;2;10390;7;2;1724;3;896;798;98
1414;2;10391;7;2;1243;0;711;452;259
1414;2;10403;7;2;2029;0;1368;964;404
1414;2;10404;7;2;1622;1;1029;769;260
1414;2;10422;7;2;2132;0;1194;1007;187
1414;2;10423;7;2;1749;1;1255;900;355
1414;3;10381;7;3;2203;2;1123;972;151
1414;3;10383;7;3;2190;7;1277;987;290
1414;3;10384;7;3;2120;2;1091;912;179
1414;3;10388;7;3;1301;0;893;625;268
1414;3;10411;7;3;1131;1;526;392;134
1414;3;10415;7;3;656;0;365;265;100
1414;4;10399;7;4;984;5;497;353;144
1414;4;10405;7;4;1831;0;800;622;178
1414;4;10416;7;4;1041;1;560;385;175
1414;4;10417;7;4;958;2;657;459;198
1414;4;10418;7;4;2219;0;1126;936;190
1414;4;10419;7;4;581;0;372;289;83
1414;5;10379;7;5;1705;0;937;793;144
1414;5;10396;7;5;774;0;409;223;186
1414;5;10401;7;5;1042;0;454;372;82
1414;5;10402;7;5;515;0;306;242;64
1414;5;10420;7;5;1970;2;994;789;205
1414;6;10407;7;6;1010;0;639;473;166
1414;6;10412;7;6;1248;1;628;482;146
1414;6;10421;7;6;983;0;592;475;117
1414;7;10380;7;7;1960;4;1096;891;205
1414;7;10394;7;7;1547;0;766;613;153
1414;7;10397;7;7;482;0;302;234;68
1414;8;10382;7;8;1152;0;519;424;95
1414;8;10386;7;8;1678;4;914;711;203
1414;9;10398;7;9;999;5;622;482;140
1414;9;10400;7;9;1763;0;851;691;160
1415;10;10434;6;10;529;0;292;184;108
1415;10;10474;6;10;194;0;97;63;34
1415;1;10430;6;1;1596;1;921;650;271
1415;1;10431;6;1;1157;0;609;486;123
1415;1;10432;6;1;917;0;591;425;166
1415;1;10442;6;1;372;0;184;130;54
1415;1;10446;6;1;1688;2;1065;836;229
1415;1;10456;6;1;1976;0;1217;915;302
1415;1;10459;6;1;720;0;281;219;62
1415;1;10465;6;1;1179;0;526;427;99
1415;1;10482;6;1;1955;5;1102;834;268
1415;1;10493;6;1;1562;1;748;577;171
1415;1;10509;6;1;1600;3;968;736;232
1415;11;10460;6;11;166;0;76;57;19
1415;11;10496;6;11;384;0;224;161;63
1415;12;10453;6;12;308;0;142;100;42
1415;12;10464;6;12;609;0;322;210;112
1415;13;10461;6;13;388;0;168;101;67
1415;13;10480;6;13;515;0;300;219;81
1415;14;10502;6;14;414;0;231;148;83
1415;2;10424;6;2;294;0;163;112;51
1415;2;10427;6;2;780;0;505;350;155
1415;2;10429;6;2;1493;0;886;708;178
1415;2;10437;6;2;538;0;313;243;70
1415;2;10469;6;2;1374;0;749;569;180
1415;2;10478;6;2;1706;0;932;766;166
1415;2;10481;6;2;594;0;284;220;64
1415;2;10489;6;2;251;0;132;100;32
1415;2;10490;6;2;392;0;196;148;48
1415;2;10498;6;2;1306;0;652;465;187
1415;2;10507;6;2;288;0;108;82;26
1415;3;10435;6;3;488;0;238;202;36
1415;3;10450;6;3;560;0;287;214;73
1415;3;10452;6;3;573;1;325;254;71
1415;3;10462;6;3;775;0;432;301;131
1415;3;10466;6;3;821;0;405;312;93
1415;3;10475;6;3;928;0;540;514;26
1415;3;10484;6;3;642;0;278;211;67
1415;3;10485;6;3;228;0;98;57;41
1415;3;10487;6;3;806;0;505;350;155
1415;3;10500;6;3;960;0;442;288;154
1415;3;10508;6;3;215;0;129;87;42
1415;4;10428;6;4;1154;0;537;428;109
1415;4;10433;6;4;1093;0;535;396;139
1415;4;10438;6;4;1252;0;708;591;117
1415;4;10439;6;4;771;0;529;372;157
1415;4;10448;6;4;845;0;333;222;111
1415;4;10454;6;4;531;0;313;231;82
1415;4;10463;6;4;371;0;179;141;38
1415;4;10468;6;4;1281;0;642;405;237
1415;4;10477;6;4;934;0;512;343;169
1415;4;10499;6;4;518;0;193;151;42
1415;4;10504;6;4;660;0;420;313;107
1415;5;10440;6;5;474;0;210;169;41
1415;5;10441;6;5;1751;0;1028;789;239
1415;5;10443;6;5;692;0;503;321;182
1415;5;10445;6;5;522;0;304;222;82
1415;5;10447;6;5;399;0;209;162;47
1415;5;10451;6;5;1292;0;731;564;167
1415;5;10458;6;5;732;1;336;257;79
1415;5;10473;6;5;749;0;443;304;139
1415;5;10497;6;5;340;0;159;120;39
1415;5;10503;6;5;908;3;623;515;108
1415;6;10467;6;6;418;0;184;112;72
1415;6;10472;6;6;546;0;331;251;80
1415;6;10479;6;6;1042;0;501;387;114
1415;6;10483;6;6;1224;0;716;586;130
1415;6;10488;6;6;769;0;404;305;99
1415;6;10491;6;6;731;0;281;208;73
1415;6;10492;6;6;1048;0;474;349;125
1415;6;10501;6;6;1039;0;427;310;117
1415;6;10510;6;6;246;0;128;98;30
1415;7;10425;6;7;695;0;343;280;63
1415;7;10426;6;7;363;0;190;152;38
1415;7;10436;6;7;339;0;222;154;68
1415;7;10449;6;7;671;0;423;351;72
1415;7;10471;6;7;468;0;306;204;102
1415;7;10476;6;7;608;1;330;227;103
1415;7;10506;6;7;1559;0;808;631;177
1415;8;10455;6;8;487;0;289;206;83
1415;8;10457;6;8;877;0;551;408;143
1415;8;10486;6;8;340;0;225;146;79
1415;8;10494;6;8;409;0;243;170;73
1415;8;10495;6;8;822;0;312;234;78
1415;8;10505;6;8;660;0;383;307;76
1415;9;10444;6;9;486;0;344;243;101
1415;9;10470;6;9;387;0;150;123;27
1416;10;10517;6;10;652;0;401;303;98
1416;10;10522;6;10;27;0;10;7;3
1416;10;10546;6;10;383;0;205;163;42
1416;1;10512;6;1;1156;2;594;486;108
1416;1;10513;6;1;957;0;631;511;120
1416;1;10514;6;1;1520;0;896;839;57
1416;1;10515;6;1;997;2;634;511;123
1416;1;10527;6;1;1083;6;524;434;90
1416;1;10537;6;1;1302;4;899;700;199
1416;1;10550;6;1;1414;7;930;679;251
1416;1;10551;6;1;2003;32;1504;1284;220
1416;1;10555;6;1;2268;0;1416;1221;195
1416;1;10572;6;1;578;0;302;249;53
1416;1;10576;6;1;1550;1;904;772;132
1416;11;10518;6;11;520;0;270;218;52
1416;11;10557;6;11;724;1;461;340;121
1416;12;10573;6;12;391;0;204;182;22
1416;13;10543;6;13;936;1;441;364;77
1416;14;10556;6;14;474;0;296;256;40
1416;15;10519;6;15;540;0;269;214;55
1416;16;10558;6;16;669;0;333;291;42
1416;2;10511;6;2;1453;1;800;618;182
1416;2;10525;6;2;689;0;367;301;66
1416;2;10528;6;2;304;3;217;181;36
1416;2;10529;6;2;359;2;236;185;51
1416;2;10531;6;2;2170;1;1258;1049;209
1416;2;10541;6;2;343;1;227;173;54
1416;2;10552;6;2;733;0;417;311;106
1416;2;10560;6;2;420;2;277;215;62
1416;2;10565;6;2;414;0;276;204;72
1416;2;10577;6;2;799;0;356;293;63
1416;3;10521;6;3;494;3;338;276;62
1416;3;10535;6;3;279;0;180;145;35
1416;3;10538;6;3;2204;0;1239;930;309
1416;3;10540;6;3;2120;0;1236;1022;214
1416;3;10544;6;3;861;24;585;504;81
1416;3;10549;6;3;1218;7;739;617;122
1416;3;10554;6;3;795;0;546;429;117
1416;3;10564;6;3;1020;5;674;528;146
1416;3;10569;6;3;759;0;388;311;77
1416;3;10570;6;3;549;1;370;278;92
1416;4;10516;6;4;345;1;200;175;25
1416;4;10520;6;4;2123;0;1225;1086;139
1416;4;10523;6;4;702;0;420;373;47
1416;4;10542;6;4;420;0;235;190;45
1416;4;10545;6;4;487;6;367;318;49
1416;4;10553;6;4;577;0;279;205;74
1416;4;10563;6;4;530;3;421;350;71
1416;4;10574;6;4;331;2;210;166;44
1416;5;10530;6;5;649;1;393;293;100
1416;5;10561;6;5;199;2;126;108;18
1416;5;10566;6;5;1188;1;720;595;125
1416;5;10567;6;5;2169;1;1255;1100;155
1416;5;10571;6;5;268;0;180;132;48
1416;6;10539;6;6;210;0;141;106;35
1416;6;10548;6;6;710;1;357;289;68
1416;6;10568;6;6;2085;4;1225;1114;111
1416;6;10575;6;6;575;2;361;260;101
1416;7;10524;6;7;2055;3;1251;1132;119
1416;7;10547;6;7;852;0;464;370;94
1416;7;10559;6;7;680;0;389;285;104
1416;8;10526;6;8;569;0;221;178;43
1416;8;10532;6;8;627;2;417;318;99
1416;8;10536;6;8;2019;1;1214;1078;136
1416;9;10533;6;9;1372;0;798;662;136
1416;9;10534;6;9;676;1;385;282;103
1416;9;10562;6;9;313;0;187;130;57
1417;10;10607;7;10;1128;0;511;447;64
1417;1;10582;7;1;533;0;316;252;64
1417;1;10598;7;1;1520;0;767;714;53
1417;1;10614;7;1;1636;1;985;770;215
1417;1;10621;7;1;1902;2;1131;794;337
1417;1;10622;7;1;2201;1;1347;997;350
1417;1;10636;7;1;1698;0;995;731;264
1417;1;10640;7;1;1050;0;597;501;96
1417;1;10649;7;1;2269;2;1355;1196;159
1417;11;10589;7;11;2174;0;1024;891;133
1417;12;10635;7;12;2124;0;990;914;76
1417;13;10603;7;13;1572;0;653;530;123
1417;14;10583;7;14;1192;0;613;539;74
1417;15;10611;7;15;1491;3;770;666;104
1417;16;10630;7;16;1558;0;675;600;75
1417;17;10628;7;17;1698;1;778;671;107
1417;18;10616;7;18;1566;0;827;720;107
1417;19;10624;7;19;1212;0;480;400;80
1417;20;10585;7;20;871;0;352;314;38
1417;2;10593;7;2;1873;0;1056;857;199
1417;2;10597;7;2;854;0;428;387;41
1417;2;10606;7;2;635;0;382;324;58
1417;2;10620;7;2;731;0;351;264;87
1417;2;10626;7;2;1005;0;546;484;62
1417;2;10632;7;2;2412;0;1500;1143;357
1417;2;10634;7;2;385;0;170;129;41
1417;2;10644;7;2;648;0;344;244;100
1417;21;10588;7;21;866;0;359;311;48
1417;22;10641;7;22;1023;0;375;329;46
1417;23;10612;7;23;1070;0;454;406;48
1417;24;10625;7;24;1142;0;649;543;106
1417;25;10601;7;25;1088;0;588;477;111
1417;26;10608;7;26;987;0;422;380;42
1417;27;10592;7;27;24;0;16;16;0
1417;28;10639;7;28;0;0;0;0;0
1417;3;10578;7;3;530;0;244;178;66
1417;3;10580;7;3;728;0;456;312;144
1417;3;10584;7;3;1632;1;925;837;88
1417;3;10604;7;3;1674;1;795;727;68
1417;3;10613;7;3;698;0;394;314;80
1417;3;10623;7;3;1445;2;767;663;104
1417;3;10627;7;3;493;0;277;207;70
1417;3;10642;7;3;1859;2;1134;896;238
1417;4;10579;7;4;1923;0;1157;1050;107
1417;4;10591;7;4;1522;0;768;653;115
1417;4;10594;7;4;1909;0;1275;1027;248
1417;4;10596;7;4;1723;2;963;830;133
1417;4;10599;7;4;803;1;468;362;106
1417;4;10619;7;4;1561;1;873;562;311
1417;4;10643;7;4;1621;0;821;732;89
1417;5;10581;7;5;1168;0;668;524;144
1417;5;10587;7;5;1142;0;524;466;58
1417;5;10590;7;5;1514;0;739;619;120
1417;5;10615;7;5;957;0;630;459;171
1417;5;10633;7;5;908;0;529;465;64
1417;5;10647;7;5;2071;0;1374;1092;282
1417;6;10586;7;6;817;0;406;365;41
1417;6;10595;7;6;854;0;384;298;86
1417;6;10610;7;6;892;0;509;411;98
1417;6;10629;7;6;2221;0;1110;973;137
1417;6;10637;7;6;477;0;274;211;63
1417;6;10638;7;6;1115;0;598;492;106
1417;7;10600;7;7;872;0;512;447;65
1417;7;10605;7;7;1969;0;828;685;143
1417;7;10609;7;7;989;0;544;452;92
1417;7;10631;7;7;1728;1;776;673;103
1417;7;10648;7;7;665;0;414;328;86
1417;7;10650;7;7;524;0;286;205;81
1417;8;10617;7;8;1305;0;687;626;61
1417;8;10618;7;8;1602;2;877;782;95
1417;8;10646;7;8;629;0;385;312;73
1417;8;10651;7;8;1707;0;922;756;166
1417;9;10602;7;9;2195;0;1214;1088;126
1417;9;10645;7;9;1660;0;697;628;69
1418;10;10675;7;10;1824;0;983;808;175
1418;10;10682;7;10;1342;0;668;622;46
1418;10;10718;7;10;1151;0;541;436;105
1418;10;10739;7;10;1410;2;771;668;103
1418;1;10657;7;1;1550;1;884;797;87
1418;1;10658;7;1;786;0;515;406;109
1418;1;10661;7;1;2118;1;912;830;82
1418;1;10686;7;1;2354;0;1118;906;212
1418;1;10687;7;1;598;0;350;228;122
1418;1;10693;7;1;1483;0;800;596;204
1418;11;10652;7;11;1214;1;642;499;143
1418;11;10700;7;11;1391;0;688;631;57
1418;11;10713;7;11;1609;1;692;621;71
1418;11;10734;7;11;1380;0;680;680;0
1418;12;10673;7;12;1115;0;593;496;97
1418;12;10685;7;12;1707;1;847;746;101
1418;12;10698;7;12;1655;2;817;670;147
1418;13;10702;7;13;1450;1;789;631;158
1418;13;10712;7;13;1585;0;779;698;81
1418;13;10735;7;13;700;0;408;331;77
1418;14;10660;7;14;678;0;390;347;43
1418;14;10683;7;14;1660;0;944;785;159
1418;14;10691;7;14;1172;0;553;508;45
1418;15;10662;7;15;1278;0;780;644;136
1418;15;10665;7;15;51;0;32;28;4
1418;15;10703;7;15;1052;0;514;514;0
1418;16;10684;7;16;1258;1;623;573;50
1418;16;10710;7;16;476;0;144;111;33
1418;16;10711;7;16;34;0;26;21;5
1418;17;10679;7;17;2152;1;1058;982;76
1418;17;10741;7;17;48;0;31;27;4
1418;18;10654;7;18;45;0;33;33;0
1418;18;10672;7;18;2033;0;968;886;82
1418;19;10653;7;19;1490;0;776;724;52
1418;20;10677;7;20;1678;2;855;798;57
1418;2;10663;7;2;1672;0;689;625;64
1418;2;10664;7;2;1217;1;667;574;93
1418;2;10670;7;2;506;0;223;167;56
1418;2;10674;7;2;1342;0;811;597;214
1418;2;10715;7;2;1443;1;785;518;267
1418;2;10738;7;2;1839;0;907;761;146
1418;21;10701;7;21;578;0;370;304;66
1418;22;10716;7;22;1258;0;696;612;84
1418;23;10733;7;23;1622;0;881;779;102
1418;24;10655;7;24;2187;0;1152;1030;122
1418;25;10678;7;25;850;0;407;341;66
1418;26;10699;7;26;1795;0;858;764;94
1418;27;10714;7;27;2054;0;1034;1013;21
1418;28;10704;7;28;2018;1;923;880;43
1418;29;10722;7;29;968;0;382;362;20
1418;30;10689;7;30;1743;0;505;485;20
1418;3;10668;7;3;689;0;320;247;73
1418;3;10671;7;3;1444;0;908;667;241
1418;3;10720;7;3;837;0;470;441;29
1418;3;10727;7;3;750;0;429;318;111
1418;3;10730;7;3;1372;0;746;671;75
1418;3;10742;7;3;1356;0;627;562;65
1418;31;10688;7;31;782;0;437;357;80
1418;32;10680;7;32;1368;0;558;524;34
1418;33;10729;7;33;1207;1;621;567;54
1418;34;10726;7;34;13;0;3;2;1
1418;4;10669;7;4;1099;0;524;485;39
1418;4;10695;7;4;860;0;453;366;87
1418;4;10717;7;4;1895;0;1003;810;193
1418;4;10737;7;4;786;0;269;254;15
1418;4;10740;7;4;1069;0;619;528;91
1418;4;10744;7;4;652;0;329;243;86
1418;5;10659;7;5;1097;0;635;525;110
1418;5;10694;7;5;998;0;559;420;139
1418;5;10705;7;5;1721;0;653;653;0
1418;5;10719;7;5;1778;0;869;774;95
1418;5;10724;7;5;1621;0;829;610;219
1418;5;10743;7;5;1596;1;872;792;80
1418;6;10666;7;6;1450;0;716;577;139
1418;6;10676;7;6;1711;1;903;737;166
1418;6;10690;7;6;784;1;370;338;32
1418;6;10728;7;6;2393;0;1180;1128;52
1418;6;10732;7;6;1534;2;895;706;189
1418;7;10681;7;7;937;0;461;418;43
1418;7;10708;7;7;1152;0;598;552;46
1418;7;10721;7;7;1316;0;641;535;106
1418;7;10725;7;7;1297;0;729;608;121
1418;7;10736;7;7;2176;0;1063;910;153
1418;8;10692;7;8;1053;0;553;462;91
1418;8;10696;7;8;1567;0;791;611;180
1418;8;10709;7;8;2261;0;937;937;0
1418;8;10723;7;8;1531;2;824;711;113
1418;8;10731;7;8;1206;0;621;595;26
1418;9;10656;7;9;2084;0;811;811;0
1418;9;10667;7;9;1505;0;799;603;196
1418;9;10697;7;9;747;0;382;311;71
1418;9;10706;7;9;1473;1;875;770;105
1418;9;10707;7;9;648;3;411;303;108
1419;1;10752;4;1;1725;0;704;602;102
1419;1;10753;4;1;2107;2;1269;1044;225
1419;1;10764;4;1;1473;2;978;749;229
1419;1;10765;4;1;1466;2;965;757;208
1419;1;10766;4;1;1410;0;834;619;215
1419;1;10772;4;1;526;0;346;294;52
1419;1;10774;4;1;942;0;466;360;106
1419;1;10778;4;1;538;1;335;265;70
1419;1;10779;4;1;1624;0;966;751;215
1419;1;10783;4;1;1318;2;784;589;195
1419;1;10789;4;1;1138;0;648;554;94
1419;1;10799;4;1;1292;0;700;556;144
1419;1;10803;4;1;2065;7;1288;1037;251
1419;1;10811;4;1;2208;3;1021;827;194
1419;1;10823;4;1;2006;8;1195;1058;137
1419;2;10747;4;2;2201;2;1300;1008;292
1419;2;10756;4;2;820;0;314;279;35
1419;2;10757;4;2;1406;0;643;506;137
1419;2;10760;4;2;1963;0;932;721;211
1419;2;10762;4;2;999;1;548;447;101
1419;2;10784;4;2;2031;3;1358;1070;288
1419;2;10791;4;2;1489;2;814;694;120
1419;2;10792;4;2;284;0;202;146;56
1419;2;10793;4;2;661;2;403;304;99
1419;2;10805;4;2;875;2;588;440;148
1419;2;10808;4;2;1645;2;943;762;181
1419;2;10815;4;2;907;0;452;368;84
1419;2;10818;4;2;564;0;372;320;52
1419;2;10826;4;2;2279;0;1127;958;169
1419;2;10828;4;2;716;3;425;343;82
1419;3;10745;4;3;1647;0;991;801;190
1419;3;10758;4;3;1269;0;726;568;158
1419;3;10770;4;3;984;9;613;519;94
1419;3;10776;4;3;1711;1;746;625;121
1419;3;10780;4;3;760;0;291;222;69
1419;3;10782;4;3;1084;1;506;455;51
1419;3;10785;4;3;1297;0;650;522;128
1419;3;10786;4;3;1524;1;760;617;143
1419;3;10787;4;3;359;0;177;151;26
1419;3;10788;4;3;1802;0;1054;878;176
1419;3;10790;4;3;363;1;240;190;50
1419;3;10795;4;3;1006;7;684;510;174
1419;3;10796;4;3;641;0;412;333;79
1419;3;10798;4;3;657;0;447;337;110
1419;3;10810;4;3;824;1;516;435;81
1419;4;10748;4;4;377;0;239;195;44
1419;4;10755;4;4;1718;0;945;830;115
1419;4;10763;4;4;856;0;344;300;44
1419;4;10767;4;4;517;0;257;208;49
1419;4;10768;4;4;541;0;279;216;63
1419;4;10775;4;4;349;1;210;168;42
1419;4;10777;4;4;1970;5;1312;1158;154
1419;4;10794;4;4;1022;0;369;294;75
1419;4;10802;4;4;1835;2;948;768;180
1419;4;10809;4;4;702;0;342;249;93
1419;4;10817;4;4;764;0;422;327;95
1419;4;10819;4;4;730;0;389;326;63
1419;4;10827;4;4;385;4;240;186;54
1419;4;10829;4;4;1053;7;546;432;114
1419;5;10746;4;5;773;3;483;357;126
1419;5;10759;4;5;589;0;280;242;38
1419;5;10761;4;5;360;0;193;166;27
1419;5;10771;4;5;606;2;360;272;88
1419;5;10797;4;5;865;2;553;438;115
1419;5;10801;4;5;1366;3;629;512;117
1419;5;10804;4;5;68;0;41;25;16
1419;5;10814;4;5;26;0;26;14;12
1419;5;10816;4;5;933;7;508;425;83
1419;5;10821;4;5;936;0;524;367;157
1419;5;10824;4;5;936;0;437;374;63
1419;6;10749;4;6;1811;0;993;792;201
1419;6;10750;4;6;423;0;212;182;30
1419;6;10781;4;6;829;0;451;400;51
1419;6;10807;4;6;393;0;151;125;26
1419;6;10812;4;6;841;0;402;326;76
1419;6;10820;4;6;1419;2;833;683;150
1419;6;10822;4;6;705;0;376;290;86
1419;7;10769;4;7;904;0;373;327;46
1419;7;10773;4;7;101;0;47;46;1
1419;7;10800;4;7;353;0;243;165;78
1419;7;10806;4;7;86;0;43;22;21
1419;7;10825;4;7;135;0;102;91;11
1419;8;10751;4;8;589;0;309;277;32
1419;8;10754;4;8;331;0;208;162;46
1419;9;10813;4;9;545;0;304;216;88
1420;10;10833;4;10;1283;2;672;565;107
1420;1;10830;4;1;1433;3;835;640;195
1420;1;10832;4;1;789;0;472;343;129
1420;1;10838;4;1;919;2;538;384;154
1420;1;10850;4;1;1525;0;553;436;117
1420;1;10852;4;1;1233;0;394;337;57
1420;1;10869;4;1;1925;6;1275;1016;259
1420;1;10872;4;1;946;0;527;412;115
1420;1;10876;4;1;2004;1;1036;852;184
1420;1;10878;4;1;1894;0;943;693;250
1420;1;10883;4;1;2566;8;1829;1373;456
1420;1;10885;4;1;1068;7;525;405;120
1420;1;10888;4;1;1920;1;941;762;179
1420;11;10853;4;11;1291;0;629;525;104
1420;12;10855;4;12;1260;0;681;561;120
1420;13;10840;4;13;12;0;7;5;2
1420;14;10842;4;14;20;0;5;4;1
1420;2;10839;4;2;1393;0;651;502;149
1420;2;10843;4;2;1840;2;769;638;131
1420;2;10844;4;2;2335;6;1492;1127;365
1420;2;10848;4;2;1221;0;754;574;180
1420;2;10849;4;2;2331;2;1245;1033;212
1420;2;10854;4;2;1035;0;654;465;189
1420;2;10858;4;2;423;0;174;138;36
1420;2;10863;4;2;1293;3;701;516;185
1420;2;10864;4;2;1081;6;387;281;106
1420;2;10867;4;2;1047;7;514;397;117
1420;2;10880;4;2;875;0;481;368;113
1420;2;10887;4;2;422;6;328;212;116
1420;3;10834;4;3;565;0;280;179;101
1420;3;10835;4;3;990;1;621;439;182
1420;3;10836;4;3;1366;0;650;438;212
1420;3;10851;4;3;1613;1;686;552;134
1420;3;10866;4;3;848;0;394;318;76
1420;3;10870;4;3;2044;0;1269;979;290
1420;3;10873;4;3;886;1;418;336;82
1420;3;10882;4;3;384;0;269;188;81
1420;3;10884;4;3;710;0;199;150;49
1420;3;10886;4;3;732;2;376;308;68
1420;4;10831;4;4;856;0;311;250;61
1420;4;10841;4;4;1621;8;709;544;165
1420;4;10856;4;4;722;0;386;284;102
1420;4;10859;4;4;1898;1;935;678;257
1420;4;10861;4;4;1214;0;718;615;103
1420;4;10874;4;4;1273;0;607;470;137
1420;4;10879;4;4;1039;0;480;379;101
1420;5;10845;4;5;993;0;314;256;58
1420;5;10847;4;5;343;0;179;157;22
1420;5;10857;4;5;989;0;381;282;99
1420;5;10865;4;5;802;0;404;344;60
1420;5;10871;4;5;1349;0;662;519;143
1420;5;10875;4;5;880;7;444;386;58
1420;6;10860;4;6;737;0;282;225;57
1420;6;10877;4;6;1239;0;668;532;136
1420;6;10889;4;6;401;0;160;160;0
1420;7;10837;4;7;802;0;374;295;79
1420;7;10881;4;7;2173;0;989;786;203
1420;8;10846;4;8;2192;0;1043;897;146
1420;8;10862;4;8;954;0;457;419;38
1420;9;10868;4;9;1198;0;607;474;133
1421;10;10895;7;10;2015;3;1132;1067;65
1421;10;10899;7;10;1240;0;588;534;54
1421;10;10905;7;10;1509;1;641;606;35
1421;10;10950;7;10;609;0;341;270;71
1421;1;10896;7;1;1346;1;826;696;130
1421;1;10908;7;1;2193;0;1082;996;86
1421;1;10919;7;1;2248;2;1091;896;195
1421;1;10932;7;1;908;0;427;368;59
1421;1;10946;7;1;2364;0;1351;1215;136
1421;1;10956;7;1;1236;0;463;397;66
1421;11;10944;7;11;1087;0;349;349;0
1421;11;10957;7;11;2073;4;1126;1009;117
1421;12;10918;7;12;753;0;296;245;51
1421;12;10962;7;12;2360;1;1039;963;76
1421;13;10933;7;13;2128;0;1100;1021;79
1421;14;10911;7;14;1986;0;795;744;51
1421;15;10904;7;15;1642;0;585;517;68
1421;16;10929;7;16;2143;0;742;665;77
1421;17;10892;7;17;1552;0;662;609;53
1421;18;10894;7;18;1686;0;756;689;67
1421;19;10915;7;19;1929;0;914;822;92
1421;20;10953;7;20;1344;0;488;445;43
1421;2;10913;7;2;2048;0;651;569;82
1421;2;10917;7;2;1963;0;951;863;88
1421;2;10924;7;2;2511;3;1473;1214;259
1421;2;10936;7;2;1301;0;730;607;123
1421;2;10939;7;2;1223;0;782;657;125
1421;2;10959;7;2;1796;1;947;804;143
1421;21;10902;7;21;2481;1;1105;1028;77
1421;22;10928;7;22;2019;0;801;714;87
1421;23;10960;7;23;1503;0;684;604;80
1421;24;10890;7;24;1173;0;431;388;43
1421;25;10941;7;25;20;0;6;6;0
1421;26;10914;7;26;73;0;15;13;2
1421;27;10897;7;27;11;0;9;6;3
1421;3;10903;7;3;1188;0;750;679;71
1421;3;10920;7;3;1964;1;1191;962;229
1421;3;10921;7;3;1692;0;856;668;188
1421;3;10940;7;3;1697;0;689;578;111
1421;3;10948;7;3;1990;0;906;825;81
1421;3;10951;7;3;1423;0;916;810;106
1421;4;10900;7;4;2060;0;1095;848;247
1421;4;10907;7;4;1759;0;672;582;90
1421;4;10912;7;4;1219;0;530;472;58
1421;4;10926;7;4;1798;0;1086;948;138
1421;4;10935;7;4;1399;0;618;537;81
1421;4;10938;7;4;2411;0;1062;924;138
1421;5;10891;7;5;1869;0;1007;753;254
1421;5;10893;7;5;2332;0;1250;1043;207
1421;5;10909;7;5;910;0;496;421;75
1421;5;10934;7;5;1976;0;936;833;103
1421;5;10945;7;5;2392;0;982;891;91
1421;5;10949;7;5;1139;0;685;630;55
1421;6;10901;7;6;1548;0;761;677;84
1421;6;10930;7;6;1096;0;625;570;55
1421;6;10931;7;6;545;0;248;231;17
1421;6;10937;7;6;2476;0;1475;1287;188
1421;6;10942;7;6;2210;1;825;749;76
1421;7;10910;7;7;2194;1;1281;1192;89
1421;7;10923;7;7;1390;0;758;637;121
1421;7;10927;7;7;1171;0;582;526;56
1421;7;10952;7;7;1015;0;409;307;102
1421;7;10961;7;7;2405;0;868;797;71
1421;8;10906;7;8;2288;0;881;824;57
1421;8;10916;7;8;835;0;276;221;55
1421;8;10943;7;8;2158;0;947;860;87
1421;8;10947;7;8;1185;0;591;481;110
1421;8;10954;7;8;2280;0;1109;978;131
1421;9;10898;7;9;1340;0;716;582;134
1421;9;10922;7;9;2190;0;829;745;84
1421;9;10925;7;9;2167;0;905;813;92
1421;9;10955;7;9;1687;0;983;916;67
1421;9;10958;7;9;1565;0;823;695;128
1422;10;10964;4;10;514;0;289;221;68
1422;10;10982;4;10;1268;1;588;508;80
1422;1;10985;4;1;1115;0;689;544;145
1422;1;10989;4;1;1746;1;957;718;239
1422;1;10995;4;1;1764;0;973;683;290
1422;1;11004;4;1;1882;0;947;828;119
1422;1;11006;4;1;495;0;295;229;66
1422;1;11010;4;1;442;0;175;151;24
1422;1;11012;4;1;1356;5;992;862;130
1422;11;11014;4;11;147;0;49;35;14
1422;12;11015;4;12;33;0;8;8;0
1422;13;11002;4;13;87;0;37;29;8
1422;2;10970;4;2;531;0;322;231;91
1422;2;10975;4;2;186;0;142;126;16
1422;2;10979;4;2;555;0;328;240;88
1422;2;10984;4;2;870;1;422;360;62
1422;2;10986;4;2;572;1;294;215;79
1422;2;11005;4;2;1060;0;542;408;134
1422;2;11017;4;2;1138;1;522;427;95
1422;3;10972;4;3;871;0;541;450;91
1422;3;10978;4;3;390;0;306;239;67
1422;3;10997;4;3;840;0;543;457;86
1422;3;10998;4;3;868;0;330;254;76
1422;3;11001;4;3;335;0;184;140;44
1422;3;11008;4;3;739;0;373;301;72
1422;3;11013;4;3;1288;0;596;517;79
1422;4;10967;4;4;184;0;143;104;39
1422;4;10981;4;4;987;5;619;471;148
1422;4;10991;4;4;687;0;393;307;86
1422;4;10994;4;4;973;0;486;423;63
1422;4;11007;4;4;204;0;105;77;28
1422;4;11009;4;4;473;0;173;148;25
1422;5;10963;4;5;744;0;313;240;73
1422;5;10968;4;5;492;0;270;230;40
1422;5;10971;4;5;215;0;163;133;30
1422;5;10992;4;5;2319;2;1557;1264;293
1422;5;11016;4;5;2190;1;1097;981;116
1422;6;10969;4;6;623;0;328;278;50
1422;6;10974;4;6;404;1;198;162;36
1422;6;11000;4;6;467;0;275;222;53
1422;6;11003;4;6;393;0;295;261;34
1422;6;11011;4;6;1067;0;429;362;67
1422;7;10973;4;7;599;0;357;267;90
1422;7;10976;4;7;373;0;242;194;48
1422;7;10980;4;7;454;0;238;202;36
1422;7;10987;4;7;219;1;172;147;25
1422;7;10988;4;7;1480;0;669;580;89
1422;8;10965;4;8;462;0;280;195;85
1422;8;10977;4;8;831;1;491;406;85
1422;8;10990;4;8;1545;0;694;606;88
1422;8;10993;4;8;943;1;501;373;128
1422;9;10966;4;9;1046;0;473;413;60
1422;9;10983;4;9;265;0;204;159;45
1422;9;10996;4;9;538;0;305;218;87
1422;9;10999;4;9;496;0;310;230;80
1423;1;11023;5;1;1074;2;803;768;35
1423;1;11024;5;1;1809;12;1293;1024;269
1423;1;11030;5;1;1430;1;938;652;286
1423;1;11037;5;1;1841;13;1396;1199;197
1423;1;11038;5;1;2034;10;1118;1118;0
1423;1;11045;5;1;914;3;715;612;103
1423;1;11051;5;1;1179;0;497;389;108
1423;1;11053;5;1;2179;1;1266;1101;165
1423;2;11018;5;2;2066;0;1208;1020;188
1423;2;11026;5;2;654;3;390;314;76
1423;2;11029;5;2;1641;8;1109;814;295
1423;2;11031;5;2;1354;0;548;432;116
1423;2;11041;5;2;742;0;497;378;119
1423;2;11046;5;2;486;0;284;197;87
1423;2;11048;5;2;917;1;682;612;70
1423;2;11052;5;2;456;0;344;330;14
1423;3;11020;5;3;1031;2;654;472;182
1423;3;11021;5;3;428;0;303;242;61
1423;3;11032;5;3;699;0;470;339;131
1423;3;11034;5;3;332;0;235;179;56
1423;3;11036;5;3;441;1;306;277;29
1423;3;11040;5;3;2365;5;1388;1211;177
1423;3;11044;5;3;312;0;160;143;17
1423;3;11047;5;3;596;12;449;321;128
1423;4;11019;5;4;1375;0;989;829;160
1423;4;11028;5;4;244;0;155;108;47
1423;4;11035;5;4;533;0;381;351;30
1423;4;11039;5;4;517;0;174;123;51
1423;4;11042;5;4;1105;2;711;514;197
1423;4;11043;5;4;423;0;244;189;55
1423;4;11049;5;4;406;7;244;179;65
1423;4;11050;5;4;946;1;672;629;43
1423;5;11033;5;5;1692;4;1050;802;248
1423;6;11022;5;6;729;2;517;428;89
1423;7;11027;5;7;835;0;479;394;85
1423;8;11025;5;8;342;1;210;154;56
1424;10;11057;4;10;1438;0;846;736;110
1424;1;11056;4;1;634;1;429;339;90
1424;1;11067;4;1;785;3;440;347;93
1424;1;11076;4;1;541;0;356;289;67
1424;1;11080;4;1;1740;1;992;706;286
1424;1;11085;4;1;1254;13;918;655;263
1424;1;11092;4;1;1424;0;933;668;265
1424;1;11101;4;1;837;0;357;273;84
1424;11;11054;4;11;852;0;387;343;44
1424;12;11063;4;12;1454;0;813;642;171
1424;13;11070;4;13;1711;1;906;773;133
1424;14;11059;4;14;1095;0;560;475;85
1424;15;11099;4;15;1140;0;524;423;101
1424;16;11087;4;16;1493;0;840;748;92
1424;17;11058;4;17;470;0;220;180;40
1424;18;11065;4;18;28;0;20;16;4
1424;2;11071;4;2;1118;0;646;542;104
1424;2;11073;4;2;608;4;447;341;106
1424;2;11078;4;2;543;0;314;221;93
1424;2;11088;4;2;498;0;323;223;100
1424;2;11090;4;2;1301;0;710;612;98
1424;2;11093;4;2;439;1;317;235;82
1424;2;11095;4;2;765;0;398;315;83
1424;3;11060;4;3;293;0;198;163;35
1424;3;11061;4;3;973;0;438;340;98
1424;3;11064;4;3;560;3;292;210;82
1424;3;11075;4;3;235;0;146;103;43
1424;3;11081;4;3;538;0;385;303;82
1424;3;11084;4;3;927;1;586;462;124
1424;3;11089;4;3;581;0;301;245;56
1424;4;11055;4;4;996;0;619;426;193
1424;4;11074;4;4;773;0;394;322;72
1424;4;11077;4;4;498;0;295;196;99
1424;4;11082;4;4;984;0;437;326;111
1424;4;11083;4;4;1092;6;788;672;116
1424;4;11086;4;4;680;1;498;334;164
1424;4;11094;4;4;940;0;455;331;124
1424;5;11072;4;5;482;0;258;224;34
1424;5;11079;4;5;224;0;111;92;19
1424;5;11096;4;5;628;0;366;259;107
1424;5;11097;4;5;483;0;301;247;54
1424;5;11100;4;5;452;0;298;187;111
1424;6;11069;4;6;2279;0;1229;1041;188
1424;6;11098;4;6;205;0;154;56;98
1424;7;11062;4;7;1517;0;772;611;161
1424;7;11068;4;7;278;0;168;125;43
1424;8;11091;4;8;747;1;397;341;56
1424;9;11066;4;9;1072;0;529;415;114
1425;10;11116;5;10;1586;0;791;670;121
1425;10;11182;5;10;457;0;223;165;58
1425;1;11108;5;1;2090;4;1452;1190;262
1425;11;11188;5;11;786;0;434;351;83
1425;11;11204;5;11;19;0;9;9;0
1425;1;11123;5;1;1597;0;923;771;152
1425;1;11125;5;1;1634;0;710;526;184
1425;1;11139;5;1;2021;0;1043;915;128
1425;1;11142;5;1;437;0;232;175;57
1425;1;11154;5;1;1828;1;994;773;221
1425;1;11166;5;1;1827;0;983;791;192
1425;1;11167;5;1;1893;0;1221;977;244
1425;1;11185;5;1;1445;1;1017;821;196
1425;1;11193;5;1;2083;0;1038;1038;0
1425;1;11201;5;1;1498;2;859;679;180
1425;1;11203;5;1;1040;0;540;421;119
1425;1;11208;5;1;1937;8;1188;984;204
1425;12;11135;5;12;423;0;219;170;49
1425;12;11189;5;12;19;0;0;0;0
1425;13;11156;5;13;316;0;172;129;43
1425;14;11172;5;14;366;0;205;170;35
1425;15;11146;5;15;1272;0;675;536;139
1425;16;11143;5;16;111;0;47;20;27
1425;17;11176;5;17;33;0;10;2;8
1425;2;11106;5;2;1739;1;1055;902;153
1425;2;11111;5;2;1252;0;636;493;143
1425;2;11113;5;2;1156;0;731;511;220
1425;2;11119;5;2;1896;0;975;782;193
1425;2;11122;5;2;1467;1;910;775;135
1425;2;11127;5;2;909;0;510;418;92
1425;2;11130;5;2;682;0;354;354;0
1425;2;11132;5;2;907;0;554;458;96
1425;2;11148;5;2;616;0;385;297;88
1425;2;11164;5;2;843;0;482;355;127
1425;2;11169;5;2;421;0;267;207;60
1425;2;11170;5;2;1286;3;824;634;190
1425;2;11173;5;2;1861;1;948;817;131
1425;3;11104;5;3;599;3;423;339;84
1425;3;11109;5;3;978;0;697;547;150
1425;3;11110;5;3;1172;0;501;356;145
1425;3;11128;5;3;1356;0;808;631;177
1425;3;11136;5;3;947;0;485;369;116
1425;3;11138;5;3;1544;3;952;758;194
1425;3;11140;5;3;451;0;178;125;53
1425;3;11145;5;3;1635;3;980;831;149
1425;3;11147;5;3;1667;0;1001;744;257
1425;3;11159;5;3;642;1;435;326;109
1425;3;11160;5;3;1017;0;553;479;74
1425;3;11175;5;3;823;0;374;294;80
1425;3;11192;5;3;1687;0;938;772;166
1425;4;11121;5;4;762;0;463;331;132
1425;4;11126;5;4;1256;0;690;525;165
1425;4;11137;5;4;1252;0;726;549;177
1425;4;11149;5;4;432;0;298;227;71
1425;4;11150;5;4;1228;0;870;605;265
1425;4;11162;5;4;997;0;488;393;95
1425;4;11163;5;4;1443;0;811;603;208
1425;4;11180;5;4;918;0;333;240;93
1425;4;11187;5;4;868;0;364;280;84
1425;4;11194;5;4;1921;1;951;782;169
1425;4;11197;5;4;555;0;301;251;50
1425;4;11202;5;4;1047;1;594;486;108
1425;4;11207;5;4;1176;0;492;433;59
1425;5;11103;5;5;941;3;654;514;140
1425;5;11105;5;5;427;1;277;214;63
1425;5;11107;5;5;1670;0;849;724;125
1425;5;11112;5;5;653;0;290;225;65
1425;5;11118;5;5;599;0;305;242;63
1425;5;11134;5;5;1728;0;799;646;153
1425;5;11141;5;5;1269;0;828;679;149
1425;5;11152;5;5;2264;1;1150;888;262
1425;5;11153;5;5;649;0;404;326;78
1425;5;11165;5;5;548;0;331;226;105
1425;5;11190;5;5;522;0;267;188;79
1425;5;11191;5;5;1641;2;834;690;144
1425;5;11198;5;5;1036;0;519;427;92
1425;6;11114;5;6;446;0;222;172;50
1425;6;11120;5;6;389;0;256;211;45
1425;6;11129;5;6;907;0;456;364;92
1425;6;11133;5;6;1102;0;636;505;131
1425;6;11171;5;6;1537;0;963;779;184
1425;6;11177;5;6;2127;0;972;805;167
1425;6;11178;5;6;1359;5;802;665;137
1425;6;11179;5;6;684;0;317;251;66
1425;6;11181;5;6;828;0;424;330;94
1425;6;11195;5;6;540;0;296;256;40
1425;6;11199;5;6;336;0;174;130;44
1425;6;11200;5;6;1234;0;686;555;131
1425;7;11102;5;7;1977;1;1074;875;199
1425;7;11115;5;7;756;0;426;355;71
1425;7;11124;5;7;623;2;347;255;92
1425;7;11144;5;7;716;0;325;234;91
1425;7;11151;5;7;705;0;358;298;60
1425;7;11155;5;7;1092;0;481;408;73
1425;7;11157;5;7;652;0;374;307;67
1425;7;11168;5;7;2079;0;873;675;198
1425;7;11174;5;7;1479;0;759;601;158
1425;7;11183;5;7;1193;0;551;428;123
1425;8;11117;5;8;1829;0;851;734;117
1425;8;11131;5;8;710;0;314;242;72
1425;8;11158;5;8;1458;0;759;558;201
1425;8;11184;5;8;1018;2;665;525;140
1425;8;11206;5;8;1505;1;810;697;113
1425;9;11161;5;9;559;4;354;222;132
1425;9;11186;5;9;798;1;393;323;70
1425;9;11196;5;9;1517;0;716;629;87
1425;9;11205;5;9;839;0;363;293;70
1426;1;11209;6;1;1515;0;898;648;250
1426;1;11213;6;1;1569;0;1052;798;254
1426;1;11218;6;1;633;0;292;220;72
1426;1;11227;6;1;555;0;252;212;40
1426;1;11229;6;1;1943;0;1154;901;253
1426;1;11243;6;1;1050;0;496;413;83
1426;1;11250;6;1;500;0;244;168;76
1426;1;11251;6;1;1965;6;1163;780;383
1426;1;11258;6;1;1363;1;915;703;212
1426;1;11262;6;1;1286;2;562;435;127
1426;1;11264;6;1;1231;15;837;654;183
1426;1;11273;6;1;1821;0;1115;823;292
1426;1;11274;6;1;2187;1;1275;951;324
1426;2;11214;6;2;599;0;300;247;53
1426;2;11228;6;2;812;2;563;462;101
1426;2;11230;6;2;179;0;115;99;16
1426;2;11232;6;2;1417;2;725;579;146
1426;2;11236;6;2;1932;0;685;685;0
1426;2;11238;6;2;1233;1;666;515;151
1426;2;11240;6;2;972;0;665;528;137
1426;2;11242;6;2;750;0;461;345;116
1426;2;11249;6;2;950;1;554;461;93
1426;2;11253;6;2;1551;0;770;629;141
1426;2;11259;6;2;287;0;134;98;36
1426;2;11263;6;2;685;0;375;282;93
1426;2;11265;6;2;404;0;209;141;68
1426;3;11210;6;3;1904;0;760;649;111
1426;3;11225;6;3;604;0;354;222;132
1426;3;11234;6;3;570;0;194;165;29
1426;3;11239;6;3;830;0;489;397;92
1426;3;11241;6;3;488;0;276;241;35
1426;3;11252;6;3;539;0;270;196;74
1426;3;11256;6;3;620;0;368;314;54
1426;3;11260;6;3;460;0;211;153;58
1426;3;11261;6;3;912;0;474;411;63
1426;3;11270;6;3;641;0;427;328;99
1426;3;11271;6;3;1118;0;559;421;138
1426;4;11211;6;4;1449;2;887;659;228
1426;4;11217;6;4;1109;0;713;543;170
1426;4;11226;6;4;425;1;239;167;72
1426;4;11231;6;4;1013;0;631;522;109
1426;4;11233;6;4;1021;0;502;398;104
1426;4;11245;6;4;1104;0;706;561;145
1426;4;11247;6;4;2026;0;896;735;161
1426;4;11255;6;4;566;2;263;211;52
1426;4;11267;6;4;762;0;421;318;103
1426;4;11272;6;4;760;0;416;313;103
1426;5;11215;6;5;580;0;337;260;77
1426;5;11220;6;5;340;0;205;151;54
1426;5;11222;6;5;827;1;493;403;90
1426;5;11237;6;5;340;0;164;124;40
1426;5;11244;6;5;599;0;369;312;57
1426;5;11248;6;5;374;0;243;180;63
1426;5;11275;6;5;1916;0;833;722;111
1426;6;11216;6;6;820;0;436;360;76
1426;6;11219;6;6;435;0;294;227;67
1426;6;11221;6;6;854;0;467;367;100
1426;6;11235;6;6;731;1;429;383;46
1426;6;11266;6;6;1049;0;679;558;121
1426;6;11276;6;6;1991;0;901;788;113
1426;7;11223;6;7;1388;0;543;449;94
1426;7;11254;6;7;338;0;255;210;45
1426;7;11257;6;7;495;0;272;200;72
1426;7;11268;6;7;588;0;382;325;57
1426;8;11212;6;8;714;0;385;346;39
1426;8;11246;6;8;405;2;233;175;58
1426;8;11269;6;8;568;0;298;236;62
1426;9;11224;6;9;526;0;327;262;65
1427;10;11300;4;10;1051;0;505;394;111
1427;11;11297;4;11;1466;1;761;604;157
1427;1;11278;4;1;2130;6;1485;1078;407
1427;1;11287;4;1;2232;21;1436;1249;187
1427;1;11295;4;1;2306;6;1409;1031;378
1427;1;11299;4;1;1360;0;703;513;190
1427;1;11303;4;1;1526;10;1043;795;248
1427;1;11309;4;1;1391;14;863;682;181
1427;1;11311;4;1;1123;1;652;472;180
1427;12;11294;4;12;972;0;535;441;94
1427;13;11305;4;13;25;0;10;10;0
1427;2;11279;4;2;1533;9;1108;856;252
1427;2;11283;4;2;1244;3;821;636;185
1427;2;11285;4;2;1263;1;680;539;141
1427;2;11292;4;2;1258;4;780;582;198
1427;2;11293;4;2;1547;9;919;747;172
1427;2;11306;4;2;1384;7;884;757;127
1427;2;11308;4;2;1236;7;807;632;175
1427;3;11280;4;3;1153;0;647;468;179
1427;3;11290;4;3;1805;1;881;756;125
1427;3;11291;4;3;1923;19;1391;883;508
1427;3;11296;4;3;899;1;514;385;129
1427;3;11304;4;3;744;0;462;338;124
1427;3;11307;4;3;851;4;637;559;78
1427;4;11282;4;4;56;0;51;48;3
1427;4;11284;4;4;1057;3;711;599;112
1427;4;11289;4;4;624;0;388;253;135
1427;4;11298;4;4;1095;0;549;442;107
1427;5;11277;4;5;741;3;469;344;125
1427;5;11288;4;5;1193;0;640;531;109
1427;6;11286;4;6;563;4;395;260;135
1427;6;11310;4;6;1365;1;712;547;165
1427;7;11281;4;7;1561;0;789;649;140
1427;8;11301;4;8;1359;0;703;584;119
1427;9;11302;4;9;922;0;498;418;80
1428;10;11315;4;10;1403;0;680;583;97
1428;11;11342;4;11;1921;2;831;740;91
1428;1;11320;4;1;887;0;466;381;85
1428;1;11326;4;1;1363;0;670;560;110
1428;1;11329;4;1;2119;4;1021;796;225
1428;1;11339;4;1;865;0;524;395;129
1428;1;11355;4;1;429;0;201;166;35
1428;1;11360;4;1;1439;0;604;527;77
1428;1;11363;4;1;1679;2;809;653;156
1428;1;11364;4;1;1138;0;584;483;101
1428;12;11348;4;12;1767;0;878;792;86
1428;13;11340;4;13;2093;1;1045;944;101
1428;14;11327;4;14;1912;2;842;745;97
1428;15;11331;4;15;1062;0;484;428;56
1428;16;11314;4;16;1832;0;789;668;121
1428;17;11341;4;17;1601;0;750;633;117
1428;18;11353;4;18;1448;0;637;500;137
1428;19;11312;4;19;2302;2;965;754;211
1428;20;11354;4;20;19;0;15;14;1
1428;21;11313;4;21;7;0;7;6;1
1428;2;11318;4;2;950;1;453;340;113
1428;2;11323;4;2;2406;0;1335;1083;252
1428;2;11332;4;2;1117;3;439;360;79
1428;2;11337;4;2;1448;0;827;654;173
1428;2;11338;4;2;1892;0;1030;779;251
1428;2;11343;4;2;1016;0;417;374;43
1428;2;11344;4;2;1301;0;568;463;105
1428;2;11352;4;2;801;0;400;345;55
1428;22;11346;4;22;40;0;36;35;1
1428;3;11325;4;3;816;4;436;319;117
1428;3;11333;4;3;579;0;221;163;58
1428;3;11335;4;3;1201;0;604;524;80
1428;3;11336;4;3;1310;2;675;558;117
1428;3;11345;4;3;418;0;200;154;46
1428;3;11356;4;3;960;0;512;411;101
1428;3;11357;4;3;2281;0;1189;1095;94
1428;3;11362;4;3;1051;0;665;555;110
1428;4;11316;4;4;1191;0;743;590;153
1428;4;11317;4;4;1761;0;741;529;212
1428;4;11349;4;4;569;0;250;223;27
1428;4;11350;4;4;1606;0;644;524;120
1428;4;11351;4;4;831;2;343;278;65
1428;4;11365;4;4;563;1;212;177;35
1428;5;11328;4;5;1026;1;472;426;46
1428;5;11330;4;5;1082;0;524;456;68
1428;5;11358;4;5;1428;0;709;515;194
1428;6;11334;4;6;786;1;355;219;136
1428;6;11347;4;6;773;0;321;283;38
1428;6;11359;4;6;1026;0;448;345;103
1428;7;11319;4;7;528;1;282;222;60
1428;7;11324;4;7;2149;0;1068;929;139
1428;8;11322;4;8;1316;0;623;548;75
1428;8;11361;4;8;1870;1;917;822;95
1428;9;11321;4;9;2166;3;1025;922;103
1429;1;11373;6;1;1091;3;644;498;146
1429;1;11383;6;1;1146;1;712;545;167
1429;1;11386;6;1;449;0;292;251;41
1429;1;11390;6;1;1241;3;674;571;103
1429;1;11395;6;1;486;0;297;259;38
1429;1;11399;6;1;1880;1;860;768;92
1429;1;11404;6;1;1001;1;576;480;96
1429;1;11414;6;1;1909;2;1001;817;184
1429;1;11419;6;1;1122;0;527;396;131
1429;2;11367;6;2;2253;2;1327;1192;135
1429;2;11368;6;2;315;1;175;144;31
1429;2;11372;6;2;1507;4;905;701;204
1429;2;11374;6;2;542;0;247;209;38
1429;2;11380;6;2;418;0;249;192;57
1429;2;11398;6;2;1036;0;618;572;46
1429;2;11401;6;2;478;0;353;254;99
1429;2;11412;6;2;546;0;337;225;112
1429;2;11415;6;2;513;0;294;232;62
1429;3;11375;6;3;770;0;446;411;35
1429;3;11378;6;3;751;0;378;287;91
1429;3;11391;6;3;2109;0;1146;988;158
1429;3;11394;6;3;540;0;291;256;35
1429;3;11403;6;3;592;0;318;287;31
1429;3;11406;6;3;857;8;465;347;118
1429;3;11408;6;3;410;0;268;223;45
1429;3;11410;6;3;407;0;194;139;55
1429;3;11420;6;3;1304;1;706;554;152
1429;4;11382;6;4;1093;0;502;404;98
1429;4;11387;6;4;333;1;177;150;27
1429;4;11396;6;4;765;5;498;391;107
1429;4;11407;6;4;380;0;244;211;33
1429;4;11409;6;4;1932;1;1004;897;107
1429;4;11413;6;4;720;0;399;354;45
1429;4;11416;6;4;251;0;145;117;28
1429;4;11418;6;4;770;2;502;394;108
1429;5;11370;6;5;420;0;276;214;62
1429;5;11371;6;5;546;0;402;318;84
1429;5;11377;6;5;350;0;229;174;55
1429;5;11384;6;5;427;0;243;194;49
1429;5;11397;6;5;637;0;383;272;111
1429;5;11400;6;5;477;0;305;263;42
1429;5;11405;6;5;1961;1;1100;969;131
1429;6;11376;6;6;1453;25;977;797;180
1429;6;11379;6;6;184;0;99;89;10
1429;6;11381;6;6;288;0;191;155;36
1429;6;11385;6;6;184;0;89;84;5
1429;6;11388;6;6;371;0;212;170;42
1429;6;11389;6;6;1932;0;968;817;151
1429;6;11392;6;6;432;0;265;192;73
1429;7;11366;6;7;1287;1;782;645;137
1429;7;11393;6;7;1439;1;784;685;99
1429;7;11402;6;7;373;0;194;150;44
1429;7;11417;6;7;396;0;223;172;51
1429;8;11369;6;8;1805;0;925;804;121
1429;9;11411;6;9;30;0;12;10;2
1430;10;11447;5;10;1033;0;605;485;120
1430;11;11448;5;11;1453;0;874;684;190
1430;1;11422;5;1;1207;0;923;567;356
1430;1;11424;5;1;2259;10;1603;1194;409
1430;1;11435;5;1;2103;4;1363;1056;307
1430;1;11439;5;1;1956;2;1151;990;161
1430;1;11440;5;1;1418;15;922;689;233
1430;2;11421;5;2;1742;0;1042;855;187
1430;2;11425;5;2;785;0;478;364;114
1430;2;11429;5;2;538;13;397;281;116
1430;2;11443;5;2;956;1;616;470;146
1430;2;11444;5;2;563;1;439;286;153
1430;3;11427;5;3;1199;1;831;538;293
1430;3;11432;5;3;1753;1;1123;986;137
1430;3;11436;5;3;711;10;435;327;108
1430;3;11438;5;3;377;1;259;205;54
1430;3;11445;5;3;883;2;542;421;121
1430;4;11426;5;4;1881;1;1089;941;148
1430;4;11428;5;4;689;4;520;383;137
1430;4;11441;5;4;434;0;292;230;62
1430;5;11431;5;5;373;0;258;208;50
1430;5;11442;5;5;1797;1;939;799;140
1430;5;11449;5;5;686;5;471;367;104
1430;6;11430;5;6;1894;1;1096;899;197
1430;6;11434;5;6;544;11;372;231;141
1430;6;11450;5;6;494;0;331;227;104
1430;7;11423;5;7;757;0;494;435;59
1430;7;11446;5;7;718;22;548;390;158
1430;8;11433;5;8;756;0;519;398;121
1430;9;11437;5;9;776;2;520;427;93
1432;10;11471;7;10;1382;0;785;695;90
1432;10;11481;7;10;999;0;428;319;109
1432;10;11485;7;10;876;0;398;324;74
1432;11;11458;7;11;1820;1;773;773;0
1432;11;11465;7;11;1686;0;957;795;162
1432;11;11482;7;11;1355;0;725;595;130
1432;1;11454;7;1;1976;0;1100;956;144
1432;1;11470;7;1;1156;1;643;507;136
1432;1;11476;7;1;1550;0;748;671;77
1432;1;11479;7;1;1473;1;775;665;110
1432;1;11484;7;1;1900;1;1206;727;479
1432;1;11500;7;1;1610;0;888;691;197
1432;1;11505;7;1;1607;0;812;651;161
1432;12;11497;7;12;2129;0;842;646;196
1432;13;11467;7;13;936;0;464;404;60
1432;14;11490;7;14;875;0;357;270;87
1432;15;11455;7;15;26;0;26;23;3
1432;2;11451;7;2;1708;0;939;796;143
1432;2;11453;7;2;1568;0;796;721;75
1432;2;11459;7;2;2093;1;1303;1138;165
1432;2;11460;7;2;1376;0;728;553;175
1432;2;11466;7;2;1046;0;507;451;56
1432;2;11478;7;2;1355;2;875;506;369
1432;2;11499;7;2;2397;1;1355;1240;115
1432;3;11461;7;3;1147;0;644;598;46
1432;3;11475;7;3;1366;0;746;615;131
1432;3;11483;7;3;1122;0;663;582;81
1432;3;11486;7;3;2155;0;973;890;83
1432;3;11493;7;3;436;0;279;205;74
1432;3;11496;7;3;2069;1;1403;1209;194
1432;4;11463;7;4;1141;0;573;467;106
1432;4;11464;7;4;1560;2;765;560;205
1432;4;11468;7;4;2092;1;1219;1076;143
1432;4;11491;7;4;1635;3;796;654;142
1432;4;11492;7;4;1612;0;941;803;138
1432;4;11494;7;4;1634;2;956;740;216
1432;5;11456;7;5;1676;0;854;737;117
1432;5;11462;7;5;2341;0;1116;827;289
1432;5;11487;7;5;2027;0;1211;991;220
1432;5;11488;7;5;1292;0;809;722;87
1432;5;11495;7;5;2099;0;1022;846;176
1432;6;11474;7;6;1614;0;915;820;95
1432;6;11480;7;6;1143;0;549;461;88
1432;6;11489;7;6;1082;0;495;407;88
1432;6;11503;7;6;1761;0;1086;902;184
1432;7;11469;7;7;1278;0;645;539;106
1432;7;11473;7;7;1255;0;731;590;141
1432;7;11502;7;7;1417;0;567;452;115
1432;7;11506;7;7;570;0;284;240;44
1432;8;11472;7;8;1472;0;586;441;145
1432;8;11477;7;8;2252;0;1360;1203;157
1432;8;11501;7;8;1162;0;593;490;103
1432;8;11504;7;8;760;0;366;303;63
1432;9;11452;7;9;1218;0;480;391;89
1432;9;11457;7;9;1081;0;399;328;71
1432;9;11498;7;9;1229;0;719;621;98
1433;10;11543;6;10;636;0;260;197;63
1433;1;11508;6;1;1809;1;1044;751;293
1433;1;11517;6;1;1539;0;705;545;160
1433;1;11521;6;1;1358;5;778;616;162
1433;1;11524;6;1;2126;0;914;786;128
1433;1;11527;6;1;820;0;403;323;80
1433;1;11528;6;1;1584;0;1038;814;224
1433;1;11534;6;1;1203;0;561;461;100
1433;1;11536;6;1;668;3;424;302;122
1433;1;11553;6;1;2160;0;1202;1014;188
1433;2;11514;6;2;608;0;250;209;41
1433;2;11519;6;2;1134;7;663;554;109
1433;2;11522;6;2;291;0;155;104;51
1433;2;11531;6;2;583;0;344;260;84
1433;2;11541;6;2;1768;0;842;696;146
1433;2;11544;6;2;816;0;449;374;75
1433;2;11546;6;2;803;0;413;359;54
1433;2;11549;6;2;459;0;206;156;50
1433;2;11555;6;2;721;0;384;255;129
1433;3;11526;6;3;297;1;117;86;31
1433;3;11533;6;3;357;0;212;144;68
1433;3;11535;6;3;1321;0;549;442;107
1433;3;11537;6;3;1808;0;775;698;77
1433;3;11540;6;3;815;0;456;333;123
1433;3;11547;6;3;2095;0;1000;854;146
1433;3;11548;6;3;558;0;244;184;60
1433;3;11557;6;3;1225;0;548;380;168
1433;3;11558;6;3;684;0;314;231;83
1433;4;11510;6;4;636;0;370;280;90
1433;4;11515;6;4;1512;0;754;627;127
1433;4;11518;6;4;1336;0;724;540;184
1433;4;11523;6;4;2090;4;1087;943;144
1433;4;11525;6;4;328;0;196;139;57
1433;4;11542;6;4;736;2;412;336;76
1433;4;11552;6;4;1310;0;611;460;151
1433;4;11556;6;4;2276;0;1100;954;146
1433;5;11507;6;5;2352;0;1143;1015;128
1433;5;11509;6;5;622;0;407;294;113
1433;5;11520;6;5;775;0;393;289;104
1433;5;11532;6;5;486;0;237;156;81
1433;5;11538;6;5;411;0;254;199;55
1433;5;11539;6;5;923;0;414;336;78
1433;5;11551;6;5;867;0;385;328;57
1433;5;11554;6;5;338;0;170;123;47
1433;6;11511;6;6;2269;2;1178;1077;101
1433;6;11516;6;6;484;0;212;161;51
1433;6;11529;6;6;14;0;4;3;1
1433;6;11545;6;6;469;0;206;160;46
1433;6;11550;6;6;312;2;232;172;60
1433;7;11513;6;7;1012;1;485;358;127
1433;8;11530;6;8;2288;0;1164;1044;120
1433;9;11512;6;9;995;0;434;356;78
1434;10;11571;7;10;1024;0;448;389;59
1434;10;11578;7;10;816;0;521;357;164
1434;10;11579;7;10;970;0;386;323;63
1434;10;11615;7;10;1387;2;609;525;84
1434;10;11639;7;10;2054;0;832;736;96
1434;10;11676;7;10;1240;0;621;543;78
1434;11;11608;7;11;115;0;39;32;7
1434;11;11622;7;11;1154;1;513;473;40
1434;11;11664;7;11;1798;2;841;752;89
1434;11;11665;7;11;2071;0;791;736;55
1434;11;11670;7;11;1187;0;590;449;141
1434;1;11574;7;1;1472;0;540;496;44
1434;1;11597;7;1;830;2;454;311;143
1434;1;11614;7;1;1700;1;883;783;100
1434;1;11626;7;1;2327;0;1545;1165;380
1434;1;11629;7;1;1143;0;578;455;123
1434;1;11640;7;1;873;0;512;337;175
1434;1;11647;7;1;1601;0;904;742;162
1434;1;11656;7;1;1719;1;954;815;139
1434;1;11671;7;1;402;10;247;154;93
1434;1;11675;7;1;2225;0;1078;941;137
1434;1;11680;7;1;1779;0;849;707;142
1434;1;11681;7;1;946;0;474;415;59
1434;12;11563;7;12;1923;1;872;785;87
1434;12;11641;7;12;1690;1;841;744;97
1434;12;11654;7;12;1254;0;773;528;245
1434;13;11636;7;13;1824;0;844;783;61
1434;14;11674;7;14;2457;0;1110;983;127
1434;15;11649;7;15;1897;0;761;680;81
1434;16;11612;7;16;1090;0;343;306;37
1434;17;11586;7;17;1357;0;576;504;72
1434;18;11596;7;18;1509;0;610;552;58
1434;19;11610;7;19;1312;0;616;544;72
1434;20;11646;7;20;1136;2;495;457;38
1434;21;11659;7;21;1898;0;865;786;79
1434;2;11559;7;2;1169;5;579;528;51
1434;2;11568;7;2;1716;2;821;686;135
1434;2;11570;7;2;734;0;419;294;125
1434;2;11575;7;2;792;0;383;279;104
1434;2;11588;7;2;2318;1;1416;1097;319
1434;2;11590;7;2;983;0;418;341;77
1434;2;11617;7;2;1944;0;826;705;121
1434;2;11631;7;2;1691;0;964;721;243
1434;2;11632;7;2;1886;0;1256;933;323
1434;2;11633;7;2;863;0;502;467;35
1434;2;11653;7;2;335;10;220;128;92
1434;2;11678;7;2;2238;0;1237;1089;148
1434;22;11637;7;22;1907;0;964;883;81
1434;23;11635;7;23;1147;0;626;560;66
1434;24;11611;7;24;1927;0;907;803;104
1434;25;11655;7;25;2019;0;927;827;100
1434;26;11658;7;26;1183;0;532;484;48
1434;27;11594;7;27;1715;0;917;744;173
1434;28;11657;7;28;1531;0;756;689;67
1434;29;11606;7;29;9;0;5;5;0
1434;3;11564;7;3;1243;0;690;612;78
1434;3;11565;7;3;1276;0;659;576;83
1434;3;11566;7;3;1277;0;707;630;77
1434;3;11573;7;3;1637;2;902;709;193
1434;3;11595;7;3;2135;0;1115;825;290
1434;3;11604;7;3;1916;3;1084;1014;70
1434;3;11616;7;3;2084;2;876;704;172
1434;3;11621;7;3;1004;0;562;457;105
1434;3;11628;7;3;882;1;551;373;178
1434;3;11643;7;3;831;0;409;299;110
1434;3;11652;7;3;344;5;263;178;85
1434;3;11684;7;3;1697;0;782;669;113
1434;4;11562;7;4;700;0;405;283;122
1434;4;11569;7;4;444;0;237;182;55
1434;4;11576;7;4;539;6;375;283;92
1434;4;11581;7;4;932;0;467;429;38
1434;4;11585;7;4;1916;0;900;787;113
1434;4;11587;7;4;2214;2;1202;1017;185
1434;4;11613;7;4;1645;0;823;744;79
1434;4;11620;7;4;2347;0;896;770;126
1434;4;11642;7;4;1406;0;633;478;155
1434;4;11673;7;4;989;3;587;412;175
1434;4;11679;7;4;692;0;382;301;81
1434;4;11682;7;4;1653;0;942;839;103
1434;5;11561;7;5;1664;0;944;800;144
1434;5;11567;7;5;1344;0;653;413;240
1434;5;11577;7;5;1453;0;594;521;73
1434;5;11584;7;5;1366;0;576;489;87
1434;5;11591;7;5;919;5;549;323;226
1434;5;11600;7;5;330;0;202;143;59
1434;5;11603;7;5;1674;1;855;738;117
1434;5;11619;7;5;784;0;374;274;100
1434;5;11624;7;5;458;0;287;189;98
1434;5;11625;7;5;924;0;497;430;67
1434;5;11644;7;5;1733;0;836;759;77
1434;5;11666;7;5;452;19;332;214;118
1434;6;11572;7;6;2385;2;1236;1022;214
1434;6;11582;7;6;277;0;149;99;50
1434;6;11589;7;6;1161;6;703;512;191
1434;6;11592;7;6;2096;0;918;829;89
1434;6;11598;7;6;530;0;278;195;83
1434;6;11599;7;6;1063;0;598;460;138
1434;6;11607;7;6;408;2;293;200;93
1434;6;11648;7;6;1513;1;786;651;135
1434;6;11650;7;6;890;0;536;442;94
1434;6;11663;7;6;1753;0;870;721;149
1434;6;11669;7;6;1157;0;519;462;57
1434;7;11580;7;7;1100;0;555;484;71
1434;7;11593;7;7;2240;0;1057;901;156
1434;7;11605;7;7;2009;0;915;785;130
1434;7;11623;7;7;450;2;257;203;54
1434;7;11630;7;7;1730;1;695;612;83
1434;7;11661;7;7;1291;0;612;471;141
1434;7;11662;7;7;15;0;6;5;1
1434;7;11668;7;7;1614;0;757;675;82
1434;7;11683;7;7;811;0;388;300;88
1434;8;11560;7;8;1305;0;663;558;105
1434;8;11583;7;8;1541;0;576;508;68
1434;8;11601;7;8;1609;0;918;740;178
1434;8;11602;7;8;2322;0;1197;1033;164
1434;8;11618;7;8;812;0;353;276;77
1434;8;11645;7;8;1017;0;534;450;84
1434;8;11667;7;8;832;0;405;378;27
1434;8;11677;7;8;45;0;37;35;2
1434;9;11609;7;9;1836;0;825;780;45
1434;9;11627;7;9;1691;0;591;536;55
1434;9;11634;7;9;483;0;266;219;47
1434;9;11638;7;9;776;1;368;339;29
1434;9;11651;7;9;2242;0;1033;851;182
1434;9;11660;7;9;958;0;534;352;182
1434;9;11672;7;9;60;0;29;24;5
1435;10;11742;6;10;2105;1;985;894;91
1435;11;11695;6;11;2112;1;844;749;95
1435;1;11704;6;1;1215;0;610;552;58
1435;1;11708;6;1;1147;0;675;565;110
1435;1;11712;6;1;1470;2;947;746;201
1435;1;11730;6;1;1767;0;910;676;234
1435;1;11733;6;1;1348;11;936;630;306
1435;1;11741;6;1;1247;0;780;570;210
1435;12;11689;6;12;2031;0;1030;938;92
1435;13;11699;6;13;1288;0;596;524;72
1435;14;11719;6;14;2008;1;1044;877;167
1435;15;11696;6;15;1861;0;853;773;80
1435;16;11707;6;16;825;0;449;380;69
1435;17;11716;6;17;990;0;431;333;98
1435;18;11711;6;18;1136;0;493;409;84
1435;19;11703;6;19;543;0;313;220;93
1435;20;11727;6;20;963;0;522;470;52
1435;21;11685;6;21;1764;0;921;841;80
1435;2;11702;6;2;616;0;305;254;51
1435;2;11709;6;2;274;0;152;124;28
1435;2;11715;6;2;616;0;302;229;73
1435;2;11722;6;2;797;0;446;293;153
1435;2;11724;6;2;810;0;480;323;157
1435;2;11740;6;2;644;3;455;356;99
1435;22;11732;6;22;30;0;7;5;2
1435;3;11688;6;3;525;0;307;213;94
1435;3;11691;6;3;845;1;483;411;72
1435;3;11698;6;3;493;5;330;249;81
1435;3;11705;6;3;921;0;480;360;120
1435;3;11713;6;3;923;0;500;368;132
1435;3;11720;6;3;1741;0;686;562;124
1435;4;11686;6;4;597;0;286;215;71
1435;4;11693;6;4;708;0;388;311;77
1435;4;11714;6;4;583;0;351;238;113
1435;4;11725;6;4;540;1;342;266;76
1435;4;11726;6;4;647;0;401;358;43
1435;4;11731;6;4;270;0;129;97;32
1435;5;11687;6;5;1209;0;597;439;158
1435;5;11701;6;5;1365;0;596;522;74
1435;5;11729;6;5;488;2;286;232;54
1435;5;11736;6;5;440;0;186;142;44
1435;5;11737;6;5;608;1;414;296;118
1435;5;11738;6;5;264;0;136;111;25
1435;6;11692;6;6;946;2;609;486;123
1435;6;11697;6;6;627;1;434;338;96
1435;6;11710;6;6;837;0;386;275;111
1435;6;11721;6;6;1077;0;620;456;164
1435;6;11728;6;6;2187;0;1129;1019;110
1435;6;11734;6;6;1379;0;747;615;132
1435;7;11690;6;7;396;0;269;204;65
1435;7;11718;6;7;1476;0;677;619;58
1435;7;11723;6;7;703;0;401;303;98
1435;7;11739;6;7;152;0;88;69;19
1435;8;11706;6;8;389;0;236;143;93
1435;8;11717;6;8;389;0;272;183;89
1435;8;11735;6;8;1263;0;868;753;115
1435;8;11743;6;8;356;0;218;162;56
1435;9;11694;6;9;2185;0;1024;891;133
1435;9;11700;6;9;318;0;218;158;60
1436;10;11753;5;10;579;0;317;246;71
1436;11;11747;5;11;397;0;235;197;38
1436;1;11745;5;1;1903;9;999;744;255
1436;1;11750;5;1;1314;4;1012;859;153
1436;1;11752;5;1;1571;0;953;755;198
1436;1;11758;5;1;1726;1;976;836;140
1436;1;11779;5;1;518;2;282;223;59
1436;12;11780;5;12;520;0;241;198;43
1436;13;11759;5;13;352;0;189;154;35
1436;14;11755;5;14;12;0;9;8;1
1436;2;11756;5;2;803;1;448;448;0
1436;2;11763;5;2;732;0;453;331;122
1436;2;11769;5;2;1213;0;594;479;115
1436;2;11770;5;2;2312;2;1335;1122;213
1436;2;11777;5;2;1301;1;720;539;181
1436;3;11751;5;3;2073;0;1085;904;181
1436;3;11754;5;3;553;0;273;213;60
1436;3;11766;5;3;446;0;251;191;60
1436;3;11768;5;3;572;1;430;305;125
1436;3;11775;5;3;638;0;322;212;110
1436;4;11744;5;4;1012;1;562;441;121
1436;4;11749;5;4;558;0;260;213;47
1436;4;11772;5;4;1781;0;1007;847;160
1436;4;11776;5;4;523;0;251;174;77
1436;4;11781;5;4;372;1;244;202;42
1436;5;11746;5;5;441;0;243;188;55
1436;5;11748;5;5;493;0;293;225;68
1436;5;11762;5;5;259;0;140;98;42
1436;5;11764;5;5;437;2;262;204;58
1436;5;11771;5;5;621;3;389;283;106
1436;6;11757;5;6;720;0;438;352;86
1436;6;11761;5;6;271;2;226;179;47
1436;6;11765;5;6;606;0;381;310;71
1436;7;11760;5;7;298;0;132;110;22
1436;7;11767;5;7;486;0;302;225;77
1436;8;11773;5;8;286;0;123;88;35
1436;8;11778;5;8;590;1;345;295;50
1436;9;11774;5;9;827;0;490;376;114
1437;10;11790;4;10;24;0;8;6;2
1437;1;11783;4;1;1591;0;817;606;211
1437;1;11792;4;1;840;4;500;351;149
1437;1;11800;4;1;1990;2;1075;854;221
1437;1;11801;4;1;1578;3;912;726;186
1437;1;11802;4;1;1069;2;630;476;154
1437;1;11803;4;1;1588;0;1012;840;172
1437;2;11784;4;2;1400;1;624;445;179
1437;2;11789;4;2;1686;2;963;779;184
1437;2;11799;4;2;1883;1;872;675;197
1437;2;11806;4;2;852;0;368;283;85
1437;2;11809;4;2;1725;24;1228;727;501
1437;2;11810;4;2;794;0;403;301;102
1437;3;11782;4;3;979;0;528;391;137
1437;3;11794;4;3;397;6;299;218;81
1437;3;11796;4;3;1916;0;1019;882;137
1437;3;11798;4;3;1420;0;740;573;167
1437;3;11804;4;3;661;0;345;262;83
1437;3;11808;4;3;1069;0;533;420;113
1437;4;11785;4;4;579;0;323;251;72
1437;4;11786;4;4;696;0;336;224;112
1437;4;11791;4;4;1581;1;908;769;139
1437;4;11795;4;4;1947;1;1011;769;242
1437;5;11797;4;5;1188;0;650;563;87
1437;5;11807;4;5;54;0;28;13;15
1437;6;11805;4;6;846;2;571;472;99
1437;7;11787;4;7;1015;1;558;464;94
1437;8;11793;4;8;808;3;506;415;91
1437;9;11788;4;9;661;0;359;301;58
1438;10;11835;4;10;1517;0;522;423;99
1438;10;11856;4;10;645;0;256;189;67
1438;11;11855;4;11;1043;0;301;230;71
1438;1;11813;4;1;1378;1;792;589;203
1438;1;11824;4;1;2142;0;1112;917;195
1438;1;11830;4;1;1323;2;794;628;166
1438;1;11837;4;1;1854;4;1147;893;254
1438;1;11847;4;1;901;0;467;374;93
1438;12;11842;4;12;591;0;219;176;43
1438;13;11812;4;13;1527;0;670;581;89
1438;14;11841;4;14;1388;0;477;367;110
1438;15;11821;4;15;2038;0;1088;973;115
1438;16;11834;4;16;2014;1;971;831;140
1438;17;11814;4;17;1734;0;835;732;103
1438;18;11826;4;18;1684;0;790;686;104
1438;19;11859;4;19;1100;0;566;492;74
1438;20;11845;4;20;1189;0;577;499;78
1438;21;11839;4;21;1316;0;528;450;78
1438;2;11819;4;2;1490;0;758;607;151
1438;2;11829;4;2;819;0;386;257;129
1438;2;11851;4;2;1374;0;719;623;96
1438;2;11853;4;2;1603;0;745;571;174
1438;2;11858;4;2;907;1;484;355;129
1438;22;11817;4;22;1169;1;586;518;68
1438;23;11849;4;23;82;0;23;20;3
1438;24;11833;4;24;61;0;33;32;1
1438;3;11820;4;3;1344;1;614;481;133
1438;3;11836;4;3;629;0;414;333;81
1438;3;11843;4;3;1500;0;761;545;216
1438;3;11846;4;3;1232;0;498;394;104
1438;3;11848;4;3;397;0;171;118;53
1438;4;11811;4;4;1202;1;589;404;185
1438;4;11816;4;4;349;0;151;111;40
1438;4;11825;4;4;2211;0;1043;893;150
1438;4;11831;4;4;1172;2;630;518;112
1438;4;11850;4;4;52;0;36;15;21
1438;5;11815;4;5;572;0;315;253;62
1438;5;11838;4;5;461;0;186;140;46
1438;5;11852;4;5;418;1;238;146;92
1438;5;11854;4;5;1967;1;1012;893;119
1438;6;11827;4;6;1173;1;610;507;103
1438;6;11828;4;6;1202;1;563;468;95
1438;6;11844;4;6;2062;4;1202;857;345
1438;6;11861;4;6;1018;0;528;384;144
1438;7;11818;4;7;2167;1;1250;956;294
1438;7;11822;4;7;695;0;361;227;134
1438;7;11840;4;7;1230;0;435;367;68
1438;8;11823;4;8;1263;0;656;577;79
1438;8;11832;4;8;618;0;294;215;79
1438;9;11857;4;9;609;0;277;224;53
1438;9;11860;4;9;1702;2;829;705;124
1461;10;11882;6;10;1650;0;696;566;130
1461;11;11889;6;11;1636;0;743;653;90
1461;1;11883;6;1;2094;0;1012;852;160
1461;12;11870;6;12;795;0;342;296;46
1461;13;11880;6;13;1792;0;797;740;57
1461;14;11864;6;14;2086;0;897;782;115
1461;15;11877;6;15;2150;0;933;835;98
1461;16;11887;6;16;2020;0;1053;985;68
1461;17;11878;6;17;2086;0;936;860;76
1461;18;11869;6;18;2374;1;1170;1056;114
1461;19;11874;6;19;2266;1;1086;984;102
1461;20;11871;6;20;2221;0;1035;911;124
1461;21;11888;6;21;2198;0;1047;925;122
1461;2;11867;6;2;1146;1;577;524;53
1461;22;11863;6;22;1433;0;710;637;73
1461;23;11865;6;23;1179;0;562;525;37
1461;24;11872;6;24;637;0;375;324;51
1461;25;11885;6;25;177;0;126;97;29
1461;26;11884;6;26;16;0;16;14;2
1461;27;11875;6;27;16;0;4;4;0
1461;28;11886;6;28;16;0;5;2;3
1461;29;11876;6;29;81;0;48;41;7
1461;3;11862;6;3;2012;1;978;845;133
1461;4;11881;6;4;2077;0;1022;907;115
1461;5;11873;6;5;1915;1;829;692;137
1461;6;11866;6;6;2011;2;855;719;136
1461;7;11890;6;7;1924;0;883;784;99
1461;8;11868;6;8;1874;1;843;752;91
1461;9;11879;6;9;1254;1;657;570;87
1462;10;11943;4;10;1069;0;430;349;81
1462;11;11931;4;11;1324;1;548;458;90
1462;1;11901;4;1;1221;0;591;531;60
1462;12;11916;4;12;1226;0;659;556;103
1462;13;11945;4;13;1731;2;764;670;94
1462;14;11919;4;14;1829;0;844;775;69
1462;15;11942;4;15;1687;2;797;707;90
1462;16;11934;4;16;1625;0;768;688;80
1462;17;11894;4;17;1783;0;817;746;71
1462;18;11940;4;18;1380;1;662;588;74
1462;19;11921;4;19;596;0;258;238;20
1462;20;11959;4;20;1249;0;621;567;54
1462;21;11898;4;21;1284;0;595;530;65
1462;2;11928;4;2;2125;0;845;714;131
1462;22;11896;4;22;1782;0;798;735;63
1462;23;11895;4;23;252;0;150;125;25
1462;24;11907;4;24;1233;0;520;410;110
1462;25;11913;4;25;1384;0;565;466;99
1462;26;11951;4;26;817;0;339;242;97
1462;27;11920;4;27;1325;0;580;540;40
1462;28;11909;4;28;1527;0;698;621;77
1462;29;11918;4;29;1493;0;659;597;62
1462;30;11925;4;30;2117;0;979;885;94
1462;31;11908;4;31;916;0;414;380;34
1462;3;11917;4;3;1460;0;599;528;71
1462;32;11932;4;32;1389;1;639;575;64
1462;33;11935;4;33;2144;0;1036;937;99
1462;34;11936;4;34;1431;0;660;609;51
1462;35;11954;4;35;2017;0;1002;916;86
1462;36;11929;4;36;1227;0;539;483;56
1462;37;11930;4;37;1270;0;611;542;69
1462;38;11906;4;38;1772;0;847;776;71
1462;39;11891;4;39;1571;0;728;654;74
1462;40;11893;4;40;2050;0;972;901;71
1462;41;11902;4;41;1564;0;736;677;59
1462;4;11956;4;4;1599;0;606;514;92
1462;42;11953;4;42;1849;0;826;768;58
1462;43;11949;4;43;1833;0;866;806;60
1462;44;11914;4;44;1909;0;978;924;54
1462;45;11892;4;45;1439;1;655;603;52
1462;46;11923;4;46;1394;0;695;620;75
1462;47;11911;4;47;1084;0;475;448;27
1462;48;11903;4;48;1229;0;543;482;61
1462;49;11958;4;49;1516;0;656;579;77
1462;50;11924;4;50;1690;1;749;670;79
1462;51;11900;4;51;2263;0;1090;1002;88
1462;5;11910;4;5;1221;0;585;513;72
1462;52;11933;4;52;1943;0;1015;954;61
1462;53;11904;4;53;1910;0;957;911;46
1462;54;11927;4;54;2197;0;1085;1002;83
1462;55;11897;4;55;2368;1;1074;1013;61
1462;56;11939;4;56;1896;0;808;723;85
1462;57;11937;4;57;2044;1;1157;1054;103
1462;58;11922;4;58;1699;1;802;707;95
1462;59;11944;4;59;1304;0;692;615;77
1462;60;11947;4;60;1693;0;816;723;93
1462;61;11926;4;61;1623;0;798;686;112
1462;6;11957;4;6;1128;0;452;399;53
1462;62;11948;4;62;1259;1;748;641;107
1462;63;11899;4;63;891;0;486;406;80
1462;64;11912;4;64;1194;0;560;483;77
1462;65;11941;4;65;1553;0;745;652;93
1462;66;11955;4;66;845;0;441;413;28
1462;67;11905;4;67;66;0;38;28;10
1462;68;11938;4;68;162;0;98;86;12
1462;69;11946;4;69;98;0;44;36;8
1462;7;11952;4;7;1692;0;672;579;93
1462;8;11950;4;8;1834;0;827;677;150
1462;9;11915;4;9;1782;0;692;572;120
1463;100;11960;5;100;1943;1;831;768;63
1463;101;12056;5;101;2178;0;963;915;48
1463;10;12037;5;10;2166;1;865;807;58
1463;102;12019;5;102;2359;0;1077;991;86
1463;103;12012;5;103;1950;1;645;645;0
1463;104;11989;5;104;1480;0;458;407;51
1463;105;12002;5;105;1147;0;452;410;42
1463;106;12003;5;106;1826;0;890;853;37
1463;107;12040;5;107;939;0;377;349;28
1463;108;12051;5;108;791;0;277;252;25
1463;109;12008;5;109;1522;0;621;572;49
1463;110;11975;5;110;69;0;23;23;0
1463;111;12046;5;111;18;0;11;8;3
1463;11;11997;5;11;860;0;351;310;41
1463;1;12044;5;1;1198;0;383;362;21
1463;112;12035;5;112;221;0;74;59;15
1463;113;11992;5;113;100;0;50;44;6
1463;114;11965;5;114;18;0;17;13;4
1463;12;12069;5;12;546;0;142;124;18
1463;13;12023;5;13;1837;0;734;701;33
1463;14;11978;5;14;2018;0;947;892;55
1463;15;11969;5;15;1321;1;639;585;54
1463;16;12036;5;16;2065;0;950;889;61
1463;17;11964;5;17;1248;0;551;508;43
1463;18;11995;5;18;1866;0;738;670;68
1463;19;12032;5;19;1623;0;692;646;46
1463;20;12024;5;20;1128;0;344;319;25
1463;21;11967;5;21;1167;0;452;433;19
1463;2;11976;5;2;1157;0;472;439;33
1463;22;12064;5;22;1053;0;417;378;39
1463;23;12038;5;23;2396;0;1077;1014;63
1463;24;11971;5;24;1730;0;849;803;46
1463;25;12000;5;25;1909;0;874;817;57
1463;26;11970;5;26;1993;0;817;756;61
1463;27;12065;5;27;1203;0;423;392;31
1463;28;12067;5;28;2177;0;1011;941;70
1463;29;12063;5;29;1847;0;858;811;47
1463;30;12014;5;30;1707;0;777;741;36
1463;31;12039;5;31;2021;0;904;829;75
1463;3;12042;5;3;1443;0;581;547;34
1463;32;12001;5;32;1537;0;661;606;55
1463;33;11999;5;33;2246;0;984;916;68
1463;34;12066;5;34;1580;0;613;571;42
1463;35;12058;5;35;1588;0;604;552;52
1463;36;12043;5;36;2230;0;934;880;54
1463;37;11977;5;37;166;0;66;51;15
1463;38;12013;5;38;1793;0;679;631;48
1463;39;12009;5;39;1287;0;429;398;31
1463;40;11996;5;40;1683;0;737;683;54
1463;41;11979;5;41;1669;0;644;615;29
1463;4;12050;5;4;1067;0;391;356;35
1463;42;12026;5;42;1755;0;662;605;57
1463;43;12071;5;43;2024;0;798;741;57
1463;44;12025;5;44;1139;0;383;367;16
1463;45;12068;5;45;1074;0;416;391;25
1463;46;12060;5;46;2007;0;799;758;41
1463;47;12021;5;47;1868;0;693;616;77
1463;48;12007;5;48;1765;0;695;654;41
1463;49;11988;5;49;2210;0;929;858;71
1463;50;12034;5;50;2228;0;780;730;50
1463;51;11966;5;51;1628;0;770;723;47
1463;5;11961;5;5;1304;0;503;474;29
1463;52;12059;5;52;1109;0;488;449;39
1463;53;11991;5;53;1836;1;895;844;51
1463;54;11993;5;54;1381;0;698;656;42
1463;55;12006;5;55;1796;0;843;772;71
1463;56;12073;5;56;1665;0;722;670;52
1463;57;12047;5;57;1469;0;626;576;50
1463;58;11987;5;58;2003;0;814;762;52
1463;59;11968;5;59;1205;0;505;465;40
1463;60;11981;5;60;2011;0;882;812;70
1463;61;11973;5;61;1979;0;710;649;61
1463;6;11984;5;6;1204;0;522;495;27
1463;62;12017;5;62;2092;0;945;879;66
1463;63;12030;5;63;2042;0;848;794;54
1463;64;12054;5;64;2271;0;1017;943;74
1463;65;11982;5;65;1549;0;607;571;36
1463;66;11990;5;66;1926;1;932;859;73
1463;67;12041;5;67;2263;0;974;909;65
1463;68;12011;5;68;2017;0;780;736;44
1463;69;11963;5;69;2050;0;824;772;52
1463;70;12016;5;70;2017;0;820;760;60
1463;71;12004;5;71;1835;0;732;673;59
1463;7;11985;5;7;1007;0;369;337;32
1463;72;12028;5;72;993;0;369;344;25
1463;73;12015;5;73;1701;0;897;846;51
1463;74;12005;5;74;1406;0;622;586;36
1463;75;11980;5;75;1441;2;558;519;39
1463;76;12033;5;76;1363;0;431;398;33
1463;77;12049;5;77;1606;0;608;543;65
1463;78;12053;5;78;1885;0;689;607;82
1463;79;12072;5;79;1968;0;819;764;55
1463;80;11998;5;80;1736;0;830;776;54
1463;81;12018;5;81;1185;0;578;546;32
1463;8;12022;5;8;865;0;273;249;24
1463;82;12010;5;82;705;0;261;250;11
1463;83;12057;5;83;2273;0;1030;959;71
1463;84;11983;5;84;2262;0;889;889;0
1463;85;11972;5;85;1827;0;741;693;48
1463;86;11974;5;86;1018;0;293;283;10
1463;87;12062;5;87;1124;0;414;389;25
1463;88;12048;5;88;1449;0;519;485;34
1463;89;12031;5;89;1394;543;543;516;27
1463;90;12027;5;90;2024;0;976;941;35
1463;91;12055;5;91;2237;0;969;920;49
1463;9;12061;5;9;746;0;291;275;16
1463;92;11962;5;92;1343;0;584;537;47
1463;93;12029;5;93;1426;0;625;575;50
1463;94;12020;5;94;1456;0;570;570;0
1463;95;11994;5;95;2168;0;947;883;64
1463;96;11986;5;96;1648;0;834;794;40
1463;97;12070;5;97;1637;0;755;659;96
1463;98;12045;5;98;2046;0;936;872;64
1463;99;12052;5;99;2327;0;1103;1016;87
1464;10;12084;6;10;2140;2;1006;812;194
1464;11;12098;6;11;2268;1;1253;1110;143
1464;1;12108;6;1;1574;0;711;644;67
1464;12;12083;6;12;1424;1;695;604;91
1464;13;12087;6;13;1796;0;884;813;71
1464;14;12116;6;14;1399;1;558;458;100
1464;15;12100;6;15;1925;1;865;780;85
1464;16;12089;6;16;1831;1;801;715;86
1464;17;12109;6;17;775;0;317;258;59
1464;18;12090;6;18;1547;0;676;615;61
1464;19;12095;6;19;1812;0;789;710;79
1464;20;12097;6;20;1203;0;526;472;54
1464;21;12096;6;21;1180;0;501;451;50
1464;2;12111;6;2;2375;0;1130;1063;67
1464;22;12112;6;22;1578;0;762;677;85
1464;23;12074;6;23;1000;0;524;481;43
1464;24;12091;6;24;1045;0;607;541;66
1464;25;12093;6;25;1441;0;666;599;67
1464;26;12106;6;26;1903;0;877;811;66
1464;27;12077;6;27;1833;0;869;768;101
1464;28;12113;6;28;1659;0;772;697;75
1464;29;12103;6;29;1882;0;878;785;93
1464;30;12088;6;30;1218;0;494;437;57
1464;31;12107;6;31;1617;0;809;744;65
1464;3;12099;6;3;1057;0;511;451;60
1464;32;12075;6;32;2040;0;943;837;106
1464;33;12082;6;33;1727;0;801;730;71
1464;34;12115;6;34;1453;0;719;654;65
1464;35;12092;6;35;1720;0;777;693;84
1464;36;12079;6;36;1870;0;861;784;77
1464;37;12080;6;37;1530;0;668;601;67
1464;38;12081;6;38;1212;0;556;498;58
1464;39;12094;6;39;83;0;25;19;6
1464;40;12078;6;40;52;0;12;11;1
1464;41;12105;6;41;10;0;6;6;0
1464;4;12085;6;4;1161;0;556;499;57
1464;42;12086;6;42;79;0;49;40;9
1464;43;12114;6;43;58;0;28;17;11
1464;5;12104;6;5;1190;0;565;513;52
1464;6;12102;6;6;2184;0;1050;988;62
1464;7;12110;6;7;1544;0;760;695;65
1464;8;12076;6;8;1468;0;794;709;85
1464;9;12101;6;9;1498;0;812;745;67
1465;1001;12331;3;1001;1561;1;859;758;101
1465;100;12853;1;100;1361;0;688;656;32
1465;1002;12273;3;1002;1803;0;877;829;48
1465;1003;12593;3;1003;1747;0;943;892;51
1465;1004;12784;3;1004;1146;1;654;596;58
1465;1005;12529;3;1005;2006;0;1150;1056;94
1465;1006;12185;3;1006;1054;1;577;543;34
1465;1007;12553;3;1007;1189;0;670;638;32
1465;1008;12644;3;1008;2249;0;1322;1258;64
1465;1009;12589;3;1009;1493;2;833;803;30
1465;1010;12758;3;1010;1910;0;1211;1160;51
1465;101;12284;1;101;1784;0;783;743;40
1465;10;12780;1;10;1638;0;745;690;55
1465;102;12647;1;102;1191;0;571;547;24
1465;103;12757;1;103;1825;0;680;587;93
1465;104;12347;1;104;2187;0;870;795;75
1465;105;12813;1;105;1886;0;863;811;52
1465;106;12480;1;106;1888;0;795;746;49
1465;107;12736;1;107;1979;0;798;740;58
1465;108;12508;1;108;2099;0;874;827;47
1465;109;12597;1;109;2220;0;862;798;64
1465;1100;12539;1;1100;102;0;54;51;3
1465;1101;12754;1;1101;90;0;14;14;0
1465;110;12526;1;110;1705;0;859;821;38
1465;1102;12477;1;1102;84;0;31;28;3
1465;1103;12442;1;1103;21;0;12;12;0
1465;1104;12964;1;1104;6;0;3;3;0
1465;1105;12125;1;1105;148;0;53;37;16
1465;1106;12713;1;1106;122;0;46;42;4
1465;1107;12225;1;1107;159;0;61;58;3
1465;1108;12417;1;1108;44;0;31;23;8
1465;1109;12608;1;1109;72;0;31;31;0
1465;1110;12180;1;1110;100;0;64;55;9
1465;1111;12370;1;1111;107;0;65;59;6
1465;111;12603;1;111;2190;0;972;896;76
1465;1112;12942;1;1112;248;0;51;43;8
1465;11;12925;1;11;1531;1;711;667;44
1465;1113;12730;1;1113;245;0;66;61;5
1465;1114;12220;1;1114;65;0;9;9;0
1465;1115;12956;1;1115;61;0;46;43;3
1465;1116;12567;1;1116;299;0;177;147;30
1465;1117;12207;2;1117;12;0;8;8;0
1465;1118;12400;2;1118;132;0;33;30;3
1465;1119;12618;2;1119;377;0;82;78;4
1465;1120;12216;2;1120;99;0;57;54;3
1465;1121;12254;2;1121;87;0;61;47;14
1465;112;12227;1;112;1485;0;703;679;24
1465;1122;12540;2;1122;106;0;76;60;16
1465;1123;12241;2;1123;53;0;35;32;3
1465;1124;12408;2;1124;143;0;87;71;16
1465;1;12429;1;1;1644;0;966;953;13
1465;1125;12145;2;1125;86;0;30;24;6
1465;1126;12588;2;1126;52;0;27;25;2
1465;1127;12778;2;1127;146;0;33;32;1
1465;1128;12619;2;1128;18;0;11;11;0
1465;1129;12617;2;1129;54;0;30;22;8
1465;1130;12424;3;1130;187;0;64;56;8
1465;1131;12881;3;1131;234;0;114;83;31
1465;113;12360;1;113;1993;0;892;842;50
1465;1132;12817;3;1132;455;0;69;56;13
1465;1133;12500;3;1133;183;0;35;32;3
1465;1134;12610;3;1134;101;0;74;69;5
1465;1135;12527;3;1135;136;0;14;8;6
1465;1136;12534;3;1136;104;0;15;15;0
1465;1137;12224;3;1137;142;0;21;18;3
1465;1138;12911;3;1138;38;0;6;5;1
1465;1139;12373;1;1139;87;0;13;12;1
1465;1140;12672;1;1140;116;0;11;11;0
1465;1141;12826;1;1141;359;0;155;120;35
1465;114;12464;1;114;1583;0;866;841;25
1465;1142;12922;2;1142;60;0;59;42;17
1465;1143;12879;2;1143;127;0;89;76;13
1465;1144;12311;2;1144;223;0;59;53;6
1465;1145;12283;2;1145;95;0;34;31;3
1465;1146;12203;3;1146;140;0;73;49;24
1465;1147;12718;3;1147;515;0;216;167;49
1465;1148;12336;3;1148;120;0;31;30;1
1465;1149;12949;3;1149;66;0;48;37;11
1465;1150;12357;3;1150;63;0;6;6;0
1465;1151;12369;3;1151;28;0;27;25;2
1465;115;12862;1;115;1639;0;907;874;33
1465;1152;12218;3;1152;21;0;11;7;4
1465;116;12292;1;116;1905;0;1036;986;50
1465;117;12962;1;117;1721;0;878;840;38
1465;118;12893;1;118;1107;0;581;555;26
1465;119;12380;1;119;1421;0;725;705;20
1465;120;12958;1;120;1412;0;790;764;26
1465;121;12880;1;121;1487;0;789;749;40
1465;12;12478;1;12;1135;0;501;480;21
1465;122;12261;1;122;1339;0;708;667;41
1465;123;12901;1;123;1981;0;923;871;52
1465;124;12343;1;124;2085;0;1009;985;24
1465;125;12836;1;125;1902;0;919;870;49
1465;126;12590;1;126;1368;0;576;545;31
1465;127;12520;1;127;1488;1;707;678;29
1465;128;12774;1;128;1540;0;680;647;33
1465;129;12900;1;129;1999;3;993;942;51
1465;130;12809;1;130;1385;0;643;605;38
1465;131;12910;1;131;1262;0;666;620;46
1465;13;12339;1;13;1480;0;610;578;32
1465;132;12738;1;132;1876;0;858;788;70
1465;133;12496;1;133;2342;0;963;899;64
1465;134;12275;1;134;2272;0;1152;1090;62
1465;135;12302;1;135;1361;0;578;545;33
1465;136;12570;1;136;1264;0;600;572;28
1465;137;12247;1;137;1204;0;621;578;43
1465;138;12340;1;138;1169;0;481;448;33
1465;139;12854;1;139;2421;4;1286;1251;35
1465;140;12822;1;140;1136;0;643;627;16
1465;141;12119;1;141;2256;2;1066;1015;51
1465;14;12317;1;14;1896;0;933;883;50
1465;142;12208;1;142;2225;0;1150;1110;40
1465;143;12327;1;143;2219;0;967;920;47
1465;144;12945;1;144;1565;0;826;779;47
1465;145;12501;1;145;1221;0;652;603;49
1465;146;12440;1;146;1054;0;479;459;20
1465;147;12801;1;147;1431;0;815;799;16
1465;148;12491;1;148;1780;0;1108;1074;34
1465;149;12433;1;149;1871;0;904;869;35
1465;150;12306;1;150;1890;0;993;939;54
1465;151;12391;1;151;1736;0;880;844;36
1465;15;12134;1;15;2084;2;966;903;63
1465;152;12658;1;152;1177;0;634;608;26
1465;153;12572;1;153;1488;0;730;695;35
1465;154;12691;1;154;2116;0;967;927;40
1465;155;12739;1;155;2083;0;1140;1091;49
1465;156;12423;1;156;1314;0;717;694;23
1465;157;12598;1;157;1383;0;725;688;37
1465;158;12243;1;158;2313;0;1159;1159;0
1465;159;12239;1;159;1973;0;1090;1051;39
1465;160;12390;1;160;1673;0;867;854;13
1465;161;12966;1;161;1724;0;1011;967;44
1465;16;12468;1;16;1338;0;614;558;56
1465;162;12497;1;162;2003;0;1014;968;46
1465;163;12795;1;163;1874;0;1062;1028;34
1465;164;12831;1;164;2158;0;1065;1037;28
1465;165;12372;1;165;2303;0;1330;1271;59
1465;166;12242;1;166;1708;0;1047;1020;27
1465;167;12811;1;167;1922;0;1063;1034;29
1465;168;12550;1;168;1858;2;982;911;71
1465;169;12762;1;169;2038;0;878;839;39
1465;170;12263;1;170;2021;0;926;875;51
1465;171;12167;1;171;1993;0;958;880;78
1465;17;12685;1;17;1625;1;854;824;30
1465;172;12856;1;172;1941;2;825;776;49
1465;173;12170;1;173;1938;0;825;783;42
1465;174;12355;1;174;1983;0;896;847;49
1465;175;12659;1;175;1195;0;571;545;26
1465;176;12846;1;176;1522;0;731;695;36
1465;177;12127;1;177;1677;0;768;726;42
1465;178;12803;1;178;1864;0;963;915;48
1465;179;12488;1;179;1925;1;965;887;78
1465;180;12594;1;180;1418;0;813;764;49
1465;181;12841;1;181;1532;0;835;803;32
1465;18;12172;1;18;1501;0;790;759;31
1465;182;12365;1;182;2226;0;1076;1009;67
1465;183;12368;1;183;1651;0;848;800;48
1465;184;12316;1;184;1949;0;976;937;39
1465;19;12606;1;19;1499;0;741;696;45
1465;201;12561;2;201;1421;3;679;632;47
1465;20;12951;1;20;1769;1;972;938;34
1465;202;12452;2;202;1396;0;634;592;42
1465;203;12870;2;203;1422;0;676;642;34
1465;204;12839;2;204;1990;0;1016;951;65
1465;205;12664;2;205;1611;1;816;751;65
1465;206;12552;2;206;1006;0;468;437;31
1465;207;12804;2;207;1634;1;841;787;54
1465;208;12872;2;208;2128;1;1238;1208;30
1465;209;12697;2;209;1012;0;502;473;29
1465;210;12731;2;210;1425;0;711;670;41
1465;211;12160;2;211;1638;0;743;702;41
1465;21;12952;1;21;886;0;459;443;16
1465;212;12898;2;212;1247;1;702;681;21
1465;2;12274;1;2;1310;0;796;780;16
1465;213;12771;2;213;1527;0;919;873;46
1465;214;12516;2;214;1360;0;651;568;83
1465;215;12683;2;215;1838;0;933;872;61
1465;216;12178;2;216;2396;0;1174;1147;27
1465;217;12580;2;217;2071;0;883;877;6
1465;218;12436;2;218;1831;0;813;768;45
1465;219;12677;2;219;1114;0;626;612;14
1465;220;12503;2;220;1400;0;623;608;15
1465;221;12163;2;221;1481;0;833;797;36
1465;22;12835;1;22;960;0;457;422;35
1465;222;12954;2;222;1463;0;717;689;28
1465;223;12627;2;223;2153;1;1030;934;96
1465;224;12717;2;224;1190;0;577;542;35
1465;225;12715;2;225;1014;1;549;506;43
1465;226;12656;2;226;1452;0;569;517;52
1465;227;12293;2;227;1471;0;728;692;36
1465;228;12549;2;228;1983;1;979;903;76
1465;229;12410;2;229;1892;1;813;738;75
1465;230;12800;2;230;1827;0;801;745;56
1465;231;12595;2;231;1977;0;919;834;85
1465;23;12927;1;23;1712;0;810;810;0
1465;232;12912;2;232;2263;2;1149;1102;47
1465;233;12873;2;233;1209;0;687;649;38
1465;234;12724;2;234;1674;0;883;834;49
1465;235;12465;2;235;1486;0;797;729;68
1465;236;12944;2;236;1625;0;917;880;37
1465;237;12833;2;237;1512;0;722;680;42
1465;238;12494;2;238;1929;0;1045;978;67
1465;239;12294;2;239;1555;0;768;733;35
1465;240;12456;2;240;1739;0;879;816;63
1465;241;12193;2;241;1375;1;635;608;27
1465;24;12322;1;24;2061;0;916;874;42
1465;242;12733;2;242;1097;0;642;614;28
1465;25;12388;1;25;1900;1;886;837;49
1465;261;12556;2;261;1989;0;801;739;62
1465;26;12729;1;26;1992;1;1003;948;55
1465;262;12431;2;262;2024;1;862;805;57
1465;263;12888;2;263;2321;0;1117;1053;64
1465;264;12941;2;264;1999;0;965;925;40
1465;265;12514;2;265;1996;0;789;732;57
1465;266;12250;2;266;2147;0;768;723;45
1465;267;12675;2;267;1498;0;664;635;29
1465;268;12840;2;268;1270;0;515;491;24
1465;269;12596;2;269;1882;0;890;830;60
1465;270;12482;2;270;1864;1;870;827;43
1465;271;12511;2;271;1599;0;794;753;41
1465;27;12587;1;27;1884;0;968;931;37
1465;272;12342;2;272;1624;0;743;692;51
1465;273;12563;2;273;1286;0;516;467;49
1465;274;12932;2;274;1874;0;789;713;76
1465;275;12359;2;275;1683;0;689;649;40
1465;276;12385;2;276;1769;1;622;573;49
1465;277;12395;2;277;1478;0;545;503;42
1465;278;12885;2;278;1516;0;739;692;47
1465;279;12634;2;279;1924;0;838;794;44
1465;280;12475;2;280;1540;0;649;616;33
1465;281;12517;2;281;1247;0;496;469;27
1465;28;12210;1;28;1749;0;773;728;45
1465;282;12171;2;282;1413;0;620;583;37
1465;283;12834;2;283;1819;0;755;702;53
1465;284;12921;2;284;1751;0;806;767;39
1465;285;12604;2;285;1934;0;892;833;59
1465;286;12304;2;286;1247;0;636;606;30
1465;287;12131;2;287;1592;0;668;623;45
1465;288;12679;2;288;2092;0;914;837;77
1465;289;12628;2;289;2086;0;756;692;64
1465;290;12206;2;290;1828;1;726;663;63
1465;291;12755;2;291;1718;0;635;594;41
1465;29;12678;1;29;1610;0;718;686;32
1465;292;12694;2;292;1960;0;761;694;67
1465;293;12462;2;293;2112;0;881;811;70
1465;294;12460;2;294;1840;0;666;610;56
1465;295;12507;2;295;2208;0;855;802;53
1465;296;12706;2;296;1743;0;909;841;68
1465;297;12469;2;297;1723;2;816;785;31
1465;298;12282;2;298;2320;1;778;721;57
1465;299;12666;2;299;2072;0;702;656;46
1465;300;12426;2;300;2216;0;920;856;64
1465;301;12745;2;301;1305;0;625;595;30
1465;30;12118;1;30;1187;0;517;478;39
1465;302;12844;2;302;2054;0;990;932;58
1465;303;12161;2;303;2129;1;1079;1015;64
1465;304;12392;2;304;1481;1;718;699;19
1465;305;12531;2;305;1585;1;825;786;39
1465;306;12265;2;306;1942;0;850;787;63
1465;307;12330;2;307;1282;0;551;515;36
1465;308;12398;2;308;1183;0;502;456;46
1465;309;12363;2;309;2332;1;1160;1086;74
1465;310;12557;2;310;2223;1;1045;997;48
1465;311;12278;2;311;1716;0;711;662;49
1465;31;12959;1;31;1976;1;900;837;63
1465;312;12272;2;312;2033;0;936;867;69
1465;3;12404;1;3;2039;0;1043;965;78
1465;313;12820;2;313;1987;0;823;777;46
1465;314;12612;2;314;1914;0;906;863;43
1465;315;12850;2;315;1888;0;856;826;30
1465;316;12267;2;316;1662;1;816;803;13
1465;317;12865;2;317;1847;0;989;955;34
1465;318;12793;2;318;1347;0;549;517;32
1465;319;12640;2;319;1431;1;617;602;15
1465;320;12896;2;320;1612;0;674;634;40
1465;321;12334;2;321;1451;0;637;612;25
1465;32;12466;1;32;838;0;402;383;19
1465;322;12894;2;322;1764;1;837;743;94
1465;331;12544;2;331;1836;0;957;900;57
1465;33;12759;1;33;1520;0;760;760;0
1465;332;12545;2;332;2234;0;1398;1344;54
1465;333;12623;2;333;1914;1;1097;1043;54
1465;334;12742;2;334;2171;3;1291;1258;33
1465;335;12447;2;335;2328;0;1155;1098;57
1465;336;12515;2;336;1656;1;893;842;51
1465;337;12704;2;337;1765;0;969;919;50
1465;338;12341;2;338;1498;0;792;738;54
1465;339;12246;2;339;1399;1;719;675;44
1465;340;12441;2;340;1252;0;725;687;38
1465;341;12338;2;341;1301;1;715;676;39
1465;34;12906;1;34;1570;0;840;803;37
1465;342;12714;2;342;940;0;394;365;29
1465;343;12641;2;343;1103;1;593;562;31
1465;344;12221;2;344;1598;0;763;713;50
1465;345;12788;2;345;2094;0;961;920;41
1465;346;12358;2;346;1740;0;889;850;39
1465;347;12375;2;347;1930;1;1125;1045;80
1465;348;12506;2;348;1038;0;478;437;41
1465;349;12905;2;349;1555;0;814;784;30
1465;350;12349;2;350;989;0;520;504;16
1465;351;12244;2;351;1267;1;765;734;31
1465;35;12148;1;35;1148;1;629;601;28
1465;352;12753;2;352;1784;0;958;958;0
1465;353;12665;2;353;1189;0;615;595;20
1465;354;12269;2;354;1080;0;665;624;41
1465;355;12652;2;355;1515;0;658;624;34
1465;361;12687;3;361;896;0;421;390;31
1465;36;12655;1;36;1040;0;419;400;19
1465;362;12291;3;362;1294;2;544;532;12
1465;363;12333;3;363;1414;0;650;589;61
1465;364;12479;3;364;1420;0;638;573;65
1465;365;12329;3;365;1230;0;590;541;49
1465;366;12749;3;366;1071;0;525;488;37
1465;367;12361;3;367;1130;0;472;444;28
1465;368;12937;3;368;1380;0;674;622;52
1465;369;12624;3;369;1313;0;583;538;45
1465;370;12650;3;370;1453;0;638;598;40
1465;371;12667;3;371;1622;3;682;638;44
1465;37;12884;1;37;1578;0;710;665;45
1465;372;12204;3;372;1572;0;659;605;54
1465;373;12535;3;373;1943;0;553;496;57
1465;374;12866;3;374;1592;0;569;522;47
1465;375;12403;3;375;1081;0;364;329;35
1465;376;12184;3;376;1010;0;310;269;41
1465;377;12262;3;377;1499;0;508;437;71
1465;378;12919;3;378;1619;1;562;499;63
1465;379;12601;3;379;1857;0;601;545;56
1465;380;12558;3;380;1624;0;643;591;52
1465;381;12761;3;381;2261;0;1116;1053;63
1465;38;12542;1;38;1934;2;978;936;42
1465;382;12379;3;382;1293;0;580;511;69
1465;383;12416;3;383;1627;0;758;707;51
1465;384;12829;3;384;1770;0;826;767;59
1465;385;12142;3;385;1727;0;505;454;51
1465;386;12231;3;386;1299;0;499;467;32
1465;387;12737;3;387;1732;0;612;536;76
1465;388;12914;3;388;1783;0;554;500;54
1465;389;12324;3;389;1757;0;711;677;34
1465;390;12653;3;390;1996;0;948;856;92
1465;391;12144;3;391;1373;0;532;491;41
1465;39;12575;1;39;1881;2;798;770;28
1465;392;12668;3;392;1841;0;750;680;70
1465;393;12454;3;393;1882;0;942;868;74
1465;394;12720;3;394;1550;0;634;592;42
1465;395;12126;3;395;2086;0;797;729;68
1465;396;12305;3;396;1339;0;404;361;43
1465;401;12636;3;401;1938;0;903;850;53
1465;40;12182;1;40;1355;0;614;592;22
1465;402;12384;3;402;830;0;307;265;42
1465;403;12670;3;403;2051;0;855;808;47
1465;404;12657;3;404;1353;0;405;371;34
1465;405;12504;3;405;1129;0;417;391;26
1465;406;12255;3;406;1851;1;943;892;51
1465;407;12397;3;407;1830;1;889;836;53
1465;408;12752;3;408;1559;0;615;551;64
1465;409;12295;3;409;1473;0;547;498;49
1465;410;12152;3;410;1166;0;487;436;51
1465;411;12132;3;411;1589;0;610;557;53
1465;41;12476;1;41;875;0;373;350;23
1465;412;12264;3;412;971;0;389;341;48
1465;4;12510;1;4;1848;1;895;828;67
1465;413;12356;3;413;1621;0;633;597;36
1465;414;12402;3;414;1542;0;602;568;34
1465;415;12791;3;415;2056;1;908;857;51
1465;416;12383;3;416;1710;0;816;776;40
1465;417;12620;3;417;1768;0;929;891;38
1465;418;12760;3;418;1904;0;883;808;75
1465;419;12300;3;419;1917;0;875;805;70
1465;420;12351;3;420;1562;0;725;692;33
1465;421;12318;3;421;1545;0;743;703;40
1465;42;12168;1;42;1917;1;942;886;56
1465;422;12198;3;422;2164;0;1002;937;65
1465;423;12767;3;423;1754;0;790;743;47
1465;424;12434;3;424;1805;0;758;706;52
1465;425;12235;3;425;2127;0;1103;1063;40
1465;426;12222;3;426;2013;0;966;926;40
1465;427;12445;3;427;1938;0;880;818;62
1465;428;12871;3;428;1991;0;959;923;36
1465;429;12722;3;429;1520;0;680;642;38
1465;430;12883;3;430;1663;0;587;534;53
1465;431;12744;3;431;1535;0;744;697;47
1465;43;12396;1;43;1219;0;512;478;34
1465;432;12918;3;432;1515;0;629;594;35
1465;433;12972;3;433;1919;0;858;799;59
1465;434;12913;3;434;1561;0;748;719;29
1465;435;12285;3;435;888;0;359;345;14
1465;436;12268;3;436;1653;0;576;576;0
1465;437;12825;3;437;1956;0;1006;1006;0
1465;438;12362;3;438;1726;0;785;752;33
1465;439;12164;3;439;1530;0;804;782;22
1465;440;12409;3;440;1951;0;928;888;40
1465;441;12312;3;441;2222;0;868;815;53
1465;44;12741;1;44;1214;1;593;544;49
1465;442;12471;3;442;1837;1;795;762;33
1465;443;12719;3;443;2169;1;1114;1047;67
1465;444;12467;3;444;1655;0;729;682;47
1465;445;12378;3;445;1241;0;555;522;33
1465;446;12642;3;446;1385;0;539;488;51
1465;447;12270;3;447;2044;1;903;867;36
1465;448;12764;3;448;2006;0;930;887;43
1465;449;12298;3;449;2322;0;1094;1032;62
1465;450;12532;3;450;1534;0;767;728;39
1465;451;12205;3;451;1548;0;755;712;43
1465;45;12626;1;45;1145;0;523;488;35
1465;452;12448;3;452;1075;0;559;542;17
1465;453;12277;3;453;1657;0;796;753;43
1465;454;12232;3;454;1985;1;971;928;43
1465;455;12689;3;455;1837;2;990;928;62
1465;456;12197;3;456;883;0;456;433;23
1465;457;12303;3;457;1637;0;913;840;73
1465;458;12712;3;458;1520;2;764;722;42
1465;459;12711;3;459;1903;0;955;911;44
1465;460;12592;3;460;1287;0;601;564;37
1465;461;12828;3;461;1918;0;1002;965;37
1465;46;12703;1;46;1847;1;883;839;44
1465;462;12169;3;462;1315;0;602;553;49
1465;463;12130;3;463;1691;0;784;749;35
1465;464;12124;3;464;1345;0;693;677;16
1465;465;12212;3;465;1800;0;962;909;53
1465;466;12700;3;466;1098;0;537;504;33
1465;467;12175;3;467;1860;0;925;889;36
1465;468;12191;3;468;1801;0;871;809;62
1465;469;12156;3;469;1712;0;993;928;65
1465;470;12611;3;470;2239;0;1111;1042;69
1465;471;12812;3;471;2297;0;1139;1063;76
1465;47;12586;1;47;2016;0;1045;954;91
1465;472;12821;3;472;1962;0;1010;942;68
1465;473;12732;3;473;1402;0;730;696;34
1465;474;12928;3;474;1903;0;909;876;33
1465;475;12518;3;475;1605;0;760;730;30
1465;476;12209;3;476;2053;0;994;943;51
1465;477;12483;3;477;2097;0;1019;992;27
1465;478;12533;3;478;2342;0;1171;1092;79
1465;479;12165;3;479;2209;0;1060;1007;53
1465;480;12548;3;480;1476;0;794;743;51
1465;481;12137;3;481;2301;0;1135;1088;47
1465;48;12785;1;48;1229;0;633;601;32
1465;482;12364;3;482;2192;0;1093;1028;65
1465;483;12957;3;483;2091;0;1009;965;44
1465;484;12492;3;484;1954;0;828;777;51
1465;49;12904;1;49;1771;0;879;822;57
1465;501;12430;3;501;2041;1;922;842;80
1465;50;12560;1;50;1511;0;732;682;50
1465;502;12963;3;502;1664;0;787;702;85
1465;503;12345;3;503;1978;0;827;744;83
1465;504;12633;3;504;1394;0;748;710;38
1465;505;12120;3;505;1769;0;909;858;51
1465;506;12773;3;506;1503;0;851;809;42
1465;507;12943;3;507;1930;1;1083;977;106
1465;508;12842;3;508;1977;0;1127;1056;71
1465;509;12577;3;509;1032;0;532;509;23
1465;510;12248;3;510;1635;0;827;764;63
1465;511;12151;3;511;1178;0;569;533;36
1465;51;12635;1;51;1355;1;748;729;19
1465;512;12525;3;512;1552;0;886;833;53
1465;5;12393;1;5;1398;0;641;610;31
1465;513;12938;3;513;1695;0;1042;988;54
1465;514;12845;3;514;1186;1;635;561;74
1465;515;12192;3;515;1212;0;558;520;38
1465;516;12279;3;516;2313;1;1323;1273;50
1465;517;12605;3;517;2195;0;1218;1149;69
1465;518;12740;3;518;1690;0;924;872;52
1465;519;12890;3;519;2203;0;1188;1133;55
1465;520;12187;3;520;2026;0;988;936;52
1465;521;12654;3;521;1083;0;517;486;31
1465;52;12319;1;52;1033;0;488;463;25
1465;522;12502;3;522;1521;0;847;774;73
1465;523;12461;3;523;563;0;269;247;22
1465;524;12215;3;524;1805;1;1046;1017;29
1465;525;12726;3;525;1898;0;988;934;54
1465;526;12444;3;526;1678;2;882;830;52
1465;527;12432;3;527;1354;0;617;563;54
1465;528;12490;3;528;1848;0;1035;975;60
1465;529;12183;3;529;1620;0;833;738;95
1465;530;12930;3;530;1260;0;545;517;28
1465;531;12947;3;531;1271;0;567;535;32
1465;53;12645;1;53;958;1;502;486;16
1465;532;12765;3;532;2137;2;1178;1105;73
1465;54;12374;1;54;2209;0;1167;1119;48
1465;55;12769;1;55;1627;0;831;787;44
1465;552;12346;1;552;1542;0;870;828;42
1465;553;12121;1;553;2095;0;1185;1121;64
1465;554;12625;1;554;2030;0;1171;1147;24
1465;555;12419;1;555;1531;2;854;798;56
1465;556;12176;1;556;2288;0;1398;1352;46
1465;557;12682;1;557;1637;0;1012;945;67
1465;558;12136;1;558;1874;0;1176;1128;48
1465;559;12219;1;559;931;0;483;437;46
1465;560;12287;1;560;1333;0;798;777;21
1465;56;12895;1;56;1302;0;697;671;26
1465;571;12674;1;571;2295;1;1212;1170;42
1465;57;12202;1;57;2110;1;1058;1005;53
1465;572;12621;1;572;1894;0;1036;986;50
1465;573;12422;1;573;1695;0;887;848;39
1465;574;12920;1;574;1515;0;762;728;34
1465;575;12917;1;575;2049;0;1115;1072;43
1465;576;12138;1;576;1816;0;891;853;38
1465;577;12146;1;577;1356;0;652;635;17
1465;578;12401;1;578;1850;0;1007;974;33
1465;579;12437;1;579;1358;0;719;682;37
1465;580;12827;1;580;1916;0;1035;984;51
1465;581;12837;1;581;2015;0;1019;960;59
1465;58;12251;1;58;1830;0;928;883;45
1465;582;12723;1;582;1797;0;970;937;33
1465;583;12522;1;583;2146;0;1107;1072;35
1465;584;12354;1;584;1502;0;827;805;22
1465;585;12150;1;585;1592;0;833;785;48
1465;586;12435;1;586;1454;0;715;679;36
1465;587;12797;1;587;1008;0;519;497;22
1465;588;12807;1;588;1701;0;816;807;9
1465;589;12546;1;589;2123;0;1015;993;22
1465;590;12406;1;590;1894;0;954;912;42
1465;591;12660;1;591;2166;0;1095;1058;37
1465;59;12868;1;59;1644;0;934;899;35
1465;592;12735;1;592;1959;0;1008;949;59
1465;593;12688;1;593;1509;0;745;705;40
1465;594;12843;1;594;2108;0;1082;1041;41
1465;595;12559;1;595;2081;3;1160;1102;58
1465;596;12848;1;596;2130;0;1301;1263;38
1465;597;12320;1;597;2225;2;1114;1054;60
1465;598;12297;1;598;1708;0;877;831;46
1465;599;12953;1;599;1826;0;859;814;45
1465;600;12139;1;600;1289;0;651;617;34
1465;601;12449;1;601;1985;0;923;923;0
1465;60;12802;1;60;1920;0;1002;934;68
1465;602;12582;1;602;1688;0;796;774;22
1465;603;12646;1;603;1372;1;694;671;23
1465;604;12484;1;604;2043;0;980;939;41
1465;605;12787;1;605;1544;0;823;799;24
1465;606;12438;1;606;2045;0;1083;1035;48
1465;607;12323;1;607;2133;0;1063;1031;32
1465;608;12367;1;608;1499;0;746;727;19
1465;609;12779;1;609;1762;0;1018;998;20
1465;610;12519;1;610;2214;0;1176;1136;40
1465;611;12960;1;611;1376;0;780;751;29
1465;61;12157;1;61;2146;0;1047;996;51
1465;612;12407;1;612;1704;0;1045;1018;27
1465;6;12249;1;6;1330;0;612;564;48
1465;613;12280;1;613;2020;0;1235;1204;31
1465;614;12309;1;614;2292;0;1338;1284;54
1465;615;12177;1;615;1867;0;1075;1047;28
1465;616;12135;1;616;2186;0;1236;1168;68
1465;617;12201;1;617;2098;0;1171;1127;44
1465;618;12819;1;618;2000;0;1238;1221;17
1465;619;12616;1;619;1692;0;962;941;21
1465;620;12950;1;620;2208;0;1106;1056;50
1465;621;12790;1;621;1646;0;1072;1047;25
1465;62;12543;1;62;1733;0;802;774;28
1465;622;12775;1;622;1936;0;1271;1245;26
1465;623;12858;1;623;1714;0;994;976;18
1465;624;12632;1;624;2100;0;1218;1169;49
1465;625;12690;1;625;2042;0;1239;1207;32
1465;626;12308;1;626;2191;0;1206;1162;44
1465;627;12967;1;627;2272;1;1286;1224;62
1465;628;12806;1;628;2198;0;1150;1105;45
1465;629;12154;1;629;1979;0;892;867;25
1465;630;12864;1;630;688;0;372;364;8
1465;63;12746;1;63;1742;0;734;689;45
1465;651;12748;2;651;1587;0;841;798;43
1465;652;12451;2;652;1071;0;577;538;39
1465;653;12573;2;653;964;0;494;443;51
1465;654;12849;2;654;1908;0;989;891;98
1465;655;12936;2;655;1213;0;689;653;36
1465;656;12935;2;656;1227;0;699;670;29
1465;657;12457;2;657;1239;0;678;635;43
1465;658;12195;2;658;1318;0;682;621;61
1465;659;12405;2;659;1052;0;584;544;40
1465;660;12933;2;660;1265;0;707;668;39
1465;661;12750;2;661;961;0;374;336;38
1465;662;12776;2;662;795;1;369;317;52
1465;663;12899;2;663;1522;1;664;591;73
1465;664;12310;2;664;916;0;386;351;35
1465;665;12332;2;665;935;0;395;356;39
1465;666;12676;2;666;1256;0;651;595;56
1465;667;12874;2;667;1544;0;764;732;32
1465;668;12181;2;668;1654;0;841;791;50
1465;669;12768;2;669;978;0;497;450;47
1465;670;12578;2;670;1135;0;632;604;28
1465;671;12147;2;671;1113;0;539;485;54
1465;672;12117;2;672;1536;0;832;778;54
1465;673;12698;2;673;1619;0;778;704;74
1465;674;12376;2;674;484;0;280;264;16
1465;681;12337;2;681;1630;0;767;705;62
1465;682;12955;2;682;1648;0;819;755;64
1465;683;12271;2;683;1742;0;823;780;43
1465;684;12149;2;684;1842;0;836;781;55
1465;685;12799;2;685;1089;0;447;406;41
1465;686;12394;2;686;1807;0;855;785;70
1465;687;12574;2;687;1976;1;878;813;65
1465;688;12969;2;688;1537;0;810;749;61
1465;689;12903;2;689;914;0;404;380;24
1465;690;12286;2;690;2150;0;1072;973;99
1465;691;12446;2;691;2054;0;1007;940;67
1465;692;12584;2;692;766;0;335;307;28
1465;693;12301;2;693;1518;0;629;570;59
1465;694;12727;2;694;2192;0;1067;994;73
1465;695;12693;2;695;1990;0;983;916;67
1465;696;12639;2;696;2169;2;1031;959;72
1465;697;12971;2;697;1584;0;794;759;35
1465;698;12934;2;698;2135;0;1041;997;44
1465;699;12158;2;699;938;0;446;427;19
1465;700;12968;2;700;1735;0;789;703;86
1465;701;12470;2;701;2244;0;1032;975;57
1465;702;12830;2;702;973;0;565;539;26
1465;703;12228;2;703;1880;0;901;834;67
1465;704;12509;2;704;667;1;305;281;24
1465;711;12189;2;711;1480;0;931;905;26
1465;712;12892;2;712;1975;0;1149;1101;48
1465;7;12847;1;7;2106;0;957;923;34
1465;713;12707;2;713;1007;0;591;556;35
1465;714;12902;2;714;1545;0;884;840;44
1465;715;12699;2;715;1423;0;736;714;22
1465;716;12252;2;716;2252;0;1099;1052;47
1465;717;12602;2;717;1872;0;914;873;41
1465;718;12418;2;718;1727;0;954;892;62
1465;719;12863;2;719;1740;0;869;833;36
1465;720;12661;2;720;2048;1;1070;1035;35
1465;721;12815;2;721;1888;0;1079;1032;47
1465;722;12190;2;722;1968;0;953;910;43
1465;723;12648;2;723;1594;0;765;724;41
1465;724;12366;2;724;1610;0;824;789;35
1465;725;12257;2;725;760;0;455;439;16
1465;726;12743;2;726;1902;0;928;889;39
1465;727;12786;2;727;1220;0;655;615;40
1465;728;12199;2;728;2203;0;1157;1101;56
1465;729;12313;2;729;2339;0;1202;1134;68
1465;730;12174;2;730;2039;0;1010;937;73
1465;731;12258;2;731;1072;0;569;544;25
1465;732;12855;2;732;1612;0;737;689;48
1465;733;12173;2;733;2367;0;1160;1080;80
1465;734;12439;2;734;2370;0;1233;1175;58
1465;735;12236;2;735;2402;0;1160;1108;52
1465;736;12352;2;736;1392;0;795;758;37
1465;737;12583;2;737;952;0;555;542;13
1465;738;12716;2;738;1992;0;1187;1143;44
1465;739;12159;2;739;465;0;256;243;13
1465;740;12547;2;740;928;1;514;482;32
1465;741;12878;2;741;1535;0;819;784;35
1465;742;12630;2;742;2196;0;1063;1012;51
1465;743;12818;2;743;1797;0;884;834;50
1465;744;12638;2;744;2150;1;1065;991;74
1465;745;12256;2;745;2133;0;989;949;40
1465;746;12217;2;746;1305;0;715;690;25
1465;747;12961;2;747;2198;0;968;907;61
1465;748;12382;2;748;1897;1;820;820;0
1465;749;12926;2;749;2135;0;1033;965;68
1465;750;12869;2;750;2133;0;1032;970;62
1465;751;12887;2;751;1246;0;680;656;24
1465;752;12852;2;752;980;0;458;441;17
1465;753;12128;2;753;2019;0;1010;970;40
1465;754;12695;2;754;1839;0;829;769;60
1465;755;12763;2;755;1750;0;829;785;44
1465;756;12472;2;756;1877;0;861;820;41
1465;757;12692;2;757;1597;0;843;802;41
1465;758;12824;2;758;1990;0;872;829;43
1465;759;12973;2;759;2164;0;1083;1023;60
1465;760;12816;2;760;1735;0;792;722;70
1465;761;12458;2;761;2136;0;1011;959;52
1465;771;12153;2;771;1788;0;1008;982;26
1465;772;12328;2;772;1819;0;1091;1062;29
1465;773;12599;2;773;1961;0;1205;1170;35
1465;774;12798;2;774;1587;0;897;856;41
1465;775;12459;2;775;1205;0;653;628;25
1465;776;12455;2;776;1032;0;549;524;25
1465;777;12290;2;777;1017;0;453;419;34
1465;778;12223;2;778;1253;0;602;590;12
1465;779;12371;2;779;1838;1;879;839;40
1465;780;12474;2;780;1552;0;713;685;28
1465;781;12377;2;781;1603;0;798;752;46
1465;782;12766;2;782;1521;0;678;628;50
1465;783;12607;2;783;1742;0;750;699;51
1465;784;12551;2;784;1407;0;802;761;41
1465;785;12579;2;785;1613;0;880;842;38
1465;786;12229;2;786;1413;1;689;644;45
1465;787;12725;2;787;1167;0;568;539;29
1465;788;12708;2;788;1435;0;606;576;30
1465;789;12523;2;789;1241;0;540;489;51
1465;790;12909;2;790;1768;0;824;785;39
1465;791;12772;2;791;1657;0;668;627;41
1465;792;12747;2;792;1787;0;951;886;65
1465;793;12155;2;793;1504;0;777;767;10
1465;794;12411;2;794;1283;0;653;621;32
1465;795;12289;2;795;2184;0;1002;941;61
1465;796;12565;2;796;2100;0;1017;969;48
1465;797;12615;2;797;2293;0;1175;1124;51
1465;798;12651;2;798;1415;0;618;579;39
1465;799;12877;2;799;1642;0;743;709;34
1465;800;12686;2;800;1336;0;680;644;36
1465;801;12281;2;801;1478;0;890;863;27
1465;802;12196;2;802;1446;1;814;792;22
1465;803;12680;2;803;1921;0;963;915;48
1465;804;12861;2;804;2115;0;1030;980;50
1465;805;12238;2;805;1271;1;570;529;41
1465;806;12569;2;806;2083;0;1013;961;52
1465;807;12832;2;807;1395;1;731;690;41
1465;808;12129;2;808;1358;0;696;629;67
1465;809;12613;2;809;1362;0;708;683;25
1465;810;12923;2;810;1194;0;651;614;37
1465;811;12143;2;811;2046;0;804;737;67
1465;81;12348;1;81;1660;3;1009;970;39
1465;812;12576;2;812;1983;0;788;694;94
1465;8;12891;1;8;1755;1;927;878;49
1465;813;12794;2;813;1742;810;810;759;51
1465;814;12234;2;814;1596;0;696;655;41
1465;815;12166;2;815;2024;0;734;674;60
1465;816;12485;2;816;1998;0;655;655;0
1465;817;12498;2;817;1744;0;579;513;66
1465;818;12568;2;818;1783;0;689;649;40
1465;819;12473;2;819;1899;0;813;766;47
1465;820;12851;2;820;1882;0;619;546;73
1465;821;12325;2;821;1560;1;582;540;42
1465;82;12609;1;82;2160;0;1153;1107;46
1465;822;12245;2;822;1019;0;489;460;29
1465;823;12907;2;823;1399;0;700;673;27
1465;824;12259;2;824;1787;1;727;667;60
1465;825;12643;2;825;1598;0;778;733;45
1465;826;12673;2;826;2267;0;1196;1149;47
1465;827;12860;2;827;1861;0;921;860;61
1465;828;12528;2;828;1548;0;762;743;19
1465;829;12629;2;829;2051;0;952;901;51
1465;830;12931;2;830;2274;0;1064;993;71
1465;831;12415;2;831;2098;1;1006;958;48
1465;83;12307;1;83;1486;0;709;709;0
1465;832;12186;2;832;2100;0;1073;1015;58
1465;833;12188;2;833;2248;0;1029;1007;22
1465;834;12662;2;834;2176;1;907;863;44
1465;84;12428;1;84;1931;0;895;865;30
1465;851;12260;3;851;1854;0;930;898;32
1465;85;12562;1;85;1221;0;640;595;45
1465;852;12536;3;852;1030;0;465;432;33
1465;853;12541;3;853;1129;0;511;470;41
1465;854;12412;3;854;881;0;450;427;23
1465;855;12970;3;855;1006;0;474;441;33
1465;856;12684;3;856;1048;0;472;441;31
1465;857;12521;3;857;1125;0;473;428;45
1465;858;12566;3;858;1173;0;584;540;44
1465;859;12315;3;859;1775;0;966;889;77
1465;860;12939;3;860;1396;0;787;762;25
1465;861;12321;3;861;1788;0;879;836;43
1465;86;12916;1;86;1316;0;606;590;16
1465;862;12756;3;862;1934;0;680;615;65
1465;863;12721;3;863;1799;0;806;753;53
1465;864;12709;3;864;1463;0;643;590;53
1465;865;12796;3;865;1195;0;554;530;24
1465;866;12814;3;866;2246;0;1230;1158;72
1465;867;12214;3;867;1111;0;521;495;26
1465;868;12538;3;868;1605;0;788;734;54
1465;869;12513;3;869;2263;0;1081;1014;67
1465;870;12681;3;870;1147;0;543;510;33
1465;871;12230;3;871;1612;0;839;806;33
1465;87;12122;1;87;1701;0;818;785;33
1465;872;12696;3;872;1351;0;895;859;36
1465;873;12276;3;873;1199;0;537;493;44
1465;874;12792;3;874;1008;0;568;542;26
1465;875;12875;3;875;1028;0;442;402;40
1465;876;12808;3;876;1611;0;863;579;284
1465;877;12948;3;877;1753;0;823;779;44
1465;878;12493;3;878;897;1;342;320;22
1465;879;12810;3;879;1808;0;903;864;39
1465;880;12530;3;880;2046;0;1076;807;269
1465;881;12622;3;881;1311;0;538;502;36
1465;88;12564;1;88;1536;0;667;634;33
1465;882;12554;3;882;2231;0;1067;1036;31
1465;883;12728;3;883;1372;0;621;572;49
1465;884;12859;3;884;1132;0;490;463;27
1465;885;12421;3;885;2016;0;756;718;38
1465;886;12897;3;886;893;0;436;401;35
1465;887;12162;3;887;1785;0;873;804;69
1465;888;12889;3;888;1725;0;754;725;29
1465;889;12296;3;889;1974;0;867;841;26
1465;890;12669;3;890;1837;1;845;809;36
1465;891;12453;3;891;1295;0;536;509;27
1465;89;12211;1;89;2151;0;997;962;35
1465;892;12326;3;892;1068;0;563;523;40
1465;893;12299;3;893;823;0;498;475;23
1465;901;12782;3;901;1478;0;715;668;47
1465;90;12314;1;90;1148;0;607;579;28
1465;902;12838;3;902;1964;1;989;930;59
1465;903;12414;3;903;1604;0;892;852;40
1465;904;12882;3;904;1845;0;829;783;46
1465;905;12555;3;905;1592;0;746;701;45
1465;906;12591;3;906;1627;0;718;683;35
1465;907;12399;3;907;1189;0;333;309;24
1465;908;12867;3;908;1925;0;934;934;0
1465;909;12194;3;909;1879;0;768;714;54
1465;910;12450;3;910;972;0;457;437;20
1465;911;12805;3;911;2008;0;893;833;60
1465;91;12637;1;91;1478;0;758;728;30
1465;912;12710;3;912;1453;0;639;594;45
1465;9;12389;1;9;1845;0;879;819;60
1465;913;12781;3;913;2059;0;913;884;29
1465;914;12425;3;914;1419;0;603;575;28
1465;915;12663;3;915;1192;0;449;395;54
1465;916;12487;3;916;1359;0;635;592;43
1465;917;12946;3;917;2243;0;944;862;82
1465;918;12857;3;918;1723;0;647;611;36
1465;919;12387;3;919;1924;0;774;712;62
1465;920;12915;3;920;1748;0;744;684;60
1465;921;12524;3;921;1915;0;792;716;76
1465;92;12940;1;92;1137;0;570;543;27
1465;922;12386;3;922;1881;0;748;681;67
1465;923;12929;3;923;1944;0;767;711;56
1465;924;12200;3;924;1209;0;580;529;51
1465;925;12537;3;925;1894;0;840;762;78
1465;926;12701;3;926;1786;1;760;707;53
1465;927;12253;3;927;843;0;348;318;30
1465;928;12486;3;928;1941;0;749;696;53
1465;929;12770;3;929;1685;0;667;602;65
1465;930;12600;3;930;2016;0;832;753;79
1465;931;12823;3;931;1876;1;826;774;52
1465;93;12233;1;93;1815;0;841;805;36
1465;932;12512;3;932;1770;0;751;699;52
1465;933;12614;3;933;2138;0;946;840;106
1465;934;12751;3;934;1623;0;621;568;53
1465;935;12499;3;935;882;0;332;295;37
1465;936;12789;3;936;1595;0;758;711;47
1465;937;12353;3;937;1180;0;485;461;24
1465;938;12783;3;938;899;0;441;397;44
1465;939;12571;3;939;2337;0;1083;1031;52
1465;940;12344;3;940;1059;0;477;433;44
1465;941;12420;3;941;1466;0;528;480;48
1465;94;12179;1;94;1773;0;834;806;28
1465;942;12671;3;942;2113;0;847;803;44
1465;943;12288;3;943;1495;0;631;593;38
1465;944;12734;3;944;1802;0;766;707;59
1465;945;12495;3;945;1617;0;655;604;51
1465;946;12226;3;946;1735;0;720;675;45
1465;947;12965;3;947;1863;0;726;644;82
1465;948;12777;3;948;1857;0;858;806;52
1465;949;12876;3;949;1927;0;653;599;54
1465;950;12886;3;950;1939;0;809;755;54
1465;951;12413;3;951;2271;0;950;894;56
1465;95;12924;1;95;1442;0;648;626;22
1465;952;12350;3;952;1809;0;718;690;28
1465;953;12123;3;953;1795;0;686;686;0
1465;954;12133;3;954;1373;0;492;439;53
1465;955;12381;3;955;1689;1;711;657;54
1465;956;12141;3;956;1458;0;571;518;53
1465;957;12237;3;957;993;0;439;407;32
1465;958;12463;3;958;2218;0;885;885;0
1465;959;12489;3;959;1875;0;787;699;88
1465;96;12240;1;96;2213;0;1157;1100;57
1465;971;12631;3;971;1656;1;980;909;71
1465;97;12213;1;97;1725;0;726;672;54
1465;972;12505;3;972;1915;0;1101;1028;73
1465;973;12481;3;973;1241;3;657;615;42
1465;974;12585;3;974;1641;0;825;719;106
1465;975;12335;3;975;1530;0;788;740;48
1465;976;12443;3;976;1664;0;874;802;72
1465;977;12908;3;977;1601;0;775;698;77
1465;978;12427;3;978;706;1;378;342;36
1465;979;12266;3;979;1420;0;772;687;85
1465;980;12140;3;980;1463;0;736;736;0
1465;981;12649;3;981;1731;0;884;794;90
1465;98;12581;1;98;1202;0;482;464;18
1465;982;12702;3;982;1110;0;644;558;86
1465;99;12705;1;99;1954;0;864;808;56
1601;10;12993;5;10;1303;1;594;547;47
1601;10;13008;5;10;344;0;183;135;48
1601;10;13009;5;10;459;0;188;152;36
1601;10;13012;5;10;510;0;204;177;27
1601;11;12987;5;11;145;0;68;52;16
1601;11;13004;5;11;1153;1;494;462;32
1601;11;13010;5;11;879;0;357;318;39
1601;11;13015;5;11;479;0;247;210;37
1601;1;12983;5;1;1142;3;417;392;25
1601;1;12989;5;1;1617;1;603;530;73
1601;1;12991;5;1;1159;0;598;535;63
1601;1;13023;5;1;1354;0;737;655;82
1601;1;13024;5;1;1968;3;905;765;140
1601;1;13042;5;1;133;0;68;54;14
1601;12;12974;5;12;2044;0;815;752;63
1601;12;13003;5;12;435;0;205;162;43
1601;12;13032;5;12;745;0;319;286;33
1601;13;13002;5;13;309;0;190;155;35
1601;13;13007;5;13;1980;0;732;669;63
1601;13;13036;5;13;836;0;296;264;32
1601;14;13016;5;14;997;0;453;406;47
1601;14;13029;5;14;2249;0;1066;996;70
1601;14;13040;5;14;437;0;218;183;35
1601;15;12986;5;15;2329;1;888;806;82
1601;15;13022;5;15;612;0;250;223;27
1601;15;13046;5;15;528;0;305;255;50
1601;16;12995;5;16;1339;0;560;520;40
1601;16;13028;5;16;52;0;35;34;1
1601;17;13026;5;17;25;0;10;8;2
1601;17;13044;5;17;20;0;0;0;0
1601;18;13014;5;18;64;0;5;4;1
1601;19;13045;5;19;9;0;2;2;0
1601;2;12980;5;2;315;0;184;129;55
1601;2;12992;5;2;1313;0;554;463;91
1601;2;13017;5;2;1402;1;630;563;67
1601;2;13021;5;2;1983;1;625;553;72
1601;2;13031;5;2;975;0;475;456;19
1601;2;13033;5;2;1521;0;699;671;28
1601;3;12984;5;3;238;0;128;106;22
1601;3;12996;5;3;850;0;361;327;34
1601;3;12998;5;3;1201;0;502;464;38
1601;3;13001;5;3;879;0;367;311;56
1601;3;13011;5;3;1846;2;667;608;59
1601;3;13030;5;3;1374;1;593;533;60
1601;4;12990;5;4;172;0;93;79;14
1601;4;12994;5;4;471;0;193;172;21
1601;4;12997;5;4;1622;0;533;506;27
1601;4;13018;5;4;509;0;301;280;21
1601;4;13027;5;4;2116;0;833;726;107
1601;4;13043;5;4;2164;0;848;764;84
1601;5;12979;5;5;701;0;293;273;20
1601;5;12982;5;5;2110;0;603;526;77
1601;5;13006;5;5;371;0;142;118;24
1601;5;13013;5;5;2219;0;693;613;80
1601;5;13039;5;5;2044;0;907;805;102
1601;6;12981;5;6;737;0;274;246;28
1601;6;12985;5;6;2428;1;926;855;71
1601;6;13005;5;6;779;0;332;295;37
1601;6;13020;5;6;674;0;281;238;43
1601;6;13037;5;6;433;0;272;248;24
1601;7;12976;5;7;982;0;350;315;35
1601;7;13025;5;7;164;0;86;69;17
1601;7;13034;5;7;1819;0;736;681;55
1601;7;13035;5;7;498;0;239;214;25
1601;7;13038;5;7;617;0;213;196;17
1601;8;12978;5;8;248;0;136;118;18
1601;8;12999;5;8;1010;0;354;307;47
1601;8;13019;5;8;2025;0;853;768;85
1601;8;13041;5;8;314;0;160;143;17
1601;9;12975;5;9;476;0;272;247;25
1601;9;12977;5;9;1846;2;783;721;62
1601;9;12988;5;9;1351;0;628;543;85
1601;9;13000;5;9;1415;0;627;542;85
1602;10;13053;4;10;626;0;281;216;65
1602;10;13091;4;10;611;0;362;307;55
1602;11;13085;4;11;750;6;449;352;97
1602;1;13052;4;1;1937;1;1027;891;136
1602;1;13061;4;1;2017;0;972;893;79
1602;1;13068;4;1;1031;0;593;479;114
1602;1;13089;4;1;2126;0;1052;975;77
1602;12;13080;4;12;947;1;609;510;99
1602;13;13055;4;13;601;0;367;326;41
1602;14;13074;4;14;536;0;281;253;28
1602;15;13084;4;15;505;0;247;206;41
1602;16;13057;4;16;1318;0;534;473;61
1602;17;13048;4;17;536;0;281;250;31
1602;18;13072;4;18;710;0;356;292;64
1602;19;13067;4;19;25;0;4;2;2
1602;20;13064;4;20;64;0;55;43;12
1602;21;13047;4;21;19;0;12;5;7
1602;2;13054;4;2;1978;0;959;858;101
1602;2;13070;4;2;644;1;358;307;51
1602;2;13077;4;2;1533;2;769;713;56
1602;2;13079;4;2;1548;0;775;595;180
1602;3;13050;4;3;1240;2;575;516;59
1602;3;13069;4;3;1255;1;587;533;54
1602;3;13073;4;3;753;0;363;326;37
1602;3;13087;4;3;1342;4;650;498;152
1602;4;13051;4;4;746;0;373;325;48
1602;4;13056;4;4;977;0;502;394;108
1602;4;13066;4;4;697;1;389;338;51
1602;4;13088;4;4;1970;0;981;891;90
1602;5;13063;4;5;467;0;261;211;50
1602;5;13065;4;5;774;1;398;362;36
1602;5;13071;4;5;657;0;324;290;34
1602;5;13078;4;5;919;0;424;347;77
1602;6;13059;4;6;1667;0;827;722;105
1602;6;13075;4;6;465;0;241;212;29
1602;6;13081;4;6;527;0;276;242;34
1602;7;13058;4;7;1361;0;709;633;76
1602;7;13062;4;7;441;0;187;175;12
1602;7;13083;4;7;79;0;27;25;2
1602;8;13049;4;8;85;0;50;32;18
1602;8;13082;4;8;593;0;299;263;36
1602;8;13086;4;8;944;1;564;444;120
1602;9;13060;4;9;833;0;558;525;33
1602;9;13076;4;9;32;0;21;14;7
1602;9;13090;4;9;557;0;276;251;25
1603;10;13116;3;10;2224;0;815;759;56
1603;11;13125;3;11;1616;0;669;628;41
1603;1;13124;3;1;1488;0;783;688;95
1603;1;13126;3;1;1019;0;414;385;29
1603;1;13134;3;1;1820;0;938;819;119
1603;1;13141;3;1;1152;0;583;522;61
1603;1;13143;3;1;1214;0;418;352;66
1603;1;13149;3;1;1957;0;799;678;121
1603;12;13108;3;12;2041;1;817;741;76
1603;13;13147;3;13;2095;0;920;839;81
1603;14;13140;3;14;935;0;481;451;30
1603;15;13129;3;15;1840;1;611;547;64
1603;16;13109;3;16;2043;0;818;753;65
1603;17;13095;3;17;2213;0;970;930;40
1603;18;13132;3;18;2003;2;773;719;54
1603;19;13100;3;19;1305;0;479;450;29
1603;20;13096;3;20;1792;0;708;659;49
1603;21;13121;3;21;1803;0;732;683;49
1603;2;13113;3;2;983;0;353;312;41
1603;2;13119;3;2;1089;0;449;402;47
1603;2;13133;3;2;1368;0;513;469;44
1603;2;13136;3;2;1418;0;603;565;38
1603;2;13138;3;2;876;0;291;249;42
1603;2;13145;3;2;1692;4;822;702;120
1603;22;13131;3;22;1935;1;765;723;42
1603;23;13114;3;23;1905;0;810;752;58
1603;24;13130;3;24;2124;0;974;916;58
1603;25;13097;3;25;1592;0;574;527;47
1603;26;13099;3;26;2206;0;775;723;52
1603;27;13106;3;27;443;0;107;101;6
1603;28;13139;3;28;310;0;144;132;12
1603;29;13148;3;29;1435;0;579;513;66
1603;30;13135;3;30;297;0;133;111;22
1603;31;13115;3;31;2197;3;782;701;81
1603;3;13092;3;3;1645;1;738;610;128
1603;3;13093;3;3;1460;1;737;688;49
1603;3;13094;3;3;1838;2;770;680;90
1603;3;13120;3;3;1334;0;590;525;65
1603;3;13128;3;3;473;0;222;184;38
1603;3;13144;3;3;847;0;345;295;50
1603;32;13118;3;32;29;0;18;15;3
1603;33;13105;3;33;40;0;16;14;2
1603;34;13103;3;34;48;0;47;43;4
1603;35;13101;3;35;39;0;12;10;2
1603;4;13098;3;4;453;0;194;163;31
1603;4;13104;3;4;1627;0;542;469;73
1603;4;13107;3;4;2082;1;907;833;74
1603;4;13112;3;4;1274;0;509;430;79
1603;4;13146;3;4;953;1;407;339;68
1603;5;13110;3;5;658;0;337;286;51
1603;5;13111;3;5;1701;0;726;588;138
1603;5;13137;3;5;1561;0;612;553;59
1603;5;13150;3;5;682;0;271;230;41
1603;6;13122;3;6;594;0;182;143;39
1603;6;13127;3;6;2156;0;847;776;71
1603;6;13142;3;6;782;0;327;256;71
1603;7;13102;3;7;1605;0;661;606;55
1603;8;13117;3;8;1825;0;592;562;30
1603;9;13123;3;9;2069;0;722;665;57
1604;10;13156;2;10;664;4;338;250;88
1604;10;13184;2;10;393;0;178;131;47
1604;10;13187;2;10;2197;0;878;795;83
1604;11;13169;2;11;407;0;160;131;29
1604;11;13188;2;11;2239;1;871;798;73
1604;1;13155;2;1;961;0;396;355;41
1604;1;13198;2;1;1009;0;341;309;32
1604;1;13203;2;1;1747;0;872;792;80
1604;1;13207;2;1;2218;0;953;843;110
1604;12;13190;2;12;1366;0;603;568;35
1604;12;13210;2;12;655;0;274;226;48
1604;13;13164;2;13;306;0;165;129;36
1604;13;13174;2;13;798;0;332;285;47
1604;14;13193;2;14;531;0;189;176;13
1604;14;13208;2;14;417;0;223;199;24
1604;15;13162;2;15;381;0;150;127;23
1604;15;13206;2;15;702;0;373;327;46
1604;16;13209;2;16;906;0;267;245;22
1604;17;13201;2;17;982;0;367;340;27
1604;18;13185;2;18;876;0;300;300;0
1604;19;13177;2;19;1690;0;594;508;86
1604;20;13199;2;20;725;0;202;180;22
1604;21;13182;2;21;575;0;160;150;10
1604;2;13168;2;2;1868;0;913;830;83
1604;2;13171;2;2;200;0;90;82;8
1604;2;13180;2;2;1533;0;525;472;53
1604;2;13211;2;2;1656;1;658;545;113
1604;22;13158;2;22;481;0;216;183;33
1604;23;13179;2;23;511;0;272;253;19
1604;24;13165;2;24;849;0;292;258;34
1604;25;13173;2;25;405;0;152;129;23
1604;26;13197;2;26;82;0;62;60;2
1604;27;13163;2;27;52;0;10;10;0
1604;28;13175;2;28;17;0;17;13;4
1604;3;13157;2;3;1102;0;477;406;71
1604;3;13166;2;3;544;0;209;189;20
1604;3;13170;2;3;1984;0;840;769;71
1604;3;13195;2;3;500;2;196;168;28
1604;4;13161;2;4;458;0;212;174;38
1604;4;13167;2;4;712;1;237;220;17
1604;4;13189;2;4;1059;0;341;294;47
1604;4;13204;2;4;703;0;331;274;57
1604;5;13159;2;5;581;0;191;156;35
1604;5;13186;2;5;708;0;240;219;21
1604;5;13192;2;5;1826;0;722;659;63
1604;5;13196;2;5;747;0;319;263;56
1604;6;13152;2;6;512;0;274;206;68
1604;6;13153;2;6;544;0;210;177;33
1604;6;13154;2;6;266;0;102;93;9
1604;6;13181;2;6;1570;0;683;625;58
1604;7;13183;2;7;919;0;407;361;46
1604;7;13191;2;7;802;0;193;172;21
1604;7;13200;2;7;475;0;232;171;61
1604;7;13205;2;7;1925;0;872;826;46
1604;8;13151;2;8;1884;0;737;686;51
1604;8;13160;2;8;807;0;363;325;38
1604;8;13172;2;8;525;0;269;226;43
1604;8;13178;2;8;909;0;376;310;66
1604;9;13176;2;9;794;0;337;276;61
1604;9;13194;2;9;258;0;120;106;14
1604;9;13202;2;9;2358;0;1057;969;88
1605;10;13219;4;10;1819;0;824;768;56
1605;10;13221;4;10;457;0;202;176;26
1605;10;13256;4;10;646;1;254;206;48
1605;11;13234;4;11;428;2;152;121;31
1605;11;13245;4;11;929;0;431;393;38
1605;1;13227;4;1;835;0;275;254;21
1605;1;13229;4;1;2000;5;825;718;107
1605;1;13246;4;1;1401;0;537;438;99
1605;1;13252;4;1;1316;0;679;563;116
1605;1;13259;4;1;1827;2;836;691;145
1605;12;13213;4;12;507;0;181;162;19
1605;12;13244;4;12;732;0;252;234;18
1605;13;13243;4;13;805;4;325;291;34
1605;14;13253;4;14;416;0;126;107;19
1605;15;13232;4;15;1189;0;498;460;38
1605;16;13242;4;16;657;0;313;286;27
1605;17;13223;4;17;546;0;203;199;4
1605;18;13228;4;18;34;0;6;6;0
1605;2;13216;4;2;1835;0;719;560;159
1605;2;13231;4;2;1834;0;776;712;64
1605;2;13235;4;2;1555;0;652;569;83
1605;2;13240;4;2;1071;1;433;408;25
1605;2;13241;4;2;2110;0;913;844;69
1605;3;13222;4;3;514;3;217;188;29
1605;3;13236;4;3;1919;0;846;786;60
1605;3;13249;4;3;1218;0;644;577;67
1605;3;13257;4;3;2037;0;751;639;112
1605;3;13260;4;3;1437;0;574;506;68
1605;4;13215;4;4;750;0;326;264;62
1605;4;13225;4;4;1285;0;583;497;86
1605;4;13233;4;4;839;0;228;213;15
1605;4;13254;4;4;1769;0;807;703;104
1605;4;13255;4;4;726;0;292;239;53
1605;5;13220;4;5;652;0;289;260;29
1605;5;13226;4;5;413;0;146;114;32
1605;5;13238;4;5;947;0;396;369;27
1605;5;13250;4;5;582;0;222;202;20
1605;5;13251;4;5;1376;0;595;500;95
1605;6;13217;4;6;512;0;193;155;38
1605;6;13218;4;6;1575;1;652;558;94
1605;6;13247;4;6;995;0;385;348;37
1605;7;13212;4;7;1852;0;784;726;58
1605;7;13224;4;7;1166;0;446;380;66
1605;7;13248;4;7;847;0;372;336;36
1605;8;13230;4;8;855;0;346;309;37
1605;8;13239;4;8;560;0;254;196;58
1605;8;13261;4;8;1114;0;447;414;33
1605;9;13214;4;9;437;0;196;165;31
1605;9;13237;4;9;1827;0;760;706;54
1605;9;13258;4;9;1120;0;441;393;48
1606;10;13263;2;10;904;1;493;449;44
1606;11;13280;2;11;909;1;425;387;38
1606;1;13276;2;1;714;0;420;340;80
1606;1;13277;2;1;523;0;252;232;20
1606;1;13291;2;1;858;0;584;492;92
1606;1;13303;2;1;411;0;139;121;18
1606;1;13306;2;1;762;0;324;288;36
1606;12;13286;2;12;319;0;138;123;15
1606;13;13297;2;13;671;0;364;310;54
1606;14;13279;2;14;665;0;349;316;33
1606;15;13281;2;15;967;0;512;456;56
1606;16;13298;2;16;792;0;380;351;29
1606;17;13284;2;17;488;0;237;198;39
1606;18;13274;2;18;769;0;333;288;45
1606;19;13283;2;19;686;0;380;330;50
1606;20;13262;2;20;922;0;455;393;62
1606;21;13300;2;21;899;0;427;370;57
1606;2;13269;2;2;327;0;225;180;45
1606;2;13285;2;2;642;0;442;380;62
1606;2;13293;2;2;1225;2;590;497;93
1606;2;13296;2;2;1191;0;611;563;48
1606;2;13307;2;2;421;0;208;193;15
1606;22;13282;2;22;511;0;218;200;18
1606;23;13264;2;23;27;0;2;2;0
1606;24;13278;2;24;0;0;0;0;0
1606;25;13290;2;25;41;0;30;25;5
1606;3;13266;2;3;1564;0;824;752;72
1606;3;13271;2;3;772;0;346;276;70
1606;3;13275;2;3;610;0;406;338;68
1606;3;13287;2;3;547;0;334;299;35
1606;3;13301;2;3;834;0;460;405;55
1606;4;13273;2;4;234;3;131;106;25
1606;4;13288;2;4;425;0;240;200;40
1606;4;13292;2;4;441;0;312;253;59
1606;4;13309;2;4;1880;4;956;895;61
1606;4;13310;2;4;970;0;311;225;86
1606;5;13265;2;5;268;0;202;162;40
1606;5;13268;2;5;1589;0;870;775;95
1606;5;13302;2;5;590;0;182;157;25
1606;5;13304;2;5;574;0;312;271;41
1606;5;13311;2;5;636;1;356;310;46
1606;6;13270;2;6;325;0;234;213;21
1606;6;13272;2;6;838;1;517;478;39
1606;6;13289;2;6;610;0;301;260;41
1606;6;13308;2;6;411;0;165;131;34
1606;7;13295;2;7;249;0;147;125;22
1606;7;13299;2;7;2068;0;1040;942;98
1606;7;13305;2;7;220;0;144;113;31
1606;8;13294;2;8;1325;1;587;534;53
1606;9;13267;2;9;480;0;277;268;9
1607;10;13322;5;10;47;0;26;20;6
1607;10;13346;5;10;580;0;342;250;92
1607;10;13367;5;10;347;0;165;142;23
1607;10;13390;5;10;2020;0;816;744;72
1607;10;13409;5;10;1827;0;663;585;78
1607;11;13319;5;11;715;0;314;273;41
1607;11;13327;5;11;2284;0;854;801;53
1607;11;13350;5;11;931;0;409;324;85
1607;11;13370;5;11;358;0;157;152;5
1607;1;13318;5;1;1839;1;687;606;81
1607;1;13329;5;1;2092;0;1019;927;92
1607;1;13343;5;1;889;4;525;451;74
1607;1;13345;5;1;1939;0;882;660;222
1607;1;13349;5;1;1453;0;716;581;135
1607;1;13365;5;1;776;0;293;268;25
1607;1;13377;5;1;1573;2;910;742;168
1607;1;13386;5;1;1149;0;534;468;66
1607;1;13393;5;1;789;2;392;311;81
1607;12;13362;5;12;690;0;299;246;53
1607;12;13397;5;12;2170;0;915;822;93
1607;12;13401;5;12;773;0;408;350;58
1607;12;13415;5;12;266;0;149;135;14
1607;13;13323;5;13;569;0;262;213;49
1607;13;13342;5;13;978;0;356;317;39
1607;13;13380;5;13;18;0;10;10;0
1607;14;13333;5;14;441;0;242;210;32
1607;14;13425;5;14;1973;1;761;672;89
1607;15;13324;5;15;677;0;348;316;32
1607;15;13408;5;15;1690;0;597;557;40
1607;16;13391;5;16;945;0;417;385;32
1607;16;13414;5;16;553;0;242;217;25
1607;17;13394;5;17;1055;0;440;386;54
1607;17;13412;5;17;1744;0;643;597;46
1607;18;13347;5;18;1170;0;500;435;65
1607;18;13361;5;18;2216;0;960;889;71
1607;19;13358;5;19;2093;1;898;833;65
1607;19;13416;5;19;636;0;252;221;31
1607;20;13340;5;20;392;0;219;208;11
1607;20;13376;5;20;2244;0;886;805;81
1607;21;13369;5;21;847;0;395;355;40
1607;21;13424;5;21;1915;0;823;740;83
1607;2;13320;5;2;1599;3;838;692;146
1607;2;13334;5;2;2046;0;828;786;42
1607;2;13341;5;2;1003;0;412;356;56
1607;2;13352;5;2;521;1;281;238;43
1607;2;13355;5;2;1526;3;644;533;111
1607;2;13385;5;2;1873;0;795;680;115
1607;2;13388;5;2;538;0;263;207;56
1607;2;13400;5;2;832;0;360;304;56
1607;2;13405;5;2;1755;0;536;480;56
1607;22;13413;5;22;1698;1;686;620;66
1607;22;13426;5;22;30;0;20;12;8
1607;23;13326;5;23;6;0;1;1;0
1607;23;13406;5;23;702;0;261;221;40
1607;24;13396;5;24;1106;4;649;589;60
1607;24;13402;5;24;25;0;11;10;1
1607;25;13373;5;25;9;0;8;8;0
1607;25;13422;5;25;1024;1;456;401;55
1607;26;13382;5;26;1105;0;590;483;107
1607;27;13379;5;27;748;0;361;318;43
1607;28;13348;5;28;1361;1;663;599;64
1607;29;13332;5;29;1332;0;481;415;66
1607;30;13368;5;30;1269;1;538;470;68
1607;31;13315;5;31;1261;0;521;482;39
1607;3;13313;5;3;987;0;339;276;63
1607;3;13330;5;3;1465;0;573;477;96
1607;3;13339;5;3;507;0;200;177;23
1607;3;13354;5;3;518;0;170;124;46
1607;3;13371;5;3;968;0;354;328;26
1607;3;13372;5;3;1252;0;596;494;102
1607;3;13383;5;3;770;0;410;359;51
1607;3;13389;5;3;872;0;303;255;48
1607;3;13403;5;3;1892;0;769;732;37
1607;32;13419;5;32;55;0;21;20;1
1607;33;13338;5;33;78;0;31;26;5
1607;34;13384;5;34;29;0;20;19;1
1607;4;13317;5;4;486;0;206;147;59
1607;4;13351;5;4;1868;0;741;696;45
1607;4;13353;5;4;2112;1;976;856;120
1607;4;13356;5;4;588;0;295;254;41
1607;4;13359;5;4;1046;1;407;372;35
1607;4;13381;5;4;982;0;391;298;93
1607;4;13395;5;4;951;0;461;402;59
1607;4;13399;5;4;448;0;209;183;26
1607;4;13410;5;4;658;0;285;183;102
1607;5;13314;5;5;1851;0;610;530;80
1607;5;13316;5;5;854;0;443;343;100
1607;5;13331;5;5;752;0;379;322;57
1607;5;13357;5;5;346;0;155;119;36
1607;5;13360;5;5;429;0;219;201;18
1607;5;13378;5;5;464;0;208;145;63
1607;5;13407;5;5;309;0;172;145;27
1607;5;13421;5;5;2117;1;860;789;71
1607;6;13312;5;6;667;0;275;235;40
1607;6;13328;5;6;371;0;185;162;23
1607;6;13364;5;6;1221;0;474;442;32
1607;6;13366;5;6;464;0;191;146;45
1607;6;13392;5;6;851;0;453;371;82
1607;6;13420;5;6;1424;1;591;563;28
1607;7;13335;5;7;1145;0;604;566;38
1607;7;13337;5;7;449;0;193;156;37
1607;7;13374;5;7;682;0;338;290;48
1607;7;13398;5;7;1013;0;493;464;29
1607;7;13411;5;7;2253;0;760;699;61
1607;7;13418;5;7;636;0;288;244;44
1607;8;13321;5;8;1123;0;421;381;40
1607;8;13325;5;8;693;0;338;292;46
1607;8;13375;5;8;1120;0;479;379;100
1607;8;13387;5;8;692;0;355;270;85
1607;8;13417;5;8;958;0;376;339;37
1607;9;13336;5;9;964;0;499;403;96
1607;9;13344;5;9;1501;1;543;506;37
1607;9;13363;5;9;972;0;396;369;27
1607;9;13404;5;9;875;0;445;414;31
1607;9;13423;5;9;762;0;384;317;67
1608;10;13433;2;10;772;0;323;277;46
1608;10;13467;2;10;591;0;261;217;44
1608;11;13429;2;11;1211;1;578;536;42
1608;11;13474;2;11;624;0;267;229;38
1608;1;13427;2;1;1190;0;377;338;39
1608;1;13436;2;1;438;0;137;123;14
1608;1;13440;2;1;1594;0;590;522;68
1608;1;13441;2;1;1975;0;660;574;86
1608;1;13446;2;1;1337;2;615;548;67
1608;1;13452;2;1;1394;0;518;461;57
1608;1;13471;2;1;2038;0;788;723;65
1608;12;13460;2;12;351;0;130;106;24
1608;13;13465;2;13;717;0;270;231;39
1608;14;13461;2;14;425;0;200;172;28
1608;15;13449;2;15;426;0;113;104;9
1608;16;13438;2;16;201;0;107;86;21
1608;17;13455;2;17;16;0;2;2;0
1608;2;13444;2;2;2171;0;653;572;81
1608;2;13445;2;2;1105;0;419;381;38
1608;2;13458;2;2;1008;0;406;344;62
1608;2;13462;2;2;2148;0;966;894;72
1608;2;13463;2;2;2211;0;931;848;83
1608;2;13464;2;2;2124;0;941;851;90
1608;2;13469;2;2;548;0;161;148;13
1608;3;13431;2;3;969;0;181;151;30
1608;3;13434;2;3;1699;0;594;558;36
1608;3;13447;2;3;908;3;310;259;51
1608;3;13451;2;3;1788;0;724;670;54
1608;3;13453;2;3;1273;1;628;566;62
1608;3;13457;2;3;1037;0;270;253;17
1608;3;13466;2;3;1694;0;856;782;74
1608;4;13430;2;4;1763;0;431;365;66
1608;4;13443;2;4;730;0;225;204;21
1608;4;13448;2;4;296;0;81;69;12
1608;4;13450;2;4;979;1;451;387;64
1608;4;13454;2;4;1356;0;625;553;72
1608;4;13476;2;4;2143;1;877;796;81
1608;5;13437;2;5;1126;0;349;298;51
1608;5;13439;2;5;1492;0;560;478;82
1608;5;13468;2;5;972;0;313;256;57
1608;5;13472;2;5;989;0;412;333;79
1608;5;13475;2;5;743;0;261;227;34
1608;6;13456;2;6;666;0;202;163;39
1608;6;13470;2;6;843;0;348;319;29
1608;6;13473;2;6;899;0;375;347;28
1608;7;13435;2;7;389;0;155;136;19
1608;7;13459;2;7;650;0;333;294;39
1608;8;13432;2;8;720;2;296;260;36
1608;8;13477;2;8;887;0;411;357;54
1608;9;13428;2;9;631;0;224;181;43
1608;9;13442;2;9;613;0;200;141;59
1609;10;13507;1;10;461;0;223;185;38
1609;10;13523;1;10;488;1;262;227;35
1609;10;13552;1;10;1739;0;457;410;47
1609;11;13515;1;11;715;0;234;217;17
1609;11;13548;1;11;604;0;276;218;58
1609;11;13549;1;11;1244;1;458;409;49
1609;1;13479;1;1;532;0;181;159;22
1609;1;13483;1;1;1079;4;424;360;64
1609;1;13510;1;1;790;0;249;212;37
1609;1;13517;1;1;1193;0;477;449;28
1609;1;13520;1;1;1006;0;469;397;72
1609;1;13526;1;1;591;0;200;162;38
1609;1;13530;1;1;368;0;178;145;33
1609;1;13540;1;1;2317;0;841;747;94
1609;1;13562;1;1;791;0;332;255;77
1609;1;13566;1;1;1423;0;605;535;70
1609;1;13567;1;1;1068;1;454;407;47
1609;1;13575;1;1;1219;0;528;448;80
1609;1;13579;1;1;1079;0;427;371;56
1609;12;13506;1;12;1359;2;454;409;45
1609;12;13564;1;12;58;0;40;37;3
1609;13;13553;1;13;390;0;160;140;20
1609;14;13546;1;14;1370;0;409;349;60
1609;15;13496;1;15;636;5;245;208;37
1609;16;13569;1;16;26;0;5;5;0
1609;2;13492;1;2;1882;0;459;393;66
1609;2;13500;1;2;956;0;305;244;61
1609;2;13501;1;2;1458;0;728;601;127
1609;2;13505;1;2;1226;0;342;309;33
1609;2;13516;1;2;1234;0;434;385;49
1609;2;13522;1;2;1212;0;495;442;53
1609;2;13525;1;2;1858;0;752;674;78
1609;2;13527;1;2;751;0;248;226;22
1609;2;13533;1;2;922;0;415;366;49
1609;2;13554;1;2;2123;2;1024;850;174
1609;2;13558;1;2;1886;0;648;566;82
1609;2;13560;1;2;1801;0;828;769;59
1609;2;13576;1;2;1762;1;684;591;93
1609;3;13481;1;3;939;0;279;260;19
1609;3;13485;1;3;2330;0;889;806;83
1609;3;13488;1;3;1738;1;801;729;72
1609;3;13508;1;3;1491;0;698;591;107
1609;3;13518;1;3;1524;1;608;523;85
1609;3;13537;1;3;957;0;355;306;49
1609;3;13538;1;3;955;0;265;240;25
1609;3;13541;1;3;939;0;307;277;30
1609;3;13550;1;3;687;0;323;273;50
1609;3;13555;1;3;521;0;201;164;37
1609;3;13561;1;3;823;0;329;296;33
1609;3;13570;1;3;2085;0;675;624;51
1609;3;13580;1;3;1119;0;448;375;73
1609;4;13489;1;4;795;0;432;353;79
1609;4;13493;1;4;1542;0;634;530;104
1609;4;13499;1;4;629;0;218;191;27
1609;4;13503;1;4;1670;0;706;637;69
1609;4;13504;1;4;1997;0;836;752;84
1609;4;13512;1;4;1117;0;437;394;43
1609;4;13519;1;4;1228;0;511;437;74
1609;4;13521;1;4;1039;0;383;334;49
1609;4;13528;1;4;232;0;147;106;41
1609;4;13542;1;4;2439;0;943;802;141
1609;4;13551;1;4;375;0;150;103;47
1609;4;13556;1;4;1032;0;309;248;61
1609;4;13577;1;4;2095;1;1039;910;129
1609;5;13484;1;5;708;0;201;181;20
1609;5;13486;1;5;797;0;452;347;105
1609;5;13511;1;5;1458;0;619;510;109
1609;5;13514;1;5;1205;2;553;525;28
1609;5;13524;1;5;959;0;449;398;51
1609;5;13529;1;5;1678;0;586;495;91
1609;5;13535;1;5;998;0;315;292;23
1609;5;13543;1;5;735;0;351;284;67
1609;5;13545;1;5;1165;0;539;407;132
1609;5;13563;1;5;187;0;110;75;35
1609;5;13565;1;5;930;2;384;323;61
1609;5;13578;1;5;1525;0;475;440;35
1609;6;13487;1;6;352;0;116;100;16
1609;6;13491;1;6;928;0;231;219;12
1609;6;13498;1;6;884;0;410;353;57
1609;6;13532;1;6;574;2;249;235;14
1609;6;13534;1;6;1605;0;657;523;134
1609;6;13536;1;6;948;0;394;335;59
1609;6;13544;1;6;1014;0;304;265;39
1609;6;13574;1;6;460;0;178;152;26
1609;7;13478;1;7;605;0;130;103;27
1609;7;13480;1;7;1196;0;424;371;53
1609;7;13490;1;7;410;0;169;151;18
1609;7;13495;1;7;1669;1;587;473;114
1609;7;13497;1;7;917;0;368;307;61
1609;7;13502;1;7;483;0;179;163;16
1609;7;13531;1;7;1244;0;355;314;41
1609;7;13571;1;7;553;0;141;113;28
1609;8;13494;1;8;352;0;145;133;12
1609;8;13513;1;8;642;0;290;237;53
1609;8;13547;1;8;686;1;308;275;33
1609;8;13557;1;8;514;0;268;240;28
1609;8;13568;1;8;1424;1;556;488;68
1609;8;13572;1;8;1050;0;260;227;33
1609;8;13573;1;8;1178;0;429;383;46
1609;9;13482;1;9;550;0;243;193;50
1609;9;13509;1;9;116;0;87;25;62
1609;9;13539;1;9;781;0;361;312;49
1609;9;13559;1;9;1502;0;658;553;105
1609;9;13581;1;9;336;0;150;135;15
1610;10;13588;4;10;518;0;231;218;13
1610;10;13593;4;10;394;0;105;93;12
1610;10;13629;4;10;1933;0;756;710;46
1610;11;13584;4;11;1760;0;643;613;30
1610;11;13633;4;11;355;0;94;71;23
1610;11;13641;4;11;551;1;213;178;35
1610;1;13585;4;1;759;0;251;212;39
1610;1;13605;4;1;926;0;472;413;59
1610;1;13625;4;1;1561;0;543;514;29
1610;1;13626;4;1;1128;0;422;370;52
1610;12;13606;4;12;399;0;173;150;23
1610;12;13619;4;12;886;0;402;379;23
1610;12;13639;4;12;324;0;114;101;13
1610;13;13610;4;13;703;0;252;235;17
1610;13;13620;4;13;639;0;272;244;28
1610;13;13645;4;13;548;0;116;103;13
1610;14;13586;4;14;342;1;155;146;9
1610;14;13623;4;14;270;0;76;72;4
1610;14;13632;4;14;551;0;270;259;11
1610;15;13601;4;15;334;0;152;130;22
1610;15;13618;4;15;255;0;91;69;22
1610;15;13624;4;15;1107;0;402;377;25
1610;16;13589;4;16;396;0;182;169;13
1610;16;13599;4;16;370;0;167;153;14
1610;16;13643;4;16;912;0;311;265;46
1610;17;13622;4;17;28;0;12;11;1
1610;17;13628;4;17;811;0;376;332;44
1610;18;13583;4;18;156;0;70;57;13
1610;18;13635;4;18;17;0;1;1;0
1610;19;13598;4;19;242;0;154;135;19
1610;20;13596;4;20;164;0;53;51;2
1610;21;13614;4;21;39;0;17;17;0
1610;2;13597;4;2;674;0;273;225;48
1610;2;13607;4;2;1832;2;573;534;39
1610;2;13617;4;2;204;0;87;75;12
1610;2;13638;4;2;1372;0;612;556;56
1610;22;13636;4;22;65;0;50;39;11
1610;23;13587;4;23;15;0;15;15;0
1610;3;13594;4;3;650;0;243;225;18
1610;3;13602;4;3;905;0;376;329;47
1610;3;13612;4;3;812;3;483;421;62
1610;3;13627;4;3;1509;0;499;453;46
1610;4;13600;4;4;377;0;116;96;20
1610;4;13631;4;4;2145;0;580;507;73
1610;4;13634;4;4;1291;0;470;419;51
1610;4;13640;4;4;503;0;170;146;24
1610;5;13590;4;5;1191;4;586;520;66
1610;5;13608;4;5;386;0;197;172;25
1610;5;13616;4;5;1687;0;527;469;58
1610;5;13630;4;5;1255;0;337;317;20
1610;6;13592;4;6;316;0;133;118;15
1610;6;13595;4;6;284;1;144;139;5
1610;6;13604;4;6;996;0;177;157;20
1610;6;13621;4;6;1716;0;728;694;34
1610;7;13609;4;7;1711;0;694;658;36
1610;7;13611;4;7;542;0;204;163;41
1610;7;13637;4;7;644;0;315;286;29
1610;7;13644;4;7;474;0;185;149;36
1610;8;13582;4;8;522;0;199;168;31
1610;8;13591;4;8;1239;0;561;534;27
1610;8;13603;4;8;765;0;195;147;48
1610;9;13613;4;9;395;0;103;93;10
1610;9;13615;4;9;1149;0;440;406;34
1610;9;13642;4;9;343;0;91;82;9
1611;10;13708;3;10;2317;0;835;718;117
1611;11;13706;3;11;571;1;239;213;26
1611;1;13656;3;1;1416;0;710;576;134
1611;1;13659;3;1;1555;2;614;530;84
1611;1;13661;3;1;1533;0;425;377;48
1611;1;13667;3;1;1373;0;574;508;66
1611;1;13672;3;1;1362;0;606;538;68
1611;1;13695;3;1;750;0;236;203;33
1611;1;13711;3;1;973;1;319;294;25
1611;12;13673;3;12;1218;0;405;342;63
1611;13;13710;3;13;989;0;310;249;61
1611;14;13654;3;14;1236;0;406;346;60
1611;15;13680;3;15;493;0;190;162;28
1611;16;13652;3;16;581;0;226;197;29
1611;17;13657;3;17;358;0;123;103;20
1611;18;13686;3;18;822;0;304;272;32
1611;19;13646;3;19;639;0;221;195;26
1611;20;13685;3;20;852;0;261;241;20
1611;21;13668;3;21;562;0;248;202;46
1611;2;13647;3;2;560;0;233;184;49
1611;2;13653;3;2;1039;0;421;386;35
1611;2;13655;3;2;1695;0;519;483;36
1611;2;13662;3;2;1015;0;266;244;22
1611;2;13691;3;2;983;1;479;417;62
1611;2;13694;3;2;2176;0;698;623;75
1611;2;13704;3;2;1346;0;540;486;54
1611;22;13683;3;22;949;0;342;296;46
1611;23;13696;3;23;732;0;237;210;27
1611;24;13692;3;24;383;0;140;123;17
1611;25;13674;3;25;46;0;36;29;7
1611;26;13702;3;26;78;0;53;53;0
1611;27;13669;3;27;44;0;2;1;1
1611;3;13651;3;3;1962;0;878;768;110
1611;3;13664;3;3;835;0;409;318;91
1611;3;13665;3;3;878;0;231;203;28
1611;3;13676;3;3;688;0;166;138;28
1611;3;13700;3;3;701;0;286;278;8
1611;3;13701;3;3;1696;0;637;586;51
1611;3;13705;3;3;1103;0;414;361;53
1611;4;13666;3;4;439;0;174;141;33
1611;4;13671;3;4;510;0;119;105;14
1611;4;13681;3;4;1669;0;494;424;70
1611;4;13682;3;4;923;0;234;213;21
1611;4;13687;3;4;2052;0;929;835;94
1611;4;13698;3;4;411;1;171;142;29
1611;4;13703;3;4;592;0;280;210;70
1611;5;13649;3;5;726;0;287;251;36
1611;5;13650;3;5;2036;0;626;550;76
1611;5;13663;3;5;924;2;300;279;21
1611;5;13688;3;5;1791;2;818;738;80
1611;5;13693;3;5;336;0;168;128;40
1611;5;13699;3;5;408;0;129;112;17
1611;5;13707;3;5;456;0;129;107;22
1611;6;13658;3;6;1428;2;607;540;67
1611;6;13660;3;6;557;0;188;154;34
1611;6;13670;3;6;1653;0;617;520;97
1611;6;13684;3;6;1617;0;712;573;139
1611;6;13689;3;6;498;0;268;208;60
1611;6;13709;3;6;887;0;241;218;23
1611;7;13677;3;7;915;0;336;293;43
1611;7;13678;3;7;477;0;222;181;41
1611;7;13690;3;7;508;0;185;169;16
1611;7;13697;3;7;1379;1;529;473;56
1611;8;13648;3;8;948;0;348;317;31
1611;8;13679;3;8;51;0;40;21;19
1611;9;13675;3;9;826;0;235;211;24
1661;10;13749;1;10;731;0;175;158;17
1661;11;13777;1;11;1177;0;352;327;25
1661;1;13757;1;1;374;0;180;163;17
1661;12;13742;1;12;1688;0;624;593;31
1661;13;13736;1;13;1325;1;433;425;8
1661;14;13762;1;14;1537;0;640;619;21
1661;15;13714;1;15;1443;0;636;628;8
1661;16;13745;1;16;2086;0;801;763;38
1661;17;13727;1;17;1422;0;463;448;15
1661;18;13744;1;18;1945;0;737;715;22
1661;19;13761;1;19;1780;0;657;635;22
1661;20;13771;1;20;1891;0;713;694;19
1661;21;13719;1;21;1404;0;514;489;25
1661;2;13720;1;2;2208;0;816;785;31
1661;22;13746;1;22;1731;0;755;732;23
1661;23;13776;1;23;2041;0;790;762;28
1661;24;13731;1;24;1524;0;542;526;16
1661;25;13725;1;25;1167;0;487;475;12
1661;26;13768;1;26;1840;1;596;573;23
1661;27;13721;1;27;2473;0;984;955;29
1661;28;13764;1;28;1029;0;275;251;24
1661;29;13753;1;29;1457;0;432;403;29
1661;30;13751;1;30;1234;0;351;342;9
1661;31;13756;1;31;1261;0;385;354;31
1661;3;13733;1;3;809;0;349;336;13
1661;32;13743;1;32;1172;0;328;307;21
1661;33;13770;1;33;2338;0;720;681;39
1661;34;13765;1;34;1187;0;402;369;33
1661;35;13718;1;35;1984;2;660;637;23
1661;36;13739;1;36;2085;0;748;730;18
1661;37;13755;1;37;2105;1;763;740;23
1661;38;13732;1;38;2183;0;679;653;26
1661;39;13730;1;39;991;0;351;337;14
1661;40;13735;1;40;1175;0;402;382;20
1661;41;13780;1;41;1373;0;596;577;19
1661;4;13715;1;4;1388;0;647;633;14
1661;42;13724;1;42;1953;1;843;806;37
1661;43;13769;1;43;1696;1;626;599;27
1661;44;13748;1;44;1635;0;672;642;30
1661;45;13726;1;45;1285;0;584;558;26
1661;46;13734;1;46;1450;0;665;655;10
1661;47;13772;1;47;1292;0;453;432;21
1661;48;13740;1;48;1670;0;592;565;27
1661;49;13722;1;49;1843;0;684;665;19
1661;50;13738;1;50;2190;0;866;844;22
1661;51;13773;1;51;1551;0;616;588;28
1661;5;13783;1;5;1027;0;399;394;5
1661;52;13737;1;52;1588;0;506;488;18
1661;53;13759;1;53;1485;0;464;437;27
1661;54;13766;1;54;1684;0;608;595;13
1661;55;13758;1;55;1068;0;349;339;10
1661;56;13775;1;56;1981;0;728;710;18
1661;57;13717;1;57;1684;0;758;739;19
1661;58;13729;1;58;1026;0;431;418;13
1661;59;13754;1;59;1522;0;620;598;22
1661;60;13767;1;60;1498;0;615;615;0
1661;61;13713;1;61;1585;0;656;635;21
1661;6;13741;1;6;1990;0;744;718;26
1661;62;13774;1;62;1755;0;713;680;33
1661;63;13760;1;63;53;0;19;16;3
1661;64;13747;1;64;24;0;13;12;1
1661;65;13752;1;65;50;0;22;20;2
1661;66;13779;1;66;98;0;11;10;1
1661;67;13712;1;67;51;0;4;4;0
1661;68;13778;1;68;18;0;16;14;2
1661;69;13716;1;69;133;0;97;83;14
1661;70;13723;1;70;7;0;3;3;0
1661;71;13750;1;71;25;0;9;8;1
1661;7;13728;1;7;1528;0;520;500;20
1661;72;13781;1;72;18;0;2;2;0
1661;8;13763;1;8;1691;0;639;616;23
1661;9;13782;1;9;1642;0;597;573;24
1801;10;13790;5;10;352;0;193;161;32
1801;11;13808;5;11;526;0;291;244;47
1801;1;13788;5;1;978;0;536;416;120
1801;1;13791;5;1;861;0;339;288;51
1801;1;13805;5;1;769;0;364;306;58
1801;12;13800;5;12;231;0;90;62;28
1801;13;13807;5;13;336;0;145;124;21
1801;14;13795;5;14;453;0;168;133;35
1801;15;13801;5;15;600;0;281;223;58
1801;16;13787;5;16;408;0;218;170;48
1801;17;13804;5;17;464;0;236;176;60
1801;18;13785;5;18;914;0;506;395;111
1801;19;13811;5;19;253;0;119;96;23
1801;20;13784;5;20;39;0;21;17;4
1801;2;13789;5;2;1158;1;463;398;65
1801;2;13797;5;2;292;0;155;114;41
1801;2;13809;5;2;477;0;254;231;23
1801;3;13798;5;3;244;0;148;120;28
1801;3;13806;5;3;317;0;177;156;21
1801;3;13810;5;3;2021;0;948;836;112
1801;4;13786;5;4;1098;0;481;434;47
1801;4;13794;5;4;318;0;187;152;35
1801;4;13799;5;4;327;0;176;159;17
1801;5;13793;5;5;1059;0;450;397;53
1801;6;13802;5;6;1743;0;527;453;74
1801;7;13796;5;7;644;0;319;249;70
1801;8;13792;5;8;788;0;304;239;65
1801;9;13803;5;9;488;0;234;165;69
1802;10;13824;5;10;1287;0;673;555;118
1802;10;13845;5;10;275;0;141;117;24
1802;10;13860;5;10;311;0;183;150;33
1802;11;13828;5;11;476;0;151;113;38
1802;11;13862;5;11;1268;0;612;527;85
1802;1;13835;5;1;1659;7;1032;855;177
1802;1;13842;5;1;1063;3;616;529;87
1802;1;13849;5;1;802;0;473;417;56
1802;1;13857;5;1;2046;0;992;872;120
1802;1;13865;5;1;1036;0;483;404;79
1802;1;13868;5;1;1235;0;525;415;110
1802;12;13816;5;12;1370;0;733;683;50
1802;12;13853;5;12;461;0;147;124;23
1802;13;13838;5;13;815;1;386;344;42
1802;14;13850;5;14;918;0;510;417;93
1802;15;13867;5;15;25;0;3;3;0
1802;16;13851;5;16;91;0;39;20;19
1802;2;13817;5;2;1614;0;796;687;109
1802;2;13822;5;2;1175;0;589;474;115
1802;2;13823;5;2;749;0;394;335;59
1802;2;13840;5;2;437;0;204;166;38
1802;2;13855;5;2;2038;2;1041;942;99
1802;2;13866;5;2;696;0;445;327;118
1802;3;13819;5;3;1497;0;897;720;177
1802;3;13833;5;3;993;0;371;324;47
1802;3;13844;5;3;870;0;352;296;56
1802;3;13846;5;3;898;6;510;452;58
1802;3;13847;5;3;2204;0;1088;1005;83
1802;3;13856;5;3;1291;2;765;667;98
1802;4;13812;5;4;273;0;125;111;14
1802;4;13820;5;4;235;0;125;85;40
1802;4;13830;5;4;1226;1;473;401;72
1802;4;13837;5;4;1141;7;630;575;55
1802;4;13843;5;4;371;0;209;171;38
1802;4;13863;5;4;377;0;197;159;38
1802;5;13815;5;5;541;4;277;243;34
1802;5;13821;5;5;143;0;64;52;12
1802;5;13826;5;5;1063;0;342;310;32
1802;5;13829;5;5;358;0;187;148;39
1802;5;13834;5;5;1271;0;611;526;85
1802;5;13839;5;5;1006;0;611;492;119
1802;6;13813;5;6;1233;0;514;458;56
1802;6;13814;5;6;338;0;156;135;21
1802;6;13825;5;6;1939;3;857;696;161
1802;6;13859;5;6;775;0;247;220;27
1802;6;13861;5;6;592;1;359;285;74
1802;7;13818;5;7;775;0;351;313;38
1802;7;13836;5;7;278;0;179;146;33
1802;7;13848;5;7;1213;0;422;352;70
1802;7;13864;5;7;2357;0;1013;896;117
1802;8;13827;5;8;1098;0;566;447;119
1802;8;13832;5;8;863;0;475;397;78
1802;8;13852;5;8;234;0;111;86;25
1802;8;13858;5;8;1268;0;511;386;125
1802;9;13831;5;9;1683;0;961;798;163
1802;9;13841;5;9;56;0;35;27;8
1802;9;13854;5;9;294;0;138;107;31
1803;10;13873;2;10;393;0;262;225;37
1803;10;13894;2;10;827;0;488;433;55
1803;10;13908;2;10;584;0;368;317;51
1803;10;13928;2;10;1264;0;636;538;98
1803;10;13932;2;10;1857;0;712;641;71
1803;10;13938;2;10;1098;0;599;559;40
1803;11;13882;2;11;887;0;449;373;76
1803;11;13893;2;11;561;0;312;274;38
1803;11;13911;2;11;1577;1;782;718;64
1803;11;13919;2;11;1324;0;559;489;70
1803;11;13939;2;11;2090;0;1093;1023;70
1803;11;13961;2;11;1129;0;537;435;102
1803;1;13870;2;1;2091;2;1064;934;130
1803;1;13871;2;1;1149;0;441;406;35
1803;1;13878;2;1;1220;0;761;671;90
1803;1;13887;2;1;1826;0;1055;929;126
1803;1;13913;2;1;2177;0;1122;1090;32
1803;1;13943;2;1;2024;1;1318;952;366
1803;1;13960;2;1;1181;0;621;517;104
1803;12;13900;2;12;616;0;314;273;41
1803;12;13923;2;12;2279;0;1153;1105;48
1803;12;13935;2;12;619;2;376;351;25
1803;12;13945;2;12;488;0;315;267;48
1803;12;13953;2;12;1070;0;450;383;67
1803;12;13962;2;12;1216;0;627;540;87
1803;13;13892;2;13;1747;0;813;756;57
1803;13;13897;2;13;1816;0;924;869;55
1803;13;13915;2;13;264;0;175;141;34
1803;13;13944;2;13;554;0;279;266;13
1803;13;13964;2;13;685;0;372;338;34
1803;14;13907;2;14;733;0;477;425;52
1803;14;13931;2;14;745;0;428;376;52
1803;14;13947;2;14;1956;1;960;919;41
1803;15;13881;2;15;833;0;455;383;72
1803;15;13891;2;15;253;0;161;144;17
1803;15;13941;2;15;830;0;392;364;28
1803;16;13877;2;16;1332;0;531;477;54
1803;16;13885;2;16;867;0;559;427;132
1803;16;13969;2;16;1868;0;804;774;30
1803;17;13884;2;17;1390;0;779;756;23
1803;17;13918;2;17;475;0;224;182;42
1803;17;13937;2;17;83;0;68;61;7
1803;18;13916;2;18;1420;0;768;724;44
1803;19;13924;2;19;1699;0;797;733;64
1803;20;13950;2;20;2084;0;895;847;48
1803;21;13901;2;21;1679;0;751;694;57
1803;2;13895;2;2;1737;0;874;839;35
1803;2;13898;2;2;775;0;466;308;158
1803;2;13899;2;2;1895;0;1028;874;154
1803;2;13926;2;2;405;3;171;136;35
1803;2;13951;2;2;391;0;160;123;37
1803;2;13952;2;2;1101;1;454;397;57
1803;2;13965;2;2;562;0;379;349;30
1803;22;13927;2;22;1069;0;464;425;39
1803;23;13902;2;23;2067;0;1173;1117;56
1803;24;13904;2;24;58;0;38;31;7
1803;25;13968;2;25;57;0;23;22;1
1803;26;13889;2;26;11;0;3;3;0
1803;3;13869;2;3;1020;0;480;401;79
1803;3;13912;2;3;803;0;509;365;144
1803;3;13920;2;3;399;0;205;186;19
1803;3;13933;2;3;950;0;538;477;61
1803;3;13934;2;3;523;0;250;234;16
1803;3;13946;2;3;1155;0;621;561;60
1803;3;13963;2;3;1814;0;849;802;47
1803;4;13875;2;4;744;0;389;328;61
1803;4;13890;2;4;1642;0;762;718;44
1803;4;13903;2;4;423;0;241;166;75
1803;4;13936;2;4;1055;2;613;510;103
1803;4;13956;2;4;739;0;364;333;31
1803;4;13966;2;4;1537;0;786;707;79
1803;4;13971;2;4;550;0;246;217;29
1803;5;13874;2;5;1962;0;1058;1005;53
1803;5;13879;2;5;796;0;437;379;58
1803;5;13883;2;5;344;0;200;139;61
1803;5;13925;2;5;945;0;562;488;74
1803;5;13957;2;5;950;0;505;444;61
1803;5;13958;2;5;419;0;184;153;31
1803;5;13959;2;5;302;0;173;147;26
1803;6;13876;2;6;295;0;131;116;15
1803;6;13910;2;6;236;1;116;93;23
1803;6;13921;2;6;1275;1;703;622;81
1803;6;13922;2;6;1826;0;900;839;61
1803;6;13949;2;6;1566;0;788;715;73
1803;6;13967;2;6;742;0;391;291;100
1803;7;13872;2;7;1026;1;500;460;40
1803;7;13888;2;7;1061;0;410;362;48
1803;7;13905;2;7;506;0;259;213;46
1803;7;13909;2;7;466;0;272;240;32
1803;7;13914;2;7;1280;0;652;621;31
1803;7;13929;2;7;354;0;200;168;32
1803;8;13880;2;8;666;0;331;290;41
1803;8;13886;2;8;1893;0;957;913;44
1803;8;13917;2;8;114;0;45;42;3
1803;8;13940;2;8;1489;0;711;587;124
1803;8;13942;2;8;527;0;255;231;24
1803;8;13970;2;8;1222;0;408;374;34
1803;9;13896;2;9;726;0;213;196;17
1803;9;13906;2;9;2111;0;887;777;110
1803;9;13930;2;9;759;0;469;440;29
1803;9;13948;2;9;1081;0;618;540;78
1803;9;13954;2;9;775;0;386;366;20
1803;9;13955;2;9;564;0;283;251;32
1804;10;14002;4;10;1040;0;605;516;89
1804;10;14028;4;10;594;0;326;286;40
1804;10;14029;4;10;1742;0;904;838;66
1804;10;14031;4;10;344;0;182;151;31
1804;11;13979;4;11;826;0;525;488;37
1804;11;13997;4;11;2065;0;909;833;76
1804;11;14057;4;11;448;0;233;189;44
1804;11;14065;4;11;328;2;228;183;45
1804;1;13989;4;1;1471;5;1030;850;180
1804;1;13993;4;1;543;0;313;225;88
1804;1;14008;4;1;484;0;278;246;32
1804;1;14012;4;1;2086;0;928;791;137
1804;1;14016;4;1;1491;1;869;746;123
1804;1;14021;4;1;734;2;430;353;77
1804;1;14046;4;1;1514;0;893;806;87
1804;1;14050;4;1;763;0;501;417;84
1804;1;14061;4;1;476;0;187;162;25
1804;1;14067;4;1;692;0;389;303;86
1804;1;14070;4;1;377;0;193;166;27
1804;12;13976;4;12;1805;1;759;706;53
1804;12;14005;4;12;497;0;321;293;28
1804;12;14062;4;12;71;0;48;29;19
1804;13;14034;4;13;2116;0;1024;948;76
1804;13;14039;4;13;86;0;29;22;7
1804;14;14004;4;14;2120;0;943;872;71
1804;14;14066;4;14;41;0;33;27;6
1804;15;14007;4;15;2417;1;1075;992;83
1804;16;14040;4;16;1833;0;930;838;92
1804;17;14073;4;17;1217;0;560;531;29
1804;18;14043;4;18;1256;0;615;559;56
1804;19;14072;4;19;10;0;3;3;0
1804;20;14015;4;20;52;0;21;20;1
1804;21;14023;4;21;40;0;10;9;1
1804;2;13987;4;2;392;0;268;240;28
1804;2;13990;4;2;945;0;514;448;66
1804;2;13999;4;2;1192;0;746;607;139
1804;2;14001;4;2;1407;0;919;795;124
1804;2;14003;4;2;1245;2;601;531;70
1804;2;14009;4;2;2272;0;1076;1003;73
1804;2;14027;4;2;907;5;485;465;20
1804;2;14041;4;2;260;0;141;126;15
1804;2;14045;4;2;921;1;513;441;72
1804;2;14063;4;2;569;0;352;270;82
1804;2;14075;4;2;1400;0;648;532;116
1804;3;13974;4;3;292;0;204;190;14
1804;3;13984;4;3;753;0;517;453;64
1804;3;13994;4;3;1442;0;615;567;48
1804;3;14010;4;3;492;0;295;271;24
1804;3;14025;4;3;736;0;351;290;61
1804;3;14032;4;3;2064;0;1170;943;227
1804;3;14033;4;3;1273;0;761;689;72
1804;3;14042;4;3;425;1;218;189;29
1804;3;14044;4;3;379;0;214;167;47
1804;3;14058;4;3;846;0;435;356;79
1804;3;14068;4;3;679;0;317;265;52
1804;4;13982;4;4;1660;0;792;708;84
1804;4;13983;4;4;698;0;389;359;30
1804;4;13998;4;4;559;0;313;271;42
1804;4;14017;4;4;551;0;343;273;70
1804;4;14035;4;4;1804;0;1172;1012;160
1804;4;14051;4;4;332;0;211;167;44
1804;4;14052;4;4;739;0;536;500;36
1804;4;14059;4;4;1884;2;808;731;77
1804;4;14064;4;4;707;0;391;312;79
1804;4;14076;4;4;428;0;274;254;20
1804;5;13980;4;5;736;6;474;436;38
1804;5;13986;4;5;1075;0;705;603;102
1804;5;13995;4;5;454;0;323;299;24
1804;5;14000;4;5;786;0;439;342;97
1804;5;14011;4;5;1162;0;522;483;39
1804;5;14019;4;5;740;1;412;355;57
1804;5;14060;4;5;458;2;309;284;25
1804;5;14069;4;5;1459;0;649;578;71
1804;5;14071;4;5;605;0;370;328;42
1804;5;14074;4;5;630;0;364;308;56
1804;6;13975;4;6;1237;0;776;696;80
1804;6;13977;4;6;1048;0;558;479;79
1804;6;13985;4;6;1634;2;739;692;47
1804;6;14018;4;6;1350;0;595;507;88
1804;6;14020;4;6;1248;3;714;613;101
1804;6;14024;4;6;624;0;420;398;22
1804;6;14030;4;6;445;0;217;178;39
1804;6;14048;4;6;626;0;350;300;50
1804;6;14053;4;6;705;0;426;360;66
1804;7;13972;4;7;638;0;387;341;46
1804;7;13973;4;7;1299;0;556;520;36
1804;7;14006;4;7;393;0;203;183;20
1804;7;14014;4;7;248;0;145;126;19
1804;7;14036;4;7;621;0;356;315;41
1804;7;14037;4;7;667;0;305;252;53
1804;7;14038;4;7;1334;0;494;442;52
1804;7;14056;4;7;434;2;295;264;31
1804;8;13988;4;8;908;2;623;546;77
1804;8;13991;4;8;1323;0;828;751;77
1804;8;13992;4;8;424;0;266;216;50
1804;8;14013;4;8;263;0;172;160;12
1804;8;14047;4;8;596;0;234;184;50
1804;8;14054;4;8;1827;3;825;755;70
1804;8;14055;4;8;479;0;247;230;17
1804;9;13978;4;9;1104;0;484;406;78
1804;9;13981;4;9;1162;0;621;576;45
1804;9;13996;4;9;381;0;251;233;18
1804;9;14022;4;9;613;0;373;348;25
1804;9;14026;4;9;1978;4;1205;1066;139
1804;9;14049;4;9;2103;0;877;800;77
1805;10;14098;5;10;544;14;305;273;32
1805;10;14110;5;10;2006;0;788;740;48
1805;10;14114;5;10;542;1;287;258;29
1805;10;14161;5;10;593;0;301;269;32
1805;11;14083;5;11;379;0;237;198;39
1805;11;14117;5;11;759;0;344;315;29
1805;11;14138;5;11;1199;0;634;602;32
1805;11;14154;5;11;463;0;266;180;86
1805;1;14080;5;1;1527;2;934;811;123
1805;1;14090;5;1;1818;3;1163;994;169
1805;1;14121;5;1;451;1;263;234;29
1805;1;14122;5;1;1033;0;643;587;56
1805;1;14123;5;1;1210;0;690;522;168
1805;1;14127;5;1;241;2;126;90;36
1805;1;14149;5;1;1483;4;705;596;109
1805;1;14150;5;1;1172;3;707;663;44
1805;1;14156;5;1;2041;1;915;742;173
1805;1;14157;5;1;615;1;352;342;10
1805;12;14151;5;12;801;3;468;396;72
1805;12;14163;5;12;325;1;201;180;21
1805;12;14165;5;12;541;0;287;273;14
1805;13;14101;5;13;1713;1;901;834;67
1805;13;14139;5;13;1866;0;777;679;98
1805;14;14125;5;14;1340;2;651;571;80
1805;14;14175;5;14;1555;0;727;698;29
1805;15;14088;5;15;622;0;415;335;80
1805;15;14171;5;15;1048;0;535;496;39
1805;16;14084;5;16;304;0;154;141;13
1805;16;14095;5;16;1432;0;771;711;60
1805;17;14159;5;17;582;0;248;235;13
1805;17;14164;5;17;2051;1;1050;934;116
1805;18;14118;5;18;498;0;206;192;14
1805;19;14111;5;19;1190;0;617;573;44
1805;20;14135;5;20;1479;1;764;720;44
1805;21;14092;5;21;853;0;387;352;35
1805;2;14079;5;2;1058;9;585;493;92
1805;2;14091;5;2;574;0;352;270;82
1805;2;14103;5;2;1465;3;842;756;86
1805;2;14109;5;2;1984;0;1163;925;238
1805;2;14115;5;2;711;0;457;366;91
1805;2;14140;5;2;294;0;132;115;17
1805;2;14144;5;2;560;2;387;341;46
1805;2;14145;5;2;2170;0;847;706;141
1805;2;14155;5;2;1607;1;854;753;101
1805;2;14174;5;2;846;0;431;402;29
1805;22;14169;5;22;623;0;339;318;21
1805;23;14099;5;23;715;0;337;317;20
1805;24;14107;5;24;1286;1;617;551;66
1805;25;14160;5;25;1147;0;476;476;0
1805;26;14085;5;26;1497;0;746;687;59
1805;27;14134;5;27;769;0;363;330;33
1805;28;14143;5;28;83;0;9;9;0
1805;3;14078;5;3;216;0;140;94;46
1805;3;14081;5;3;1014;0;504;420;84
1805;3;14082;5;3;1341;0;654;591;63
1805;3;14096;5;3;1395;0;767;657;110
1805;3;14097;5;3;542;5;351;321;30
1805;3;14120;5;3;1469;1;788;717;71
1805;3;14153;5;3;260;2;138;107;31
1805;3;14166;5;3;1256;3;676;615;61
1805;3;14170;5;3;1160;0;628;554;74
1805;3;14173;5;3;477;0;268;214;54
1805;4;14093;5;4;2162;0;1113;1037;76
1805;4;14106;5;4;615;3;332;286;46
1805;4;14112;5;4;364;1;214;173;41
1805;4;14116;5;4;1272;0;701;618;83
1805;4;14119;5;4;832;0;359;317;42
1805;4;14124;5;4;214;0;125;103;22
1805;4;14129;5;4;805;0;397;367;30
1805;4;14137;5;4;386;2;212;171;41
1805;4;14142;5;4;1269;0;582;517;65
1805;4;14162;5;4;599;5;385;310;75
1805;5;14077;5;5;271;1;125;87;38
1805;5;14087;5;5;1133;1;506;440;66
1805;5;14094;5;5;639;0;308;264;44
1805;5;14102;5;5;743;0;359;292;67
1805;5;14113;5;5;996;1;549;484;65
1805;5;14131;5;5;1295;1;615;525;90
1805;5;14152;5;5;1074;1;559;494;65
1805;5;14172;5;5;1543;0;674;583;91
1805;6;14100;5;6;1771;0;929;821;108
1805;6;14105;5;6;820;0;384;368;16
1805;6;14108;5;6;1338;1;651;557;94
1805;6;14130;5;6;478;14;335;301;34
1805;6;14147;5;6;528;1;318;291;27
1805;6;14148;5;6;771;0;369;325;44
1805;7;14089;5;7;368;0;196;178;18
1805;7;14104;5;7;138;0;102;64;38
1805;7;14128;5;7;1058;0;504;477;27
1805;7;14136;5;7;723;0;381;319;62
1805;7;14141;5;7;761;0;264;241;23
1805;8;14086;5;8;698;0;355;277;78
1805;8;14132;5;8;467;1;189;149;40
1805;8;14133;5;8;426;1;200;180;20
1805;8;14167;5;8;1276;0;691;640;51
1805;9;14126;5;9;396;0;212;184;28
1805;9;14146;5;9;567;0;327;268;59
1805;9;14158;5;9;1262;0;580;506;74
1805;9;14168;5;9;450;2;270;235;35
1806;10;14185;3;10;2215;0;1111;1009;102
1806;11;14233;3;11;1872;0;894;797;97
1806;1;14184;3;1;1210;4;654;505;149
1806;1;14189;3;1;1751;0;895;798;97
1806;1;14208;3;1;2122;4;1027;940;87
1806;1;14209;3;1;1747;8;1121;893;228
1806;1;14213;3;1;1004;0;583;503;80
1806;1;14218;3;1;1343;0;638;549;89
1806;12;14193;3;12;1218;0;577;499;78
1806;13;14188;3;13;221;0;130;100;30
1806;14;14182;3;14;276;0;189;159;30
1806;15;14234;3;15;779;0;432;370;62
1806;16;14200;3;16;241;0;145;134;11
1806;17;14199;3;17;706;1;362;320;42
1806;18;14231;3;18;552;0;235;199;36
1806;19;14235;3;19;438;2;237;195;42
1806;20;14178;3;20;71;0;20;14;6
1806;2;14196;3;2;1262;0;562;507;55
1806;2;14203;3;2;511;0;224;188;36
1806;2;14204;3;2;1513;3;880;769;111
1806;2;14219;3;2;351;0;206;177;29
1806;2;14223;3;2;1230;0;712;603;109
1806;2;14226;3;2;2255;3;1126;998;128
1806;3;14187;3;3;1069;0;589;530;59
1806;3;14195;3;3;563;0;339;289;50
1806;3;14198;3;3;679;0;350;308;42
1806;3;14202;3;3;1158;0;617;545;72
1806;3;14211;3;3;670;3;367;325;42
1806;3;14232;3;3;395;0;190;169;21
1806;4;14179;3;4;578;0;278;250;28
1806;4;14194;3;4;181;0;120;112;8
1806;4;14201;3;4;613;0;299;245;54
1806;4;14210;3;4;478;2;293;260;33
1806;4;14216;3;4;1425;0;723;659;64
1806;4;14228;3;4;776;0;319;258;61
1806;5;14190;3;5;482;0;268;221;47
1806;5;14197;3;5;1042;1;450;383;67
1806;5;14217;3;5;494;0;266;229;37
1806;5;14221;3;5;747;0;361;316;45
1806;5;14225;3;5;1181;1;613;569;44
1806;5;14227;3;5;546;0;313;267;46
1806;6;14176;3;6;352;1;210;176;34
1806;6;14180;3;6;994;0;469;425;44
1806;6;14192;3;6;521;0;286;249;37
1806;6;14205;3;6;236;3;148;120;28
1806;6;14220;3;6;755;0;351;307;44
1806;6;14224;3;6;1537;0;792;721;71
1806;7;14177;3;7;702;0;416;368;48
1806;7;14181;3;7;1161;1;548;484;64
1806;7;14183;3;7;600;0;312;277;35
1806;7;14212;3;7;229;0;111;111;0
1806;7;14214;3;7;337;1;234;181;53
1806;8;14186;3;8;220;0;140;121;19
1806;8;14206;3;8;1137;0;560;532;28
1806;8;14207;3;8;258;1;176;146;30
1806;8;14222;3;8;1224;0;727;653;74
1806;8;14229;3;8;637;0;269;217;52
1806;9;14191;3;9;50;0;48;43;5
1806;9;14215;3;9;173;0;84;69;15
1806;9;14230;3;9;236;0;114;105;9
1807;10;14266;5;10;373;0;132;115;17
1807;10;14279;5;10;633;0;381;313;68
1807;10;14304;5;10;703;0;388;331;57
1807;10;14306;5;10;627;0;379;318;61
1807;10;14311;5;10;286;0;160;131;29
1807;11;14245;5;11;1635;0;660;604;56
1807;11;14251;5;11;662;1;361;312;49
1807;11;14298;5;11;898;0;458;391;67
1807;11;14300;5;11;1302;0;712;629;83
1807;11;14301;5;11;413;0;177;154;23
1807;1;14238;5;1;1952;4;1022;909;113
1807;1;14239;5;1;2004;1;1128;987;141
1807;1;14249;5;1;665;2;304;264;40
1807;1;14276;5;1;1929;0;980;887;93
1807;1;14278;5;1;1637;0;985;822;163
1807;1;14281;5;1;2403;2;1199;970;229
1807;1;14317;5;1;1556;1;783;693;90
1807;1;14323;5;1;2123;2;1158;1096;62
1807;1;14324;5;1;1355;0;612;531;81
1807;1;14325;5;1;2013;0;775;707;68
1807;12;14253;5;12;940;3;547;491;56
1807;12;14271;5;12;511;5;290;204;86
1807;12;14289;5;12;404;0;232;194;38
1807;12;14308;5;12;980;0;516;457;59
1807;13;14240;5;13;1688;0;831;761;70
1807;13;14319;5;13;649;0;266;219;47
1807;14;14280;5;14;809;0;338;305;33
1807;2;14236;5;2;2186;1;1144;955;189
1807;2;14243;5;2;1388;0;722;663;59
1807;2;14248;5;2;1336;0;684;608;76
1807;2;14252;5;2;697;0;358;307;51
1807;2;14258;5;2;887;0;534;487;47
1807;2;14295;5;2;1569;0;718;660;58
1807;2;14309;5;2;651;4;354;289;65
1807;2;14313;5;2;516;0;225;194;31
1807;2;14327;5;2;1809;0;913;803;110
1807;3;14237;5;3;868;0;547;476;71
1807;3;14265;5;3;556;0;258;231;27
1807;3;14277;5;3;507;1;310;269;41
1807;3;14292;5;3;1492;0;812;731;81
1807;3;14297;5;3;1718;0;758;663;95
1807;3;14307;5;3;283;0;182;142;40
1807;3;14310;5;3;1669;0;881;772;109
1807;3;14315;5;3;443;3;265;220;45
1807;3;14326;5;3;1544;0;711;624;87
1807;4;14246;5;4;572;0;243;200;43
1807;4;14247;5;4;1020;0;391;327;64
1807;4;14261;5;4;864;0;417;353;64
1807;4;14291;5;4;780;0;398;330;68
1807;4;14293;5;4;624;0;292;219;73
1807;4;14303;5;4;1831;0;1007;870;137
1807;4;14312;5;4;891;0;365;303;62
1807;4;14318;5;4;1327;0;769;660;109
1807;5;14255;5;5;1403;0;711;585;126
1807;5;14257;5;5;862;0;460;384;76
1807;5;14260;5;5;466;0;253;208;45
1807;5;14262;5;5;838;0;505;442;63
1807;5;14269;5;5;662;0;286;246;40
1807;5;14272;5;5;1138;0;566;515;51
1807;5;14288;5;5;943;0;483;385;98
1807;5;14322;5;5;970;0;459;409;50
1807;6;14242;5;6;872;0;417;348;69
1807;6;14244;5;6;1910;0;933;809;124
1807;6;14264;5;6;1027;0;430;377;53
1807;6;14282;5;6;625;0;234;210;24
1807;6;14287;5;6;1407;0;611;528;83
1807;6;14290;5;6;1136;2;557;481;76
1807;6;14305;5;6;1253;0;668;569;99
1807;6;14316;5;6;1057;0;616;554;62
1807;7;14241;5;7;519;0;197;165;32
1807;7;14254;5;7;951;0;503;462;41
1807;7;14274;5;7;1184;1;517;444;73
1807;7;14286;5;7;565;0;357;298;59
1807;7;14294;5;7;409;0;204;186;18
1807;7;14296;5;7;73;0;8;6;2
1807;7;14302;5;7;1178;2;711;623;88
1807;7;14321;5;7;338;0;155;135;20
1807;8;14250;5;8;85;0;36;34;2
1807;8;14259;5;8;261;0;110;96;14
1807;8;14268;5;8;892;0;400;356;44
1807;8;14270;5;8;966;0;470;408;62
1807;8;14273;5;8;1001;0;522;447;75
1807;8;14283;5;8;254;0;130;110;20
1807;8;14284;5;8;856;1;425;381;44
1807;8;14320;5;8;238;0;144;123;21
1807;9;14256;5;9;255;0;118;94;24
1807;9;14263;5;9;565;1;323;266;57
1807;9;14267;5;9;380;0;174;145;29
1807;9;14275;5;9;676;0;356;283;73
1807;9;14285;5;9;834;0;361;312;49
1807;9;14299;5;9;245;0;111;85;26
1807;9;14314;5;9;283;0;173;135;38
1808;10;14365;1;10;740;1;362;295;67
1808;10;14368;1;10;285;0;172;153;19
1808;11;14336;1;11;1327;0;646;576;70
1808;11;14363;1;11;1480;0;794;738;56
1808;1;14337;1;1;1231;0;706;643;63
1808;1;14342;1;1;1844;0;897;797;100
1808;1;14343;1;1;1325;0;743;665;78
1808;1;14357;1;1;1847;0;1007;883;124
1808;1;14371;1;1;1206;5;651;606;45
1808;12;14329;1;12;1405;0;773;727;46
1808;12;14379;1;12;716;0;401;375;26
1808;13;14335;1;13;1203;0;589;508;81
1808;13;14356;1;13;465;0;269;249;20
1808;14;14340;1;14;1528;0;828;735;93
1808;14;14361;1;14;1047;1;591;571;20
1808;15;14331;1;15;604;0;396;369;27
1808;16;14328;1;16;685;0;338;319;19
1808;2;14354;1;2;1253;0;641;589;52
1808;2;14358;1;2;1360;0;736;683;53
1808;2;14360;1;2;2193;0;1037;975;62
1808;2;14369;1;2;633;0;340;299;41
1808;2;14372;1;2;1298;0;622;562;60
1808;3;14338;1;3;219;0;139;128;11
1808;3;14350;1;3;1420;0;683;608;75
1808;3;14352;1;3;1422;0;682;638;44
1808;3;14367;1;3;734;1;410;335;75
1808;3;14374;1;3;1126;0;659;619;40
1808;4;14332;1;4;681;0;375;341;34
1808;4;14341;1;4;1495;0;656;616;40
1808;4;14345;1;4;976;0;461;397;64
1808;4;14348;1;4;500;0;254;225;29
1808;4;14375;1;4;1515;0;789;724;65
1808;5;14333;1;5;1732;0;922;866;56
1808;5;14339;1;5;1602;1;797;756;41
1808;5;14346;1;5;433;0;183;163;20
1808;5;14349;1;5;2286;1;1124;976;148
1808;5;14373;1;5;616;0;350;325;25
1808;6;14344;1;6;748;0;374;328;46
1808;6;14347;1;6;1564;0;720;624;96
1808;6;14355;1;6;1384;2;747;655;92
1808;6;14364;1;6;1402;2;750;700;50
1808;6;14377;1;6;343;0;152;127;25
1808;7;14334;1;7;691;0;418;370;48
1808;7;14359;1;7;640;0;352;315;37
1808;7;14366;1;7;1349;2;718;658;60
1808;7;14370;1;7;1313;0;694;619;75
1808;8;14353;1;8;603;0;369;334;35
1808;8;14362;1;8;498;0;279;237;42
1808;8;14376;1;8;1186;0;580;550;30
1808;9;14330;1;9;25;0;8;7;1
1808;9;14351;1;9;1262;0;686;614;72
1808;9;14378;1;9;235;0;163;134;29
1809;1;14383;4;1;1734;2;747;631;116
1809;1;14388;4;1;1859;0;850;751;99
1809;1;14390;4;1;415;0;254;213;41
1809;1;14403;4;1;1133;0;643;534;109
1809;1;14410;4;1;403;0;255;229;26
1809;1;14412;4;1;1390;0;762;675;87
1809;1;14422;4;1;1040;3;636;476;160
1809;1;14428;4;1;291;0;173;157;16
1809;2;14384;4;2;320;0;163;150;13
1809;2;14391;4;2;1330;1;528;465;63
1809;2;14393;4;2;1296;0;746;657;89
1809;2;14399;4;2;1276;4;748;748;0
1809;2;14404;4;2;434;0;248;206;42
1809;2;14405;4;2;2095;1;1150;1009;141
1809;2;14413;4;2;834;4;555;440;115
1809;2;14416;4;2;2367;1;1213;1096;117
1809;3;14394;4;3;1222;0;685;579;106
1809;3;14396;4;3;1344;1;800;703;97
1809;3;14400;4;3;1124;0;686;624;62
1809;3;14408;4;3;2154;0;1088;1004;84
1809;3;14417;4;3;431;1;293;205;88
1809;3;14424;4;3;673;0;365;325;40
1809;3;14429;4;3;1077;1;769;670;99
1809;3;14432;4;3;987;0;388;321;67
1809;4;14380;4;4;251;0;168;165;3
1809;4;14389;4;4;511;0;221;208;13
1809;4;14392;4;4;444;0;276;232;44
1809;4;14406;4;4;375;0;199;179;20
1809;4;14407;4;4;1904;1;878;795;83
1809;4;14420;4;4;417;0;300;246;54
1809;4;14423;4;4;1443;2;867;781;86
1809;4;14431;4;4;1036;0;595;524;71
1809;5;14382;4;5;647;0;354;312;42
1809;5;14395;4;5;209;0;131;117;14
1809;5;14397;4;5;1482;3;936;719;217
1809;5;14398;4;5;801;1;478;424;54
1809;5;14402;4;5;457;2;268;190;78
1809;5;14411;4;5;853;0;535;473;62
1809;5;14427;4;5;237;0;140;125;15
1809;5;14430;4;5;969;0;424;380;44
1809;6;14385;4;6;1072;0;604;540;64
1809;6;14386;4;6;566;0;346;302;44
1809;6;14401;4;6;519;0;333;264;69
1809;6;14418;4;6;402;0;168;138;30
1809;6;14421;4;6;509;0;286;246;40
1809;6;14426;4;6;1075;0;669;576;93
1809;7;14381;4;7;20;0;10;7;3
1809;7;14387;4;7;331;0;148;129;19
1809;7;14415;4;7;849;0;559;512;47
1809;7;14419;4;7;995;0;549;463;86
1809;7;14425;4;7;511;0;276;253;23
1809;8;14409;4;8;673;0;260;206;54
1809;9;14414;4;9;149;0;86;50;36
1810;10;14470;1;10;1393;0;695;647;48
1810;10;14478;1;10;36;0;7;7;0
1810;11;14436;1;11;1442;1;612;527;85
1810;11;14448;1;11;78;0;35;30;5
1810;1;14438;1;1;1330;0;561;494;67
1810;1;14446;1;1;1340;0;657;611;46
1810;1;14450;1;1;1880;1;945;859;86
1810;1;14452;1;1;2197;0;1187;967;220
1810;1;14455;1;1;1522;1;793;650;143
1810;1;14465;1;1;1476;1;907;773;134
1810;1;14466;1;1;1842;0;1045;893;152
1810;2;14433;1;2;911;0;457;415;42
1810;2;14444;1;2;1394;0;569;482;87
1810;2;14445;1;2;1498;0;599;520;79
1810;2;14472;1;2;1848;1;1082;914;168
1810;2;14477;1;2;1098;1;650;563;87
1810;2;14479;1;2;1794;1;1053;880;173
1810;2;14482;1;2;671;0;347;311;36
1810;3;14449;1;3;1165;1;634;518;116
1810;3;14451;1;3;947;0;426;377;49
1810;3;14453;1;3;1321;1;732;591;141
1810;3;14461;1;3;1513;0;659;494;165
1810;3;14462;1;3;2184;0;1183;1102;81
1810;3;14468;1;3;1206;0;568;513;55
1810;3;14473;1;3;411;0;235;192;43
1810;4;14435;1;4;2224;0;1397;1327;70
1810;4;14441;1;4;611;0;338;276;62
1810;4;14454;1;4;2345;0;1117;961;156
1810;4;14458;1;4;2217;0;1214;1117;97
1810;4;14471;1;4;889;1;460;418;42
1810;4;14475;1;4;371;0;225;182;43
1810;4;14481;1;4;1050;0;587;517;70
1810;5;14434;1;5;727;0;341;305;36
1810;5;14443;1;5;1997;0;1007;915;92
1810;5;14464;1;5;1224;0;653;563;90
1810;5;14467;1;5;508;0;314;233;81
1810;5;14474;1;5;1174;2;567;515;52
1810;6;14439;1;6;2307;0;1056;948;108
1810;6;14459;1;6;443;0;267;234;33
1810;6;14469;1;6;557;0;337;302;35
1810;6;14476;1;6;1777;1;808;726;82
1810;7;14437;1;7;338;0;177;140;37
1810;7;14440;1;7;550;0;347;292;55
1810;7;14463;1;7;1910;0;1023;930;93
1810;7;14480;1;7;1226;0;514;409;105
1810;8;14442;1;8;645;0;240;215;25
1810;8;14447;1;8;1341;1;643;506;137
1810;8;14456;1;8;870;0;383;383;0
1810;9;14457;1;9;1100;1;496;434;62
1810;9;14460;1;9;1385;0;682;641;41
1811;10;14483;2;10;283;0;204;181;23
1811;10;14511;2;10;1336;0;571;499;72
1811;10;14514;2;10;1730;0;725;657;68
1811;10;14542;2;10;375;0;255;215;40
1811;10;14589;2;10;656;4;395;354;41
1811;11;14557;2;11;640;0;352;299;53
1811;11;14565;2;11;198;0;123;112;11
1811;11;14572;2;11;1787;0;758;681;77
1811;1;14498;2;1;1164;0;667;604;63
1811;1;14503;2;1;408;0;248;196;52
1811;1;14523;2;1;926;0;551;503;48
1811;1;14531;2;1;1632;0;966;856;110
1811;1;14552;2;1;1182;0;690;638;52
1811;1;14553;2;1;1257;1;721;621;100
1811;1;14555;2;1;1439;0;654;569;85
1811;1;14570;2;1;1225;1;622;554;68
1811;1;14574;2;1;729;0;342;331;11
1811;1;14586;2;1;1011;2;689;614;75
1811;12;14510;2;12;584;0;367;338;29
1811;12;14588;2;12;2157;0;879;879;0
1811;13;14513;2;13;1167;0;643;594;49
1811;13;14543;2;13;2290;0;987;926;61
1811;14;14585;2;14;1975;0;754;713;41
1811;15;14499;2;15;2085;0;811;762;49
1811;16;14577;2;16;1546;0;720;693;27
1811;17;14573;2;17;1745;0;816;745;71
1811;18;14551;2;18;1669;0;829;784;45
1811;19;14489;2;19;2120;0;892;828;64
1811;20;14497;2;20;1557;0;648;591;57
1811;21;14507;2;21;1782;2;843;802;41
1811;2;14516;2;2;1400;0;682;587;95
1811;2;14527;2;2;450;0;232;201;31
1811;2;14533;2;2;339;0;213;178;35
1811;2;14545;2;2;1231;0;645;586;59
1811;2;14546;2;2;862;0;518;482;36
1811;2;14549;2;2;2230;0;972;870;102
1811;2;14554;2;2;1739;0;789;738;51
1811;2;14558;2;2;476;0;293;270;23
1811;2;14580;2;2;847;0;465;394;71
1811;2;14583;2;2;639;0;267;233;34
1811;22;14538;2;22;918;0;403;368;35
1811;23;14490;2;23;246;0;124;113;11
1811;24;14594;2;24;1549;0;650;598;52
1811;25;14539;2;25;1838;0;769;708;61
1811;26;14508;2;26;1858;0;949;890;59
1811;27;14564;2;27;2205;0;1044;964;80
1811;28;14544;2;28;2221;0;938;881;57
1811;29;14540;2;29;2165;0;895;815;80
1811;30;14493;2;30;80;0;10;9;1
1811;3;14486;2;3;217;0;140;110;30
1811;3;14487;2;3;205;0;118;110;8
1811;3;14500;2;3;390;0;211;176;35
1811;3;14518;2;3;720;0;360;316;44
1811;3;14532;2;3;560;0;316;260;56
1811;3;14547;2;3;1868;1;894;843;51
1811;3;14567;2;3;1031;1;478;456;22
1811;3;14568;2;3;196;0;123;105;18
1811;3;14590;2;3;568;0;278;242;36
1811;3;14593;2;3;546;0;242;208;34
1811;4;14512;2;4;1899;3;886;800;86
1811;4;14517;2;4;1437;0;439;415;24
1811;4;14519;2;4;236;0;163;121;42
1811;4;14524;2;4;177;0;115;100;15
1811;4;14529;2;4;744;0;428;371;57
1811;4;14536;2;4;899;0;477;414;63
1811;4;14556;2;4;410;0;261;237;24
1811;4;14566;2;4;1165;2;567;457;110
1811;4;14571;2;4;598;0;365;316;49
1811;4;14575;2;4;415;0;184;164;20
1811;5;14502;2;5;318;0;173;145;28
1811;5;14506;2;5;1027;0;644;554;90
1811;5;14515;2;5;1565;0;801;719;82
1811;5;14525;2;5;274;0;162;138;24
1811;5;14534;2;5;1446;0;520;479;41
1811;5;14535;2;5;868;0;456;417;39
1811;5;14541;2;5;531;0;304;261;43
1811;5;14550;2;5;498;0;314;269;45
1811;5;14559;2;5;802;0;382;325;57
1811;5;14560;2;5;893;0;439;379;60
1811;6;14492;2;6;257;0;142;125;17
1811;6;14495;2;6;248;0;172;151;21
1811;6;14504;2;6;613;0;284;253;31
1811;6;14509;2;6;683;0;328;296;32
1811;6;14526;2;6;1728;0;670;604;66
1811;6;14537;2;6;537;0;245;216;29
1811;6;14548;2;6;557;0;303;281;22
1811;6;14562;2;6;377;0;232;187;45
1811;6;14578;2;6;726;0;266;232;34
1811;6;14587;2;6;1521;0;748;677;71
1811;7;14485;2;7;278;0;147;139;8
1811;7;14491;2;7;317;0;197;181;16
1811;7;14496;2;7;506;0;262;239;23
1811;7;14530;2;7;165;0;88;78;10
1811;7;14561;2;7;692;2;378;298;80
1811;7;14569;2;7;1058;0;532;443;89
1811;7;14581;2;7;1708;0;713;682;31
1811;7;14582;2;7;736;0;269;237;32
1811;7;14592;2;7;447;0;282;266;16
1811;8;14488;2;8;2433;1;1167;1098;69
1811;8;14501;2;8;191;0;124;105;19
1811;8;14521;2;8;825;0;421;346;75
1811;8;14528;2;8;712;0;404;373;31
1811;8;14563;2;8;684;0;350;304;46
1811;8;14576;2;8;720;0;398;353;45
1811;8;14579;2;8;206;0;116;102;14
1811;8;14584;2;8;317;0;197;170;27
1811;9;14484;2;9;2190;0;1095;1027;68
1811;9;14494;2;9;927;1;539;482;57
1811;9;14505;2;9;563;1;294;234;60
1811;9;14520;2;9;518;0;185;164;21
1811;9;14522;2;9;204;0;122;110;12
1811;9;14591;2;9;143;0;73;64;9
1812;10;14623;3;10;741;0;434;397;37
1812;10;14635;3;10;312;0;165;136;29
1812;10;14638;3;10;1727;0;844;763;81
1812;11;14616;3;11;250;0;145;123;22
1812;11;14637;3;11;375;0;200;167;33
1812;11;14655;3;11;2272;0;1013;933;80
1812;1;14598;3;1;1281;1;730;653;77
1812;1;14603;3;1;1664;0;731;672;59
1812;1;14624;3;1;981;0;519;429;90
1812;1;14628;3;1;1243;0;613;526;87
1812;1;14632;3;1;1055;1;549;448;101
1812;1;14647;3;1;930;0;473;389;84
1812;1;14651;3;1;1077;1;493;448;45
1812;12;14617;3;12;53;0;14;13;1
1812;12;14645;3;12;296;0;129;113;16
1812;2;14596;3;2;1852;1;913;858;55
1812;2;14609;3;2;1012;0;486;422;64
1812;2;14622;3;2;613;0;289;242;47
1812;2;14634;3;2;1474;0;849;734;115
1812;2;14639;3;2;1128;0;492;430;62
1812;2;14640;3;2;842;1;439;398;41
1812;2;14653;3;2;741;0;407;346;61
1812;3;14614;3;3;312;0;169;141;28
1812;3;14621;3;3;1291;0;553;509;44
1812;3;14627;3;3;657;0;426;360;66
1812;3;14643;3;3;2218;1;1056;985;71
1812;3;14644;3;3;1187;1;668;541;127
1812;3;14650;3;3;540;0;211;185;26
1812;3;14652;3;3;965;0;407;333;74
1812;4;14597;3;4;719;0;392;351;41
1812;4;14608;3;4;529;0;326;269;57
1812;4;14615;3;4;620;0;309;260;49
1812;4;14626;3;4;655;0;300;244;56
1812;4;14630;3;4;538;0;292;262;30
1812;4;14641;3;4;493;0;265;235;30
1812;4;14654;3;4;976;0;451;404;47
1812;5;14611;3;5;867;0;421;351;70
1812;5;14612;3;5;668;0;407;366;41
1812;5;14619;3;5;726;1;393;336;57
1812;5;14620;3;5;1117;0;493;455;38
1812;5;14631;3;5;459;0;259;211;48
1812;5;14636;3;5;972;0;445;409;36
1812;5;14646;3;5;499;1;307;258;49
1812;6;14600;3;6;1201;0;511;475;36
1812;6;14601;3;6;1000;0;448;388;60
1812;6;14602;3;6;745;0;336;280;56
1812;6;14607;3;6;426;3;209;194;15
1812;6;14629;3;6;812;0;485;436;49
1812;6;14649;3;6;383;0;257;235;22
1812;7;14599;3;7;458;0;311;276;35
1812;7;14604;3;7;1808;0;717;660;57
1812;7;14606;3;7;569;0;285;253;32
1812;7;14642;3;7;1455;1;541;464;77
1812;7;14648;3;7;273;0;140;122;18
1812;8;14595;3;8;2024;0;836;789;47
1812;8;14605;3;8;392;0;155;126;29
1812;8;14610;3;8;1010;0;391;356;35
1812;8;14613;3;8;386;0;239;208;31
1812;9;14618;3;9;1531;0;774;683;91
1812;9;14625;3;9;411;0;189;152;37
1812;9;14633;3;9;390;0;228;204;24
1813;10;14675;4;10;1405;1;835;758;77
1813;10;14689;4;10;507;0;246;204;42
1813;10;14717;4;10;236;0;163;135;28
1813;10;14728;4;10;288;0;202;170;32
1813;11;14670;4;11;232;0;146;126;20
1813;11;14672;4;11;1248;1;718;613;105
1813;1;14656;4;1;758;3;336;264;72
1813;1;14677;4;1;993;0;527;451;76
1813;1;14685;4;1;2093;2;1318;1105;213
1813;1;14701;4;1;940;3;567;470;97
1813;1;14702;4;1;928;2;595;526;69
1813;1;14707;4;1;527;1;347;290;57
1813;1;14710;4;1;1046;0;625;553;72
1813;1;14716;4;1;268;0;94;82;12
1813;1;14721;4;1;235;0;176;102;74
1813;1;14733;4;1;717;0;386;313;73
1813;12;14681;4;12;283;0;195;161;34
1813;13;14693;4;13;68;0;37;19;18
1813;2;14671;4;2;792;5;417;328;89
1813;2;14682;4;2;911;0;336;289;47
1813;2;14687;4;2;749;0;330;281;49
1813;2;14704;4;2;605;0;285;238;47
1813;2;14706;4;2;761;2;378;349;29
1813;2;14708;4;2;1321;1;630;509;121
1813;2;14713;4;2;676;0;383;343;40
1813;2;14714;4;2;538;0;270;233;37
1813;2;14724;4;2;1436;0;894;717;177
1813;2;14727;4;2;428;2;260;205;55
1813;3;14662;4;3;1463;0;798;688;110
1813;3;14665;4;3;506;0;305;248;57
1813;3;14666;4;3;497;0;293;248;45
1813;3;14668;4;3;816;0;486;393;93
1813;3;14676;4;3;1194;0;725;589;136
1813;3;14695;4;3;698;0;425;344;81
1813;3;14699;4;3;800;1;430;387;43
1813;3;14732;4;3;1260;0;587;497;90
1813;3;14736;4;3;604;0;226;151;75
1813;3;14738;4;3;1344;2;746;621;125
1813;4;14679;4;4;1019;0;519;385;134
1813;4;14683;4;4;1234;0;790;696;94
1813;4;14684;4;4;481;0;235;169;66
1813;4;14686;4;4;395;0;253;224;29
1813;4;14694;4;4;453;0;250;221;29
1813;4;14700;4;4;318;3;217;171;46
1813;4;14709;4;4;595;0;360;336;24
1813;4;14722;4;4;1754;1;966;826;140
1813;4;14725;4;4;646;0;420;341;79
1813;4;14734;4;4;929;0;419;385;34
1813;5;14657;4;5;394;2;276;227;49
1813;5;14659;4;5;386;0;211;182;29
1813;5;14673;4;5;301;0;129;102;27
1813;5;14674;4;5;365;0;194;145;49
1813;5;14680;4;5;530;0;349;305;44
1813;5;14688;4;5;369;0;155;136;19
1813;5;14690;4;5;705;0;369;308;61
1813;5;14697;4;5;1366;0;732;649;83
1813;5;14711;4;5;454;0;263;221;42
1813;5;14718;4;5;394;0;177;140;37
1813;6;14660;4;6;367;1;221;202;19
1813;6;14663;4;6;795;0;395;294;101
1813;6;14667;4;6;324;0;203;177;26
1813;6;14698;4;6;1607;0;798;734;64
1813;6;14705;4;6;341;0;200;163;37
1813;6;14719;4;6;770;0;401;332;69
1813;6;14720;4;6;196;0;85;67;18
1813;6;14735;4;6;605;0;268;227;41
1813;7;14658;4;7;814;0;476;395;81
1813;7;14703;4;7;322;0;143;110;33
1813;7;14712;4;7;251;0;169;143;26
1813;7;14723;4;7;783;0;287;244;43
1813;7;14729;4;7;609;0;362;299;63
1813;7;14730;4;7;401;0;260;193;67
1813;7;14731;4;7;685;0;454;373;81
1813;8;14661;4;8;247;0;158;131;27
1813;8;14678;4;8;395;0;218;164;54
1813;8;14691;4;8;1098;0;610;499;111
1813;8;14692;4;8;381;0;234;204;30
1813;8;14737;4;8;590;1;358;320;38
1813;9;14664;4;9;297;0;214;179;35
1813;9;14669;4;9;944;0;472;424;48
1813;9;14696;4;9;304;0;218;185;33
1813;9;14715;4;9;237;1;142;111;31
1813;9;14726;4;9;1292;5;813;688;125
1814;10;14769;4;10;770;0;385;361;24
1814;10;14794;4;10;643;0;349;305;44
1814;11;14784;4;11;23;0;13;12;1
1814;11;14795;4;11;1442;1;668;587;81
1814;1;14740;4;1;1262;0;791;697;94
1814;1;14747;4;1;617;0;291;246;45
1814;1;14758;4;1;1515;0;975;811;164
1814;1;14770;4;1;2119;2;1153;1058;95
1814;1;14774;4;1;922;2;521;415;106
1814;1;14776;4;1;1236;13;859;762;97
1814;1;14783;4;1;1418;1;822;715;107
1814;1;14802;4;1;342;0;239;192;47
1814;1;14805;4;1;1669;30;1177;795;382
1814;2;14750;4;2;383;0;275;250;25
1814;2;14751;4;2;700;7;493;356;137
1814;2;14765;4;2;657;13;404;309;95
1814;2;14766;4;2;1321;0;577;502;75
1814;2;14778;4;2;944;7;656;511;145
1814;2;14781;4;2;881;0;402;358;44
1814;2;14787;4;2;493;12;352;297;55
1814;2;14793;4;2;991;0;572;465;107
1814;2;14797;4;2;1298;0;627;584;43
1814;3;14754;4;3;367;3;282;222;60
1814;3;14760;4;3;1728;0;880;827;53
1814;3;14761;4;3;364;0;251;209;42
1814;3;14786;4;3;1572;0;714;714;0
1814;3;14789;4;3;973;2;529;471;58
1814;3;14796;4;3;1655;0;901;796;105
1814;3;14798;4;3;1171;8;648;490;158
1814;3;14801;4;3;1256;1;682;579;103
1814;3;14807;4;3;964;2;530;450;80
1814;4;14744;4;4;582;0;322;257;65
1814;4;14746;4;4;647;1;420;376;44
1814;4;14749;4;4;228;0;137;130;7
1814;4;14757;4;4;850;0;516;434;82
1814;4;14767;4;4;1766;0;966;880;86
1814;4;14780;4;4;932;6;543;438;105
1814;4;14782;4;4;569;1;432;393;39
1814;4;14792;4;4;1154;12;865;603;262
1814;4;14800;4;4;580;0;381;332;49
1814;5;14743;4;5;550;1;320;293;27
1814;5;14745;4;5;850;22;529;400;129
1814;5;14752;4;5;249;0;179;155;24
1814;5;14762;4;5;428;5;233;201;32
1814;5;14771;4;5;1062;0;424;424;0
1814;5;14791;4;5;383;0;272;242;30
1814;5;14806;4;5;1916;0;1032;968;64
1814;6;14741;4;6;642;0;376;338;38
1814;6;14753;4;6;598;3;382;312;70
1814;6;14756;4;6;1554;0;694;628;66
1814;6;14759;4;6;1202;1;813;685;128
1814;6;14775;4;6;1727;0;950;898;52
1814;6;14785;4;6;529;0;228;195;33
1814;7;14764;4;7;557;0;274;236;38
1814;7;14773;4;7;550;0;320;241;79
1814;7;14777;4;7;591;1;410;351;59
1814;7;14788;4;7;860;12;480;397;83
1814;7;14790;4;7;1574;3;854;744;110
1814;7;14803;4;7;312;1;209;180;29
1814;8;14739;4;8;1112;0;628;521;107
1814;8;14748;4;8;1768;2;1104;997;107
1814;8;14755;4;8;299;0;197;189;8
1814;8;14763;4;8;1232;0;553;476;77
1814;8;14799;4;8;474;0;239;224;15
1814;9;14742;4;9;546;1;356;323;33
1814;9;14768;4;9;687;0;399;368;31
1814;9;14772;4;9;233;2;190;173;17
1814;9;14779;4;9;1321;1;729;601;128
1814;9;14804;4;9;676;0;402;352;50
1815;10;14839;2;10;579;1;273;219;54
1815;10;14844;2;10;611;0;342;318;24
1815;11;14842;2;11;1202;0;469;430;39
1815;11;14852;2;11;1759;3;952;874;78
1815;1;14808;2;1;1635;2;1002;889;113
1815;1;14833;2;1;1674;2;968;877;91
1815;1;14846;2;1;795;0;500;447;53
1815;1;14861;2;1;686;1;441;420;21
1815;1;14870;2;1;1233;2;831;641;190
1815;12;14826;2;12;651;0;353;329;24
1815;12;14866;2;12;280;2;136;120;16
1815;13;14831;2;13;225;0;139;120;19
1815;13;14871;2;13;561;2;394;333;61
1815;14;14840;2;14;777;0;380;334;46
1815;14;14863;2;14;732;0;402;363;39
1815;15;14817;2;15;963;1;533;490;43
1815;15;14857;2;15;1165;1;489;443;46
1815;16;14835;2;16;306;1;192;180;12
1815;16;14869;2;16;755;0;346;310;36
1815;17;14848;2;17;1044;3;574;490;84
1815;17;14868;2;17;890;2;459;407;52
1815;18;14843;2;18;1127;0;547;479;68
1815;18;14854;2;18;576;2;337;285;52
1815;19;14822;2;19;146;0;91;72;19
1815;19;14849;2;19;1405;4;834;688;146
1815;20;14809;2;20;762;0;452;355;97
1815;20;14823;2;20;98;0;76;74;2
1815;21;14810;2;21;23;0;11;10;1
1815;21;14821;2;21;306;0;191;166;25
1815;2;14830;2;2;1511;0;901;610;291
1815;2;14845;2;2;1770;3;1064;970;94
1815;2;14858;2;2;805;1;452;367;85
1815;2;14860;2;2;601;1;311;289;22
1815;2;14867;2;2;519;1;347;311;36
1815;3;14811;2;3;1158;0;694;624;70
1815;3;14825;2;3;529;1;299;242;57
1815;3;14832;2;3;927;0;480;439;41
1815;3;14856;2;3;1232;0;738;702;36
1815;3;14872;2;3;1525;1;908;822;86
1815;4;14828;2;4;1280;1;753;701;52
1815;4;14838;2;4;982;0;530;475;55
1815;4;14841;2;4;192;2;133;112;21
1815;4;14855;2;4;1538;0;794;717;77
1815;4;14859;2;4;664;1;349;269;80
1815;5;14815;2;5;1972;1;1044;970;74
1815;5;14827;2;5;948;0;528;464;64
1815;5;14834;2;5;341;0;193;175;18
1815;5;14862;2;5;1193;1;602;499;103
1815;5;14865;2;5;959;2;673;530;143
1815;6;14812;2;6;350;0;175;125;50
1815;6;14819;2;6;1048;0;565;511;54
1815;6;14824;2;6;1325;0;717;648;69
1815;6;14836;2;6;677;0;411;361;50
1815;6;14851;2;6;582;0;305;275;30
1815;7;14813;2;7;1257;1;707;650;57
1815;7;14820;2;7;199;3;145;112;33
1815;7;14829;2;7;713;1;387;356;31
1815;7;14847;2;7;1444;1;761;697;64
1815;8;14814;2;8;435;0;277;253;24
1815;8;14818;2;8;631;0;355;322;33
1815;8;14837;2;8;859;4;525;445;80
1815;8;14850;2;8;1516;0;684;606;78
1815;9;14816;2;9;964;0;443;392;51
1815;9;14853;2;9;568;3;339;312;27
1815;9;14864;2;9;899;3;369;369;0
1816;10;14920;1;10;955;0;480;445;35
1816;10;14922;1;10;437;0;213;194;19
1816;10;14944;1;10;154;0;71;54;17
1816;10;14945;1;10;2146;0;1010;939;71
1816;10;14986;1;10;378;0;200;190;10
1816;10;14988;1;10;541;0;274;255;19
1816;11;14894;1;11;1208;0;546;498;48
1816;11;14930;1;11;2292;0;1277;1136;141
1816;11;14957;1;11;269;0;120;91;29
1816;11;14959;1;11;540;0;331;304;27
1816;11;14961;1;11;1295;2;566;524;42
1816;1;14873;1;1;427;0;245;219;26
1816;1;14882;1;1;1778;4;874;766;108
1816;1;14883;1;1;1957;1;1211;977;234
1816;1;14893;1;1;2168;1;1261;1177;84
1816;1;14902;1;1;2394;0;1366;1140;226
1816;1;14911;1;1;1203;0;467;406;61
1816;1;14913;1;1;1748;0;991;858;133
1816;1;14937;1;1;1526;0;764;704;60
1816;1;14938;1;1;1281;4;668;602;66
1816;1;14947;1;1;1488;1;804;685;119
1816;1;14949;1;1;938;0;361;305;56
1816;1;14952;1;1;1813;0;1091;1024;67
1816;1;14972;1;1;2085;1;1203;1004;199
1816;1;14977;1;1;1360;0;747;685;62
1816;12;14875;1;12;1137;0;571;488;83
1816;12;14906;1;12;1307;0;634;583;51
1816;12;14954;1;12;1419;0;862;732;130
1816;13;14926;1;13;406;0;232;201;31
1816;13;14965;1;13;602;0;279;263;16
1816;14;14985;1;14;264;0;168;153;15
1816;15;14898;1;15;2192;0;1277;1171;106
1816;2;14874;1;2;1372;0;772;683;89
1816;2;14884;1;2;346;0;130;115;15
1816;2;14888;1;2;646;0;360;331;29
1816;2;14891;1;2;483;0;259;223;36
1816;2;14892;1;2;1106;0;616;556;60
1816;2;14904;1;2;1475;0;630;575;55
1816;2;14915;1;2;928;1;555;521;34
1816;2;14925;1;2;1405;4;800;679;121
1816;2;14932;1;2;560;0;258;234;24
1816;2;14935;1;2;1275;0;675;555;120
1816;2;14943;1;2;1699;1;790;703;87
1816;2;14984;1;2;1052;0;644;604;40
1816;2;14991;1;2;1264;0;601;525;76
1816;2;14994;1;2;1224;1;713;635;78
1816;3;14889;1;3;1011;0;595;550;45
1816;3;14895;1;3;1362;0;707;603;104
1816;3;14901;1;3;1124;0;438;403;35
1816;3;14903;1;3;1516;0;866;823;43
1816;3;14909;1;3;604;0;286;286;0
1816;3;14919;1;3;846;0;425;372;53
1816;3;14921;1;3;333;0;175;157;18
1816;3;14924;1;3;441;1;248;233;15
1816;3;14976;1;3;1512;1;841;675;166
1816;3;14978;1;3;482;0;170;140;30
1816;3;14981;1;3;1207;1;658;532;126
1816;3;14982;1;3;1084;0;453;411;42
1816;3;14983;1;3;1128;3;706;619;87
1816;3;14987;1;3;1274;0;590;533;57
1816;4;14877;1;4;357;0;231;201;30
1816;4;14886;1;4;891;0;449;410;39
1816;4;14899;1;4;730;0;452;394;58
1816;4;14900;1;4;1221;0;651;564;87
1816;4;14912;1;4;1362;0;599;549;50
1816;4;14927;1;4;587;0;314;260;54
1816;4;14929;1;4;1738;0;821;759;62
1816;4;14939;1;4;1134;0;605;540;65
1816;4;14942;1;4;960;0;471;417;54
1816;4;14946;1;4;711;0;332;267;65
1816;4;14953;1;4;425;0;223;205;18
1816;4;14963;1;4;308;0;108;98;10
1816;4;14973;1;4;316;0;229;211;18
1816;4;14975;1;4;1065;1;466;436;30
1816;5;14876;1;5;632;0;241;208;33
1816;5;14908;1;5;1338;0;744;716;28
1816;5;14910;1;5;1308;0;686;624;62
1816;5;14918;1;5;520;0;280;246;34
1816;5;14931;1;5;444;0;180;166;14
1816;5;14948;1;5;715;0;350;313;37
1816;5;14951;1;5;56;0;46;45;1
1816;5;14955;1;5;539;1;271;238;33
1816;5;14956;1;5;1332;0;666;546;120
1816;5;14958;1;5;297;0;107;100;7
1816;5;14968;1;5;372;0;213;185;28
1816;5;14979;1;5;2198;0;1067;1013;54
1816;5;14993;1;5;1339;0;649;583;66
1816;6;14880;1;6;984;0;535;481;54
1816;6;14887;1;6;1601;3;862;748;114
1816;6;14896;1;6;230;0;126;110;16
1816;6;14897;1;6;352;0;182;126;56
1816;6;14905;1;6;2018;0;925;816;109
1816;6;14907;1;6;1008;0;565;513;52
1816;6;14917;1;6;822;0;534;499;35
1816;6;14923;1;6;411;0;296;254;42
1816;6;14950;1;6;1083;0;520;452;68
1816;6;14969;1;6;1714;0;1052;950;102
1816;6;14989;1;6;2286;0;1140;1025;115
1816;7;14885;1;7;974;0;308;233;75
1816;7;14890;1;7;1231;0;640;575;65
1816;7;14914;1;7;41;0;30;30;0
1816;7;14934;1;7;1084;0;620;568;52
1816;7;14960;1;7;1091;0;566;473;93
1816;7;14962;1;7;776;0;395;368;27
1816;7;14967;1;7;429;0;239;216;23
1816;7;14980;1;7;693;0;343;311;32
1816;7;14990;1;7;2169;0;1151;991;160
1816;8;14878;1;8;871;0;417;368;49
1816;8;14881;1;8;790;0;445;356;89
1816;8;14928;1;8;289;0;201;189;12
1816;8;14933;1;8;1101;0;588;555;33
1816;8;14970;1;8;459;0;236;213;23
1816;8;14971;1;8;399;2;169;130;39
1816;8;14974;1;8;1746;1;759;705;54
1816;8;14992;1;8;1026;1;525;469;56
1816;9;14879;1;9;330;0;179;171;8
1816;9;14916;1;9;1426;0;874;812;62
1816;9;14936;1;9;1499;3;707;629;78
1816;9;14940;1;9;1081;0;503;469;34
1816;9;14941;1;9;477;0;285;263;22
1816;9;14964;1;9;1995;0;909;835;74
1816;9;14966;1;9;715;0;365;313;52
1817;10;14996;5;10;768;2;357;256;101
1817;10;15030;5;10;2139;0;1054;954;100
1817;11;15009;5;11;2097;1;997;921;76
1817;11;15014;5;11;930;0;406;362;44
1817;1;15002;5;1;1826;0;833;701;132
1817;1;15007;5;1;1260;1;594;469;125
1817;1;15016;5;1;1861;4;830;733;97
1817;1;15017;5;1;1590;2;785;672;113
1817;1;15028;5;1;521;0;240;214;26
1817;1;15032;5;1;1532;0;872;617;255
1817;1;15035;5;1;1840;0;1091;901;190
1817;1;15061;5;1;1905;0;1030;872;158
1817;12;15010;5;12;274;0;170;134;36
1817;12;15051;5;12;1934;1;966;879;87
1817;13;15006;5;13;2052;0;994;910;84
1817;13;15047;5;13;198;0;105;90;15
1817;14;14999;5;14;621;0;274;237;37
1817;14;15063;5;14;631;0;303;242;61
1817;15;15020;5;15;1733;0;898;783;115
1817;15;15027;5;15;722;0;342;273;69
1817;16;14995;5;16;1685;0;817;726;91
1817;16;15050;5;16;541;0;269;210;59
1817;17;15044;5;17;2324;0;1126;1022;104
1817;17;15055;5;17;636;0;299;248;51
1817;18;15034;5;18;273;0;128;119;9
1817;18;15057;5;18;987;1;515;479;36
1817;19;15003;5;19;1443;2;760;671;89
1817;20;15059;5;20;35;0;16;15;1
1817;21;15029;5;21;20;0;11;10;1
1817;2;15000;5;2;2319;0;1247;1079;168
1817;2;15004;5;2;1077;0;508;475;33
1817;2;15018;5;2;1311;1;610;542;68
1817;2;15033;5;2;1330;0;842;707;135
1817;2;15037;5;2;1374;0;633;520;113
1817;2;15045;5;2;1681;0;949;872;77
1817;2;15049;5;2;2016;2;985;887;98
1817;22;15024;5;22;5;0;5;5;0
1817;3;15011;5;3;2012;0;1006;938;68
1817;3;15015;5;3;617;0;246;206;40
1817;3;15021;5;3;934;0;607;471;136
1817;3;15025;5;3;1006;0;553;431;122
1817;3;15026;5;3;293;0;129;106;23
1817;3;15043;5;3;637;0;316;274;42
1817;3;15058;5;3;1253;0;602;511;91
1817;4;14997;5;4;288;0;153;110;43
1817;4;15036;5;4;843;1;361;326;35
1817;4;15040;5;4;1645;0;807;730;77
1817;4;15042;5;4;1650;0;978;853;125
1817;4;15054;5;4;1305;0;538;491;47
1817;5;14998;5;5;1122;0;708;608;100
1817;5;15005;5;5;1214;1;590;525;65
1817;5;15012;5;5;363;0;157;123;34
1817;5;15023;5;5;1021;0;480;452;28
1817;5;15053;5;5;827;0;377;316;61
1817;6;15001;5;6;209;0;95;62;33
1817;6;15039;5;6;722;0;354;329;25
1817;6;15048;5;6;1922;0;880;764;116
1817;6;15052;5;6;596;0;290;254;36
1817;6;15056;5;6;1069;0;550;490;60
1817;7;15008;5;7;586;0;291;257;34
1817;7;15013;5;7;1771;0;737;648;89
1817;7;15019;5;7;1032;0;479;362;117
1817;7;15060;5;7;181;0;87;74;13
1817;7;15062;5;7;1096;0;508;394;114
1817;8;15031;5;8;890;0;438;392;46
1817;8;15041;5;8;905;1;524;458;66
1817;8;15046;5;8;1646;0;777;714;63
1817;9;15022;5;9;1319;1;607;544;63
1817;9;15038;5;9;995;2;560;444;116
1818;10;15090;3;10;62;0;57;56;1
1818;10;15097;3;10;2101;0;882;841;41
1818;10;15128;3;10;510;0;289;253;36
1818;11;15127;3;11;1993;0;883;843;40
1818;1;15065;3;1;2347;0;1134;1052;82
1818;1;15099;3;1;1357;0;679;594;85
1818;1;15106;3;1;2012;1;1046;988;58
1818;1;15123;3;1;625;0;320;284;36
1818;1;15129;3;1;1228;2;658;519;139
1818;1;15137;3;1;1029;0;587;507;80
1818;12;15094;3;12;1934;0;890;850;40
1818;13;15114;3;13;1133;1;545;516;29
1818;14;15085;3;14;1922;0;804;749;55
1818;15;15119;3;15;1780;0;736;695;41
1818;16;15073;3;16;1714;0;802;760;42
1818;17;15132;3;17;1704;0;721;674;47
1818;18;15100;3;18;1589;0;740;695;45
1818;19;15080;3;19;1870;0;873;845;28
1818;20;15079;3;20;1757;0;748;686;62
1818;21;15124;3;21;1346;1;613;571;42
1818;2;15082;3;2;799;1;346;312;34
1818;2;15083;3;2;2325;0;918;842;76
1818;2;15096;3;2;469;0;248;214;34
1818;2;15102;3;2;1039;0;570;531;39
1818;2;15104;3;2;1324;1;766;617;149
1818;2;15125;3;2;1154;0;545;453;92
1818;22;15095;3;22;1237;2;606;560;46
1818;23;15117;3;23;1754;2;863;813;50
1818;24;15084;3;24;2166;1;947;866;81
1818;25;15091;3;25;1778;2;788;751;37
1818;26;15113;3;26;1320;0;534;463;71
1818;27;15138;3;27;1723;0;828;769;59
1818;28;15087;3;28;1452;1;614;572;42
1818;29;15066;3;29;1035;0;420;387;33
1818;30;15110;3;30;1812;1;823;761;62
1818;31;15133;3;31;1763;0;725;666;59
1818;3;15072;3;3;1227;1;585;509;76
1818;3;15093;3;3;1128;0;618;501;117
1818;3;15098;3;3;2018;1;990;921;69
1818;3;15101;3;3;225;0;114;89;25
1818;3;15109;3;3;258;0;150;125;25
1818;3;15116;3;3;445;0;184;164;20
1818;32;15134;3;32;2086;1;945;888;57
1818;33;15135;3;33;112;0;72;63;9
1818;34;15086;3;34;85;0;36;27;9
1818;4;15068;3;4;1532;0;651;608;43
1818;4;15075;3;4;1318;0;696;611;85
1818;4;15107;3;4;1212;0;434;394;40
1818;4;15115;3;4;1053;0;534;486;48
1818;4;15118;3;4;287;0;147;122;25
1818;4;15136;3;4;985;0;419;380;39
1818;5;15064;3;5;288;0;159;115;44
1818;5;15076;3;5;1962;0;834;786;48
1818;5;15108;3;5;1074;0;374;335;39
1818;5;15122;3;5;680;0;363;317;46
1818;5;15131;3;5;872;0;318;276;42
1818;5;15139;3;5;701;1;374;329;45
1818;6;15067;3;6;274;0;128;113;15
1818;6;15092;3;6;996;0;405;382;23
1818;6;15111;3;6;1254;0;543;467;76
1818;6;15120;3;6;777;0;483;375;108
1818;6;15130;3;6;387;0;191;161;30
1818;7;15069;3;7;720;2;321;248;73
1818;7;15070;3;7;239;0;115;95;20
1818;7;15074;3;7;1853;1;740;708;32
1818;7;15089;3;7;330;0;139;109;30
1818;7;15126;3;7;505;0;274;247;27
1818;8;15071;3;8;410;0;191;182;9
1818;8;15077;3;8;1047;0;526;456;70
1818;8;15078;3;8;1898;0;850;719;131
1818;8;15081;3;8;1200;1;572;489;83
1818;8;15112;3;8;1012;0;414;384;30
1818;9;15088;3;9;194;0;91;74;17
1818;9;15103;3;9;478;0;227;184;43
1818;9;15105;3;9;2063;0;920;855;65
1818;9;15121;3;9;566;0;234;210;24
1819;10;15183;2;10;703;0;284;262;22
1819;10;15184;2;10;1127;0;473;394;79
1819;10;15189;2;10;816;0;481;414;67
1819;10;15195;2;10;292;0;165;135;30
1819;11;15143;2;11;360;0;206;185;21
1819;11;15173;2;11;724;0;328;315;13
1819;11;15186;2;11;220;0;147;117;30
1819;1;15164;2;1;474;0;319;293;26
1819;1;15177;2;1;1615;0;737;676;61
1819;1;15180;2;1;2367;1;1303;1215;88
1819;1;15196;2;1;1309;0;714;603;111
1819;1;15198;2;1;2122;0;909;814;95
1819;12;15175;2;12;1795;0;693;658;35
1819;12;15197;2;12;195;0;83;62;21
1819;13;15172;2;13;269;0;135;125;10
1819;13;15192;2;13;718;0;383;342;41
1819;14;15145;2;14;136;0;67;58;9
1819;15;15142;2;15;1105;0;459;417;42
1819;16;15146;2;16;589;0;264;240;24
1819;17;15144;2;17;1349;0;735;660;75
1819;18;15152;2;18;823;0;346;283;63
1819;19;15166;2;19;267;0;121;109;12
1819;20;15176;2;20;18;0;10;9;1
1819;2;15150;2;2;683;0;242;212;30
1819;2;15155;2;2;783;0;362;328;34
1819;2;15157;2;2;1469;0;635;569;66
1819;2;15163;2;2;328;0;211;179;32
1819;2;15170;2;2;1939;0;933;878;55
1819;3;15140;2;3;279;0;163;137;26
1819;3;15148;2;3;952;0;497;452;45
1819;3;15165;2;3;894;0;346;285;61
1819;3;15168;2;3;487;0;237;216;21
1819;3;15178;2;3;2168;0;1131;1056;75
1819;4;15156;2;4;994;0;677;563;114
1819;4;15159;2;4;1492;0;631;599;32
1819;4;15160;2;4;342;0;176;164;12
1819;4;15179;2;4;1120;0;465;440;25
1819;4;15191;2;4;193;0;117;100;17
1819;5;15154;2;5;350;0;219;174;45
1819;5;15171;2;5;881;1;474;444;30
1819;5;15182;2;5;640;0;217;176;41
1819;5;15185;2;5;329;0;153;140;13
1819;5;15193;2;5;278;0;126;115;11
1819;6;15151;2;6;1057;0;589;476;113
1819;6;15153;2;6;640;0;298;273;25
1819;6;15161;2;6;676;0;407;374;33
1819;6;15169;2;6;786;0;261;221;40
1819;6;15190;2;6;245;0;115;100;15
1819;7;15141;2;7;331;0;125;109;16
1819;7;15174;2;7;1534;0;671;598;73
1819;7;15187;2;7;1747;0;813;685;128
1819;7;15188;2;7;454;0;259;229;30
1819;7;15200;2;7;647;0;293;258;35
1819;8;15147;2;8;252;0;77;68;9
1819;8;15149;2;8;121;0;70;64;6
1819;8;15162;2;8;462;1;249;224;25
1819;8;15167;2;8;241;0;126;117;9
1819;8;15194;2;8;946;0;493;436;57
1819;9;15158;2;9;465;0;208;190;18
1819;9;15181;2;9;966;0;491;418;73
1819;9;15199;2;9;1273;1;686;606;80
1819;9;15201;2;9;707;0;295;249;46
1820;10;15207;3;10;700;396;396;331;65
1820;10;15246;3;10;189;0;92;71;21
1820;11;15229;3;11;630;0;293;255;38
1820;11;15232;3;11;560;0;283;242;41
1820;1;15202;3;1;1242;0;703;630;73
1820;1;15217;3;1;2010;17;1387;1069;318
1820;1;15239;3;1;1995;0;828;725;103
1820;1;15241;3;1;1859;0;801;714;87
1820;12;15236;3;12;565;0;245;215;30
1820;13;15244;3;13;34;0;24;22;2
1820;14;15242;3;14;20;0;10;9;1
1820;15;15218;3;15;16;0;11;10;1
1820;16;15206;3;16;0;0;0;0;0
1820;17;15212;3;17;2;0;2;0;2
1820;2;15211;3;2;1070;0;416;374;42
1820;2;15219;3;2;1830;0;790;728;62
1820;2;15238;3;2;397;1;232;195;37
1820;2;15240;3;2;2181;0;1163;1024;139
1820;3;15203;3;3;673;0;348;302;46
1820;3;15225;3;3;533;2;414;328;86
1820;3;15230;3;3;1313;0;516;456;60
1820;3;15233;3;3;1226;0;484;440;44
1820;4;15213;3;4;1449;0;786;718;68
1820;4;15221;3;4;1789;0;681;624;57
1820;4;15226;3;4;1039;5;612;449;163
1820;4;15237;3;4;996;0;477;407;70
1820;5;15215;3;5;246;0;162;151;11
1820;5;15222;3;5;1554;0;621;540;81
1820;5;15228;3;5;1501;2;739;643;96
1820;5;15234;3;5;1315;0;693;615;78
1820;6;15205;3;6;160;0;84;75;9
1820;6;15216;3;6;1409;0;574;520;54
1820;6;15224;3;6;686;8;448;395;53
1820;6;15245;3;6;498;2;255;215;40
1820;7;15208;3;7;587;8;408;330;78
1820;7;15214;3;7;1747;0;902;751;151
1820;7;15220;3;7;1675;2;737;652;85
1820;7;15223;3;7;1242;0;717;681;36
1820;8;15204;3;8;1019;17;724;490;234
1820;8;15227;3;8;1224;0;500;452;48
1820;8;15231;3;8;574;0;271;231;40
1820;8;15243;3;8;884;0;464;426;38
1820;9;15209;3;9;1269;0;512;454;58
1820;9;15210;3;9;1576;0;667;589;78
1820;9;15235;3;9;543;0;283;256;27
1821;1;15252;5;1;1322;1;620;525;95
1821;1;15257;5;1;1512;0;804;716;88
1821;1;15258;5;1;1455;3;954;778;176
1821;1;15263;5;1;895;0;560;460;100
1821;1;15272;5;1;671;1;414;347;67
1821;2;15249;5;2;561;0;373;300;73
1821;2;15253;5;2;1668;0;742;618;124
1821;2;15262;5;2;308;0;193;133;60
1821;2;15264;5;2;556;0;335;289;46
1821;2;15265;5;2;1102;0;572;527;45
1821;3;15248;5;3;576;0;229;173;56
1821;3;15260;5;3;589;0;374;299;75
1821;3;15266;5;3;2178;2;1055;964;91
1821;3;15267;5;3;688;0;519;388;131
1821;4;15255;5;4;530;0;239;200;39
1821;4;15261;5;4;446;0;296;249;47
1821;4;15269;5;4;1565;0;701;621;80
1821;5;15251;5;5;725;0;499;422;77
1821;5;15256;5;5;611;0;329;292;37
1821;6;15268;5;6;477;0;319;269;50
1821;6;15270;5;6;730;0;371;331;40
1821;7;15250;5;7;705;0;387;330;57
1821;7;15271;5;7;652;0;451;332;119
1821;8;15247;5;8;1087;0;504;412;92
1821;8;15254;5;8;421;0;273;233;40
1821;9;15259;5;9;17;0;9;9;0
1861;10;15298;5;10;1483;0;772;743;29
1861;11;15290;5;11;1285;0;622;586;36
1861;1;15283;5;1;2221;0;1007;952;55
1861;12;15297;5;12;512;0;233;224;9
1861;13;15287;5;13;1699;3;828;781;47
1861;14;15273;5;14;1898;0;893;834;59
1861;15;15289;5;15;1491;0;684;646;38
1861;16;15279;5;16;1792;0;725;677;48
1861;17;15284;5;17;2166;0;955;886;69
1861;18;15292;5;18;1778;0;744;699;45
1861;19;15285;5;19;2311;0;1245;1164;81
1861;20;15288;5;20;1825;0;862;816;46
1861;21;15282;5;21;2096;0;969;892;77
1861;2;15293;5;2;1937;0;769;722;47
1861;22;15274;5;22;1878;1;893;857;36
1861;23;15295;5;23;2028;0;945;899;46
1861;24;15275;5;24;73;0;48;45;3
1861;25;15276;5;25;67;0;26;22;4
1861;26;15286;5;26;13;0;2;2;0
1861;3;15280;5;3;1896;0;861;808;53
1861;4;15278;5;4;1220;0;609;571;38
1861;5;15296;5;5;1384;0;646;600;46
1861;6;15294;5;6;1692;0;774;732;42
1861;7;15281;5;7;2255;0;989;913;76
1861;8;15291;5;8;1390;1;610;575;35
1861;9;15277;5;9;777;0;360;334;26
1862;10;15317;4;10;2184;0;1013;941;72
1862;11;15321;4;11;1981;0;936;893;43
1862;1;15312;4;1;1023;0;455;413;42
1862;12;15336;4;12;2200;1;1056;978;78
1862;13;15319;4;13;1928;2;930;854;76
1862;14;15323;4;14;2381;0;1118;1118;0
1862;15;15322;4;15;1886;2;966;878;88
1862;16;15304;4;16;1816;0;903;864;39
1862;17;15335;4;17;1155;0;538;482;56
1862;18;15328;4;18;2258;0;900;814;86
1862;19;15329;4;19;1344;0;599;553;46
1862;20;15320;4;20;2044;1;966;863;103
1862;21;15302;4;21;1233;2;485;437;48
1862;2;15318;4;2;2012;1;951;867;84
1862;22;15326;4;22;1211;0;580;526;54
1862;23;15300;4;23;2135;0;842;765;77
1862;24;15316;4;24;1377;0;595;521;74
1862;25;15327;4;25;1762;0;745;681;64
1862;26;15305;4;26;945;0;363;302;61
1862;27;15311;4;27;2053;5;864;802;62
1862;28;15299;4;28;1873;0;832;776;56
1862;29;15306;4;29;2190;0;1046;994;52
1862;30;15314;4;30;1372;0;589;537;52
1862;31;15301;4;31;497;0;203;179;24
1862;3;15308;4;3;2129;0;986;906;80
1862;32;15310;4;32;66;0;48;46;2
1862;33;15337;4;33;16;0;8;7;1
1862;34;15325;4;34;64;0;45;37;8
1862;35;15307;4;35;28;0;28;28;0
1862;36;15331;4;36;38;0;27;13;14
1862;37;15313;4;37;103;0;47;41;6
1862;38;15324;4;38;63;0;35;33;2
1862;39;15333;4;39;22;0;7;7;0
1862;4;15330;4;4;1734;0;849;769;80
1862;5;15309;4;5;984;0;456;433;23
1862;6;15315;4;6;1719;3;834;762;72
1862;7;15303;4;7;904;0;458;428;30
1862;8;15334;4;8;2111;0;1023;920;103
1862;9;15332;4;9;2239;0;1154;1080;74
1863;10;15428;1;10;1418;0;647;613;34
1863;11;15427;1;11;1758;0;878;838;40
1863;1;15417;1;1;1906;1;740;709;31
1863;12;15386;1;12;1633;0;738;705;33
1863;13;15373;1;13;1683;0;826;778;48
1863;14;15383;1;14;2446;0;1193;1117;76
1863;15;15376;1;15;1511;0;694;666;28
1863;16;15399;1;16;1939;0;841;820;21
1863;17;15381;1;17;967;0;377;337;40
1863;18;15358;1;18;1897;0;771;708;63
1863;19;15339;1;19;1619;0;839;781;58
1863;20;15350;1;20;1666;0;793;748;45
1863;21;15394;1;21;1914;0;954;868;86
1863;2;15387;1;2;1944;0;763;723;40
1863;22;15341;1;22;1554;0;863;863;0
1863;23;15342;1;23;1982;1;870;811;59
1863;24;15414;1;24;1221;1;583;553;30
1863;25;15412;1;25;1833;0;879;852;27
1863;26;15351;1;26;1733;0;863;826;37
1863;27;15352;1;27;1454;0;737;701;36
1863;28;15345;1;28;1614;1;856;822;34
1863;29;15343;1;29;2113;0;1004;930;74
1863;30;15423;1;30;2313;0;1308;1275;33
1863;31;15407;1;31;1872;0;982;972;10
1863;3;15338;1;3;1739;1;747;710;37
1863;32;15389;1;32;1796;0;825;781;44
1863;33;15409;1;33;1140;0;503;477;26
1863;34;15384;1;34;1833;0;1067;1037;30
1863;35;15348;1;35;1927;0;1109;1084;25
1863;36;15398;1;36;1962;0;946;907;39
1863;37;15397;1;37;1778;0;791;757;34
1863;38;15366;1;38;1283;0;641;591;50
1863;39;15421;1;39;1067;0;461;434;27
1863;40;15346;1;40;2020;0;887;835;52
1863;41;15382;1;41;1551;0;754;710;44
1863;4;15404;1;4;1061;1;469;445;24
1863;42;15405;1;42;1700;0;771;739;32
1863;43;15429;1;43;1429;0;707;652;55
1863;44;15385;1;44;1529;0;675;616;59
1863;45;15356;1;45;1733;0;905;858;47
1863;46;15354;1;46;1479;0;811;768;43
1863;47;15340;1;47;1499;2;715;677;38
1863;48;15349;1;48;1306;0;660;640;20
1863;49;15377;1;49;2171;1;970;937;33
1863;50;15364;1;50;2039;0;941;903;38
1863;51;15416;1;51;2111;0;988;939;49
1863;5;15355;1;5;1736;0;810;745;65
1863;52;15359;1;52;1829;0;954;919;35
1863;53;15395;1;53;2022;0;926;873;53
1863;54;15361;1;54;2174;3;914;871;43
1863;55;15378;1;55;1980;0;1074;1027;47
1863;56;15363;1;56;909;0;358;339;19
1863;57;15400;1;57;1623;0;797;763;34
1863;58;15418;1;58;1797;0;860;860;0
1863;59;15353;1;59;1143;0;590;573;17
1863;60;15392;1;60;2290;1;1215;1160;55
1863;61;15422;1;61;2108;0;1149;1107;42
1863;6;15365;1;6;1935;0;927;882;45
1863;62;15396;1;62;1794;0;907;907;0
1863;63;15419;1;63;2078;0;1107;1042;65
1863;64;15401;1;64;1923;0;1016;962;54
1863;65;15408;1;65;1896;0;940;892;48
1863;66;15374;1;66;1563;0;810;768;42
1863;67;15393;1;67;1506;0;740;706;34
1863;68;15391;1;68;1540;0;791;737;54
1863;69;15379;1;69;1414;0;739;706;33
1863;70;15362;1;70;1440;2;803;755;48
1863;71;15375;1;71;1117;0;577;543;34
1863;7;15357;1;7;1900;1;930;891;39
1863;72;15403;1;72;1322;0;602;548;54
1863;73;15424;1;73;2019;0;1034;992;42
1863;74;15347;1;74;1173;1;565;524;41
1863;75;15415;1;75;1330;2;779;716;63
1863;76;15426;1;76;1212;0;559;531;28
1863;77;15344;1;77;1507;0;852;754;98
1863;78;15425;1;78;1451;0;776;749;27
1863;79;15370;1;79;1699;0;886;829;57
1863;80;15410;1;80;563;0;339;328;11
1863;81;15420;1;81;1709;0;854;769;85
1863;8;15413;1;8;1904;0;838;808;30
1863;82;15369;1;82;1593;0;969;921;48
1863;83;15411;1;83;881;0;476;451;25
1863;84;15360;1;84;1305;0;696;670;26
1863;85;15372;1;85;71;0;19;18;1
1863;86;15402;1;86;123;0;12;12;0
1863;87;15406;1;87;22;0;2;1;1
1863;88;15390;1;88;20;0;6;6;0
1863;89;15371;1;89;34;0;11;11;0
1863;90;15388;1;90;85;0;45;36;9
1863;91;15380;1;91;42;0;13;8;5
1863;9;15368;1;9;1219;0;619;589;30
1863;92;15367;1;92;87;0;36;34;2
1864;10;15449;3;10;813;0;385;357;28
1864;11;15434;3;11;570;0;326;310;16
1864;1;15452;3;1;1814;0;786;752;34
1864;12;15456;3;12;1251;0;637;618;19
1864;13;15453;3;13;1606;0;809;752;57
1864;14;15436;3;14;1480;0;688;651;37
1864;15;15442;3;15;839;2;488;463;25
1864;16;15439;3;16;134;0;89;83;6
1864;17;15438;3;17;390;0;260;242;18
1864;18;15457;3;18;2142;2;1082;1013;69
1864;19;15430;3;19;1880;1;906;837;69
1864;20;15433;3;20;2013;1;966;894;72
1864;21;15461;3;21;414;0;188;171;17
1864;2;15454;3;2;2022;1;909;848;61
1864;22;15437;3;22;943;0;467;426;41
1864;23;15459;3;23;1478;1;643;600;43
1864;24;15441;3;24;1760;2;947;908;39
1864;25;15445;3;25;1101;0;557;535;22
1864;26;15431;3;26;1747;12;882;771;111
1864;27;15450;3;27;1289;2;579;521;58
1864;28;15444;3;28;725;1;444;402;42
1864;29;15451;3;29;411;0;231;215;16
1864;30;15440;3;30;1249;1;677;600;77
1864;31;15447;3;31;54;0;25;22;3
1864;3;15458;3;3;1330;1;579;543;36
1864;32;15435;3;32;96;0;42;38;4
1864;4;15446;3;4;1659;0;751;713;38
1864;5;15432;3;5;1808;0;798;752;46
1864;6;15443;3;6;1819;1;775;723;52
1864;7;15455;3;7;1900;1;822;787;35
1864;8;15460;3;8;1811;22;887;828;59
1864;9;15448;3;9;1775;0;785;736;49
2001;10;15487;2;10;1015;3;446;421;25
2001;11;15475;2;11;2266;2;941;871;70
2001;1;15466;2;1;2119;0;811;725;86
2001;1;15473;2;1;1261;0;720;648;72
2001;1;15474;2;1;1487;0;960;842;118
2001;1;15477;2;1;2311;0;1040;908;132
2001;1;15479;2;1;1913;0;818;697;121
2001;1;15482;2;1;1142;5;790;719;71
2001;1;15486;2;1;850;0;428;390;38
2001;12;15480;2;12;763;1;305;291;14
2001;13;15491;2;13;1735;0;762;708;54
2001;14;15499;2;14;670;0;293;273;20
2001;15;15476;2;15;1136;0;525;493;32
2001;16;15496;2;16;2057;0;880;825;55
2001;17;15483;2;17;34;0;11;8;3
2001;2;15463;2;2;654;0;385;323;62
2001;2;15467;2;2;710;0;259;244;15
2001;2;15468;2;2;859;0;378;307;71
2001;2;15478;2;2;1373;0;634;586;48
2001;2;15481;2;2;638;0;376;309;67
2001;2;15493;2;2;654;0;456;411;45
2001;2;15498;2;2;1141;0;481;415;66
2001;3;15465;2;3;1407;0;525;475;50
2001;3;15470;2;3;665;0;422;343;79
2001;3;15471;2;3;1432;0;597;529;68
2001;3;15489;2;3;1587;0;627;581;46
2001;3;15490;2;3;596;0;382;339;43
2001;3;15495;2;3;1385;0;508;434;74
2001;4;15469;2;4;641;0;253;234;19
2001;4;15484;2;4;2122;1;1214;1083;131
2001;4;15494;2;4;1320;0;511;451;60
2001;5;15485;2;5;943;0;393;327;66
2001;5;15488;2;5;1003;0;407;375;32
2001;6;15492;2;6;583;0;197;177;20
2001;6;15497;2;6;1401;1;529;476;53
2001;7;15462;2;7;2220;0;886;825;61
2001;8;15472;2;8;1801;0;715;664;51
2001;9;15464;2;9;2084;0;897;827;70
2002;10;15509;5;10;1964;0;1019;961;58
2002;10;15545;5;10;197;0;23;23;0
2002;10;15580;5;10;66;0;42;30;12
2002;11;15582;5;11;1903;1;903;847;56
2002;11;15603;5;11;88;0;68;54;14
2002;1;15504;5;1;1805;1;887;786;101
2002;1;15505;5;1;2249;1;993;890;103
2002;1;15510;5;1;1599;1;884;747;137
2002;1;15512;5;1;1889;2;1132;1004;128
2002;1;15513;5;1;1353;0;530;455;75
2002;1;15514;5;1;2171;0;1079;966;113
2002;1;15529;5;1;1979;2;1103;989;114
2002;1;15552;5;1;1166;0;713;590;123
2002;1;15553;5;1;1585;2;826;683;143
2002;1;15559;5;1;816;0;419;380;39
2002;1;15563;5;1;1612;21;1020;913;107
2002;1;15569;5;1;885;0;584;480;104
2002;1;15571;5;1;1956;1;940;803;137
2002;1;15586;5;1;1127;0;482;436;46
2002;1;15601;5;1;1343;4;864;765;99
2002;12;15537;5;12;1527;1;744;702;42
2002;13;15594;5;13;858;0;437;415;22
2002;14;15511;5;14;84;0;54;49;5
2002;15;15527;5;15;18;0;12;11;1
2002;2;15503;5;2;1076;0;354;315;39
2002;2;15516;5;2;1023;1;586;472;114
2002;2;15523;5;2;1429;0;881;768;113
2002;2;15533;5;2;1331;0;520;448;72
2002;2;15549;5;2;1792;0;756;682;74
2002;2;15550;5;2;1642;12;995;856;139
2002;2;15551;5;2;698;0;341;320;21
2002;2;15555;5;2;773;0;501;454;47
2002;2;15558;5;2;299;0;189;164;25
2002;2;15566;5;2;806;0;421;344;77
2002;2;15567;5;2;575;0;266;215;51
2002;2;15568;5;2;1801;0;1015;878;137
2002;2;15591;5;2;1177;0;580;509;71
2002;2;15596;5;2;1697;0;814;754;60
2002;2;15598;5;2;2158;5;1081;945;136
2002;3;15515;5;3;1403;0;801;712;89
2002;3;15520;5;3;2182;2;1026;937;89
2002;3;15534;5;3;779;0;336;303;33
2002;3;15543;5;3;1784;1;852;733;119
2002;3;15544;5;3;1400;0;658;605;53
2002;3;15546;5;3;229;0;150;138;12
2002;3;15556;5;3;714;0;319;254;65
2002;3;15572;5;3;259;4;133;122;11
2002;3;15573;5;3;1646;2;762;673;89
2002;3;15579;5;3;1890;1;1005;896;109
2002;3;15587;5;3;254;0;79;72;7
2002;3;15593;5;3;797;0;313;273;40
2002;3;15600;5;3;437;1;259;235;24
2002;3;15605;5;3;1378;1;712;642;70
2002;4;15506;5;4;1184;0;611;534;77
2002;4;15518;5;4;206;0;93;77;16
2002;4;15521;5;4;1040;0;537;454;83
2002;4;15536;5;4;461;0;181;168;13
2002;4;15539;5;4;276;0;138;105;33
2002;4;15557;5;4;259;0;84;57;27
2002;4;15562;5;4;522;0;246;195;51
2002;4;15565;5;4;245;0;160;136;24
2002;4;15570;5;4;407;0;218;185;33
2002;4;15576;5;4;1296;0;533;462;71
2002;4;15584;5;4;394;0;228;209;19
2002;4;15597;5;4;892;0;465;401;64
2002;4;15604;5;4;884;0;347;278;69
2002;5;15500;5;5;1503;0;724;570;154
2002;5;15508;5;5;1234;0;637;559;78
2002;5;15522;5;5;404;6;219;175;44
2002;5;15524;5;5;540;0;259;212;47
2002;5;15538;5;5;1982;849;849;782;67
2002;5;15541;5;5;238;0;58;53;5
2002;5;15548;5;5;1175;0;471;398;73
2002;5;15560;5;5;1126;0;501;439;62
2002;5;15577;5;5;1184;0;647;604;43
2002;5;15583;5;5;1678;0;775;706;69
2002;5;15585;5;5;415;0;220;197;23
2002;6;15502;5;6;1319;0;651;572;79
2002;6;15526;5;6;1762;0;680;633;47
2002;6;15528;5;6;599;2;314;261;53
2002;6;15530;5;6;1626;0;732;664;68
2002;6;15531;5;6;1279;0;678;650;28
2002;6;15554;5;6;430;9;231;193;38
2002;6;15561;5;6;789;0;295;258;37
2002;6;15575;5;6;511;0;286;261;25
2002;6;15588;5;6;1358;1;822;713;109
2002;6;15595;5;6;437;0;156;133;23
2002;7;15501;5;7;1142;0;560;508;52
2002;7;15507;5;7;792;0;369;305;64
2002;7;15525;5;7;2187;0;1005;984;21
2002;7;15532;5;7;979;0;400;383;17
2002;7;15535;5;7;775;1;303;262;41
2002;7;15542;5;7;2032;0;852;771;81
2002;7;15547;5;7;320;0;114;100;14
2002;7;15578;5;7;1323;0;566;513;53
2002;7;15592;5;7;432;0;214;184;30
2002;7;15599;5;7;2316;0;1086;1011;75
2002;8;15519;5;8;2098;0;1060;1001;59
2002;8;15574;5;8;88;0;64;57;7
2002;8;15581;5;8;919;0;383;350;33
2002;8;15589;5;8;506;0;211;179;32
2002;8;15590;5;8;280;0;161;146;15
2002;8;15602;5;8;693;4;338;262;76
2002;9;15517;5;9;318;2;184;154;30
2002;9;15540;5;9;883;0;448;390;58
2002;9;15564;5;9;1687;0;937;890;47
2003;10;15635;4;10;1941;0;965;903;62
2003;11;15633;4;11;1828;0;817;763;54
2003;1;15610;4;1;1287;7;734;658;76
2003;1;15611;4;1;1634;4;1022;935;87
2003;1;15612;4;1;636;1;330;312;18
2003;1;15615;4;1;539;1;317;277;40
2003;1;15640;4;1;831;0;436;343;93
2003;1;15642;4;1;1213;0;511;455;56
2003;1;15645;4;1;442;0;225;207;18
2003;1;15653;4;1;1213;3;748;598;150
2003;12;15648;4;12;1975;0;909;860;49
2003;13;15644;4;13;1117;0;417;369;48
2003;14;15618;4;14;37;0;17;14;3
2003;2;15619;4;2;384;0;207;189;18
2003;2;15620;4;2;1469;4;909;833;76
2003;2;15622;4;2;1626;7;1041;965;76
2003;2;15627;4;2;561;0;332;281;51
2003;2;15629;4;2;371;0;241;213;28
2003;2;15631;4;2;1183;0;494;458;36
2003;2;15646;4;2;557;0;265;242;23
2003;2;15647;4;2;929;1;449;406;43
2003;3;15616;4;3;94;0;60;46;14
2003;3;15626;4;3;820;3;499;445;54
2003;3;15628;4;3;1769;0;862;764;98
2003;3;15632;4;3;1050;0;527;484;43
2003;3;15637;4;3;822;1;334;323;11
2003;3;15643;4;3;734;0;427;378;49
2003;3;15649;4;3;555;0;360;285;75
2003;4;15607;4;4;471;1;245;194;51
2003;4;15608;4;4;1873;0;912;854;58
2003;4;15625;4;4;562;6;337;308;29
2003;4;15638;4;4;326;0;191;187;4
2003;4;15651;4;4;452;0;268;248;20
2003;4;15652;4;4;1529;4;834;785;49
2003;5;15613;4;5;2069;0;837;766;71
2003;5;15614;4;5;1672;4;993;904;89
2003;5;15630;4;5;506;1;285;250;35
2003;5;15634;4;5;929;1;609;569;40
2003;6;15606;4;6;1645;0;701;654;47
2003;6;15636;4;6;676;0;394;380;14
2003;6;15654;4;6;850;0;391;350;41
2003;7;15609;4;7;1991;0;850;778;72
2003;7;15623;4;7;712;0;410;362;48
2003;7;15641;4;7;837;0;488;442;46
2003;8;15617;4;8;432;4;203;196;7
2003;8;15624;4;8;2188;1;959;885;74
2003;8;15650;4;8;441;0;255;227;28
2003;9;15621;4;9;1295;2;632;588;44
2003;9;15639;4;9;290;0;191;181;10
2004;10;15688;3;10;1930;0;939;880;59
2004;11;15668;3;11;2113;2;1057;974;83
2004;1;15658;3;1;919;0;420;355;65
2004;1;15667;3;1;1773;1;886;807;79
2004;1;15673;3;1;1579;0;863;756;107
2004;1;15683;3;1;348;0;191;172;19
2004;1;15687;3;1;1804;3;925;812;113
2004;1;15690;3;1;1078;3;619;518;101
2004;12;15656;3;12;21;0;13;10;3
2004;2;15662;3;2;1342;1;835;728;107
2004;2;15675;3;2;2012;2;901;821;80
2004;2;15676;3;2;580;0;320;272;48
2004;2;15678;3;2;887;0;451;371;80
2004;2;15684;3;2;873;0;491;420;71
2004;2;15691;3;2;987;0;571;454;117
2004;3;15660;3;3;623;0;313;250;63
2004;3;15661;3;3;453;0;196;158;38
2004;3;15669;3;3;1720;3;853;743;110
2004;3;15679;3;3;615;2;351;319;32
2004;3;15680;3;3;639;0;338;290;48
2004;3;15686;3;3;1057;0;614;544;70
2004;4;15664;3;4;511;0;251;185;66
2004;4;15670;3;4;1478;1;768;624;144
2004;4;15672;3;4;655;0;334;279;55
2004;4;15677;3;4;805;0;400;349;51
2004;4;15685;3;4;1291;2;668;619;49
2004;4;15692;3;4;580;0;306;260;46
2004;5;15657;3;5;969;0;468;420;48
2004;5;15659;3;5;1053;0;516;463;53
2004;5;15671;3;5;614;0;334;284;50
2004;5;15674;3;5;771;0;497;414;83
2004;5;15681;3;5;508;0;251;218;33
2004;6;15663;3;6;1591;1;783;687;96
2004;6;15665;3;6;580;0;320;252;68
2004;6;15682;3;6;576;0;296;242;54
2004;7;15655;3;7;1343;0;628;550;78
2004;8;15689;3;8;1525;0;716;659;57
2004;9;15666;3;9;1669;1;751;669;82
2005;10;15717;5;10;1620;0;788;714;74
2005;11;15727;5;11;1281;1;593;531;62
2005;1;15697;5;1;1733;6;1084;941;143
2005;1;15710;5;1;739;17;453;395;58
2005;1;15718;5;1;2298;0;1164;1089;75
2005;1;15720;5;1;1927;13;1220;1099;121
2005;1;15725;5;1;1121;5;664;617;47
2005;1;15728;5;1;925;0;602;512;90
2005;1;15732;5;1;1429;3;891;746;145
2005;1;15734;5;1;2148;11;1434;1083;351
2005;1;15736;5;1;1725;1;1025;862;163
2005;12;15715;5;12;2181;0;1117;1005;112
2005;13;15693;5;13;49;0;18;15;3
2005;14;15714;5;14;16;0;4;3;1
2005;15;15705;5;15;15;0;10;9;1
2005;2;15694;5;2;591;5;295;257;38
2005;2;15695;5;2;1488;0;722;635;87
2005;2;15700;5;2;939;0;607;420;187
2005;2;15702;5;2;635;1;395;326;69
2005;2;15706;5;2;218;0;125;91;34
2005;2;15716;5;2;521;1;208;193;15
2005;2;15719;5;2;588;1;323;306;17
2005;2;15721;5;2;278;1;151;125;26
2005;2;15735;5;2;461;0;295;226;69
2005;3;15703;5;3;933;5;495;446;49
2005;3;15707;5;3;275;0;191;147;44
2005;3;15708;5;3;324;0;218;198;20
2005;3;15709;5;3;570;0;252;224;28
2005;3;15712;5;3;1640;0;816;753;63
2005;3;15713;5;3;420;1;212;175;37
2005;3;15731;5;3;304;2;173;146;27
2005;3;15733;5;3;51;0;25;12;13
2005;4;15696;5;4;535;3;267;231;36
2005;4;15699;5;4;311;1;120;117;3
2005;4;15701;5;4;1164;0;500;435;65
2005;4;15704;5;4;430;1;281;248;33
2005;4;15737;5;4;579;3;317;277;40
2005;5;15723;5;5;306;1;120;106;14
2005;5;15726;5;5;457;0;274;226;48
2005;5;15730;5;5;1570;1;721;650;71
2005;6;15698;5;6;1125;0;520;465;55
2005;6;15729;5;6;492;0;320;266;54
2005;7;15724;5;7;1213;0;564;535;29
2005;8;15722;5;8;1693;0;762;697;65
2005;9;15711;5;9;1419;3;641;581;60
2006;10;15746;3;10;541;0;326;278;48
2006;1;15741;3;1;826;0;490;381;109
2006;1;15748;3;1;768;0;373;319;54
2006;1;15755;3;1;1983;2;1036;788;248
2006;1;15758;3;1;2101;4;1190;1024;166
2006;1;15761;3;1;1188;1;614;514;100
2006;1;15765;3;1;614;0;335;291;44
2006;2;15740;3;2;1039;0;434;355;79
2006;2;15742;3;2;626;0;353;310;43
2006;2;15766;3;2;1387;1;782;624;158
2006;2;15767;3;2;1823;0;979;876;103
2006;2;15771;3;2;643;0;354;271;83
2006;2;15772;3;2;978;0;590;494;96
2006;3;15739;3;3;474;0;256;226;30
2006;3;15747;3;3;1104;0;628;557;71
2006;3;15749;3;3;799;0;472;420;52
2006;3;15753;3;3;1389;2;743;579;164
2006;3;15762;3;3;319;0;167;145;22
2006;3;15769;3;3;1207;1;683;599;84
2006;4;15751;3;4;683;0;405;320;85
2006;4;15752;3;4;1002;0;470;419;51
2006;4;15754;3;4;466;0;216;171;45
2006;4;15756;3;4;252;0;96;87;9
2006;4;15768;3;4;581;0;296;253;43
2006;5;15738;3;5;702;3;457;368;89
2006;5;15760;3;5;605;0;355;314;41
2006;5;15763;3;5;1137;0;516;469;47
2006;6;15743;3;6;1161;0;576;507;69
2006;6;15757;3;6;417;0;201;151;50
2006;6;15770;3;6;650;0;457;411;46
2006;7;15745;3;7;283;5;209;169;40
2006;7;15750;3;7;1979;0;1009;920;89
2006;7;15759;3;7;558;0;305;267;38
2006;8;15744;3;8;431;0;246;228;18
2006;9;15764;3;9;1220;0;738;659;79
2007;10;15796;3;10;397;0;251;218;33
2007;11;15802;3;11;803;0;465;434;31
2007;1;15774;3;1;558;1;273;251;22
2007;1;15775;3;1;521;0;279;251;28
2007;1;15782;3;1;411;0;259;224;35
2007;1;15789;3;1;1447;2;812;652;160
2007;1;15795;3;1;1805;0;995;892;103
2007;1;15803;3;1;453;0;204;177;27
2007;1;15814;3;1;968;0;517;436;81
2007;1;15818;3;1;1210;0;698;522;176
2007;1;15820;3;1;589;1;316;275;41
2007;12;15815;3;12;572;9;353;302;51
2007;13;15798;3;13;341;2;188;163;25
2007;2;15773;3;2;253;0;172;158;14
2007;2;15784;3;2;547;0;298;265;33
2007;2;15791;3;2;842;3;375;340;35
2007;2;15792;3;2;801;0;475;419;56
2007;2;15794;3;2;1110;0;559;465;94
2007;2;15797;3;2;1138;0;611;544;67
2007;2;15807;3;2;1401;1;627;567;60
2007;2;15808;3;2;911;3;552;481;71
2007;2;15819;3;2;403;0;231;195;36
2007;3;15779;3;3;1198;0;563;458;105
2007;3;15780;3;3;507;4;306;281;25
2007;3;15783;3;3;351;0;179;155;24
2007;3;15786;3;3;1778;0;1106;1003;103
2007;3;15787;3;3;1672;0;905;764;141
2007;3;15788;3;3;1029;0;581;530;51
2007;3;15793;3;3;722;0;381;335;46
2007;3;15809;3;3;1073;1;496;399;97
2007;3;15812;3;3;1219;0;759;673;86
2007;4;15776;3;4;1192;0;694;617;77
2007;4;15781;3;4;824;1;420;372;48
2007;4;15799;3;4;940;0;524;407;117
2007;4;15804;3;4;1450;0;900;807;93
2007;4;15806;3;4;873;1;405;342;63
2007;4;15810;3;4;900;1;485;428;57
2007;4;15816;3;4;866;0;437;393;44
2007;5;15777;3;5;418;0;234;179;55
2007;5;15778;3;5;564;0;322;292;30
2007;5;15790;3;5;1009;0;545;471;74
2007;5;15817;3;5;299;0;168;157;11
2007;6;15800;3;6;512;0;254;213;41
2007;6;15813;3;6;1075;4;570;530;40
2007;7;15801;3;7;524;1;283;250;33
2007;7;15821;3;7;536;0;261;200;61
2007;8;15785;3;8;1190;0;568;462;106
2007;8;15805;3;8;422;0;196;164;32
2007;9;15811;3;9;478;0;237;213;24
2008;10;15842;5;10;42;0;9;7;2
2008;1;15824;5;1;2034;8;1192;998;194
2008;1;15827;5;1;1314;0;693;562;131
2008;1;15831;5;1;2236;3;1193;972;221
2008;1;15832;5;1;1929;0;708;668;40
2008;1;15845;5;1;1284;0;683;597;86
2008;1;15848;5;1;1758;5;1071;911;160
2008;1;15850;5;1;1697;2;858;776;82
2008;2;15828;5;2;1080;4;594;493;101
2008;2;15829;5;2;1354;0;694;547;147
2008;2;15830;5;2;1724;0;838;706;132
2008;2;15839;5;2;1050;1;536;446;90
2008;2;15844;5;2;1186;5;672;544;128
2008;2;15847;5;2;686;1;376;323;53
2008;2;15852;5;2;983;0;322;283;39
2008;3;15826;5;3;1598;9;816;723;93
2008;3;15833;5;3;1539;0;598;530;68
2008;3;15835;5;3;778;12;451;368;83
2008;3;15836;5;3;536;0;277;221;56
2008;3;15843;5;3;646;5;355;267;88
2008;4;15822;5;4;38;0;31;23;8
2008;4;15823;5;4;443;1;288;237;51
2008;4;15825;5;4;1619;2;751;667;84
2008;4;15834;5;4;396;0;215;191;24
2008;4;15846;5;4;646;0;277;204;73
2008;5;15840;5;5;1773;7;893;813;80
2008;5;15841;5;5;470;0;219;197;22
2008;6;15838;5;6;1831;3;833;712;121
2008;7;15837;5;7;973;0;487;424;63
2008;8;15849;5;8;724;0;274;247;27
2008;9;15851;5;9;834;0;406;343;63
2009;1;15857;2;1;1614;4;939;819;120
2009;1;15861;2;1;1542;1;803;754;49
2009;1;15863;2;1;1562;1;790;726;64
2009;1;15868;2;1;1470;0;521;458;63
2009;1;15874;2;1;911;5;617;574;43
2009;2;15858;2;2;1515;2;812;784;28
2009;2;15862;2;2;447;3;297;275;22
2009;2;15871;2;2;468;0;155;146;9
2009;2;15872;2;2;420;0;129;120;9
2009;2;15873;2;2;717;0;354;312;42
2009;3;15854;2;3;485;0;276;260;16
2009;3;15855;2;3;398;0;195;179;16
2009;3;15859;2;3;695;0;336;317;19
2009;3;15860;2;3;420;0;164;142;22
2009;3;15864;2;3;1613;10;913;868;45
2009;4;15856;2;4;259;0;151;123;28
2009;4;15865;2;4;4;0;2;2;0
2009;4;15866;2;4;481;0;206;183;23
2009;4;15867;2;4;238;0;132;119;13
2009;4;15870;2;4;958;1;581;539;42
2009;5;15853;2;5;323;0;190;160;30
2009;5;15869;2;5;742;0;388;325;63
2010;10;15914;4;10;17;0;6;6;0
2010;1;15881;4;1;486;0;284;243;41
2010;1;15886;4;1;886;5;611;530;81
2010;1;15890;4;1;1191;3;651;548;103
2010;1;15904;4;1;1854;0;975;902;73
2010;1;15906;4;1;435;0;163;131;32
2010;1;15907;4;1;534;0;343;253;90
2010;1;15913;4;1;1827;0;1005;875;130
2010;1;15915;4;1;190;0;101;79;22
2010;1;15920;4;1;1419;0;705;568;137
2010;2;15883;4;2;635;3;371;323;48
2010;2;15885;4;2;1069;0;626;531;95
2010;2;15892;4;2;1272;0;593;515;78
2010;2;15895;4;2;1199;6;831;690;141
2010;2;15898;4;2;1719;1;869;784;85
2010;2;15902;4;2;1255;0;626;597;29
2010;2;15908;4;2;719;0;354;312;42
2010;2;15916;4;2;343;0;233;197;36
2010;2;15919;4;2;1345;0;753;689;64
2010;3;15877;4;3;602;9;401;337;64
2010;3;15888;4;3;708;0;366;292;74
2010;3;15891;4;3;251;0;162;130;32
2010;3;15893;4;3;454;0;222;197;25
2010;3;15896;4;3;645;1;370;306;64
2010;3;15897;4;3;1483;0;706;655;51
2010;3;15911;4;3;553;0;257;239;18
2010;3;15917;4;3;845;0;432;364;68
2010;3;15918;4;3;826;0;449;402;47
2010;4;15887;4;4;2241;1;1020;938;82
2010;4;15899;4;4;163;0;72;60;12
2010;4;15900;4;4;697;0;325;278;47
2010;4;15909;4;4;393;0;190;169;21
2010;4;15910;4;4;621;0;303;282;21
2010;4;15912;4;4;571;0;257;228;29
2010;4;15921;4;4;152;0;114;89;25
2010;5;15876;4;5;219;0;164;141;23
2010;5;15879;4;5;1111;0;488;453;35
2010;5;15894;4;5;1053;0;464;409;55
2010;5;15903;4;5;1940;0;829;771;58
2010;5;15905;4;5;769;0;412;387;25
2010;6;15880;4;6;738;1;363;324;39
2010;6;15901;4;6;1023;3;485;460;25
2010;7;15875;4;7;1916;3;926;849;77
2010;7;15884;4;7;329;0;167;144;23
2010;8;15878;4;8;991;2;515;473;42
2010;8;15889;4;8;387;0;146;130;16
2010;9;15882;4;9;57;0;30;16;14
2011;10;15935;5;10;1309;0;683;608;75
2011;10;15973;5;10;17;0;11;9;2
2011;11;15923;5;11;645;0;363;312;51
2011;1;15925;5;1;1366;22;1014;881;133
2011;1;15928;5;1;1506;0;908;814;94
2011;1;15930;5;1;890;0;360;323;37
2011;1;15933;5;1;1617;3;1057;902;155
2011;1;15936;5;1;206;0;122;107;15
2011;1;15942;5;1;2127;0;1166;1048;118
2011;1;15948;5;1;2255;3;1318;1102;216
2011;1;15954;5;1;1602;0;722;673;49
2011;1;15974;5;1;344;0;121;108;13
2011;1;15978;5;1;1973;3;955;838;117
2011;12;15960;5;12;795;0;414;355;59
2011;13;15961;5;13;784;0;436;371;65
2011;14;15972;5;14;782;0;466;411;55
2011;15;15939;5;15;814;0;484;417;67
2011;16;15941;5;16;416;1;224;195;29
2011;17;15944;5;17;52;0;25;19;6
2011;2;15932;5;2;1448;1;706;634;72
2011;2;15937;5;2;529;1;316;279;37
2011;2;15945;5;2;1967;0;878;781;97
2011;2;15950;5;2;736;4;342;307;35
2011;2;15955;5;2;2052;0;674;610;64
2011;2;15958;5;2;404;0;218;179;39
2011;2;15962;5;2;375;0;209;182;27
2011;2;15965;5;2;413;0;236;199;37
2011;2;15970;5;2;318;0;147;135;12
2011;2;15976;5;2;580;9;442;388;54
2011;3;15924;5;3;972;8;581;500;81
2011;3;15926;5;3;555;12;409;325;84
2011;3;15931;5;3;1614;3;729;678;51
2011;3;15938;5;3;545;0;317;271;46
2011;3;15940;5;3;477;0;275;233;42
2011;3;15956;5;3;353;0;89;89;0
2011;3;15966;5;3;1694;0;892;832;60
2011;3;15967;5;3;398;0;187;153;34
2011;3;15968;5;3;1324;3;840;704;136
2011;3;15977;5;3;890;0;344;300;44
2011;4;15922;5;4;406;6;272;227;45
2011;4;15943;5;4;461;1;275;235;40
2011;4;15946;5;4;907;1;530;443;87
2011;4;15947;5;4;1392;0;686;607;79
2011;4;15949;5;4;1920;4;1021;917;104
2011;4;15953;5;4;546;0;272;247;25
2011;4;15975;5;4;1829;0;917;855;62
2011;5;15952;5;5;1276;0;631;556;75
2011;5;15971;5;5;1875;2;912;820;92
2011;5;15979;5;5;1147;1;538;489;49
2011;6;15929;5;6;865;0;378;315;63
2011;6;15964;5;6;728;0;277;253;24
2011;6;15969;5;6;2356;0;1302;1211;91
2011;7;15927;5;7;783;0;343;291;52
2011;7;15959;5;7;2055;0;1101;991;110
2011;8;15957;5;8;2113;3;1088;960;128
2011;8;15963;5;8;666;0;351;312;39
2011;9;15934;5;9;576;0;306;276;30
2011;9;15951;5;9;385;0;199;175;24
2012;1;15984;2;1;1415;8;732;654;78
2012;1;15987;2;1;1108;3;582;526;56
2012;1;15990;2;1;584;0;233;203;30
2012;1;15995;2;1;1137;0;555;476;79
2012;1;15998;2;1;1326;0;624;558;66
2012;1;16000;2;1;1163;1;707;647;60
2012;1;16003;2;1;312;0;204;174;30
2012;1;16006;2;1;1654;4;1124;970;154
2012;1;16007;2;1;1641;0;803;677;126
2012;2;15982;2;2;1744;1;850;749;101
2012;2;15983;2;2;1848;0;912;767;145
2012;2;15988;2;2;493;3;246;231;15
2012;2;15989;2;2;1600;2;1148;1015;133
2012;2;15992;2;2;451;0;136;114;22
2012;2;15999;2;2;486;1;255;229;26
2012;2;16002;2;2;355;0;176;149;27
2012;2;16008;2;2;390;2;290;257;33
2012;2;16009;2;2;1012;0;415;330;85
2012;3;15980;2;3;562;0;377;320;57
2012;3;15985;2;3;947;1;482;424;58
2012;3;15986;2;3;1845;1;1042;886;156
2012;3;15991;2;3;486;0;232;206;26
2012;3;15993;2;3;491;1;199;176;23
2012;3;15996;2;3;834;0;400;337;63
2012;3;16001;2;3;651;0;330;271;59
2012;4;15981;2;4;389;0;188;168;20
2012;4;15994;2;4;594;0;300;257;43
2012;4;16004;2;4;2309;2;1162;1037;125
2012;4;16005;2;4;161;0;54;36;18
2012;5;15997;2;5;739;2;413;383;30
2013;10;16038;4;10;308;1;175;162;13
2013;11;16040;4;11;426;0;217;190;27
2013;1;16010;4;1;1400;0;596;521;75
2013;1;16015;4;1;1591;0;918;796;122
2013;1;16023;4;1;1291;0;697;590;107
2013;1;16027;4;1;1489;2;763;714;49
2013;1;16028;4;1;2194;1;1196;1070;126
2013;1;16032;4;1;2317;6;1324;1247;77
2013;1;16036;4;1;818;0;359;300;59
2013;1;16041;4;1;1316;9;853;735;118
2013;1;16046;4;1;1735;0;898;776;122
2013;1;16057;4;1;1026;0;669;583;86
2013;12;16042;4;12;94;0;43;20;23
2013;13;16051;4;13;23;0;8;7;1
2013;2;16011;4;2;1452;2;717;635;82
2013;2;16017;4;2;1284;0;578;502;76
2013;2;16018;4;2;1008;0;627;573;54
2013;2;16030;4;2;1101;1;632;571;61
2013;2;16035;4;2;2045;0;1126;1053;73
2013;2;16037;4;2;903;0;499;438;61
2013;2;16039;4;2;1248;0;734;650;84
2013;2;16044;4;2;527;6;372;344;28
2013;2;16045;4;2;1211;1;625;564;61
2013;2;16055;4;2;1432;1;777;701;76
2013;3;16014;4;3;373;0;202;180;22
2013;3;16020;4;3;1866;0;898;829;69
2013;3;16024;4;3;1309;1;635;572;63
2013;3;16031;4;3;1757;1;828;730;98
2013;3;16033;4;3;1167;0;626;556;70
2013;3;16043;4;3;1154;0;666;569;97
2013;3;16047;4;3;667;0;329;301;28
2013;3;16050;4;3;406;0;271;250;21
2013;3;16053;4;3;838;3;569;501;68
2013;3;16054;4;3;939;0;381;331;50
2013;4;16013;4;4;1322;0;764;659;105
2013;4;16016;4;4;1481;1;763;688;75
2013;4;16048;4;4;633;0;325;299;26
2013;4;16052;4;4;214;0;142;125;17
2013;4;16056;4;4;796;0;403;356;47
2013;4;16059;4;4;355;0;171;161;10
2013;5;16012;4;5;322;3;219;202;17
2013;5;16019;4;5;1075;0;585;526;59
2013;5;16021;4;5;8;0;6;6;0
2013;5;16049;4;5;431;0;227;192;35
2013;6;16022;4;6;274;0;186;176;10
2013;6;16058;4;6;229;0;124;107;17
2013;7;16026;4;7;222;0;126;122;4
2013;7;16034;4;7;323;0;203;189;14
2013;8;16029;4;8;285;0;195;183;12
2013;9;16025;4;9;1712;1;898;792;106
2014;10;16060;4;10;662;0;295;270;25
2014;10;16067;4;10;531;0;240;219;21
2014;11;16082;4;11;577;0;271;240;31
2014;11;16098;4;11;1661;0;795;714;81
2014;1;16063;4;1;1344;1;806;676;130
2014;1;16071;4;1;443;0;236;206;30
2014;1;16081;4;1;1821;0;914;844;70
2014;1;16084;4;1;943;0;559;496;63
2014;1;16097;4;1;874;0;586;514;72
2014;12;16069;4;12;3;0;2;0;2
2014;12;16090;4;12;1946;0;901;780;121
2014;13;16074;4;13;1203;0;525;455;70
2014;14;16089;4;14;29;0;12;11;1
2014;2;16061;4;2;477;2;330;308;22
2014;2;16062;4;2;565;0;289;255;34
2014;2;16083;4;2;1390;2;634;584;50
2014;2;16085;4;2;757;0;428;383;45
2014;2;16086;4;2;1037;1;537;489;48
2014;3;16068;4;3;699;0;304;256;48
2014;3;16072;4;3;566;0;242;207;35
2014;3;16075;4;3;588;0;271;243;28
2014;3;16078;4;3;1335;1;615;540;75
2014;3;16100;4;3;637;4;373;328;45
2014;4;16077;4;4;786;0;378;334;44
2014;4;16099;4;4;624;0;293;263;30
2014;4;16101;4;4;378;0;208;205;3
2014;4;16102;4;4;1326;0;595;537;58
2014;5;16066;4;5;1009;0;467;429;38
2014;5;16079;4;5;1064;0;589;480;109
2014;5;16095;4;5;423;0;203;155;48
2014;5;16096;4;5;919;0;379;335;44
2014;6;16076;4;6;229;0;121;104;17
2014;6;16087;4;6;2012;0;864;754;110
2014;6;16092;4;6;503;0;275;254;21
2014;7;16065;4;7;438;0;251;220;31
2014;7;16073;4;7;370;0;208;187;21
2014;7;16093;4;7;1301;0;657;596;61
2014;8;16064;4;8;999;0;460;416;44
2014;8;16070;4;8;502;0;254;228;26
2014;8;16094;4;8;189;0;130;93;37
2014;9;16080;4;9;1785;0;858;759;99
2014;9;16088;4;9;275;0;108;97;11
2014;9;16091;4;9;886;0;336;305;31
2061;100;16186;1;100;1987;0;475;441;34
2061;101;16103;1;101;1788;0;634;609;25
2061;10;16141;1;10;1940;0;982;961;21
2061;102;16234;1;102;2139;0;853;832;21
2061;103;16209;1;103;1933;0;675;651;24
2061;104;16243;1;104;1386;0;559;536;23
2061;105;16228;1;105;1563;0;609;594;15
2061;106;16206;1;106;1971;0;728;714;14
2061;107;16247;1;107;1670;0;741;726;15
2061;108;16198;1;108;871;0;338;325;13
2061;109;16117;1;109;1984;0;779;767;12
2061;110;16124;1;110;2080;2;820;793;27
2061;111;16125;1;111;1902;0;863;848;15
2061;11;16176;1;11;1986;1;921;902;19
2061;112;16151;1;112;2084;0;909;884;25
2061;113;16142;1;113;1460;0;636;636;0
2061;114;16256;1;114;1332;0;629;608;21
2061;115;16200;1;115;971;0;357;344;13
2061;1;16143;1;1;1985;0;952;924;28
2061;116;16175;1;116;1650;0;564;549;15
2061;117;16246;1;117;618;0;203;194;9
2061;118;16187;1;118;1147;2;361;349;12
2061;119;16128;1;119;1932;1;857;817;40
2061;120;16261;1;120;1367;0;531;514;17
2061;121;16137;1;121;1693;0;783;768;15
2061;12;16104;1;12;1760;0;726;707;19
2061;122;16211;1;122;1333;0;542;530;12
2061;123;16115;1;123;1991;0;874;849;25
2061;124;16218;1;124;1307;0;563;530;33
2061;125;16219;1;125;2139;0;876;853;23
2061;126;16194;1;126;1895;0;801;782;19
2061;127;16118;1;127;1314;0;525;513;12
2061;128;16232;1;128;2034;0;828;810;18
2061;129;16265;1;129;1564;0;705;690;15
2061;130;16197;1;130;2014;0;942;924;18
2061;131;16263;1;131;1168;0;536;521;15
2061;13;16201;1;13;1974;1;763;734;29
2061;132;16113;1;132;585;0;283;282;1
2061;133;16140;1;133;1625;0;740;740;0
2061;134;16266;1;134;1965;0;742;727;15
2061;135;16212;1;135;833;0;433;411;22
2061;136;16251;1;136;1573;0;612;593;19
2061;137;16213;1;137;640;0;271;261;10
2061;138;16136;1;138;1567;0;541;521;20
2061;139;16207;1;139;933;0;356;343;13
2061;140;16109;1;140;2053;0;743;720;23
2061;141;16122;1;141;1787;0;632;613;19
2061;14;16238;1;14;1927;0;827;801;26
2061;142;16236;1;142;1052;0;439;425;14
2061;143;16131;1;143;1814;0;765;737;28
2061;144;16185;1;144;1468;0;538;518;20
2061;145;16144;1;145;958;0;374;349;25
2061;146;16123;1;146;1266;0;582;578;4
2061;147;16105;1;147;1095;0;445;433;12
2061;148;16248;1;148;1703;0;625;601;24
2061;149;16259;1;149;1576;0;484;477;7
2061;150;16119;1;150;1706;0;720;703;17
2061;151;16150;1;151;1024;0;533;516;17
2061;15;16217;1;15;1630;0;532;511;21
2061;152;16133;1;152;1198;0;363;349;14
2061;153;16166;1;153;896;0;356;341;15
2061;154;16163;1;154;146;0;17;17;0
2061;155;16129;1;155;24;0;4;4;0
2061;156;16178;1;156;58;0;26;25;1
2061;157;16111;1;157;144;0;71;63;8
2061;158;16190;1;158;37;0;2;2;0
2061;159;16138;1;159;51;0;23;21;2
2061;160;16193;1;160;6;0;2;2;0
2061;161;16231;1;161;20;0;2;2;0
2061;16;16108;1;16;1166;0;442;427;15
2061;162;16159;1;162;41;0;6;6;0
2061;163;16170;1;163;173;0;77;66;11
2061;164;16230;1;164;43;0;14;13;1
2061;17;16191;1;17;1926;0;926;911;15
2061;18;16157;1;18;1936;0;961;945;16
2061;19;16160;1;19;1136;0;506;495;11
2061;20;16264;1;20;2220;0;925;895;30
2061;21;16158;1;21;2080;0;815;788;27
2061;2;16121;1;2;1370;1;546;531;15
2061;22;16106;1;22;1895;0;841;805;36
2061;23;16253;1;23;1960;0;860;824;36
2061;24;16252;1;24;873;0;422;412;10
2061;25;16215;1;25;975;0;413;404;9
2061;26;16146;1;26;1051;0;394;379;15
2061;27;16204;1;27;973;0;360;354;6
2061;28;16183;1;28;988;0;383;367;16
2061;29;16260;1;29;997;1;368;359;9
2061;30;16229;1;30;863;1;336;332;4
2061;31;16132;1;31;981;2;352;345;7
2061;3;16110;1;3;1640;0;766;756;10
2061;32;16165;1;32;1404;0;448;433;15
2061;33;16154;1;33;1596;0;561;543;18
2061;34;16210;1;34;959;0;380;372;8
2061;35;16182;1;35;1175;0;396;381;15
2061;36;16107;1;36;660;0;183;176;7
2061;37;16203;1;37;1939;3;904;888;16
2061;38;16112;1;38;785;0;288;277;11
2061;39;16240;1;39;1208;0;465;451;14
2061;40;16181;1;40;1733;0;738;720;18
2061;41;16156;1;41;957;0;416;394;22
2061;4;16239;1;4;1023;0;425;425;0
2061;42;16257;1;42;1428;0;707;688;19
2061;43;16216;1;43;1866;0;799;774;25
2061;44;16130;1;44;1560;1;624;608;16
2061;45;16235;1;45;2170;0;982;947;35
2061;46;16139;1;46;1983;0;867;852;15
2061;47;16202;1;47;765;0;294;290;4
2061;48;16164;1;48;1987;0;857;830;27
2061;49;16262;1;49;2245;0;988;969;19
2061;50;16168;1;50;2446;0;1222;1189;33
2061;51;16244;1;51;1215;0;600;591;9
2061;5;16120;1;5;622;0;167;160;7
2061;52;16226;1;52;1762;0;756;744;12
2061;53;16199;1;53;1822;0;814;783;31
2061;54;16214;1;54;1750;0;732;712;20
2061;55;16254;1;55;2273;0;1017;993;24
2061;56;16180;1;56;1474;0;541;527;14
2061;57;16258;1;57;867;0;299;282;17
2061;58;16222;1;58;1786;0;764;736;28
2061;59;16184;1;59;1181;0;526;498;28
2061;60;16172;1;60;1412;0;685;672;13
2061;61;16208;1;61;1276;0;545;524;21
2061;6;16220;1;6;1125;0;585;563;22
2061;62;16225;1;62;1992;1;759;743;16
2061;63;16241;1;63;1188;0;539;529;10
2061;64;16221;1;64;538;0;239;232;7
2061;65;16148;1;65;824;0;359;350;9
2061;66;16147;1;66;1531;0;671;650;21
2061;67;16177;1;67;1847;0;817;804;13
2061;68;16179;1;68;1866;1;812;789;23
2061;69;16114;1;69;1519;0;621;604;17
2061;70;16153;1;70;1455;0;624;603;21
2061;71;16152;1;71;1158;0;507;495;12
2061;7;16155;1;7;1815;0;786;769;17
2061;72;16224;1;72;957;0;390;374;16
2061;73;16223;1;73;1038;2;445;432;13
2061;74;16192;1;74;777;0;349;335;14
2061;75;16162;1;75;978;0;463;440;23
2061;76;16189;1;76;1457;0;645;627;18
2061;77;16134;1;77;2029;0;865;836;29
2061;78;16227;1;78;1209;0;502;476;26
2061;79;16249;1;79;1181;1;469;450;19
2061;80;16196;1;80;1523;1;499;483;16
2061;81;16116;1;81;1961;0;872;845;27
2061;8;16126;1;8;1244;0;540;527;13
2061;82;16188;1;82;1695;0;753;735;18
2061;83;16173;1;83;1502;0;727;706;21
2061;84;16135;1;84;1080;0;477;470;7
2061;85;16145;1;85;1680;0;786;768;18
2061;86;16195;1;86;965;0;447;434;13
2061;87;16245;1;87;1069;0;485;459;26
2061;88;16242;1;88;1663;0;828;810;18
2061;89;16127;1;89;2167;0;1031;1007;24
2061;90;16233;1;90;1458;0;645;626;19
2061;91;16167;1;91;1431;0;656;635;21
2061;9;16171;1;9;1563;0;675;654;21
2061;92;16205;1;92;2123;0;819;785;34
2061;93;16149;1;93;1281;0;473;451;22
2061;94;16250;1;94;930;0;386;372;14
2061;95;16161;1;95;1201;0;485;467;18
2061;96;16237;1;96;2007;0;839;815;24
2061;97;16255;1;97;1559;0;687;668;19
2061;98;16169;1;98;2330;0;842;810;32
2061;99;16174;1;99;1691;0;765;751;14
2062;10;16282;3;10;1327;0;518;493;25
2062;11;16289;3;11;2236;1;1009;961;48
2062;1;16298;3;1;1747;0;831;756;75
2062;12;16294;3;12;1445;0;533;515;18
2062;13;16283;3;13;978;0;363;348;15
2062;14;16275;3;14;1805;0;741;703;38
2062;15;16274;3;15;1976;0;828;784;44
2062;16;16280;3;16;1581;0;716;683;33
2062;17;16286;3;17;1968;0;725;681;44
2062;18;16276;3;18;1847;0;720;662;58
2062;19;16287;3;19;2223;0;824;787;37
2062;20;16273;3;20;1839;0;863;810;53
2062;21;16281;3;21;1935;0;820;780;40
2062;2;16295;3;2;1696;0;757;728;29
2062;22;16269;3;22;1439;0;629;599;30
2062;23;16296;3;23;1857;0;766;735;31
2062;24;16284;3;24;1996;0;806;806;0
2062;25;16300;3;25;1558;0;648;608;40
2062;26;16288;3;26;2035;0;835;785;50
2062;27;16290;3;27;1935;0;877;828;49
2062;28;16279;3;28;1994;0;782;734;48
2062;29;16270;3;29;809;0;377;346;31
2062;30;16299;3;30;1254;0;510;486;24
2062;31;16268;3;31;812;0;356;338;18
2062;3;16267;3;3;2068;0;789;729;60
2062;32;16292;3;32;44;0;20;19;1
2062;33;16297;3;33;17;0;5;5;0
2062;34;16278;3;34;89;0;33;19;14
2062;35;16301;3;35;11;0;10;10;0
2062;4;16277;3;4;991;0;306;284;22
2062;5;16291;3;5;1490;0;619;598;21
2062;6;16293;3;6;1384;1;520;493;27
2062;7;16285;3;7;1427;1;651;611;40
2062;8;16272;3;8;654;0;264;255;9
2062;9;16271;3;9;1609;0;708;687;21
2063;10;16305;2;10;1451;0;614;591;23
2063;11;16336;2;11;733;0;287;272;15
2063;1;16329;2;1;2193;0;910;853;57
2063;12;16326;2;12;1857;1;811;762;49
2063;13;16316;2;13;1252;0;468;446;22
2063;14;16322;2;14;1843;0;856;808;48
2063;15;16325;2;15;1341;0;664;635;29
2063;16;16321;2;16;1416;1;681;659;22
2063;17;16310;2;17;1852;1;687;661;26
2063;18;16330;2;18;2239;0;1000;967;33
2063;19;16313;2;19;2420;0;1027;974;53
2063;20;16328;2;20;1705;0;712;673;39
2063;21;16312;2;21;1712;0;612;578;34
2063;2;16319;2;2;1283;0;437;414;23
2063;22;16311;2;22;2207;0;856;796;60
2063;23;16314;2;23;183;0;161;158;3
2063;24;16337;2;24;1863;0;632;610;22
2063;25;16324;2;25;1673;0;661;620;41
2063;26;16331;2;26;2200;0;814;765;49
2063;27;16308;2;27;2051;0;860;792;68
2063;28;16334;2;28;1428;0;541;511;30
2063;29;16338;2;29;2094;0;776;736;40
2063;30;16335;2;30;1654;1;728;682;46
2063;31;16318;2;31;1723;0;636;621;15
2063;3;16315;2;3;1311;0;571;550;21
2063;32;16303;2;32;1359;0;573;528;45
2063;33;16306;2;33;1189;0;418;401;17
2063;34;16304;2;34;1130;0;481;465;16
2063;35;16317;2;35;122;0;60;44;16
2063;36;16332;2;36;40;0;5;5;0
2063;37;16333;2;37;92;0;27;25;2
2063;4;16327;2;4;2010;1;904;868;36
2063;5;16302;2;5;1391;0;603;568;35
2063;6;16309;2;6;1320;0;622;592;30
2063;7;16307;2;7;2031;0;809;754;55
2063;8;16320;2;8;688;0;252;237;15
2063;9;16323;2;9;1204;1;514;470;44
2201;10;16342;1;10;1106;0;454;415;39
2201;10;16398;1;10;721;0;311;262;49
2201;11;16351;1;11;525;0;271;231;40
2201;11;16400;1;11;867;1;548;484;64
2201;1;16344;1;1;1423;10;857;722;135
2201;1;16345;1;1;1336;7;773;588;185
2201;1;16346;1;1;1363;0;988;815;173
2201;1;16349;1;1;1365;0;829;595;234
2201;1;16359;1;1;2038;0;867;638;229
2201;1;16377;1;1;1366;1;882;797;85
2201;1;16382;1;1;684;12;463;382;81
2201;1;16383;1;1;982;3;613;521;92
2201;1;16385;1;1;1523;0;722;670;52
2201;1;16390;1;1;1840;0;893;842;51
2201;12;16369;1;12;710;0;313;287;26
2201;12;16396;1;12;695;0;352;289;63
2201;13;16374;1;13;1206;0;601;562;39
2201;13;16388;1;13;488;0;196;168;28
2201;14;16357;1;14;607;0;250;202;48
2201;14;16360;1;14;1599;0;834;788;46
2201;15;16343;1;15;577;0;266;243;23
2201;15;16376;1;15;1147;0;548;504;44
2201;16;16354;1;16;510;0;227;205;22
2201;16;16381;1;16;6;0;3;2;1
2201;17;16371;1;17;20;0;3;3;0
2201;2;16347;1;2;1691;0;703;656;47
2201;2;16356;1;2;599;0;207;169;38
2201;2;16361;1;2;393;2;256;222;34
2201;2;16363;1;2;608;0;361;310;51
2201;2;16364;1;2;1484;0;746;693;53
2201;2;16367;1;2;1629;1;698;565;133
2201;2;16375;1;2;741;0;478;360;118
2201;2;16379;1;2;441;0;232;180;52
2201;2;16391;1;2;1366;0;853;684;169
2201;2;16397;1;2;660;2;438;331;107
2201;3;16341;1;3;772;3;508;433;75
2201;3;16348;1;3;889;0;569;474;95
2201;3;16350;1;3;1637;2;782;701;81
2201;3;16355;1;3;1497;0;757;693;64
2201;3;16358;1;3;416;0;239;197;42
2201;3;16365;1;3;412;0;272;218;54
2201;3;16366;1;3;572;0;361;303;58
2201;3;16370;1;3;470;0;228;196;32
2201;3;16373;1;3;246;0;169;140;29
2201;4;16340;1;4;2295;2;1031;941;90
2201;4;16352;1;4;532;0;320;240;80
2201;4;16368;1;4;752;0;337;306;31
2201;4;16372;1;4;1193;5;743;633;110
2201;4;16387;1;4;1333;3;912;733;179
2201;4;16392;1;4;326;0;210;176;34
2201;5;16339;1;5;896;2;512;438;74
2201;5;16362;1;5;458;1;342;255;87
2201;5;16386;1;5;1525;0;759;699;60
2201;5;16399;1;5;1841;2;848;767;81
2201;6;16380;1;6;1515;0;730;663;67
2201;6;16394;1;6;1381;0;623;577;46
2201;7;16389;1;7;748;0;385;359;26
2201;7;16395;1;7;1574;1;751;679;72
2201;8;16353;1;8;602;0;319;263;56
2201;8;16384;1;8;865;0;409;366;43
2201;9;16378;1;9;712;1;310;276;34
2201;9;16393;1;9;785;0;400;344;56
2202;10;16425;1;10;659;0;381;339;42
2202;10;16426;1;10;1308;0;496;373;123
2202;10;16444;1;10;1672;1;847;771;76
2202;10;16451;1;10;620;0;390;336;54
2202;11;16406;1;11;1119;0;431;367;64
2202;11;16416;1;11;1012;0;392;359;33
2202;11;16418;1;11;566;0;253;223;30
2202;1;16408;1;1;1696;0;1129;923;206
2202;1;16409;1;1;1813;1;948;852;96
2202;1;16427;1;1;1521;1;933;808;125
2202;1;16430;1;1;1953;0;1070;969;101
2202;1;16446;1;1;888;1;492;414;78
2202;12;16428;1;12;603;0;361;305;56
2202;12;16438;1;12;1774;1;861;763;98
2202;13;16412;1;13;1813;0;875;783;92
2202;13;16421;1;13;1854;0;832;709;123
2202;14;16414;1;14;831;1;391;336;55
2202;14;16415;1;14;2265;0;1056;963;93
2202;15;16442;1;15;1948;0;932;861;71
2202;16;16454;1;16;1959;0;859;792;67
2202;17;16453;1;17;1321;0;719;633;86
2202;18;16433;1;18;41;0;16;15;1
2202;19;16441;1;19;78;0;42;27;15
2202;20;16458;1;20;16;0;11;9;2
2202;21;16431;1;21;2255;0;1050;958;92
2202;2;16417;1;2;1119;0;397;323;74
2202;2;16437;1;2;1933;0;1034;968;66
2202;2;16448;1;2;1863;0;989;884;105
2202;2;16450;1;2;2142;2;1401;1207;194
2202;22;16405;1;22;798;0;363;323;40
2202;23;16440;1;23;1033;0;570;545;25
2202;3;16432;1;3;1989;0;1062;959;103
2202;3;16435;1;3;1000;0;486;412;74
2202;3;16456;1;3;1731;0;951;802;149
2202;3;16459;1;3;1286;1;732;625;107
2202;4;16403;1;4;2031;2;915;812;103
2202;4;16411;1;4;1652;1;822;748;74
2202;4;16423;1;4;1368;1;825;710;115
2202;4;16445;1;4;1064;0;465;380;85
2202;5;16413;1;5;949;0;432;360;72
2202;5;16434;1;5;1071;0;464;413;51
2202;5;16443;1;5;1852;0;824;733;91
2202;5;16455;1;5;931;0;454;382;72
2202;6;16401;1;6;352;0;215;183;32
2202;6;16407;1;6;1304;0;515;398;117
2202;6;16429;1;6;1286;0;687;626;61
2202;6;16447;1;6;929;2;575;508;67
2202;7;16404;1;7;450;0;227;179;48
2202;7;16410;1;7;802;0;393;284;109
2202;7;16424;1;7;499;0;209;167;42
2202;7;16449;1;7;1003;1;514;455;59
2202;8;16402;1;8;2095;1;918;821;97
2202;8;16419;1;8;501;0;280;250;30
2202;8;16420;1;8;1047;0;451;370;81
2202;8;16439;1;8;1995;0;937;815;122
2202;9;16422;1;9;1981;0;782;666;116
2202;9;16436;1;9;662;0;379;295;84
2202;9;16452;1;9;313;0;144;127;17
2202;9;16457;1;9;574;0;288;217;71
2203;10;16476;1;10;114;0;46;26;20
2203;1;16461;1;1;1471;0;865;751;114
2203;1;16462;1;1;1994;0;1028;843;185
2203;1;16464;1;1;1474;0;899;614;285
2203;1;16477;1;1;514;0;194;169;25
2203;1;16490;1;1;1361;0;661;536;125
2203;1;16492;1;1;2341;0;1131;1001;130
2203;1;16499;1;1;374;0;172;129;43
2203;2;16460;1;2;2097;16;995;803;192
2203;2;16463;1;2;387;0;238;167;71
2203;2;16473;1;2;1331;1;833;645;188
2203;2;16488;1;2;1116;0;528;487;41
2203;2;16496;1;2;1794;0;1023;910;113
2203;2;16504;1;2;2171;0;1151;950;201
2203;2;16505;1;2;1196;2;475;405;70
2203;3;16469;1;3;395;0;224;177;47
2203;3;16470;1;3;2044;0;866;680;186
2203;3;16471;1;3;806;0;358;309;49
2203;3;16478;1;3;1314;0;764;700;64
2203;3;16487;1;3;883;0;492;394;98
2203;3;16489;1;3;807;0;395;305;90
2203;3;16502;1;3;340;0;146;134;12
2203;4;16479;1;4;1460;2;683;621;62
2203;4;16486;1;4;608;0;278;216;62
2203;4;16491;1;4;272;0;135;122;13
2203;4;16494;1;4;1402;2;892;696;196
2203;4;16498;1;4;893;0;402;306;96
2203;4;16501;1;4;427;0;262;181;81
2203;5;16466;1;5;731;0;430;354;76
2203;5;16467;1;5;459;0;218;171;47
2203;5;16468;1;5;770;0;405;371;34
2203;5;16472;1;5;1902;1;915;793;122
2203;5;16500;1;5;626;0;391;329;62
2203;5;16503;1;5;293;0;197;135;62
2203;6;16474;1;6;570;0;309;256;53
2203;6;16475;1;6;509;0;276;209;67
2203;6;16481;1;6;973;0;375;297;78
2203;6;16495;1;6;2026;1;933;802;131
2203;6;16497;1;6;291;0;165;130;35
2203;7;16482;1;7;793;0;335;261;74
2203;7;16483;1;7;2211;0;1038;921;117
2203;7;16485;1;7;719;0;334;279;55
2203;7;16493;1;7;282;0;123;102;21
2203;8;16465;1;8;469;0;244;216;28
2203;8;16484;1;8;32;0;9;8;1
2203;9;16480;1;9;343;1;202;185;17
2204;10;16507;4;10;1389;0;648;587;61
2204;10;16550;4;10;1145;0;561;531;30
2204;11;16533;4;11;2161;0;860;814;46
2204;11;16542;4;11;1117;0;439;399;40
2204;1;16514;4;1;1201;3;660;548;112
2204;1;16519;4;1;1350;0;629;522;107
2204;1;16520;4;1;2028;0;961;910;51
2204;1;16523;4;1;2515;0;1299;1155;144
2204;1;16526;4;1;1180;0;514;425;89
2204;1;16528;4;1;989;0;560;452;108
2204;1;16531;4;1;2122;0;745;567;178
2204;1;16553;4;1;1679;0;633;505;128
2204;12;16546;4;12;1919;0;946;896;50
2204;13;16522;4;13;804;0;258;230;28
2204;14;16536;4;14;944;0;402;389;13
2204;2;16508;4;2;2339;0;1245;1132;113
2204;2;16513;4;2;1405;0;629;478;151
2204;2;16517;4;2;2249;0;1131;923;208
2204;2;16521;4;2;1895;0;709;608;101
2204;2;16527;4;2;1408;2;586;539;47
2204;2;16540;4;2;1420;0;682;647;35
2204;2;16543;4;2;1233;0;635;497;138
2204;2;16548;4;2;1734;0;633;509;124
2204;3;16511;4;3;1567;1;791;720;71
2204;3;16512;4;3;2128;0;1015;864;151
2204;3;16524;4;3;1133;0;598;465;133
2204;3;16532;4;3;887;0;203;172;31
2204;3;16534;4;3;1676;0;746;628;118
2204;3;16537;4;3;734;0;354;283;71
2204;3;16544;4;3;977;0;547;472;75
2204;3;16551;4;3;1357;0;567;532;35
2204;4;16515;4;4;1075;0;521;477;44
2204;4;16516;4;4;1796;0;953;892;61
2204;4;16518;4;4;2132;3;984;845;139
2204;4;16529;4;4;846;0;348;260;88
2204;4;16535;4;4;1782;0;822;772;50
2204;5;16525;4;5;1033;0;384;330;54
2204;5;16545;4;5;1901;1;934;878;56
2204;5;16547;4;5;1039;0;538;482;56
2204;5;16552;4;5;2428;1;1060;975;85
2204;5;16554;4;5;951;0;485;443;42
2204;6;16510;4;6;1181;0;505;458;47
2204;6;16530;4;6;1370;0;607;549;58
2204;7;16509;4;7;2091;0;948;883;65
2204;7;16539;4;7;1472;1;640;545;95
2204;8;16506;4;8;1056;1;428;354;74
2204;8;16538;4;8;1178;0;531;494;37
2204;9;16541;4;9;2027;0;857;776;81
2204;9;16549;4;9;846;0;377;346;31
2205;10;16571;4;10;774;0;463;384;79
2205;10;16581;4;10;1096;0;663;603;60
2205;10;16611;4;10;1405;0;807;668;139
2205;11;16583;4;11;843;0;414;344;70
2205;11;16587;4;11;952;0;559;506;53
2205;1;16563;4;1;1930;0;1224;1095;129
2205;1;16568;4;1;1345;0;721;553;168
2205;1;16570;4;1;2394;0;1183;1119;64
2205;1;16573;4;1;2206;1;1354;1260;94
2205;1;16591;4;1;2100;0;1275;1101;174
2205;1;16597;4;1;1233;0;477;412;65
2205;1;16604;4;1;1467;0;850;699;151
2205;1;16621;4;1;1388;0;946;821;125
2205;12;16574;4;12;1532;0;825;762;63
2205;12;16598;4;12;1209;0;666;595;71
2205;13;16596;4;13;747;0;408;350;58
2205;13;16609;4;13;943;0;453;405;48
2205;14;16579;4;14;1049;0;590;525;65
2205;14;16612;4;14;1111;0;569;518;51
2205;15;16592;4;15;831;0;344;315;29
2205;15;16606;4;15;1160;0;517;443;74
2205;16;16610;4;16;1435;1;759;667;92
2205;17;16599;4;17;690;0;448;406;42
2205;18;16614;4;18;7;0;1;1;0
2205;19;16584;4;19;14;0;3;3;0
2205;2;16555;4;2;802;0;517;416;101
2205;2;16560;4;2;2080;0;1197;1080;117
2205;2;16575;4;2;2292;1;1195;1085;110
2205;2;16576;4;2;1596;0;889;805;84
2205;2;16590;4;2;2031;1;1243;986;257
2205;2;16594;4;2;1854;0;1113;966;147
2205;2;16608;4;2;848;0;478;400;78
2205;2;16618;4;2;815;1;417;316;101
2205;3;16557;4;3;1206;0;540;491;49
2205;3;16558;4;3;636;2;426;409;17
2205;3;16577;4;3;627;0;360;288;72
2205;3;16580;4;3;1799;1;930;846;84
2205;3;16582;4;3;1795;0;962;783;179
2205;3;16585;4;3;889;0;484;389;95
2205;3;16613;4;3;997;0;649;570;79
2205;3;16616;4;3;2028;1;1197;975;222
2205;4;16556;4;4;2083;0;1263;1173;90
2205;4;16561;4;4;1012;0;503;443;60
2205;4;16564;4;4;957;0;594;552;42
2205;4;16566;4;4;979;1;627;549;78
2205;4;16572;4;4;957;0;600;492;108
2205;4;16607;4;4;968;0;508;402;106
2205;4;16615;4;4;1272;0;615;477;138
2205;4;16619;4;4;1257;0;519;374;145
2205;5;16559;4;5;1900;0;1030;938;92
2205;5;16565;4;5;1600;0;993;906;87
2205;5;16567;4;5;1074;1;653;541;112
2205;5;16595;4;5;363;2;221;177;44
2205;5;16600;4;5;1251;0;555;463;92
2205;5;16605;4;5;1474;0;633;499;134
2205;6;16578;4;6;1913;0;1170;1067;103
2205;6;16586;4;6;1488;0;757;635;122
2205;6;16593;4;6;758;0;355;301;54
2205;6;16603;4;6;2218;0;1367;1245;122
2205;7;16601;4;7;807;0;355;284;71
2205;7;16602;4;7;960;0;562;455;107
2205;7;16622;4;7;1668;0;957;869;88
2205;8;16562;4;8;1661;0;817;717;100
2205;8;16617;4;8;988;0;556;468;88
2205;8;16620;4;8;876;0;463;385;78
2205;9;16569;4;9;820;0;421;369;52
2205;9;16588;4;9;1391;0;784;696;88
2205;9;16589;4;9;1017;0;568;464;104
2206;10;16632;4;10;1484;1;929;796;133
2206;10;16653;4;10;601;0;366;309;57
2206;11;16636;4;11;1534;1;936;826;110
2206;11;16658;4;11;700;0;357;305;52
2206;1;16624;4;1;1983;0;1110;927;183
2206;1;16635;4;1;1902;0;1084;967;117
2206;1;16638;4;1;1925;0;1074;953;121
2206;1;16639;4;1;1566;0;910;786;124
2206;1;16659;4;1;1401;0;833;725;108
2206;1;16660;4;1;1430;0;967;858;109
2206;1;16663;4;1;1260;0;709;564;145
2206;1;16666;4;1;1481;0;1133;917;216
2206;12;16643;4;12;532;0;346;306;40
2206;12;16661;4;12;39;0;19;17;2
2206;2;16626;4;2;1931;0;1118;1020;98
2206;2;16633;4;2;434;0;287;239;48
2206;2;16634;4;2;603;0;332;285;47
2206;2;16637;4;2;1762;4;987;901;86
2206;2;16649;4;2;879;0;531;488;43
2206;2;16655;4;2;1259;0;674;587;87
2206;2;16656;4;2;743;0;525;385;140
2206;2;16665;4;2;1361;0;765;654;111
2206;3;16623;4;3;1182;0;632;524;108
2206;3;16630;4;3;1014;1;762;619;143
2206;3;16644;4;3;810;0;505;420;85
2206;3;16646;4;3;531;0;342;305;37
2206;3;16647;4;3;615;0;357;264;93
2206;3;16657;4;3;672;0;348;328;20
2206;3;16664;4;3;1599;0;922;837;85
2206;4;16628;4;4;1050;0;626;540;86
2206;4;16640;4;4;1417;0;822;755;67
2206;4;16642;4;4;462;0;312;257;55
2206;4;16645;4;4;64;0;39;31;8
2206;4;16667;4;4;777;0;467;398;69
2206;5;16627;4;5;1683;0;934;820;114
2206;5;16629;4;5;1483;0;742;595;147
2206;5;16648;4;5;2424;0;1553;1414;139
2206;6;16625;4;6;1513;0;807;704;103
2206;6;16662;4;6;1643;0;1039;931;108
2206;7;16631;4;7;797;0;417;355;62
2206;7;16641;4;7;2098;0;1195;1064;131
2206;8;16651;4;8;1759;0;937;839;98
2206;8;16654;4;8;981;0;485;423;62
2206;9;16650;4;9;1166;0;600;533;67
2206;9;16652;4;9;692;0;389;333;56
2207;10;16687;5;10;963;0;350;318;32
2207;10;16691;5;10;29;0;14;13;1
2207;11;16693;5;11;1096;0;503;476;27
2207;1;16680;5;1;1526;0;701;554;147
2207;1;16690;5;1;1737;0;875;737;138
2207;1;16710;5;1;1105;0;371;328;43
2207;1;16713;5;1;1483;1;619;520;99
2207;1;16714;5;1;47;0;10;10;0
2207;1;16719;5;1;834;0;343;298;45
2207;12;16668;5;12;1742;0;757;715;42
2207;13;16672;5;13;1002;0;411;387;24
2207;14;16692;5;14;1949;1;800;784;16
2207;15;16677;5;15;1544;0;689;662;27
2207;16;16676;5;16;1398;0;560;529;31
2207;17;16712;5;17;1918;0;747;715;32
2207;18;16671;5;18;1066;1;467;444;23
2207;19;16686;5;19;1995;0;755;712;43
2207;20;16683;5;20;1463;0;583;547;36
2207;21;16696;5;21;2101;0;883;842;41
2207;2;16675;5;2;1433;4;597;528;69
2207;2;16685;5;2;1436;0;651;532;119
2207;2;16697;5;2;2243;0;992;922;70
2207;2;16698;5;2;1199;0;596;462;134
2207;2;16702;5;2;2058;1;893;800;93
2207;2;16707;5;2;921;0;359;326;33
2207;22;16709;5;22;11;0;2;2;0
2207;3;16669;5;3;2174;0;922;826;96
2207;3;16670;5;3;775;0;375;338;37
2207;3;16682;5;3;1444;0;593;481;112
2207;3;16701;5;3;1080;0;461;388;73
2207;3;16716;5;3;1235;0;581;497;84
2207;3;16717;5;3;1695;0;763;723;40
2207;4;16705;5;4;1757;0;790;687;103
2207;4;16706;5;4;1974;0;656;587;69
2207;4;16711;5;4;983;0;391;320;71
2207;4;16715;5;4;690;0;272;238;34
2207;4;16720;5;4;920;0;326;299;27
2207;5;16674;5;5;73;0;26;22;4
2207;5;16688;5;5;884;0;416;363;53
2207;5;16695;5;5;826;0;250;209;41
2207;5;16704;5;5;932;0;387;347;40
2207;5;16718;5;5;840;1;363;323;40
2207;6;16678;5;6;1639;0;640;597;43
2207;6;16679;5;6;706;0;374;315;59
2207;6;16694;5;6;591;0;268;218;50
2207;6;16699;5;6;1920;0;748;649;99
2207;7;16684;5;7;1112;0;412;386;26
2207;7;16703;5;7;569;0;268;223;45
2207;7;16708;5;7;1828;1;651;588;63
2207;8;16681;5;8;475;0;197;174;23
2207;8;16700;5;8;1987;0;882;842;40
2207;9;16673;5;9;84;0;39;31;8
2207;9;16689;5;9;463;0;224;180;44
2208;10;16737;1;10;961;0;501;369;132
2208;10;16744;1;10;1671;0;846;751;95
2208;11;16734;1;11;966;0;426;349;77
2208;11;16746;1;11;1870;0;894;727;167
2208;1;16723;1;1;2150;2;1322;820;502
2208;1;16724;1;1;1588;0;830;726;104
2208;1;16730;1;1;2072;0;1096;913;183
2208;1;16736;1;1;2173;0;1357;969;388
2208;1;16754;1;1;1625;0;936;714;222
2208;12;16735;1;12;574;0;296;234;62
2208;12;16753;1;12;1231;0;576;503;73
2208;13;16747;1;13;59;0;43;39;4
2208;14;16760;1;14;1878;1;949;822;127
2208;15;16751;1;15;1340;0;637;571;66
2208;16;16743;1;16;1886;1;842;741;101
2208;17;16742;1;17;1240;0;598;527;71
2208;18;16741;1;18;1383;0;710;645;65
2208;19;16745;1;19;1412;1;624;572;52
2208;20;16725;1;20;1234;0;589;525;64
2208;21;16728;1;21;1530;0;833;734;99
2208;2;16722;1;2;1037;4;640;505;135
2208;2;16727;1;2;1198;2;771;635;136
2208;2;16739;1;2;49;0;22;15;7
2208;2;16757;1;2;1441;0;746;547;199
2208;2;16762;1;2;442;0;229;196;33
2208;22;16726;1;22;16;0;10;10;0
2208;3;16731;1;3;1320;0;704;633;71
2208;3;16738;1;3;1020;0;495;449;46
2208;3;16740;1;3;1228;0;674;536;138
2208;3;16749;1;3;843;0;442;289;153
2208;4;16733;1;4;1482;1;838;628;210
2208;4;16750;1;4;419;0;216;185;31
2208;4;16755;1;4;1268;0;642;584;58
2208;5;16752;1;5;1226;1;571;509;62
2208;5;16758;1;5;1325;0;584;504;80
2208;6;16748;1;6;392;0;216;158;58
2208;6;16763;1;6;1814;1;852;751;101
2208;7;16732;1;7;485;0;235;201;34
2208;7;16759;1;7;1539;1;750;679;71
2208;8;16729;1;8;2299;0;1174;1047;127
2208;8;16761;1;8;544;0;283;235;48
2208;9;16721;1;9;436;2;215;193;22
2208;9;16756;1;9;428;0;235;200;35
2209;10;16785;5;10;803;1;354;336;18
2209;11;16781;5;11;1654;0;757;697;60
2209;1;16767;5;1;1832;2;1129;972;157
2209;1;16777;5;1;2372;4;1204;1017;187
2209;1;16783;5;1;1814;2;836;758;78
2209;1;16784;5;1;1409;0;786;692;94
2209;1;16792;5;1;2067;0;1152;937;215
2209;1;16798;5;1;1723;0;957;814;143
2209;12;16782;5;12;1730;1;795;745;50
2209;13;16774;5;13;878;0;312;292;20
2209;14;16772;5;14;1479;0;583;529;54
2209;15;16787;5;15;1479;0;746;646;100
2209;16;16789;5;16;1434;2;701;632;69
2209;17;16766;5;17;1630;2;614;561;53
2209;18;16795;5;18;1229;1;581;503;78
2209;19;16799;5;19;1005;2;383;316;67
2209;20;16790;5;20;1989;1;831;729;102
2209;21;16773;5;21;57;0;24;18;6
2209;2;16764;5;2;971;0;577;465;112
2209;2;16768;5;2;1371;1;648;517;131
2209;2;16770;5;2;1142;0;531;437;94
2209;2;16776;5;2;1294;0;542;471;71
2209;2;16778;5;2;835;0;538;472;66
2209;2;16800;5;2;1075;0;363;315;48
2209;22;16793;5;22;28;0;28;17;11
2209;23;16797;5;23;32;0;17;13;4
2209;3;16765;5;3;800;0;323;249;74
2209;3;16771;5;3;2332;0;1028;942;86
2209;3;16779;5;3;738;0;429;341;88
2209;3;16780;5;3;1888;3;975;812;163
2209;4;16791;5;4;1051;0;445;363;82
2209;4;16794;5;4;1873;1;738;686;52
2209;5;16769;5;5;2139;1;896;832;64
2209;6;16796;5;6;2251;2;957;889;68
2209;7;16775;5;7;2122;0;867;796;71
2209;8;16786;5;8;1409;0;555;496;59
2209;9;16788;5;9;954;0;351;304;47
2210;10;16818;5;10;1136;0;528;438;90
2210;11;16814;5;11;773;0;455;369;86
2210;1;16810;5;1;2198;0;1140;964;176
2210;1;16816;5;1;1398;0;653;571;82
2210;1;16817;5;1;1804;0;1053;895;158
2210;1;16821;5;1;2337;1;1313;1050;263
2210;1;16825;5;1;1133;0;765;607;158
2210;12;16808;5;12;738;0;434;389;45
2210;13;16823;5;13;26;0;2;2;0
2210;2;16804;5;2;596;0;306;240;66
2210;2;16806;5;2;971;0;426;346;80
2210;2;16811;5;2;1004;0;485;422;63
2210;2;16826;5;2;741;0;444;373;71
2210;3;16802;5;3;1456;1;762;665;97
2210;3;16819;5;3;593;0;216;191;25
2210;4;16803;5;4;2095;1;987;832;155
2210;4;16805;5;4;450;0;139;106;33
2210;5;16807;5;5;1485;0;724;583;141
2210;5;16813;5;5;1202;0;554;486;68
2210;6;16820;5;6;615;0;293;259;34
2210;6;16824;5;6;1701;0;853;734;119
2210;7;16812;5;7;1522;0;679;562;117
2210;7;16815;5;7;966;1;524;430;94
2210;8;16809;5;8;1085;0;681;573;108
2210;8;16822;5;8;94;0;58;30;28
2210;9;16801;5;9;786;0;353;285;68
2211;10;16847;2;10;889;0;389;316;73
2211;10;16859;2;10;348;0;177;146;31
2211;11;16854;2;11;478;1;208;159;49
2211;11;16861;2;11;1305;0;520;445;75
2211;1;16828;2;1;1499;0;766;703;63
2211;1;16829;2;1;2217;0;1418;1243;175
2211;1;16835;2;1;2030;0;1158;938;220
2211;1;16848;2;1;2189;0;1039;917;122
2211;1;16849;2;1;1584;0;922;848;74
2211;1;16858;2;1;2215;0;1108;971;137
2211;1;16863;2;1;1927;1;1182;1047;135
2211;12;16850;2;12;875;0;323;280;43
2211;13;16865;2;13;722;0;313;263;50
2211;14;16870;2;14;626;0;265;236;29
2211;2;16827;2;2;1584;0;900;829;71
2211;2;16830;2;2;1742;0;884;748;136
2211;2;16832;2;2;503;0;316;261;55
2211;2;16840;2;2;1200;0;824;638;186
2211;2;16846;2;2;1821;0;933;839;94
2211;2;16851;2;2;2008;0;1154;1057;97
2211;2;16871;2;2;754;0;515;436;79
2211;3;16837;2;3;2014;1;1245;981;264
2211;3;16841;2;3;472;0;207;175;32
2211;3;16843;2;3;4;0;4;4;0
2211;3;16844;2;3;2078;0;1154;1025;129
2211;3;16845;2;3;908;0;345;302;43
2211;3;16852;2;3;1409;0;955;892;63
2211;3;16874;2;3;1679;0;812;691;121
2211;4;16833;2;4;1448;0;744;622;122
2211;4;16834;2;4;833;0;431;393;38
2211;4;16838;2;4;2217;0;1092;971;121
2211;4;16860;2;4;1345;1;846;782;64
2211;4;16868;2;4;1780;0;919;755;164
2211;5;16855;2;5;781;0;440;382;58
2211;5;16862;2;5;1877;0;997;900;97
2211;5;16867;2;5;742;0;368;301;67
2211;5;16869;2;5;1788;0;769;617;152
2211;5;16872;2;5;2009;0;1189;1116;73
2211;6;16831;2;6;84;0;37;17;20
2211;6;16836;2;6;1052;0;508;416;92
2211;6;16864;2;6;43;0;26;20;6
2211;6;16873;2;6;1414;0;611;489;122
2211;7;16839;2;7;327;0;217;174;43
2211;7;16853;2;7;796;0;393;335;58
2211;8;16857;2;8;245;0;112;100;12
2211;8;16866;2;8;1808;0;904;794;110
2211;9;16842;2;9;1661;0;879;762;117
2211;9;16856;2;9;827;0;350;297;53
2212;10;16879;1;10;287;0;150;117;33
2212;10;16890;1;10;444;0;184;160;24
2212;11;16911;1;11;396;0;154;140;14
2212;11;16925;1;11;371;0;145;111;34
2212;1;16882;1;1;1731;0;1121;853;268
2212;1;16883;1;1;1475;0;648;578;70
2212;1;16887;1;1;1613;0;875;730;145
2212;1;16899;1;1;360;0;231;180;51
2212;1;16912;1;1;1446;0;740;583;157
2212;1;16914;1;1;1461;0;843;656;187
2212;1;16916;1;1;1511;0;940;699;241
2212;1;16918;1;1;1014;0;353;280;73
2212;1;16930;1;1;2077;0;920;767;153
2212;1;16937;1;1;2257;0;1298;1065;233
2212;12;16904;1;12;396;0;146;126;20
2212;12;16924;1;12;367;0;151;136;15
2212;13;16936;1;13;448;0;212;168;44
2212;14;16906;1;14;346;0;189;168;21
2212;2;16880;1;2;533;0;182;156;26
2212;2;16881;1;2;1594;0;721;628;93
2212;2;16895;1;2;1017;0;375;306;69
2212;2;16900;1;2;1051;1;592;440;152
2212;2;16920;1;2;1867;0;942;713;229
2212;2;16921;1;2;1445;0;738;619;119
2212;2;16922;1;2;953;0;501;447;54
2212;2;16934;1;2;2171;3;1011;845;166
2212;2;16935;1;2;1789;1;1038;853;185
2212;2;16939;1;2;628;0;314;267;47
2212;3;16877;1;3;2452;0;956;834;122
2212;3;16884;1;3;1440;0;790;624;166
2212;3;16892;1;3;481;0;174;157;17
2212;3;16893;1;3;758;0;378;304;74
2212;3;16903;1;3;779;0;377;306;71
2212;3;16905;1;3;1444;0;556;377;179
2212;3;16927;1;3;1268;0;497;388;109
2212;3;16943;1;3;544;0;219;179;40
2212;3;16945;1;3;1940;2;697;585;112
2212;4;16875;1;4;826;1;476;395;81
2212;4;16888;1;4;663;0;329;271;58
2212;4;16901;1;4;905;0;441;334;107
2212;4;16909;1;4;491;0;210;182;28
2212;4;16923;1;4;1182;0;496;378;118
2212;4;16929;1;4;885;0;334;264;70
2212;4;16931;1;4;1878;0;826;742;84
2212;4;16941;1;4;1823;0;744;664;80
2212;5;16878;1;5;835;0;491;384;107
2212;5;16885;1;5;1375;0;578;445;133
2212;5;16886;1;5;1767;0;703;603;100
2212;5;16896;1;5;1066;0;466;390;76
2212;5;16902;1;5;380;0;121;105;16
2212;5;16907;1;5;676;0;356;256;100
2212;5;16908;1;5;551;0;257;191;66
2212;5;16944;1;5;1234;0;526;373;153
2212;6;16898;1;6;690;1;345;304;41
2212;6;16917;1;6;599;0;240;205;35
2212;6;16919;1;6;1160;0;502;378;124
2212;6;16926;1;6;1437;0;617;539;78
2212;6;16932;1;6;2161;0;926;775;151
2212;6;16938;1;6;935;0;415;352;63
2212;6;16940;1;6;1150;0;602;475;127
2212;7;16876;1;7;465;0;202;174;28
2212;7;16889;1;7;1298;0;557;487;70
2212;7;16913;1;7;1762;1;957;784;173
2212;7;16928;1;7;1434;1;651;561;90
2212;7;16942;1;7;400;0;178;154;24
2212;8;16891;1;8;1264;0;489;444;45
2212;8;16894;1;8;414;0;174;144;30
2212;8;16910;1;8;48;0;31;29;2
2212;8;16915;1;8;162;0;119;101;18
2212;9;16897;1;9;564;0;209;174;35
2212;9;16933;1;9;183;0;142;119;23
2213;10;16991;4;10;1151;0;417;363;54
2213;10;17002;4;10;1761;0;673;604;69
2213;11;16964;4;11;1884;0;768;700;68
2213;11;16985;4;11;553;0;235;205;30
2213;1;16950;4;1;1368;1;781;641;140
2213;1;16959;4;1;1818;0;869;723;146
2213;1;16972;4;1;1803;1;1061;848;213
2213;1;16980;4;1;1677;4;1024;840;184
2213;1;16986;4;1;1856;1;686;624;62
2213;1;16998;4;1;725;5;443;390;53
2213;1;17001;4;1;649;0;232;202;30
2213;1;17009;4;1;1377;0;651;553;98
2213;1;17015;4;1;2212;0;1157;979;178
2213;1;17016;4;1;1254;0;729;535;194
2213;1;17017;4;1;1242;0;772;658;114
2213;1;17020;4;1;1447;0;900;700;200
2213;1;17027;4;1;1225;1;795;582;213
2213;12;16971;4;12;1594;0;700;639;61
2213;12;17010;4;12;458;0;171;148;23
2213;13;16973;4;13;723;0;241;206;35
2213;13;17019;4;13;1700;0;618;548;70
2213;14;16990;4;14;751;0;356;304;52
2213;14;17029;4;14;1319;0;556;516;40
2213;15;17000;4;15;416;0;230;168;62
2213;15;17007;4;15;2255;0;880;800;80
2213;16;16956;4;16;472;0;283;234;49
2213;16;17018;4;16;1905;0;819;769;50
2213;17;16996;4;17;2151;0;890;826;64
2213;17;17006;4;17;606;0;334;291;43
2213;18;16948;4;18;1420;0;685;632;53
2213;18;17008;4;18;133;0;21;11;10
2213;19;17024;4;19;2208;0;717;647;70
2213;20;16958;4;20;1330;0;579;538;41
2213;21;17031;4;21;1252;0;577;527;50
2213;2;16946;4;2;361;0;196;161;35
2213;2;16947;4;2;2171;0;883;801;82
2213;2;16954;4;2;2210;1;1061;915;146
2213;2;16955;4;2;999;0;605;428;177
2213;2;16960;4;2;1275;1;711;590;121
2213;2;16969;4;2;1025;1;593;485;108
2213;2;16974;4;2;672;0;376;286;90
2213;2;16975;4;2;361;0;209;169;40
2213;2;16979;4;2;1437;2;607;520;87
2213;2;16995;4;2;987;1;631;559;72
2213;2;16997;4;2;1213;0;271;212;59
2213;2;17003;4;2;2131;0;1186;1019;167
2213;2;17033;4;2;1035;0;479;396;83
2213;22;16989;4;22;36;0;8;8;0
2213;23;16976;4;23;15;0;9;9;0
2213;24;17004;4;24;31;0;30;26;4
2213;3;16957;4;3;484;0;244;179;65
2213;3;16962;4;3;390;0;182;168;14
2213;3;16963;4;3;960;0;507;417;90
2213;3;16977;4;3;281;1;135;123;12
2213;3;16978;4;3;744;0;350;275;75
2213;3;16988;4;3;1185;1;604;509;95
2213;3;16999;4;3;1099;0;539;479;60
2213;3;17012;4;3;1638;0;882;714;168
2213;3;17021;4;3;336;0;166;129;37
2213;3;17028;4;3;1373;1;519;479;40
2213;4;16951;4;4;586;0;248;212;36
2213;4;16968;4;4;464;1;267;206;61
2213;4;16981;4;4;2189;0;887;808;79
2213;4;16982;4;4;767;0;377;328;49
2213;4;16984;4;4;815;0;438;368;70
2213;4;17011;4;4;1059;0;423;385;38
2213;4;17013;4;4;370;0;193;144;49
2213;4;17030;4;4;654;2;249;192;57
2213;5;16949;4;5;503;0;268;223;45
2213;5;16953;4;5;592;0;352;294;58
2213;5;16961;4;5;335;0;168;129;39
2213;5;16970;4;5;1682;0;532;480;52
2213;5;17022;4;5;1945;0;1001;868;133
2213;5;17023;4;5;494;0;241;200;41
2213;6;16967;4;6;671;0;257;186;71
2213;6;16987;4;6;1276;0;632;568;64
2213;6;16993;4;6;2260;2;895;804;91
2213;6;16994;4;6;740;0;312;266;46
2213;6;17032;4;6;576;1;311;268;43
2213;7;16983;4;7;453;0;173;125;48
2213;7;16992;4;7;1083;0;477;402;75
2213;7;17026;4;7;1808;1;543;474;69
2213;8;16965;4;8;584;0;329;273;56
2213;8;17014;4;8;338;0;151;127;24
2213;8;17025;4;8;1807;0;607;506;101
2213;9;16952;4;9;1785;0;570;509;61
2213;9;16966;4;9;546;1;333;290;43
2213;9;17005;4;9;701;0;298;261;37
2214;10;17038;5;10;1105;8;565;482;83
2214;10;17070;5;10;1771;0;751;710;41
2214;10;17085;5;10;1239;0;561;450;111
2214;10;17105;5;10;980;0;490;420;70
2214;11;17049;5;11;587;0;184;143;41
2214;11;17050;5;11;783;0;317;284;33
2214;11;17053;5;11;1430;1;574;527;47
2214;11;17066;5;11;94;0;40;31;9
2214;1;17047;5;1;568;0;322;283;39
2214;1;17054;5;1;1916;0;665;602;63
2214;1;17082;5;1;2378;0;1180;983;197
2214;1;17090;5;1;1247;0;377;317;60
2214;1;17095;5;1;1831;1;741;680;61
2214;1;17097;5;1;1903;0;903;786;117
2214;12;17068;5;12;2300;0;994;940;54
2214;12;17092;5;12;123;0;90;52;38
2214;12;17096;5;12;81;0;66;59;7
2214;13;17040;5;13;1828;2;899;866;33
2214;14;17036;5;14;1354;0;547;514;33
2214;15;17034;5;15;1733;0;605;542;63
2214;16;17061;5;16;1176;0;471;433;38
2214;17;17058;5;17;1682;0;719;662;57
2214;18;17062;5;18;1902;0;807;771;36
2214;19;17094;5;19;1847;0;706;679;27
2214;20;17052;5;20;1524;0;536;488;48
2214;21;17083;5;21;2294;2;964;915;49
2214;2;17041;5;2;1775;0;868;721;147
2214;2;17067;5;2;761;0;376;348;28
2214;2;17069;5;2;752;0;215;168;47
2214;2;17084;5;2;1571;0;514;463;51
2214;2;17089;5;2;1022;0;295;249;46
2214;2;17098;5;2;1624;0;663;565;98
2214;22;17044;5;22;1838;0;746;695;51
2214;23;17099;5;23;1752;0;646;621;25
2214;24;17086;5;24;1027;0;401;375;26
2214;25;17088;5;25;1464;0;607;567;40
2214;26;17064;5;26;2164;0;977;926;51
2214;27;17107;5;27;1667;0;678;653;25
2214;28;17037;5;28;782;0;312;284;28
2214;29;17075;5;29;1897;0;809;762;47
2214;30;17101;5;30;2140;2;935;894;41
2214;31;17076;5;31;9;0;1;1;0
2214;3;17042;5;3;1771;0;727;586;141
2214;3;17051;5;3;872;2;184;137;47
2214;3;17065;5;3;983;1;330;287;43
2214;3;17081;5;3;620;0;287;264;23
2214;3;17102;5;3;1158;0;441;391;50
2214;3;17104;5;3;1358;0;634;508;126
2214;32;17055;5;32;28;0;5;5;0
2214;33;17045;5;33;25;0;7;6;1
2214;4;17063;5;4;1033;0;437;371;66
2214;4;17071;5;4;1193;0;546;453;93
2214;4;17072;5;4;838;0;362;302;60
2214;4;17100;5;4;1224;0;406;350;56
2214;5;17046;5;5;966;0;330;271;59
2214;5;17048;5;5;1177;0;493;397;96
2214;5;17079;5;5;384;0;214;182;32
2214;5;17091;5;5;1382;0;505;444;61
2214;6;17056;5;6;639;1;260;234;26
2214;6;17059;5;6;756;0;428;341;87
2214;6;17060;5;6;870;0;413;348;65
2214;6;17103;5;6;1254;0;628;559;69
2214;7;17039;5;7;1451;0;625;585;40
2214;7;17077;5;7;588;0;289;238;51
2214;7;17080;5;7;1179;0;602;489;113
2214;7;17093;5;7;1179;2;508;445;63
2214;8;17043;5;8;1432;0;562;520;42
2214;8;17073;5;8;1029;0;375;320;55
2214;8;17074;5;8;805;0;410;338;72
2214;8;17078;5;8;1113;0;413;344;69
2214;9;17035;5;9;987;0;408;342;66
2214;9;17057;5;9;1513;0;631;589;42
2214;9;17087;5;9;529;0;244;209;35
2214;9;17106;5;9;741;0;352;314;38
2215;10;17172;2;10;1212;0;631;510;121
2215;10;17173;2;10;2311;0;1057;981;76
2215;10;17181;2;10;1243;0;439;405;34
2215;11;17136;2;11;2125;0;1014;925;89
2215;11;17187;2;11;2285;0;1163;1082;81
2215;1;17118;2;1;1563;0;825;576;249
2215;1;17120;2;1;2375;0;1578;1267;311
2215;1;17146;2;1;1988;0;952;826;126
2215;1;17150;2;1;1592;0;957;791;166
2215;1;17154;2;1;1836;0;1122;923;199
2215;1;17165;2;1;1933;0;1053;861;192
2215;1;17168;2;1;2129;0;1162;852;310
2215;1;17183;2;1;2054;0;915;851;64
2215;1;17189;2;1;1809;1;907;840;67
2215;1;17191;2;1;2380;0;1073;984;89
2215;12;17109;2;12;2053;1;958;867;91
2215;12;17134;2;12;2251;0;1093;1015;78
2215;13;17144;2;13;2354;0;1030;952;78
2215;13;17198;2;13;2129;0;1059;964;95
2215;14;17108;2;14;2120;0;956;875;81
2215;14;17199;2;14;2280;0;1139;1053;86
2215;15;17131;2;15;2302;0;1076;1002;74
2215;15;17147;2;15;1617;0;809;702;107
2215;16;17121;2;16;1340;0;577;577;0
2215;16;17171;2;16;2454;0;1097;1025;72
2215;17;17175;2;17;1573;2;774;673;101
2215;17;17179;2;17;1154;0;508;467;41
2215;18;17196;2;18;1444;1;661;568;93
2215;19;17176;2;19;1207;1;546;487;59
2215;20;17148;2;20;1751;1;915;806;109
2215;21;17124;2;21;1792;2;932;831;101
2215;2;17129;2;2;2068;0;850;742;108
2215;2;17149;2;2;1642;0;949;822;127
2215;2;17155;2;2;734;0;326;278;48
2215;2;17157;2;2;934;0;443;393;50
2215;2;17158;2;2;1575;0;1024;872;152
2215;2;17182;2;2;2124;0;846;796;50
2215;2;17184;2;2;1716;0;846;647;199
2215;2;17190;2;2;1573;0;929;785;144
2215;2;17197;2;2;1576;0;842;787;55
2215;2;17200;2;2;525;1;308;218;90
2215;22;17123;2;22;2305;0;1130;1044;86
2215;23;17128;2;23;32;0;8;6;2
2215;24;17122;2;24;31;0;2;1;1
2215;25;17145;2;25;71;0;41;36;5
2215;3;17110;2;3;484;0;337;258;79
2215;3;17111;2;3;1473;0;768;652;116
2215;3;17137;2;3;1543;0;909;651;258
2215;3;17138;2;3;1732;0;644;597;47
2215;3;17139;2;3;567;0;330;229;101
2215;3;17142;2;3;2051;3;1234;1038;196
2215;3;17152;2;3;1618;0;538;401;137
2215;3;17159;2;3;1749;8;883;715;168
2215;3;17169;2;3;2250;0;921;843;78
2215;3;17201;2;3;1491;1;827;778;49
2215;4;17113;2;4;1426;3;777;713;64
2215;4;17117;2;4;953;0;565;404;161
2215;4;17130;2;4;1113;0;454;419;35
2215;4;17132;2;4;534;0;286;240;46
2215;4;17140;2;4;1262;0;638;562;76
2215;4;17143;2;4;2468;1;1189;1109;80
2215;4;17174;2;4;1014;11;647;425;222
2215;4;17177;2;4;1139;0;570;433;137
2215;4;17185;2;4;1770;0;1027;933;94
2215;5;17114;2;5;2076;0;1034;958;76
2215;5;17126;2;5;1923;0;845;764;81
2215;5;17153;2;5;2195;1;1193;1016;177
2215;5;17162;2;5;1163;0;654;549;105
2215;5;17178;2;5;1212;0;583;523;60
2215;5;17188;2;5;1002;0;569;517;52
2215;5;17193;2;5;572;0;203;158;45
2215;5;17195;2;5;1395;0;763;556;207
2215;6;17115;2;6;2162;0;1260;1015;245
2215;6;17116;2;6;1604;0;804;742;62
2215;6;17127;2;6;750;0;388;300;88
2215;6;17135;2;6;1960;0;815;731;84
2215;6;17156;2;6;1269;0;621;485;136
2215;6;17160;2;6;1927;0;1273;981;292
2215;6;17161;2;6;2336;0;1118;1052;66
2215;6;17164;2;6;122;0;66;48;18
2215;7;17119;2;7;1677;0;832;737;95
2215;7;17133;2;7;1943;0;1002;922;80
2215;7;17163;2;7;964;0;445;402;43
2215;7;17170;2;7;1106;0;691;552;139
2215;7;17186;2;7;1041;0;488;440;48
2215;7;17192;2;7;1038;0;495;376;119
2215;8;17112;2;8;2147;1;1063;982;81
2215;8;17167;2;8;1779;2;1041;832;209
2215;8;17180;2;8;2083;0;849;762;87
2215;8;17194;2;8;1821;0;897;813;84
2215;9;17125;2;9;1616;0;775;708;67
2215;9;17141;2;9;1884;0;773;699;74
2215;9;17151;2;9;1647;0;772;697;75
2215;9;17166;2;9;1181;0;704;579;125
2216;10;17213;5;10;1788;0;816;750;66
2216;10;17221;5;10;204;0;80;70;10
2216;11;17214;5;11;1319;0;585;522;63
2216;1;17202;5;1;603;1;343;281;62
2216;1;17205;5;1;1753;0;776;651;125
2216;1;17215;5;1;1905;0;784;595;189
2216;1;17232;5;1;449;0;210;189;21
2216;1;17233;5;1;2083;1;860;690;170
2216;12;17203;5;12;1289;0;569;494;75
2216;13;17225;5;13;39;0;7;7;0
2216;2;17208;5;2;930;0;374;319;55
2216;2;17210;5;2;1150;0;386;285;101
2216;2;17212;5;2;1274;0;438;378;60
2216;2;17227;5;2;2549;0;1112;903;209
2216;2;17231;5;2;1250;0;837;709;128
2216;3;17216;5;3;1768;1;747;652;95
2216;3;17218;5;3;1482;8;1001;797;204
2216;3;17226;5;3;250;0;113;89;24
2216;3;17229;5;3;1022;0;409;378;31
2216;4;17207;5;4;801;0;320;275;45
2216;4;17211;5;4;708;0;349;283;66
2216;4;17223;5;4;319;0;162;134;28
2216;5;17220;5;5;414;0;162;145;17
2216;5;17224;5;5;519;0;219;164;55
2216;5;17234;5;5;363;0;102;88;14
2216;6;17206;5;6;1304;0;631;556;75
2216;6;17217;5;6;442;0;194;140;54
2216;7;17204;5;7;2135;0;1013;904;109
2216;7;17222;5;7;419;0;225;182;43
2216;8;17219;5;8;335;0;111;92;19
2216;8;17230;5;8;1100;0;470;431;39
2216;9;17209;5;9;628;1;226;176;50
2216;9;17228;5;9;813;0;441;381;60
2261;100;17271;3;100;1619;0;742;716;26
2261;101;17304;3;101;1968;0;925;913;12
2261;10;17370;3;10;1388;0;432;403;29
2261;102;17350;3;102;1405;0;653;624;29
2261;103;17410;3;103;1786;0;864;848;16
2261;104;17273;3;104;1832;0;799;774;25
2261;105;17354;3;105;2750;0;1201;1183;18
2261;106;17421;3;106;2736;0;1197;1166;31
2261;107;17365;3;107;2186;0;943;928;15
2261;108;17404;3;108;2310;0;1006;968;38
2261;109;17311;3;109;2052;0;898;872;26
2261;110;17425;3;110;1218;0;501;483;18
2261;111;17372;3;111;2147;0;1042;1024;18
2261;11;17247;3;11;1981;0;587;555;32
2261;112;17446;3;112;1690;0;814;782;32
2261;113;17249;3;113;1260;0;641;620;21
2261;114;17324;3;114;2404;0;897;869;28
2261;115;17300;3;115;2309;0;853;823;30
2261;116;17424;3;116;1376;0;429;406;23
2261;117;17387;3;117;2002;0;641;611;30
2261;1;17431;3;1;1884;0;777;759;18
2261;118;17332;3;118;2237;0;1002;982;20
2261;119;17270;3;119;1894;0;885;861;24
2261;120;17401;3;120;1030;0;344;336;8
2261;121;17375;3;121;1080;0;357;343;14
2261;12;17388;3;12;1376;0;410;390;20
2261;122;17434;3;122;54;0;8;8;0
2261;123;17236;3;123;178;0;20;20;0
2261;124;17264;3;124;2024;0;897;883;14
2261;125;17321;3;125;118;0;30;28;2
2261;126;17378;3;126;1967;0;734;725;9
2261;127;17302;3;127;1989;0;770;759;11
2261;128;17447;3;128;1676;0;755;747;8
2261;129;17352;3;129;695;0;287;273;14
2261;130;17419;3;130;1578;0;579;553;26
2261;131;17339;3;131;1821;0;655;655;0
2261;13;17277;3;13;1096;0;214;194;20
2261;132;17336;3;132;1846;0;807;786;21
2261;133;17438;3;133;1426;0;505;490;15
2261;134;17347;3;134;905;0;416;408;8
2261;135;17322;3;135;1334;0;492;479;13
2261;136;17292;3;136;22;0;11;11;0
2261;137;17238;3;137;1725;0;673;651;22
2261;138;17296;3;138;1938;0;660;636;24
2261;139;17325;3;139;1276;0;444;430;14
2261;140;17433;3;140;1369;0;541;530;11
2261;141;17398;3;141;60;0;14;14;0
2261;14;17361;3;14;1806;0;742;713;29
2261;142;17283;3;142;2620;1;1021;994;27
2261;143;17299;3;143;1280;0;541;516;25
2261;144;17391;3;144;2090;0;800;777;23
2261;145;17280;3;145;2054;0;830;803;27
2261;146;17389;3;146;1787;0;739;724;15
2261;147;17337;3;147;1785;0;698;683;15
2261;148;17342;3;148;1982;0;631;608;23
2261;149;17319;3;149;1930;0;766;740;26
2261;150;17338;3;150;1895;0;725;697;28
2261;151;17298;3;151;1720;0;573;557;16
2261;15;17284;3;15;1104;0;332;313;19
2261;152;17278;3;152;834;0;387;375;12
2261;153;17445;3;153;1374;0;707;690;17
2261;154;17348;3;154;1222;0;565;548;17
2261;155;17407;3;155;1489;0;643;617;26
2261;156;17334;3;156;2131;0;933;922;11
2261;157;17246;3;157;2100;0;963;947;16
2261;158;17281;3;158;2158;0;954;939;15
2261;159;17288;3;159;2156;0;885;872;13
2261;160;17250;3;160;854;0;399;391;8
2261;161;17430;3;161;159;0;45;45;0
2261;16;17235;3;16;1991;0;557;536;21
2261;162;17439;3;162;1495;0;727;698;29
2261;163;17353;3;163;2118;0;908;875;33
2261;164;17379;3;164;85;0;45;34;11
2261;165;17256;3;165;2201;0;998;980;18
2261;166;17242;3;166;2132;0;904;887;17
2261;167;17297;3;167;2305;0;1005;978;27
2261;168;17385;3;168;1549;0;753;739;14
2261;169;17317;3;169;1896;0;936;918;18
2261;170;17301;3;170;1977;0;736;698;38
2261;171;17444;3;171;2040;0;744;731;13
2261;17;17384;3;17;2152;0;692;659;33
2261;172;17406;3;172;1947;0;909;888;21
2261;173;17420;3;173;2097;0;800;774;26
2261;174;17371;3;174;2242;0;815;789;26
2261;175;17318;3;175;1864;0;693;671;22
2261;176;17269;3;176;2132;0;846;824;22
2261;177;17260;3;177;1907;0;864;835;29
2261;178;17244;3;178;1599;0;743;723;20
2261;179;17285;3;179;2275;0;955;942;13
2261;180;17259;3;180;2157;0;822;795;27
2261;181;17411;3;181;2131;0;883;883;0
2261;18;17251;3;18;94;0;45;33;12
2261;182;17386;3;182;1855;0;750;750;0
2261;183;17441;3;183;2022;0;812;780;32
2261;184;17409;3;184;2342;0;1132;1095;37
2261;185;17383;3;185;1315;0;581;581;0
2261;186;17303;3;186;1762;0;806;787;19
2261;187;17295;3;187;76;0;35;30;5
2261;188;17394;3;188;2042;0;907;907;0
2261;189;17265;3;189;1632;0;739;713;26
2261;190;17275;3;190;2104;0;901;869;32
2261;191;17320;3;191;2090;0;889;863;26
2261;19;17448;3;19;44;0;20;17;3
2261;192;17442;3;192;1967;0;662;644;18
2261;193;17369;3;193;1977;0;818;805;13
2261;194;17274;3;194;1808;0;657;640;17
2261;195;17418;3;195;2048;0;952;927;25
2261;196;17408;3;196;2043;0;898;898;0
2261;197;17240;3;197;2112;0;1016;990;26
2261;198;17373;3;198;2021;1;951;933;18
2261;199;17282;3;199;1815;0;778;759;19
2261;200;17358;3;200;2000;0;882;850;32
2261;201;17294;3;201;2108;0;765;744;21
2261;20;17261;3;20;2296;0;738;688;50
2261;202;17422;3;202;1851;0;704;677;27
2261;203;17396;3;203;1665;1;591;573;18
2261;204;17349;3;204;1611;0;717;706;11
2261;205;17392;3;205;1980;0;874;844;30
2261;206;17326;3;206;1343;0;629;619;10
2261;207;17360;3;207;98;0;43;37;6
2261;208;17258;3;208;661;0;344;339;5
2261;209;17308;3;209;1429;0;695;680;15
2261;210;17268;3;210;1930;0;911;889;22
2261;211;17262;3;211;40;0;14;13;1
2261;21;17289;3;21;1782;1;518;491;27
2261;212;17402;3;212;2194;0;1081;1056;25
2261;213;17355;3;213;2031;0;965;965;0
2261;214;17412;3;214;2211;0;1110;1080;30
2261;215;17357;3;215;1896;1;975;956;19
2261;216;17428;3;216;1798;0;874;847;27
2261;2;17414;3;2;1986;0;765;748;17
2261;22;17255;3;22;2145;0;648;607;41
2261;23;17331;3;23;1812;0;560;524;36
2261;24;17345;3;24;1901;0;652;632;20
2261;25;17287;3;25;1567;0;440;410;30
2261;26;17359;3;26;1216;0;369;360;9
2261;27;17397;3;27;1511;0;348;328;20
2261;28;17436;3;28;1162;0;268;253;15
2261;29;17279;3;29;662;0;165;157;8
2261;30;17328;3;30;1952;0;557;528;29
2261;31;17413;3;31;1944;0;478;444;34
2261;3;17429;3;3;1649;0;565;547;18
2261;32;17399;3;32;1645;0;642;630;12
2261;33;17395;3;33;1438;0;541;521;20
2261;34;17313;3;34;1316;0;303;283;20
2261;35;17291;3;35;936;0;275;253;22
2261;36;17381;3;36;1451;0;360;330;30
2261;37;17380;3;37;1233;0;393;362;31
2261;38;17344;3;38;1336;1;384;359;25
2261;39;17290;3;39;872;0;241;233;8
2261;40;17245;3;40;705;0;257;250;7
2261;41;17364;3;41;1552;0;613;589;24
2261;4;17286;3;4;1730;0;537;520;17
2261;42;17306;3;42;1126;0;566;543;23
2261;43;17340;3;43;1131;0;510;500;10
2261;44;17382;3;44;1622;0;622;588;34
2261;45;17237;3;45;1541;0;660;637;23
2261;46;17310;3;46;1490;2;631;618;13
2261;47;17248;3;47;1865;0;768;701;67
2261;48;17368;3;48;1424;0;501;501;0
2261;49;17243;3;49;948;0;336;326;10
2261;50;17335;3;50;1601;0;529;496;33
2261;51;17362;3;51;1894;0;546;523;23
2261;5;17341;3;5;72;0;27;8;19
2261;52;17393;3;52;1864;0;542;524;18
2261;53;17367;3;53;1655;0;556;518;38
2261;54;17356;3;54;1761;0;644;621;23
2261;55;17440;3;55;1370;0;509;490;19
2261;56;17315;3;56;915;0;217;203;14
2261;57;17417;3;57;126;0;11;11;0
2261;58;17327;3;58;285;0;150;125;25
2261;59;17305;3;59;2040;1;621;603;18
2261;60;17239;3;60;2472;0;888;867;21
2261;61;17312;3;61;2021;0;744;734;10
2261;6;17377;3;6;1995;0;805;776;29
2261;62;17266;3;62;1812;0;516;500;16
2261;63;17252;3;63;2249;0;884;849;35
2261;64;17254;3;64;2208;0;804;775;29
2261;65;17323;3;65;2096;0;838;823;15
2261;66;17330;3;66;2721;0;1164;1137;27
2261;67;17376;3;67;1843;0;571;554;17
2261;68;17427;3;68;2289;0;870;842;28
2261;69;17443;3;69;2275;0;1050;1026;24
2261;70;17316;3;70;2382;0;1047;1018;29
2261;71;17423;3;71;2329;0;1079;1055;24
2261;7;17403;3;7;2069;0;739;716;23
2261;72;17400;3;72;2809;0;1212;1204;8
2261;73;17363;3;73;2423;0;1080;1051;29
2261;74;17263;3;74;2720;0;1213;1186;27
2261;75;17267;3;75;1857;0;652;617;35
2261;76;17257;3;76;1333;0;511;495;16
2261;77;17366;3;77;1988;0;842;813;29
2261;78;17405;3;78;1915;0;786;760;26
2261;79;17374;3;79;2162;0;933;899;34
2261;80;17309;3;80;1544;0;662;643;19
2261;81;17437;3;81;2501;0;1029;1004;25
2261;8;17449;3;8;1981;0;778;760;18
2261;82;17333;3;82;2327;0;921;891;30
2261;83;17307;3;83;2480;0;970;936;34
2261;84;17450;3;84;2297;0;845;797;48
2261;85;17293;3;85;2191;0;1106;1085;21
2261;86;17253;3;86;2059;0;696;661;35
2261;87;17390;3;87;1395;0;495;465;30
2261;88;17416;3;88;1754;2;645;621;24
2261;89;17272;3;89;2151;0;857;837;20
2261;90;17426;3;90;2003;0;772;731;41
2261;91;17351;3;91;1805;0;731;703;28
2261;9;17276;3;9;2125;0;839;794;45
2261;92;17435;3;92;17;0;10;9;1
2261;93;17314;3;93;911;0;317;301;16
2261;94;17329;3;94;69;0;9;9;0
2261;95;17346;3;95;1464;0;570;539;31
2261;96;17432;3;96;1580;0;678;654;24
2261;97;17343;3;97;1429;0;687;663;24
2261;98;17241;3;98;1773;0;775;759;16
2261;99;17415;3;99;1629;0;733;705;28
2262;100;17504;2;100;1634;2;684;656;28
2262;101;17465;2;101;1861;0;882;817;65
2262;10;17474;2;10;1218;0;595;563;32
2262;102;17554;2;102;1414;0;686;653;33
2262;103;17457;2;103;1130;0;542;515;27
2262;104;17518;2;104;1905;0;916;878;38
2262;105;17455;2;105;1956;0;964;929;35
2262;106;17463;2;106;2320;0;1050;1003;47
2262;107;17531;2;107;2021;0;927;893;34
2262;108;17509;2;108;1225;0;639;608;31
2262;109;17508;2;109;1636;0;807;779;28
2262;110;17547;2;110;2278;0;1109;1053;56
2262;111;17548;2;111;1893;0;887;809;78
2262;11;17452;2;11;1935;0;866;808;58
2262;112;17536;2;112;2235;0;1027;981;46
2262;113;17460;2;113;1549;0;710;661;49
2262;114;17530;2;114;2165;0;984;879;105
2262;115;17545;2;115;1679;0;760;707;53
2262;116;17461;2;116;2041;0;761;701;60
2262;117;17454;2;117;97;0;34;27;7
2262;1;17542;2;1;1758;0;759;759;0
2262;118;17476;2;118;64;0;20;16;4
2262;119;17491;2;119;36;0;26;25;1
2262;120;17480;2;120;75;0;53;42;11
2262;12;17568;2;12;2152;0;958;917;41
2262;13;17479;2;13;1961;0;941;900;41
2262;14;17475;2;14;1715;0;774;745;29
2262;15;17458;2;15;1981;0;734;732;2
2262;16;17551;2;16;2168;0;996;949;47
2262;17;17468;2;17;1705;0;807;755;52
2262;18;17510;2;18;1980;2;872;831;41
2262;19;17494;2;19;1819;0;856;792;64
2262;20;17481;2;20;2156;0;862;809;53
2262;21;17482;2;21;1881;1;637;589;48
2262;2;17515;2;2;1713;0;807;779;28
2262;22;17534;2;22;1690;0;692;661;31
2262;23;17453;2;23;1189;1;474;434;40
2262;24;17538;2;24;2099;0;912;872;40
2262;25;17477;2;25;2221;0;927;881;46
2262;26;17487;2;26;2253;0;992;946;46
2262;27;17562;2;27;896;0;440;424;16
2262;28;17503;2;28;2230;0;1013;938;75
2262;29;17505;2;29;1789;0;829;792;37
2262;30;17485;2;30;746;0;357;349;8
2262;31;17532;2;31;1670;0;820;793;27
2262;3;17467;2;3;1599;0;713;682;31
2262;32;17498;2;32;1117;0;481;470;11
2262;33;17516;2;33;1100;0;521;498;23
2262;34;17486;2;34;1025;7;580;555;25
2262;35;17529;2;35;862;0;420;403;17
2262;36;17462;2;36;1566;0;792;732;60
2262;37;17563;2;37;2283;0;1235;1191;44
2262;38;17470;2;38;1763;1;832;785;47
2262;39;17540;2;39;1805;0;623;565;58
2262;40;17512;2;40;1876;0;790;740;50
2262;41;17553;2;41;1079;0;516;480;36
2262;4;17483;2;4;1535;0;605;557;48
2262;42;17500;2;42;2348;0;1213;1150;63
2262;43;17564;2;43;2147;0;1037;1009;28
2262;44;17552;2;44;2084;0;1047;1017;30
2262;45;17528;2;45;810;1;371;357;14
2262;46;17459;2;46;1393;0;659;629;30
2262;47;17566;2;47;2013;0;1193;1159;34
2262;48;17507;2;48;2248;1;1046;993;53
2262;49;17517;2;49;1639;0;770;747;23
2262;50;17543;2;50;2017;1;1079;1036;43
2262;51;17555;2;51;1474;0;730;709;21
2262;5;17520;2;5;2094;0;892;857;35
2262;52;17524;2;52;2379;0;1256;1214;42
2262;53;17492;2;53;2176;1;1028;1002;26
2262;54;17490;2;54;1776;0;798;771;27
2262;55;17546;2;55;2333;0;1185;1149;36
2262;56;17533;2;56;2116;0;1029;1008;21
2262;57;17522;2;57;2246;0;1057;1010;47
2262;58;17501;2;58;1220;0;645;625;20
2262;59;17456;2;59;1160;0;606;577;29
2262;60;17519;2;60;1981;0;906;867;39
2262;61;17488;2;61;2142;0;1080;1024;56
2262;6;17497;2;6;2064;0;1014;936;78
2262;62;17493;2;62;2089;0;929;904;25
2262;63;17565;2;63;1981;0;836;805;31
2262;64;17489;2;64;1908;0;891;868;23
2262;65;17521;2;65;2414;0;1081;1045;36
2262;66;17511;2;66;1907;0;823;787;36
2262;67;17550;2;67;1124;0;589;567;22
2262;68;17496;2;68;1531;0;755;722;33
2262;69;17567;2;69;1304;0;674;647;27
2262;70;17478;2;70;1836;0;940;914;26
2262;71;17557;2;71;2283;0;1159;1122;37
2262;7;17570;2;7;2418;0;1130;1071;59
2262;72;17473;2;72;2349;0;1185;1154;31
2262;73;17526;2;73;2153;0;1057;1032;25
2262;74;17525;2;74;1605;0;765;744;21
2262;75;17464;2;75;1549;0;614;570;44
2262;76;17506;2;76;1705;1;725;682;43
2262;77;17513;2;77;1291;0;623;578;45
2262;78;17544;2;78;1204;0;556;530;26
2262;79;17537;2;79;1347;1;643;621;22
2262;80;17556;2;80;1574;0;806;781;25
2262;81;17495;2;81;1066;1;587;562;25
2262;8;17539;2;8;1627;0;762;740;22
2262;82;17471;2;82;1445;1;836;804;32
2262;83;17559;2;83;1094;0;584;560;24
2262;84;17472;2;84;1310;2;647;628;19
2262;85;17484;2;85;1142;0;533;501;32
2262;86;17499;2;86;1083;2;538;520;18
2262;87;17466;2;87;795;0;332;318;14
2262;88;17523;2;88;1486;0;822;802;20
2262;89;17527;2;89;915;0;498;477;21
2262;90;17549;2;90;845;1;442;425;17
2262;91;17469;2;91;1412;1;731;705;26
2262;9;17569;2;9;1835;0;875;818;57
2262;92;17541;2;92;1013;0;508;483;25
2262;93;17560;2;93;1721;0;836;788;48
2262;94;17451;2;94;1142;0;398;367;31
2262;95;17558;2;95;1795;0;793;751;42
2262;96;17535;2;96;1977;0;890;860;30
2262;97;17502;2;97;1723;0;837;804;33
2262;98;17514;2;98;1365;1;599;577;22
2262;99;17561;2;99;2266;0;959;904;55
2263;10;17612;1;10;1388;0;556;516;40
2263;11;17572;1;11;2239;0;954;893;61
2263;1;17586;1;1;1269;0;608;574;34
2263;12;17610;1;12;2000;0;774;710;64
2263;13;17602;1;13;2122;0;967;903;64
2263;14;17576;1;14;1196;0;471;433;38
2263;15;17616;1;15;1648;0;652;609;43
2263;16;17594;1;16;1350;0;631;583;48
2263;17;17599;1;17;1260;0;418;371;47
2263;18;17605;1;18;2053;1;992;898;94
2263;19;17590;1;19;1676;0;877;800;77
2263;20;17593;1;20;1617;0;737;672;65
2263;21;17607;1;21;1757;1;658;653;5
2263;2;17589;1;2;1966;0;894;832;62
2263;22;17575;1;22;2126;0;946;888;58
2263;23;17596;1;23;1910;1;596;520;76
2263;24;17588;1;24;1974;0;629;544;85
2263;25;17595;1;25;38;0;8;5;3
2263;26;17571;1;26;1840;0;623;560;63
2263;27;17600;1;27;1980;0;672;618;54
2263;28;17580;1;28;1850;0;707;650;57
2263;29;17591;1;29;1229;0;616;571;45
2263;30;17608;1;30;1307;0;452;398;54
2263;31;17592;1;31;1541;0;506;448;58
2263;3;17582;1;3;2124;0;941;858;83
2263;32;17615;1;32;1741;0;660;604;56
2263;33;17573;1;33;2084;1;876;810;66
2263;34;17604;1;34;1934;1;808;749;59
2263;35;17578;1;35;72;0;37;24;13
2263;36;17587;1;36;1489;0;581;494;87
2263;37;17577;1;37;1994;0;707;632;75
2263;38;17597;1;38;579;0;224;198;26
2263;39;17579;1;39;2059;0;845;845;0
2263;40;17585;1;40;1903;1;823;733;90
2263;41;17601;1;41;2300;0;1017;929;88
2263;4;17606;1;4;1946;0;840;801;39
2263;42;17584;1;42;28;0;12;12;0
2263;43;17598;1;43;2438;0;1133;1046;87
2263;44;17614;1;44;2400;2;1172;1053;119
2263;45;17603;1;45;2307;0;1009;941;68
2263;46;17613;1;46;58;0;20;12;8
2263;5;17611;1;5;2521;1;1293;1201;92
2263;6;17574;1;6;1940;0;968;918;50
2263;7;17583;1;7;1820;0;817;745;72
2263;8;17581;1;8;2320;0;1119;1051;68
2263;9;17609;1;9;2092;0;949;881;68
2264;10;17632;2;10;1957;0;1135;1076;59
2264;11;17626;2;11;1523;1;878;843;35
2264;1;17619;2;1;1207;0;703;664;39
2264;12;17633;2;12;1338;1;856;825;31
2264;13;17630;2;13;2088;0;1067;1015;52
2264;14;17618;2;14;1414;1;711;671;40
2264;15;17629;2;15;1940;1;1179;1105;74
2264;16;17624;2;16;1407;1;752;703;49
2264;17;17627;2;17;1929;0;1135;1085;50
2264;18;17621;2;18;1045;0;546;511;35
2264;19;17634;2;19;1630;1;926;892;34
2264;20;17620;2;20;1596;0;962;917;45
2264;21;17636;2;21;1662;1;992;950;42
2264;2;17628;2;2;928;0;522;488;34
2264;3;17622;2;3;1165;1;672;639;33
2264;4;17625;2;4;1331;1;752;707;45
2264;5;17635;2;5;1187;1;680;636;44
2264;6;17623;2;6;1951;1;1121;1063;58
2264;7;17631;2;7;1003;0;540;505;35
2264;8;17637;2;8;1879;1;1036;984;52
2264;9;17617;2;9;2086;1;1183;1128;55
2401;10;17661;7;10;494;0;253;219;34
2401;10;17676;7;10;1765;0;808;709;99
2401;10;17719;7;10;1191;0;501;458;43
2401;11;17646;7;11;787;0;361;328;33
2401;11;17671;7;11;1903;0;782;723;59
2401;1;17649;7;1;989;0;542;478;64
2401;1;17669;7;1;920;1;340;313;27
2401;1;17695;7;1;878;0;488;405;83
2401;1;17697;7;1;1983;0;1182;957;225
2401;1;17700;7;1;1594;0;579;527;52
2401;1;17708;7;1;1392;2;702;627;75
2401;1;17710;7;1;2528;2;1263;1077;186
2401;1;17726;7;1;1261;0;650;555;95
2401;12;17662;7;12;1579;0;718;644;74
2401;12;17718;7;12;1941;0;837;766;71
2401;13;17656;7;13;2277;2;977;883;94
2401;13;17675;7;13;1663;0;647;597;50
2401;14;17670;7;14;2011;0;737;647;90
2401;14;17673;7;14;2087;0;880;790;90
2401;15;17709;7;15;2015;0;1006;940;66
2401;15;17728;7;15;1578;0;694;616;78
2401;16;17681;7;16;1329;1;599;537;62
2401;16;17705;7;16;1795;0;714;634;80
2401;17;17701;7;17;1906;0;818;721;97
2401;17;17711;7;17;1749;2;799;711;88
2401;18;17657;7;18;33;0;23;19;4
2401;18;17707;7;18;1754;0;736;663;73
2401;19;17650;7;19;2171;0;825;738;87
2401;20;17696;7;20;1538;0;748;690;58
2401;21;17721;7;21;705;0;200;176;24
2401;2;17639;7;2;1721;0;662;594;68
2401;2;17658;7;2;1244;0;533;459;74
2401;2;17665;7;2;1160;0;465;375;90
2401;2;17666;7;2;1784;3;1172;956;216
2401;2;17679;7;2;2083;2;1195;1014;181
2401;2;17684;7;2;2118;0;757;668;89
2401;2;17690;7;2;1174;0;511;422;89
2401;2;17704;7;2;606;0;280;218;62
2401;22;17680;7;22;2043;0;900;811;89
2401;23;17702;7;23;1886;1;650;591;59
2401;24;17643;7;24;741;0;276;247;29
2401;25;17644;7;25;1575;0;573;487;86
2401;26;17660;7;26;1820;0;605;554;51
2401;27;17642;7;27;1458;0;544;495;49
2401;28;17692;7;28;1753;0;549;503;46
2401;29;17640;7;29;2087;0;869;807;62
2401;30;17686;7;30;58;0;23;22;1
2401;31;17703;7;31;1419;0;489;465;24
2401;3;17651;7;3;1313;0;554;484;70
2401;3;17678;7;3;721;0;388;329;59
2401;3;17683;7;3;2138;1;970;881;89
2401;3;17689;7;3;1270;0;765;598;167
2401;3;17693;7;3;1845;0;685;602;83
2401;3;17699;7;3;749;0;390;347;43
2401;3;17725;7;3;1625;0;775;664;111
2401;3;17729;7;3;992;0;384;314;70
2401;4;17652;7;4;313;1;178;130;48
2401;4;17664;7;4;1261;0;692;586;106
2401;4;17691;7;4;594;0;290;241;49
2401;4;17694;7;4;769;0;363;296;67
2401;4;17706;7;4;840;0;426;375;51
2401;4;17713;7;4;1877;0;797;718;79
2401;4;17714;7;4;773;0;319;293;26
2401;4;17722;7;4;1554;0;759;695;64
2401;5;17655;7;5;602;0;307;257;50
2401;5;17667;7;5;2151;0;982;844;138
2401;5;17677;7;5;1133;0;553;493;60
2401;5;17685;7;5;544;0;271;214;57
2401;5;17688;7;5;53;0;29;27;2
2401;5;17698;7;5;1215;1;648;544;104
2401;5;17727;7;5;1875;1;1081;988;93
2401;6;17668;7;6;705;0;367;320;47
2401;6;17712;7;6;1569;0;689;637;52
2401;6;17717;7;6;460;0;274;213;61
2401;6;17720;7;6;1207;1;624;549;75
2401;6;17723;7;6;1429;0;710;581;129
2401;6;17724;7;6;1001;0;449;392;57
2401;7;17641;7;7;1231;0;528;495;33
2401;7;17648;7;7;2300;0;1181;984;197
2401;7;17654;7;7;2105;2;1001;938;63
2401;7;17672;7;7;345;4;236;198;38
2401;7;17687;7;7;1172;0;551;441;110
2401;7;17716;7;7;695;0;343;310;33
2401;8;17638;7;8;807;5;422;370;52
2401;8;17645;7;8;518;0;236;194;42
2401;8;17647;7;8;1545;0;751;679;72
2401;8;17653;7;8;2262;2;1064;1008;56
2401;8;17715;7;8;2121;0;1086;1015;71
2401;9;17659;7;9;1490;0;651;607;44
2401;9;17663;7;9;351;10;241;208;33
2401;9;17674;7;9;1991;0;860;763;97
2401;9;17682;7;9;1507;0;705;615;90
2402;10;17738;1;10;510;1;250;223;27
2402;10;17744;1;10;2130;0;823;768;55
2402;10;17789;1;10;45;0;29;24;5
2402;11;17751;1;11;2282;0;1072;1007;65
2402;11;17792;1;11;1009;0;552;506;46
2402;1;17746;1;1;1635;0;900;769;131
2402;1;17758;1;1;1592;1;838;726;112
2402;1;17763;1;1;1338;0;516;451;65
2402;1;17780;1;1;1618;0;567;495;72
2402;1;17781;1;1;2059;0;1074;905;169
2402;1;17783;1;1;1648;0;785;680;105
2402;1;17784;1;1;1854;0;893;776;117
2402;1;17788;1;1;1781;0;849;727;122
2402;1;17800;1;1;2345;0;1317;1198;119
2402;1;17806;1;1;2045;0;1122;1009;113
2402;12;17793;1;12;836;0;364;319;45
2402;12;17809;1;12;1563;0;649;598;51
2402;13;17761;1;13;1165;0;524;487;37
2402;13;17776;1;13;1794;0;948;839;109
2402;14;17755;1;14;1222;0;534;499;35
2402;14;17790;1;14;1225;0;657;606;51
2402;15;17742;1;15;1376;0;690;690;0
2402;15;17774;1;15;1813;0;936;854;82
2402;16;17754;1;16;2239;0;1134;1046;88
2402;17;17799;1;17;1252;0;643;551;92
2402;18;17778;1;18;1264;0;701;631;70
2402;19;17736;1;19;1672;0;736;641;95
2402;20;17807;1;20;789;0;425;373;52
2402;21;17757;1;21;1126;0;567;498;69
2402;2;17731;1;2;2214;0;978;896;82
2402;2;17743;1;2;2046;1;962;819;143
2402;2;17747;1;2;1745;0;911;764;147
2402;2;17759;1;2;1980;3;1018;898;120
2402;2;17766;1;2;1288;0;467;411;56
2402;2;17786;1;2;1082;0;623;548;75
2402;2;17801;1;2;1609;0;824;700;124
2402;2;17808;1;2;2052;2;1014;892;122
2402;2;17811;1;2;1787;1;843;735;108
2402;2;17813;1;2;1395;1;730;622;108
2402;22;17797;1;22;802;0;504;454;50
2402;3;17732;1;3;2351;0;1414;1250;164
2402;3;17735;1;3;1266;0;580;502;78
2402;3;17737;1;3;1863;2;984;892;92
2402;3;17748;1;3;1777;1;692;616;76
2402;3;17753;1;3;2147;0;1191;1041;150
2402;3;17765;1;3;1202;0;660;530;130
2402;3;17768;1;3;2371;0;1323;1205;118
2402;3;17782;1;3;663;0;402;345;57
2402;3;17794;1;3;2062;0;1007;927;80
2402;3;17798;1;3;2017;0;1024;914;110
2402;4;17734;1;4;1977;0;956;835;121
2402;4;17752;1;4;1563;1;732;593;139
2402;4;17767;1;4;1264;0;602;524;78
2402;4;17772;1;4;2226;1;1240;1056;184
2402;4;17779;1;4;560;0;207;207;0
2402;4;17791;1;4;990;0;380;337;43
2402;4;17795;1;4;1062;2;569;492;77
2402;4;17802;1;4;1935;0;843;745;98
2402;4;17803;1;4;1327;0;624;555;69
2402;5;17749;1;5;1803;2;954;740;214
2402;5;17750;1;5;1528;0;795;621;174
2402;5;17756;1;5;447;0;213;181;32
2402;5;17760;1;5;2094;0;854;691;163
2402;5;17762;1;5;2005;1;1012;899;113
2402;5;17805;1;5;929;0;469;432;37
2402;5;17810;1;5;1245;0;606;524;82
2402;5;17812;1;5;1294;0;595;555;40
2402;6;17730;1;6;1576;1;968;761;207
2402;6;17733;1;6;1980;0;909;800;109
2402;6;17745;1;6;637;0;352;310;42
2402;6;17764;1;6;1558;0;760;647;113
2402;6;17777;1;6;2438;2;1164;1067;97
2402;6;17785;1;6;792;0;385;332;53
2402;6;17814;1;6;1213;1;546;444;102
2402;7;17741;1;7;1305;0;628;575;53
2402;7;17769;1;7;1573;0;791;669;122
2402;7;17770;1;7;600;0;312;251;61
2402;7;17796;1;7;1581;1;913;752;161
2402;7;17804;1;7;854;0;376;317;59
2402;8;17739;1;8;5;0;3;3;0
2402;8;17771;1;8;2071;0;895;823;72
2402;8;17787;1;8;648;0;377;304;73
2402;9;17740;1;9;9;0;7;7;0
2402;9;17773;1;9;1324;0;522;471;51
2402;9;17775;1;9;959;1;458;417;41
2403;10;17825;1;10;31;0;29;29;0
2403;10;17829;1;10;2072;0;808;744;64
2403;10;17850;1;10;1381;0;576;515;61
2403;10;17905;1;10;1170;0;490;422;68
2403;11;17892;1;11;1646;0;716;611;105
2403;11;17906;1;11;443;0;216;180;36
2403;11;17924;1;11;961;0;387;361;26
2403;1;17834;1;1;1236;0;449;410;39
2403;1;17852;1;1;1394;0;706;572;134
2403;1;17872;1;1;1957;0;1210;1020;190
2403;1;17874;1;1;1470;0;749;649;100
2403;1;17885;1;1;1522;2;736;639;97
2403;1;17894;1;1;1349;0;676;590;86
2403;1;17895;1;1;1777;0;904;775;129
2403;1;17903;1;1;746;0;256;221;35
2403;1;17914;1;1;1544;1;798;634;164
2403;1;17927;1;1;1808;3;783;703;80
2403;1;17929;1;1;571;0;306;266;40
2403;1;17930;1;1;1200;0;507;468;39
2403;12;17818;1;12;1301;0;626;525;101
2403;12;17820;1;12;1225;2;434;369;65
2403;12;17845;1;12;78;0;45;38;7
2403;13;17878;1;13;561;0;269;213;56
2403;13;17911;1;13;677;0;274;250;24
2403;14;17839;1;14;503;0;306;246;60
2403;14;17841;1;14;1298;0;499;464;35
2403;15;17861;1;15;1279;0;570;535;35
2403;15;17897;1;15;59;0;9;5;4
2403;16;17849;1;16;1745;0;685;628;57
2403;16;17863;1;16;87;0;25;23;2
2403;17;17848;1;17;1041;0;477;445;32
2403;17;17896;1;17;1732;0;697;586;111
2403;18;17909;1;18;453;1;185;170;15
2403;18;17926;1;18;607;0;286;238;48
2403;19;17844;1;19;1914;0;870;811;59
2403;20;17860;1;20;1213;0;552;509;43
2403;21;17871;1;21;1200;0;500;446;54
2403;2;17817;1;2;1491;1;703;584;119
2403;2;17824;1;2;2021;1;903;778;125
2403;2;17847;1;2;788;1;288;278;10
2403;2;17853;1;2;1107;0;523;472;51
2403;2;17862;1;2;1477;0;725;633;92
2403;2;17864;1;2;1841;4;1010;880;130
2403;2;17870;1;2;414;0;176;156;20
2403;2;17881;1;2;2062;2;1195;983;212
2403;2;17890;1;2;531;0;266;240;26
2403;2;17908;1;2;1281;1;639;575;64
2403;2;17917;1;2;1195;1;643;555;88
2403;2;17923;1;2;1280;0;597;532;65
2403;22;17891;1;22;1085;0;503;455;48
2403;23;17836;1;23;1143;0;574;530;44
2403;24;17907;1;24;69;0;45;45;0
2403;25;17882;1;25;134;0;34;32;2
2403;26;17838;1;26;33;0;13;12;1
2403;27;17877;1;27;16;0;16;11;5
2403;3;17830;1;3;1998;0;699;580;119
2403;3;17842;1;3;1459;0;682;592;90
2403;3;17851;1;3;727;0;294;270;24
2403;3;17854;1;3;2262;0;970;896;74
2403;3;17857;1;3;1230;0;704;631;73
2403;3;17859;1;3;1222;1;639;552;87
2403;3;17868;1;3;796;0;266;245;21
2403;3;17893;1;3;778;0;319;288;31
2403;3;17901;1;3;1249;0;785;710;75
2403;3;17919;1;3;705;0;290;243;47
2403;3;17928;1;3;1087;0;673;490;183
2403;3;17931;1;3;1717;0;745;640;105
2403;4;17821;1;4;1110;0;620;557;63
2403;4;17835;1;4;1234;0;568;529;39
2403;4;17840;1;4;2401;1;1289;982;307
2403;4;17855;1;4;1713;0;740;576;164
2403;4;17856;1;4;953;0;368;335;33
2403;4;17879;1;4;1193;1;680;594;86
2403;4;17900;1;4;1548;1;777;699;78
2403;4;17902;1;4;1062;0;475;411;64
2403;4;17915;1;4;2141;0;983;912;71
2403;4;17916;1;4;1391;0;632;497;135
2403;4;17920;1;4;486;0;241;197;44
2403;4;17922;1;4;845;0;383;342;41
2403;5;17816;1;5;1947;3;898;758;140
2403;5;17819;1;5;1287;0;446;380;66
2403;5;17833;1;5;2016;0;1031;920;111
2403;5;17843;1;5;1020;0;217;182;35
2403;5;17858;1;5;1463;0;714;604;110
2403;5;17875;1;5;1271;2;623;485;138
2403;5;17880;1;5;927;0;489;451;38
2403;5;17886;1;5;1184;0;563;484;79
2403;5;17898;1;5;1902;1;793;676;117
2403;5;17899;1;5;2069;1;849;780;69
2403;5;17904;1;5;543;0;245;214;31
2403;5;17925;1;5;1062;0;284;218;66
2403;6;17822;1;6;1936;1;830;764;66
2403;6;17823;1;6;1283;0;417;350;67
2403;6;17827;1;6;2303;3;1124;962;162
2403;6;17846;1;6;1595;2;837;746;91
2403;6;17869;1;6;515;0;258;218;40
2403;6;17876;1;6;791;0;359;303;56
2403;6;17889;1;6;1372;0;626;531;95
2403;6;17910;1;6;531;0;205;178;27
2403;6;17912;1;6;1464;3;760;606;154
2403;6;17913;1;6;1793;0;718;676;42
2403;7;17828;1;7;737;0;309;273;36
2403;7;17831;1;7;635;2;364;336;28
2403;7;17832;1;7;1001;0;406;354;52
2403;7;17837;1;7;1246;1;435;376;59
2403;7;17866;1;7;1148;0;369;322;47
2403;7;17873;1;7;855;0;427;365;62
2403;7;17883;1;7;481;0;222;194;28
2403;7;17918;1;7;349;0;188;162;26
2403;8;17815;1;8;1810;0;651;606;45
2403;8;17826;1;8;1019;1;546;479;67
2403;8;17865;1;8;1030;2;534;466;68
2403;8;17884;1;8;1184;0;497;438;59
2403;8;17888;1;8;1438;0;724;628;96
2403;9;17867;1;9;1281;1;527;437;90
2403;9;17887;1;9;1482;0;652;600;52
2403;9;17921;1;9;825;0;377;318;59
2403;9;17932;1;9;917;0;335;298;37
2404;10;17986;6;10;875;0;439;351;88
2404;10;18006;6;10;430;0;225;203;22
2404;10;18030;6;10;623;0;303;284;19
2404;11;17968;6;11;728;1;387;334;53
2404;11;17973;6;11;502;1;257;212;45
2404;11;17995;6;11;389;0;225;181;44
2404;1;17940;6;1;1925;0;977;844;133
2404;1;17941;6;1;335;0;161;135;26
2404;1;17953;6;1;1191;4;889;691;198
2404;1;17954;6;1;1425;8;890;762;128
2404;1;17956;6;1;1212;0;602;531;71
2404;1;17957;6;1;412;0;250;224;26
2404;1;17961;6;1;686;0;377;292;85
2404;1;17962;6;1;2294;20;1511;1044;467
2404;1;17971;6;1;2137;0;1057;929;128
2404;1;17979;6;1;2380;1;1292;1146;146
2404;1;17982;6;1;1332;0;634;525;109
2404;1;17987;6;1;1037;0;642;540;102
2404;1;17993;6;1;2732;1;1536;1313;223
2404;1;18022;6;1;2389;3;1323;1179;144
2404;1;18028;6;1;694;0;359;293;66
2404;1;18036;6;1;1991;0;993;882;111
2404;12;18033;6;12;424;2;242;193;49
2404;2;17943;6;2;1144;1;702;593;109
2404;2;17946;6;2;822;0;392;322;70
2404;2;17952;6;2;2019;0;1079;910;169
2404;2;17974;6;2;1118;1;653;512;141
2404;2;17977;6;2;2296;0;1071;945;126
2404;2;17980;6;2;966;0;527;448;79
2404;2;17985;6;2;1492;0;669;609;60
2404;2;17988;6;2;1298;3;618;518;100
2404;2;17991;6;2;1978;0;1086;933;153
2404;2;17992;6;2;296;0;175;145;30
2404;2;18012;6;2;450;0;267;205;62
2404;2;18018;6;2;1405;0;726;686;40
2404;2;18026;6;2;649;1;341;290;51
2404;2;18039;6;2;807;0;500;411;89
2404;2;18041;6;2;1144;0;564;465;99
2404;3;17933;6;3;689;0;477;372;105
2404;3;17937;6;3;1263;1;822;672;150
2404;3;17949;6;3;1119;0;544;505;39
2404;3;17951;6;3;1447;0;710;605;105
2404;3;17958;6;3;600;0;324;267;57
2404;3;17966;6;3;807;0;337;262;75
2404;3;17978;6;3;375;0;228;180;48
2404;3;17981;6;3;442;0;252;217;35
2404;3;17990;6;3;535;0;237;171;66
2404;3;18002;6;3;727;0;407;330;77
2404;3;18021;6;3;2153;0;1112;943;169
2404;3;18027;6;3;959;2;540;456;84
2404;3;18032;6;3;1000;0;571;471;100
2404;3;18037;6;3;2220;0;1404;1189;215
2404;3;18043;6;3;1993;1;909;797;112
2404;4;17934;6;4;2013;3;1126;986;140
2404;4;17936;6;4;335;0;110;83;27
2404;4;17939;6;4;496;1;245;198;47
2404;4;17955;6;4;485;0;319;223;96
2404;4;17964;6;4;1508;1;707;640;67
2404;4;17969;6;4;723;3;425;372;53
2404;4;17983;6;4;1152;0;579;487;92
2404;4;17994;6;4;1259;0;643;527;116
2404;4;17996;6;4;675;0;383;328;55
2404;4;18004;6;4;743;0;494;387;107
2404;4;18009;6;4;1308;0;650;553;97
2404;4;18013;6;4;898;0;467;376;91
2404;4;18016;6;4;709;0;402;306;96
2404;4;18024;6;4;719;0;370;291;79
2404;5;17950;6;5;524;0;324;276;48
2404;5;17959;6;5;560;0;236;173;63
2404;5;17963;6;5;2234;0;1142;956;186
2404;5;17970;6;5;1474;0;793;736;57
2404;5;17975;6;5;1597;0;869;646;223
2404;5;17984;6;5;925;0;444;373;71
2404;5;17997;6;5;673;0;379;294;85
2404;5;18000;6;5;476;0;244;208;36
2404;5;18005;6;5;501;0;285;235;50
2404;5;18019;6;5;913;1;506;463;43
2404;5;18035;6;5;438;0;291;220;71
2404;5;18038;6;5;522;0;284;213;71
2404;6;17942;6;6;632;0;413;345;68
2404;6;17944;6;6;621;0;361;297;64
2404;6;17945;6;6;651;0;363;331;32
2404;6;17989;6;6;728;0;384;322;62
2404;6;18010;6;6;1617;0;829;743;86
2404;6;18011;6;6;320;0;165;135;30
2404;6;18015;6;6;388;0;125;118;7
2404;6;18017;6;6;836;1;597;508;89
2404;6;18020;6;6;539;0;216;179;37
2404;6;18025;6;6;1159;3;814;710;104
2404;6;18029;6;6;844;1;429;388;41
2404;6;18031;6;6;1039;0;499;436;63
2404;7;17935;6;7;550;0;261;224;37
2404;7;17938;6;7;6;0;3;3;0
2404;7;17948;6;7;74;0;72;65;7
2404;7;17998;6;7;991;0;444;390;54
2404;7;17999;6;7;902;2;581;476;105
2404;7;18001;6;7;678;0;328;305;23
2404;7;18008;6;7;56;0;49;42;7
2404;7;18023;6;7;760;0;294;248;46
2404;7;18034;6;7;549;0;295;245;50
2404;7;18042;6;7;1782;0;975;841;134
2404;8;17960;6;8;1466;1;942;863;79
2404;8;17965;6;8;114;0;49;34;15
2404;8;17967;6;8;530;1;334;304;30
2404;8;17976;6;8;762;0;389;315;74
2404;8;18003;6;8;1586;0;710;654;56
2404;8;18014;6;8;802;1;390;308;82
2404;9;17947;6;9;1284;0;608;496;112
2404;9;17972;6;9;527;0;326;260;66
2404;9;18007;6;9;988;0;503;462;41
2404;9;18040;6;9;510;2;266;238;28
2405;10;18062;4;10;1707;0;690;608;82
2405;11;18102;4;11;1805;1;760;667;93
2405;1;18051;4;1;2177;0;796;698;98
2405;1;18053;4;1;2162;0;898;767;131
2405;1;18065;4;1;1742;0;844;741;103
2405;1;18066;4;1;977;0;522;440;82
2405;1;18078;4;1;1324;0;646;542;104
2405;1;18086;4;1;1633;0;741;624;117
2405;1;18095;4;1;1341;0;695;564;131
2405;1;18099;4;1;1550;1;829;688;141
2405;12;18106;4;12;1844;0;889;790;99
2405;13;18080;4;13;1548;0;783;685;98
2405;14;18075;4;14;899;0;428;369;59
2405;15;18083;4;15;2175;0;859;702;157
2405;16;18111;4;16;1176;0;467;386;81
2405;17;18067;4;17;1372;0;691;617;74
2405;18;18045;4;18;1853;0;797;682;115
2405;19;18055;4;19;1227;0;481;406;75
2405;20;18091;4;20;1276;0;531;438;93
2405;21;18107;4;21;40;0;19;16;3
2405;2;18044;4;2;2263;0;1082;952;130
2405;2;18048;4;2;1069;0;396;345;51
2405;2;18074;4;2;1747;0;849;722;127
2405;2;18087;4;2;1401;1;661;544;117
2405;2;18088;4;2;1941;0;780;658;122
2405;2;18108;4;2;648;0;254;211;43
2405;2;18112;4;2;1093;0;444;388;56
2405;2;18113;4;2;502;0;321;279;42
2405;3;18049;4;3;1049;0;490;398;92
2405;3;18052;4;3;611;0;203;175;28
2405;3;18054;4;3;865;0;418;366;52
2405;3;18069;4;3;2300;0;1025;854;171
2405;3;18070;4;3;2024;0;810;693;117
2405;3;18072;4;3;1994;0;706;598;108
2405;3;18082;4;3;1532;0;841;733;108
2405;3;18084;4;3;938;0;345;282;63
2405;4;18046;4;4;1151;0;718;607;111
2405;4;18047;4;4;58;0;41;23;18
2405;4;18064;4;4;1027;0;499;416;83
2405;4;18085;4;4;1382;0;430;378;52
2405;4;18096;4;4;1803;0;737;639;98
2405;4;18100;4;4;1113;0;462;385;77
2405;4;18103;4;4;856;0;303;262;41
2405;4;18109;4;4;1094;0;503;449;54
2405;5;18050;4;5;733;0;255;230;25
2405;5;18058;4;5;588;0;207;175;32
2405;5;18063;4;5;1159;2;540;461;79
2405;5;18090;4;5;2010;0;762;663;99
2405;5;18093;4;5;1088;0;493;422;71
2405;5;18097;4;5;1644;3;853;719;134
2405;5;18110;4;5;1913;0;976;906;70
2405;6;18056;4;6;987;0;324;270;54
2405;6;18057;4;6;1326;0;580;497;83
2405;6;18071;4;6;2225;0;1145;1011;134
2405;6;18077;4;6;1943;2;706;595;111
2405;6;18081;4;6;944;0;391;352;39
2405;6;18089;4;6;449;0;168;133;35
2405;6;18101;4;6;1139;0;599;517;82
2405;7;18060;4;7;566;0;237;194;43
2405;7;18068;4;7;575;0;255;213;42
2405;7;18076;4;7;1896;0;645;546;99
2405;7;18092;4;7;726;0;282;217;65
2405;7;18104;4;7;1580;0;664;563;101
2405;8;18059;4;8;617;0;243;215;28
2405;8;18079;4;8;1270;0;517;451;66
2405;8;18094;4;8;2129;0;917;821;96
2405;8;18098;4;8;1574;0;738;643;95
2405;9;18061;4;9;761;0;237;202;35
2405;9;18073;4;9;1764;0;698;611;87
2405;9;18105;4;9;28;0;16;15;1
2406;10;18154;6;10;506;0;264;211;53
2406;10;18163;6;10;1158;0;513;464;49
2406;11;18130;6;11;1466;0;613;497;116
2406;1;18115;6;1;1799;0;1228;982;246
2406;1;18132;6;1;1284;10;801;655;146
2406;1;18137;6;1;1900;0;932;811;121
2406;1;18148;6;1;1474;0;684;530;154
2406;1;18151;6;1;2276;4;1271;1135;136
2406;1;18160;6;1;1597;2;973;835;138
2406;1;18162;6;1;2080;1;996;810;186
2406;1;18170;6;1;1143;0;604;519;85
2406;1;18173;6;1;2400;0;1317;1123;194
2406;12;18161;6;12;555;0;238;226;12
2406;13;18142;6;13;15;0;9;5;4
2406;2;18116;6;2;1849;0;691;574;117
2406;2;18117;6;2;1730;0;844;702;142
2406;2;18127;6;2;692;2;437;342;95
2406;2;18129;6;2;1438;0;800;728;72
2406;2;18145;6;2;1766;0;682;547;135
2406;2;18149;6;2;1629;0;941;802;139
2406;2;18156;6;2;794;0;277;204;73
2406;2;18158;6;2;783;0;425;348;77
2406;2;18168;6;2;1504;0;773;630;143
2406;3;18119;6;3;869;0;375;306;69
2406;3;18122;6;3;763;0;442;356;86
2406;3;18123;6;3;325;0;170;144;26
2406;3;18139;6;3;857;0;491;370;121
2406;3;18147;6;3;1833;0;769;695;74
2406;3;18159;6;3;384;0;177;129;48
2406;3;18164;6;3;1235;0;720;552;168
2406;3;18165;6;3;549;0;193;154;39
2406;3;18167;6;3;1943;0;1099;966;133
2406;4;18124;6;4;557;0;326;255;71
2406;4;18125;6;4;639;0;274;201;73
2406;4;18128;6;4;848;0;417;359;58
2406;4;18136;6;4;761;0;394;310;84
2406;4;18138;6;4;571;0;281;214;67
2406;4;18141;6;4;2312;1;994;842;152
2406;4;18144;6;4;744;0;410;372;38
2406;4;18171;6;4;1218;0;628;544;84
2406;5;18133;6;5;1041;0;445;356;89
2406;5;18134;6;5;284;0;157;120;37
2406;5;18150;6;5;975;3;590;484;106
2406;5;18152;6;5;1914;3;907;862;45
2406;5;18157;6;5;1895;1;1068;930;138
2406;5;18166;6;5;474;0;304;253;51
2406;5;18172;6;5;619;0;296;258;38
2406;6;18120;6;6;1624;0;816;697;119
2406;6;18131;6;6;998;3;484;365;119
2406;6;18140;6;6;515;0;227;173;54
2406;6;18146;6;6;1606;0;795;699;96
2406;6;18153;6;6;1085;4;460;399;61
2406;7;18121;6;7;744;0;399;348;51
2406;7;18135;6;7;582;1;237;198;39
2406;7;18169;6;7;718;0;353;313;40
2406;8;18114;6;8;2250;1;997;847;150
2406;8;18126;6;8;1092;0;513;436;77
2406;8;18155;6;8;672;0;266;212;54
2406;9;18118;6;9;513;0;345;264;81
2406;9;18143;6;9;1867;0;843;728;115
2407;10;18185;4;10;886;0;386;355;31
2407;10;18198;4;10;2387;0;1166;1082;84
2407;11;18184;4;11;1271;2;636;562;74
2407;1;18174;4;1;506;0;236;185;51
2407;1;18177;4;1;2311;1;1089;1004;85
2407;1;18179;4;1;1249;0;683;591;92
2407;1;18186;4;1;2321;0;818;623;195
2407;1;18210;4;1;1388;8;983;753;230
2407;1;18222;4;1;2051;0;1244;979;265
2407;1;18224;4;1;1944;3;1055;888;167
2407;1;18225;4;1;1207;0;497;393;104
2407;12;18188;4;12;1192;0;524;476;48
2407;13;18209;4;13;143;0;64;56;8
2407;2;18183;4;2;2055;2;1210;1043;167
2407;2;18193;4;2;1353;3;936;725;211
2407;2;18199;4;2;514;0;250;204;46
2407;2;18200;4;2;1325;1;705;594;111
2407;2;18213;4;2;935;0;592;376;216
2407;2;18214;4;2;773;0;306;227;79
2407;2;18215;4;2;453;0;187;153;34
2407;2;18220;4;2;2385;1;1199;1056;143
2407;3;18182;4;3;1264;0;562;488;74
2407;3;18189;4;3;1637;0;800;668;132
2407;3;18201;4;3;235;0;135;128;7
2407;3;18204;4;3;697;0;414;336;78
2407;3;18207;4;3;1920;0;573;488;85
2407;3;18211;4;3;2072;0;977;767;210
2407;3;18218;4;3;1601;0;836;745;91
2407;4;18175;4;4;1191;0;620;537;83
2407;4;18187;4;4;761;0;348;300;48
2407;4;18195;4;4;1063;1;521;465;56
2407;4;18203;4;4;525;0;138;95;43
2407;4;18205;4;4;539;0;280;211;69
2407;4;18208;4;4;1479;0;658;575;83
2407;4;18219;4;4;1729;0;684;575;109
2407;5;18176;4;5;1402;0;602;491;111
2407;5;18180;4;5;637;0;248;216;32
2407;5;18197;4;5;940;0;285;233;52
2407;5;18202;4;5;1148;0;437;384;53
2407;5;18217;4;5;859;0;219;158;61
2407;5;18221;4;5;668;0;357;298;59
2407;6;18191;4;6;470;0;230;180;50
2407;6;18194;4;6;608;0;230;189;41
2407;6;18196;4;6;1178;0;639;544;95
2407;6;18212;4;6;760;1;387;316;71
2407;6;18216;4;6;1160;1;513;446;67
2407;7;18178;4;7;1770;0;701;603;98
2407;7;18223;4;7;253;0;115;105;10
2407;8;18190;4;8;1565;0;702;631;71
2407;8;18192;4;8;491;0;295;252;43
2407;9;18181;4;9;355;0;175;144;31
2407;9;18206;4;9;2007;0;917;811;106
2408;10;18239;3;10;1425;0;625;554;71
2408;10;18253;3;10;653;0;301;264;37
2408;10;18275;3;10;1224;1;498;449;49
2408;11;18249;3;11;1485;2;830;744;86
2408;11;18264;3;11;1311;0;592;543;49
2408;11;18265;3;11;807;0;397;344;53
2408;1;18226;3;1;1428;1;679;571;108
2408;1;18230;3;1;1950;0;701;601;100
2408;1;18247;3;1;1053;0;564;497;67
2408;1;18258;3;1;1844;1;766;682;84
2408;1;18270;3;1;2315;0;1287;1127;160
2408;12;18259;3;12;843;0;355;299;56
2408;12;18272;3;12;771;0;348;323;25
2408;13;18236;3;13;2238;0;928;846;82
2408;14;18260;3;14;1958;0;914;838;76
2408;15;18254;3;15;1953;0;824;744;80
2408;16;18257;3;16;714;0;277;247;30
2408;17;18263;3;17;1181;0;609;526;83
2408;18;18252;3;18;1644;0;780;678;102
2408;19;18242;3;19;1591;0;799;711;88
2408;20;18271;3;20;39;0;12;7;5
2408;21;18235;3;21;35;0;9;8;1
2408;2;18227;3;2;2138;0;910;798;112
2408;2;18243;3;2;1223;1;585;499;86
2408;2;18251;3;2;1033;0;485;425;60
2408;2;18268;3;2;2289;3;1201;1096;105
2408;2;18269;3;2;2053;0;859;769;90
2408;22;18276;3;22;119;0;78;67;11
2408;3;18229;3;3;1315;0;629;549;80
2408;3;18245;3;3;1469;0;743;656;87
2408;3;18250;3;3;2126;0;1029;943;86
2408;3;18273;3;3;1332;0;520;481;39
2408;4;18228;3;4;1363;0;653;584;69
2408;4;18248;3;4;1293;0;484;434;50
2408;4;18256;3;4;1573;0;679;597;82
2408;4;18267;3;4;1923;0;766;709;57
2408;5;18240;3;5;2146;0;992;913;79
2408;5;18246;3;5;1417;0;498;438;60
2408;5;18266;3;5;2187;0;1053;876;177
2408;6;18244;3;6;1979;0;733;665;68
2408;6;18261;3;6;1827;0;856;784;72
2408;6;18274;3;6;640;0;395;363;32
2408;7;18232;3;7;1507;0;758;698;60
2408;7;18241;3;7;2012;0;906;819;87
2408;7;18255;3;7;1873;1;922;779;143
2408;8;18231;3;8;1339;0;547;505;42
2408;8;18237;3;8;2006;1;1046;918;128
2408;8;18262;3;8;1517;0;640;562;78
2408;9;18233;3;9;1085;0;479;412;67
2408;9;18234;3;9;1155;0;464;406;58
2408;9;18238;3;9;2189;0;740;660;80
2409;10;18288;6;10;875;0;550;454;96
2409;10;18291;6;10;1827;0;775;675;100
2409;11;18278;6;11;1018;4;630;497;133
2409;11;18293;6;11;1896;0;882;813;69
2409;1;18282;6;1;982;2;493;410;83
2409;1;18290;6;1;1015;0;478;430;48
2409;1;18294;6;1;1905;4;1184;1099;85
2409;1;18313;6;1;1207;3;917;751;166
2409;1;18328;6;1;1786;2;969;865;104
2409;12;18305;6;12;1213;0;585;508;77
2409;13;18286;6;13;1464;0;713;646;67
2409;14;18317;6;14;770;0;374;331;43
2409;15;18312;6;15;1960;0;1077;1014;63
2409;16;18298;6;16;1518;1;728;642;86
2409;17;18321;6;17;1174;0;688;623;65
2409;18;18284;6;18;1786;0;957;865;92
2409;19;18319;6;19;1273;0;669;585;84
2409;20;18327;6;20;33;0;25;23;2
2409;2;18279;6;2;1003;3;805;617;188
2409;2;18297;6;2;1838;0;945;827;118
2409;2;18300;6;2;1240;0;780;780;0
2409;2;18303;6;2;1611;0;863;776;87
2409;2;18315;6;2;821;0;457;359;98
2409;3;18304;6;3;835;0;670;527;143
2409;3;18314;6;3;523;1;308;287;21
2409;3;18318;6;3;1086;0;471;402;69
2409;3;18324;6;3;2338;0;1189;1111;78
2409;3;18326;6;3;1048;2;534;467;67
2409;4;18277;6;4;729;4;549;463;86
2409;4;18287;6;4;1049;1;536;459;77
2409;4;18295;6;4;771;0;406;363;43
2409;4;18309;6;4;996;1;585;484;101
2409;4;18316;6;4;625;1;451;417;34
2409;5;18281;6;5;1299;0;549;494;55
2409;5;18299;6;5;728;0;369;307;62
2409;5;18306;6;5;381;0;310;266;44
2409;5;18307;6;5;967;7;597;508;89
2409;5;18308;6;5;559;0;284;232;52
2409;6;18280;6;6;455;6;320;271;49
2409;6;18292;6;6;1571;0;916;826;90
2409;6;18322;6;6;940;0;516;386;130
2409;6;18323;6;6;707;0;414;275;139
2409;6;18325;6;6;532;0;274;222;52
2409;7;18285;6;7;2070;1;943;890;53
2409;7;18289;6;7;750;0;405;353;52
2409;7;18301;6;7;2081;1;1103;990;113
2409;7;18311;6;7;499;3;319;264;55
2409;8;18283;6;8;1791;0;932;836;96
2409;8;18296;6;8;1770;0;990;831;159
2409;8;18310;6;8;369;0;291;242;49
2409;9;18302;6;9;981;1;537;490;47
2409;9;18320;6;9;647;0;388;304;84
2410;10;18330;2;10;1447;0;688;611;77
2410;10;18344;2;10;2058;1;929;801;128
2410;10;18375;2;10;1195;0;567;525;42
2410;11;18338;2;11;1640;2;884;793;91
2410;11;18380;2;11;806;0;348;296;52
2410;1;18335;2;1;1540;3;828;727;101
2410;1;18337;2;1;1352;0;750;585;165
2410;1;18345;2;1;390;0;238;197;41
2410;1;18347;2;1;1434;0;856;723;133
2410;1;18370;2;1;1654;1;611;535;76
2410;1;18374;2;1;1745;0;791;677;114
2410;12;18333;2;12;1793;1;946;889;57
2410;13;18386;2;13;890;0;393;374;19
2410;14;18351;2;14;1747;0;825;751;74
2410;15;18369;2;15;1532;0;671;602;69
2410;16;18368;2;16;1386;0;710;667;43
2410;17;18378;2;17;1263;1;616;570;46
2410;18;18382;2;18;831;0;362;318;44
2410;19;18390;2;19;751;0;325;274;51
2410;20;18336;2;20;2145;0;1102;961;141
2410;21;18332;2;21;1338;0;604;518;86
2410;2;18349;2;2;2289;2;1267;1081;186
2410;2;18350;2;2;1178;0;712;599;113
2410;2;18373;2;2;1258;0;694;578;116
2410;2;18377;2;2;1003;0;540;458;82
2410;2;18384;2;2;1274;1;561;500;61
2410;2;18387;2;2;1540;1;955;835;120
2410;22;18361;2;22;2191;2;1037;947;90
2410;23;18371;2;23;890;0;422;377;45
2410;24;18372;2;24;2265;0;1032;873;159
2410;25;18348;2;25;1686;0;853;770;83
2410;26;18334;2;26;1006;0;438;385;53
2410;27;18376;2;27;1756;0;808;684;124
2410;28;18364;2;28;107;0;41;39;2
2410;3;18342;2;3;807;0;412;349;63
2410;3;18352;2;3;1146;0;719;587;132
2410;3;18354;2;3;1295;0;543;503;40
2410;3;18356;2;3;1096;0;404;358;46
2410;3;18367;2;3;971;1;460;398;62
2410;4;18341;2;4;2071;0;781;654;127
2410;4;18346;2;4;1075;0;684;611;73
2410;4;18357;2;4;1314;0;743;630;113
2410;4;18360;2;4;1226;0;499;439;60
2410;4;18391;2;4;1079;0;574;498;76
2410;5;18329;2;5;1424;0;806;699;107
2410;5;18358;2;5;411;0;180;162;18
2410;5;18379;2;5;1952;0;693;590;103
2410;5;18383;2;5;1058;0;485;434;51
2410;5;18385;2;5;1263;0;650;598;52
2410;6;18359;2;6;1575;0;633;565;68
2410;6;18366;2;6;1460;0;547;483;64
2410;6;18381;2;6;1013;0;493;433;60
2410;6;18388;2;6;423;0;224;182;42
2410;7;18343;2;7;1669;1;713;643;70
2410;7;18355;2;7;1285;0;752;655;97
2410;7;18362;2;7;999;0;462;376;86
2410;7;18365;2;7;1471;0;513;448;65
2410;8;18331;2;8;1143;0;397;337;60
2410;8;18353;2;8;1668;0;741;676;65
2410;8;18389;2;8;483;0;219;188;31
2410;9;18339;2;9;2123;0;1060;966;94
2410;9;18340;2;9;1898;0;939;795;144
2410;9;18363;2;9;1271;0;360;308;52
2411;10;18431;3;10;1993;0;607;568;39
2411;11;18409;3;11;1906;0;812;766;46
2411;1;18392;3;1;1094;0;551;442;109
2411;1;18427;3;1;861;0;526;398;128
2411;1;18442;3;1;2181;2;921;775;146
2411;1;18443;3;1;2279;0;893;767;126
2411;1;18445;3;1;736;0;392;320;72
2411;1;18446;3;1;2041;0;771;702;69
2411;1;18447;3;1;1365;0;633;546;87
2411;1;18452;3;1;2348;0;811;620;191
2411;12;18397;3;12;1399;1;555;520;35
2411;13;18399;3;13;1935;0;840;787;53
2411;14;18453;3;14;1778;0;722;662;60
2411;15;18432;3;15;2006;0;709;662;47
2411;16;18457;3;16;2048;1;694;641;53
2411;17;18439;3;17;1734;0;559;525;34
2411;18;18430;3;18;1841;2;685;643;42
2411;19;18420;3;19;2030;1;734;661;73
2411;20;18455;3;20;2265;0;676;600;76
2411;21;18454;3;21;1970;0;842;795;47
2411;2;18393;3;2;2028;0;772;699;73
2411;2;18394;3;2;777;0;454;377;77
2411;2;18405;3;2;1474;0;565;445;120
2411;2;18414;3;2;1003;0;265;237;28
2411;2;18422;3;2;2017;0;1022;791;231
2411;2;18426;3;2;375;0;232;192;40
2411;2;18436;3;2;895;0;270;248;22
2411;2;18437;3;2;733;0;307;260;47
2411;22;18450;3;22;2087;0;866;814;52
2411;23;18425;3;23;1725;0;619;558;61
2411;24;18396;3;24;1757;0;563;516;47
2411;25;18451;3;25;1683;0;680;633;47
2411;26;18440;3;26;134;0;114;112;2
2411;27;18418;3;27;181;0;89;69;20
2411;28;18404;3;28;76;0;30;26;4
2411;29;18433;3;29;26;0;6;4;2
2411;3;18398;3;3;1974;0;756;696;60
2411;3;18401;3;3;1539;0;676;549;127
2411;3;18403;3;3;903;0;258;208;50
2411;3;18412;3;3;701;0;283;236;47
2411;3;18415;3;3;932;0;440;323;117
2411;3;18424;3;3;769;0;299;273;26
2411;3;18435;3;3;455;0;208;176;32
2411;3;18459;3;3;1658;0;709;617;92
2411;4;18400;3;4;1215;0;580;475;105
2411;4;18410;3;4;474;0;142;134;8
2411;4;18411;3;4;1012;0;540;484;56
2411;4;18416;3;4;518;0;203;160;43
2411;4;18421;3;4;2136;0;736;633;103
2411;4;18428;3;4;1372;0;591;473;118
2411;4;18434;3;4;634;1;206;166;40
2411;4;18441;3;4;1377;1;505;427;78
2411;5;18402;3;5;519;0;192;159;33
2411;5;18407;3;5;2314;0;865;772;93
2411;5;18429;3;5;917;0;417;374;43
2411;5;18438;3;5;314;0;132;114;18
2411;5;18449;3;5;854;0;323;266;57
2411;5;18456;3;5;1791;0;598;546;52
2411;5;18458;3;5;1458;1;609;509;100
2411;5;18460;3;5;613;0;239;224;15
2411;6;18395;3;6;630;0;276;224;52
2411;6;18408;3;6;1928;0;594;536;58
2411;6;18413;3;6;892;0;357;284;73
2411;6;18419;3;6;241;0;157;137;20
2411;6;18423;3;6;577;1;186;167;19
2411;7;18417;3;7;1722;0;532;484;48
2411;7;18448;3;7;1396;1;493;442;51
2411;8;18406;3;8;1280;0;436;413;23
2411;9;18444;3;9;1677;0;577;525;52
2412;10;18481;3;10;471;0;244;199;45
2412;10;18482;3;10;1479;1;662;586;76
2412;11;18492;3;11;77;0;54;30;24
2412;11;18501;3;11;1711;0;693;628;65
2412;1;18465;3;1;1569;1;879;758;121
2412;1;18469;3;1;1222;0;655;571;84
2412;1;18471;3;1;2366;4;1336;1117;219
2412;1;18475;3;1;748;0;364;304;60
2412;1;18502;3;1;2048;1;700;588;112
2412;12;18485;3;12;1424;0;649;572;77
2412;13;18488;3;13;1589;0;809;694;115
2412;14;18472;3;14;1226;0;546;445;101
2412;15;18467;3;15;1530;0;793;673;120
2412;16;18500;3;16;1134;0;502;428;74
2412;17;18490;3;17;1300;0;536;466;70
2412;18;18497;3;18;2056;0;898;794;104
2412;19;18478;3;19;1353;0;684;608;76
2412;20;18483;3;20;1840;0;918;821;97
2412;2;18461;3;2;1637;4;825;685;140
2412;2;18462;3;2;634;1;350;292;58
2412;2;18474;3;2;816;0;377;306;71
2412;2;18491;3;2;1926;0;688;562;126
2412;2;18503;3;2;1862;0;910;774;136
2412;3;18463;3;3;1488;4;845;741;104
2412;3;18470;3;3;1423;0;518;432;86
2412;3;18484;3;3;404;0;223;174;49
2412;3;18489;3;3;1776;0;683;549;134
2412;4;18464;3;4;2294;2;1053;860;193
2412;4;18473;3;4;1447;0;927;826;101
2412;4;18480;3;4;2196;0;808;726;82
2412;4;18498;3;4;1202;0;561;483;78
2412;5;18487;3;5;1765;2;976;838;138
2412;5;18495;3;5;357;0;234;202;32
2412;5;18499;3;5;2091;0;1092;960;132
2412;6;18466;3;6;2108;0;661;567;94
2412;6;18476;3;6;1393;1;644;514;130
2412;6;18479;3;6;772;0;410;345;65
2412;7;18486;3;7;900;2;417;362;55
2412;7;18496;3;7;1812;0;762;663;99
2412;8;18477;3;8;749;0;420;339;81
2412;8;18494;3;8;1076;0;520;433;87
2412;9;18468;3;9;1060;0;562;470;92
2412;9;18493;3;9;1934;0;776;660;116
2413;10;18550;4;10;53;0;19;17;2
2413;10;18586;4;10;1043;0;440;390;50
2413;11;18577;4;11;1858;0;720;670;50
2413;1;18512;4;1;1271;0;762;597;165
2413;1;18524;4;1;2300;1;1095;879;216
2413;1;18540;4;1;1012;1;389;361;28
2413;1;18543;4;1;1165;0;552;443;109
2413;1;18563;4;1;1532;0;657;580;77
2413;1;18570;4;1;1449;2;930;771;159
2413;1;18576;4;1;1987;0;998;889;109
2413;1;18578;4;1;1743;0;669;632;37
2413;1;18591;4;1;2451;1;1002;865;137
2413;12;18580;4;12;1233;0;585;546;39
2413;13;18560;4;13;1417;0;656;613;43
2413;14;18545;4;14;1751;0;836;773;63
2413;15;18549;4;15;1542;0;735;661;74
2413;16;18558;4;16;1678;0;744;693;51
2413;17;18509;4;17;1653;0;729;664;65
2413;18;18525;4;18;1864;0;784;714;70
2413;19;18521;4;19;1686;0;806;748;58
2413;20;18514;4;20;1546;0;741;696;45
2413;21;18564;4;21;1620;0;699;641;58
2413;2;18506;4;2;1786;0;1049;834;215
2413;2;18527;4;2;1034;0;307;284;23
2413;2;18528;4;2;1497;1;759;589;170
2413;2;18551;4;2;666;0;372;300;72
2413;2;18552;4;2;1656;0;755;635;120
2413;2;18567;4;2;2112;0;750;647;103
2413;2;18582;4;2;1950;0;985;951;34
2413;2;18585;4;2;719;0;384;324;60
2413;2;18588;4;2;585;1;334;287;47
2413;22;18535;4;22;1533;0;661;661;0
2413;23;18569;4;23;1337;0;657;629;28
2413;24;18562;4;24;1269;0;552;502;50
2413;25;18559;4;25;1802;0;810;741;69
2413;26;18557;4;26;682;0;359;328;31
2413;27;18556;4;27;2086;0;789;724;65
2413;28;18508;4;28;1696;0;738;691;47
2413;29;18517;4;29;1320;0;608;550;58
2413;30;18510;4;30;932;1;496;398;98
2413;31;18537;4;31;1416;0;542;495;47
2413;3;18504;4;3;2328;0;1285;1041;244
2413;3;18513;4;3;764;0;297;275;22
2413;3;18516;4;3;1719;0;570;450;120
2413;3;18519;4;3;1185;0;653;532;121
2413;3;18526;4;3;1391;0;679;540;139
2413;3;18532;4;3;775;0;475;380;95
2413;3;18536;4;3;1641;1;1068;932;136
2413;3;18541;4;3;976;0;378;337;41
2413;3;18544;4;3;724;0;324;273;51
2413;32;18574;4;32;1890;0;837;762;75
2413;33;18573;4;33;1566;0;563;503;60
2413;34;18584;4;34;1584;0;688;616;72
2413;35;18554;4;35;50;0;36;26;10
2413;36;18522;4;36;19;0;11;11;0
2413;37;18548;4;37;22;0;22;16;6
2413;38;18534;4;38;125;0;56;37;19
2413;39;18561;4;39;19;0;11;10;1
2413;40;18529;4;40;65;0;17;14;3
2413;41;18590;4;41;14;0;12;11;1
2413;4;18511;4;4;546;0;274;236;38
2413;4;18520;4;4;1824;0;934;863;71
2413;4;18538;4;4;1187;0;459;375;84
2413;4;18539;4;4;1644;1;804;715;89
2413;4;18565;4;4;464;0;250;191;59
2413;4;18566;4;4;355;0;166;133;33
2413;4;18572;4;4;1196;2;380;356;24
2413;4;18583;4;4;909;0;540;422;118
2413;5;18518;4;5;593;0;180;169;11
2413;5;18523;4;5;965;0;426;320;106
2413;5;18533;4;5;1770;0;906;741;165
2413;5;18542;4;5;1681;0;866;722;144
2413;5;18571;4;5;485;0;170;135;35
2413;5;18581;4;5;1828;0;899;835;64
2413;6;18515;4;6;415;0;217;183;34
2413;6;18553;4;6;1470;0;722;608;114
2413;6;18575;4;6;1897;0;767;658;109
2413;6;18579;4;6;1620;1;790;740;50
2413;6;18587;4;6;1833;0;932;870;62
2413;7;18507;4;7;1967;1;1115;1008;107
2413;7;18546;4;7;1339;0;603;507;96
2413;7;18555;4;7;1040;0;418;390;28
2413;7;18568;4;7;1242;0;548;442;106
2413;8;18505;4;8;1903;0;722;653;69
2413;8;18530;4;8;1814;0;899;830;69
2413;8;18589;4;8;1469;0;390;279;111
2413;9;18531;4;9;1980;0;899;827;72
2413;9;18547;4;9;51;0;17;14;3
2414;10;18615;2;10;1923;1;1065;901;164
2414;10;18622;2;10;378;0;180;140;40
2414;11;18593;2;11;1967;0;1028;872;156
2414;1;18595;2;1;1698;0;894;779;115
2414;1;18598;2;1;1482;2;996;776;220
2414;1;18609;2;1;1730;1;981;800;181
2414;1;18611;2;1;1566;0;919;812;107
2414;1;18623;2;1;1444;0;877;688;189
2414;2;18597;2;2;1432;0;610;529;81
2414;2;18600;2;2;2259;0;1305;1053;252
2414;2;18608;2;2;1781;2;1019;905;114
2414;2;18619;2;2;1643;1;1032;915;117
2414;2;18620;2;2;753;0;302;257;45
2414;3;18601;2;3;1447;1;853;760;93
2414;3;18603;2;3;1035;0;471;409;62
2414;3;18612;2;3;641;0;381;328;53
2414;3;18614;2;3;982;3;641;554;87
2414;3;18617;2;3;602;0;309;266;43
2414;4;18606;2;4;2426;4;1347;1156;191
2414;4;18613;2;4;1796;0;1083;938;145
2414;4;18616;2;4;1458;0;658;570;88
2414;4;18618;2;4;1597;1;867;719;148
2414;5;18594;2;5;1647;1;778;636;142
2414;5;18621;2;5;1626;1;853;705;148
2414;6;18604;2;6;2346;0;1285;1143;142
2414;6;18605;2;6;1112;0;425;368;57
2414;7;18599;2;7;1159;0;654;560;94
2414;7;18607;2;7;1288;2;554;496;58
2414;8;18596;2;8;949;1;398;327;71
2414;8;18610;2;8;1633;0;615;551;64
2414;9;18592;2;9;945;2;374;334;40
2414;9;18602;2;9;832;0;446;400;46
2415;10;18630;3;10;1135;1;475;434;41
2415;10;18666;3;10;1863;0;867;767;100
2415;10;18674;3;10;1350;0;494;450;44
2415;11;18633;3;11;2025;0;958;862;96
2415;11;18637;3;11;1143;0;526;493;33
2415;11;18692;3;11;938;0;467;415;52
2415;1;18627;3;1;1495;0;887;696;191
2415;1;18632;3;1;1925;0;1093;831;262
2415;1;18639;3;1;2196;0;1002;904;98
2415;1;18685;3;1;2354;0;1022;864;158
2415;1;18694;3;1;1545;0;672;605;67
2415;1;18698;3;1;866;0;388;359;29
2415;1;18700;3;1;2130;0;971;900;71
2415;1;18707;3;1;1433;0;529;461;68
2415;1;18709;3;1;1546;0;709;626;83
2415;12;18645;3;12;1272;0;532;471;61
2415;12;18689;3;12;1882;0;888;753;135
2415;12;18716;3;12;1479;0;635;561;74
2415;13;18655;3;13;1581;0;598;544;54
2415;13;18711;3;13;1298;9;636;545;91
2415;13;18714;3;13;1610;2;748;667;81
2415;14;18624;3;14;36;0;11;10;1
2415;14;18661;3;14;902;0;476;448;28
2415;14;18680;3;14;1379;0;592;535;57
2415;15;18658;3;15;205;0;98;85;13
2415;15;18690;3;15;1478;0;671;613;58
2415;16;18705;3;16;1292;0;515;447;68
2415;17;18649;3;17;1530;0;563;504;59
2415;18;18656;3;18;1953;0;876;796;80
2415;19;18659;3;19;1454;0;684;603;81
2415;20;18675;3;20;1647;2;753;616;137
2415;21;18713;3;21;1336;0;564;513;51
2415;2;18628;3;2;1422;0;665;619;46
2415;2;18634;3;2;1582;2;597;509;88
2415;2;18654;3;2;1394;0;772;611;161
2415;2;18657;3;2;2283;1;720;634;86
2415;2;18678;3;2;1161;0;568;509;59
2415;2;18681;3;2;1176;0;500;478;22
2415;2;18693;3;2;774;0;344;311;33
2415;2;18695;3;2;998;0;488;432;56
2415;2;18696;3;2;1253;0;753;633;120
2415;22;18712;3;22;1279;0;581;542;39
2415;23;18679;3;23;1116;0;511;452;59
2415;24;18672;3;24;1038;0;346;281;65
2415;25;18648;3;25;1320;0;582;521;61
2415;26;18640;3;26;1307;1;698;635;63
2415;27;18626;3;27;1326;0;598;540;58
2415;28;18641;3;28;60;0;22;20;2
2415;29;18715;3;29;7;0;2;2;0
2415;3;18636;3;3;1471;0;549;528;21
2415;3;18643;3;3;293;9;152;121;31
2415;3;18646;3;3;2038;0;1211;1017;194
2415;3;18662;3;3;1075;0;452;425;27
2415;3;18663;3;3;1068;0;518;411;107
2415;3;18669;3;3;735;0;308;270;38
2415;3;18673;3;3;1018;0;497;459;38
2415;3;18676;3;3;1236;0;575;504;71
2415;3;18688;3;3;2463;1;1019;898;121
2415;4;18642;3;4;1437;0;677;600;77
2415;4;18647;3;4;1592;0;721;672;49
2415;4;18650;3;4;2191;1;768;622;146
2415;4;18665;3;4;966;0;436;367;69
2415;4;18667;3;4;2310;3;1099;998;101
2415;4;18671;3;4;1257;0;561;462;99
2415;4;18687;3;4;820;0;452;400;52
2415;4;18710;3;4;1506;0;617;538;79
2415;5;18631;3;5;2077;0;824;764;60
2415;5;18638;3;5;2108;0;819;726;93
2415;5;18664;3;5;1218;0;441;377;64
2415;5;18682;3;5;1403;0;710;652;58
2415;5;18702;3;5;2401;1;1136;1051;85
2415;5;18704;3;5;1327;0;606;483;123
2415;5;18708;3;5;2320;0;924;816;108
2415;6;18651;3;6;1470;0;526;526;0
2415;6;18670;3;6;367;0;156;133;23
2415;6;18677;3;6;900;1;469;405;64
2415;6;18686;3;6;536;0;207;187;20
2415;6;18697;3;6;727;0;281;257;24
2415;6;18699;3;6;2186;1;953;862;91
2415;7;18625;3;7;2263;0;720;649;71
2415;7;18660;3;7;1262;0;445;413;32
2415;7;18668;3;7;290;2;148;122;26
2415;7;18684;3;7;1260;0;628;557;71
2415;7;18701;3;7;1312;0;613;570;43
2415;7;18703;3;7;1518;0;697;572;125
2415;8;18644;3;8;951;0;412;385;27
2415;8;18652;3;8;1361;0;524;440;84
2415;8;18653;3;8;961;0;331;306;25
2415;8;18683;3;8;1263;0;489;405;84
2415;8;18706;3;8;1335;0;654;598;56
2415;9;18629;3;9;328;0;125;124;1
2415;9;18635;3;9;1697;0;804;710;94
2415;9;18691;3;9;2449;0;1350;1211;139
2416;10;18749;7;10;1045;2;438;417;21
2416;10;18795;7;10;1665;0;767;662;105
2416;11;18737;7;11;1394;1;663;612;51
2416;1;18732;7;1;1443;0;794;583;211
2416;1;18748;7;1;1506;0;919;771;148
2416;1;18754;7;1;1068;2;596;557;39
2416;1;18755;7;1;1445;0;876;715;161
2416;1;18759;7;1;863;4;629;499;130
2416;1;18764;7;1;1542;0;969;736;233
2416;1;18767;7;1;2368;0;1023;860;163
2416;1;18770;7;1;1918;0;1007;864;143
2416;1;18778;7;1;622;0;351;315;36
2416;1;18790;7;1;434;0;273;244;29
2416;12;18783;7;12;1506;2;709;658;51
2416;13;18791;7;13;807;0;393;372;21
2416;14;18734;7;14;1415;0;765;720;45
2416;15;18752;7;15;1663;2;612;549;63
2416;16;18735;7;16;884;0;363;335;28
2416;17;18771;7;17;1633;1;762;694;68
2416;18;18774;7;18;656;0;349;313;36
2416;19;18720;7;19;795;0;336;294;42
2416;20;18731;7;20;117;0;97;93;4
2416;21;18792;7;21;1929;2;923;856;67
2416;2;18721;7;2;1670;4;969;864;105
2416;2;18725;7;2;544;0;325;247;78
2416;2;18733;7;2;647;0;321;286;35
2416;2;18740;7;2;858;9;539;422;117
2416;2;18753;7;2;497;0;350;274;76
2416;2;18757;7;2;861;0;351;324;27
2416;2;18760;7;2;1402;0;692;593;99
2416;2;18765;7;2;1293;0;750;649;101
2416;2;18769;7;2;1794;3;1177;1026;151
2416;2;18789;7;2;2052;0;865;744;121
2416;22;18787;7;22;1221;0;400;359;41
2416;23;18803;7;23;787;1;315;276;39
2416;24;18802;7;24;1061;0;450;413;37
2416;25;18723;7;25;1041;1;459;420;39
2416;26;18796;7;26;1032;0;309;256;53
2416;27;18801;7;27;825;0;350;327;23
2416;28;18738;7;28;2188;0;824;764;60
2416;29;18785;7;29;1515;0;607;564;43
2416;30;18730;7;30;1695;0;721;682;39
2416;31;18799;7;31;2400;2;1111;1020;91
2416;3;18722;7;3;1372;0;686;597;89
2416;3;18739;7;3;1496;2;626;531;95
2416;3;18751;7;3;411;0;304;255;49
2416;3;18758;7;3;2217;2;968;904;64
2416;3;18776;7;3;1957;0;1178;1036;142
2416;3;18777;7;3;2055;2;1099;994;105
2416;3;18780;7;3;421;2;271;198;73
2416;3;18781;7;3;393;0;261;184;77
2416;3;18788;7;3;1266;0;598;540;58
2416;3;18805;7;3;1258;0;712;585;127
2416;32;18766;7;32;2482;2;1315;1211;104
2416;33;18763;7;33;1079;1;532;498;34
2416;34;18762;7;34;55;0;27;27;0
2416;4;18728;7;4;502;2;345;309;36
2416;4;18742;7;4;328;0;184;151;33
2416;4;18743;7;4;777;0;427;352;75
2416;4;18756;7;4;770;0;420;357;63
2416;4;18772;7;4;997;0;444;383;61
2416;4;18779;7;4;1260;0;597;526;71
2416;4;18782;7;4;1908;0;980;902;78
2416;4;18786;7;4;690;0;444;352;92
2416;4;18804;7;4;1187;1;699;601;98
2416;5;18719;7;5;1061;0;614;492;122
2416;5;18726;7;5;630;0;319;261;58
2416;5;18727;7;5;259;3;179;140;39
2416;5;18729;7;5;864;0;557;476;81
2416;5;18741;7;5;1249;0;556;518;38
2416;5;18744;7;5;899;0;366;322;44
2416;5;18773;7;5;675;0;395;331;64
2416;5;18784;7;5;650;0;431;381;50
2416;6;18717;7;6;646;5;436;325;111
2416;6;18718;7;6;870;0;349;325;24
2416;6;18736;7;6;1077;0;481;410;71
2416;6;18746;7;6;1467;0;883;772;111
2416;6;18768;7;6;2076;0;979;856;123
2416;6;18775;7;6;1099;0;700;614;86
2416;7;18745;7;7;1168;0;485;418;67
2416;7;18747;7;7;526;2;346;295;51
2416;7;18750;7;7;1426;0;604;548;56
2416;7;18798;7;7;362;4;264;208;56
2416;7;18806;7;7;1020;0;462;401;61
2416;8;18724;7;8;365;0;265;226;39
2416;8;18793;7;8;2127;0;1001;921;80
2416;8;18794;7;8;914;0;383;341;42
2416;9;18761;7;9;783;0;450;422;28
2416;9;18797;7;9;243;0;148;122;26
2416;9;18800;7;9;1223;0;454;409;45
2417;10;18835;1;10;1372;1;1022;755;267
2417;10;18910;1;10;2221;0;1093;963;130
2417;11;18866;1;11;915;0;505;443;62
2417;11;18899;1;11;86;0;71;62;9
2417;1;18808;1;1;1775;1;1054;935;119
2417;1;18831;1;1;738;16;560;418;142
2417;1;18841;1;1;1752;0;980;780;200
2417;1;18843;1;1;1624;3;1119;860;259
2417;1;18848;1;1;1136;1;831;618;213
2417;1;18851;1;1;2191;2;1098;905;193
2417;1;18858;1;1;2280;0;1175;960;215
2417;1;18860;1;1;1325;0;784;627;157
2417;1;18863;1;1;739;0;402;348;54
2417;1;18874;1;1;417;0;260;201;59
2417;1;18876;1;1;2030;1;1113;836;277
2417;1;18896;1;1;1199;0;628;558;70
2417;1;18904;1;1;640;0;300;215;85
2417;1;18905;1;1;1510;0;896;748;148
2417;1;18907;1;1;1606;4;949;777;172
2417;12;18833;1;12;2098;0;1300;1126;174
2417;13;18824;1;13;1294;0;749;680;69
2417;14;18887;1;14;1244;3;790;710;80
2417;15;18879;1;15;970;0;584;484;100
2417;16;18895;1;16;268;0;166;147;19
2417;17;18872;1;17;471;0;279;245;34
2417;18;18861;1;18;2039;0;1131;1009;122
2417;19;18812;1;19;95;0;51;44;7
2417;20;18839;1;20;453;0;233;212;21
2417;2;18814;1;2;930;1;566;466;100
2417;2;18815;1;2;795;0;432;311;121
2417;2;18823;1;2;1289;0;794;681;113
2417;2;18825;1;2;1192;1;552;463;89
2417;2;18827;1;2;599;16;498;387;111
2417;2;18832;1;2;1557;0;877;715;162
2417;2;18834;1;2;1200;0;594;539;55
2417;2;18845;1;2;2380;1;1254;967;287
2417;2;18857;1;2;1422;2;748;617;131
2417;2;18859;1;2;1578;0;808;680;128
2417;2;18864;1;2;719;0;299;206;93
2417;2;18871;1;2;807;1;473;373;100
2417;2;18873;1;2;1324;0;756;602;154
2417;2;18877;1;2;1619;0;940;850;90
2417;2;18893;1;2;547;0;361;293;68
2417;3;18807;1;3;1878;0;1150;1053;97
2417;3;18811;1;3;631;1;418;329;89
2417;3;18813;1;3;505;9;400;301;99
2417;3;18817;1;3;1235;4;741;608;133
2417;3;18819;1;3;1764;0;1013;861;152
2417;3;18828;1;3;231;0;140;125;15
2417;3;18837;1;3;1608;0;764;641;123
2417;3;18844;1;3;1823;0;1223;1011;212
2417;3;18847;1;3;527;1;230;179;51
2417;3;18849;1;3;2003;2;1188;997;191
2417;3;18855;1;3;1333;0;707;629;78
2417;3;18865;1;3;1098;0;582;472;110
2417;3;18881;1;3;1656;0;744;621;123
2417;3;18889;1;3;1173;0;605;477;128
2417;3;18902;1;3;1174;1;688;581;107
2417;4;18818;1;4;836;1;383;299;84
2417;4;18820;1;4;680;0;355;279;76
2417;4;18853;1;4;1412;1;877;734;143
2417;4;18854;1;4;740;0;436;340;96
2417;4;18870;1;4;168;1;129;98;31
2417;4;18875;1;4;1744;0;906;806;100
2417;4;18882;1;4;1348;0;727;608;119
2417;4;18885;1;4;1234;2;599;469;130
2417;4;18888;1;4;1008;0;477;398;79
2417;4;18891;1;4;129;0;44;39;5
2417;4;18901;1;4;1454;2;1015;867;148
2417;4;18906;1;4;1506;0;890;779;111
2417;4;18909;1;4;794;0;424;334;90
2417;5;18826;1;5;1025;1;572;446;126
2417;5;18829;1;5;1056;0;574;540;34
2417;5;18830;1;5;650;0;323;274;49
2417;5;18862;1;5;1315;1;1023;971;52
2417;5;18868;1;5;751;0;362;307;55
2417;5;18869;1;5;1493;0;916;749;167
2417;5;18884;1;5;614;0;346;268;78
2417;5;18892;1;5;1710;0;924;696;228
2417;5;18898;1;5;1904;0;1013;876;137
2417;5;18900;1;5;1077;0;564;407;157
2417;5;18903;1;5;873;0;423;376;47
2417;6;18822;1;6;617;0;331;271;60
2417;6;18836;1;6;803;0;412;307;105
2417;6;18838;1;6;1829;0;871;749;122
2417;6;18852;1;6;1839;0;951;754;197
2417;6;18856;1;6;970;1;697;623;74
2417;6;18867;1;6;298;0;157;114;43
2417;6;18883;1;6;1271;0;691;628;63
2417;6;18890;1;6;370;0;208;178;30
2417;6;18897;1;6;1867;0;1050;880;170
2417;7;18810;1;7;1681;0;863;733;130
2417;7;18816;1;7;751;0;387;313;74
2417;7;18840;1;7;1242;2;835;690;145
2417;7;18842;1;7;2161;0;1265;1094;171
2417;7;18846;1;7;834;0;476;411;65
2417;7;18894;1;7;1776;0;944;801;143
2417;7;18908;1;7;389;0;247;194;53
2417;8;18809;1;8;1650;0;841;673;168
2417;8;18878;1;8;853;0;477;423;54
2417;8;18880;1;8;214;0;140;108;32
2417;8;18886;1;8;1283;0;613;473;140
2417;9;18821;1;9;369;3;305;242;63
2417;9;18850;1;9;1970;0;1001;905;96
2461;10;18954;1;10;1081;0;535;485;50
2461;11;18951;1;11;1239;0;602;545;57
2461;1;18946;1;1;1923;0;878;804;74
2461;12;18969;1;12;1534;0;561;537;24
2461;13;18956;1;13;1446;0;659;608;51
2461;14;18973;1;14;1076;1;450;414;36
2461;15;18945;1;15;1272;0;383;335;48
2461;16;18984;1;16;1743;0;563;504;59
2461;17;18929;1;17;1303;0;602;560;42
2461;18;19004;1;18;1369;0;599;541;58
2461;19;18928;1;19;2384;0;964;890;74
2461;20;18981;1;20;2333;0;797;720;77
2461;21;19002;1;21;2187;0;977;916;61
2461;2;18918;1;2;1484;0;636;580;56
2461;22;18990;1;22;1199;0;519;489;30
2461;23;18944;1;23;1691;0;767;712;55
2461;24;18937;1;24;2092;0;1040;970;70
2461;25;18995;1;25;800;0;393;353;40
2461;26;18982;1;26;1602;0;708;648;60
2461;27;19005;1;27;1078;0;544;492;52
2461;28;18993;1;28;2004;0;847;781;66
2461;29;18923;1;29;1538;0;682;640;42
2461;30;18941;1;30;1194;0;595;555;40
2461;31;18961;1;31;1619;0;780;705;75
2461;3;18953;1;3;1853;0;710;649;61
2461;32;18931;1;32;1575;0;744;693;51
2461;33;19008;1;33;510;0;211;194;17
2461;34;19000;1;34;1441;0;609;609;0
2461;35;18915;1;35;1056;0;520;467;53
2461;36;18955;1;36;1356;0;703;650;53
2461;37;18962;1;37;1288;0;616;568;48
2461;38;18952;1;38;1257;0;539;500;39
2461;39;18998;1;39;1289;0;589;557;32
2461;40;18949;1;40;1358;0;655;603;52
2461;41;18914;1;41;998;0;526;483;43
2461;4;18911;1;4;1997;1;959;909;50
2461;42;18970;1;42;786;0;302;275;27
2461;43;18975;1;43;1901;0;824;739;85
2461;44;18989;1;44;472;0;157;139;18
2461;45;18936;1;45;949;0;368;347;21
2461;46;18927;1;46;815;0;247;225;22
2461;47;18977;1;47;1188;0;586;559;27
2461;48;18916;1;48;797;0;324;299;25
2461;49;18934;1;49;1218;0;622;592;30
2461;50;18942;1;50;1150;0;557;513;44
2461;51;18922;1;51;558;1;232;222;10
2461;5;18957;1;5;1054;0;466;420;46
2461;52;19003;1;52;1301;0;587;544;43
2461;53;18988;1;53;2037;0;966;876;90
2461;54;18967;1;54;1402;0;666;624;42
2461;55;18933;1;55;1128;0;529;494;35
2461;56;18966;1;56;1781;0;784;737;47
2461;57;18996;1;57;1235;0;510;478;32
2461;58;18974;1;58;1021;0;529;504;25
2461;59;18917;1;59;1426;0;550;488;62
2461;60;18960;1;60;1747;0;687;612;75
2461;61;18983;1;61;1886;0;902;846;56
2461;6;18991;1;6;1630;0;697;636;61
2461;62;18943;1;62;1767;1;926;851;75
2461;63;18994;1;63;1785;0;867;795;72
2461;64;18930;1;64;1858;0;926;864;62
2461;65;18963;1;65;1978;0;991;923;68
2461;66;18932;1;66;1744;0;792;724;68
2461;67;18964;1;67;2202;0;1030;980;50
2461;68;18925;1;68;1803;0;830;750;80
2461;69;18948;1;69;1362;0;547;509;38
2461;70;18999;1;70;1890;0;1051;946;105
2461;71;18924;1;71;949;0;466;431;35
2461;7;18935;1;7;1512;0;638;579;59
2461;72;18920;1;72;736;0;342;308;34
2461;73;18950;1;73;2435;0;1135;1064;71
2461;74;18947;1;74;1114;0;561;534;27
2461;75;18913;1;75;2342;0;1107;1047;60
2461;76;18926;1;76;1808;0;991;923;68
2461;77;18978;1;77;852;0;457;412;45
2461;78;18976;1;78;1198;0;572;536;36
2461;79;18965;1;79;1536;0;809;752;57
2461;80;19006;1;80;1814;0;796;749;47
2461;81;18940;1;81;1933;0;832;786;46
2461;8;18986;1;8;1125;0;529;494;35
2461;82;18979;1;82;1845;0;703;651;52
2461;83;18921;1;83;1263;0;594;563;31
2461;84;18992;1;84;2110;0;1009;933;76
2461;85;18972;1;85;2135;0;954;944;10
2461;86;18987;1;86;2117;0;980;901;79
2461;87;18958;1;87;2386;0;1089;1028;61
2461;88;18997;1;88;2334;0;1249;1145;104
2461;89;18938;1;89;1939;0;1004;931;73
2461;90;18971;1;90;2372;0;1109;1023;86
2461;91;18968;1;91;1723;0;814;764;50
2461;9;18980;1;9;2205;1;894;819;75
2461;92;19007;1;92;1885;0;869;810;59
2461;93;18959;1;93;55;0;47;44;3
2461;94;18985;1;94;69;0;31;26;5
2461;95;18912;1;95;56;0;31;30;1
2461;96;19001;1;96;23;0;17;15;2
2461;97;18939;1;97;170;0;53;47;6
2461;98;18919;1;98;87;0;65;54;11
2462;10;19022;4;10;970;0;400;379;21
2462;11;19060;4;11;1450;0;591;554;37
2462;1;19024;4;1;1941;1;645;586;59
2462;12;19057;4;12;1508;0;627;590;37
2462;13;19050;4;13;1376;1;545;522;23
2462;14;19010;4;14;1840;0;842;773;69
2462;15;19027;4;15;1350;0;390;364;26
2462;16;19051;4;16;1418;0;489;459;30
2462;17;19033;4;17;813;0;162;147;15
2462;18;19077;4;18;1896;0;327;295;32
2462;19;19094;4;19;1594;0;466;386;80
2462;20;19075;4;20;1585;0;545;494;51
2462;21;19071;4;21;1498;0;548;496;52
2462;2;19043;4;2;1435;0;377;358;19
2462;22;19095;4;22;1775;0;662;622;40
2462;23;19029;4;23;1579;0;575;525;50
2462;24;19028;4;24;1084;0;272;241;31
2462;25;19066;4;25;1005;0;301;278;23
2462;26;19064;4;26;1199;0;507;472;35
2462;27;19090;4;27;1418;0;501;465;36
2462;28;19083;4;28;1668;0;663;602;61
2462;29;19105;4;29;1439;0;446;400;46
2462;30;19025;4;30;1888;0;821;749;72
2462;31;19015;4;31;1856;0;723;672;51
2462;3;19046;4;3;1025;0;250;234;16
2462;32;19023;4;32;1167;0;386;348;38
2462;33;19078;4;33;1764;0;662;602;60
2462;34;19096;4;34;1858;1;742;693;49
2462;35;19080;4;35;1334;0;287;261;26
2462;36;19106;4;36;957;0;146;130;16
2462;37;19026;4;37;1469;0;446;422;24
2462;38;19032;4;38;2065;0;654;617;37
2462;39;19053;4;39;1993;0;574;529;45
2462;40;19073;4;40;1609;0;425;391;34
2462;41;19069;4;41;1986;0;516;472;44
2462;4;19020;4;4;2017;0;555;503;52
2462;42;19091;4;42;1984;0;549;525;24
2462;43;19081;4;43;1641;0;573;535;38
2462;44;19089;4;44;1000;0;185;185;0
2462;45;19074;4;45;2126;0;802;740;62
2462;46;19034;4;46;1858;0;724;674;50
2462;47;19103;4;47;1328;0;519;485;34
2462;48;19070;4;48;1303;0;506;480;26
2462;49;19101;4;49;1363;0;569;521;48
2462;50;19019;4;50;1241;0;502;459;43
2462;51;19055;4;51;1415;0;515;469;46
2462;5;19054;4;5;1317;0;481;452;29
2462;52;19018;4;52;1531;0;535;486;49
2462;53;19097;4;53;1343;0;496;450;46
2462;54;19037;4;54;1215;0;352;322;30
2462;55;19065;4;55;1690;0;475;439;36
2462;56;19102;4;56;1345;0;367;325;42
2462;57;19079;4;57;1905;1;700;667;33
2462;58;19036;4;58;1857;0;525;457;68
2462;59;19044;4;59;1780;0;479;443;36
2462;60;19039;4;60;1154;0;329;297;32
2462;61;19016;4;61;1881;1;607;569;38
2462;6;19098;4;6;1953;0;761;714;47
2462;62;19045;4;62;1632;0;698;649;49
2462;63;19021;4;63;1408;0;401;371;30
2462;64;19082;4;64;1458;1;624;586;38
2462;65;19031;4;65;1002;0;281;255;26
2462;66;19009;4;66;1850;0;782;728;54
2462;67;19041;4;67;2090;0;714;640;74
2462;68;19011;4;68;1820;0;776;746;30
2462;69;19012;4;69;1907;0;684;634;50
2462;70;19092;4;70;1980;0;542;504;38
2462;71;19100;4;71;1693;0;568;540;28
2462;7;19038;4;7;1025;0;332;310;22
2462;72;19093;4;72;2005;0;564;510;54
2462;73;19052;4;73;2013;0;705;654;51
2462;74;19061;4;74;1918;0;819;773;46
2462;75;19040;4;75;1507;0;512;481;31
2462;76;19014;4;76;1660;0;523;488;35
2462;77;19084;4;77;1583;0;582;547;35
2462;78;19072;4;78;1740;0;810;768;42
2462;79;19068;4;79;2078;0;837;792;45
2462;80;19035;4;80;1422;0;663;613;50
2462;81;19088;4;81;1467;0;563;539;24
2462;8;19049;4;8;1123;0;394;359;35
2462;82;19104;4;82;1884;0;896;840;56
2462;83;19076;4;83;1832;0;610;586;24
2462;84;19059;4;84;2019;0;757;687;70
2462;85;19047;4;85;1058;0;391;365;26
2462;86;19086;4;86;1662;0;561;522;39
2462;87;19056;4;87;775;0;285;265;20
2462;88;19085;4;88;1430;0;512;466;46
2462;89;19099;4;89;27;0;8;8;0
2462;90;19067;4;90;53;0;19;17;2
2462;91;19030;4;91;33;0;3;3;0
2462;9;19013;4;9;1034;0;415;387;28
2462;92;19042;4;92;50;0;40;39;1
2462;93;19017;4;93;73;0;15;11;4
2462;94;19048;4;94;94;0;4;4;0
2462;95;19058;4;95;198;0;49;46;3
2462;96;19087;4;96;148;0;73;66;7
2462;97;19062;4;97;103;0;62;55;7
2462;98;19063;4;98;39;0;14;14;0
2463;10;19108;5;10;1108;0;470;435;35
2463;11;19135;5;11;1953;0;551;515;36
2463;1;19132;5;1;1840;1;635;586;49
2463;12;19154;5;12;1761;0;524;483;41
2463;13;19124;5;13;2041;0;737;697;40
2463;14;19145;5;14;1916;0;577;539;38
2463;15;19149;5;15;1747;0;639;600;39
2463;16;19165;5;16;2248;1;956;908;48
2463;17;19166;5;17;2305;0;967;923;44
2463;18;19134;5;18;2083;0;615;567;48
2463;19;19152;5;19;2158;0;800;755;45
2463;20;19109;5;20;1623;1;491;451;40
2463;21;19138;5;21;1512;0;622;593;29
2463;2;19120;5;2;1037;0;429;393;36
2463;22;19107;5;22;1079;0;289;258;31
2463;23;19128;5;23;1510;0;715;667;48
2463;24;19141;5;24;1541;0;543;509;34
2463;25;19164;5;25;529;0;184;177;7
2463;26;19115;5;26;1735;0;670;638;32
2463;27;19151;5;27;2025;0;954;911;43
2463;28;19117;5;28;1910;0;635;599;36
2463;29;19127;5;29;1929;0;782;739;43
2463;30;19121;5;30;1965;0;1023;972;51
2463;31;19153;5;31;1423;0;594;567;27
2463;3;19144;5;3;2116;0;747;688;59
2463;32;19118;5;32;1968;1;1054;1013;41
2463;33;19163;5;33;1189;0;557;527;30
2463;34;19130;5;34;1576;0;639;601;38
2463;35;19157;5;35;2030;0;677;630;47
2463;36;19122;5;36;1703;0;539;512;27
2463;37;19146;5;37;1929;0;752;706;46
2463;38;19161;5;38;952;0;258;242;16
2463;39;19123;5;39;1037;0;457;437;20
2463;40;19110;5;40;1676;0;422;399;23
2463;41;19162;5;41;2215;0;782;735;47
2463;4;19143;5;4;1752;0;775;736;39
2463;42;19113;5;42;1760;0;579;546;33
2463;43;19167;5;43;1760;0;386;355;31
2463;44;19155;5;44;1185;1;509;469;40
2463;45;19148;5;45;1676;0;756;711;45
2463;46;19150;5;46;1591;1;667;609;58
2463;47;19160;5;47;1184;0;444;415;29
2463;48;19116;5;48;2020;0;955;890;65
2463;49;19119;5;49;856;0;310;287;23
2463;50;19147;5;50;2354;1;1144;1058;86
2463;51;19131;5;51;1145;0;349;316;33
2463;5;19158;5;5;1904;0;551;528;23
2463;52;19112;5;52;1322;0;430;405;25
2463;53;19111;5;53;2403;0;907;842;65
2463;54;19114;5;54;135;0;73;68;5
2463;55;19156;5;55;69;0;16;16;0
2463;56;19129;5;56;53;0;50;50;0
2463;57;19159;5;57;74;0;42;39;3
2463;58;19137;5;58;123;0;57;50;7
2463;59;19140;5;59;50;0;22;19;3
2463;60;19126;5;60;49;0;19;15;4
2463;61;19142;5;61;45;0;34;28;6
2463;6;19136;5;6;1715;0;669;636;33
2463;7;19125;5;7;1214;0;470;451;19
2463;8;19133;5;8;1476;1;435;396;39
2463;9;19139;5;9;2001;0;941;860;81
2464;100;19211;6;100;1912;0;701;676;25
2464;101;19259;6;101;675;0;250;233;17
2464;10;19231;6;10;1512;0;683;661;22
2464;102;19279;6;102;1546;0;510;479;31
2464;103;19203;6;103;1502;0;439;401;38
2464;104;19242;6;104;1792;0;589;544;45
2464;105;19290;6;105;521;0;183;174;9
2464;106;19271;6;106;1009;0;407;395;12
2464;107;19251;6;107;1253;0;491;475;16
2464;108;19246;6;108;1522;0;582;565;17
2464;109;19294;6;109;2170;0;901;856;45
2464;110;19179;6;110;1237;0;512;482;30
2464;111;19300;6;111;1095;0;373;352;21
2464;11;19207;6;11;1277;0;530;516;14
2464;112;19236;6;112;1423;0;504;476;28
2464;113;19209;6;113;1782;0;703;670;33
2464;114;19169;6;114;1140;0;484;470;14
2464;115;19180;6;115;2004;1;720;690;30
2464;116;19215;6;116;2011;0;869;835;34
2464;117;19287;6;117;1667;0;792;758;34
2464;118;19226;6;118;1898;0;1010;984;26
2464;1;19173;6;1;1197;0;246;235;11
2464;119;19206;6;119;1807;0;823;787;36
2464;120;19178;6;120;1856;0;952;919;33
2464;121;19272;6;121;786;0;276;266;10
2464;12;19191;6;12;1051;0;535;506;29
2464;122;19210;6;122;2152;2;866;839;27
2464;123;19216;6;123;1189;0;442;427;15
2464;124;19187;6;124;1296;0;511;492;19
2464;125;19298;6;125;95;0;61;61;0
2464;126;19253;6;126;38;0;20;19;1
2464;127;19186;6;127;75;0;22;20;2
2464;128;19288;6;128;98;0;26;25;1
2464;129;19196;6;129;137;0;95;86;9
2464;130;19195;6;130;69;0;24;21;3
2464;131;19299;6;131;90;0;43;38;5
2464;13;19199;6;13;801;0;365;359;6
2464;132;19264;6;132;48;0;40;39;1
2464;133;19197;6;133;103;0;85;59;26
2464;134;19262;6;134;63;0;9;9;0
2464;14;19200;6;14;1320;0;388;374;14
2464;15;19238;6;15;1627;0;660;637;23
2464;16;19266;6;16;1446;0;609;588;21
2464;17;19267;6;17;1821;0;741;706;35
2464;18;19233;6;18;1079;1;453;446;7
2464;19;19270;6;19;1761;1;718;692;26
2464;20;19214;6;20;2103;0;848;817;31
2464;21;19241;6;21;1668;0;663;649;14
2464;2;19188;6;2;1363;0;407;379;28
2464;22;19254;6;22;1781;0;623;603;20
2464;23;19190;6;23;2145;0;826;785;41
2464;24;19265;6;24;828;0;364;364;0
2464;25;19250;6;25;1335;0;633;600;33
2464;26;19170;6;26;1266;0;553;530;23
2464;27;19301;6;27;1587;0;741;712;29
2464;28;19177;6;28;1724;0;757;707;50
2464;29;19230;6;29;1290;0;479;469;10
2464;30;19182;6;30;1209;0;514;494;20
2464;31;19280;6;31;1606;0;625;605;20
2464;3;19220;6;3;598;0;129;126;3
2464;32;19256;6;32;1534;0;665;650;15
2464;33;19263;6;33;752;0;356;342;14
2464;34;19234;6;34;1933;0;964;945;19
2464;35;19282;6;35;1843;0;928;901;27
2464;36;19258;6;36;1846;0;825;787;38
2464;37;19284;6;37;2007;0;907;874;33
2464;38;19185;6;38;2204;0;1022;982;40
2464;39;19217;6;39;2369;0;1150;1102;48
2464;40;19237;6;40;2379;0;1061;992;69
2464;41;19276;6;41;2152;0;995;972;23
2464;4;19225;6;4;1076;0;342;328;14
2464;42;19168;6;42;1865;0;835;813;22
2464;43;19268;6;43;1916;0;854;808;46
2464;44;19212;6;44;1096;8;409;398;11
2464;45;19260;6;45;2148;0;889;857;32
2464;46;19223;6;46;1213;0;506;491;15
2464;47;19293;6;47;2290;0;959;916;43
2464;48;19193;6;48;1992;1;858;832;26
2464;49;19269;6;49;1899;0;771;753;18
2464;50;19219;6;50;1100;0;444;434;10
2464;51;19224;6;51;1862;0;769;746;23
2464;5;19232;6;5;1348;0;413;391;22
2464;52;19218;6;52;1973;0;803;774;29
2464;53;19257;6;53;1737;0;729;701;28
2464;54;19221;6;54;1903;0;690;655;35
2464;55;19194;6;55;1741;0;627;603;24
2464;56;19181;6;56;1590;0;703;681;22
2464;57;19204;6;57;1186;0;531;516;15
2464;58;19227;6;58;1794;0;859;826;33
2464;59;19297;6;59;464;0;252;243;9
2464;60;19229;6;60;898;0;257;244;13
2464;61;19296;6;61;911;0;250;237;13
2464;6;19171;6;6;1602;0;409;391;18
2464;62;19205;6;62;1273;0;477;441;36
2464;63;19228;6;63;1262;0;520;492;28
2464;64;19198;6;64;1500;0;649;617;32
2464;65;19247;6;65;326;0;110;109;1
2464;66;19285;6;66;1230;0;404;393;11
2464;67;19248;6;67;1576;0;552;533;19
2464;68;19175;6;68;1337;0;457;434;23
2464;69;19189;6;69;1506;0;515;473;42
2464;70;19192;6;70;2051;1;808;779;29
2464;71;19183;6;71;1800;0;786;731;55
2464;7;19172;6;7;1725;0;423;397;26
2464;72;19255;6;72;1388;0;327;307;20
2464;73;19274;6;73;1862;0;750;712;38
2464;74;19261;6;74;2204;0;864;824;40
2464;75;19208;6;75;1608;0;560;529;31
2464;76;19295;6;76;1071;0;412;383;29
2464;77;19286;6;77;2220;0;758;715;43
2464;78;19273;6;78;1710;0;641;612;29
2464;79;19245;6;79;1322;2;430;392;38
2464;80;19283;6;80;2158;0;815;774;41
2464;81;19243;6;81;1214;0;301;271;30
2464;8;19240;6;8;1171;0;265;252;13
2464;82;19239;6;82;1676;0;664;633;31
2464;83;19292;6;83;1204;0;451;417;34
2464;84;19235;6;84;1915;0;814;770;44
2464;85;19174;6;85;1364;0;567;536;31
2464;86;19252;6;86;1745;0;705;687;18
2464;87;19244;6;87;1328;0;587;557;30
2464;88;19222;6;88;2356;0;862;809;53
2464;89;19281;6;89;2138;0;874;836;38
2464;90;19277;6;90;2128;0;822;793;29
2464;91;19275;6;91;1745;0;659;628;31
2464;9;19289;6;9;1480;0;560;533;27
2464;92;19176;6;92;2293;0;864;803;61
2464;93;19201;6;93;2141;0;742;719;23
2464;94;19202;6;94;1632;0;637;598;39
2464;95;19249;6;95;1484;0;580;562;18
2464;96;19213;6;96;782;0;344;329;15
2464;97;19184;6;97;1873;0;758;721;37
2464;98;19291;6;98;1983;0;709;673;36
2464;99;19278;6;99;2176;1;825;782;43
2465;10;19361;7;10;2128;2;792;746;46
2465;11;19324;7;11;1397;0;600;558;42
2465;1;19355;7;1;1459;2;702;669;33
2465;12;19347;7;12;1681;0;598;546;52
2465;13;19307;7;13;201;0;79;73;6
2465;14;19367;7;14;1227;0;464;440;24
2465;15;19343;7;15;1868;0;756;711;45
2465;16;19358;7;16;2016;1;790;727;63
2465;17;19323;7;17;1547;0;628;584;44
2465;18;19315;7;18;1129;0;505;475;30
2465;19;19317;7;19;1973;1;827;765;62
2465;20;19325;7;20;2035;0;836;765;71
2465;21;19336;7;21;927;1;397;365;32
2465;2;19331;7;2;639;0;268;246;22
2465;22;19306;7;22;1396;1;625;532;93
2465;23;19352;7;23;2220;0;915;812;103
2465;24;19321;7;24;1459;1;662;612;50
2465;25;19359;7;25;1584;0;778;733;45
2465;26;19328;7;26;529;0;194;184;10
2465;27;19304;7;27;1689;0;748;696;52
2465;28;19349;7;28;1438;0;531;512;19
2465;29;19360;7;29;2331;0;917;842;75
2465;30;19353;7;30;2083;0;784;721;63
2465;31;19316;7;31;1820;0;758;701;57
2465;3;19354;7;3;1777;0;800;728;72
2465;32;19320;7;32;1307;0;568;529;39
2465;33;19305;7;33;109;0;64;34;30
2465;34;19368;7;34;1977;0;849;793;56
2465;35;19362;7;35;1231;0;495;468;27
2465;36;19308;7;36;1171;0;556;527;29
2465;37;19334;7;37;1769;0;698;640;58
2465;38;19302;7;38;1941;0;762;700;62
2465;39;19348;7;39;2053;0;777;707;70
2465;40;19364;7;40;2072;0;848;800;48
2465;41;19314;7;41;1057;0;416;388;28
2465;4;19310;7;4;1910;0;767;686;81
2465;42;19344;7;42;1898;0;786;726;60
2465;43;19365;7;43;1365;0;499;455;44
2465;44;19345;7;44;1575;0;586;511;75
2465;45;19341;7;45;943;1;351;322;29
2465;46;19311;7;46;2023;0;873;785;88
2465;47;19303;7;47;2131;0;729;668;61
2465;48;19351;7;48;2209;0;769;701;68
2465;49;19335;7;49;1365;0;569;512;57
2465;50;19357;7;50;1772;0;737;665;72
2465;51;19312;7;51;848;0;400;341;59
2465;5;19350;7;5;2062;0;887;819;68
2465;52;19366;7;52;1403;2;647;593;54
2465;53;19318;7;53;1784;0;872;817;55
2465;54;19309;7;54;826;0;347;332;15
2465;55;19322;7;55;2383;2;1190;1085;105
2465;56;19326;7;56;1132;0;347;307;40
2465;57;19338;7;57;1505;0;506;449;57
2465;58;19329;7;58;1954;0;985;888;97
2465;59;19363;7;59;622;0;411;370;41
2465;60;19327;7;60;1048;0;631;563;68
2465;61;19346;7;61;1457;1;840;742;98
2465;6;19319;7;6;2220;0;967;867;100
2465;62;19313;7;62;1785;0;732;681;51
2465;63;19342;7;63;2173;0;859;769;90
2465;64;19333;7;64;1341;0;546;518;28
2465;65;19339;7;65;1742;0;682;616;66
2465;66;19340;7;66;1185;0;473;429;44
2465;67;19332;7;67;1248;1;630;547;83
2465;7;19356;7;7;1579;0;658;623;35
2465;8;19330;7;8;1399;0;488;441;47
2465;9;19337;7;9;2173;0;918;865;53
2466;100;19379;4;100;1775;0;794;759;35
2466;101;19431;4;101;1261;0;580;566;14
2466;10;19420;4;10;1826;0;748;719;29
2466;102;19395;4;102;1184;0;464;464;0
2466;103;19412;4;103;1372;0;569;528;41
2466;104;19371;4;104;1385;1;656;630;26
2466;105;19401;4;105;50;0;18;16;2
2466;106;19447;4;106;39;0;13;11;2
2466;107;19464;4;107;36;0;9;9;0
2466;108;19440;4;108;10;0;5;4;1
2466;109;19436;4;109;34;0;17;14;3
2466;110;19435;4;110;79;0;45;44;1
2466;111;19450;4;111;44;0;27;22;5
2466;11;19462;4;11;1545;0;378;364;14
2466;112;19415;4;112;112;0;78;51;27
2466;113;19417;4;113;32;0;19;19;0
2466;114;19403;4;114;192;0;85;73;12
2466;1;19445;4;1;1368;1;474;431;43
2466;12;19413;4;12;2114;0;905;873;32
2466;13;19409;4;13;1872;0;816;772;44
2466;14;19443;4;14;1336;0;564;538;26
2466;15;19478;4;15;1574;0;676;648;28
2466;16;19421;4;16;1240;0;523;488;35
2466;17;19402;4;17;1563;0;551;520;31
2466;18;19477;4;18;1392;0;306;283;23
2466;19;19461;4;19;943;0;419;412;7
2466;20;19446;4;20;1667;0;683;648;35
2466;21;19422;4;21;1345;0;559;531;28
2466;2;19467;4;2;1001;0;216;202;14
2466;22;19381;4;22;1693;3;750;732;18
2466;23;19383;4;23;1309;0;632;622;10
2466;24;19459;4;24;1462;0;632;597;35
2466;25;19466;4;25;1558;0;700;678;22
2466;26;19406;4;26;1371;1;735;715;20
2466;27;19390;4;27;1066;0;489;469;20
2466;28;19427;4;28;1770;0;923;865;58
2466;29;19369;4;29;1529;0;684;661;23
2466;30;19429;4;30;2379;0;1103;1048;55
2466;31;19388;4;31;1928;1;811;760;51
2466;3;19428;4;3;550;0;258;231;27
2466;32;19480;4;32;1116;0;310;288;22
2466;33;19382;4;33;1696;0;468;428;40
2466;34;19392;4;34;1107;0;440;410;30
2466;35;19434;4;35;1269;0;346;346;0
2466;36;19479;4;36;950;0;425;410;15
2466;37;19438;4;37;2165;3;888;858;30
2466;38;19397;4;38;1894;0;695;647;48
2466;39;19432;4;39;1862;0;800;733;67
2466;40;19400;4;40;1339;0;526;490;36
2466;41;19474;4;41;1370;0;470;441;29
2466;4;19389;4;4;1068;0;385;360;25
2466;42;19472;4;42;2197;0;790;759;31
2466;43;19449;4;43;2131;0;845;802;43
2466;44;19433;4;44;1560;0;671;638;33
2466;45;19424;4;45;841;0;265;255;10
2466;46;19377;4;46;1751;0;851;810;41
2466;47;19471;4;47;1146;0;447;424;23
2466;48;19425;4;48;1432;1;573;547;26
2466;49;19470;4;49;717;0;315;309;6
2466;50;19460;4;50;1701;0;638;609;29
2466;51;19454;4;51;1742;0;727;713;14
2466;5;19469;4;5;1214;0;337;321;16
2466;52;19387;4;52;1538;0;685;656;29
2466;53;19375;4;53;1961;1;610;569;41
2466;54;19408;4;54;1424;0;410;388;22
2466;55;19373;4;55;1306;0;412;384;28
2466;56;19386;4;56;1692;0;534;500;34
2466;57;19439;4;57;1329;0;453;416;37
2466;58;19399;4;58;1138;0;335;319;16
2466;59;19473;4;59;1547;0;525;478;47
2466;60;19475;4;60;1533;0;505;469;36
2466;61;19396;4;61;1810;0;513;487;26
2466;6;19458;4;6;1580;0;488;457;31
2466;62;19372;4;62;1084;0;238;214;24
2466;63;19370;4;63;1925;0;437;393;44
2466;64;19481;4;64;1649;0;446;446;0
2466;65;19437;4;65;1598;0;413;378;35
2466;66;19441;4;66;840;0;276;252;24
2466;67;19394;4;67;882;0;266;249;17
2466;68;19384;4;68;1696;0;475;440;35
2466;69;19442;4;69;727;2;247;228;19
2466;70;19407;4;70;1089;0;420;403;17
2466;71;19456;4;71;1617;2;684;667;17
2466;7;19423;4;7;1332;0;517;497;20
2466;72;19457;4;72;1266;0;474;458;16
2466;73;19476;4;73;1987;1;724;688;36
2466;74;19418;4;74;1094;0;553;506;47
2466;75;19465;4;75;1081;0;476;425;51
2466;76;19452;4;76;996;0;355;355;0
2466;77;19404;4;77;1063;0;433;414;19
2466;78;19385;4;78;1228;0;356;336;20
2466;79;19398;4;79;1818;0;608;579;29
2466;80;19391;4;80;1562;0;637;606;31
2466;81;19378;4;81;1473;0;670;640;30
2466;8;19416;4;8;1357;0;407;374;33
2466;82;19393;4;82;1656;0;796;760;36
2466;83;19411;4;83;1662;0;630;596;34
2466;84;19463;4;84;1079;1;486;470;16
2466;85;19455;4;85;1156;0;576;556;20
2466;86;19482;4;86;991;1;509;495;14
2466;87;19451;4;87;958;0;339;327;12
2466;88;19376;4;88;495;0;91;86;5
2466;89;19430;4;89;1682;1;601;576;25
2466;90;19426;4;90;1374;0;459;442;17
2466;91;19414;4;91;2041;0;831;786;45
2466;9;19448;4;9;1104;0;376;339;37
2466;92;19444;4;92;1911;0;861;836;25
2466;93;19374;4;93;1634;0;609;569;40
2466;94;19380;4;94;1891;1;728;684;44
2466;95;19410;4;95;1734;0;540;505;35
2466;96;19419;4;96;1797;1;814;767;47
2466;97;19468;4;97;1206;0;412;398;14
2466;98;19405;4;98;1902;1;789;763;26
2466;99;19453;4;99;1868;0;788;762;26
2467;10;19491;3;10;1762;0;749;694;55
2467;11;19498;3;11;1746;0;768;701;67
2467;1;19527;3;1;2004;0;751;663;88
2467;12;19487;3;12;1593;0;664;617;47
2467;13;19507;3;13;1505;0;575;550;25
2467;14;19501;3;14;1637;0;779;722;57
2467;15;19516;3;15;1781;0;640;559;81
2467;16;19489;3;16;1874;0;568;512;56
2467;17;19534;3;17;1194;0;456;452;4
2467;18;19499;3;18;1498;0;617;573;44
2467;19;19528;3;19;1332;0;634;592;42
2467;20;19519;3;20;1436;0;546;504;42
2467;21;19526;3;21;1887;0;780;726;54
2467;2;19525;3;2;2206;2;970;885;85
2467;22;19509;3;22;1325;0;493;454;39
2467;23;19531;3;23;1214;0;455;433;22
2467;24;19518;3;24;1197;0;451;420;31
2467;25;19485;3;25;1173;0;409;379;30
2467;26;19532;3;26;1356;0;450;415;35
2467;27;19517;3;27;2119;0;848;776;72
2467;28;19529;3;28;1302;0;536;505;31
2467;29;19530;3;29;1020;0;456;428;28
2467;30;19493;3;30;1719;0;652;580;72
2467;31;19512;3;31;1510;0;499;452;47
2467;3;19524;3;3;2013;1;637;593;44
2467;32;19490;3;32;1277;2;517;481;36
2467;33;19505;3;33;1489;0;617;545;72
2467;34;19510;3;34;1362;0;477;435;42
2467;35;19496;3;35;1339;0;490;456;34
2467;36;19494;3;36;1462;0;529;485;44
2467;37;19497;3;37;1313;0;512;490;22
2467;38;19502;3;38;1023;0;387;363;24
2467;39;19520;3;39;1361;0;481;445;36
2467;40;19513;3;40;1185;0;374;356;18
2467;41;19504;3;41;1588;0;524;481;43
2467;4;19523;3;4;1246;0;601;539;62
2467;42;19514;3;42;2005;0;788;736;52
2467;43;19522;3;43;1463;0;528;498;30
2467;44;19495;3;44;1582;1;586;549;37
2467;45;19511;3;45;1625;0;591;545;46
2467;46;19484;3;46;1195;0;410;378;32
2467;47;19483;3;47;1062;0;394;363;31
2467;48;19500;3;48;1192;0;496;459;37
2467;49;19508;3;49;1163;0;462;436;26
2467;50;19503;3;50;60;0;12;12;0
2467;51;19492;3;51;33;0;13;11;2
2467;5;19521;3;5;1360;0;605;565;40
2467;52;19506;3;52;27;0;7;7;0
2467;6;19486;3;6;1996;0;795;716;79
2467;7;19533;3;7;1612;1;489;443;46
2467;8;19515;3;8;1717;0;984;867;117
2467;9;19488;3;9;1018;0;454;401;53
2468;10;19565;7;10;1805;0;614;558;56
2468;11;19577;7;11;1976;0;818;768;50
2468;1;19545;7;1;1347;0;625;556;69
2468;12;19564;7;12;2105;0;1002;933;69
2468;13;19562;7;13;566;0;190;178;12
2468;14;19549;7;14;2447;0;1114;1042;72
2468;15;19569;7;15;1600;0;619;573;46
2468;16;19579;7;16;1763;0;717;672;45
2468;17;19540;7;17;1514;0;624;588;36
2468;18;19558;7;18;1648;0;692;644;48
2468;19;19578;7;19;2108;1;892;813;79
2468;20;19559;7;20;2058;0;824;761;63
2468;21;19571;7;21;2057;0;781;732;49
2468;2;19566;7;2;2026;0;859;813;46
2468;22;19568;7;22;2019;0;851;782;69
2468;23;19542;7;23;2113;0;843;769;74
2468;24;19548;7;24;1790;1;651;598;53
2468;25;19536;7;25;1708;0;664;624;40
2468;26;19570;7;26;2054;0;805;764;41
2468;27;19557;7;27;1866;1;853;787;66
2468;28;19551;7;28;1932;0;819;760;59
2468;29;19554;7;29;2007;0;893;837;56
2468;30;19563;7;30;987;0;442;399;43
2468;31;19546;7;31;1642;0;497;451;46
2468;3;19539;7;3;1682;1;584;539;45
2468;32;19575;7;32;2387;0;1195;1093;102
2468;33;19556;7;33;1740;0;762;698;64
2468;34;19572;7;34;1536;0;676;626;50
2468;35;19567;7;35;1667;0;513;477;36
2468;36;19550;7;36;1506;0;501;469;32
2468;37;19543;7;37;1665;0;713;659;54
2468;38;19535;7;38;1965;0;632;583;49
2468;39;19537;7;39;1864;0;754;699;55
2468;40;19553;7;40;1965;0;904;833;71
2468;41;19541;7;41;2095;0;956;875;81
2468;4;19574;7;4;1863;0;844;783;61
2468;42;19573;7;42;1566;0;763;700;63
2468;43;19538;7;43;1613;0;713;634;79
2468;44;19555;7;44;103;0;62;41;21
2468;45;19560;7;45;141;0;58;48;10
2468;5;19547;7;5;1446;0;731;650;81
2468;6;19561;7;6;2094;0;860;780;80
2468;7;19544;7;7;2011;0;776;695;81
2468;8;19576;7;8;1816;0;668;617;51
2468;9;19552;7;9;1839;0;685;641;44
2469;100;19585;2;100;2103;0;518;494;24
2469;101;19648;2;101;1775;0;659;596;63
2469;10;19730;2;10;1810;0;783;764;19
2469;102;19663;2;102;1544;0;489;448;41
2469;103;19701;2;103;1528;0;397;353;44
2469;104;19691;2;104;2056;0;659;607;52
2469;105;19669;2;105;1985;0;717;688;29
2469;106;19708;2;106;1945;0;715;687;28
2469;107;19608;2;107;1347;0;500;467;33
2469;108;19744;2;108;2013;0;728;683;45
2469;109;19687;2;109;1993;0;747;709;38
2469;110;19656;2;110;2205;0;776;729;47
2469;111;19619;2;111;1548;0;624;590;34
2469;11;19714;2;11;2013;0;855;824;31
2469;112;19674;2;112;1989;0;704;656;48
2469;113;19713;2;113;1959;0;894;873;21
2469;114;19591;2;114;1923;0;951;932;19
2469;115;19692;2;115;2085;0;891;864;27
2469;116;19735;2;116;1829;0;676;652;24
2469;117;19665;2;117;1341;0;652;634;18
2469;118;19666;2;118;1963;0;949;918;31
2469;119;19704;2;119;2270;12;806;778;28
2469;1;19705;2;1;1665;0;816;789;27
2469;120;19728;2;120;2236;2;832;805;27
2469;121;19673;2;121;2162;1;898;873;25
2469;12;19694;2;12;1824;0;358;346;12
2469;122;19689;2;122;1909;0;631;616;15
2469;123;19609;2;123;1059;0;504;487;17
2469;124;19712;2;124;1612;0;693;671;22
2469;125;19659;2;125;1564;0;702;661;41
2469;126;19709;2;126;850;0;361;353;8
2469;127;19612;2;127;1842;1;852;823;29
2469;128;19595;2;128;1430;0;611;585;26
2469;129;19588;2;129;1721;0;767;734;33
2469;130;19646;2;130;1338;0;548;523;25
2469;131;19710;2;131;1637;0;758;734;24
2469;13;19682;2;13;2054;0;621;584;37
2469;132;19652;2;132;2039;0;719;687;32
2469;133;19693;2;133;2110;0;923;895;28
2469;134;19645;2;134;2182;0;943;904;39
2469;135;19657;2;135;2172;0;883;838;45
2469;136;19743;2;136;2081;0;932;892;40
2469;137;19620;2;137;2079;0;853;853;0
2469;138;19603;2;138;1662;0;848;814;34
2469;139;19650;2;139;2095;0;1060;1007;53
2469;140;19653;2;140;2022;0;1080;980;100
2469;141;19680;2;141;977;0;358;326;32
2469;14;19615;2;14;1710;0;479;445;34
2469;142;19618;2;142;1604;0;630;561;69
2469;143;19671;2;143;2145;0;1078;1010;68
2469;144;19610;2;144;2159;0;1154;1079;75
2469;145;19596;2;145;1636;0;748;718;30
2469;146;19643;2;146;1510;0;593;568;25
2469;147;19726;2;147;1388;0;510;482;28
2469;148;19654;2;148;79;0;38;30;8
2469;149;19724;2;149;73;0;60;54;6
2469;150;19593;2;150;31;0;16;15;1
2469;151;19600;2;151;18;0;18;16;2
2469;15;19631;2;15;1641;0;391;353;38
2469;152;19740;2;152;60;0;19;19;0
2469;153;19716;2;153;189;0;56;52;4
2469;154;19723;2;154;29;0;17;16;1
2469;155;19684;2;155;118;0;26;24;2
2469;156;19703;2;156;77;0;23;22;1
2469;157;19638;2;157;52;0;8;5;3
2469;158;19678;2;158;88;0;14;13;1
2469;159;19627;2;159;69;0;35;33;2
2469;160;19670;2;160;31;0;13;13;0
2469;161;19604;2;161;36;0;14;13;1
2469;16;19641;2;16;1477;0;525;507;18
2469;162;19707;2;162;13;0;13;13;0
2469;163;19706;2;163;71;0;48;44;4
2469;164;19614;2;164;12;0;1;1;0
2469;165;19625;2;165;85;0;41;40;1
2469;17;19699;2;17;2079;0;612;589;23
2469;18;19639;2;18;1742;0;740;707;33
2469;19;19613;2;19;1157;0;416;395;21
2469;20;19635;2;20;1571;1;541;511;30
2469;21;19679;2;21;1650;0;489;466;23
2469;2;19698;2;2;2089;0;888;857;31
2469;22;19721;2;22;1474;0;477;460;17
2469;23;19662;2;23;1987;0;695;658;37
2469;24;19664;2;24;1880;0;759;714;45
2469;25;19688;2;25;1921;0;770;745;25
2469;26;19741;2;26;1959;0;803;767;36
2469;27;19695;2;27;601;0;172;165;7
2469;28;19655;2;28;2045;0;845;805;40
2469;29;19738;2;29;1175;0;549;524;25
2469;30;19617;2;30;2041;0;941;914;27
2469;31;19606;2;31;1818;0;860;844;16
2469;3;19636;2;3;1686;0;749;705;44
2469;32;19594;2;32;2050;0;813;787;26
2469;33;19672;2;33;1530;0;492;468;24
2469;34;19592;2;34;1805;0;719;691;28
2469;35;19660;2;35;2020;0;1170;1138;32
2469;36;19739;2;36;549;0;244;232;12
2469;37;19651;2;37;1702;1;988;969;19
2469;38;19668;2;38;1641;0;794;776;18
2469;39;19711;2;39;2219;0;762;739;23
2469;40;19737;2;40;1960;0;750;736;14
2469;41;19602;2;41;1806;0;802;767;35
2469;4;19580;2;4;1665;0;651;632;19
2469;42;19717;2;42;1664;0;726;693;33
2469;43;19681;2;43;1951;0;655;627;28
2469;44;19589;2;44;1647;0;681;651;30
2469;45;19623;2;45;1691;0;708;687;21
2469;46;19697;2;46;1799;0;755;744;11
2469;47;19690;2;47;1558;0;840;819;21
2469;48;19732;2;48;1284;0;550;525;25
2469;49;19677;2;49;1355;0;658;639;19
2469;50;19644;2;50;2125;0;901;876;25
2469;51;19718;2;51;2046;0;776;744;32
2469;5;19715;2;5;1295;0;529;509;20
2469;52;19616;2;52;1249;0;385;363;22
2469;53;19586;2;53;1357;0;678;667;11
2469;54;19702;2;54;716;0;212;201;11
2469;55;19584;2;55;992;0;312;299;13
2469;56;19734;2;56;1356;0;468;450;18
2469;57;19729;2;57;1343;0;369;353;16
2469;58;19634;2;58;1749;0;621;600;21
2469;59;19626;2;59;1595;0;699;683;16
2469;60;19733;2;60;1690;0;610;585;25
2469;61;19628;2;61;2115;0;941;916;25
2469;6;19611;2;6;1630;1;671;653;18
2469;62;19720;2;62;1690;0;493;464;29
2469;63;19642;2;63;1217;0;641;628;13
2469;64;19583;2;64;1870;0;942;901;41
2469;65;19622;2;65;1679;0;574;554;20
2469;66;19722;2;66;1410;0;488;473;15
2469;67;19731;2;67;1827;0;695;659;36
2469;68;19649;2;68;1760;0;711;686;25
2469;69;19590;2;69;1814;2;978;961;17
2469;70;19624;2;70;1985;0;957;938;19
2469;71;19685;2;71;2054;0;924;902;22
2469;7;19599;2;7;1549;0;803;787;16
2469;72;19727;2;72;2069;0;831;798;33
2469;73;19621;2;73;1446;0;578;541;37
2469;74;19700;2;74;1457;7;356;337;19
2469;75;19719;2;75;2026;0;887;839;48
2469;76;19742;2;76;2130;0;725;708;17
2469;77;19675;2;77;1627;0;466;443;23
2469;78;19630;2;78;1458;0;666;641;25
2469;79;19683;2;79;1682;0;458;425;33
2469;80;19633;2;80;1922;8;769;733;36
2469;81;19607;2;81;2187;0;1029;1007;22
2469;8;19605;2;8;2158;0;967;940;27
2469;82;19658;2;82;1505;0;679;657;22
2469;83;19676;2;83;1202;0;580;563;17
2469;84;19597;2;84;1569;0;316;304;12
2469;85;19667;2;85;2064;1;814;779;35
2469;86;19582;2;86;1598;1;461;434;27
2469;87;19601;2;87;1337;0;580;544;36
2469;88;19647;2;88;1245;0;550;521;29
2469;89;19587;2;89;2151;0;770;729;41
2469;90;19661;2;90;1156;0;342;324;18
2469;91;19581;2;91;1031;0;376;337;39
2469;9;19736;2;9;1688;0;703;672;31
2469;92;19632;2;92;1505;1;423;406;17
2469;93;19696;2;93;1639;0;561;541;20
2469;94;19640;2;94;1089;0;214;202;12
2469;95;19629;2;95;1328;0;271;251;20
2469;96;19637;2;96;1704;0;581;551;30
2469;97;19725;2;97;2091;0;526;490;36
2469;98;19598;2;98;1451;0;331;321;10
2469;99;19686;2;99;1745;0;348;324;24
2470;10;19755;2;10;1939;0;1024;956;68
2470;11;19747;2;11;1516;0;799;749;50
2470;1;19772;2;1;1629;0;618;558;60
2470;12;19771;2;12;2041;0;1187;1098;89
2470;13;19765;2;13;2188;0;1119;1050;69
2470;14;19783;2;14;1496;0;677;605;72
2470;15;19748;2;15;1218;0;634;590;44
2470;16;19756;2;16;1487;0;709;675;34
2470;17;19757;2;17;955;0;582;548;34
2470;18;19776;2;18;1482;0;766;710;56
2470;19;19763;2;19;1850;0;907;841;66
2470;20;19760;2;20;2017;0;799;728;71
2470;21;19784;2;21;592;0;276;256;20
2470;2;19749;2;2;1474;0;581;526;55
2470;22;19753;2;22;923;0;541;512;29
2470;23;19781;2;23;1799;0;963;888;75
2470;24;19746;2;24;1714;0;979;893;86
2470;25;19768;2;25;1553;0;773;715;58
2470;26;19751;2;26;1949;0;1076;981;95
2470;27;19782;2;27;2302;0;1286;1205;81
2470;28;19745;2;28;1772;0;856;796;60
2470;29;19750;2;29;2116;0;1233;1170;63
2470;30;19770;2;30;1397;2;827;788;39
2470;31;19786;2;31;1431;2;855;810;45
2470;3;19764;2;3;1689;1;645;598;47
2470;32;19767;2;32;1106;1;658;623;35
2470;33;19773;2;33;824;0;468;429;39
2470;34;19766;2;34;1972;0;1221;1153;68
2470;35;19777;2;35;2384;0;1082;999;83
2470;36;19754;2;36;468;0;294;271;23
2470;37;19778;2;37;1121;0;466;413;53
2470;38;19775;2;38;1057;0;459;421;38
2470;39;19758;2;39;1250;2;768;700;68
2470;40;19769;2;40;31;0;18;16;2
2470;41;19762;2;41;58;0;44;42;2
2470;4;19759;2;4;1347;0;606;551;55
2470;42;19779;2;42;40;0;8;7;1
2470;5;19780;2;5;1508;1;702;642;60
2470;6;19752;2;6;2104;0;946;900;46
2470;7;19761;2;7;1998;1;1023;960;63
2470;8;19774;2;8;1626;0;647;576;71
2470;9;19785;2;9;934;0;315;286;29
2471;10;19803;5;10;1627;0;597;552;45
2471;11;19809;5;11;1929;0;839;763;76
2471;1;19806;5;1;1387;0;581;524;57
2471;12;19796;5;12;1974;0;837;782;55
2471;13;19818;5;13;2046;0;874;799;75
2471;14;19816;5;14;50;0;31;19;12
2471;15;19802;5;15;2049;0;1079;999;80
2471;16;19810;5;16;2021;1;843;753;90
2471;17;19795;5;17;17;0;15;14;1
2471;18;19805;5;18;1669;1;598;540;58
2471;19;19804;5;19;72;0;31;23;8
2471;20;19798;5;20;1324;0;390;369;21
2471;21;19791;5;21;1521;0;620;567;53
2471;2;19792;5;2;1079;0;560;508;52
2471;22;19790;5;22;1570;1;710;645;65
2471;23;19788;5;23;1602;0;699;599;100
2471;24;19797;5;24;1249;0;592;528;64
2471;25;19787;5;25;1341;0;571;484;87
2471;26;19811;5;26;1691;0;762;697;65
2471;27;19813;5;27;1829;0;792;700;92
2471;28;19793;5;28;2021;1;816;691;125
2471;29;19817;5;29;1687;0;681;595;86
2471;30;19812;5;30;97;0;65;56;9
2471;31;19815;5;31;1464;1;826;808;18
2471;3;19801;5;3;1925;0;629;549;80
2471;32;19800;5;32;1903;1;1097;978;119
2471;4;19808;5;4;2262;1;959;875;84
2471;5;19789;5;5;2040;0;842;767;75
2471;6;19799;5;6;1367;0;487;445;42
2471;7;19814;5;7;1355;0;547;510;37
2471;8;19794;5;8;1618;0;798;740;58
2471;9;19807;5;9;1600;0;672;614;58
2472;10;19831;5;10;802;0;335;308;27
2472;11;19893;5;11;1915;0;819;752;67
2472;1;19828;5;1;1537;0;392;348;44
2472;12;19885;5;12;1859;0;689;637;52
2472;13;19830;5;13;1087;0;509;474;35
2472;14;19888;5;14;1335;0;583;546;37
2472;15;19868;5;15;1939;0;489;458;31
2472;16;19876;5;16;1575;0;544;504;40
2472;17;19853;5;17;1767;0;808;760;48
2472;18;19861;5;18;1353;0;581;533;48
2472;19;19896;5;19;1123;0;560;529;31
2472;20;19863;5;20;1655;0;649;589;60
2472;21;19892;5;21;1756;0;745;691;54
2472;2;19877;5;2;1218;0;298;278;20
2472;22;19855;5;22;1929;1;843;766;77
2472;23;19856;5;23;1535;0;556;512;44
2472;24;19870;5;24;1358;0;558;517;41
2472;25;19835;5;25;790;0;222;207;15
2472;26;19886;5;26;2048;0;617;552;65
2472;27;19819;5;27;1970;0;646;574;72
2472;28;19875;5;28;1362;1;510;481;29
2472;29;19873;5;29;1892;1;771;708;63
2472;30;19846;5;30;1072;0;539;507;32
2472;31;19824;5;31;1124;0;518;473;45
2472;3;19838;5;3;1246;0;523;468;55
2472;32;19872;5;32;1974;0;698;647;51
2472;33;19895;5;33;1278;0;482;457;25
2472;34;19851;5;34;1427;0;478;439;39
2472;35;19852;5;35;623;0;224;206;18
2472;36;19837;5;36;1603;0;568;533;35
2472;37;19850;5;37;1595;0;579;542;37
2472;38;19845;5;38;1586;0;492;463;29
2472;39;19829;5;39;1726;0;810;762;48
2472;40;19897;5;40;1159;0;319;300;19
2472;41;19858;5;41;1282;0;419;390;29
2472;4;19865;5;4;1236;0;453;403;50
2472;42;19890;5;42;912;0;182;162;20
2472;43;19834;5;43;1059;0;501;473;28
2472;44;19898;5;44;1439;0;479;442;37
2472;45;19879;5;45;1931;1;741;700;41
2472;46;19848;5;46;1666;0;611;583;28
2472;47;19859;5;47;1651;0;505;492;13
2472;48;19854;5;48;1366;0;458;430;28
2472;49;19832;5;49;1558;0;630;593;37
2472;50;19844;5;50;1438;0;555;521;34
2472;51;19820;5;51;2212;1;866;793;73
2472;5;19827;5;5;1133;0;399;374;25
2472;52;19860;5;52;1600;3;540;481;59
2472;53;19894;5;53;1140;0;436;395;41
2472;54;19891;5;54;1736;0;689;648;41
2472;55;19849;5;55;1650;0;672;631;41
2472;56;19857;5;56;1674;0;692;655;37
2472;57;19878;5;57;1654;0;669;630;39
2472;58;19822;5;58;2127;0;687;646;41
2472;59;19867;5;59;2023;1;813;792;21
2472;60;19847;5;60;1115;0;507;484;23
2472;61;19882;5;61;1488;0;560;514;46
2472;6;19880;5;6;1152;0;413;394;19
2472;62;19821;5;62;1548;1;577;543;34
2472;63;19866;5;63;1985;0;634;601;33
2472;64;19836;5;64;2247;0;1086;1022;64
2472;65;19842;5;65;1999;0;876;821;55
2472;66;19869;5;66;1739;0;649;616;33
2472;67;19871;5;67;1085;0;483;457;26
2472;68;19839;5;68;1055;0;451;414;37
2472;69;19883;5;69;1638;0;861;783;78
2472;70;19840;5;70;2031;0;892;817;75
2472;71;19889;5;71;1880;0;800;739;61
2472;7;19884;5;7;1566;0;430;391;39
2472;72;19841;5;72;1984;0;755;683;72
2472;73;19843;5;73;2040;0;848;769;79
2472;74;19833;5;74;1550;0;653;603;50
2472;75;19881;5;75;1726;0;755;697;58
2472;76;19862;5;76;81;0;48;41;7
2472;77;19825;5;77;103;0;56;46;10
2472;78;19887;5;78;40;0;22;19;3
2472;79;19823;5;79;133;0;61;40;21
2472;80;19874;5;80;74;0;64;57;7
2472;8;19864;5;8;665;0;268;247;21
2472;9;19826;5;9;1645;0;681;635;46
2473;10;19900;3;10;1944;0;862;831;31
2473;11;19933;3;11;2172;0;853;810;43
2473;1;19950;3;1;1784;0;721;690;31
2473;12;19914;3;12;1542;0;543;506;37
2473;13;19915;3;13;1405;0;576;543;33
2473;14;19912;3;14;1603;1;680;661;19
2473;15;19931;3;15;1691;0;637;593;44
2473;16;19941;3;16;1750;0;648;624;24
2473;17;19949;3;17;1878;0;707;668;39
2473;18;19951;3;18;2333;1;1056;1005;51
2473;19;19970;3;19;2343;0;773;721;52
2473;20;19924;3;20;1197;0;621;558;63
2473;21;19958;3;21;1279;0;532;483;49
2473;2;19961;3;2;1934;0;783;753;30
2473;22;19906;3;22;2170;2;987;954;33
2473;23;19947;3;23;2363;0;1227;1184;43
2473;24;19901;3;24;1463;0;591;552;39
2473;25;19937;3;25;860;0;356;328;28
2473;26;19956;3;26;1397;0;513;487;26
2473;27;19960;3;27;2097;0;968;879;89
2473;28;19934;3;28;1320;0;583;538;45
2473;29;19965;3;29;1493;0;651;609;42
2473;30;19918;3;30;1382;0;572;534;38
2473;31;19938;3;31;1394;0;702;662;40
2473;3;19917;3;3;1002;2;450;419;31
2473;32;19899;3;32;1300;0;578;542;36
2473;33;19963;3;33;1936;0;676;624;52
2473;34;19952;3;34;1917;1;809;748;61
2473;35;19944;3;35;1123;0;568;522;46
2473;36;19971;3;36;1949;0;658;629;29
2473;37;19926;3;37;1598;0;527;479;48
2473;38;19953;3;38;1091;0;388;357;31
2473;39;19923;3;39;1143;0;410;373;37
2473;40;19943;3;40;1406;0;273;243;30
2473;41;19909;3;41;1483;0;334;290;44
2473;4;19913;3;4;2071;0;769;716;53
2473;42;19922;3;42;1617;0;407;374;33
2473;43;19945;3;43;1127;0;266;239;27
2473;44;19907;3;44;1074;0;299;270;29
2473;45;19957;3;45;1689;0;670;632;38
2473;46;19929;3;46;1772;0;708;674;34
2473;47;19967;3;47;1892;0;646;589;57
2473;48;19905;3;48;1219;0;386;359;27
2473;49;19908;3;49;2110;0;905;905;0
2473;50;19916;3;50;1283;1;511;487;24
2473;51;19925;3;51;1541;0;668;612;56
2473;5;19935;3;5;1548;0;629;612;17
2473;52;19911;3;52;1215;0;377;355;22
2473;53;19954;3;53;1387;0;401;378;23
2473;54;19962;3;54;1102;0;474;441;33
2473;55;19968;3;55;902;0;294;278;16
2473;56;19939;3;56;1877;0;520;492;28
2473;57;19964;3;57;1902;0;857;808;49
2473;58;19920;3;58;1526;0;516;477;39
2473;59;19959;3;59;2296;0;751;709;42
2473;60;19955;3;60;2081;0;723;662;61
2473;61;19902;3;61;1247;0;538;490;48
2473;6;19932;3;6;1849;0;768;718;50
2473;62;19928;3;62;1522;0;674;634;40
2473;63;19966;3;63;1623;0;622;574;48
2473;64;19946;3;64;1392;0;477;442;35
2473;65;19919;3;65;1603;0;746;676;70
2473;66;19930;3;66;2356;0;1043;951;92
2473;67;19948;3;67;507;0;205;186;19
2473;68;19904;3;68;1451;0;736;675;61
2473;69;19927;3;69;1359;0;601;551;50
2473;70;19903;3;70;1300;0;460;436;24
2473;71;19910;3;71;111;0;23;19;4
2473;7;19942;3;7;2316;0;1013;963;50
2473;72;19921;3;72;141;0;57;37;20
2473;73;19936;3;73;119;0;35;33;2
2473;8;19969;3;8;1696;0;814;788;26
2473;9;19940;3;9;1426;1;712;664;48
2474;10;19994;5;10;2206;0;736;657;79
2474;11;19982;5;11;1818;0;586;524;62
2474;1;19973;5;1;1082;0;227;203;24
2474;12;20001;5;12;1222;0;632;582;50
2474;13;19977;5;13;1586;0;606;541;65
2474;14;20005;5;14;1596;0;675;638;37
2474;15;19981;5;15;2433;0;1009;972;37
2474;16;19985;5;16;1870;0;896;842;54
2474;17;20010;5;17;1595;0;679;635;44
2474;18;20011;5;18;1981;0;799;759;40
2474;19;20007;5;19;1549;0;640;640;0
2474;20;19988;5;20;1190;0;564;514;50
2474;21;19986;5;21;1460;1;617;589;28
2474;2;19987;5;2;1112;0;390;359;31
2474;22;19995;5;22;1638;0;673;645;28
2474;23;20008;5;23;1152;0;503;475;28
2474;24;20002;5;24;1224;0;522;489;33
2474;25;20006;5;25;1384;0;794;741;53
2474;26;19991;5;26;1368;0;441;410;31
2474;27;19979;5;27;1742;1;640;601;39
2474;28;19984;5;28;1723;0;607;540;67
2474;29;19999;5;29;403;0;176;166;10
2474;30;19992;5;30;1365;0;479;432;47
2474;31;20009;5;31;1002;0;332;311;21
2474;3;19975;5;3;1429;0;466;424;42
2474;32;19989;5;32;812;0;350;325;25
2474;33;20000;5;33;1626;0;662;618;44
2474;34;19974;5;34;1880;0;753;707;46
2474;35;19983;5;35;1901;0;854;785;69
2474;36;19996;5;36;1926;0;735;679;56
2474;37;19978;5;37;1444;0;533;481;52
2474;38;19976;5;38;717;1;226;212;14
2474;39;19997;5;39;1239;0;304;276;28
2474;40;19980;5;40;2031;0;913;855;58
2474;4;19993;5;4;1611;0;485;444;41
2474;5;19990;5;5;1461;0;459;409;50
2474;6;20003;5;6;1379;0;468;428;40
2474;7;19998;5;7;20;0;6;6;0
2474;8;19972;5;8;71;0;41;38;3
2474;9;20004;5;9;2175;0;643;572;71
2475;100;20058;7;100;1248;0;406;380;26
2475;101;20027;7;101;1207;0;391;372;19
2475;10;20053;7;10;1284;0;215;199;16
2475;102;20086;7;102;1427;0;564;526;38
2475;103;20072;7;103;1514;0;581;557;24
2475;104;20111;7;104;1311;0;582;556;26
2475;105;20060;7;105;873;0;420;391;29
2475;106;20012;7;106;1471;0;430;411;19
2475;107;20112;7;107;1631;0;489;465;24
2475;108;20077;7;108;1410;0;510;485;25
2475;109;20094;7;109;1360;0;479;457;22
2475;110;20083;7;110;676;1;185;176;9
2475;111;20088;7;111;197;0;18;16;2
2475;11;20105;7;11;1560;0;603;585;18
2475;112;20062;7;112;64;0;27;24;3
2475;113;20050;7;113;225;0;31;26;5
2475;114;20048;7;114;176;0;34;30;4
2475;115;20109;7;115;39;0;10;5;5
2475;116;20120;7;116;96;0;39;32;7
2475;117;20085;7;117;70;0;39;39;0
2475;118;20074;7;118;82;0;62;59;3
2475;1;20061;7;1;1200;1;446;429;17
2475;12;20099;7;12;1546;0;524;505;19
2475;13;20035;7;13;1372;0;492;476;16
2475;14;20032;7;14;2214;0;752;721;31
2475;15;20018;7;15;1645;0;503;485;18
2475;16;20116;7;16;2283;0;925;893;32
2475;17;20118;7;17;1975;0;839;797;42
2475;18;20124;7;18;1736;1;666;648;18
2475;19;20022;7;19;2357;1;976;937;39
2475;20;20090;7;20;1864;0;647;620;27
2475;21;20013;7;21;2177;0;733;705;28
2475;2;20075;7;2;1753;0;590;562;28
2475;22;20069;7;22;2223;0;728;708;20
2475;23;20021;7;23;965;0;273;259;14
2475;24;20084;7;24;1830;2;641;604;37
2475;25;20071;7;25;1205;1;372;356;16
2475;26;20092;7;26;1942;0;585;557;28
2475;27;20073;7;27;1871;0;552;515;37
2475;28;20082;7;28;1683;0;566;533;33
2475;29;20042;7;29;2075;0;841;801;40
2475;30;20020;7;30;1715;0;627;606;21
2475;31;20081;7;31;1562;0;573;558;15
2475;3;20040;7;3;1297;0;489;465;24
2475;32;20078;7;32;1640;0;575;550;25
2475;33;20051;7;33;1766;0;627;599;28
2475;34;20114;7;34;1445;1;513;480;33
2475;35;20029;7;35;1459;0;560;533;27
2475;36;20128;7;36;1138;0;392;376;16
2475;37;20054;7;37;1182;0;348;333;15
2475;38;20117;7;38;1537;0;512;473;39
2475;39;20079;7;39;1160;0;195;178;17
2475;40;20100;7;40;1959;0;682;626;56
2475;41;20045;7;41;1173;0;249;234;15
2475;4;20034;7;4;929;0;202;190;12
2475;42;20063;7;42;1438;0;576;561;15
2475;43;20066;7;43;2142;0;862;835;27
2475;44;20019;7;44;1403;0;557;532;25
2475;45;20041;7;45;1964;0;724;697;27
2475;46;20049;7;46;1624;0;640;616;24
2475;47;20067;7;47;2055;2;701;668;33
2475;48;20087;7;48;2205;0;813;775;38
2475;49;20096;7;49;1721;0;538;518;20
2475;50;20056;7;50;1581;1;530;509;21
2475;51;20080;7;51;2034;0;725;700;25
2475;5;20119;7;5;1114;0;468;453;15
2475;52;20107;7;52;1309;0;453;440;13
2475;53;20091;7;53;2416;0;919;875;44
2475;54;20043;7;54;1289;0;543;522;21
2475;55;20121;7;55;1805;0;465;449;16
2475;56;20065;7;56;1016;0;302;289;13
2475;57;20097;7;57;1111;0;313;298;15
2475;58;20095;7;58;2192;0;650;608;42
2475;59;20089;7;59;2111;0;690;663;27
2475;60;20023;7;60;2149;0;592;569;23
2475;61;20037;7;61;826;0;269;245;24
2475;6;20108;7;6;1935;0;549;526;23
2475;62;20044;7;62;2397;0;827;783;44
2475;63;20052;7;63;2150;0;760;719;41
2475;64;20101;7;64;2112;0;763;717;46
2475;65;20016;7;65;1901;0;652;612;40
2475;66;20036;7;66;1050;0;381;359;22
2475;67;20129;7;67;445;0;130;121;9
2475;68;20068;7;68;1086;0;309;290;19
2475;69;20030;7;69;1655;0;536;498;38
2475;70;20093;7;70;1872;0;558;529;29
2475;71;20057;7;71;1838;0;630;593;37
2475;7;20026;7;7;898;0;238;230;8
2475;72;20102;7;72;2175;0;792;746;46
2475;73;20126;7;73;2094;0;672;630;42
2475;74;20017;7;74;2114;0;561;540;21
2475;75;20123;7;75;1763;0;390;363;27
2475;76;20070;7;76;1717;0;538;511;27
2475;77;20039;7;77;1314;0;436;409;27
2475;78;20113;7;78;1950;0;605;584;21
2475;79;20047;7;79;1872;0;646;622;24
2475;80;20025;7;80;1836;0;675;651;24
2475;81;20064;7;81;1922;0;611;584;27
2475;8;20038;7;8;1315;0;553;542;11
2475;82;20028;7;82;1932;0;688;662;26
2475;83;20103;7;83;1155;0;347;338;9
2475;84;20104;7;84;1518;0;438;432;6
2475;85;20125;7;85;1803;0;572;553;19
2475;86;20015;7;86;1994;0;637;615;22
2475;87;20024;7;87;1952;0;695;670;25
2475;88;20033;7;88;2393;0;740;708;32
2475;89;20059;7;89;1726;0;540;518;22
2475;90;20098;7;90;919;0;253;244;9
2475;91;20127;7;91;1825;0;526;500;26
2475;9;20046;7;9;929;0;193;181;12
2475;92;20076;7;92;1907;0;585;553;32
2475;93;20106;7;93;2422;0;737;675;62
2475;94;20122;7;94;988;1;264;264;0
2475;95;20115;7;95;760;0;219;204;15
2475;96;20031;7;96;2284;0;706;640;66
2475;97;20110;7;97;2001;0;613;557;56
2475;98;20014;7;98;2086;0;647;611;36
2475;99;20055;7;99;1961;0;607;572;35
2476;10;20145;5;10;2126;0;985;924;61
2476;11;20153;5;11;1960;0;941;874;67
2476;1;20130;5;1;2080;0;902;803;99
2476;12;20135;5;12;2092;0;1055;1006;49
2476;13;20150;5;13;1254;0;302;282;20
2476;14;20148;5;14;2047;0;1058;975;83
2476;15;20131;5;15;2121;0;818;734;84
2476;16;20154;5;16;1505;0;362;327;35
2476;17;20143;5;17;931;0;280;259;21
2476;18;20142;5;18;1587;0;740;691;49
2476;19;20147;5;19;1529;0;694;637;57
2476;20;20136;5;20;1321;0;351;322;29
2476;21;20141;5;21;1441;0;479;442;37
2476;2;20144;5;2;2026;0;435;435;0
2476;22;20138;5;22;1446;0;703;645;58
2476;23;20152;5;23;1948;0;798;744;54
2476;24;20146;5;24;2279;0;1038;989;49
2476;25;20139;5;25;1159;0;485;456;29
2476;26;20151;5;26;58;0;46;38;8
2476;27;20156;5;27;62;0;12;12;0
2476;3;20149;5;3;1885;0;779;728;51
2476;4;20133;5;4;2062;0;853;798;55
2476;5;20134;5;5;1628;1;699;634;65
2476;6;20132;5;6;1257;0;685;640;45
2476;7;20140;5;7;1521;0;472;398;74
2476;8;20137;5;8;1664;0;538;436;102
2476;9;20155;5;9;1980;0;667;539;128
2477;10;20172;2;10;1816;0;656;596;60
2477;11;20207;2;11;2150;1;860;801;59
2477;1;20183;2;1;2013;2;1127;1063;64
2477;12;20177;2;12;1486;0;640;601;39
2477;13;20178;2;13;2201;0;701;612;89
2477;14;20158;2;14;894;0;506;480;26
2477;15;20192;2;15;1308;0;674;596;78
2477;16;20193;2;16;1397;0;664;570;94
2477;17;20159;2;17;1726;0;678;635;43
2477;18;20216;2;18;1927;1;790;739;51
2477;19;20188;2;19;2006;0;802;732;70
2477;20;20173;2;20;1264;0;454;426;28
2477;21;20189;2;21;1814;1;710;644;66
2477;2;20215;2;2;1268;0;635;606;29
2477;22;20163;2;22;1765;0;685;625;60
2477;23;20175;2;23;2148;1;917;872;45
2477;24;20204;2;24;1256;0;515;482;33
2477;25;20176;2;25;1441;0;576;544;32
2477;26;20203;2;26;1933;0;930;855;75
2477;27;20213;2;27;1048;0;487;438;49
2477;28;20165;2;28;1377;0;506;463;43
2477;29;20170;2;29;1121;0;504;468;36
2477;30;20167;2;30;1791;0;742;695;47
2477;31;20184;2;31;1658;0;673;637;36
2477;3;20206;2;3;1613;0;741;701;40
2477;32;20223;2;32;1528;0;684;627;57
2477;33;20171;2;33;1467;0;653;577;76
2477;34;20201;2;34;1559;0;769;707;62
2477;35;20222;2;35;1987;0;886;815;71
2477;36;20164;2;36;1506;0;688;635;53
2477;37;20180;2;37;1607;0;805;746;59
2477;38;20157;2;38;1616;0;787;732;55
2477;39;20199;2;39;1551;0;710;679;31
2477;40;20209;2;40;1090;0;454;408;46
2477;41;20191;2;41;1667;0;679;623;56
2477;4;20200;2;4;1805;0;811;751;60
2477;42;20195;2;42;1378;1;600;567;33
2477;43;20202;2;43;1179;0;441;386;55
2477;44;20217;2;44;1106;0;415;392;23
2477;45;20211;2;45;1904;2;773;739;34
2477;46;20186;2;46;1701;0;764;710;54
2477;47;20197;2;47;1865;0;776;711;65
2477;48;20185;2;48;1948;0;788;737;51
2477;49;20196;2;49;2017;0;1009;898;111
2477;50;20221;2;50;1659;0;738;683;55
2477;51;20205;2;51;1715;0;735;684;51
2477;5;20187;2;5;1827;0;953;891;62
2477;52;20218;2;52;1421;0;683;639;44
2477;53;20210;2;53;1570;0;674;625;49
2477;54;20160;2;54;1873;1;820;731;89
2477;55;20212;2;55;1804;0;809;773;36
2477;56;20198;2;56;1406;0;747;700;47
2477;57;20214;2;57;2031;1;820;737;83
2477;58;20161;2;58;2033;0;803;755;48
2477;59;20169;2;59;2296;0;1093;1000;93
2477;60;20174;2;60;2037;0;795;710;85
2477;61;20208;2;61;1473;1;599;559;40
2477;6;20219;2;6;1019;0;328;297;31
2477;62;20181;2;62;2091;0;871;809;62
2477;63;20220;2;63;1947;0;780;695;85
2477;64;20182;2;64;1395;0;495;451;44
2477;65;20168;2;65;24;0;13;12;1
2477;66;20179;2;66;196;0;58;50;8
2477;67;20166;2;67;45;0;17;12;5
2477;7;20190;2;7;2125;0;752;695;57
2477;8;20194;2;8;1090;0;416;378;38
2477;9;20162;2;9;1777;1;698;579;119
2478;10;20275;5;10;1967;0;576;576;0
2478;11;20288;5;11;2375;0;587;477;110
2478;1;20296;5;1;1602;0;456;416;40
2478;12;20304;5;12;1701;0;647;566;81
2478;13;20263;5;13;2476;0;730;653;77
2478;14;20273;5;14;2120;0;357;357;0
2478;15;20306;5;15;1715;0;370;328;42
2478;16;20307;5;16;1626;0;381;333;48
2478;17;20313;5;17;2295;0;544;488;56
2478;18;20314;5;18;1663;0;589;540;49
2478;19;20257;5;19;2177;0;972;850;122
2478;20;20311;5;20;2067;0;799;710;89
2478;21;20227;5;21;955;1;391;357;34
2478;2;20280;5;2;1925;0;525;426;99
2478;22;20267;5;22;2017;0;701;628;73
2478;23;20247;5;23;1754;0;650;606;44
2478;24;20260;5;24;1910;0;771;701;70
2478;25;20271;5;25;1664;0;663;607;56
2478;26;20292;5;26;2151;0;583;527;56
2478;27;20277;5;27;1492;0;552;505;47
2478;28;20264;5;28;1859;0;740;704;36
2478;29;20248;5;29;1388;0;618;565;53
2478;30;20266;5;30;2159;0;691;627;64
2478;31;20312;5;31;1073;0;474;410;64
2478;3;20293;5;3;1865;0;536;490;46
2478;32;20239;5;32;2219;0;818;756;62
2478;33;20284;5;33;2137;0;912;833;79
2478;34;20230;5;34;2228;0;565;507;58
2478;35;20238;5;35;2021;0;541;487;54
2478;36;20270;5;36;2005;0;563;524;39
2478;37;20301;5;37;2046;0;504;432;72
2478;38;20229;5;38;2119;1;776;722;54
2478;39;20290;5;39;1300;0;239;221;18
2478;40;20235;5;40;1956;1;475;405;70
2478;41;20269;5;41;1700;0;465;403;62
2478;4;20308;5;4;1777;0;636;592;44
2478;42;20276;5;42;1659;0;405;368;37
2478;43;20232;5;43;2013;0;324;263;61
2478;44;20231;5;44;2199;0;861;799;62
2478;45;20242;5;45;2129;0;735;653;82
2478;46;20299;5;46;2107;0;452;410;42
2478;47;20261;5;47;1882;0;530;476;54
2478;48;20246;5;48;1716;1;726;683;43
2478;49;20244;5;49;1601;1;665;619;46
2478;50;20283;5;50;2035;0;656;608;48
2478;51;20228;5;51;2277;0;761;697;64
2478;5;20243;5;5;1448;0;437;399;38
2478;52;20253;5;52;1958;0;762;683;79
2478;53;20294;5;53;1719;0;483;433;50
2478;54;20255;5;54;1554;0;435;380;55
2478;55;20285;5;55;1548;0;373;346;27
2478;56;20291;5;56;2126;0;736;663;73
2478;57;20245;5;57;2182;0;965;877;88
2478;58;20225;5;58;2294;1;944;862;82
2478;59;20240;5;59;2034;1;683;614;69
2478;60;20302;5;60;2130;0;850;774;76
2478;61;20281;5;61;2195;0;687;612;75
2478;6;20224;5;6;2182;0;634;584;50
2478;62;20297;5;62;1915;0;557;504;53
2478;63;20241;5;63;2282;2;746;657;89
2478;64;20256;5;64;2145;0;695;632;63
2478;65;20236;5;65;1990;0;649;613;36
2478;66;20303;5;66;1974;0;739;676;63
2478;67;20234;5;67;1859;0;719;649;70
2478;68;20237;5;68;2270;0;568;513;55
2478;69;20310;5;69;1499;0;351;316;35
2478;70;20226;5;70;2022;0;704;638;66
2478;71;20250;5;71;1807;0;660;605;55
2478;7;20274;5;7;1957;0;494;445;49
2478;72;20251;5;72;1607;0;529;450;79
2478;73;20268;5;73;1897;0;724;643;81
2478;74;20287;5;74;1798;0;792;702;90
2478;75;20233;5;75;876;0;435;400;35
2478;76;20249;5;76;953;0;455;408;47
2478;77;20278;5;77;1799;0;704;632;72
2478;78;20298;5;78;96;0;55;49;6
2478;79;20279;5;79;57;0;31;30;1
2478;80;20265;5;80;47;0;26;21;5
2478;81;20295;5;81;69;0;49;39;10
2478;8;20259;5;8;1703;0;535;486;49
2478;82;20282;5;82;48;0;19;16;3
2478;83;20300;5;83;38;0;19;17;2
2478;84;20254;5;84;126;0;57;51;6
2478;85;20258;5;85;4;0;4;3;1
2478;86;20305;5;86;74;0;25;22;3
2478;87;20289;5;87;24;0;4;4;0
2478;88;20309;5;88;17;0;1;1;0
2478;89;20252;5;89;29;0;6;4;2
2478;90;20286;5;90;42;0;13;9;4
2478;91;20262;5;91;8;0;7;2;5
2478;9;20272;5;9;2191;0;553;493;60
2479;10;20344;3;10;2073;0;789;750;39
2479;11;20322;3;11;1918;0;648;602;46
2479;1;20347;3;1;1066;0;442;420;22
2479;12;20341;3;12;1069;0;415;384;31
2479;13;20345;3;13;1005;0;372;344;28
2479;14;20326;3;14;1884;0;733;685;48
2479;15;20323;3;15;1994;0;790;742;48
2479;16;20324;3;16;1557;0;565;522;43
2479;17;20333;3;17;1636;0;609;561;48
2479;18;20343;3;18;1607;0;568;515;53
2479;19;20318;3;19;1857;0;635;569;66
2479;20;20325;3;20;1809;0;623;576;47
2479;21;20331;3;21;1572;0;515;454;61
2479;2;20321;3;2;1033;0;525;503;22
2479;22;20330;3;22;1599;0;829;755;74
2479;23;20315;3;23;2254;0;1078;949;129
2479;24;20332;3;24;1042;0;364;314;50
2479;25;20342;3;25;1751;0;638;580;58
2479;26;20329;3;26;2101;0;714;657;57
2479;27;20339;3;27;2138;0;728;660;68
2479;28;20319;3;28;1988;0;632;576;56
2479;29;20337;3;29;903;0;501;456;45
2479;30;20327;3;30;1287;0;583;549;34
2479;31;20334;3;31;1312;0;714;661;53
2479;3;20335;3;3;1841;1;743;689;54
2479;32;20336;3;32;52;0;22;17;5
2479;33;20340;3;33;24;0;19;18;1
2479;4;20317;3;4;950;0;343;323;20
2479;5;20328;3;5;1155;0;651;609;42
2479;6;20338;3;6;1591;0;766;719;47
2479;7;20346;3;7;1867;0;889;842;47
2479;8;20320;3;8;1597;0;624;624;0
2479;9;20316;3;9;1287;2;603;603;0
2601;10;20360;4;10;882;1;496;471;25
2601;11;20364;4;11;862;0;429;403;26
2601;1;20349;4;1;1634;5;1098;1045;53
2601;1;20361;4;1;1283;1;788;719;69
2601;1;20373;4;1;443;0;347;278;69
2601;1;20379;4;1;563;0;309;266;43
2601;1;20386;4;1;1022;0;691;597;94
2601;1;20392;4;1;1185;0;600;559;41
2601;1;20398;4;1;1972;5;1335;1148;187
2601;1;20406;4;1;1900;1;1058;921;137
2601;12;20397;4;12;1320;0;696;652;44
2601;13;20415;4;13;900;2;534;502;32
2601;14;20355;4;14;1037;0;555;514;41
2601;15;20370;4;15;608;0;361;320;41
2601;16;20393;4;16;665;0;401;359;42
2601;17;20405;4;17;647;1;393;370;23
2601;18;20416;4;18;952;0;508;468;40
2601;19;20385;4;19;1127;0;584;532;52
2601;20;20371;4;20;1230;1;720;683;37
2601;21;20394;4;21;568;0;286;271;15
2601;2;20354;4;2;708;0;415;351;64
2601;2;20362;4;2;764;0;403;334;69
2601;2;20366;4;2;1038;1;550;504;46
2601;2;20369;4;2;1164;1;774;646;128
2601;2;20377;4;2;2216;3;1435;1231;204
2601;2;20396;4;2;1075;0;496;417;79
2601;2;20399;4;2;1534;1;934;934;0
2601;2;20400;4;2;428;0;297;265;32
2601;22;20363;4;22;1038;0;599;559;40
2601;23;20391;4;23;816;1;498;443;55
2601;24;20412;4;24;795;0;516;456;60
2601;25;20359;4;25;427;0;260;242;18
2601;26;20365;4;26;817;0;431;397;34
2601;27;20411;4;27;653;0;395;343;52
2601;28;20414;4;28;566;0;355;322;33
2601;29;20384;4;29;685;0;343;308;35
2601;30;20376;4;30;1184;2;677;632;45
2601;31;20389;4;31;42;0;13;9;4
2601;3;20348;4;3;740;0;463;435;28
2601;3;20350;4;3;1035;0;534;452;82
2601;3;20381;4;3;1645;4;1107;960;147
2601;3;20383;4;3;1294;0;690;594;96
2601;3;20401;4;3;855;3;487;455;32
2601;3;20402;4;3;1089;2;751;667;84
2601;3;20408;4;3;1653;2;1014;918;96
2601;3;20410;4;3;704;0;464;371;93
2601;32;20378;4;32;3;0;2;2;0
2601;33;20356;4;33;2;0;1;1;0
2601;4;20352;4;4;741;0;487;446;41
2601;4;20357;4;4;816;0;626;557;69
2601;4;20358;4;4;1365;3;897;812;85
2601;4;20372;4;4;787;0;401;352;49
2601;4;20380;4;4;619;0;411;390;21
2601;4;20395;4;4;710;2;371;371;0
2601;4;20404;4;4;881;0;467;436;31
2601;5;20353;4;5;1106;0;564;514;50
2601;5;20368;4;5;1194;7;740;705;35
2601;5;20375;4;5;753;9;388;359;29
2601;5;20387;4;5;1270;1;713;671;42
2601;5;20388;4;5;76;0;23;20;3
2601;5;20409;4;5;498;0;251;223;28
2601;6;20374;4;6;1008;0;492;461;31
2601;6;20390;4;6;513;0;284;220;64
2601;6;20417;4;6;46;0;20;13;7
2601;7;20351;4;7;1000;0;564;497;67
2601;7;20382;4;7;27;0;25;25;0
2601;7;20403;4;7;75;0;44;43;1
2601;8;20407;4;8;42;0;26;16;10
2601;8;20413;4;8;922;0;465;421;44
2601;9;20367;4;9;1189;0;677;628;49
2602;10;20423;4;10;701;0;402;317;85
2602;10;20476;4;10;1360;1;668;632;36
2602;11;20433;4;11;800;0;400;365;35
2602;11;20454;4;11;788;0;469;415;54
2602;1;20422;4;1;1694;5;858;758;100
2602;1;20429;4;1;1233;0;691;562;129
2602;1;20434;4;1;767;0;365;330;35
2602;1;20437;4;1;1579;2;1103;1009;94
2602;1;20447;4;1;800;5;572;473;99
2602;1;20448;4;1;1439;13;910;779;131
2602;1;20462;4;1;1451;0;871;762;109
2602;1;20469;4;1;1118;5;622;523;99
2602;1;20471;4;1;784;0;411;378;33
2602;12;20439;4;12;1618;0;860;713;147
2602;13;20480;4;13;988;1;557;501;56
2602;14;20461;4;14;922;3;495;422;73
2602;15;20483;4;15;666;0;369;337;32
2602;16;20445;4;16;958;1;532;483;49
2602;17;20482;4;17;1572;0;687;588;99
2602;18;20451;4;18;1278;0;712;615;97
2602;19;20489;4;19;16;0;2;2;0
2602;20;20452;4;20;63;0;0;0;0
2602;2;20421;4;2;1770;0;963;873;90
2602;2;20431;4;2;303;0;161;135;26
2602;2;20432;4;2;1064;1;728;585;143
2602;2;20441;4;2;387;0;237;189;48
2602;2;20449;4;2;1945;2;1022;932;90
2602;2;20453;4;2;495;0;232;209;23
2602;2;20458;4;2;1001;0;567;484;83
2602;2;20465;4;2;483;9;339;261;78
2602;2;20473;4;2;1375;2;852;725;127
2602;3;20430;4;3;530;1;274;223;51
2602;3;20436;4;3;575;0;317;245;72
2602;3;20443;4;3;1403;0;655;600;55
2602;3;20446;4;3;954;0;583;504;79
2602;3;20459;4;3;1305;2;830;666;164
2602;3;20470;4;3;873;2;526;478;48
2602;3;20475;4;3;847;1;396;345;51
2602;3;20484;4;3;806;0;313;262;51
2602;3;20487;4;3;1451;1;854;702;152
2602;4;20419;4;4;509;2;341;272;69
2602;4;20440;4;4;1478;1;757;727;30
2602;4;20444;4;4;1255;0;578;528;50
2602;4;20460;4;4;1456;1;727;642;85
2602;4;20468;4;4;459;0;264;236;28
2602;4;20477;4;4;339;0;182;147;35
2602;4;20479;4;4;704;1;371;322;49
2602;4;20481;4;4;883;1;468;384;84
2602;4;20488;4;4;1280;0;582;530;52
2602;5;20425;4;5;940;0;598;495;103
2602;5;20427;4;5;1691;3;1073;992;81
2602;5;20450;4;5;1939;1;990;887;103
2602;5;20467;4;5;1178;1;493;445;48
2602;5;20478;4;5;484;0;176;155;21
2602;5;20485;4;5;309;0;172;145;27
2602;5;20486;4;5;621;2;368;324;44
2602;6;20418;4;6;1982;0;815;748;67
2602;6;20428;4;6;1963;3;891;787;104
2602;6;20457;4;6;816;0;500;423;77
2602;6;20463;4;6;1451;0;833;735;98
2602;6;20464;4;6;424;0;243;203;40
2602;6;20474;4;6;451;0;196;163;33
2602;7;20420;4;7;1806;1;956;882;74
2602;7;20424;4;7;875;0;338;268;70
2602;7;20435;4;7;530;0;310;270;40
2602;7;20438;4;7;270;0;171;135;36
2602;7;20490;4;7;1759;0;1077;942;135
2602;8;20426;4;8;1207;0;612;563;49
2602;8;20442;4;8;964;0;595;532;63
2602;8;20455;4;8;460;0;271;222;49
2602;9;20456;4;9;728;0;526;420;106
2602;9;20466;4;9;341;0;183;153;30
2602;9;20472;4;9;814;0;442;412;30
2603;10;20500;4;10;854;2;404;340;64
2603;11;20493;4;11;927;0;450;372;78
2603;1;20497;4;1;2287;2;1183;1091;92
2603;1;20502;4;1;1127;1;607;570;37
2603;1;20507;4;1;1422;6;796;742;54
2603;1;20508;4;1;1133;5;695;648;47
2603;1;20509;4;1;2205;3;1146;1011;135
2603;12;20505;4;12;18;0;10;9;1
2603;2;20492;4;2;1689;0;816;757;59
2603;2;20496;4;2;1104;20;703;659;44
2603;2;20498;4;2;952;0;510;474;36
2603;2;20512;4;2;928;1;548;511;37
2603;2;20516;4;2;1220;0;520;483;37
2603;3;20491;4;3;887;0;417;396;21
2603;3;20501;4;3;1407;1;619;572;47
2603;3;20503;4;3;1792;1;978;888;90
2603;3;20511;4;3;62;0;34;22;12
2603;3;20515;4;3;660;5;433;396;37
2603;4;20510;4;4;1991;0;947;778;169
2603;4;20513;4;4;644;2;288;264;24
2603;5;20494;4;5;1037;9;542;480;62
2603;5;20514;4;5;1262;1;568;505;63
2603;6;20495;4;6;881;1;488;446;42
2603;7;20506;4;7;653;1;355;311;44
2603;8;20504;4;8;891;2;460;356;104
2603;9;20499;4;9;1849;1;840;677;163
2604;10;20546;3;10;471;0;283;220;63
2604;10;20599;3;10;1127;0;623;558;65
2604;10;20623;3;10;966;0;596;497;99
2604;10;20624;3;10;695;0;460;401;59
2604;10;20646;3;10;425;0;200;177;23
2604;10;20674;3;10;13;0;8;8;0
2604;11;20556;3;11;119;0;29;18;11
2604;11;20607;3;11;985;1;547;547;0
2604;11;20628;3;11;679;1;350;306;44
2604;11;20651;3;11;28;0;28;27;1
2604;1;20527;3;1;1228;0;836;708;128
2604;1;20530;3;1;2027;13;1186;975;211
2604;1;20533;3;1;1459;1;827;750;77
2604;1;20534;3;1;246;0;109;102;7
2604;1;20537;3;1;1924;18;1335;1197;138
2604;1;20551;3;1;1584;2;972;883;89
2604;1;20553;3;1;1924;1;1189;1068;121
2604;1;20555;3;1;502;3;339;283;56
2604;1;20560;3;1;2383;0;1485;1263;222
2604;1;20567;3;1;1282;0;895;791;104
2604;1;20581;3;1;1739;5;1083;958;125
2604;1;20589;3;1;658;1;434;343;91
2604;1;20602;3;1;1395;0;763;689;74
2604;1;20627;3;1;1690;1;842;774;68
2604;1;20649;3;1;718;0;325;289;36
2604;1;20653;3;1;833;0;351;326;25
2604;1;20662;3;1;2201;0;964;874;90
2604;1;20667;3;1;1878;0;1126;1045;81
2604;1;20673;3;1;432;2;293;242;51
2604;12;20677;3;12;620;0;325;279;46
2604;13;20545;3;13;529;0;327;297;30
2604;14;20598;3;14;22;0;7;7;0
2604;2;20517;3;2;894;1;497;451;46
2604;2;20521;3;2;464;0;326;298;28
2604;2;20523;3;2;980;14;532;467;65
2604;2;20524;3;2;1656;2;1030;921;109
2604;2;20528;3;2;1599;0;979;905;74
2604;2;20543;3;2;1866;0;1061;911;150
2604;2;20576;3;2;902;0;495;440;55
2604;2;20578;3;2;1047;0;508;439;69
2604;2;20615;3;2;1304;0;655;593;62
2604;2;20617;3;2;200;1;128;102;26
2604;2;20618;3;2;2255;0;1229;1064;165
2604;2;20625;3;2;1213;4;762;643;119
2604;2;20654;3;2;2281;0;1091;1035;56
2604;2;20656;3;2;1694;0;828;749;79
2604;2;20665;3;2;422;0;236;203;33
2604;2;20666;3;2;403;0;245;212;33
2604;2;20668;3;2;764;0;523;472;51
2604;2;20669;3;2;751;2;465;357;108
2604;2;20675;3;2;1495;0;833;645;188
2604;3;20520;3;3;377;0;246;214;32
2604;3;20552;3;3;385;1;280;241;39
2604;3;20558;3;3;1824;0;978;825;153
2604;3;20565;3;3;665;0;342;276;66
2604;3;20568;3;3;1537;0;814;720;94
2604;3;20570;3;3;1874;1;1008;912;96
2604;3;20571;3;3;975;0;321;282;39
2604;3;20580;3;3;1240;0;635;542;93
2604;3;20593;3;3;891;0;596;536;60
2604;3;20600;3;3;445;1;270;220;50
2604;3;20609;3;3;868;0;532;435;97
2604;3;20619;3;3;1129;0;633;582;51
2604;3;20634;3;3;445;0;227;192;35
2604;3;20642;3;3;1061;0;658;563;95
2604;3;20643;3;3;1902;1;1157;977;180
2604;3;20648;3;3;728;0;355;316;39
2604;3;20657;3;3;662;3;437;349;88
2604;3;20661;3;3;594;5;453;395;58
2604;3;20678;3;3;946;0;503;434;69
2604;4;20522;3;4;886;0;472;397;75
2604;4;20535;3;4;820;1;392;321;71
2604;4;20541;3;4;597;0;216;187;29
2604;4;20550;3;4;907;1;551;445;106
2604;4;20554;3;4;1227;1;852;758;94
2604;4;20564;3;4;483;4;337;269;68
2604;4;20583;3;4;1295;0;701;701;0
2604;4;20604;3;4;902;0;469;403;66
2604;4;20605;3;4;839;1;580;493;87
2604;4;20606;3;4;401;8;277;238;39
2604;4;20611;3;4;1804;0;1171;949;222
2604;4;20614;3;4;1654;0;708;622;86
2604;4;20621;3;4;536;0;303;264;39
2604;4;20630;3;4;2269;1;1375;1118;257
2604;4;20637;3;4;921;0;510;400;110
2604;4;20639;3;4;687;0;394;346;48
2604;4;20644;3;4;1561;0;957;832;125
2604;4;20663;3;4;1361;1;968;797;171
2604;4;20672;3;4;2038;0;1103;958;145
2604;5;20518;3;5;760;3;497;408;89
2604;5;20531;3;5;942;0;387;333;54
2604;5;20544;3;5;1168;0;667;618;49
2604;5;20547;3;5;998;0;577;399;178
2604;5;20548;3;5;589;0;331;273;58
2604;5;20559;3;5;1609;0;679;594;85
2604;5;20561;3;5;1448;0;862;763;99
2604;5;20579;3;5;994;0;506;423;83
2604;5;20587;3;5;896;4;590;501;89
2604;5;20590;3;5;1467;0;1013;908;105
2604;5;20601;3;5;1393;0;603;527;76
2604;5;20608;3;5;943;1;572;532;40
2604;5;20613;3;5;859;2;559;514;45
2604;5;20622;3;5;540;1;333;266;67
2604;5;20629;3;5;27;0;27;2;25
2604;5;20636;3;5;1040;0;555;487;68
2604;5;20638;3;5;586;0;269;221;48
2604;5;20645;3;5;1243;1;731;601;130
2604;5;20679;3;5;910;0;339;307;32
2604;6;20538;3;6;2121;0;1000;918;82
2604;6;20542;3;6;517;0;277;227;50
2604;6;20566;3;6;1287;0;762;682;80
2604;6;20569;3;6;768;5;483;417;66
2604;6;20572;3;6;1323;4;803;742;61
2604;6;20574;3;6;1630;0;720;720;0
2604;6;20575;3;6;653;0;333;266;67
2604;6;20582;3;6;1045;0;517;478;39
2604;6;20588;3;6;1102;12;764;690;74
2604;6;20603;3;6;832;0;307;271;36
2604;6;20612;3;6;993;0;534;461;73
2604;6;20616;3;6;944;0;598;518;80
2604;6;20626;3;6;1135;0;736;624;112
2604;6;20633;3;6;364;1;213;178;35
2604;6;20640;3;6;571;0;388;326;62
2604;6;20658;3;6;809;10;518;425;93
2604;6;20660;3;6;179;0;100;85;15
2604;6;20676;3;6;1051;0;389;347;42
2604;7;20525;3;7;1021;2;530;461;69
2604;7;20529;3;7;356;0;209;176;33
2604;7;20532;3;7;576;0;301;256;45
2604;7;20536;3;7;885;0;358;330;28
2604;7;20539;3;7;1423;0;853;741;112
2604;7;20563;3;7;786;0;433;383;50
2604;7;20586;3;7;1780;0;664;565;99
2604;7;20592;3;7;444;0;211;169;42
2604;7;20594;3;7;479;0;261;207;54
2604;7;20610;3;7;694;0;406;361;45
2604;7;20632;3;7;421;0;281;223;58
2604;7;20641;3;7;530;0;403;253;150
2604;7;20652;3;7;1094;0;692;590;102
2604;7;20664;3;7;1073;3;627;564;63
2604;7;20670;3;7;2176;11;1204;980;224
2604;8;20519;3;8;813;2;499;426;73
2604;8;20526;3;8;948;0;468;396;72
2604;8;20540;3;8;457;0;204;204;0
2604;8;20549;3;8;1087;0;819;680;139
2604;8;20562;3;8;251;0;144;124;20
2604;8;20584;3;8;1201;5;667;591;76
2604;8;20595;3;8;663;0;295;262;33
2604;8;20597;3;8;1005;0;551;492;59
2604;8;20631;3;8;591;0;195;175;20
2604;8;20650;3;8;853;0;469;416;53
2604;8;20655;3;8;1006;0;537;484;53
2604;8;20671;3;8;410;1;293;264;29
2604;9;20557;3;9;1277;0;768;693;75
2604;9;20573;3;9;361;0;193;176;17
2604;9;20577;3;9;1167;0;651;522;129
2604;9;20585;3;9;854;0;493;399;94
2604;9;20591;3;9;1069;0;650;564;86
2604;9;20596;3;9;756;0;377;341;36
2604;9;20620;3;9;414;0;264;218;46
2604;9;20635;3;9;480;5;275;228;47
2604;9;20647;3;9;737;0;379;302;77
2604;9;20659;3;9;945;0;472;413;59
2605;10;20710;2;10;624;0;322;264;58
2605;10;20717;2;10;1985;0;1041;944;97
2605;11;20692;2;11;1396;0;596;510;86
2605;11;20713;2;11;1104;7;666;510;156
2605;1;20685;2;1;1924;3;1138;1008;130
2605;1;20686;2;1;965;0;639;522;117
2605;1;20689;2;1;379;2;269;232;37
2605;1;20693;2;1;1530;19;921;694;227
2605;1;20695;2;1;1711;1;910;820;90
2605;1;20698;2;1;1672;3;993;853;140
2605;1;20716;2;1;1047;16;627;450;177
2605;1;20721;2;1;1816;0;952;875;77
2605;12;20694;2;12;1295;0;687;603;84
2605;12;20737;2;12;653;0;372;321;51
2605;13;20681;2;13;277;4;192;172;20
2605;13;20743;2;13;1978;0;1041;952;89
2605;14;20683;2;14;520;0;266;237;29
2605;14;20734;2;14;1802;0;1018;905;113
2605;15;20727;2;15;1707;2;1073;1006;67
2605;16;20725;2;16;1187;8;617;541;76
2605;17;20742;2;17;1436;0;824;734;90
2605;18;20709;2;18;960;0;504;460;44
2605;19;20702;2;19;431;4;254;231;23
2605;20;20700;2;20;728;0;471;416;55
2605;21;20731;2;21;1644;1;923;873;50
2605;2;20697;2;2;760;0;467;395;72
2605;2;20712;2;2;871;1;610;510;100
2605;2;20714;2;2;1764;12;1043;805;238
2605;2;20719;2;2;391;1;291;228;63
2605;2;20723;2;2;2085;2;1058;993;65
2605;2;20724;2;2;966;0;622;459;163
2605;2;20729;2;2;1772;3;1044;947;97
2605;2;20745;2;2;1764;0;1085;898;187
2605;22;20726;2;22;116;0;82;54;28
2605;23;20705;2;23;69;0;38;31;7
2605;3;20687;2;3;355;0;203;175;28
2605;3;20690;2;3;323;1;223;177;46
2605;3;20704;2;3;442;0;295;249;46
2605;3;20706;2;3;1482;2;903;757;146
2605;3;20707;2;3;2136;0;1094;1010;84
2605;3;20711;2;3;1641;4;942;817;125
2605;3;20715;2;3;736;5;397;293;104
2605;3;20744;2;3;708;0;431;364;67
2605;4;20682;2;4;474;0;325;269;56
2605;4;20684;2;4;1889;1;984;858;126
2605;4;20703;2;4;479;0;326;291;35
2605;4;20708;2;4;679;1;412;313;99
2605;4;20720;2;4;549;0;376;244;132
2605;4;20733;2;4;1504;1;756;697;59
2605;4;20738;2;4;945;6;666;538;128
2605;5;20688;2;5;252;3;182;134;48
2605;5;20699;2;5;539;0;251;230;21
2605;5;20722;2;5;450;0;306;244;62
2605;5;20730;2;5;197;0;141;107;34
2605;5;20735;2;5;923;1;614;482;132
2605;5;20736;2;5;871;0;451;399;52
2605;6;20728;2;6;961;0;600;568;32
2605;6;20732;2;6;1392;0;840;718;122
2605;6;20739;2;6;453;1;264;215;49
2605;7;20680;2;7;508;0;300;222;78
2605;7;20701;2;7;1256;2;660;620;40
2605;7;20740;2;7;593;0;325;288;37
2605;8;20696;2;8;2035;5;1065;982;83
2605;8;20718;2;8;1213;0;610;536;74
2605;9;20691;2;9;1779;4;1000;900;100
2605;9;20741;2;9;1067;2;591;490;101
2606;10;20776;1;10;299;1;153;142;11
2606;10;20781;1;10;667;0;341;290;51
2606;11;20746;1;11;621;5;441;385;56
2606;11;20766;1;11;644;5;352;281;71
2606;1;20748;1;1;988;9;671;553;118
2606;1;20753;1;1;1969;0;989;871;118
2606;1;20756;1;1;1625;5;961;804;157
2606;1;20761;1;1;1314;7;832;725;107
2606;1;20765;1;1;1289;2;800;671;129
2606;1;20768;1;1;2210;7;1539;1292;247
2606;1;20783;1;1;2345;0;1444;1240;204
2606;1;20795;1;1;1282;3;923;748;175
2606;12;20750;1;12;1201;7;685;595;90
2606;13;20774;1;13;96;0;89;60;29
2606;14;20770;1;14;15;0;7;4;3
2606;2;20754;1;2;1095;2;654;540;114
2606;2;20757;1;2;635;0;451;374;77
2606;2;20764;1;2;1006;0;500;440;60
2606;2;20773;1;2;742;0;426;358;68
2606;2;20775;1;2;987;7;712;598;114
2606;2;20780;1;2;1290;0;711;616;95
2606;2;20782;1;2;1732;3;932;784;148
2606;2;20794;1;2;1449;1;848;740;108
2606;3;20755;1;3;691;0;316;269;47
2606;3;20758;1;3;1449;0;762;684;78
2606;3;20769;1;3;606;1;428;336;92
2606;3;20777;1;3;1446;7;882;791;91
2606;3;20785;1;3;841;3;551;469;82
2606;3;20786;1;3;764;2;440;326;114
2606;3;20791;1;3;607;1;433;395;38
2606;3;20793;1;3;376;2;232;197;35
2606;4;20749;1;4;417;4;273;215;58
2606;4;20759;1;4;220;2;157;121;36
2606;4;20760;1;4;578;0;299;245;54
2606;4;20784;1;4;555;0;262;221;41
2606;4;20787;1;4;919;6;575;504;71
2606;4;20788;1;4;695;2;467;397;70
2606;4;20792;1;4;1567;1;1007;908;99
2606;5;20752;1;5;493;3;299;256;43
2606;5;20762;1;5;557;1;349;272;77
2606;5;20789;1;5;540;1;336;270;66
2606;5;20790;1;5;979;0;660;543;117
2606;6;20747;1;6;630;0;341;296;45
2606;6;20771;1;6;719;1;502;413;89
2606;6;20778;1;6;602;0;332;301;31
2606;6;20796;1;6;1113;2;658;531;127
2606;7;20767;1;7;638;4;404;325;79
2606;7;20779;1;7;678;0;387;356;31
2606;8;20772;1;8;443;0;252;216;36
2606;8;20797;1;8;660;0;358;305;53
2606;9;20751;1;9;502;0;268;232;36
2606;9;20763;1;9;154;0;96;86;10
2607;10;20815;1;10;626;0;336;257;79
2607;10;20859;1;10;1620;0;750;694;56
2607;10;20870;1;10;441;0;210;187;23
2607;11;20843;1;11;1417;0;731;699;32
2607;11;20852;1;11;568;0;268;224;44
2607;11;20864;1;11;752;0;374;328;46
2607;1;20806;1;1;1726;1;686;603;83
2607;1;20820;1;1;1905;0;941;795;146
2607;1;20835;1;1;1382;0;670;582;88
2607;1;20837;1;1;1260;2;635;517;118
2607;1;20849;1;1;1242;2;932;844;88
2607;1;20869;1;1;459;1;256;218;38
2607;12;20832;1;12;1848;0;866;826;40
2607;12;20872;1;12;396;0;185;137;48
2607;13;20798;1;13;1307;0;595;528;67
2607;14;20858;1;14;1271;0;566;524;42
2607;15;20801;1;15;1908;1;795;724;71
2607;16;20844;1;16;1589;0;731;666;65
2607;17;20816;1;17;1278;0;517;473;44
2607;18;20829;1;18;1896;0;861;806;55
2607;19;20857;1;19;1219;0;522;478;44
2607;20;20811;1;20;1383;0;569;508;61
2607;21;20871;1;21;1050;0;464;426;38
2607;2;20800;1;2;725;0;340;292;48
2607;2;20817;1;2;1527;0;520;456;64
2607;2;20822;1;2;671;0;425;350;75
2607;2;20823;1;2;613;0;362;275;87
2607;2;20828;1;2;603;7;319;287;32
2607;2;20842;1;2;2278;0;1353;1127;226
2607;22;20845;1;22;1546;0;601;547;54
2607;23;20868;1;23;2182;0;879;807;72
2607;24;20827;1;24;1588;0;634;578;56
2607;25;20876;1;25;2138;1;804;727;77
2607;26;20825;1;26;1367;0;659;544;115
2607;27;20821;1;27;1959;0;830;758;72
2607;28;20826;1;28;1541;0;591;536;55
2607;29;20803;1;29;1741;0;628;571;57
2607;30;20830;1;30;1784;1;750;699;51
2607;31;20863;1;31;1628;0;592;550;42
2607;3;20799;1;3;1527;0;731;590;141
2607;3;20808;1;3;691;0;496;443;53
2607;3;20831;1;3;1946;1;825;739;86
2607;3;20839;1;3;372;3;247;190;57
2607;3;20861;1;3;1791;3;1023;881;142
2607;3;20865;1;3;1504;0;664;562;102
2607;32;20813;1;32;1517;0;589;536;53
2607;33;20862;1;33;1607;0;623;579;44
2607;34;20846;1;34;1297;0;458;420;38
2607;35;20851;1;35;2167;1;803;741;62
2607;36;20838;1;36;1972;0;728;670;58
2607;37;20841;1;37;2151;0;739;682;57
2607;38;20807;1;38;1837;0;862;777;85
2607;39;20860;1;39;188;0;145;133;12
2607;40;20855;1;40;114;0;97;76;21
2607;41;20873;1;41;118;0;29;26;3
2607;4;20805;1;4;375;0;225;190;35
2607;4;20809;1;4;1000;0;426;395;31
2607;4;20818;1;4;1166;0;594;528;66
2607;4;20819;1;4;555;0;379;337;42
2607;4;20840;1;4;1839;4;962;828;134
2607;4;20853;1;4;815;0;378;315;63
2607;5;20802;1;5;855;0;400;324;76
2607;5;20812;1;5;733;0;287;259;28
2607;5;20824;1;5;381;0;251;221;30
2607;5;20834;1;5;888;0;444;364;80
2607;5;20875;1;5;1138;0;676;600;76
2607;6;20836;1;6;1830;5;992;895;97
2607;6;20847;1;6;1116;1;497;447;50
2607;6;20848;1;6;386;0;235;201;34
2607;6;20856;1;6;766;0;341;297;44
2607;7;20804;1;7;1751;0;645;568;77
2607;7;20850;1;7;385;0;224;184;40
2607;7;20874;1;7;900;0;416;343;73
2607;8;20810;1;8;1603;0;717;628;89
2607;8;20854;1;8;657;0;362;303;59
2607;8;20866;1;8;879;0;443;349;94
2607;9;20814;1;9;579;0;310;251;59
2607;9;20833;1;9;2031;1;835;770;65
2607;9;20867;1;9;648;1;351;304;47
2608;10;20887;4;10;896;0;503;477;26
2608;11;20881;4;11;1658;1;937;876;61
2608;1;20877;4;1;1377;0;763;683;80
2608;1;20897;4;1;592;1;369;330;39
2608;1;20898;4;1;1417;28;986;813;173
2608;1;20899;4;1;958;0;503;455;48
2608;1;20908;4;1;1255;8;705;652;53
2608;12;20893;4;12;1592;0;869;791;78
2608;13;20901;4;13;863;0;529;477;52
2608;14;20879;4;14;1989;0;990;927;63
2608;15;20889;4;15;61;0;30;27;3
2608;16;20884;4;16;90;0;74;55;19
2608;2;20882;4;2;1492;8;826;756;70
2608;2;20883;4;2;1374;1;793;716;77
2608;2;20885;4;2;1563;0;998;838;160
2608;2;20895;4;2;1213;20;880;755;125
2608;2;20904;4;2;998;1;594;496;98
2608;3;20888;4;3;1281;9;827;753;74
2608;3;20890;4;3;780;4;491;404;87
2608;3;20896;4;3;481;4;332;251;81
2608;3;20903;4;3;1599;0;905;856;49
2608;3;20907;4;3;942;0;498;440;58
2608;4;20880;4;4;923;3;629;563;66
2608;4;20891;4;4;837;1;503;421;82
2608;4;20900;4;4;438;0;271;232;39
2608;4;20906;4;4;820;3;540;482;58
2608;5;20892;4;5;1627;0;912;839;73
2608;5;20909;4;5;650;1;434;373;61
2608;6;20886;4;6;607;0;328;273;55
2608;6;20894;4;6;961;1;519;448;71
2608;7;20905;4;7;1075;0;621;591;30
2608;8;20878;4;8;878;0;477;454;23
2608;9;20902;4;9;1145;2;552;495;57
2609;10;20911;1;10;815;0;361;333;28
2609;11;20957;1;11;1187;0;639;588;51
2609;1;20913;1;1;2398;2;1517;1330;187
2609;1;20914;1;1;2196;0;1168;1019;149
2609;1;20926;1;1;1728;4;1056;891;165
2609;1;20928;1;1;2133;7;1257;1110;147
2609;1;20931;1;1;1549;4;949;805;144
2609;1;20941;1;1;905;2;524;431;93
2609;1;20942;1;1;1752;3;881;798;83
2609;1;20954;1;1;1609;2;717;615;102
2609;1;20960;1;1;1604;0;952;832;120
2609;12;20939;1;12;1203;0;660;608;52
2609;13;20934;1;13;2073;0;939;856;83
2609;14;20923;1;14;51;0;8;7;1
2609;15;20968;1;15;82;0;63;51;12
2609;2;20916;1;2;1482;3;796;678;118
2609;2;20938;1;2;718;1;449;391;58
2609;2;20944;1;2;1948;7;1281;1146;135
2609;2;20946;1;2;764;3;415;348;67
2609;2;20950;1;2;854;0;518;480;38
2609;2;20951;1;2;600;4;376;341;35
2609;2;20956;1;2;1494;0;792;672;120
2609;2;20958;1;2;940;0;573;501;72
2609;2;20963;1;2;687;0;325;273;52
2609;3;20910;1;3;470;4;351;291;60
2609;3;20915;1;3;818;0;458;359;99
2609;3;20917;1;3;1265;0;761;656;105
2609;3;20921;1;3;424;1;272;249;23
2609;3;20927;1;3;1351;2;913;783;130
2609;3;20932;1;3;1644;0;854;779;75
2609;3;20959;1;3;731;5;450;400;50
2609;3;20965;1;3;2010;4;1047;914;133
2609;3;20967;1;3;664;0;392;323;69
2609;4;20920;1;4;1634;12;1144;1009;135
2609;4;20929;1;4;1950;0;992;904;88
2609;4;20930;1;4;626;0;327;286;41
2609;4;20940;1;4;938;2;584;512;72
2609;4;20943;1;4;671;0;430;387;43
2609;4;20947;1;4;637;1;423;341;82
2609;4;20962;1;4;952;0;454;377;77
2609;4;20966;1;4;903;0;549;475;74
2609;5;20912;1;5;1875;0;930;865;65
2609;5;20922;1;5;741;0;312;280;32
2609;5;20933;1;5;709;5;459;418;41
2609;5;20936;1;5;1064;1;488;436;52
2609;5;20937;1;5;213;0;144;113;31
2609;5;20952;1;5;1690;0;825;732;93
2609;5;20953;1;5;539;0;320;276;44
2609;6;20919;1;6;1228;1;638;572;66
2609;6;20935;1;6;462;0;256;225;31
2609;6;20949;1;6;422;1;245;215;30
2609;6;20955;1;6;605;0;306;260;46
2609;7;20918;1;7;1024;0;522;440;82
2609;7;20948;1;7;943;0;698;608;90
2609;7;20961;1;7;758;0;402;365;37
2609;7;20964;1;7;2207;1;1117;1029;88
2609;8;20925;1;8;1222;1;661;561;100
2609;8;20945;1;8;1781;0;978;881;97
2609;9;20924;1;9;1055;0;488;429;59
2610;10;20994;2;10;863;0;407;348;59
2610;11;20988;2;11;1828;0;888;812;76
2610;1;20991;2;1;2034;0;977;790;187
2610;1;20998;2;1;951;0;451;403;48
2610;1;21008;2;1;839;0;492;401;91
2610;1;21015;2;1;819;0;488;421;67
2610;1;21020;2;1;1316;0;651;568;83
2610;12;20990;2;12;2190;0;1108;1002;106
2610;13;21006;2;13;2195;0;1052;960;92
2610;14;21011;2;14;2393;0;1224;1142;82
2610;15;20985;2;15;801;0;417;385;32
2610;16;21002;2;16;356;0;141;134;7
2610;17;21017;2;17;1387;0;671;608;63
2610;18;20979;2;18;1887;0;951;860;91
2610;19;21016;2;19;2265;0;1171;1078;93
2610;20;20980;2;20;1983;0;965;888;77
2610;21;21000;2;21;2008;2;962;864;98
2610;2;20973;2;2;608;0;402;322;80
2610;2;20978;2;2;1435;0;808;724;84
2610;2;20987;2;2;1461;0;843;758;85
2610;2;20993;2;2;230;0;135;98;37
2610;2;21007;2;2;1516;0;786;700;86
2610;22;21003;2;22;1435;1;772;684;88
2610;23;20992;2;23;1229;2;663;613;50
2610;24;20983;2;24;1458;0;731;668;63
2610;25;21021;2;25;2014;0;1004;873;131
2610;26;20975;2;26;894;0;418;354;64
2610;27;21005;2;27;712;0;364;336;28
2610;28;20971;2;28;1470;0;844;750;94
2610;29;21025;2;29;917;1;443;401;42
2610;30;21012;2;30;1282;1;651;555;96
2610;31;20989;2;31;45;0;25;24;1
2610;3;20974;2;3;1160;0;671;604;67
2610;3;20999;2;3;2170;3;1324;1162;162
2610;3;21010;2;3;998;0;461;427;34
2610;3;21019;2;3;1744;0;870;714;156
2610;3;21023;2;3;1018;0;644;540;104
2610;32;20976;2;32;33;0;9;7;2
2610;33;21022;2;33;44;0;23;20;3
2610;4;20982;2;4;1021;0;466;390;76
2610;4;20984;2;4;669;0;301;261;40
2610;4;20997;2;4;1246;3;663;544;119
2610;4;21018;2;4;638;0;423;320;103
2610;4;21026;2;4;964;0;458;356;102
2610;5;20977;2;5;877;0;415;365;50
2610;5;20986;2;5;532;0;340;238;102
2610;5;21004;2;5;517;0;211;193;18
2610;5;21009;2;5;594;0;385;303;82
2610;5;21024;2;5;979;1;595;502;93
2610;6;20996;2;6;861;0;443;397;46
2610;6;21013;2;6;1001;0;657;564;93
2610;6;21014;2;6;1287;0;693;614;79
2610;7;20970;2;7;1385;2;726;657;69
2610;7;20981;2;7;838;0;428;362;66
2610;8;20969;2;8;364;0;241;199;42
2610;8;20995;2;8;1479;0;774;710;64
2610;9;20972;2;9;1540;0;741;675;66
2610;9;21001;2;9;383;0;206;192;14
2611;10;21038;2;10;1498;0;680;621;59
2611;10;21085;2;10;276;1;115;82;33
2611;10;21089;2;10;444;0;270;233;37
2611;11;21027;2;11;2024;1;1089;966;123
2611;11;21048;2;11;893;0;306;306;0
2611;11;21082;2;11;587;0;338;258;80
2611;1;21051;2;1;728;1;453;377;76
2611;1;21053;2;1;1194;3;674;489;185
2611;1;21067;2;1;2199;4;1070;976;94
2611;1;21078;2;1;1189;5;733;658;75
2611;1;21087;2;1;712;2;471;412;59
2611;12;21035;2;12;75;0;50;43;7
2611;12;21061;2;12;2204;0;1179;1077;102
2611;12;21088;2;12;892;0;459;362;97
2611;13;21043;2;13;446;0;207;157;50
2611;13;21060;2;13;1900;2;1009;900;109
2611;14;21064;2;14;153;0;52;43;9
2611;14;21074;2;14;2062;0;986;892;94
2611;15;21049;2;15;1665;1;826;739;87
2611;16;21086;2;16;1474;3;690;590;100
2611;17;21077;2;17;1452;1;588;533;55
2611;18;21055;2;18;1770;1;775;685;90
2611;19;21042;2;19;1711;0;800;710;90
2611;20;21046;2;20;2444;0;1156;1011;145
2611;21;21075;2;21;1627;0;707;612;95
2611;2;21032;2;2;460;2;286;243;43
2611;2;21050;2;2;1519;0;1020;850;170
2611;2;21062;2;2;85;0;55;43;12
2611;2;21063;2;2;648;0;340;298;42
2611;2;21093;2;2;1219;8;708;630;78
2611;22;21031;2;22;1822;1;825;758;67
2611;23;21028;2;23;1275;1;549;476;73
2611;24;21036;2;24;83;0;43;40;3
2611;25;21072;2;25;1913;1;910;805;105
2611;26;21073;2;26;2001;0;982;882;100
2611;3;21034;2;3;1722;2;760;667;93
2611;3;21044;2;3;683;0;470;415;55
2611;3;21059;2;3;719;0;409;317;92
2611;3;21070;2;3;1299;1;816;673;143
2611;3;21084;2;3;837;0;492;408;84
2611;4;21037;2;4;1013;2;645;535;110
2611;4;21052;2;4;847;0;560;440;120
2611;4;21057;2;4;1317;8;766;705;61
2611;4;21083;2;4;1666;0;731;644;87
2611;4;21091;2;4;1690;0;1118;963;155
2611;5;21047;2;5;435;0;285;212;73
2611;5;21058;2;5;1872;1;870;797;73
2611;5;21065;2;5;775;1;335;292;43
2611;5;21071;2;5;542;0;318;265;53
2611;5;21092;2;5;1036;1;724;635;89
2611;6;21041;2;6;1754;1;747;691;56
2611;6;21045;2;6;789;0;475;401;74
2611;6;21066;2;6;1357;0;661;577;84
2611;6;21080;2;6;361;0;225;209;16
2611;6;21081;2;6;401;0;161;121;40
2611;7;21039;2;7;885;0;276;234;42
2611;7;21068;2;7;650;5;390;338;52
2611;7;21069;2;7;1658;0;878;715;163
2611;7;21076;2;7;2452;0;1238;1129;109
2611;8;21029;2;8;1655;1;953;796;157
2611;8;21033;2;8;750;0;300;267;33
2611;8;21054;2;8;2016;2;898;792;106
2611;8;21079;2;8;518;0;328;264;64
2611;9;21030;2;9;487;0;265;205;60
2611;9;21040;2;9;981;4;678;580;98
2611;9;21056;2;9;1844;0;886;819;67
2611;9;21090;2;9;520;0;334;266;68
2612;10;21096;1;10;715;0;442;383;59
2612;11;21112;1;11;511;0;320;267;53
2612;1;21098;1;1;2220;0;1346;1220;126
2612;1;21101;1;1;1353;0;804;756;48
2612;1;21105;1;1;1553;0;894;763;131
2612;1;21113;1;1;2081;29;1556;1423;133
2612;1;21125;1;1;1294;3;862;709;153
2612;1;21132;1;1;503;0;319;245;74
2612;1;21136;1;1;2227;7;1448;1213;235
2612;1;21146;1;1;592;0;382;338;44
2612;12;21095;1;12;881;0;541;446;95
2612;13;21116;1;13;1048;2;620;524;96
2612;14;21100;1;14;1100;0;607;517;90
2612;15;21094;1;15;831;0;547;461;86
2612;16;21144;1;16;628;1;427;368;59
2612;17;21150;1;17;1050;2;611;551;60
2612;18;21141;1;18;1296;0;826;760;66
2612;19;21118;1;19;130;0;91;91;0
2612;20;21115;1;20;18;0;13;12;1
2612;2;21102;1;2;2011;0;1097;874;223
2612;2;21120;1;2;1164;3;810;746;64
2612;2;21122;1;2;748;0;401;352;49
2612;2;21126;1;2;1307;0;668;596;72
2612;2;21143;1;2;679;0;418;294;124
2612;2;21147;1;2;274;2;192;162;30
2612;2;21148;1;2;710;1;455;351;104
2612;2;21149;1;2;1546;0;857;809;48
2612;3;21099;1;3;1549;0;866;772;94
2612;3;21109;1;3;766;0;458;349;109
2612;3;21110;1;3;1565;0;946;849;97
2612;3;21121;1;3;876;0;547;474;73
2612;3;21127;1;3;998;1;585;452;133
2612;3;21128;1;3;2180;4;1373;1018;355
2612;3;21139;1;3;429;2;284;246;38
2612;3;21151;1;3;1459;10;828;714;114
2612;4;21103;1;4;1464;0;873;820;53
2612;4;21106;1;4;430;2;294;210;84
2612;4;21107;1;4;563;0;389;297;92
2612;4;21124;1;4;621;1;392;315;77
2612;4;21135;1;4;1881;0;1140;1010;130
2612;4;21137;1;4;808;0;537;462;75
2612;4;21152;1;4;650;0;380;303;77
2612;5;21097;1;5;1262;1;840;686;154
2612;5;21104;1;5;850;4;654;561;93
2612;5;21108;1;5;460;0;254;236;18
2612;5;21131;1;5;862;0;470;436;34
2612;5;21134;1;5;587;0;399;347;52
2612;6;21111;1;6;571;0;353;296;57
2612;6;21123;1;6;700;0;379;321;58
2612;6;21129;1;6;896;1;650;536;114
2612;6;21130;1;6;367;3;218;193;25
2612;6;21138;1;6;278;0;167;138;29
2612;7;21133;1;7;648;0;362;296;66
2612;7;21142;1;7;522;5;380;327;53
2612;7;21145;1;7;1794;0;1050;940;110
2612;8;21114;1;8;2393;1;1395;1299;96
2612;8;21117;1;8;587;3;379;338;41
2612;8;21140;1;8;1113;0;760;693;67
2612;9;21119;1;9;2035;0;1195;1083;112
2613;10;21158;4;10;1286;2;761;685;76
2613;11;21165;4;11;360;0;197;156;41
2613;1;21153;4;1;997;0;679;597;82
2613;1;21156;4;1;2260;0;1399;1174;225
2613;1;21157;4;1;1161;0;783;642;141
2613;1;21162;4;1;1687;4;944;832;112
2613;1;21182;4;1;592;0;318;262;56
2613;1;21192;4;1;1911;0;1131;1031;100
2613;12;21166;4;12;421;0;225;207;18
2613;13;21171;4;13;807;0;500;445;55
2613;14;21174;4;14;1171;0;771;650;121
2613;15;21159;4;15;773;3;489;414;75
2613;16;21175;4;16;212;0;144;132;12
2613;17;21164;4;17;184;0;131;125;6
2613;18;21178;4;18;35;0;11;10;1
2613;19;21169;4;19;84;0;52;50;2
2613;2;21172;4;2;1970;0;1093;994;99
2613;2;21177;4;2;726;0;407;349;58
2613;2;21179;4;2;936;9;609;495;114
2613;2;21185;4;2;703;0;319;273;46
2613;2;21187;4;2;523;0;289;224;65
2613;2;21195;4;2;891;0;649;560;89
2613;3;21155;4;3;572;0;324;268;56
2613;3;21168;4;3;2112;0;1251;1129;122
2613;3;21173;4;3;912;0;508;418;90
2613;3;21183;4;3;897;0;522;447;75
2613;3;21184;4;3;577;0;317;266;51
2613;3;21193;4;3;226;0;167;140;27
2613;4;21154;4;4;405;0;265;219;46
2613;4;21180;4;4;1843;0;999;853;146
2613;4;21181;4;4;301;0;212;182;30
2613;4;21188;4;4;876;3;563;446;117
2613;4;21190;4;4;1854;1;1123;1020;103
2613;5;21167;4;5;1128;8;717;590;127
2613;5;21176;4;5;908;1;573;525;48
2613;5;21194;4;5;342;0;187;165;22
2613;6;21160;4;6;1898;4;1223;987;236
2613;6;21161;4;6;583;0;353;319;34
2613;6;21186;4;6;678;0;428;350;78
2613;7;21170;4;7;505;0;290;256;34
2613;7;21191;4;7;604;0;337;287;50
2613;8;21189;4;8;489;0;260;222;38
2613;9;21163;4;9;788;0;455;398;57
2661;10;21231;3;10;1860;0;785;758;27
2661;11;21220;3;11;2114;0;914;898;16
2661;1;21224;3;1;2381;0;996;960;36
2661;12;21197;3;12;1993;1;706;677;29
2661;13;21207;3;13;1948;0;708;674;34
2661;14;21199;3;14;1998;0;864;831;33
2661;15;21274;3;15;411;0;183;180;3
2661;16;21205;3;16;1626;1;761;728;33
2661;17;21280;3;17;1878;0;871;825;46
2661;18;21254;3;18;1924;0;760;721;39
2661;19;21272;3;19;2005;0;692;655;37
2661;20;21253;3;20;2126;0;906;862;44
2661;21;21238;3;21;2303;0;1035;974;61
2661;2;21278;3;2;2526;0;1006;950;56
2661;22;21273;3;22;1710;0;725;669;56
2661;23;21209;3;23;1914;0;984;938;46
2661;24;21237;3;24;1994;0;984;936;48
2661;25;21235;3;25;2156;0;1082;1031;51
2661;26;21249;3;26;2341;0;988;952;36
2661;27;21200;3;27;2185;0;1017;972;45
2661;28;21265;3;28;2273;0;1150;1096;54
2661;29;21282;3;29;2256;2;862;809;53
2661;30;21232;3;30;2260;0;777;743;34
2661;31;21277;3;31;2412;0;1015;957;58
2661;3;21215;3;3;1942;0;955;901;54
2661;32;21285;3;32;2482;1;911;848;63
2661;33;21260;3;33;1032;0;397;383;14
2661;34;21204;3;34;2489;1;1327;1296;31
2661;35;21251;3;35;2144;0;1130;1109;21
2661;36;21263;3;36;2243;0;968;931;37
2661;37;21269;3;37;2306;0;990;990;0
2661;38;21281;3;38;2206;0;947;923;24
2661;39;21257;3;39;1433;0;669;653;16
2661;40;21286;3;40;1923;0;895;859;36
2661;41;21222;3;41;2512;0;1003;949;54
2661;4;21226;3;4;2099;0;902;874;28
2661;42;21270;3;42;2409;0;1051;999;52
2661;43;21250;3;43;2581;0;1077;1031;46
2661;44;21225;3;44;2509;0;1096;1058;38
2661;45;21213;3;45;2460;1;1139;1095;44
2661;46;21261;3;46;2486;0;1060;1019;41
2661;47;21248;3;47;2478;0;1092;1030;62
2661;48;21247;3;48;1940;0;949;920;29
2661;49;21246;3;49;1708;0;805;780;25
2661;50;21230;3;50;1738;0;813;789;24
2661;51;21221;3;51;2431;1;1211;1159;52
2661;5;21242;3;5;2323;0;1178;1105;73
2661;52;21206;3;52;2240;1;1125;1083;42
2661;53;21252;3;53;2097;0;952;916;36
2661;54;21267;3;54;2017;2;929;885;44
2661;55;21266;3;55;2085;0;1011;965;46
2661;56;21227;3;56;2156;1;1120;1066;54
2661;57;21244;3;57;1324;0;569;524;45
2661;58;21239;3;58;2195;0;920;896;24
2661;59;21233;3;59;2303;0;1054;999;55
2661;60;21219;3;60;2277;0;1040;992;48
2661;61;21202;3;61;2315;0;1069;1018;51
2661;6;21216;3;6;1022;0;395;378;17
2661;62;21245;3;62;2108;0;1043;1001;42
2661;63;21271;3;63;1997;0;994;940;54
2661;64;21217;3;64;534;0;222;207;15
2661;65;21284;3;65;2284;0;1158;1115;43
2661;66;21262;3;66;2170;1;1020;954;66
2661;67;21203;3;67;2387;0;1138;1089;49
2661;68;21283;3;68;2342;0;777;707;70
2661;69;21223;3;69;1967;1;786;758;28
2661;70;21241;3;70;2461;0;1142;1065;77
2661;71;21255;3;71;2101;0;999;943;56
2661;7;21218;3;7;2262;0;1083;1047;36
2661;72;21256;3;72;1795;0;770;770;0
2661;73;21234;3;73;1471;0;657;610;47
2661;74;21229;3;74;2227;1;1104;1046;58
2661;75;21208;3;75;909;0;413;383;30
2661;76;21214;3;76;1616;0;622;587;35
2661;77;21258;3;77;2144;1;922;881;41
2661;78;21276;3;78;1910;0;943;904;39
2661;79;21201;3;79;1774;0;832;799;33
2661;80;21211;3;80;781;0;382;359;23
2661;81;21236;3;81;1340;1;641;608;33
2661;8;21268;3;8;2270;0;1084;1029;55
2661;82;21259;3;82;26;0;7;7;0
2661;83;21275;3;83;96;0;49;42;7
2661;84;21279;3;84;82;0;44;39;5
2661;85;21240;3;85;17;0;7;7;0
2661;86;21228;3;86;259;0;91;72;19
2661;87;21198;3;87;33;0;7;6;1
2661;88;21212;3;88;73;0;32;28;4
2661;89;21243;3;89;424;0;101;81;20
2661;90;21196;3;90;40;0;14;14;0
2661;91;21210;3;91;300;0;129;100;29
2661;9;21264;3;9;2475;0;1062;1012;50
2801;10;21310;3;10;1595;0;681;611;70
2801;11;21306;3;11;53;0;21;19;2
2801;1;21303;3;1;2110;1;943;776;167
2801;1;21313;3;1;1721;0;1077;974;103
2801;1;21314;3;1;2265;0;868;868;0
2801;1;21317;3;1;1822;0;1018;842;176
2801;1;21318;3;1;2038;8;1205;999;206
2801;1;21324;3;1;1529;3;713;630;83
2801;12;21292;3;12;39;0;12;10;2
2801;13;21322;3;13;21;0;14;13;1
2801;2;21287;3;2;886;0;430;355;75
2801;2;21296;3;2;1285;0;610;556;54
2801;2;21298;3;2;1946;0;1149;1012;137
2801;2;21299;3;2;2082;0;841;841;0
2801;2;21309;3;2;981;0;560;497;63
2801;2;21320;3;2;1566;0;674;543;131
2801;3;21295;3;3;1911;9;1175;987;188
2801;3;21302;3;3;1576;0;779;698;81
2801;3;21304;3;3;385;0;180;155;25
2801;3;21311;3;3;2028;0;929;828;101
2801;3;21312;3;3;831;0;374;296;78
2801;4;21288;3;4;1514;0;660;554;106
2801;4;21291;3;4;646;0;358;318;40
2801;4;21300;3;4;825;0;360;299;61
2801;4;21307;3;4;889;3;571;486;85
2801;4;21321;3;4;2084;1;1012;909;103
2801;5;21289;3;5;2162;2;865;782;83
2801;5;21315;3;5;612;0;327;272;55
2801;5;21319;3;5;1078;0;505;417;88
2801;6;21293;3;6;516;0;258;228;30
2801;6;21301;3;6;615;1;270;240;30
2801;6;21305;3;6;2240;0;946;865;81
2801;7;21316;3;7;794;0;398;318;80
2801;7;21323;3;7;2322;4;1107;1015;92
2801;8;21294;3;8;1888;0;803;690;113
2801;8;21297;3;8;771;0;394;348;46
2801;9;21290;3;9;536;2;287;248;39
2801;9;21308;3;9;1944;0;879;806;73
2802;10;21330;3;10;26;0;20;19;1
2802;1;21327;3;1;1702;1;899;773;126
2802;1;21334;3;1;1043;2;675;588;87
2802;1;21337;3;1;2205;3;1337;1160;177
2802;1;21338;3;1;1035;0;487;436;51
2802;1;21343;3;1;1169;1;690;618;72
2802;1;21355;3;1;2054;4;1215;1078;137
2802;1;21358;3;1;1495;1;884;771;113
2802;2;21326;3;2;787;0;448;395;53
2802;2;21331;3;2;574;0;309;258;51
2802;2;21341;3;2;1014;0;527;469;58
2802;2;21347;3;2;567;0;277;231;46
2802;2;21354;3;2;712;0;396;297;99
2802;2;21356;3;2;1063;0;637;574;63
2802;2;21357;3;2;1630;2;901;819;82
2802;3;21325;3;3;1208;0;506;432;74
2802;3;21328;3;3;342;0;203;161;42
2802;3;21345;3;3;801;0;396;340;56
2802;3;21346;3;3;1710;1;917;790;127
2802;3;21348;3;3;1038;3;608;557;51
2802;3;21349;3;3;498;0;229;190;39
2802;4;21329;3;4;461;0;287;229;58
2802;4;21335;3;4;691;1;428;381;47
2802;4;21339;3;4;487;0;276;227;49
2802;4;21344;3;4;1705;0;819;819;0
2802;5;21333;3;5;1825;1;973;862;111
2802;5;21336;3;5;457;0;244;205;39
2802;5;21342;3;5;297;0;193;170;23
2802;6;21350;3;6;1905;0;978;867;111
2802;6;21353;3;6;391;0;237;195;42
2802;7;21332;3;7;1707;2;975;882;93
2802;7;21351;3;7;623;0;383;325;58
2802;8;21352;3;8;1963;3;1136;996;140
2802;9;21340;3;9;9;0;7;7;0
2803;10;21378;2;10;66;0;29;19;10
2803;10;21390;2;10;2032;0;921;752;169
2803;11;21382;2;11;2293;0;1025;934;91
2803;11;21395;2;11;534;0;256;210;46
2803;1;21362;2;1;565;0;387;275;112
2803;1;21364;2;1;1377;0;806;608;198
2803;1;21365;2;1;1785;0;984;930;54
2803;1;21377;2;1;809;2;482;384;98
2803;1;21381;2;1;2242;1;1139;987;152
2803;1;21403;2;1;404;0;279;237;42
2803;12;21359;2;12;2280;0;1070;946;124
2803;12;21402;2;12;499;0;193;167;26
2803;13;21384;2;13;29;0;14;13;1
2803;2;21375;2;2;1780;1;889;779;110
2803;2;21376;2;2;955;1;491;392;99
2803;2;21383;2;2;809;0;487;355;132
2803;2;21394;2;2;342;0;177;148;29
2803;2;21400;2;2;1011;0;465;392;73
2803;2;21406;2;2;1520;1;856;725;131
2803;3;21366;2;3;593;0;247;177;70
2803;3;21369;2;3;654;0;365;280;85
2803;3;21370;2;3;1239;1;674;584;90
2803;3;21372;2;3;732;0;443;324;119
2803;3;21380;2;3;781;0;468;367;101
2803;3;21393;2;3;1604;2;781;643;138
2803;4;21360;2;4;973;0;464;410;54
2803;4;21367;2;4;1176;0;689;580;109
2803;4;21368;2;4;637;0;262;219;43
2803;4;21396;2;4;532;0;288;218;70
2803;4;21397;2;4;1687;0;884;743;141
2803;4;21399;2;4;740;0;486;366;120
2803;5;21363;2;5;864;0;429;339;90
2803;5;21371;2;5;2145;0;1466;1108;358
2803;5;21385;2;5;829;0;383;334;49
2803;5;21387;2;5;948;1;421;351;70
2803;5;21388;2;5;1915;13;1147;861;286
2803;5;21405;2;5;604;0;294;229;65
2803;6;21373;2;6;1198;0;597;511;86
2803;6;21374;2;6;1428;0;557;424;133
2803;6;21379;2;6;521;0;248;209;39
2803;6;21407;2;6;634;0;386;288;98
2803;7;21391;2;7;616;0;258;228;30
2803;7;21392;2;7;733;0;355;282;73
2803;7;21401;2;7;903;0;445;401;44
2803;7;21404;2;7;474;0;308;218;90
2803;8;21361;2;8;883;1;410;342;68
2803;8;21386;2;8;624;0;338;275;63
2803;8;21398;2;8;905;0;403;348;55
2803;9;21389;2;9;1356;5;650;512;138
2803;9;21408;2;9;1992;0;888;746;142
2803;9;21409;2;9;526;0;245;212;33
2804;10;21413;3;10;1219;0;518;447;71
2804;11;21449;3;11;1353;0;546;462;84
2804;1;21417;3;1;581;0;235;204;31
2804;1;21424;3;1;847;1;419;346;73
2804;1;21425;3;1;1451;0;669;600;69
2804;1;21426;3;1;1472;1;963;758;205
2804;1;21429;3;1;2246;2;1098;943;155
2804;1;21441;3;1;1131;0;406;325;81
2804;1;21445;3;1;1174;1;636;549;87
2804;1;21446;3;1;1011;0;431;384;47
2804;1;21450;3;1;1615;4;1011;899;112
2804;12;21438;3;12;947;0;379;311;68
2804;13;21414;3;13;754;0;259;217;42
2804;14;21420;3;14;15;0;3;3;0
2804;2;21410;3;2;1033;5;594;489;105
2804;2;21415;3;2;1324;2;802;689;113
2804;2;21416;3;2;1013;0;534;471;63
2804;2;21423;3;2;1693;0;812;687;125
2804;2;21433;3;2;780;0;363;307;56
2804;2;21434;3;2;1173;0;535;496;39
2804;2;21439;3;2;1044;1;615;518;97
2804;2;21443;3;2;883;0;454;379;75
2804;2;21447;3;2;1024;0;445;371;74
2804;3;21411;3;3;835;1;370;303;67
2804;3;21430;3;3;1213;0;486;431;55
2804;3;21436;3;3;1393;1;686;577;109
2804;3;21437;3;3;1838;0;741;574;167
2804;3;21442;3;3;835;0;293;263;30
2804;3;21444;3;3;702;2;420;349;71
2804;3;21451;3;3;1168;5;612;546;66
2804;4;21419;3;4;2138;0;1053;901;152
2804;4;21427;3;4;1016;0;442;392;50
2804;4;21440;3;4;887;0;281;230;51
2804;5;21421;3;5;29;0;25;25;0
2804;5;21428;3;5;1209;0;522;452;70
2804;5;21448;3;5;544;2;301;254;47
2804;6;21412;3;6;1374;0;544;487;57
2804;6;21435;3;6;89;0;42;33;9
2804;7;21418;3;7;585;0;292;263;29
2804;7;21432;3;7;1347;0;527;472;55
2804;8;21422;3;8;1354;0;548;474;74
2804;9;21431;3;9;1381;0;513;447;66
2805;10;21477;4;10;2023;0;868;733;135
2805;11;21474;4;11;1471;0;612;551;61
2805;1;21465;4;1;1326;1;799;678;121
2805;1;21470;4;1;1939;0;1006;766;240
2805;1;21482;4;1;968;0;545;440;105
2805;1;21495;4;1;1026;0;385;327;58
2805;1;21499;4;1;1728;0;910;658;252
2805;12;21463;4;12;1645;0;697;632;65
2805;13;21459;4;13;1803;1;750;658;92
2805;14;21490;4;14;2234;0;969;852;117
2805;15;21457;4;15;1873;0;819;722;97
2805;16;21486;4;16;1182;0;493;435;58
2805;17;21503;4;17;1288;0;493;440;53
2805;18;21484;4;18;1664;1;604;524;80
2805;19;21493;4;19;2269;2;1064;953;111
2805;20;21468;4;20;1605;0;642;577;65
2805;21;21492;4;21;1449;0;650;565;85
2805;2;21466;4;2;1830;0;785;672;113
2805;2;21469;4;2;1474;0;793;640;153
2805;2;21478;4;2;735;0;312;238;74
2805;2;21494;4;2;736;1;394;301;93
2805;2;21496;4;2;907;0;550;460;90
2805;22;21501;4;22;1840;1;740;645;95
2805;23;21497;4;23;1033;1;434;377;57
2805;24;21500;4;24;1533;0;569;489;80
2805;25;21472;4;25;1339;0;528;434;94
2805;26;21488;4;26;1185;0;464;409;55
2805;27;21460;4;27;1231;0;558;484;74
2805;28;21476;4;28;1727;0;781;717;64
2805;29;21480;4;29;200;0;6;6;0
2805;30;21453;4;30;43;0;13;13;0
2805;3;21456;4;3;1111;0;719;628;91
2805;3;21464;4;3;415;0;206;161;45
2805;3;21471;4;3;492;0;256;189;67
2805;3;21487;4;3;1091;0;594;502;92
2805;3;21489;4;3;2141;0;871;740;131
2805;4;21454;4;4;2410;0;933;829;104
2805;4;21461;4;4;783;0;406;295;111
2805;4;21483;4;4;1039;0;571;439;132
2805;4;21491;4;4;1822;0;843;662;181
2805;5;21455;4;5;616;0;295;227;68
2805;5;21462;4;5;1729;0;808;657;151
2805;5;21473;4;5;1314;0;545;411;134
2805;5;21498;4;5;1656;0;677;605;72
2805;6;21458;4;6;1948;0;831;724;107
2805;6;21467;4;6;809;0;349;255;94
2805;6;21481;4;6;605;0;384;306;78
2805;7;21452;4;7;938;0;530;447;83
2805;7;21485;4;7;1654;0;635;534;101
2805;8;21475;4;8;179;0;50;44;6
2805;8;21479;4;8;1155;0;471;429;42
2805;9;21502;4;9;1568;1;693;638;55
2806;10;21511;4;10;2236;0;1047;970;77
2806;11;21525;4;11;2067;0;847;773;74
2806;1;21505;4;1;1189;0;677;574;103
2806;1;21513;4;1;702;0;375;319;56
2806;1;21522;4;1;2075;0;867;795;72
2806;1;21524;4;1;463;0;183;136;47
2806;1;21526;4;1;1338;0;753;613;140
2806;1;21530;4;1;1612;1;803;652;151
2806;12;21537;4;12;1219;0;526;485;41
2806;13;21510;4;13;12;0;12;8;4
2806;14;21540;4;14;43;0;27;26;1
2806;15;21544;4;15;114;0;82;60;22
2806;2;21515;4;2;548;0;248;215;33
2806;2;21519;4;2;1924;0;980;868;112
2806;2;21520;4;2;621;0;366;267;99
2806;2;21535;4;2;2098;1;1014;757;257
2806;2;21538;4;2;2192;0;1047;966;81
2806;2;21542;4;2;334;0;195;155;40
2806;3;21506;4;3;1195;0;634;509;125
2806;3;21514;4;3;366;0;160;137;23
2806;3;21517;4;3;662;0;252;204;48
2806;3;21527;4;3;348;0;194;163;31
2806;3;21532;4;3;2262;0;956;868;88
2806;3;21536;4;3;494;0;228;186;42
2806;4;21508;4;4;1060;0;482;438;44
2806;4;21516;4;4;1599;0;841;716;125
2806;4;21521;4;4;440;0;201;167;34
2806;4;21534;4;4;319;0;175;144;31
2806;4;21541;4;4;2242;2;1039;946;93
2806;5;21518;4;5;2214;1;978;890;88
2806;5;21523;4;5;410;0;223;182;41
2806;5;21531;4;5;1949;0;1129;1022;107
2806;5;21545;4;5;352;0;190;155;35
2806;6;21504;4;6;1033;0;558;458;100
2806;6;21507;4;6;404;1;233;188;45
2806;6;21543;4;6;2045;0;799;719;80
2806;7;21509;4;7;1652;1;720;648;72
2806;7;21533;4;7;510;0;263;225;38
2806;7;21539;4;7;20;0;19;18;1
2806;8;21512;4;8;1768;1;791;708;83
2806;8;21529;4;8;367;0;208;186;22
2806;9;21528;4;9;2076;0;858;798;60
2807;10;21547;2;10;851;2;532;427;105
2807;10;21579;2;10;633;0;278;252;26
2807;10;21606;2;10;2106;0;744;697;47
2807;11;21552;2;11;780;0;491;392;99
2807;11;21559;2;11;2163;0;843;792;51
2807;11;21568;2;11;685;0;372;293;79
2807;1;21555;2;1;2232;0;657;616;41
2807;1;21573;2;1;1884;2;1018;867;151
2807;1;21577;2;1;678;0;309;286;23
2807;1;21581;2;1;2235;0;1083;885;198
2807;1;21586;2;1;2011;2;1003;773;230
2807;1;21596;2;1;1041;1;573;471;102
2807;1;21597;2;1;1182;0;507;396;111
2807;12;21548;2;12;902;0;418;316;102
2807;12;21605;2;12;2286;0;776;717;59
2807;13;21562;2;13;1897;0;736;698;38
2807;14;21591;2;14;1479;2;494;452;42
2807;15;21572;2;15;1307;0;502;440;62
2807;16;21585;2;16;21;0;6;6;0
2807;17;21558;2;17;36;0;15;12;3
2807;2;21550;2;2;1418;0;548;469;79
2807;2;21565;2;2;1323;1;761;638;123
2807;2;21566;2;2;1851;0;685;643;42
2807;2;21569;2;2;1392;0;687;537;150
2807;2;21578;2;2;1558;0;801;637;164
2807;2;21584;2;2;1573;0;733;589;144
2807;2;21598;2;2;638;0;325;228;97
2807;3;21556;2;3;1577;4;953;850;103
2807;3;21570;2;3;428;0;185;140;45
2807;3;21575;2;3;1402;0;709;541;168
2807;3;21576;2;3;706;5;391;303;88
2807;3;21580;2;3;1786;0;731;670;61
2807;3;21582;2;3;1778;0;881;702;179
2807;3;21604;2;3;1213;0;580;458;122
2807;4;21551;2;4;718;0;342;263;79
2807;4;21557;2;4;902;0;391;327;64
2807;4;21560;2;4;585;0;275;205;70
2807;4;21561;2;4;1185;1;646;500;146
2807;4;21592;2;4;593;0;282;218;64
2807;4;21602;2;4;1976;0;891;711;180
2807;4;21607;2;4;918;0;420;387;33
2807;5;21590;2;5;876;0;336;289;47
2807;5;21599;2;5;516;0;249;212;37
2807;5;21600;2;5;1470;0;561;503;58
2807;5;21601;2;5;267;0;158;128;30
2807;5;21603;2;5;574;0;359;228;131
2807;6;21549;2;6;1743;0;795;746;49
2807;6;21567;2;6;639;0;255;206;49
2807;6;21583;2;6;1076;0;606;482;124
2807;6;21589;2;6;581;1;217;188;29
2807;6;21594;2;6;841;2;489;389;100
2807;7;21563;2;7;2099;0;633;578;55
2807;7;21571;2;7;1004;0;598;493;105
2807;7;21593;2;7;551;0;248;194;54
2807;7;21595;2;7;564;1;322;253;69
2807;8;21546;2;8;534;0;277;213;64
2807;8;21553;2;8;795;0;433;343;90
2807;8;21574;2;8;1348;0;551;497;54
2807;8;21587;2;8;1403;0;521;403;118
2807;9;21554;2;9;2013;0;738;679;59
2807;9;21564;2;9;957;0;453;387;66
2807;9;21588;2;9;574;0;344;267;77
2808;10;21622;4;10;1976;1;890;784;106
2808;10;21634;4;10;359;0;147;103;44
2808;11;21608;4;11;1548;0;721;637;84
2808;11;21619;4;11;368;0;177;136;41
2808;1;21616;4;1;1686;3;1002;854;148
2808;1;21620;4;1;1916;4;920;782;138
2808;1;21635;4;1;1415;0;644;577;67
2808;1;21637;4;1;309;0;137;100;37
2808;1;21639;4;1;239;0;126;91;35
2808;1;21646;4;1;1528;0;681;557;124
2808;12;21647;4;12;2178;0;1037;927;110
2808;13;21640;4;13;904;0;370;332;38
2808;14;21629;4;14;1440;0;712;630;82
2808;15;21630;4;15;59;0;25;11;14
2808;16;21631;4;16;20;0;9;9;0
2808;2;21610;4;2;1917;1;924;832;92
2808;2;21624;4;2;788;0;366;292;74
2808;2;21626;4;2;2341;1;1098;916;182
2808;2;21632;4;2;519;0;229;178;51
2808;2;21645;4;2;745;0;311;252;59
2808;2;21648;4;2;959;0;501;409;92
2808;3;21621;4;3;1372;0;672;566;106
2808;3;21636;4;3;914;1;407;331;76
2808;3;21644;4;3;1773;1;863;731;132
2808;3;21650;4;3;897;0;418;371;47
2808;3;21652;4;3;1782;0;994;851;143
2808;3;21655;4;3;1044;0;582;494;88
2808;4;21613;4;4;1726;0;857;774;83
2808;4;21623;4;4;1409;0;633;541;92
2808;4;21643;4;4;523;0;245;194;51
2808;4;21649;4;4;681;0;344;276;68
2808;4;21651;4;4;1167;2;531;430;101
2808;4;21653;4;4;376;0;175;157;18
2808;5;21611;4;5;2092;0;928;809;119
2808;5;21612;4;5;539;0;271;239;32
2808;5;21627;4;5;422;0;186;147;39
2808;5;21628;4;5;865;1;473;400;73
2808;5;21656;4;5;1507;2;711;556;155
2808;6;21618;4;6;1824;1;829;718;111
2808;6;21625;4;6;1010;0;407;320;87
2808;6;21641;4;6;404;0;182;144;38
2808;6;21654;4;6;914;0;469;383;86
2808;7;21614;4;7;759;0;270;223;47
2808;7;21615;4;7;985;0;468;353;115
2808;7;21633;4;7;7;0;2;2;0
2808;7;21657;4;7;1937;0;982;900;82
2808;8;21609;4;8;965;1;468;415;53
2808;8;21642;4;8;1535;2;673;598;75
2808;9;21617;4;9;1354;1;512;461;51
2808;9;21638;4;9;774;0;359;313;46
2809;1;21664;3;1;2202;0;944;888;56
2809;1;21668;3;1;1988;5;1029;882;147
2809;1;21673;3;1;1195;0;641;557;84
2809;1;21674;3;1;1700;0;707;553;154
2809;1;21675;3;1;725;0;512;440;72
2809;2;21667;3;2;509;0;212;166;46
2809;2;21677;3;2;896;0;589;484;105
2809;2;21681;3;2;1894;1;1097;974;123
2809;2;21684;3;2;815;0;418;357;61
2809;2;21685;3;2;2227;0;1056;1009;47
2809;3;21663;3;3;1349;1;707;589;118
2809;3;21666;3;3;606;0;364;313;51
2809;3;21672;3;3;1381;1;569;527;42
2809;3;21676;3;3;693;0;287;236;51
2809;3;21680;3;3;712;0;404;362;42
2809;4;21665;3;4;1537;0;683;629;54
2809;4;21683;3;4;1542;0;773;667;106
2809;4;21686;3;4;916;0;503;462;41
2809;4;21689;3;4;593;0;381;324;57
2809;5;21658;3;5;659;0;336;291;45
2809;5;21661;3;5;1778;0;862;686;176
2809;5;21678;3;5;1203;0;503;465;38
2809;6;21669;3;6;701;1;403;341;62
2809;6;21671;3;6;907;0;483;454;29
2809;6;21687;3;6;336;0;174;144;30
2809;7;21659;3;7;528;0;282;237;45
2809;7;21679;3;7;1752;0;780;736;44
2809;7;21682;3;7;286;0;157;142;15
2809;8;21660;3;8;468;0;222;188;34
2809;8;21662;3;8;553;1;261;205;56
2809;8;21670;3;8;2243;0;1054;977;77
2809;9;21688;3;9;13;0;7;3;4
2810;10;21714;5;10;1708;0;743;659;84
2810;11;21716;5;11;2210;1;1086;964;122
2810;1;21698;5;1;1944;0;1001;830;171
2810;1;21700;5;1;1405;1;768;638;130
2810;1;21715;5;1;1236;0;619;555;64
2810;1;21718;5;1;2096;0;1020;855;165
2810;1;21723;5;1;1474;1;998;831;167
2810;12;21709;5;12;15;0;5;5;0
2810;2;21701;5;2;1995;2;1127;961;166
2810;2;21704;5;2;578;0;244;197;47
2810;2;21713;5;2;1175;7;802;611;191
2810;2;21720;5;2;1549;0;813;736;77
2810;2;21721;5;2;2100;1;1055;888;167
2810;3;21695;5;3;1579;0;785;707;78
2810;3;21696;5;3;725;0;481;394;87
2810;3;21697;5;3;1523;0;657;546;111
2810;3;21705;5;3;419;2;216;170;46
2810;3;21707;5;3;1225;0;620;497;123
2810;4;21690;5;4;1229;0;505;440;65
2810;4;21706;5;4;354;2;227;169;58
2810;4;21710;5;4;1283;0;631;567;64
2810;4;21712;5;4;380;0;276;202;74
2810;4;21719;5;4;622;0;268;225;43
2810;5;21691;5;5;777;0;412;309;103
2810;5;21693;5;5;1184;1;656;510;146
2810;5;21702;5;5;1034;0;506;451;55
2810;5;21711;5;5;812;0;378;294;84
2810;6;21692;5;6;2104;1;909;800;109
2810;6;21699;5;6;434;0;228;177;51
2810;6;21717;5;6;59;0;41;23;18
2810;7;21694;5;7;432;0;221;189;32
2810;7;21703;5;7;2112;0;1035;939;96
2810;8;21722;5;8;1195;0;559;526;33
2810;9;21708;5;9;2053;0;971;877;94
2811;10;21747;5;10;845;0;427;368;59
2811;11;21745;5;11;641;0;354;258;96
2811;1;21725;5;1;2188;0;1128;1024;104
2811;1;21730;5;1;1686;0;1096;944;152
2811;1;21735;5;1;608;9;498;392;106
2811;1;21740;5;1;646;4;394;300;94
2811;12;21724;5;12;421;0;295;236;59
2811;13;21752;5;13;701;0;319;249;70
2811;14;21732;5;14;1300;0;591;494;97
2811;15;21739;5;15;27;0;7;7;0
2811;2;21726;5;2;742;1;430;348;82
2811;2;21737;5;2;424;7;324;262;62
2811;2;21738;5;2;720;0;463;356;107
2811;2;21749;5;2;1743;0;947;858;89
2811;3;21733;5;3;366;3;261;184;77
2811;3;21741;5;3;387;0;248;176;72
2811;3;21742;5;3;521;17;402;325;77
2811;3;21751;5;3;1066;1;535;470;65
2811;4;21729;5;4;2331;2;1238;1112;126
2811;4;21744;5;4;477;2;289;237;52
2811;4;21748;5;4;726;12;526;409;117
2811;4;21750;5;4;1185;0;726;555;171
2811;5;21727;5;5;896;1;549;411;138
2811;5;21736;5;5;449;2;320;206;114
2811;5;21743;5;5;1297;1;642;553;89
2811;6;21746;5;6;1651;0;864;793;71
2811;7;21731;5;7;1615;2;821;736;85
2811;8;21728;5;8;1234;0;646;527;119
2811;9;21734;5;9;286;1;161;136;25
2812;1;21756;2;1;1099;0;493;421;72
2812;1;21759;2;1;1188;0;617;534;83
2812;1;21769;2;1;871;0;492;423;69
2812;1;21771;2;1;2095;0;1129;965;164
2812;1;21778;2;1;1622;0;1023;860;163
2812;2;21758;2;2;1188;0;600;503;97
2812;2;21765;2;2;1449;0;677;591;86
2812;2;21766;2;2;1205;0;574;510;64
2812;2;21776;2;2;450;0;242;214;28
2812;2;21779;2;2;1414;0;724;607;117
2812;3;21753;2;3;405;0;254;203;51
2812;3;21755;2;3;1450;0;695;651;44
2812;3;21777;2;3;1030;0;428;371;57
2812;3;21780;2;3;1907;0;933;830;103
2812;3;21781;2;3;935;0;475;422;53
2812;4;21760;2;4;1784;0;821;738;83
2812;4;21763;2;4;736;0;389;302;87
2812;4;21764;2;4;820;0;372;348;24
2812;4;21767;2;4;1372;0;661;582;79
2812;4;21772;2;4;681;0;358;320;38
2812;5;21754;2;5;439;0;226;197;29
2812;5;21761;2;5;1109;1;505;444;61
2812;5;21762;2;5;1136;0;610;522;88
2812;5;21774;2;5;1477;0;748;653;95
2812;5;21775;2;5;821;0;303;257;46
2812;6;21757;2;6;1645;0;696;606;90
2812;6;21768;2;6;738;0;316;267;49
2812;6;21770;2;6;1290;1;780;682;98
2812;6;21783;2;6;740;0;428;386;42
2812;7;21773;2;7;599;0;338;298;40
2812;7;21782;2;7;702;0;402;351;51
2813;10;21803;4;10;1855;0;623;549;74
2813;11;21787;4;11;571;0;238;215;23
2813;1;21786;4;1;518;0;133;96;37
2813;1;21798;4;1;1585;1;816;725;91
2813;1;21804;4;1;1574;0;732;635;97
2813;1;21809;4;1;1127;0;738;604;134
2813;12;21808;4;12;712;0;382;333;49
2813;13;21801;4;13;952;0;357;312;45
2813;14;21805;4;14;27;0;7;5;2
2813;15;21799;4;15;26;0;7;6;1
2813;2;21788;4;2;391;0;208;170;38
2813;2;21789;4;2;1601;0;748;682;66
2813;2;21793;4;2;419;0;167;144;23
2813;2;21807;4;2;1982;1;776;580;196
2813;3;21784;4;3;360;0;150;122;28
2813;3;21795;4;3;1656;0;769;675;94
2813;3;21797;4;3;661;0;361;262;99
2813;3;21800;4;3;1053;0;299;247;52
2813;4;21790;4;4;454;0;180;152;28
2813;4;21794;4;4;1649;1;713;643;70
2813;4;21802;4;4;766;0;220;182;38
2813;4;21806;4;4;541;0;277;217;60
2813;5;21792;4;5;1133;0;598;554;44
2813;5;21810;4;5;444;0;159;144;15
2813;6;21785;4;6;1375;0;647;607;40
2813;7;21796;4;7;1824;2;805;757;48
2813;8;21791;4;8;629;2;261;222;39
2813;9;21811;4;9;1796;0;721;637;84
2814;10;21829;1;10;996;0;436;377;59
2814;10;21838;1;10;886;0;345;306;39
2814;10;21849;1;10;390;0;178;142;36
2814;10;21893;1;10;721;0;275;217;58
2814;11;21822;1;11;488;0;161;139;22
2814;11;21837;1;11;472;0;198;170;28
2814;11;21871;1;11;842;0;351;268;83
2814;11;21918;1;11;412;0;151;127;24
2814;1;21825;1;1;1677;0;834;742;92
2814;1;21826;1;1;1640;0;672;530;142
2814;1;21851;1;1;1207;1;601;553;48
2814;1;21862;1;1;703;0;385;314;71
2814;1;21863;1;1;2237;0;1280;1166;114
2814;1;21866;1;1;841;0;427;392;35
2814;1;21873;1;1;1252;1;655;525;130
2814;1;21876;1;1;1073;2;622;486;136
2814;1;21883;1;1;2010;0;940;862;78
2814;1;21885;1;1;866;0;413;364;49
2814;1;21904;1;1;1388;0;671;573;98
2814;1;21908;1;1;1935;6;1151;986;165
2814;12;21836;1;12;334;0;129;107;22
2814;12;21852;1;12;558;0;187;172;15
2814;12;21884;1;12;625;0;287;251;36
2814;12;21895;1;12;116;0;49;34;15
2814;13;21839;1;13;521;0;180;163;17
2814;13;21916;1;13;336;0;161;137;24
2814;13;21917;1;13;355;0;67;52;15
2814;14;21894;1;14;507;0;171;149;22
2814;14;21896;1;14;515;0;193;162;31
2814;14;21919;1;14;409;0;164;137;27
2814;15;21812;1;15;385;0;136;115;21
2814;15;21828;1;15;1028;0;522;482;40
2814;15;21888;1;15;862;0;356;299;57
2814;16;21841;1;16;456;2;189;172;17
2814;16;21856;1;16;576;0;172;158;14
2814;16;21891;1;16;952;1;352;311;41
2814;17;21832;1;17;17;0;8;7;1
2814;17;21850;1;17;27;0;11;6;5
2814;17;21853;1;17;314;0;200;176;24
2814;18;21818;1;18;25;0;11;9;2
2814;18;21859;1;18;15;0;15;6;9
2814;2;21814;1;2;928;0;509;418;91
2814;2;21830;1;2;872;0;367;304;63
2814;2;21840;1;2;1170;0;404;341;63
2814;2;21848;1;2;1374;0;611;547;64
2814;2;21868;1;2;1619;0;771;655;116
2814;2;21869;1;2;1326;0;656;520;136
2814;2;21872;1;2;459;0;216;159;57
2814;2;21875;1;2;1227;0;598;531;67
2814;2;21897;1;2;1275;1;609;540;69
2814;2;21905;1;2;834;0;417;321;96
2814;2;21913;1;2;275;0;75;63;12
2814;2;21920;1;2;1398;1;682;607;75
2814;3;21831;1;3;880;1;480;386;94
2814;3;21833;1;3;589;0;273;217;56
2814;3;21843;1;3;1660;0;750;632;118
2814;3;21845;1;3;787;0;373;280;93
2814;3;21846;1;3;794;0;405;336;69
2814;3;21858;1;3;821;0;440;359;81
2814;3;21864;1;3;385;0;187;145;42
2814;3;21878;1;3;2004;1;948;820;128
2814;3;21879;1;3;1388;1;683;621;62
2814;3;21903;1;3;1253;0;570;524;46
2814;3;21907;1;3;1688;0;683;622;61
2814;3;21910;1;3;1133;1;631;547;84
2814;4;21816;1;4;1116;0;506;421;85
2814;4;21842;1;4;128;0;36;31;5
2814;4;21844;1;4;1504;0;743;700;43
2814;4;21854;1;4;1246;0;573;477;96
2814;4;21860;1;4;935;0;410;362;48
2814;4;21880;1;4;731;0;355;286;69
2814;4;21881;1;4;1046;2;555;474;81
2814;4;21898;1;4;1237;0;526;408;118
2814;4;21899;1;4;1754;1;736;568;168
2814;4;21909;1;4;377;0;172;148;24
2814;4;21911;1;4;1646;0;504;449;55
2814;5;21813;1;5;468;0;273;208;65
2814;5;21823;1;5;769;0;315;290;25
2814;5;21824;1;5;1632;0;783;734;49
2814;5;21835;1;5;1418;0;607;512;95
2814;5;21857;1;5;48;0;24;18;6
2814;5;21877;1;5;1865;0;787;730;57
2814;5;21889;1;5;893;0;331;285;46
2814;5;21900;1;5;51;0;26;21;5
2814;5;21912;1;5;701;0;330;310;20
2814;5;21914;1;5;1819;2;857;727;130
2814;6;21819;1;6;589;0;289;243;46
2814;6;21820;1;6;2057;1;1022;952;70
2814;6;21821;1;6;1291;1;707;657;50
2814;6;21861;1;6;301;0;137;102;35
2814;6;21870;1;6;236;0;84;57;27
2814;6;21874;1;6;666;0;253;195;58
2814;6;21882;1;6;381;0;202;166;36
2814;6;21892;1;6;477;0;195;166;29
2814;7;21817;1;7;1362;0;741;665;76
2814;7;21827;1;7;987;0;359;307;52
2814;7;21855;1;7;107;0;61;43;18
2814;7;21887;1;7;1100;0;400;366;34
2814;7;21901;1;7;315;0;192;152;40
2814;7;21902;1;7;466;0;183;149;34
2814;8;21815;1;8;749;0;287;235;52
2814;8;21834;1;8;819;0;460;421;39
2814;8;21865;1;8;499;0;195;140;55
2814;8;21886;1;8;326;0;186;169;17
2814;8;21906;1;8;449;0;204;168;36
2814;9;21847;1;9;337;0;156;132;24
2814;9;21867;1;9;595;0;192;162;30
2814;9;21890;1;9;752;0;313;244;69
2814;9;21915;1;9;611;0;208;194;14
2815;10;21934;2;10;394;0;184;152;32
2815;10;21938;2;10;519;0;328;279;49
2815;10;21990;2;10;1827;1;745;660;85
2815;11;21922;2;11;658;0;359;298;61
2815;11;21924;2;11;591;0;364;301;63
2815;11;21926;2;11;1237;0;557;512;45
2815;1;21944;2;1;1507;1;949;792;157
2815;1;21948;2;1;1245;0;596;527;69
2815;1;21952;2;1;931;0;385;339;46
2815;1;21959;2;1;2219;7;1327;956;371
2815;1;21977;2;1;2199;0;1159;971;188
2815;1;21983;2;1;1460;5;716;548;168
2815;1;21984;2;1;2007;0;991;881;110
2815;1;21988;2;1;963;3;503;416;87
2815;1;21994;2;1;831;0;433;392;41
2815;12;21955;2;12;549;0;282;240;42
2815;12;21958;2;12;1224;0;536;477;59
2815;12;21968;2;12;672;0;323;246;77
2815;13;21953;2;13;796;0;389;273;116
2815;13;21979;2;13;842;0;493;388;105
2815;13;21985;2;13;1773;0;867;775;92
2815;14;21933;2;14;456;0;277;207;70
2815;14;21965;2;14;1563;0;770;677;93
2815;14;21981;2;14;435;0;268;220;48
2815;15;21961;2;15;1708;0;756;695;61
2815;15;21982;2;15;897;0;371;319;52
2815;15;21997;2;15;540;0;357;310;47
2815;16;21943;2;16;1190;0;637;482;155
2815;16;21976;2;16;1649;0;756;679;77
2815;17;21942;2;17;877;0;491;408;83
2815;17;21966;2;17;1524;0;694;620;74
2815;18;21969;2;18;1371;0;685;570;115
2815;18;21974;2;18;23;0;3;3;0
2815;19;21975;2;19;701;0;427;382;45
2815;20;21945;2;20;37;0;24;20;4
2815;2;21921;2;2;2285;3;1114;900;214
2815;2;21923;2;2;1396;2;727;579;148
2815;2;21947;2;2;374;0;159;124;35
2815;2;21950;2;2;926;0;457;394;63
2815;2;21956;2;2;1439;0;516;431;85
2815;2;21960;2;2;1933;0;934;884;50
2815;2;21962;2;2;323;0;227;162;65
2815;2;21986;2;2;860;0;475;319;156
2815;2;21993;2;2;1130;0;533;414;119
2815;3;21927;2;3;1615;1;689;607;82
2815;3;21929;2;3;921;0;448;352;96
2815;3;21932;2;3;389;0;225;194;31
2815;3;21936;2;3;937;0;401;332;69
2815;3;21941;2;3;1043;0;627;475;152
2815;3;21951;2;3;1907;5;1141;933;208
2815;3;21954;2;3;1573;0;732;659;73
2815;3;21970;2;3;985;0;428;347;81
2815;3;21992;2;3;877;0;399;346;53
2815;4;21931;2;4;1619;1;641;563;78
2815;4;21937;2;4;1092;0;473;380;93
2815;4;21940;2;4;342;0;144;103;41
2815;4;21949;2;4;568;0;308;237;71
2815;4;21957;2;4;700;0;395;317;78
2815;4;21987;2;4;947;0;426;344;82
2815;4;21991;2;4;574;0;322;265;57
2815;4;21996;2;4;1145;0;577;516;61
2815;5;21928;2;5;301;0;141;118;23
2815;5;21967;2;5;1955;0;712;613;99
2815;5;21973;2;5;1962;0;989;907;82
2815;5;21989;2;5;608;2;352;299;53
2815;6;21935;2;6;1002;0;418;353;65
2815;6;21946;2;6;1202;1;668;616;52
2815;6;21971;2;6;1497;0;661;611;50
2815;7;21930;2;7;1188;0;478;421;57
2815;7;21939;2;7;753;1;413;358;55
2815;7;21972;2;7;705;0;369;329;40
2815;8;21925;2;8;901;0;428;378;50
2815;8;21963;2;8;1620;0;752;691;61
2815;8;21995;2;8;2001;2;1076;966;110
2815;9;21964;2;9;1952;2;738;660;78
2815;9;21978;2;9;491;0;293;225;68
2815;9;21980;2;9;1207;1;693;584;109
2816;10;22006;5;10;1601;1;905;840;65
2816;11;22039;5;11;1790;0;970;873;97
2816;1;22007;5;1;1417;1;841;763;78
2816;1;22013;5;1;1514;1;716;638;78
2816;1;22017;5;1;886;3;518;457;61
2816;1;22036;5;1;844;0;473;431;42
2816;12;22001;5;12;2187;1;1218;1114;104
2816;13;22030;5;13;1678;0;918;849;69
2816;14;22011;5;14;1682;0;946;852;94
2816;15;22031;5;15;1722;0;922;822;100
2816;16;22015;5;16;1555;1;886;832;54
2816;17;22033;5;17;1550;0;875;779;96
2816;18;22035;5;18;37;0;18;15;3
2816;2;21999;5;2;1950;0;1199;1076;123
2816;2;22005;5;2;1140;2;651;537;114
2816;2;22038;5;2;1806;0;957;835;122
2816;2;22040;5;2;358;0;207;189;18
2816;3;22014;5;3;618;0;365;339;26
2816;3;22025;5;3;1410;0;800;707;93
2816;3;22027;5;3;1052;5;568;488;80
2816;3;22034;5;3;489;0;319;272;47
2816;4;22008;5;4;946;4;502;415;87
2816;4;22023;5;4;544;0;264;212;52
2816;4;22024;5;4;673;0;334;306;28
2816;4;22037;5;4;1837;0;1039;893;146
2816;5;22018;5;5;510;0;274;225;49
2816;5;22019;5;5;981;0;431;366;65
2816;5;22022;5;5;705;0;425;372;53
2816;5;22026;5;5;852;5;496;427;69
2816;6;22003;5;6;482;0;277;243;34
2816;6;22012;5;6;1795;2;1109;898;211
2816;6;22029;5;6;498;0;246;201;45
2816;6;22032;5;6;567;0;309;268;41
2816;7;22000;5;7;759;0;374;328;46
2816;7;22002;5;7;325;0;195;157;38
2816;7;22004;5;7;463;0;194;167;27
2816;7;22016;5;7;829;0;492;434;58
2816;8;21998;5;8;1132;0;634;505;129
2816;8;22009;5;8;1828;1;1073;998;75
2816;8;22010;5;8;31;0;23;16;7
2816;8;22028;5;8;460;0;161;147;14
2816;9;22020;5;9;877;0;447;380;67
2816;9;22021;5;9;1976;0;1137;1016;121
2817;10;22092;5;10;2204;0;1185;1048;137
2817;10;22096;5;10;419;1;290;213;77
2817;11;22073;5;11;1682;2;912;819;93
2817;1;22058;5;1;1014;3;461;341;120
2817;1;22060;5;1;910;0;472;378;94
2817;1;22063;5;1;1510;0;780;700;80
2817;1;22067;5;1;1781;0;1204;930;274
2817;1;22069;5;1;977;3;581;448;133
2817;1;22075;5;1;2105;1;1318;1062;256
2817;1;22082;5;1;1335;0;638;494;144
2817;1;22088;5;1;1742;0;897;692;205
2817;12;22070;5;12;1185;0;629;549;80
2817;13;22084;5;13;1848;2;960;810;150
2817;14;22046;5;14;105;0;86;64;22
2817;15;22056;5;15;33;0;19;12;7
2817;16;22074;5;16;22;0;15;12;3
2817;2;22041;5;2;1761;3;965;874;91
2817;2;22044;5;2;1163;0;698;553;145
2817;2;22048;5;2;1070;0;441;325;116
2817;2;22053;5;2;480;0;335;248;87
2817;2;22057;5;2;1215;0;530;414;116
2817;2;22068;5;2;1673;3;857;692;165
2817;2;22072;5;2;568;0;275;204;71
2817;2;22081;5;2;906;0;475;389;86
2817;3;22047;5;3;1629;0;887;809;78
2817;3;22050;5;3;613;0;334;237;97
2817;3;22066;5;3;1413;0;761;669;92
2817;3;22083;5;3;941;0;526;418;108
2817;3;22090;5;3;1422;0;640;493;147
2817;3;22091;5;3;685;1;318;261;57
2817;3;22093;5;3;560;0;343;251;92
2817;3;22095;5;3;680;0;274;200;74
2817;4;22054;5;4;468;0;159;121;38
2817;4;22055;5;4;813;1;375;339;36
2817;4;22059;5;4;680;0;398;323;75
2817;4;22079;5;4;293;0;142;130;12
2817;4;22085;5;4;1764;0;951;857;94
2817;4;22087;5;4;829;0;365;287;78
2817;4;22097;5;4;327;0;207;153;54
2817;5;22042;5;5;1081;4;613;533;80
2817;5;22049;5;5;1413;0;780;694;86
2817;5;22051;5;5;373;0;217;182;35
2817;5;22062;5;5;411;1;199;144;55
2817;5;22076;5;5;550;0;319;255;64
2817;5;22086;5;5;585;0;356;249;107
2817;5;22089;5;5;791;0;363;279;84
2817;6;22043;5;6;11;0;11;7;4
2817;6;22045;5;6;1205;1;709;369;340
2817;6;22052;5;6;670;0;427;352;75
2817;6;22077;5;6;442;0;216;177;39
2817;6;22094;5;6;1924;1;1014;854;160
2817;7;22065;5;7;679;0;357;272;85
2817;7;22071;5;7;956;0;532;464;68
2817;8;22061;5;8;692;0;343;289;54
2817;8;22080;5;8;1144;0;582;472;110
2817;9;22064;5;9;1467;1;806;652;154
2817;9;22078;5;9;1149;0;701;545;156
2818;10;22101;4;10;1426;0;667;613;54
2818;11;22109;4;11;1325;0;636;609;27
2818;1;22105;4;1;1942;9;1106;914;192
2818;1;22113;4;1;1214;0;685;542;143
2818;1;22114;4;1;562;0;266;213;53
2818;12;22111;4;12;1976;0;911;833;78
2818;13;22108;4;13;1992;1;886;802;84
2818;14;22102;4;14;1426;0;793;735;58
2818;15;22115;4;15;33;0;13;11;2
2818;2;22103;4;2;560;1;311;218;93
2818;2;22110;4;2;1056;0;503;390;113
2818;2;22117;4;2;1061;0;558;457;101
2818;3;22104;4;3;352;0;213;163;50
2818;3;22106;4;3;843;1;475;388;87
2818;3;22112;4;3;559;0;289;255;34
2818;4;22099;4;4;427;0;231;205;26
2818;5;22100;4;5;695;0;338;277;61
2818;6;22098;4;6;621;0;304;256;48
2818;7;22118;4;7;1183;0;605;539;66
2818;8;22116;4;8;1458;0;680;646;34
2818;9;22107;4;9;1243;0;636;571;65
2819;10;22133;4;10;1830;0;721;607;114
2819;11;22121;4;11;230;0;51;31;20
2819;1;22123;4;1;1445;0;572;530;42
2819;1;22134;4;1;955;1;554;451;103
2819;1;22136;4;1;902;1;584;465;119
2819;12;22126;4;12;9;0;3;3;0
2819;13;22135;4;13;16;0;6;6;0
2819;2;22128;4;2;720;0;363;296;67
2819;2;22130;4;2;652;1;337;269;68
2819;2;22132;4;2;1946;0;816;750;66
2819;3;22124;4;3;616;1;340;308;32
2819;3;22129;4;3;1182;0;657;532;125
2819;3;22131;4;3;1100;0;425;383;42
2819;4;22119;4;4;2101;0;796;711;85
2819;4;22138;4;4;360;0;204;178;26
2819;5;22122;4;5;1816;0;722;645;77
2819;6;22127;4;6;1051;0;320;277;43
2819;7;22137;4;7;1012;0;394;333;61
2819;8;22125;4;8;774;0;258;222;36
2819;9;22120;4;9;861;0;269;233;36
2861;10;22140;3;10;1545;0;616;595;21
2861;11;22166;3;11;1756;0;652;624;28
2861;1;22142;3;1;2051;0;768;727;41
2861;12;22177;3;12;2211;1;794;758;36
2861;13;22163;3;13;2202;0;886;842;44
2861;14;22149;3;14;2106;0;814;774;40
2861;15;22154;3;15;2007;0;676;631;45
2861;16;22139;3;16;2079;0;756;718;38
2861;17;22195;3;17;1326;0;515;492;23
2861;18;22141;3;18;1987;0;699;651;48
2861;19;22191;3;19;1881;1;756;710;46
2861;20;22145;3;20;1877;0;676;640;36
2861;21;22183;3;21;2050;0;710;670;40
2861;2;22196;3;2;1976;0;822;757;65
2861;22;22179;3;22;2317;2;765;729;36
2861;23;22188;3;23;1767;1;657;620;37
2861;24;22146;3;24;2093;0;811;762;49
2861;25;22185;3;25;1992;0;606;570;36
2861;26;22186;3;26;1815;0;738;700;38
2861;27;22169;3;27;1881;0;693;658;35
2861;28;22156;3;28;1640;0;745;713;32
2861;29;22161;3;29;1477;0;538;502;36
2861;30;22176;3;30;68;0;33;28;5
2861;31;22199;3;31;1674;0;622;591;31
2861;3;22168;3;3;1458;0;602;562;40
2861;32;22193;3;32;1457;0;560;528;32
2861;33;22144;3;33;1853;0;713;689;24
2861;34;22162;3;34;1545;0;563;530;33
2861;35;22192;3;35;2264;0;867;836;31
2861;36;22189;3;36;1481;0;551;520;31
2861;37;22198;3;37;1848;0;722;694;28
2861;38;22153;3;38;2171;0;883;826;57
2861;39;22160;3;39;2157;0;834;787;47
2861;40;22165;3;40;1551;0;607;571;36
2861;41;22184;3;41;1288;0;539;522;17
2861;4;22182;3;4;2115;0;773;738;35
2861;42;22187;3;42;1988;0;853;820;33
2861;43;22155;3;43;1913;0;573;515;58
2861;44;22159;3;44;1359;1;559;535;24
2861;45;22200;3;45;1770;0;668;629;39
2861;46;22148;3;46;1904;0;467;418;49
2861;47;22178;3;47;1062;0;352;329;23
2861;48;22151;3;48;2082;0;711;664;47
2861;49;22150;3;49;1959;0;700;700;0
2861;50;22190;3;50;1506;0;400;367;33
2861;51;22158;3;51;1948;0;715;676;39
2861;5;22147;3;5;1940;0;785;760;25
2861;52;22175;3;52;1441;0;489;453;36
2861;53;22194;3;53;1518;0;444;420;24
2861;54;22152;3;54;2153;0;850;789;61
2861;55;22197;3;55;1630;0;611;565;46
2861;56;22157;3;56;1905;0;662;619;43
2861;57;22173;3;57;1464;0;568;540;28
2861;58;22167;3;58;113;0;33;30;3
2861;59;22164;3;59;50;0;13;11;2
2861;60;22171;3;60;72;0;28;24;4
2861;61;22174;3;61;10;0;6;6;0
2861;6;22172;3;6;1943;0;766;737;29
2861;62;22180;3;62;115;0;52;48;4
2861;7;22170;3;7;863;0;205;194;11
2861;8;22181;3;8;1125;0;348;323;25
2861;9;22143;3;9;497;0;211;190;21
2862;10;22220;1;10;2221;1;1017;972;45
2862;11;22294;1;11;1590;0;680;641;39
2862;1;22223;1;1;1028;0;396;360;36
2862;12;22283;1;12;1848;0;773;727;46
2862;13;22286;1;13;1557;1;748;692;56
2862;14;22288;1;14;1357;0;597;548;49
2862;15;22269;1;15;1904;1;890;836;54
2862;16;22284;1;16;2065;0;1001;956;45
2862;17;22256;1;17;1905;1;1042;1002;40
2862;18;22285;1;18;1492;0;930;907;23
2862;19;22254;1;19;2354;0;1232;1165;67
2862;20;22292;1;20;2460;0;1324;1256;68
2862;21;22237;1;21;1816;0;972;934;38
2862;22;22264;1;22;621;0;362;331;31
2862;2;22228;1;2;676;0;315;292;23
2862;23;22221;1;23;1435;1;615;582;33
2862;24;22289;1;24;1176;0;583;552;31
2862;25;22233;1;25;945;0;356;330;26
2862;26;22276;1;26;1105;0;476;451;25
2862;27;22279;1;27;1419;1;525;490;35
2862;28;22262;1;28;1394;0;640;614;26
2862;29;22227;1;29;1511;0;661;619;42
2862;30;22241;1;30;1536;0;731;707;24
2862;31;22244;1;31;1683;0;776;731;45
2862;32;22224;1;32;1229;0;581;538;43
2862;3;22240;1;3;858;0;398;373;25
2862;33;22248;1;33;1252;0;430;396;34
2862;34;22287;1;34;1298;0;606;575;31
2862;35;22250;1;35;1375;0;645;607;38
2862;36;22213;1;36;1568;0;770;722;48
2862;37;22225;1;37;1113;0;505;485;20
2862;38;22229;1;38;1710;0;788;741;47
2862;39;22230;1;39;1704;0;813;769;44
2862;40;22266;1;40;1726;0;739;699;40
2862;41;22203;1;41;1268;0;570;545;25
2862;4;22201;1;4;1129;0;578;549;29
2862;42;22205;1;42;1497;0;657;607;50
2862;43;22246;1;43;1626;0;687;635;52
2862;44;22267;1;44;2269;0;941;888;53
2862;45;22236;1;45;1722;0;843;784;59
2862;46;22257;1;46;2268;0;1096;1037;59
2862;47;22207;1;47;1828;0;878;821;57
2862;48;22268;1;48;2443;0;1132;1078;54
2862;49;22231;1;49;1825;1;884;827;57
2862;50;22245;1;50;2153;0;1014;946;68
2862;51;22291;1;51;1360;0;617;579;38
2862;5;22204;1;5;1299;1;588;552;36
2862;52;22275;1;52;1824;0;808;760;48
2862;53;22210;1;53;1241;0;572;551;21
2862;54;22218;1;54;1344;0;605;574;31
2862;55;22251;1;55;2287;0;1019;935;84
2862;56;22222;1;56;1900;0;790;753;37
2862;57;22272;1;57;1840;0;860;803;57
2862;58;22282;1;58;1675;0;742;707;35
2862;59;22280;1;59;2029;0;884;844;40
2862;60;22249;1;60;1920;0;884;824;60
2862;61;22253;1;61;1913;1;907;843;64
2862;62;22265;1;62;2315;0;1038;984;54
2862;6;22258;1;6;1854;0;678;647;31
2862;63;22247;1;63;1983;1;841;792;49
2862;64;22208;1;64;2410;0;1212;1154;58
2862;65;22243;1;65;2019;0;938;900;38
2862;66;22270;1;66;1449;0;657;625;32
2862;67;22219;1;67;2124;1;953;902;51
2862;68;22260;1;68;1809;0;870;817;53
2862;69;22206;1;69;2143;0;960;910;50
2862;70;22281;1;70;1152;0;425;395;30
2862;71;22232;1;71;2306;0;1090;1012;78
2862;72;22255;1;72;2163;0;890;810;80
2862;7;22226;1;7;853;1;405;385;20
2862;73;22290;1;73;1142;0;518;488;30
2862;74;22202;1;74;1889;0;780;720;60
2862;75;22209;1;75;1935;0;731;667;64
2862;76;22273;1;76;756;0;341;319;22
2862;77;22214;1;77;2061;0;846;788;58
2862;78;22215;1;78;1968;0;836;768;68
2862;79;22259;1;79;1915;0;886;832;54
2862;80;22293;1;80;1336;0;527;487;40
2862;81;22274;1;81;1125;0;509;480;29
2862;82;22263;1;82;179;0;71;59;12
2862;8;22271;1;8;1345;0;708;665;43
2862;83;22239;1;83;134;0;74;67;7
2862;84;22211;1;84;627;0;297;288;9
2862;85;22261;1;85;53;0;14;13;1
2862;86;22238;1;86;57;0;43;30;13
2862;87;22234;1;87;90;0;21;19;2
2862;88;22217;1;88;47;0;9;6;3
2862;89;22212;1;89;33;0;2;1;1
2862;90;22277;1;90;95;0;14;13;1
2862;91;22295;1;91;66;0;39;36;3
2862;9;22216;1;9;1616;0;732;679;53
2862;92;22252;1;92;20;0;12;10;2
2862;93;22278;1;93;28;0;7;7;0
2862;94;22235;1;94;41;0;9;9;0
2862;95;22242;1;95;47;0;21;19;2
3001;10;22320;2;10;13;0;5;5;0
3001;11;22302;2;11;14;0;13;13;0
3001;1;22303;2;1;1718;1;1237;1153;84
3001;1;22310;2;1;1516;1;846;717;129
3001;1;22317;2;1;546;0;286;236;50
3001;1;22318;2;1;2426;0;1005;914;91
3001;1;22327;2;1;1465;1;758;587;171
3001;2;22306;2;2;1865;1;979;827;152
3001;2;22309;2;2;2014;2;966;823;143
3001;2;22319;2;2;1238;7;875;760;115
3001;2;22322;2;2;322;0;182;137;45
3001;2;22324;2;2;1908;0;931;802;129
3001;3;22299;2;3;1276;0;480;412;68
3001;3;22304;2;3;710;0;442;387;55
3001;3;22312;2;3;860;1;433;433;0
3001;3;22316;2;3;2116;1;1037;942;95
3001;3;22329;2;3;1086;0;484;370;114
3001;4;22307;2;4;851;0;450;408;42
3001;4;22308;2;4;2133;1;877;787;90
3001;4;22321;2;4;493;0;224;175;49
3001;4;22323;2;4;692;0;328;260;68
3001;4;22326;2;4;753;0;303;243;60
3001;5;22296;2;5;1149;0;471;377;94
3001;5;22300;2;5;398;0;273;238;35
3001;5;22301;2;5;810;0;422;368;54
3001;5;22305;2;5;527;0;283;224;59
3001;5;22313;2;5;2012;1;797;706;91
3001;6;22314;2;6;832;0;442;366;76
3001;6;22328;2;6;1986;1;800;688;112
3001;7;22315;2;7;1197;0;521;489;32
3001;7;22325;2;7;399;0;196;172;24
3001;8;22297;2;8;275;0;169;129;40
3001;8;22298;2;8;2027;0;892;749;143
3001;9;22311;2;9;95;0;49;35;14
3002;10;22365;2;10;434;0;257;189;68
3002;10;22368;2;10;614;0;243;205;38
3002;10;22383;2;10;725;0;386;289;97
3002;11;22334;2;11;581;0;289;244;45
3002;11;22377;2;11;623;0;205;169;36
3002;12;22336;2;12;506;0;209;177;32
3002;1;22346;2;1;2228;3;1447;1123;324
3002;1;22358;2;1;1796;0;1021;831;190
3002;1;22362;2;1;1933;0;893;759;134
3002;1;22363;2;1;616;0;298;226;72
3002;1;22372;2;1;1918;0;862;600;262
3002;1;22378;2;1;1318;0;675;486;189
3002;1;22386;2;1;1582;0;785;644;141
3002;1;22392;2;1;2193;0;1090;753;337
3002;13;22387;2;13;506;0;228;164;64
3002;14;22357;2;14;578;307;307;260;47
3002;15;22364;2;15;404;0;229;194;35
3002;16;22381;2;16;383;3;242;175;67
3002;17;22359;2;17;597;0;296;254;42
3002;18;22348;2;18;1052;1;501;406;95
3002;19;22338;2;19;21;0;7;5;2
3002;2;22332;2;2;693;0;246;175;71
3002;2;22341;2;2;1959;0;931;829;102
3002;2;22343;2;2;866;0;472;365;107
3002;2;22345;2;2;212;0;131;125;6
3002;2;22350;2;2;843;0;392;300;92
3002;2;22373;2;2;1720;0;759;598;161
3002;2;22384;2;2;682;0;386;310;76
3002;2;22391;2;2;1542;0;813;710;103
3002;3;22333;2;3;674;0;365;275;90
3002;3;22344;2;3;1883;0;974;719;255
3002;3;22355;2;3;1770;0;808;630;178
3002;3;22360;2;3;811;0;294;235;59
3002;3;22369;2;3;1568;1;766;655;111
3002;3;22382;2;3;1527;0;520;400;120
3002;3;22388;2;3;616;0;242;187;55
3002;3;22389;2;3;1953;0;1189;884;305
3002;4;22337;2;4;537;0;283;212;71
3002;4;22339;2;4;1926;2;1042;908;134
3002;4;22340;2;4;1477;1;784;677;107
3002;4;22349;2;4;1373;0;622;498;124
3002;4;22356;2;4;655;0;305;195;110
3002;4;22370;2;4;793;0;389;288;101
3002;4;22379;2;4;673;0;253;209;44
3002;4;22380;2;4;418;0;257;212;45
3002;5;22330;2;5;823;0;381;291;90
3002;5;22342;2;5;1789;0;824;757;67
3002;5;22351;2;5;1178;0;407;324;83
3002;5;22374;2;5;1377;0;643;512;131
3002;5;22376;2;5;1623;0;978;864;114
3002;5;22390;2;5;995;1;575;475;100
3002;5;22394;2;5;708;0;414;255;159
3002;6;22331;2;6;969;0;461;363;98
3002;6;22347;2;6;864;0;350;278;72
3002;6;22353;2;6;9;0;1;1;0
3002;6;22361;2;6;1383;1;696;592;104
3002;7;22352;2;7;888;0;466;358;108
3002;7;22367;2;7;827;0;426;311;115
3002;7;22393;2;7;1511;0;786;649;137
3002;8;22335;2;8;836;0;361;267;94
3002;8;22354;2;8;552;0;228;207;21
3002;8;22371;2;8;1637;1;818;689;129
3002;9;22366;2;9;1046;0;441;337;104
3002;9;22375;2;9;987;0;470;396;74
3002;9;22385;2;9;1454;0;790;662;128
3003;10;22422;3;10;9;0;8;4;4
3003;10;22445;3;10;1353;0;635;604;31
3003;11;22472;3;11;1748;0;785;722;63
3003;12;22437;3;12;1516;0;721;634;87
3003;1;22400;3;1;2137;2;1223;864;359
3003;1;22412;3;1;885;0;491;398;93
3003;1;22414;3;1;2125;0;1090;798;292
3003;1;22417;3;1;1497;0;696;595;101
3003;1;22429;3;1;1078;0;398;295;103
3003;1;22451;3;1;1341;0;591;441;150
3003;1;22464;3;1;901;0;344;296;48
3003;1;22467;3;1;2111;1;1243;926;317
3003;1;22469;3;1;1354;0;584;503;81
3003;1;22476;3;1;1669;0;860;656;204
3003;13;22465;3;13;2051;1;859;776;83
3003;14;22434;3;14;2221;0;927;829;98
3003;15;22427;3;15;1648;0;735;637;98
3003;16;22403;3;16;1796;0;768;648;120
3003;17;22407;3;17;1997;0;873;770;103
3003;18;22466;3;18;2002;0;866;771;95
3003;19;22435;3;19;2309;0;1094;972;122
3003;20;22408;3;20;2013;0;965;872;93
3003;21;22413;3;21;1946;2;923;809;114
3003;22;22474;3;22;2345;0;999;878;121
3003;2;22401;3;2;1358;0;633;479;154
3003;2;22409;3;2;1434;0;679;583;96
3003;2;22432;3;2;1727;0;832;615;217
3003;2;22436;3;2;1044;1;409;327;82
3003;2;22441;3;2;794;0;360;283;77
3003;2;22454;3;2;1518;0;703;594;109
3003;2;22456;3;2;1578;1;627;546;81
3003;2;22471;3;2;975;0;468;343;125
3003;2;22473;3;2;1056;0;398;315;83
3003;2;22475;3;2;1230;0;572;435;137
3003;23;22399;3;23;1683;0;765;647;118
3003;24;22439;3;24;1408;0;674;674;0
3003;25;22398;3;25;1611;1;826;738;88
3003;26;22461;3;26;1810;1;902;793;109
3003;27;22460;3;27;1109;0;557;490;67
3003;28;22411;3;28;1985;0;995;889;106
3003;29;22405;3;29;2157;0;1067;983;84
3003;30;22397;3;30;1658;0;834;739;95
3003;31;22421;3;31;1348;0;582;514;68
3003;32;22396;3;32;1431;1;639;561;78
3003;3;22404;3;3;603;1;286;232;54
3003;3;22415;3;3;1524;0;674;563;111
3003;3;22426;3;3;1100;0;434;340;94
3003;3;22430;3;3;1574;2;728;643;85
3003;3;22433;3;3;1554;1;608;548;60
3003;3;22440;3;3;1767;0;851;544;307
3003;3;22443;3;3;1574;0;657;530;127
3003;3;22444;3;3;1382;1;728;540;188
3003;3;22452;3;3;1039;0;503;375;128
3003;3;22462;3;3;1610;0;846;668;178
3003;33;22463;3;33;40;0;10;9;1
3003;34;22428;3;34;62;0;32;28;4
3003;35;22459;3;35;32;0;11;9;2
3003;36;22448;3;36;62;0;35;33;2
3003;4;22395;3;4;1258;0;419;355;64
3003;4;22406;3;4;1747;3;832;625;207
3003;4;22418;3;4;690;0;392;292;100
3003;4;22423;3;4;981;0;369;294;75
3003;4;22442;3;4;785;0;381;322;59
3003;4;22446;3;4;533;0;207;160;47
3003;4;22457;3;4;996;0;495;352;143
3003;4;22468;3;4;1635;0;813;696;117
3003;5;22410;3;5;1825;0;726;632;94
3003;5;22425;3;5;1302;0;512;391;121
3003;5;22453;3;5;767;0;304;234;70
3003;5;22458;3;5;1304;0;533;485;48
3003;6;22416;3;6;1603;0;529;451;78
3003;6;22424;3;6;727;0;279;213;66
3003;6;22450;3;6;420;0;173;118;55
3003;7;22419;3;7;1713;0;518;473;45
3003;7;22447;3;7;1093;0;458;347;111
3003;7;22470;3;7;813;0;391;283;108
3003;8;22420;3;8;2094;0;746;661;85
3003;8;22431;3;8;1219;1;668;566;102
3003;8;22455;3;8;1066;0;370;237;133
3003;9;22402;3;9;1174;2;545;409;136
3003;9;22438;3;9;2294;0;1191;932;259
3003;9;22449;3;9;2468;0;1185;1087;98
3004;10;22506;6;10;2188;0;1103;903;200
3004;11;22521;6;11;1228;0;487;406;81
3004;12;22520;6;12;724;0;346;277;69
3004;1;22480;6;1;1495;0;805;558;247
3004;1;22481;6;1;1651;0;828;596;232
3004;1;22492;6;1;1708;1;954;770;184
3004;1;22500;6;1;1972;0;1016;832;184
3004;1;22503;6;1;1477;1;845;698;147
3004;1;22514;6;1;2365;4;1395;863;532
3004;1;22525;6;1;1446;0;785;580;205
3004;13;22494;6;13;1197;0;425;327;98
3004;14;22510;6;14;750;0;297;240;57
3004;15;22495;6;15;792;0;297;245;52
3004;16;22487;6;16;1108;0;479;380;99
3004;17;22496;6;17;9;0;2;2;0
3004;2;22479;6;2;1008;0;546;409;137
3004;2;22488;6;2;1107;1;622;515;107
3004;2;22499;6;2;1703;2;934;550;384
3004;2;22516;6;2;792;0;410;292;118
3004;2;22523;6;2;1322;0;684;536;148
3004;2;22524;6;2;1657;0;720;596;124
3004;2;22526;6;2;1669;0;866;644;222
3004;3;22482;6;3;1815;0;743;608;135
3004;3;22483;6;3;1066;0;625;522;103
3004;3;22486;6;3;1804;0;889;747;142
3004;3;22504;6;3;1148;0;545;336;209
3004;3;22505;6;3;1513;0;638;447;191
3004;3;22517;6;3;600;0;264;186;78
3004;3;22519;6;3;1300;0;617;421;196
3004;4;22478;6;4;2086;0;757;757;0
3004;4;22485;6;4;997;0;476;378;98
3004;4;22489;6;4;450;0;257;167;90
3004;4;22490;6;4;921;0;405;279;126
3004;4;22498;6;4;1105;1;450;450;0
3004;4;22501;6;4;2246;0;1064;853;211
3004;4;22508;6;4;833;2;411;301;110
3004;5;22477;6;5;902;1;455;343;112
3004;5;22502;6;5;667;0;233;178;55
3004;5;22509;6;5;671;0;273;180;93
3004;5;22511;6;5;846;0;320;255;65
3004;5;22512;6;5;1717;0;810;687;123
3004;6;22507;6;6;1245;0;612;535;77
3004;6;22513;6;6;750;0;375;316;59
3004;6;22515;6;6;1200;0;527;393;134
3004;7;22493;6;7;802;0;346;247;99
3004;7;22497;6;7;1182;1;556;491;65
3004;8;22491;6;8;1678;0;713;611;102
3004;8;22518;6;8;752;0;366;273;93
3004;9;22484;6;9;98;0;29;17;12
3004;9;22522;6;9;1037;0;452;359;93
3005;10;22548;6;10;23;0;10;9;1
3005;1;22527;6;1;1833;1;1038;825;213
3005;1;22528;6;1;2017;0;988;801;187
3005;1;22529;6;1;2116;2;1050;855;195
3005;1;22538;6;1;1919;0;1024;904;120
3005;1;22547;6;1;1373;0;853;631;222
3005;2;22539;6;2;1792;0;885;736;149
3005;2;22543;6;2;829;0;344;250;94
3005;2;22549;6;2;2121;0;1131;883;248
3005;2;22550;6;2;452;0;266;199;67
3005;2;22551;6;2;1156;0;537;430;107
3005;3;22530;6;3;1309;0;508;386;122
3005;3;22532;6;3;1365;0;482;344;138
3005;3;22542;6;3;1822;0;998;774;224
3005;3;22545;6;3;979;0;520;430;90
3005;3;22554;6;3;1364;0;612;463;149
3005;4;22531;6;4;2008;0;1007;858;149
3005;4;22533;6;4;2054;1;848;590;258
3005;4;22541;6;4;1228;0;589;418;171
3005;4;22546;6;4;1011;0;622;448;174
3005;5;22535;6;5;1305;0;610;464;146
3005;5;22537;6;5;2319;1;1119;917;202
3005;5;22540;6;5;506;0;209;168;41
3005;6;22536;6;6;612;0;331;236;95
3005;6;22552;6;6;1052;0;371;318;53
3005;7;22544;6;7;2117;0;721;543;178
3005;8;22553;6;8;1539;2;745;617;128
3005;9;22534;6;9;701;0;221;173;48
3006;10;22585;5;10;2008;1;858;765;93
3006;11;22567;5;11;2410;1;1199;1087;112
3006;12;22573;5;12;2264;1;1157;1068;89
3006;1;22558;5;1;781;0;469;401;68
3006;1;22569;5;1;1772;0;860;708;152
3006;1;22571;5;1;1227;0;696;563;133
3006;1;22583;5;1;1723;0;1067;877;190
3006;13;22580;5;13;1605;0;662;584;78
3006;14;22579;5;14;1555;0;633;564;69
3006;15;22576;5;15;2078;0;926;833;93
3006;16;22557;5;16;1918;0;902;826;76
3006;17;22572;5;17;1429;1;679;616;63
3006;18;22587;5;18;2194;1;951;864;87
3006;19;22588;5;19;2034;0;963;884;79
3006;20;22577;5;20;2100;0;963;877;86
3006;21;22555;5;21;40;0;11;11;0
3006;2;22559;5;2;1188;0;568;459;109
3006;2;22561;5;2;1734;0;980;836;144
3006;2;22563;5;2;1561;1;977;784;193
3006;2;22565;5;2;2324;0;1102;1060;42
3006;3;22556;5;3;1216;0;486;378;108
3006;3;22564;5;3;786;0;422;269;153
3006;3;22582;5;3;2158;0;1039;915;124
3006;3;22590;5;3;2154;1;1269;1038;231
3006;4;22566;5;4;985;0;586;452;134
3006;4;22570;5;4;904;0;537;387;150
3006;4;22575;5;4;1081;0;573;451;122
3006;4;22584;5;4;1070;0;386;386;0
3006;5;22568;5;5;882;0;461;412;49
3006;5;22578;5;5;1132;0;586;506;80
3006;5;22581;5;5;1164;0;561;454;107
3006;5;22589;5;5;520;0;260;209;51
3006;6;22562;5;6;1946;0;925;756;169
3006;6;22592;5;6;2033;0;1019;888;131
3006;7;22574;5;7;1677;0;794;693;101
3006;7;22591;5;7;626;0;257;202;55
3006;8;22586;5;8;1772;0;859;784;75
3006;9;22560;5;9;837;0;383;300;83
3007;1;22595;5;1;1713;1;1049;903;146
3007;1;22596;5;1;1736;0;975;787;188
3007;1;22601;5;1;912;0;491;367;124
3007;1;22606;5;1;1004;0;455;364;91
3007;1;22619;5;1;1223;0;718;599;119
3007;1;22627;5;1;1721;1;981;787;194
3007;1;22638;5;1;1310;0;630;470;160
3007;1;22641;5;1;1466;0;896;713;183
3007;1;22646;5;1;1400;0;679;524;155
3007;1;22649;5;1;1374;0;710;611;99
3007;1;22653;5;1;995;0;411;346;65
3007;2;22598;5;2;1701;0;844;681;163
3007;2;22612;5;2;1117;0;669;568;101
3007;2;22613;5;2;1218;0;605;434;171
3007;2;22615;5;2;2221;0;901;696;205
3007;2;22616;5;2;922;0;315;220;95
3007;2;22617;5;2;937;0;462;381;81
3007;2;22626;5;2;1265;0;767;609;158
3007;2;22630;5;2;1050;0;408;344;64
3007;2;22639;5;2;608;2;328;270;58
3007;2;22647;5;2;1050;2;572;457;115
3007;2;22651;5;2;1060;0;553;417;136
3007;3;22607;5;3;1006;0;529;473;56
3007;3;22608;5;3;1827;1;955;752;203
3007;3;22614;5;3;1444;2;847;717;130
3007;3;22624;5;3;799;0;397;339;58
3007;3;22625;5;3;1304;0;592;465;127
3007;3;22628;5;3;520;0;379;267;112
3007;3;22631;5;3;884;0;332;268;64
3007;3;22637;5;3;1279;0;594;524;70
3007;3;22642;5;3;2377;0;1002;780;222
3007;3;22645;5;3;905;0;436;357;79
3007;3;22648;5;3;1314;0;651;419;232
3007;4;22593;5;4;758;0;402;327;75
3007;4;22594;5;4;801;0;363;303;60
3007;4;22599;5;4;598;0;299;235;64
3007;4;22602;5;4;929;0;396;369;27
3007;4;22610;5;4;461;0;278;213;65
3007;4;22618;5;4;343;0;196;152;44
3007;4;22621;5;4;480;1;303;254;49
3007;4;22629;5;4;463;0;172;149;23
3007;4;22634;5;4;2073;0;1330;1048;282
3007;5;22597;5;5;701;3;405;362;43
3007;5;22600;5;5;1861;1;965;856;109
3007;5;22620;5;5;856;0;380;307;73
3007;5;22633;5;5;22;0;19;16;3
3007;5;22636;5;5;657;0;346;271;75
3007;5;22640;5;5;1825;0;711;596;115
3007;5;22650;5;5;1013;0;560;455;105
3007;6;22611;5;6;866;0;371;318;53
3007;6;22632;5;6;451;2;286;240;46
3007;6;22635;5;6;1495;0;623;527;96
3007;6;22644;5;6;402;0;199;177;22
3007;6;22652;5;6;1044;1;598;516;82
3007;6;22654;5;6;492;0;228;203;25
3007;7;22604;5;7;973;1;531;457;74
3007;7;22605;5;7;1077;1;413;303;110
3007;7;22643;5;7;428;0;199;160;39
3007;8;22609;5;8;872;0;400;329;71
3007;8;22622;5;8;506;0;276;203;73
3007;8;22623;5;8;508;0;262;206;56
3007;9;22603;5;9;499;0;202;185;17
3008;10;22679;5;10;486;0;266;212;54
3008;11;22678;5;11;1260;0;723;605;118
3008;12;22673;5;12;855;0;461;373;88
3008;1;22663;5;1;1608;0;719;551;168
3008;1;22667;5;1;1539;0;984;658;326
3008;1;22668;5;1;1833;0;916;770;146
3008;1;22671;5;1;1599;1;793;538;255
3008;1;22686;5;1;1323;0;732;596;136
3008;1;22687;5;1;1345;1;880;763;117
3008;1;22696;5;1;1529;0;837;682;155
3008;13;22659;5;13;818;0;483;355;128
3008;14;22662;5;14;621;0;425;291;134
3008;15;22666;5;15;846;0;487;399;88
3008;16;22680;5;16;33;0;13;10;3
3008;17;22665;5;17;43;0;17;15;2
3008;2;22664;5;2;2352;0;1335;1202;133
3008;2;22669;5;2;1029;0;595;540;55
3008;2;22676;5;2;954;2;559;484;75
3008;2;22682;5;2;1592;0;853;601;252
3008;2;22683;5;2;543;0;305;205;100
3008;2;22684;5;2;705;0;366;289;77
3008;2;22685;5;2;787;0;410;330;80
3008;3;22655;5;3;1245;4;687;613;74
3008;3;22672;5;3;583;0;259;177;82
3008;3;22674;5;3;832;0;495;394;101
3008;3;22681;5;3;419;0;206;156;50
3008;3;22688;5;3;1017;0;512;408;104
3008;3;22694;5;3;916;0;539;454;85
3008;3;22695;5;3;1529;0;951;737;214
3008;4;22660;5;4;609;0;199;166;33
3008;4;22675;5;4;1860;4;1057;943;114
3008;4;22689;5;4;1239;0;720;565;155
3008;4;22692;5;4;481;0;312;249;63
3008;5;22656;5;5;552;2;311;245;66
3008;5;22657;5;5;1135;0;629;522;107
3008;5;22661;5;5;1916;2;981;828;153
3008;6;22658;5;6;332;0;175;139;36
3008;6;22690;5;6;510;0;283;195;88
3008;6;22693;5;6;2337;1;1243;1040;203
3008;7;22691;5;7;1949;0;1005;853;152
3008;8;22677;5;8;1030;0;604;511;93
3008;9;22670;5;9;322;0;172;133;39
3009;10;22704;4;10;1118;1;533;468;65
3009;10;22743;4;10;731;0;313;275;38
3009;11;22717;4;11;519;0;234;181;53
3009;11;22724;4;11;1516;2;815;730;85
3009;12;22737;4;12;1020;0;518;471;47
3009;12;22750;4;12;347;0;141;113;28
3009;1;22699;4;1;1797;0;988;767;221
3009;1;22710;4;1;1709;0;703;478;225
3009;1;22716;4;1;1702;0;1105;894;211
3009;1;22722;4;1;2118;1;997;763;234
3009;1;22725;4;1;1405;2;730;650;80
3009;1;22728;4;1;1209;2;716;572;144
3009;1;22733;4;1;1481;17;958;710;248
3009;1;22736;4;1;2059;0;1160;978;182
3009;1;22741;4;1;435;0;230;176;54
3009;1;22742;4;1;1882;0;871;654;217
3009;1;22752;4;1;2254;5;1396;1160;236
3009;13;22729;4;13;1664;0;827;714;113
3009;14;22756;4;14;2188;1;989;908;81
3009;15;22706;4;15;33;0;5;5;0
3009;2;22697;4;2;1575;1;864;753;111
3009;2;22698;4;2;1518;0;590;454;136
3009;2;22700;4;2;1297;0;554;464;90
3009;2;22701;4;2;812;0;432;316;116
3009;2;22705;4;2;1084;8;757;569;188
3009;2;22712;4;2;1018;0;559;437;122
3009;2;22719;4;2;989;1;440;354;86
3009;2;22720;4;2;2313;5;1532;1107;425
3009;2;22727;4;2;1108;0;611;541;70
3009;2;22735;4;2;730;0;305;251;54
3009;2;22739;4;2;1497;1;723;576;147
3009;3;22708;4;3;1715;0;1027;867;160
3009;3;22713;4;3;783;0;430;350;80
3009;3;22714;4;3;1711;0;770;647;123
3009;3;22723;4;3;547;0;217;165;52
3009;3;22732;4;3;879;0;368;304;64
3009;3;22734;4;3;411;0;236;205;31
3009;3;22740;4;3;593;0;331;272;59
3009;3;22747;4;3;103;0;63;52;11
3009;3;22749;4;3;1008;0;584;464;120
3009;3;22751;4;3;1360;0;613;476;137
3009;3;22757;4;3;976;3;677;517;160
3009;4;22709;4;4;1145;0;725;588;137
3009;4;22715;4;4;1207;0;609;510;99
3009;4;22726;4;4;606;0;397;314;83
3009;4;22731;4;4;1667;0;744;618;126
3009;4;22744;4;4;810;0;381;285;96
3009;4;22746;4;4;1209;0;671;557;114
3009;4;22748;4;4;1937;0;927;813;114
3009;5;22703;4;5;1078;0;651;551;100
3009;5;22711;4;5;791;0;355;291;64
3009;5;22754;4;5;967;0;513;443;70
3009;5;22755;4;5;1243;0;591;470;121
3009;6;22702;4;6;1334;2;682;592;90
3009;6;22730;4;6;821;0;353;299;54
3009;7;22745;4;7;2061;1;944;806;138
3009;7;22753;4;7;406;0;219;192;27
3009;8;22707;4;8;2155;2;1066;951;115
3009;8;22721;4;8;883;0;355;312;43
3009;9;22718;4;9;56;0;40;40;0
3009;9;22738;4;9;664;0;319;288;31
3010;10;22780;4;10;1418;0;810;671;139
3010;1;22771;4;1;1777;0;1061;752;309
3010;1;22783;4;1;979;0;410;308;102
3010;1;22785;4;1;1939;2;1028;862;166
3010;1;22794;4;1;1595;2;979;749;230
3010;1;22797;4;1;1418;5;1035;783;252
3010;1;22807;4;1;1661;3;929;705;224
3010;1;22810;4;1;375;0;270;183;87
3010;1;22815;4;1;843;0;571;479;92
3010;1;22829;4;1;1797;4;1106;838;268
3010;1;22831;4;1;2157;0;1271;1017;254
3010;1;22837;4;1;2153;1;1231;1030;201
3010;1;22840;4;1;889;9;552;437;115
3010;1;22844;4;1;2136;0;1283;1117;166
3010;1;22847;4;1;760;0;403;306;97
3010;2;22758;4;2;331;0;243;184;59
3010;2;22762;4;2;1669;3;829;664;165
3010;2;22767;4;2;1665;0;948;829;119
3010;2;22769;4;2;1691;2;949;838;111
3010;2;22787;4;2;1613;0;926;622;304
3010;2;22808;4;2;1618;4;1149;895;254
3010;2;22813;4;2;692;0;346;281;65
3010;2;22817;4;2;952;0;520;442;78
3010;2;22822;4;2;1721;0;953;707;246
3010;2;22830;4;2;1527;0;763;569;194
3010;2;22834;4;2;641;0;297;217;80
3010;2;22836;4;2;1311;3;956;728;228
3010;2;22839;4;2;752;1;494;412;82
3010;2;22846;4;2;944;0;455;355;100
3010;3;22761;4;3;1064;2;719;538;181
3010;3;22772;4;3;579;0;333;251;82
3010;3;22773;4;3;981;4;607;413;194
3010;3;22781;4;3;1397;2;797;617;180
3010;3;22784;4;3;1785;1;929;765;164
3010;3;22788;4;3;1613;3;850;708;142
3010;3;22792;4;3;1305;5;661;438;223
3010;3;22799;4;3;1381;6;935;653;282
3010;3;22805;4;3;666;0;357;284;73
3010;3;22816;4;3;39;0;13;6;7
3010;3;22824;4;3;2322;9;1617;1368;249
3010;3;22832;4;3;1041;0;619;505;114
3010;3;22833;4;3;891;0;516;405;111
3010;3;22835;4;3;844;0;626;455;171
3010;4;22760;4;4;636;1;422;290;132
3010;4;22764;4;4;642;0;349;292;57
3010;4;22765;4;4;676;0;405;305;100
3010;4;22778;4;4;311;0;192;133;59
3010;4;22786;4;4;1651;1;817;623;194
3010;4;22790;4;4;670;3;422;303;119
3010;4;22791;4;4;998;0;525;408;117
3010;4;22801;4;4;1046;0;549;355;194
3010;4;22811;4;4;1291;0;695;583;112
3010;4;22814;4;4;838;3;532;421;111
3010;4;22827;4;4;713;0;427;339;88
3010;4;22828;4;4;1835;1;991;765;226
3010;4;22843;4;4;1151;0;735;574;161
3010;4;22845;4;4;1391;10;891;685;206
3010;5;22770;4;5;1233;1;641;542;99
3010;5;22774;4;5;457;2;312;238;74
3010;5;22776;4;5;1017;0;640;519;121
3010;5;22777;4;5;1681;1;957;706;251
3010;5;22779;4;5;498;0;210;186;24
3010;5;22795;4;5;343;0;222;169;53
3010;5;22803;4;5;2095;3;1011;723;288
3010;5;22806;4;5;866;0;541;424;117
3010;5;22825;4;5;912;0;412;313;99
3010;5;22841;4;5;1508;0;809;687;122
3010;5;22842;4;5;1273;10;738;574;164
3010;6;22775;4;6;872;0;460;371;89
3010;6;22789;4;6;1060;10;719;535;184
3010;6;22793;4;6;492;0;298;242;56
3010;6;22796;4;6;601;0;248;206;42
3010;6;22798;4;6;1147;6;590;461;129
3010;6;22800;4;6;270;2;155;115;40
3010;6;22804;4;6;1498;0;697;630;67
3010;6;22818;4;6;821;1;520;431;89
3010;6;22823;4;6;1784;5;1066;802;264
3010;7;22759;4;7;851;0;405;256;149
3010;7;22766;4;7;1427;0;598;540;58
3010;7;22768;4;7;614;0;369;304;65
3010;7;22782;4;7;623;2;376;312;64
3010;7;22812;4;7;489;1;320;238;82
3010;7;22819;4;7;666;0;386;353;33
3010;7;22820;4;7;546;0;359;246;113
3010;7;22826;4;7;457;4;324;217;107
3010;8;22802;4;8;456;0;249;198;51
3010;8;22809;4;8;1007;0;545;456;89
3010;8;22838;4;8;1534;0;825;571;254
3010;9;22763;4;9;708;2;421;358;63
3010;9;22821;4;9;603;0;337;271;66
3011;10;22856;6;10;1519;0;679;447;232
3011;10;22887;6;10;847;0;280;206;74
3011;10;22897;6;10;1369;0;714;632;82
3011;11;22854;6;11;1893;0;798;644;154
3011;11;22878;6;11;1714;1;645;523;122
3011;11;22890;6;11;1650;0;801;711;90
3011;12;22868;6;12;1648;0;746;659;87
3011;12;22875;6;12;906;0;289;213;76
3011;1;22855;6;1;1077;7;613;437;176
3011;1;22881;6;1;1987;0;1207;994;213
3011;1;22882;6;1;1955;0;962;771;191
3011;1;22883;6;1;1534;0;646;493;153
3011;1;22896;6;1;833;0;346;268;78
3011;13;22860;6;13;351;0;189;127;62
3011;13;22884;6;13;12;0;6;5;1
3011;14;22858;6;14;23;0;6;6;0
3011;14;22891;6;14;511;0;230;177;53
3011;2;22848;6;2;2045;1;1184;908;276
3011;2;22861;6;2;2202;0;928;707;221
3011;2;22874;6;2;2163;1;1245;999;246
3011;2;22886;6;2;2018;0;834;732;102
3011;2;22895;6;2;918;0;299;253;46
3011;3;22862;6;3;1632;2;630;483;147
3011;3;22869;6;3;2330;1;1484;1278;206
3011;3;22871;6;3;759;0;337;242;95
3011;3;22872;6;3;1537;0;801;565;236
3011;3;22877;6;3;1716;0;813;675;138
3011;4;22851;6;4;1677;0;832;614;218
3011;4;22866;6;4;1069;0;452;348;104
3011;4;22876;6;4;1186;0;459;380;79
3011;4;22880;6;4;1466;1;835;617;218
3011;4;22888;6;4;788;0;357;219;138
3011;5;22849;6;5;1516;1;781;676;105
3011;5;22850;6;5;441;0;251;190;61
3011;5;22859;6;5;1558;0;659;491;168
3011;5;22873;6;5;901;0;416;346;70
3011;5;22893;6;5;1566;1;778;570;208
3011;6;22870;6;6;58;0;43;40;3
3011;6;22879;6;6;1447;0;577;433;144
3011;6;22885;6;6;1869;0;1004;807;197
3011;6;22892;6;6;573;0;211;171;40
3011;7;22857;6;7;1488;1;683;597;86
3011;7;22865;6;7;839;0;380;299;81
3011;7;22867;6;7;436;0;174;125;49
3011;8;22852;6;8;1777;0;829;698;131
3011;8;22863;6;8;638;0;380;255;125
3011;8;22894;6;8;1101;0;484;375;109
3011;9;22853;6;9;1409;0;778;651;127
3011;9;22864;6;9;668;0;310;262;48
3011;9;22889;6;9;665;0;179;135;44
3012;10;22910;6;10;1473;1;733;618;115
3012;11;22923;6;11;2077;1;854;704;150
3012;12;22938;6;12;1331;0;724;649;75
3012;1;22901;6;1;1858;2;816;693;123
3012;1;22902;6;1;1764;1;915;682;233
3012;1;22932;6;1;2264;0;946;691;255
3012;1;22933;6;1;1546;1;681;500;181
3012;1;22935;6;1;1367;0;873;659;214
3012;1;22942;6;1;2210;0;1468;1034;434
3012;13;22900;6;13;1217;2;613;544;69
3012;14;22909;6;14;1750;0;978;870;108
3012;15;22912;6;15;1557;0;857;736;121
3012;16;22924;6;16;1102;0;542;482;60
3012;17;22939;6;17;1867;0;888;777;111
3012;18;22911;6;18;747;0;444;374;70
3012;19;22915;6;19;2040;1;1059;929;130
3012;20;22930;6;20;1409;0;749;650;99
3012;21;22903;6;21;32;0;6;5;1
3012;22;22899;6;22;17;0;10;9;1
3012;2;22898;6;2;952;0;406;296;110
3012;2;22906;6;2;1918;2;960;844;116
3012;2;22914;6;2;1198;2;641;495;146
3012;2;22929;6;2;2123;0;826;639;187
3012;2;22941;6;2;2198;0;1188;846;342
3012;23;22918;6;23;14;0;9;8;1
3012;3;22904;6;3;516;0;261;189;72
3012;3;22908;6;3;1337;0;627;545;82
3012;3;22926;6;3;1082;0;426;337;89
3012;3;22928;6;3;1435;1;757;601;156
3012;3;22940;6;3;1564;0;700;549;151
3012;4;22922;6;4;1091;0;499;377;122
3012;4;22925;6;4;1208;0;522;461;61
3012;4;22927;6;4;1115;0;434;335;99
3012;4;22944;6;4;144;0;106;73;33
3012;5;22905;6;5;711;0;252;173;79
3012;5;22916;6;5;1804;1;890;804;86
3012;5;22936;6;5;1608;0;511;373;138
3012;6;22913;6;6;1056;0;440;359;81
3012;6;22921;6;6;1511;0;775;658;117
3012;6;22943;6;6;621;0;270;192;78
3012;7;22917;6;7;2186;0;1106;977;129
3012;7;22920;6;7;438;0;181;152;29
3012;7;22934;6;7;1667;0;542;395;147
3012;8;22907;6;8;1990;0;1003;900;103
3012;8;22931;6;8;6;0;6;6;0
3012;8;22937;6;8;489;0;175;123;52
3012;9;22919;6;9;1875;0;981;845;136
3013;10;22969;6;10;242;0;133;110;23
3013;1;22946;6;1;951;0;525;399;126
3013;1;22947;6;1;314;0;169;145;24
3013;1;22949;6;1;1907;0;939;734;205
3013;1;22976;6;1;1193;0;643;512;131
3013;1;22977;6;1;1012;0;395;298;97
3013;1;22978;6;1;2150;0;1422;957;465
3013;1;22980;6;1;1256;0;483;357;126
3013;2;22948;6;2;1311;0;623;411;212
3013;2;22953;6;2;1863;0;700;537;163
3013;2;22956;6;2;1967;0;806;619;187
3013;2;22960;6;2;1462;1;968;759;209
3013;2;22965;6;2;1490;0;685;496;189
3013;2;22973;6;2;1574;0;787;606;181
3013;2;22975;6;2;894;0;475;406;69
3013;3;22950;6;3;2079;0;1327;1010;317
3013;3;22952;6;3;1002;0;503;424;79
3013;3;22961;6;3;657;0;318;246;72
3013;3;22962;6;3;1778;0;614;487;127
3013;3;22968;6;3;897;0;444;281;163
3013;3;22970;6;3;1585;0;1050;864;186
3013;4;22957;6;4;1240;0;695;521;174
3013;4;22958;6;4;779;0;373;273;100
3013;4;22963;6;4;1218;0;444;356;88
3013;4;22964;6;4;1115;0;661;459;202
3013;4;22966;6;4;893;0;451;366;85
3013;4;22979;6;4;1053;0;578;437;141
3013;5;22954;6;5;822;0;377;311;66
3013;5;22955;6;5;739;0;349;283;66
3013;5;22971;6;5;1139;0;540;407;133
3013;5;22972;6;5;1435;0;612;421;191
3013;6;22945;6;6;280;0;148;126;22
3013;6;22959;6;6;1308;0;732;564;168
3013;7;22974;6;7;443;0;224;170;54
3013;8;22951;6;8;431;0;269;237;32
3013;9;22967;6;9;199;0;107;95;12
3014;10;23004;2;10;1336;0;538;426;112
3014;11;22991;2;11;486;0;222;191;31
3014;12;22982;2;12;642;0;287;205;82
3014;1;22984;2;1;1323;0;858;695;163
3014;1;22994;2;1;2071;0;1239;998;241
3014;1;22999;2;1;2203;3;1151;937;214
3014;1;23000;2;1;1607;0;774;584;190
3014;13;22988;2;13;42;0;24;15;9
3014;14;22989;2;14;20;0;10;8;2
3014;2;22985;2;2;1202;0;693;543;150
3014;2;22993;2;2;1545;0;742;610;132
3014;2;22997;2;2;1074;0;520;398;122
3014;2;23003;2;2;1884;0;1074;886;188
3014;3;22990;2;3;1571;0;698;526;172
3014;3;22995;2;3;2099;0;1211;967;244
3014;3;23001;2;3;105;0;72;58;14
3014;3;23002;2;3;1664;0;817;687;130
3014;4;22983;2;4;879;0;440;365;75
3014;4;22987;2;4;1648;0;583;501;82
3014;5;22996;2;5;1040;0;499;439;60
3014;6;22992;2;6;1180;0;569;488;81
3014;7;22981;2;7;1681;0;721;608;113
3014;8;22986;2;8;985;0;454;362;92
3014;9;22998;2;9;816;0;378;322;56
3015;10;23042;6;10;621;0;330;259;71
3015;10;23045;6;10;797;0;398;331;67
3015;11;23026;6;11;1530;0;702;631;71
3015;11;23039;6;11;1014;0;531;371;160
3015;12;23051;6;12;944;0;342;304;38
3015;1;23005;6;1;2159;0;1255;1005;250
3015;1;23028;6;1;1822;0;1154;833;321
3015;1;23031;6;1;1025;0;521;444;77
3015;1;23033;6;1;960;0;537;383;154
3015;1;23036;6;1;1680;18;969;701;268
3015;1;23044;6;1;1774;1;1080;938;142
3015;13;23027;6;13;815;0;325;291;34
3015;14;23021;6;14;621;0;284;242;42
3015;15;23030;6;15;539;0;288;252;36
3015;16;23018;6;16;545;0;228;183;45
3015;17;23015;6;17;17;0;6;6;0
3015;2;23006;6;2;1688;1;859;689;170
3015;2;23007;6;2;2076;0;1248;1023;225
3015;2;23019;6;2;1418;1;846;652;194
3015;2;23024;6;2;1297;1;834;682;152
3015;2;23046;6;2;1177;0;597;535;62
3015;2;23050;6;2;1211;0;523;441;82
3015;3;23009;6;3;1350;0;812;688;124
3015;3;23017;6;3;1739;0;1064;834;230
3015;3;23022;6;3;1207;0;600;478;122
3015;3;23034;6;3;886;0;535;408;127
3015;3;23049;6;3;1997;0;1033;947;86
3015;4;23016;6;4;2050;1;1099;952;147
3015;4;23020;6;4;841;0;397;290;107
3015;4;23032;6;4;1410;0;847;666;181
3015;4;23035;6;4;1539;0;851;629;222
3015;5;23012;6;5;1714;1;872;773;99
3015;5;23013;6;5;1589;0;701;603;98
3015;5;23037;6;5;846;0;446;323;123
3015;5;23040;6;5;745;0;363;250;113
3015;6;23014;6;6;1104;0;548;421;127
3015;6;23029;6;6;613;0;357;254;103
3015;6;23038;6;6;945;0;484;430;54
3015;6;23048;6;6;1451;0;577;438;139
3015;7;23008;6;7;1417;0;673;559;114
3015;7;23023;6;7;460;0;216;167;49
3015;7;23041;6;7;1541;0;674;597;77
3015;8;23011;6;8;1740;0;810;689;121
3015;8;23025;6;8;1370;0;589;464;125
3015;8;23043;6;8;1007;0;601;481;120
3015;9;23010;6;9;370;0;224;175;49
3015;9;23047;6;9;1631;1;591;504;87
3016;10;23064;2;10;519;0;231;191;40
3016;10;23090;2;10;985;0;454;383;71
3016;11;23062;2;11;666;0;319;234;85
3016;11;23088;2;11;1851;0;838;696;142
3016;12;23060;2;12;1037;0;408;346;62
3016;12;23084;2;12;390;0;154;136;18
3016;1;23083;2;1;2108;0;1243;1041;202
3016;1;23085;2;1;1514;0;854;745;109
3016;1;23091;2;1;1408;0;741;657;84
3016;13;23063;2;13;978;0;494;418;76
3016;14;23058;2;14;878;1;543;450;93
3016;15;23065;2;15;1024;0;531;466;65
3016;16;23077;2;16;1117;0;580;495;85
3016;17;23074;2;17;1225;0;690;570;120
3016;18;23068;2;18;862;0;343;268;75
3016;19;23076;2;19;1078;0;573;478;95
3016;20;23092;2;20;21;0;11;10;1
3016;21;23067;2;21;33;0;20;18;2
3016;2;23057;2;2;1298;1;706;600;106
3016;2;23078;2;2;294;0;155;125;30
3016;2;23080;2;2;876;0;436;354;82
3016;3;23053;2;3;1855;0;943;813;130
3016;3;23059;2;3;854;0;370;299;71
3016;3;23071;2;3;876;0;349;270;79
3016;4;23054;2;4;602;0;283;229;54
3016;4;23082;2;4;1673;1;895;798;97
3016;4;23089;2;4;1901;0;953;805;148
3016;5;23073;2;5;905;1;476;388;88
3016;5;23079;2;5;1306;0;742;658;84
3016;5;23081;2;5;271;0;127;96;31
3016;6;23052;2;6;1794;0;943;790;153
3016;6;23066;2;6;539;0;225;177;48
3016;6;23086;2;6;1550;0;810;683;127
3016;7;23070;2;7;912;0;438;362;76
3016;7;23072;2;7;2282;0;1191;1017;174
3016;7;23087;2;7;670;0;231;198;33
3016;8;23055;2;8;939;0;364;289;75
3016;8;23069;2;8;343;0;165;137;28
3016;8;23075;2;8;2380;1;1262;1086;176
3016;9;23056;2;9;1068;0;503;412;91
3016;9;23061;2;9;2118;0;1191;1006;185
3017;10;23093;5;10;2414;0;1051;951;100
3017;10;23113;5;10;788;0;283;237;46
3017;10;23190;5;10;755;0;380;268;112
3017;11;23104;5;11;1251;0;546;419;127
3017;11;23117;5;11;1754;0;729;642;87
3017;11;23167;5;11;600;0;303;262;41
3017;12;23096;5;12;1383;0;551;465;86
3017;12;23125;5;12;2073;0;925;828;97
3017;12;23183;5;12;15;0;12;5;7
3017;1;23097;5;1;1719;0;620;560;60
3017;1;23112;5;1;521;0;155;116;39
3017;1;23121;5;1;1079;0;425;314;111
3017;1;23123;5;1;620;0;259;208;51
3017;1;23126;5;1;2358;2;1090;888;202
3017;1;23144;5;1;1345;0;672;585;87
3017;1;23157;5;1;1456;0;885;682;203
3017;1;23158;5;1;1471;2;976;706;270
3017;13;23115;5;13;1908;0;760;695;65
3017;13;23165;5;13;675;0;297;235;62
3017;14;23140;5;14;1673;0;663;615;48
3017;15;23142;5;15;1691;0;696;629;67
3017;16;23187;5;16;1772;0;780;706;74
3017;17;23120;5;17;1650;0;693;610;83
3017;18;23138;5;18;1558;1;668;607;61
3017;19;23156;5;19;1209;2;407;359;48
3017;20;23151;5;20;1445;0;643;596;47
3017;21;23146;5;21;2056;0;936;863;73
3017;22;23191;5;22;1819;0;852;749;103
3017;2;23109;5;2;794;0;360;294;66
3017;2;23119;5;2;567;0;367;278;89
3017;2;23129;5;2;887;0;462;367;95
3017;2;23137;5;2;1810;1;794;736;58
3017;2;23150;5;2;606;0;385;263;122
3017;2;23172;5;2;1351;0;541;467;74
3017;2;23182;5;2;2276;1;967;758;209
3017;2;23188;5;2;566;0;321;253;68
3017;23;23131;5;23;1162;0;426;379;47
3017;24;23147;5;24;1401;0;592;534;58
3017;25;23173;5;25;1812;0;795;712;83
3017;26;23132;5;26;1849;0;816;724;92
3017;27;23169;5;27;2232;1;1002;899;103
3017;28;23102;5;28;1544;0;641;579;62
3017;29;23178;5;29;2231;0;1053;939;114
3017;30;23155;5;30;1535;0;720;657;63
3017;31;23130;5;31;1683;0;664;537;127
3017;32;23171;5;32;1950;1;864;785;79
3017;3;23107;5;3;1003;0;580;494;86
3017;3;23143;5;3;2019;0;1231;963;268
3017;3;23149;5;3;1585;0;577;511;66
3017;3;23168;5;3;836;1;537;354;183
3017;3;23170;5;3;1865;0;603;511;92
3017;3;23177;5;3;760;0;317;245;72
3017;3;23185;5;3;1566;0;702;485;217
3017;3;23186;5;3;2351;0;1163;951;212
3017;33;23174;5;33;1128;0;532;490;42
3017;34;23184;5;34;1704;0;696;696;0
3017;35;23134;5;35;39;0;22;15;7
3017;36;23116;5;36;101;0;19;18;1
3017;37;23122;5;37;17;0;6;5;1
3017;4;23095;5;4;1862;1;654;602;52
3017;4;23101;5;4;1638;0;695;551;144
3017;4;23103;5;4;715;0;387;261;126
3017;4;23127;5;4;952;0;265;215;50
3017;4;23139;5;4;2052;0;1209;970;239
3017;4;23160;5;4;1348;0;770;643;127
3017;4;23162;5;4;581;0;340;261;79
3017;4;23181;5;4;909;0;329;297;32
3017;5;23098;5;5;1236;0;620;533;87
3017;5;23114;5;5;1026;0;386;311;75
3017;5;23118;5;5;1057;0;423;341;82
3017;5;23128;5;5;1328;0;611;545;66
3017;5;23136;5;5;750;0;378;297;81
3017;5;23152;5;5;1087;1;670;485;185
3017;5;23163;5;5;954;0;411;295;116
3017;5;23164;5;5;1832;0;1140;961;179
3017;6;23099;5;6;1130;0;678;581;97
3017;6;23124;5;6;1283;0;513;405;108
3017;6;23133;5;6;1823;0;749;695;54
3017;6;23135;5;6;1219;0;580;486;94
3017;6;23141;5;6;516;0;133;106;27
3017;6;23175;5;6;415;3;280;184;96
3017;6;23176;5;6;1042;0;493;361;132
3017;6;23189;5;6;1488;0;644;513;131
3017;7;23105;5;7;595;0;202;166;36
3017;7;23106;5;7;1850;0;946;820;126
3017;7;23110;5;7;1188;1;490;404;86
3017;7;23145;5;7;1910;0;808;748;60
3017;7;23148;5;7;556;0;332;248;84
3017;7;23179;5;7;1576;0;854;711;143
3017;7;23180;5;7;1350;0;455;347;108
3017;8;23094;5;8;90;0;48;28;20
3017;8;23100;5;8;2422;0;1075;965;110
3017;8;23108;5;8;1026;0;625;497;128
3017;8;23154;5;8;1364;0;645;564;81
3017;8;23159;5;8;1456;1;604;506;98
3017;8;23166;5;8;954;0;502;386;116
3017;9;23111;5;9;1990;0;989;875;114
3017;9;23153;5;9;863;0;378;306;72
3017;9;23161;5;9;783;0;483;336;147
3018;10;23208;5;10;64;0;19;10;9
3018;10;23216;5;10;1056;2;479;412;67
3018;11;23228;5;11;965;2;499;439;60
3018;12;23199;5;12;669;2;355;289;66
3018;1;23200;5;1;1620;0;1069;906;163
3018;1;23203;5;1;2059;3;1007;848;159
3018;1;23205;5;1;1276;0;703;535;168
3018;1;23213;5;1;1769;0;951;693;258
3018;1;23221;5;1;1422;0;900;803;97
3018;1;23224;5;1;467;0;271;219;52
3018;1;23229;5;1;2185;0;1165;918;247
3018;13;23194;5;13;968;1;436;341;95
3018;14;23241;5;14;551;0;266;215;51
3018;15;23218;5;15;28;0;10;10;0
3018;16;23211;5;16;47;0;21;15;6
3018;2;23193;5;2;471;0;199;139;60
3018;2;23196;5;2;1984;1;919;816;103
3018;2;23197;5;2;574;0;316;241;75
3018;2;23202;5;2;743;0;478;373;105
3018;2;23219;5;2;341;0;182;151;31
3018;2;23225;5;2;522;0;274;212;62
3018;2;23240;5;2;1353;1;882;603;279
3018;3;23198;5;3;515;0;262;221;41
3018;3;23201;5;3;948;0;391;306;85
3018;3;23209;5;3;809;0;371;281;90
3018;3;23226;5;3;691;0;298;202;96
3018;3;23227;5;3;2101;1;1038;908;130
3018;3;23238;5;3;1057;0;651;485;166
3018;4;23210;5;4;266;0;138;122;16
3018;4;23212;5;4;495;0;205;165;40
3018;4;23231;5;4;666;0;328;272;56
3018;4;23236;5;4;632;0;359;266;93
3018;4;23239;5;4;1862;0;906;826;80
3018;5;23207;5;5;1777;0;820;730;90
3018;5;23214;5;5;292;0;186;150;36
3018;5;23223;5;5;431;0;223;186;37
3018;5;23237;5;5;615;0;334;224;110
3018;6;23195;5;6;462;0;261;232;29
3018;6;23222;5;6;2103;0;958;864;94
3018;6;23234;5;6;506;0;203;160;43
3018;6;23235;5;6;324;0;182;161;21
3018;7;23206;5;7;1364;0;675;550;125
3018;7;23215;5;7;287;0;171;150;21
3018;7;23232;5;7;280;0;164;129;35
3018;7;23233;5;7;295;0;188;164;24
3018;8;23192;5;8;406;0;247;223;24
3018;8;23204;5;8;331;0;161;127;34
3018;8;23242;5;8;252;0;123;111;12
3018;9;23217;5;9;1467;0;783;680;103
3018;9;23220;5;9;1028;2;490;402;88
3018;9;23230;5;9;184;0;123;97;26
3019;10;23290;2;10;837;0;321;241;80
3019;10;23293;2;10;2030;0;984;904;80
3019;11;23275;2;11;2087;1;828;749;79
3019;11;23295;2;11;23;0;1;1;0
3019;12;23311;2;12;2088;0;841;784;57
3019;1;23253;2;1;2174;1;1166;970;196
3019;1;23261;2;1;1263;1;744;608;136
3019;1;23264;2;1;1477;0;823;652;171
3019;1;23272;2;1;2209;0;812;812;0
3019;1;23274;2;1;1162;0;645;502;143
3019;1;23283;2;1;1031;0;590;465;125
3019;1;23296;2;1;822;0;382;327;55
3019;1;23304;2;1;1267;3;633;555;78
3019;1;23308;2;1;1420;0;874;706;168
3019;13;23250;2;13;1701;0;597;569;28
3019;14;23315;2;14;1966;0;777;740;37
3019;15;23243;2;15;1959;1;832;762;70
3019;16;23257;2;16;1707;0;670;637;33
3019;17;23267;2;17;1545;1;635;592;43
3019;18;23313;2;18;2095;0;897;830;67
3019;19;23300;2;19;2107;0;959;908;51
3019;20;23281;2;20;1504;0;615;558;57
3019;21;23282;2;21;1111;0;464;424;40
3019;22;23289;2;22;1282;0;577;535;42
3019;2;23252;2;2;930;1;459;395;64
3019;2;23270;2;2;1534;0;937;769;168
3019;2;23278;2;2;1470;0;702;551;151
3019;2;23286;2;2;2254;1;1448;1184;264
3019;2;23287;2;2;808;0;404;324;80
3019;2;23292;2;2;1244;0;675;452;223
3019;2;23312;2;2;822;0;548;414;134
3019;2;23314;2;2;1333;0;652;510;142
3019;2;23323;2;2;1997;0;819;761;58
3019;23;23299;2;23;1764;0;740;690;50
3019;24;23324;2;24;2263;0;1000;908;92
3019;25;23316;2;25;1377;0;546;503;43
3019;26;23310;2;26;1192;0;485;445;40
3019;27;23262;2;27;1949;0;754;697;57
3019;28;23294;2;28;1980;0;923;849;74
3019;29;23309;2;29;1790;0;756;715;41
3019;30;23317;2;30;2061;0;829;758;71
3019;31;23280;2;31;560;0;245;223;22
3019;32;23260;2;32;1971;0;931;854;77
3019;3;23245;2;3;1355;0;710;545;165
3019;3;23254;2;3;1602;0;809;713;96
3019;3;23255;2;3;1990;0;739;649;90
3019;3;23258;2;3;254;0;119;85;34
3019;3;23288;2;3;1002;0;576;454;122
3019;3;23291;2;3;1657;0;594;478;116
3019;3;23301;2;3;997;0;538;414;124
3019;3;23319;2;3;1817;0;959;783;176
3019;3;23320;2;3;611;0;347;286;61
3019;33;23256;2;33;1351;0;497;469;28
3019;34;23246;2;34;47;0;22;17;5
3019;35;23321;2;35;112;0;34;34;0
3019;4;23248;2;4;1131;0;557;469;88
3019;4;23259;2;4;688;1;409;268;141
3019;4;23268;2;4;2126;0;794;732;62
3019;4;23297;2;4;1462;0;703;577;126
3019;4;23306;2;4;1286;3;763;605;158
3019;4;23318;2;4;820;0;361;254;107
3019;4;23322;2;4;394;0;223;172;51
3019;5;23244;2;5;314;0;136;126;10
3019;5;23247;2;5;618;0;308;237;71
3019;5;23263;2;5;819;0;503;440;63
3019;5;23277;2;5;1426;0;686;536;150
3019;5;23298;2;5;1993;1;778;718;60
3019;5;23302;2;5;1563;0;651;499;152
3019;5;23307;2;5;668;1;394;317;77
3019;6;23265;2;6;1092;0;627;506;121
3019;6;23269;2;6;598;0;273;223;50
3019;6;23276;2;6;450;0;281;227;54
3019;6;23284;2;6;656;0;353;296;57
3019;6;23285;2;6;2060;0;834;765;69
3019;7;23251;2;7;424;0;160;128;32
3019;7;23273;2;7;1208;0;518;486;32
3019;7;23279;2;7;1299;0;692;599;93
3019;7;23303;2;7;726;0;352;311;41
3019;8;23249;2;8;2038;0;915;867;48
3019;8;23271;2;8;913;0;418;348;70
3019;9;23266;2;9;2373;0;990;908;82
3019;9;23305;2;9;727;1;415;349;66
3020;10;23354;5;10;994;1;558;493;65
3020;11;23351;5;11;1409;0;830;650;180
3020;12;23350;5;12;449;3;269;228;41
3020;1;23331;5;1;1192;5;844;628;216
3020;1;23340;5;1;2245;0;1063;830;233
3020;1;23356;5;1;1098;7;717;562;155
3020;1;23357;5;1;2056;1;1092;959;133
3020;1;23362;5;1;879;0;413;330;83
3020;1;23365;5;1;1020;1;601;476;125
3020;13;23344;5;13;460;0;296;232;64
3020;14;23325;5;14;461;0;233;191;42
3020;15;23366;5;15;380;0;188;160;28
3020;16;23355;5;16;508;0;260;206;54
3020;17;23358;5;17;634;0;307;238;69
3020;18;23337;5;18;707;0;401;322;79
3020;19;23374;5;19;496;0;246;201;45
3020;20;23326;5;20;555;1;275;244;31
3020;21;23341;5;21;1050;2;497;412;85
3020;22;23346;5;22;958;0;435;370;65
3020;2;23328;5;2;875;0;288;200;88
3020;2;23343;5;2;1395;1;704;602;102
3020;2;23347;5;2;795;0;504;370;134
3020;2;23363;5;2;1055;2;623;480;143
3020;2;23369;5;2;991;12;719;514;205
3020;2;23370;5;2;2003;4;1150;1011;139
3020;23;23339;5;23;661;0;321;253;68
3020;24;23360;5;24;505;0;305;248;57
3020;25;23359;5;25;1414;2;812;715;97
3020;26;23335;5;26;33;0;9;7;2
3020;3;23330;5;3;1606;1;868;762;106
3020;3;23336;5;3;1566;0;844;679;165
3020;3;23349;5;3;725;0;375;336;39
3020;3;23352;5;3;573;1;312;240;72
3020;3;23371;5;3;657;1;372;260;112
3020;3;23372;5;3;848;5;615;456;159
3020;4;23329;5;4;637;0;290;224;66
3020;4;23342;5;4;613;0;320;242;78
3020;4;23367;5;4;205;0;152;146;6
3020;4;23368;5;4;585;3;354;233;121
3020;4;23375;5;4;940;0;493;412;81
3020;5;23345;5;5;1020;0;537;448;89
3020;5;23361;5;5;749;0;441;317;124
3020;5;23364;5;5;1899;0;766;635;131
3020;6;23327;5;6;1686;3;1097;768;329
3020;6;23338;5;6;1260;0;413;321;92
3020;6;23376;5;6;833;1;421;363;58
3020;7;23333;5;7;441;0;224;185;39
3020;7;23353;5;7;1297;1;688;597;91
3020;7;23373;5;7;901;0;469;332;137
3020;8;23334;5;8;66;0;28;14;14
3020;8;23348;5;8;2249;1;1236;1101;135
3020;9;23332;5;9;1213;0;644;584;60
3021;10;23396;3;10;763;0;335;251;84
3021;10;23406;3;10;1739;0;683;628;55
3021;10;23428;3;10;366;0;205;184;21
3021;10;23432;3;10;1169;0;531;452;79
3021;10;23439;3;10;1769;0;928;814;114
3021;10;23446;3;10;1459;0;747;720;27
3021;10;23468;3;10;1640;0;605;534;71
3021;10;23471;3;10;2040;0;980;821;159
3021;10;23498;3;10;1623;0;721;661;60
3021;10;23539;3;10;1982;3;961;818;143
3021;10;23545;3;10;605;0;316;305;11
3021;11;23443;3;11;1672;0;779;672;107
3021;11;23455;3;11;1555;0;598;542;56
3021;11;23461;3;11;1348;1;718;595;123
3021;11;23489;3;11;1991;0;886;787;99
3021;11;23495;3;11;1002;4;567;474;93
3021;11;23500;3;11;1033;0;481;409;72
3021;11;23507;3;11;70;0;39;27;12
3021;11;23522;3;11;679;0;252;209;43
3021;11;23534;3;11;1710;1;719;593;126
3021;12;23386;3;12;24;0;1;1;0
3021;12;23430;3;12;600;0;278;227;51
3021;12;23482;3;12;1147;1;568;502;66
3021;12;23509;3;12;1707;2;751;683;68
3021;12;23538;3;12;1343;0;459;407;52
3021;1;23382;3;1;806;0;441;372;69
3021;1;23384;3;1;1327;0;688;597;91
3021;1;23391;3;1;1723;0;752;655;97
3021;1;23395;3;1;1001;0;533;482;51
3021;1;23401;3;1;2137;0;1065;1010;55
3021;1;23431;3;1;1868;0;828;733;95
3021;1;23436;3;1;1696;0;980;863;117
3021;1;23448;3;1;1879;0;991;881;110
3021;1;23453;3;1;1795;0;929;747;182
3021;1;23456;3;1;1755;1;896;789;107
3021;1;23460;3;1;994;0;395;321;74
3021;1;23463;3;1;1079;0;640;545;95
3021;1;23465;3;1;1545;1;900;786;114
3021;1;23488;3;1;1809;0;993;821;172
3021;1;23532;3;1;742;0;413;352;61
3021;1;23552;3;1;1168;2;547;485;62
3021;1;23554;3;1;765;0;247;194;53
3021;13;23400;3;13;864;0;458;394;64
3021;13;23433;3;13;1260;0;676;549;127
3021;13;23473;3;13;1774;0;799;671;128
3021;13;23497;3;13;2300;0;854;800;54
3021;14;23480;3;14;1398;1;748;659;89
3021;14;23494;3;14;634;0;329;259;70
3021;15;23475;3;15;1291;1;718;626;92
3021;15;23511;3;15;624;0;351;286;65
3021;16;23388;3;16;675;0;328;267;61
3021;16;23531;3;16;1476;0;741;641;100
3021;17;23402;3;17;747;1;368;329;39
3021;17;23405;3;17;504;0;302;219;83
3021;18;23381;3;18;1467;0;728;595;133
3021;18;23487;3;18;1991;0;914;820;94
3021;19;23414;3;19;1317;1;604;515;89
3021;19;23525;3;19;778;0;334;271;63
3021;20;23449;3;20;1254;0;604;529;75
3021;21;23394;3;21;1785;0;760;635;125
3021;22;23485;3;22;1201;0;563;504;59
3021;2;23378;3;2;1119;0;593;567;26
3021;2;23385;3;2;1472;0;684;611;73
3021;2;23389;3;2;753;1;415;333;82
3021;2;23398;3;2;557;0;224;179;45
3021;2;23403;3;2;1744;0;920;749;171
3021;2;23410;3;2;1980;1;972;854;118
3021;2;23417;3;2;1023;0;511;457;54
3021;2;23424;3;2;1026;0;560;481;79
3021;2;23425;3;2;2497;0;1358;1316;42
3021;2;23442;3;2;1688;0;923;818;105
3021;2;23444;3;2;1808;0;755;668;87
3021;2;23452;3;2;1374;0;856;713;143
3021;2;23467;3;2;2070;0;1099;985;114
3021;2;23496;3;2;1900;0;994;802;192
3021;2;23524;3;2;947;0;378;305;73
3021;2;23543;3;2;1757;1;942;841;101
3021;2;23547;3;2;1234;0;635;559;76
3021;23;23399;3;23;1323;0;572;517;55
3021;3;23379;3;3;1716;0;971;787;184
3021;3;23380;3;3;989;0;476;434;42
3021;3;23407;3;3;1093;2;577;529;48
3021;3;23411;3;3;1707;0;770;725;45
3021;3;23438;3;3;2098;2;990;891;99
3021;3;23440;3;3;694;3;279;234;45
3021;3;23447;3;3;1947;0;974;827;147
3021;3;23454;3;3;479;0;229;182;47
3021;3;23478;3;3;1375;1;739;574;165
3021;3;23481;3;3;1415;0;826;746;80
3021;3;23483;3;3;2089;0;1090;962;128
3021;3;23490;3;3;963;0;535;406;129
3021;3;23510;3;3;1913;0;976;821;155
3021;3;23512;3;3;2243;3;1298;1172;126
3021;3;23516;3;3;740;0;404;322;82
3021;3;23527;3;3;378;0;162;135;27
3021;3;23546;3;3;1604;0;791;722;69
3021;4;23390;3;4;1707;0;894;667;227
3021;4;23419;3;4;1593;0;739;677;62
3021;4;23422;3;4;1502;4;882;777;105
3021;4;23429;3;4;2233;0;1024;868;156
3021;4;23434;3;4;1043;0;449;364;85
3021;4;23451;3;4;1549;0;709;642;67
3021;4;23458;3;4;1671;2;719;662;57
3021;4;23470;3;4;1660;2;917;759;158
3021;4;23502;3;4;1515;1;837;657;180
3021;4;23508;3;4;925;0;464;399;65
3021;4;23514;3;4;2346;2;1200;1083;117
3021;4;23515;3;4;1855;0;824;688;136
3021;4;23517;3;4;888;0;405;355;50
3021;4;23535;3;4;2131;2;1159;946;213
3021;4;23541;3;4;917;0;436;381;55
3021;4;23549;3;4;840;0;372;287;85
3021;5;23387;3;5;1715;0;768;651;117
3021;5;23392;3;5;1348;3;784;636;148
3021;5;23408;3;5;1154;4;590;503;87
3021;5;23409;3;5;864;0;374;325;49
3021;5;23413;3;5;1987;0;854;743;111
3021;5;23416;3;5;1033;0;444;326;118
3021;5;23445;3;5;1528;0;579;449;130
3021;5;23459;3;5;1726;0;744;678;66
3021;5;23493;3;5;1461;0;834;738;96
3021;5;23518;3;5;1149;0;521;422;99
3021;5;23528;3;5;1564;0;699;543;156
3021;5;23533;3;5;1880;0;936;894;42
3021;5;23536;3;5;1640;0;709;627;82
3021;5;23542;3;5;764;0;337;266;71
3021;5;23553;3;5;2079;0;907;812;95
3021;6;23377;3;6;1604;0;621;572;49
3021;6;23383;3;6;1581;0;760;701;59
3021;6;23412;3;6;1529;0;736;675;61
3021;6;23421;3;6;1106;0;493;380;113
3021;6;23427;3;6;1215;0;670;646;24
3021;6;23479;3;6;939;0;435;342;93
3021;6;23484;3;6;1806;0;886;803;83
3021;6;23499;3;6;1545;2;738;629;109
3021;6;23505;3;6;1472;0;811;701;110
3021;6;23506;3;6;1824;1;725;554;171
3021;6;23521;3;6;1640;0;898;782;116
3021;6;23529;3;6;1151;0;440;373;67
3021;6;23530;3;6;1704;1;791;623;168
3021;6;23540;3;6;1517;3;701;618;83
3021;6;23544;3;6;745;0;282;233;49
3021;7;23404;3;7;938;0;453;369;84
3021;7;23415;3;7;1336;0;777;686;91
3021;7;23423;3;7;1799;0;716;630;86
3021;7;23426;3;7;1256;0;620;601;19
3021;7;23464;3;7;1549;0;769;625;144
3021;7;23477;3;7;1469;0;725;651;74
3021;7;23492;3;7;2139;0;1133;1059;74
3021;7;23501;3;7;1808;0;760;674;86
3021;7;23513;3;7;1580;0;895;797;98
3021;7;23520;3;7;1107;0;480;369;111
3021;7;23548;3;7;1559;1;835;759;76
3021;7;23550;3;7;2266;0;915;754;161
3021;7;23551;3;7;972;0;413;346;67
3021;8;23393;3;8;760;0;297;273;24
3021;8;23418;3;8;1667;0;819;671;148
3021;8;23420;3;8;2234;0;949;836;113
3021;8;23435;3;8;2031;0;786;632;154
3021;8;23441;3;8;1474;0;778;693;85
3021;8;23457;3;8;691;0;382;296;86
3021;8;23462;3;8;2126;0;1102;987;115
3021;8;23472;3;8;1477;1;629;544;85
3021;8;23474;3;8;868;1;455;401;54
3021;8;23476;3;8;1427;0;661;606;55
3021;8;23486;3;8;615;0;305;264;41
3021;8;23491;3;8;1439;0;809;754;55
3021;9;23397;3;9;1746;0;687;569;118
3021;9;23437;3;9;1843;0;868;745;123
3021;9;23450;3;9;823;0;370;319;51
3021;9;23466;3;9;1580;0;717;664;53
3021;9;23469;3;9;1875;0;888;777;111
3021;9;23503;3;9;1775;0;759;688;71
3021;9;23504;3;9;852;0;433;371;62
3021;9;23519;3;9;2002;0;828;766;62
3021;9;23523;3;9;1107;1;529;459;70
3021;9;23526;3;9;1837;0;960;846;114
3021;9;23537;3;9;1961;2;796;707;89
3022;10;23561;6;10;1360;0;631;532;99
3022;11;23565;6;11;1569;0;573;445;128
3022;12;23575;6;12;713;0;334;279;55
3022;1;23559;6;1;1353;0;765;602;163
3022;1;23567;6;1;1555;1;993;719;274
3022;1;23569;6;1;1207;0;557;478;79
3022;1;23585;6;1;1212;1;748;603;145
3022;1;23586;6;1;1150;0;562;464;98
3022;13;23591;6;13;1246;0;537;428;109
3022;14;23592;6;14;785;0;374;280;94
3022;15;23587;6;15;1120;0;469;418;51
3022;16;23556;6;16;1367;0;628;540;88
3022;17;23558;6;17;35;0;7;6;1
3022;18;23583;6;18;22;0;5;5;0
3022;2;23562;6;2;1330;0;477;421;56
3022;2;23570;6;2;1236;0;755;576;179
3022;2;23574;6;2;629;0;310;237;73
3022;2;23576;6;2;1177;2;662;567;95
3022;2;23580;6;2;1560;1;772;556;216
3022;3;23560;6;3;1153;0;589;500;89
3022;3;23564;6;3;1024;0;480;367;113
3022;3;23568;6;3;1738;0;894;678;216
3022;3;23573;6;3;1511;0;614;541;73
3022;3;23581;6;3;1145;0;700;572;128
3022;4;23555;6;4;1260;0;623;468;155
3022;4;23557;6;4;656;0;325;252;73
3022;4;23572;6;4;1872;0;756;672;84
3022;4;23579;6;4;873;0;421;307;114
3022;4;23590;6;4;1260;1;546;455;91
3022;5;23563;6;5;2100;0;847;737;110
3022;5;23571;6;5;1017;0;546;385;161
3022;5;23582;6;5;902;0;393;264;129
3022;6;23566;6;6;1912;0;1072;779;293
3022;6;23577;6;6;1607;0;652;544;108
3022;6;23589;6;6;736;3;386;252;134
3022;7;23578;6;7;2068;0;857;748;109
3022;8;23584;6;8;1833;0;814;698;116
3022;9;23588;6;9;2135;0;938;810;128
3023;1;23604;4;1;858;0;487;417;70
3023;1;23611;4;1;1478;6;751;659;92
3023;1;23615;4;1;1304;3;723;613;110
3023;1;23619;4;1;2166;1;1099;780;319
3023;1;23624;4;1;2076;6;1312;1015;297
3023;1;23625;4;1;2364;1;1166;885;281
3023;1;23626;4;1;1086;12;870;683;187
3023;1;23627;4;1;1527;0;826;483;343
3023;2;23593;4;2;790;0;424;350;74
3023;2;23597;4;2;385;0;241;180;61
3023;2;23600;4;2;1399;0;651;548;103
3023;2;23610;4;2;2213;1;1320;1090;230
3023;2;23616;4;2;59;0;51;26;25
3023;2;23621;4;2;689;3;520;376;144
3023;2;23622;4;2;1244;1;581;437;144
3023;2;23623;4;2;2036;1;1037;800;237
3023;3;23596;4;3;2149;0;1125;945;180
3023;3;23599;4;3;1022;0;465;336;129
3023;3;23602;4;3;1538;0;861;672;189
3023;3;23608;4;3;612;0;237;164;73
3023;3;23617;4;3;330;0;227;172;55
3023;3;23620;4;3;1128;0;587;513;74
3023;3;23628;4;3;1829;1;848;633;215
3023;4;23595;4;4;1612;3;882;643;239
3023;4;23603;4;4;358;0;219;172;47
3023;4;23606;4;4;1892;0;905;785;120
3023;4;23612;4;4;1333;0;567;446;121
3023;4;23618;4;4;763;0;248;173;75
3023;4;23629;4;4;1416;0;704;588;116
3023;5;23594;4;5;1360;0;619;387;232
3023;5;23605;4;5;1426;0;752;606;146
3023;5;23607;4;5;1572;1;758;681;77
3023;5;23614;4;5;1171;0;470;343;127
3023;6;23598;4;6;1715;0;843;743;100
3023;6;23601;4;6;1201;0;590;508;82
3023;6;23609;4;6;82;0;58;33;25
3023;7;23630;4;7;1483;2;734;646;88
3023;8;23613;4;8;24;0;9;7;2
3024;10;23642;2;10;1660;0;912;758;154
3024;10;23653;2;10;969;0;478;425;53
3024;11;23650;2;11;2220;0;940;820;120
3024;11;23663;2;11;943;0;459;367;92
3024;12;23632;2;12;1376;0;711;563;148
3024;1;23635;2;1;1874;8;1243;882;361
3024;1;23651;2;1;2350;2;1522;1249;273
3024;1;23655;2;1;2241;4;1110;826;284
3024;1;23656;2;1;1965;1;872;733;139
3024;1;23662;2;1;2170;0;1179;1006;173
3024;1;23670;2;1;2041;0;1249;968;281
3024;1;23671;2;1;1490;0;842;696;146
3024;1;23679;2;1;1599;0;924;665;259
3024;13;23673;2;13;1747;0;809;645;164
3024;14;23674;2;14;1856;0;1100;897;203
3024;15;23666;2;15;1680;0;814;662;152
3024;16;23639;2;16;19;0;3;1;2
3024;17;23654;2;17;11;0;9;3;6
3024;2;23637;2;2;2280;1;1088;808;280
3024;2;23640;2;2;1825;1;970;802;168
3024;2;23644;2;2;1776;0;1002;719;283
3024;2;23645;2;2;689;0;310;233;77
3024;2;23649;2;2;2280;0;1154;1004;150
3024;2;23665;2;2;1167;0;566;438;128
3024;2;23675;2;2;2002;1;1017;860;157
3024;3;23634;2;3;540;0;243;189;54
3024;3;23638;2;3;1556;0;853;614;239
3024;3;23661;2;3;846;0;383;309;74
3024;3;23664;2;3;1704;0;1115;938;177
3024;3;23678;2;3;1141;0;430;363;67
3024;4;23636;2;4;723;0;331;258;73
3024;4;23647;2;4;1240;0;654;508;146
3024;4;23657;2;4;1144;0;647;498;149
3024;4;23668;2;4;782;2;372;308;64
3024;4;23677;2;4;1656;0;843;740;103
3024;5;23643;2;5;1590;2;898;668;230
3024;5;23648;2;5;647;0;241;179;62
3024;5;23652;2;5;1645;0;891;713;178
3024;5;23658;2;5;709;0;354;314;40
3024;6;23633;2;6;2008;9;1120;977;143
3024;6;23672;2;6;1061;7;517;458;59
3024;6;23676;2;6;1684;0;952;727;225
3024;7;23631;2;7;1099;0;559;423;136
3024;7;23641;2;7;1505;1;719;608;111
3024;7;23669;2;7;961;0;449;340;109
3024;8;23659;2;8;1285;0;660;556;104
3024;8;23667;2;8;1137;0;503;411;92
3024;9;23646;2;9;1745;1;898;792;106
3024;9;23660;2;9;764;0;369;265;104
3025;10;23692;3;10;1680;0;901;728;173
3025;11;23700;3;11;1370;0;747;626;121
3025;12;23695;3;12;1979;0;800;688;112
3025;1;23681;3;1;1405;0;619;474;145
3025;1;23683;3;1;1030;0;688;520;168
3025;1;23690;3;1;1495;0;769;613;156
3025;1;23693;3;1;1222;0;570;461;109
3025;1;23705;3;1;1420;0;683;509;174
3025;13;23702;3;13;1281;0;554;480;74
3025;14;23687;3;14;1137;0;461;364;97
3025;15;23710;3;15;1420;0;703;545;158
3025;16;23680;3;16;919;0;420;341;79
3025;17;23689;3;17;18;0;3;3;0
3025;18;23713;3;18;12;0;12;8;4
3025;2;23698;3;2;1811;0;953;801;152
3025;2;23701;3;2;1433;0;687;538;149
3025;2;23707;3;2;655;0;386;320;66
3025;2;23708;3;2;1694;0;709;554;155
3025;2;23712;3;2;2014;0;1311;1054;257
3025;3;23686;3;3;1591;0;879;689;190
3025;3;23699;3;3;579;0;304;234;70
3025;3;23703;3;3;765;0;321;227;94
3025;3;23706;3;3;1056;2;558;434;124
3025;3;23709;3;3;1719;0;680;565;115
3025;4;23684;3;4;1594;0;851;730;121
3025;4;23691;3;4;1500;0;889;723;166
3025;4;23696;3;4;920;0;389;292;97
3025;4;23704;3;4;854;0;338;262;76
3025;5;23685;3;5;2013;0;1110;923;187
3025;5;23711;3;5;1446;2;642;485;157
3025;6;23682;3;6;1626;0;858;708;150
3025;7;23697;3;7;1666;0;975;833;142
3025;8;23688;3;8;1649;0;878;727;151
3025;9;23694;3;9;1181;0;543;433;110
3026;10;23737;3;10;2220;0;942;798;144
3026;11;23738;3;11;1882;0;779;698;81
3026;12;23729;3;12;1926;0;806;675;131
3026;1;23719;3;1;1461;0;660;579;81
3026;1;23724;3;1;1287;0;712;576;136
3026;1;23745;3;1;2148;0;1211;951;260
3026;1;23746;3;1;2210;0;1068;710;358
3026;13;23733;3;13;1720;0;841;726;115
3026;14;23716;3;14;1001;0;392;330;62
3026;15;23731;3;15;859;0;365;290;75
3026;16;23743;3;16;787;0;289;241;48
3026;17;23732;3;17;1469;0;595;526;69
3026;18;23721;3;18;924;0;425;346;79
3026;19;23727;3;19;1034;0;443;355;88
3026;20;23715;3;20;1305;0;415;342;73
3026;21;23734;3;21;1077;0;447;383;64
3026;22;23741;3;22;1360;1;555;473;82
3026;2;23714;3;2;1460;1;702;562;140
3026;2;23717;3;2;946;0;554;437;117
3026;2;23739;3;2;1568;0;650;498;152
3026;2;23744;3;2;883;0;377;275;102
3026;23;23747;3;23;61;0;31;26;5
3026;24;23735;3;24;90;0;52;46;6
3026;25;23723;3;25;68;0;37;30;7
3026;26;23736;3;26;51;0;16;15;1
3026;3;23725;3;3;637;0;277;200;77
3026;3;23730;3;3;1883;0;846;754;92
3026;3;23740;3;3;1016;0;513;411;102
3026;3;23751;3;3;1788;0;696;532;164
3026;4;23720;3;4;890;0;394;286;108
3026;4;23728;3;4;579;0;354;270;84
3026;4;23748;3;4;1008;0;476;342;134
3026;4;23749;3;4;1625;0;658;565;93
3026;5;23742;3;5;1796;0;807;692;115
3026;6;23718;3;6;1198;0;470;416;54
3026;7;23750;3;7;1558;1;661;581;80
3026;8;23722;3;8;1773;1;806;706;100
3026;9;23726;3;9;1437;0;614;537;77
3027;10;23766;4;10;2027;1;1000;877;123
3027;11;23768;4;11;1823;0;835;722;113
3027;12;23800;4;12;1581;0;687;601;86
3027;1;23756;4;1;889;0;476;356;120
3027;1;23760;4;1;1920;9;1196;887;309
3027;1;23769;4;1;1544;2;1046;796;250
3027;1;23772;4;1;958;3;573;423;150
3027;1;23774;4;1;951;1;613;463;150
3027;1;23775;4;1;1345;0;622;509;113
3027;1;23776;4;1;1951;1;1068;876;192
3027;1;23782;4;1;1989;1;822;740;82
3027;1;23798;4;1;1468;0;832;685;147
3027;13;23794;4;13;1134;0;504;432;72
3027;14;23804;4;14;41;0;18;14;4
3027;2;23752;4;2;1155;0;637;522;115
3027;2;23767;4;2;1978;2;909;800;109
3027;2;23785;4;2;862;0;543;418;125
3027;2;23788;4;2;1062;3;743;559;184
3027;2;23790;4;2;1345;5;945;774;171
3027;2;23795;4;2;1322;0;604;455;149
3027;2;23797;4;2;800;1;428;353;75
3027;2;23803;4;2;1293;1;677;498;179
3027;2;23807;4;2;842;1;585;494;91
3027;3;23753;4;3;416;1;314;220;94
3027;3;23757;4;3;231;0;170;131;39
3027;3;23764;4;3;915;0;524;403;121
3027;3;23773;4;3;525;0;281;222;59
3027;3;23778;4;3;724;0;421;331;90
3027;3;23787;4;3;1529;2;558;499;59
3027;3;23789;4;3;1379;1;669;528;141
3027;3;23791;4;3;2111;2;1253;989;264
3027;3;23808;4;3;834;0;371;277;94
3027;4;23754;4;4;1403;0;737;564;173
3027;4;23765;4;4;909;0;554;436;118
3027;4;23770;4;4;1013;2;652;492;160
3027;4;23771;4;4;1392;0;772;667;105
3027;4;23781;4;4;2181;1;1119;953;166
3027;4;23793;4;4;1408;3;896;710;186
3027;4;23796;4;4;899;0;551;446;105
3027;4;23802;4;4;682;0;284;250;34
3027;5;23755;4;5;1657;0;807;715;92
3027;5;23759;4;5;588;0;367;277;90
3027;5;23763;4;5;406;0;191;152;39
3027;5;23786;4;5;406;0;200;169;31
3027;5;23801;4;5;1850;4;1030;883;147
3027;5;23806;4;5;557;0;265;216;49
3027;6;23758;4;6;743;1;446;353;93
3027;6;23761;4;6;707;5;469;367;102
3027;6;23780;4;6;634;0;364;302;62
3027;6;23783;4;6;391;0;185;160;25
3027;6;23784;4;6;822;0;496;380;116
3027;6;23792;4;6;2061;2;1035;940;95
3027;7;23762;4;7;814;0;394;334;60
3027;7;23777;4;7;2073;1;935;829;106
3027;7;23799;4;7;900;8;634;525;109
3027;8;23805;4;8;2019;0;979;865;114
3027;9;23779;4;9;1972;0;930;804;126
3028;10;23839;2;10;1842;0;780;718;62
3028;11;23809;2;11;33;0;6;6;0
3028;1;23814;2;1;1795;0;861;648;213
3028;1;23819;2;1;1737;0;646;539;107
3028;1;23827;2;1;1847;1;1096;937;159
3028;1;23835;2;1;1364;0;635;582;53
3028;1;23836;2;1;1911;1;973;880;93
3028;1;23845;2;1;2090;0;970;897;73
3028;1;23851;2;1;1929;2;1252;1008;244
3028;2;23812;2;2;530;0;275;216;59
3028;2;23824;2;2;1841;0;780;725;55
3028;2;23829;2;2;340;0;148;118;30
3028;2;23837;2;2;1296;0;617;545;72
3028;2;23838;2;2;669;0;255;237;18
3028;2;23849;2;2;2079;0;865;791;74
3028;2;23850;2;2;1827;1;1097;949;148
3028;3;23813;2;3;1281;3;573;506;67
3028;3;23817;2;3;596;0;165;147;18
3028;3;23825;2;3;845;0;505;459;46
3028;3;23830;2;3;1436;1;710;602;108
3028;3;23834;2;3;2091;1;943;839;104
3028;3;23848;2;3;1885;0;871;717;154
3028;4;23811;2;4;1128;0;435;361;74
3028;4;23815;2;4;277;0;141;122;19
3028;4;23816;2;4;2394;0;1082;987;95
3028;4;23820;2;4;712;0;408;334;74
3028;4;23823;2;4;1049;0;411;333;78
3028;4;23826;2;4;551;0;306;261;45
3028;5;23821;2;5;465;0;281;229;52
3028;5;23828;2;5;563;0;172;153;19
3028;5;23831;2;5;1734;0;798;693;105
3028;5;23833;2;5;861;0;366;305;61
3028;5;23842;2;5;1651;0;501;410;91
3028;6;23818;2;6;2402;1;993;903;90
3028;6;23822;2;6;506;0;308;257;51
3028;6;23832;2;6;1027;0;432;354;78
3028;6;23844;2;6;531;0;191;156;35
3028;7;23840;2;7;391;0;191;151;40
3028;7;23841;2;7;675;0;251;225;26
3028;7;23846;2;7;1429;0;563;490;73
3028;7;23847;2;7;483;0;102;89;13
3028;8;23810;2;8;1635;0;719;673;46
3028;9;23843;2;9;2314;1;1093;947;146
3029;10;23876;6;10;906;0;398;316;82
3029;11;23859;6;11;1445;0;836;640;196
3029;12;23861;6;12;1039;0;498;391;107
3029;1;23852;6;1;1466;0;831;673;158
3029;1;23856;6;1;777;0;388;337;51
3029;1;23883;6;1;1483;3;958;687;271
3029;13;23860;6;13;1023;0;507;419;88
3029;14;23871;6;14;571;0;328;287;41
3029;15;23887;6;15;443;0;228;193;35
3029;16;23875;6;16;601;0;315;232;83
3029;17;23882;6;17;704;0;305;251;54
3029;18;23878;6;18;557;0;291;192;99
3029;19;23858;6;19;1112;0;521;413;108
3029;20;23881;6;20;1654;0;849;642;207
3029;21;23886;6;21;85;0;63;63;0
3029;22;23884;6;22;45;0;16;14;2
3029;2;23863;6;2;682;0;405;286;119
3029;2;23865;6;2;1471;0;671;569;102
3029;2;23866;6;2;1516;0;749;576;173
3029;3;23867;6;3;1191;0;621;520;101
3029;3;23870;6;3;885;0;424;306;118
3029;3;23885;6;3;1528;0;780;632;148
3029;4;23862;6;4;2106;0;1062;885;177
3029;4;23869;6;4;2048;0;1184;934;250
3029;4;23888;6;4;1432;0;682;414;268
3029;5;23872;6;5;1679;0;908;753;155
3029;5;23873;6;5;2049;0;1002;743;259
3029;5;23879;6;5;1555;0;753;689;64
3029;6;23853;6;6;1877;2;917;818;99
3029;6;23857;6;6;1566;0;793;645;148
3029;6;23868;6;6;1034;0;599;449;150
3029;7;23854;6;7;1145;0;475;420;55
3029;7;23864;6;7;1132;0;539;466;73
3029;7;23880;6;7;1406;0;726;537;189
3029;8;23855;6;8;1125;0;496;427;69
3029;8;23874;6;8;623;0;332;236;96
3029;9;23877;6;9;1699;0;826;616;210
3030;10;23893;3;10;1848;0;782;719;63
3030;11;23932;3;11;1643;0;635;635;0
3030;12;23897;3;12;1720;0;784;695;89
3030;1;23908;3;1;1321;3;767;639;128
3030;1;23915;3;1;2010;0;968;818;150
3030;1;23928;3;1;1274;0;787;719;68
3030;1;23929;3;1;1796;0;588;535;53
3030;1;23933;3;1;1838;0;996;844;152
3030;13;23935;3;13;1800;0;651;543;108
3030;14;23904;3;14;2177;0;850;775;75
3030;15;23891;3;15;784;0;295;252;43
3030;16;23911;3;16;1366;0;408;356;52
3030;17;23894;3;17;831;0;265;236;29
3030;18;23895;3;18;1008;0;415;358;57
3030;19;23900;3;19;1067;0;390;366;24
3030;20;23924;3;20;1408;0;507;455;52
3030;21;23892;3;21;1005;0;389;357;32
3030;22;23898;3;22;881;0;309;265;44
3030;2;23889;3;2;1613;2;898;774;124
3030;2;23916;3;2;1304;0;642;531;111
3030;2;23920;3;2;1876;2;936;736;200
3030;2;23922;3;2;1446;0;539;514;25
3030;2;23923;3;2;1402;1;540;464;76
3030;23;23931;3;23;2068;0;792;704;88
3030;24;23905;3;24;633;0;236;204;32
3030;25;23901;3;25;1031;0;392;355;37
3030;26;23921;3;26;24;0;2;2;0
3030;27;23906;3;27;21;0;6;5;1
3030;3;23899;3;3;595;0;309;257;52
3030;3;23910;3;3;513;0;311;266;45
3030;3;23918;3;3;1837;0;733;686;47
3030;3;23926;3;3;799;0;314;242;72
3030;3;23934;3;3;720;0;350;274;76
3030;4;23890;3;4;773;2;431;352;79
3030;4;23907;3;4;1418;0;665;600;65
3030;4;23913;3;4;956;0;435;322;113
3030;4;23927;3;4;940;0;478;428;50
3030;4;23936;3;4;1871;0;922;709;213
3030;5;23896;3;5;707;0;279;224;55
3030;5;23912;3;5;2145;0;1005;929;76
3030;5;23914;3;5;661;0;288;220;68
3030;5;23930;3;5;718;0;308;270;38
3030;6;23902;3;6;843;0;285;243;42
3030;6;23919;3;6;707;0;385;298;87
3030;6;23925;3;6;1167;0;540;502;38
3030;7;23909;3;7;1293;0;498;443;55
3030;7;23937;3;7;947;0;435;337;98
3030;8;23917;3;8;1111;0;425;386;39
3030;9;23903;3;9;2074;0;904;844;60
3031;10;23978;2;10;4;0;2;0;2
3031;1;23940;2;1;1175;3;712;607;105
3031;1;23945;2;1;1300;0;841;651;190
3031;1;23947;2;1;1652;0;1037;756;281
3031;1;23957;2;1;551;0;278;229;49
3031;1;23962;2;1;2187;0;1072;755;317
3031;1;23970;2;1;2080;1;1090;984;106
3031;1;23976;2;1;2058;0;967;746;221
3031;1;23981;2;1;1912;3;1094;900;194
3031;2;23938;2;2;1737;0;985;837;148
3031;2;23950;2;2;1929;2;1217;969;248
3031;2;23952;2;2;1542;0;712;557;155
3031;2;23953;2;2;1689;0;908;678;230
3031;2;23954;2;2;1962;0;941;848;93
3031;2;23958;2;2;301;0;201;157;44
3031;2;23964;2;2;1278;0;572;497;75
3031;2;23979;2;2;973;0;473;429;44
3031;3;23942;2;3;526;0;272;232;40
3031;3;23948;2;3;2163;1;1103;915;188
3031;3;23955;2;3;480;1;250;162;88
3031;3;23956;2;3;2114;1;1063;932;131
3031;3;23959;2;3;998;0;512;408;104
3031;3;23963;2;3;454;1;237;200;37
3031;3;23974;2;3;1362;0;787;658;129
3031;3;23977;2;3;504;0;279;205;74
3031;4;23939;2;4;720;0;382;290;92
3031;4;23941;2;4;1237;0;679;608;71
3031;4;23946;2;4;961;1;406;337;69
3031;4;23960;2;4;1111;0;508;442;66
3031;4;23961;2;4;1586;0;688;576;112
3031;4;23969;2;4;1211;0;558;454;104
3031;4;23971;2;4;1929;0;1012;875;137
3031;5;23944;2;5;1291;0;650;464;186
3031;5;23965;2;5;563;0;287;205;82
3031;5;23966;2;5;938;0;410;342;68
3031;5;23967;2;5;1806;2;828;673;155
3031;5;23973;2;5;809;0;404;336;68
3031;6;23943;2;6;1102;0;500;400;100
3031;6;23980;2;6;1925;0;952;875;77
3031;6;23982;2;6;1017;0;551;383;168
3031;7;23949;2;7;414;0;208;172;36
3031;7;23951;2;7;2178;0;1162;1042;120
3031;8;23972;2;8;1027;0;421;362;59
3031;8;23975;2;8;411;0;245;167;78
3031;9;23968;2;9;28;0;22;16;6
3061;10;24034;5;10;983;1;416;387;29
3061;11;24024;5;11;1481;0;587;537;50
3061;12;24019;5;12;2095;0;893;829;64
3061;1;24009;5;1;1587;0;572;518;54
3061;13;24031;5;13;1676;0;660;606;54
3061;14;23984;5;14;1265;2;506;463;43
3061;15;23998;5;15;2290;0;966;908;58
3061;16;24030;5;16;2133;0;879;814;65
3061;17;24029;5;17;1851;0;580;526;54
3061;18;24013;5;18;1918;0;704;652;52
3061;19;23990;5;19;2339;0;1024;952;72
3061;20;24023;5;20;1170;0;499;470;29
3061;21;24014;5;21;1740;0;760;699;61
3061;22;24012;5;22;1656;0;817;765;52
3061;2;24011;5;2;1343;0;473;427;46
3061;23;24033;5;23;2193;0;1097;1047;50
3061;24;23983;5;24;2022;0;1020;943;77
3061;25;24008;5;25;2105;0;979;892;87
3061;26;24027;5;26;1708;0;769;707;62
3061;27;23999;5;27;1806;0;688;603;85
3061;28;24032;5;28;1756;2;757;707;50
3061;29;24003;5;29;1960;0;775;718;57
3061;30;24022;5;30;1891;0;841;799;42
3061;31;24025;5;31;1640;0;694;637;57
3061;32;24016;5;32;2069;0;919;819;100
3061;3;24026;5;3;1446;2;507;448;59
3061;33;24021;5;33;2013;0;884;796;88
3061;34;24035;5;34;2395;0;1206;1147;59
3061;35;24002;5;35;1167;0;385;355;30
3061;36;24036;5;36;2147;0;897;835;62
3061;37;23989;5;37;1859;0;747;702;45
3061;38;24001;5;38;2015;0;879;816;63
3061;39;24006;5;39;889;0;359;330;29
3061;40;23985;5;40;2382;0;1106;1056;50
3061;41;24005;5;41;1098;0;566;523;43
3061;42;23988;5;42;834;0;307;285;22
3061;4;24004;5;4;1642;0;673;585;88
3061;43;23986;5;43;1521;0;673;627;46
3061;44;24037;5;44;1800;4;666;666;0
3061;45;23992;5;45;902;0;431;408;23
3061;46;24017;5;46;656;0;298;281;17
3061;47;24007;5;47;1400;0;470;406;64
3061;48;24018;5;48;606;0;317;301;16
3061;49;23996;5;49;1477;0;618;580;38
3061;50;23991;5;50;1646;0;776;723;53
3061;51;23997;5;51;1043;0;451;410;41
3061;52;24010;5;52;87;0;17;16;1
3061;5;23987;5;5;1582;0;467;424;43
3061;53;24015;5;53;18;0;1;1;0
3061;54;23995;5;54;53;0;21;16;5
3061;55;24000;5;55;171;0;101;85;16
3061;6;23993;5;6;1936;0;620;555;65
3061;7;24020;5;7;1974;0;780;704;76
3061;8;24028;5;8;1657;0;531;531;0
3061;9;23994;5;9;2245;0;993;953;40
3062;10;24050;4;10;1718;0;690;661;29
3062;11;24063;4;11;1547;0;591;557;34
3062;12;24080;4;12;883;0;316;305;11
3062;1;24052;4;1;2043;0;726;670;56
3062;13;24068;4;13;1304;0;511;475;36
3062;14;24072;4;14;1329;0;511;481;30
3062;15;24042;4;15;1872;0;624;580;44
3062;16;24051;4;16;1019;0;362;341;21
3062;17;24049;4;17;891;0;337;295;42
3062;18;24064;4;18;2142;0;986;929;57
3062;19;24045;4;19;2000;0;1120;1083;37
3062;20;24062;4;20;1947;0;893;838;55
3062;21;24077;4;21;661;0;362;346;16
3062;22;24055;4;22;1445;1;576;527;49
3062;2;24066;4;2;1840;0;813;759;54
3062;23;24059;4;23;881;1;340;324;16
3062;24;24079;4;24;1440;0;554;510;44
3062;25;24071;4;25;2359;0;824;776;48
3062;26;24060;4;26;1830;0;783;746;37
3062;27;24039;4;27;1393;0;541;495;46
3062;28;24076;4;28;983;0;431;403;28
3062;29;24067;4;29;105;0;33;31;2
3062;30;24056;4;30;1660;0;606;575;31
3062;31;24057;4;31;1622;0;616;581;35
3062;32;24082;4;32;1182;0;453;412;41
3062;3;24058;4;3;2010;0;831;803;28
3062;33;24074;4;33;1559;0;602;573;29
3062;34;24038;4;34;1474;0;586;569;17
3062;35;24069;4;35;1036;0;441;402;39
3062;36;24083;4;36;1005;0;421;398;23
3062;37;24048;4;37;1821;0;756;710;46
3062;38;24040;4;38;1837;0;771;744;27
3062;39;24078;4;39;654;0;256;239;17
3062;40;24075;4;40;1297;0;535;494;41
3062;41;24061;4;41;2185;0;801;755;46
3062;42;24041;4;42;1975;0;801;755;46
3062;4;24070;4;4;936;0;444;428;16
3062;43;24065;4;43;1916;0;724;646;78
3062;44;24081;4;44;1649;0;507;467;40
3062;45;24043;4;45;21;0;15;12;3
3062;46;24047;4;46;18;0;9;9;0
3062;5;24053;4;5;883;0;327;308;19
3062;6;24046;4;6;1746;0;709;662;47
3062;7;24054;4;7;2084;0;989;913;76
3062;8;24044;4;8;1135;0;459;436;23
3062;9;24073;4;9;790;0;278;260;18
3063;10;24098;6;10;1675;2;719;651;68
3063;11;24088;6;11;1519;0;634;586;48
3063;12;24107;6;12;1101;0;435;398;37
3063;1;24110;6;1;96;0;38;36;2
3063;13;24102;6;13;1182;2;549;516;33
3063;14;24087;6;14;1443;1;584;535;49
3063;15;24089;6;15;1447;0;658;600;58
3063;16;24109;6;16;1103;0;490;458;32
3063;17;24092;6;17;1817;0;811;733;78
3063;18;24101;6;18;1520;0;644;573;71
3063;19;24108;6;19;1419;0;534;472;62
3063;20;24116;6;20;1521;0;531;473;58
3063;21;24112;6;21;1227;1;400;350;50
3063;22;24096;6;22;1324;0;455;385;70
3063;2;24084;6;2;2216;0;877;793;84
3063;23;24100;6;23;1640;0;504;431;73
3063;24;24090;6;24;1856;1;682;625;57
3063;25;24099;6;25;1479;0;689;636;53
3063;26;24104;6;26;1604;0;807;719;88
3063;27;24086;6;27;1799;0;769;676;93
3063;28;24097;6;28;1399;0;662;604;58
3063;29;24085;6;29;1768;0;756;687;69
3063;30;24106;6;30;1705;0;854;803;51
3063;31;24111;6;31;1633;0;697;638;59
3063;32;24094;6;32;1317;0;619;575;44
3063;3;24091;6;3;1851;1;776;725;51
3063;33;24114;6;33;2265;0;1003;872;131
3063;4;24105;6;4;1718;0;825;765;60
3063;5;24103;6;5;1772;0;687;631;56
3063;6;24115;6;6;2198;0;1015;937;78
3063;7;24113;6;7;1335;0;474;432;42
3063;8;24093;6;8;1698;0;741;691;50
3063;9;24095;6;9;1464;2;617;548;69
3064;100;24139;1;100;2274;0;958;909;49
3064;101;24409;1;101;1213;0;565;526;39
3064;102;24401;1;102;1572;0;676;652;24
3064;10;24179;1;10;1569;1;599;572;27
3064;103;24272;1;103;1746;0;705;684;21
3064;104;24323;1;104;1590;0;532;520;12
3064;105;24152;1;105;1323;0;567;552;15
3064;106;24303;1;106;1151;0;433;410;23
3064;107;24289;1;107;1721;0;701;679;22
3064;108;24284;1;108;1846;0;739;699;40
3064;109;24131;1;109;1755;0;685;658;27
3064;110;24181;1;110;1857;1;764;720;44
3064;111;24299;1;111;1327;0;573;549;24
3064;112;24319;1;112;1465;0;589;565;24
3064;11;24327;1;11;1594;0;398;359;39
3064;113;24196;1;113;1608;0;658;612;46
3064;114;24178;1;114;1720;0;747;710;37
3064;115;24235;1;115;1828;0;751;732;19
3064;116;24391;1;116;1386;0;492;461;31
3064;117;24227;1;117;1231;0;443;429;14
3064;118;24365;1;118;2085;0;971;930;41
3064;119;24221;1;119;1390;0;470;457;13
3064;120;24159;1;120;1088;0;446;435;11
3064;121;24288;1;121;1394;0;610;585;25
3064;122;24380;1;122;1783;0;718;696;22
3064;12;24382;1;12;936;2;272;250;22
3064;123;24146;1;123;1740;0;828;803;25
3064;1;24156;1;1;1525;0;374;316;58
3064;124;24128;1;124;1783;0;749;705;44
3064;125;24372;1;125;1691;0;683;646;37
3064;126;24416;1;126;1364;0;724;706;18
3064;127;24345;1;127;2350;0;991;939;52
3064;128;24261;1;128;1922;0;682;650;32
3064;129;24265;1;129;1327;0;517;493;24
3064;130;24213;1;130;1939;0;762;724;38
3064;131;24215;1;131;820;0;278;267;11
3064;132;24292;1;132;2105;0;1013;988;25
3064;13;24197;1;13;1248;0;398;377;21
3064;133;24313;1;133;2246;0;857;836;21
3064;134;24241;1;134;2249;0;909;880;29
3064;135;24145;1;135;1536;0;312;280;32
3064;136;24396;1;136;1636;0;386;336;50
3064;137;24207;1;137;1927;0;534;471;63
3064;138;24276;1;138;1392;0;488;468;20
3064;139;24247;1;139;1822;0;579;560;19
3064;140;24264;1;140;1238;0;495;443;52
3064;141;24203;1;141;1751;0;835;783;52
3064;142;24163;1;142;2368;0;877;840;37
3064;14;24136;1;14;1230;1;389;367;22
3064;143;24239;1;143;1788;0;746;715;31
3064;144;24188;1;144;1825;0;790;725;65
3064;145;24324;1;145;725;0;273;259;14
3064;146;24370;1;146;2020;0;775;726;49
3064;147;24258;1;147;1410;0;515;483;32
3064;148;24260;1;148;1752;0;734;676;58
3064;149;24321;1;149;1328;0;586;562;24
3064;150;24253;1;150;1562;0;714;662;52
3064;151;24399;1;151;1613;0;705;675;30
3064;152;24331;1;152;1535;0;602;578;24
3064;15;24333;1;15;2201;0;798;769;29
3064;153;24337;1;153;1761;0;698;669;29
3064;154;24192;1;154;1596;0;767;750;17
3064;155;24173;1;155;1719;0;785;741;44
3064;156;24388;1;156;2023;1;793;793;0
3064;157;24296;1;157;1781;0;722;683;39
3064;158;24220;1;158;1781;0;863;821;42
3064;159;24130;1;159;2040;0;882;861;21
3064;160;24295;1;160;1924;0;835;803;32
3064;161;24151;1;161;1547;0;690;661;29
3064;162;24164;1;162;1685;0;594;594;0
3064;16;24397;1;16;1747;0;534;515;19
3064;163;24316;1;163;1775;0;738;705;33
3064;164;24138;1;164;1066;0;411;392;19
3064;165;24126;1;165;1715;1;741;705;36
3064;166;24243;1;166;1297;0;565;545;20
3064;167;24340;1;167;1209;1;516;488;28
3064;168;24318;1;168;1321;0;588;567;21
3064;169;24204;1;169;1338;0;502;473;29
3064;170;24262;1;170;1319;0;505;480;25
3064;171;24341;1;171;1800;0;791;761;30
3064;172;24339;1;172;1498;2;637;602;35
3064;17;24209;1;17;1568;0;601;573;28
3064;173;24359;1;173;1385;0;605;576;29
3064;174;24240;1;174;2133;0;865;826;39
3064;175;24355;1;175;1755;0;670;620;50
3064;176;24226;1;176;1505;0;645;623;22
3064;177;24328;1;177;1583;0;634;601;33
3064;178;24358;1;178;1627;0;706;659;47
3064;179;24309;1;179;1670;0;720;679;41
3064;180;24183;1;180;1857;0;781;737;44
3064;181;24245;1;181;2306;0;837;807;30
3064;182;24402;1;182;2163;0;785;757;28
3064;18;24223;1;18;1703;0;509;487;22
3064;183;24325;1;183;1994;0;766;735;31
3064;184;24144;1;184;2070;0;749;720;29
3064;185;24387;1;185;2016;0;801;758;43
3064;186;24344;1;186;1042;0;340;319;21
3064;187;24305;1;187;1372;0;362;336;26
3064;188;24330;1;188;1436;0;496;456;40
3064;189;24357;1;189;1514;0;635;605;30
3064;190;24301;1;190;1576;0;618;574;44
3064;191;24251;1;191;1794;0;527;478;49
3064;192;24185;1;192;1478;0;516;499;17
3064;19;24378;1;19;1190;0;333;307;26
3064;193;24403;1;193;2185;0;905;850;55
3064;194;24404;1;194;1412;0;561;517;44
3064;195;24255;1;195;1165;0;448;432;16
3064;196;24182;1;196;1238;0;491;467;24
3064;197;24287;1;197;1104;0;487;451;36
3064;198;24368;1;198;1386;0;555;519;36
3064;199;24180;1;199;1588;0;653;639;14
3064;200;24408;1;200;667;0;248;236;12
3064;201;24293;1;201;1926;0;581;565;16
3064;202;24230;1;202;975;0;314;298;16
3064;20;24363;1;20;1188;1;409;388;21
3064;203;24208;1;203;1945;0;813;790;23
3064;204;24360;1;204;1852;0;643;620;23
3064;205;24195;1;205;1127;0;578;560;18
3064;206;24373;1;206;1161;0;482;478;4
3064;207;24410;1;207;2046;0;690;655;35
3064;208;24314;1;208;1786;0;738;700;38
3064;209;24225;1;209;1762;0;525;489;36
3064;210;24348;1;210;1286;0;398;363;35
3064;211;24392;1;211;1329;0;375;375;0
3064;212;24222;1;212;1205;0;447;427;20
3064;21;24133;1;21;1185;0;351;338;13
3064;213;24291;1;213;1056;0;316;296;20
3064;214;24122;1;214;1394;0;492;461;31
3064;215;24228;1;215;1358;0;517;489;28
3064;216;24153;1;216;2132;0;923;875;48
3064;217;24383;1;217;1208;0;464;448;16
3064;218;24406;1;218;1503;0;572;572;0
3064;219;24298;1;219;820;0;480;473;7
3064;220;24367;1;220;2130;0;985;956;29
3064;221;24161;1;221;1379;0;642;626;16
3064;222;24384;1;222;1705;0;681;592;89
3064;22;24320;1;22;1701;0;720;665;55
3064;223;24211;1;223;1541;0;686;648;38
3064;2;24172;1;2;1244;0;332;315;17
3064;224;24118;1;224;1507;0;506;497;9
3064;225;24198;1;225;1136;0;487;470;17
3064;226;24306;1;226;1013;0;458;445;13
3064;227;24157;1;227;1758;0;756;718;38
3064;228;24168;1;228;2038;0;854;826;28
3064;229;24119;1;229;1842;0;858;832;26
3064;230;24393;1;230;2089;0;858;828;30
3064;231;24229;1;231;2352;0;1056;1027;29
3064;232;24259;1;232;1797;0;532;488;44
3064;23;24160;1;23;1438;0;381;381;0
3064;233;24155;1;233;1377;1;566;551;15
3064;234;24238;1;234;1780;0;649;617;32
3064;235;24361;1;235;1874;0;758;727;31
3064;236;24186;1;236;1793;0;857;828;29
3064;237;24356;1;237;1837;0;964;926;38
3064;238;24304;1;238;1475;0;756;740;16
3064;239;24216;1;239;1977;0;871;833;38
3064;240;24212;1;240;2023;0;794;773;21
3064;241;24120;1;241;1966;0;807;778;29
3064;242;24374;1;242;586;0;389;378;11
3064;24;24405;1;24;1899;0;521;487;34
3064;243;24395;1;243;2119;2;859;812;47
3064;244;24379;1;244;1928;0;753;724;29
3064;245;24350;1;245;2158;0;923;854;69
3064;246;24231;1;246;1555;0;755;731;24
3064;247;24158;1;247;1616;0;612;590;22
3064;248;24234;1;248;1171;0;471;449;22
3064;249;24326;1;249;2248;0;928;887;41
3064;250;24377;1;250;1681;0;601;581;20
3064;251;24254;1;251;1788;0;897;872;25
3064;252;24149;1;252;2293;1;969;926;43
3064;25;24199;1;25;1560;0;383;366;17
3064;253;24257;1;253;2010;0;815;748;67
3064;254;24219;1;254;2395;0;926;878;48
3064;255;24129;1;255;2471;0;964;910;54
3064;256;24294;1;256;2148;0;862;826;36
3064;257;24290;1;257;2081;0;824;803;21
3064;258;24343;1;258;2187;0;1026;980;46
3064;259;24280;1;259;2173;0;941;907;34
3064;260;24224;1;260;1827;0;784;745;39
3064;261;24271;1;261;2235;0;922;884;38
3064;262;24273;1;262;2207;0;984;943;41
3064;26;24307;1;26;1135;0;337;316;21
3064;263;24218;1;263;1987;0;790;752;38
3064;264;24210;1;264;1676;0;594;574;20
3064;265;24124;1;265;1922;0;778;738;40
3064;266;24412;1;266;2147;0;852;829;23
3064;267;24282;1;267;2239;0;930;889;41
3064;268;24407;1;268;2301;0;1013;958;55
3064;269;24300;1;269;2022;0;848;802;46
3064;270;24189;1;270;1642;0;994;962;32
3064;271;24117;1;271;43;0;19;18;1
3064;272;24190;1;272;10;0;8;8;0
3064;27;24236;1;27;1562;0;389;369;20
3064;273;24411;1;273;21;0;10;10;0
3064;274;24237;1;274;82;0;30;24;6
3064;275;24141;1;275;200;0;76;60;16
3064;276;24142;1;276;97;0;34;30;4
3064;277;24232;1;277;62;0;35;35;0
3064;278;24162;1;278;45;0;23;23;0
3064;279;24274;1;279;19;0;3;3;0
3064;280;24334;1;280;94;0;34;31;3
3064;281;24275;1;281;65;0;23;22;1
3064;282;24263;1;282;86;0;24;24;0
3064;28;24148;1;28;1445;0;523;494;29
3064;283;24342;1;283;130;0;38;33;5
3064;284;24166;1;284;45;0;26;24;2
3064;285;24193;1;285;18;0;12;12;0
3064;286;24147;1;286;15;0;6;6;0
3064;287;24278;1;287;108;0;63;51;12
3064;288;24281;1;288;198;0;42;38;4
3064;289;24371;1;289;38;0;20;16;4
3064;290;24322;1;290;87;0;37;27;10
3064;291;24364;1;291;56;0;17;16;1
3064;292;24134;1;292;114;0;39;33;6
3064;29;24362;1;29;1002;0;298;274;24
3064;293;24283;1;293;72;0;46;44;2
3064;294;24256;1;294;18;0;5;3;2
3064;295;24242;1;295;63;0;45;43;2
3064;296;24121;1;296;68;0;29;17;12
3064;297;24150;1;297;83;0;38;37;1
3064;298;24390;1;298;51;0;18;13;5
3064;299;24398;1;299;52;0;27;24;3
3064;300;24123;1;300;38;0;22;18;4
3064;30;24400;1;30;891;0;279;266;13
3064;31;24154;1;31;1439;0;524;501;23
3064;32;24135;1;32;1255;0;364;351;13
3064;3;24285;1;3;1318;0;334;308;26
3064;33;24177;1;33;1429;1;499;475;24
3064;34;24140;1;34;1581;0;611;550;61
3064;35;24248;1;35;1244;0;414;395;19
3064;36;24335;1;36;1333;1;433;418;15
3064;37;24184;1;37;1320;0;480;457;23
3064;38;24312;1;38;1144;0;481;451;30
3064;39;24366;1;39;1460;0;574;534;40
3064;40;24375;1;40;1109;0;359;332;27
3064;41;24354;1;41;2152;0;852;805;47
3064;42;24206;1;42;1781;0;457;435;22
3064;4;24244;1;4;1462;0;461;426;35
3064;43;24308;1;43;2393;0;850;821;29
3064;44;24270;1;44;2348;0;955;921;34
3064;45;24250;1;45;1386;0;444;423;21
3064;46;24170;1;46;1609;1;556;556;0
3064;47;24246;1;47;2094;0;849;827;22
3064;48;24266;1;48;1169;0;498;471;27
3064;49;24132;1;49;1285;0;407;390;17
3064;50;24171;1;50;1832;0;688;638;50
3064;51;24249;1;51;1195;0;465;439;26
3064;52;24386;1;52;1707;0;583;550;33
3064;5;24286;1;5;1502;0;644;600;44
3064;53;24277;1;53;1502;0;580;563;17
3064;54;24317;1;54;884;0;324;304;20
3064;55;24329;1;55;918;0;317;303;14
3064;56;24352;1;56;1297;0;343;317;26
3064;57;24233;1;57;1186;0;454;430;24
3064;58;24205;1;58;1004;0;346;328;18
3064;59;24279;1;59;936;0;373;356;17
3064;60;24268;1;60;1256;0;497;491;6
3064;61;24267;1;61;1920;1;643;594;49
3064;62;24137;1;62;1220;0;560;530;30
3064;6;24376;1;6;1544;0;450;394;56
3064;63;24175;1;63;1602;0;407;371;36
3064;64;24125;1;64;1168;0;325;307;18
3064;65;24369;1;65;1849;1;503;466;37
3064;66;24311;1;66;1794;0;471;451;20
3064;67;24394;1;67;591;0;203;187;16
3064;68;24385;1;68;1194;0;321;312;9
3064;69;24297;1;69;640;0;211;201;10
3064;70;24413;1;70;1576;0;544;517;27
3064;71;24302;1;71;967;0;335;328;7
3064;72;24252;1;72;1681;0;644;613;31
3064;7;24414;1;7;1474;0;375;346;29
3064;73;24351;1;73;793;1;242;224;18
3064;74;24176;1;74;1098;0;370;347;23
3064;75;24415;1;75;876;0;276;265;11
3064;76;24389;1;76;844;0;289;273;16
3064;77;24315;1;77;1628;0;407;385;22
3064;78;24381;1;78;1339;0;316;294;22
3064;79;24336;1;79;1739;0;614;575;39
3064;80;24191;1;80;1201;0;316;299;17
3064;81;24201;1;81;1138;0;289;255;34
3064;82;24269;1;82;1566;0;500;478;22
3064;8;24200;1;8;1811;2;577;510;67
3064;83;24353;1;83;1256;0;390;370;20
3064;84;24338;1;84;1894;0;751;726;25
3064;85;24165;1;85;1038;0;375;361;14
3064;86;24214;1;86;1127;1;286;267;19
3064;87;24349;1;87;2110;0;641;582;59
3064;88;24174;1;88;1825;0;680;669;11
3064;89;24127;1;89;1958;0;632;598;34
3064;90;24167;1;90;1752;0;867;837;30
3064;91;24194;1;91;1576;0;825;803;22
3064;92;24187;1;92;1303;0;586;565;21
3064;9;24169;1;9;1383;0;407;376;31
3064;93;24346;1;93;2132;0;928;890;38
3064;94;24202;1;94;2301;0;715;697;18
3064;95;24347;1;95;1330;0;556;532;24
3064;96;24310;1;96;1702;0;693;655;38
3064;97;24217;1;97;1491;0;675;660;15
3064;98;24332;1;98;1234;0;471;439;32
3064;99;24143;1;99;1482;0;617;595;22
3201;10;24421;3;10;1647;2;847;747;100
3201;11;24436;3;11;735;1;406;355;51
3201;12;24435;3;12;1114;0;536;485;51
3201;1;24419;3;1;787;0;350;273;77
3201;1;24425;3;1;1310;0;637;517;120
3201;1;24438;3;1;896;0;459;371;88
3201;1;24446;3;1;1312;1;704;644;60
3201;13;24427;3;13;1825;0;1060;994;66
3201;14;24448;3;14;1556;0;734;656;78
3201;15;24445;3;15;9;0;3;3;0
3201;16;24424;3;16;37;0;17;17;0
3201;17;24418;3;17;15;0;10;10;0
3201;18;24442;3;18;136;0;95;89;6
3201;2;24429;3;2;1405;0;739;657;82
3201;2;24432;3;2;1216;1;683;540;143
3201;2;24434;3;2;2011;0;1101;943;158
3201;2;24444;3;2;738;0;378;296;82
3201;3;24422;3;3;1697;1;867;690;177
3201;3;24430;3;3;1233;1;652;609;43
3201;3;24437;3;3;1319;0;592;498;94
3201;3;24450;3;3;1360;0;750;633;117
3201;4;24426;3;4;866;0;407;263;144
3201;4;24431;3;4;1525;5;771;700;71
3201;4;24439;3;4;1998;0;777;676;101
3201;4;24440;3;4;1080;0;656;544;112
3201;5;24420;3;5;1160;0;529;430;99
3201;5;24441;3;5;624;0;301;218;83
3201;5;24443;3;5;873;0;453;376;77
3201;5;24451;3;5;1641;1;864;790;74
3201;6;24423;3;6;1091;0;459;341;118
3201;6;24447;3;6;1618;0;771;684;87
3201;6;24449;3;6;4;0;4;3;1
3201;7;24433;3;7;1738;0;826;723;103
3201;8;24428;3;8;786;1;363;297;66
3201;9;24417;3;9;1215;2;598;492;106
3202;10;24483;3;10;1103;0;629;516;113
3202;11;24467;3;11;1055;0;557;467;90
3202;12;24475;3;12;1026;0;568;496;72
3202;1;24459;3;1;1266;0;678;543;135
3202;1;24463;3;1;1782;3;1087;926;161
3202;1;24469;3;1;2234;2;1187;971;216
3202;1;24476;3;1;1547;0;911;761;150
3202;1;24478;3;1;1711;2;1026;764;262
3202;1;24480;3;1;1920;0;948;854;94
3202;13;24472;3;13;41;0;8;6;2
3202;14;24464;3;14;8;0;7;7;0
3202;15;24456;3;15;5;0;5;3;2
3202;2;24457;3;2;1400;0;733;558;175
3202;2;24461;3;2;1173;2;686;541;145
3202;2;24466;3;2;1615;0;850;739;111
3202;2;24468;3;2;1432;0;843;553;290
3202;2;24470;3;2;856;1;513;440;73
3202;2;24474;3;2;1387;0;710;633;77
3202;3;24454;3;3;985;0;530;422;108
3202;3;24455;3;3;1631;0;872;776;96
3202;3;24471;3;3;836;0;474;407;67
3202;3;24481;3;3;983;0;371;296;75
3202;3;24482;3;3;2152;1;1033;775;258
3202;4;24452;3;4;1952;0;966;839;127
3202;4;24460;3;4;432;0;285;242;43
3202;4;24465;3;4;1594;0;733;553;180
3202;5;24477;3;5;465;2;263;213;50
3202;5;24479;3;5;1341;0;674;585;89
3202;6;24462;3;6;1736;2;884;807;77
3202;6;24473;3;6;87;0;69;66;3
3202;7;24453;3;7;1867;0;911;830;81
3202;8;24458;3;8;1543;0;756;703;53
3202;9;24484;3;9;1288;1;763;652;111
3203;10;24513;3;10;575;0;270;235;35
3203;10;24518;3;10;710;0;247;191;56
3203;11;24507;3;11;224;0;88;78;10
3203;11;24516;3;11;852;0;358;299;59
3203;12;24490;3;12;614;0;232;183;49
3203;12;24493;3;12;325;0;173;158;15
3203;1;24494;3;1;1458;1;742;684;58
3203;1;24506;3;1;949;0;506;379;127
3203;1;24508;3;1;1146;0;450;354;96
3203;1;24522;3;1;1445;0;659;596;63
3203;1;24524;3;1;2025;1;1236;960;276
3203;1;24527;3;1;1966;4;1005;803;202
3203;13;24485;3;13;371;0;119;106;13
3203;13;24526;3;13;664;0;296;244;52
3203;14;24525;3;14;5;0;5;3;2
3203;2;24488;3;2;1665;0;748;628;120
3203;2;24502;3;2;1478;0;810;651;159
3203;2;24504;3;2;1840;0;1060;834;226
3203;2;24511;3;2;910;0;502;319;183
3203;2;24514;3;2;1303;0;578;532;46
3203;2;24521;3;2;1499;2;716;566;150
3203;3;24489;3;3;1411;0;641;641;0
3203;3;24501;3;3;990;0;458;420;38
3203;3;24503;3;3;862;0;468;337;131
3203;3;24505;3;3;1267;1;652;524;128
3203;3;24509;3;3;1599;0;810;658;152
3203;4;24486;3;4;766;0;331;279;52
3203;4;24500;3;4;1094;0;572;417;155
3203;4;24512;3;4;1341;0;665;590;75
3203;4;24519;3;4;840;1;320;254;66
3203;5;24492;3;5;1246;0;626;441;185
3203;5;24497;3;5;1271;0;513;452;61
3203;5;24510;3;5;1665;0;735;666;69
3203;6;24517;3;6;637;0;338;266;72
3203;6;24520;3;6;1349;1;591;537;54
3203;6;24523;3;6;1436;0;635;530;105
3203;7;24491;3;7;936;0;444;335;109
3203;7;24496;3;7;1287;1;579;511;68
3203;7;24515;3;7;1075;0;496;441;55
3203;8;24495;3;8;998;0;571;391;180
3203;8;24499;3;8;857;0;398;346;52
3203;8;24528;3;8;1229;0;450;394;56
3203;9;24487;3;9;1150;0;314;285;29
3203;9;24498;3;9;265;0;119;103;16
3204;10;24540;2;10;2038;0;863;817;46
3204;10;24541;2;10;1493;0;602;488;114
3204;11;24530;2;11;801;2;367;287;80
3204;11;24553;2;11;1665;0;609;537;72
3204;12;24551;2;12;574;0;245;215;30
3204;12;24559;2;12;1053;0;438;367;71
3204;1;24532;2;1;2273;0;894;815;79
3204;1;24543;2;1;1769;0;876;798;78
3204;1;24546;2;1;2097;0;857;707;150
3204;1;24556;2;1;2400;3;1168;959;209
3204;1;24561;2;1;1468;1;829;586;243
3204;1;24564;2;1;2125;5;1002;818;184
3204;13;24558;2;13;1241;2;654;532;122
3204;13;24567;2;13;1001;0;420;365;55
3204;14;24531;2;14;1045;0;409;346;63
3204;14;24548;2;14;838;1;397;322;75
3204;15;24549;2;15;962;0;420;371;49
3204;15;24560;2;15;36;0;30;29;1
3204;16;24550;2;16;94;0;55;27;28
3204;16;24573;2;16;1785;0;579;520;59
3204;17;24539;2;17;21;0;5;5;0
3204;17;24565;2;17;35;0;7;7;0
3204;18;24537;2;18;15;0;10;9;1
3204;18;24545;2;18;35;0;15;10;5
3204;2;24535;2;2;1452;0;945;803;142
3204;2;24542;2;2;786;0;459;356;103
3204;2;24544;2;2;1739;0;866;774;92
3204;2;24562;2;2;1385;0;515;376;139
3204;2;24570;2;2;1978;1;804;744;60
3204;2;24575;2;2;924;0;458;349;109
3204;3;24533;2;3;1009;0;604;511;93
3204;3;24538;2;3;674;0;258;212;46
3204;3;24552;2;3;1519;1;731;637;94
3204;3;24568;2;3;2015;1;689;632;57
3204;3;24572;2;3;555;0;289;230;59
3204;4;24536;2;4;2201;0;944;873;71
3204;4;24554;2;4;818;0;432;376;56
3204;4;24576;2;4;1846;0;960;888;72
3204;5;24534;2;5;1580;0;843;751;92
3204;5;24566;2;5;1988;0;803;716;87
3204;5;24577;2;5;1128;0;500;412;88
3204;6;24563;2;6;1757;0;696;659;37
3204;6;24569;2;6;1705;0;922;835;87
3204;7;24547;2;7;1603;1;708;654;54
3204;7;24571;2;7;1697;0;838;784;54
3204;8;24555;2;8;1747;0;863;804;59
3204;8;24557;2;8;1557;0;726;631;95
3204;9;24529;2;9;1934;0;849;784;65
3204;9;24574;2;9;1012;0;443;378;65
3205;10;24613;2;10;980;0;611;544;67
3205;10;24618;2;10;1769;0;820;714;106
3205;11;24592;2;11;1185;0;618;534;84
3205;11;24602;2;11;212;0;60;44;16
3205;12;24578;2;12;2325;0;1330;1234;96
3205;1;24581;2;1;2005;0;1221;1116;105
3205;1;24583;2;1;2085;0;1190;1021;169
3205;1;24596;2;1;1541;2;971;799;172
3205;1;24606;2;1;1591;4;853;853;0
3205;1;24614;2;1;1096;0;624;588;36
3205;1;24617;2;1;854;0;440;376;64
3205;13;24611;2;13;589;0;328;285;43
3205;14;24610;2;14;63;0;18;17;1
3205;15;24593;2;15;51;0;40;38;2
3205;2;24585;2;2;1002;0;649;565;84
3205;2;24588;2;2;2120;0;1200;1083;117
3205;2;24599;2;2;900;0;482;369;113
3205;2;24605;2;2;1845;6;1228;980;248
3205;2;24607;2;2;1800;1;1046;943;103
3205;2;24616;2;2;2134;0;1114;988;126
3205;3;24580;2;3;2249;0;1094;928;166
3205;3;24595;2;3;906;0;566;512;54
3205;3;24603;2;3;944;0;526;411;115
3205;3;24608;2;3;649;0;351;319;32
3205;4;24589;2;4;997;0;373;373;0
3205;4;24591;2;4;1570;0;804;683;121
3205;4;24594;2;4;2417;0;1341;1226;115
3205;5;24579;2;5;1095;0;607;543;64
3205;5;24598;2;5;763;0;419;345;74
3205;5;24612;2;5;1674;0;723;645;78
3205;6;24604;2;6;657;0;294;243;51
3205;6;24609;2;6;786;2;447;378;69
3205;6;24615;2;6;1238;0;675;580;95
3205;7;24584;2;7;780;0;454;420;34
3205;7;24590;2;7;428;0;205;154;51
3205;7;24600;2;7;599;0;354;288;66
3205;8;24582;2;8;6;0;6;5;1
3205;8;24586;2;8;568;0;278;190;88
3205;8;24597;2;8;1758;1;1051;972;79
3205;9;24587;2;9;2118;1;1147;991;156
3205;9;24601;2;9;1063;0;528;394;134
3206;10;24672;5;10;1762;0;914;806;108
3206;11;24637;5;11;1128;0;585;516;69
3206;12;24666;5;12;1141;0;588;496;92
3206;1;24621;5;1;1151;1;589;505;84
3206;1;24623;5;1;1452;2;783;601;182
3206;1;24640;5;1;1747;0;899;726;173
3206;1;24644;5;1;1730;2;722;722;0
3206;1;24645;5;1;1570;0;1077;891;186
3206;1;24651;5;1;1839;0;1060;783;277
3206;1;24652;5;1;1377;1;927;665;262
3206;1;24665;5;1;1997;1;1244;1034;210
3206;1;24669;5;1;1776;0;914;580;334
3206;13;24622;5;13;1443;1;766;560;206
3206;14;24653;5;14;799;0;516;430;86
3206;15;24634;5;15;1241;0;586;501;85
3206;16;24668;5;16;605;0;345;313;32
3206;17;24619;5;17;798;0;434;359;75
3206;18;24633;5;18;903;0;364;282;82
3206;19;24638;5;19;1260;0;811;653;158
3206;20;24642;5;20;56;0;21;12;9
3206;2;24620;5;2;1407;2;787;607;180
3206;2;24639;5;2;1688;0;862;728;134
3206;2;24641;5;2;2173;2;1226;869;357
3206;2;24647;5;2;839;0;314;238;76
3206;2;24650;5;2;1495;0;955;740;215
3206;2;24659;5;2;1682;1;822;659;163
3206;2;24664;5;2;1855;2;1013;770;243
3206;2;24667;5;2;1096;0;407;293;114
3206;2;24670;5;2;1044;0;568;415;153
3206;3;24627;5;3;967;0;494;398;96
3206;3;24628;5;3;639;0;374;271;103
3206;3;24629;5;3;670;0;359;263;96
3206;3;24631;5;3;618;0;238;172;66
3206;3;24632;5;3;1334;0;495;400;95
3206;3;24656;5;3;908;1;425;280;145
3206;3;24663;5;3;2026;0;1094;918;176
3206;4;24625;5;4;1931;1;826;688;138
3206;4;24635;5;4;1210;0;512;387;125
3206;4;24643;5;4;645;0;334;236;98
3206;4;24648;5;4;77;0;55;55;0
3206;4;24661;5;4;1382;1;675;555;120
3206;4;24662;5;4;668;0;306;225;81
3206;4;24671;5;4;71;0;28;25;3
3206;5;24655;5;5;1425;0;804;663;141
3206;5;24657;5;5;1748;2;920;661;259
3206;5;24660;5;5;1023;1;468;383;85
3206;6;24624;5;6;1178;0;479;388;91
3206;6;24646;5;6;1191;0;627;546;81
3206;7;24636;5;7;1334;0;665;546;119
3206;7;24654;5;7;1336;0;805;723;82
3206;8;24626;5;8;663;0;312;231;81
3206;8;24649;5;8;1957;0;982;829;153
3206;9;24630;5;9;630;170;300;199;101
3206;9;24658;5;9;2046;0;1073;936;137
3207;10;24687;2;10;64;0;20;15;5
3207;10;24688;2;10;1026;0;479;370;109
3207;11;24704;2;11;401;0;206;172;34
3207;11;24709;2;11;9;0;9;6;3
3207;1;24675;2;1;867;0;493;423;70
3207;1;24681;2;1;507;0;274;241;33
3207;1;24691;2;1;2234;4;1217;1075;142
3207;1;24692;2;1;884;0;468;384;84
3207;1;24702;2;1;1919;0;946;765;181
3207;1;24703;2;1;2323;3;1465;1303;162
3207;2;24680;2;2;1186;6;638;556;82
3207;2;24683;2;2;1707;0;1020;906;114
3207;2;24689;2;2;1717;0;1011;863;148
3207;2;24690;2;2;960;0;465;368;97
3207;2;24694;2;2;1397;0;587;468;119
3207;2;24699;2;2;2046;3;1061;931;130
3207;3;24673;2;3;2291;0;1145;1042;103
3207;3;24674;2;3;563;1;290;226;64
3207;3;24678;2;3;1406;0;683;591;92
3207;3;24685;2;3;1361;0;670;542;128
3207;3;24701;2;3;1818;2;1081;859;222
3207;3;24707;2;3;697;0;440;386;54
3207;4;24676;2;4;1006;2;576;487;89
3207;4;24677;2;4;846;0;379;302;77
3207;4;24679;2;4;1704;4;835;723;112
3207;4;24693;2;4;456;0;267;224;43
3207;4;24695;2;4;528;0;297;265;32
3207;5;24700;2;5;767;3;419;364;55
3207;5;24708;2;5;899;0;476;398;78
3207;6;24682;2;6;570;2;330;267;63
3207;6;24684;2;6;1260;0;720;604;116
3207;7;24697;2;7;892;1;448;343;105
3207;7;24706;2;7;766;0;456;360;96
3207;8;24698;2;8;564;0;337;258;79
3207;8;24705;2;8;418;0;205;168;37
3207;9;24686;2;9;366;2;238;202;36
3207;9;24696;2;9;1107;0;526;389;137
3208;10;24718;3;10;2111;0;962;867;95
3208;11;24731;3;11;1941;2;1031;895;136
3208;12;24745;3;12;1885;0;888;830;58
3208;1;24711;3;1;1113;0;521;408;113
3208;1;24719;3;1;2468;8;1544;1293;251
3208;1;24724;3;1;1087;0;495;430;65
3208;1;24732;3;1;1749;2;870;676;194
3208;1;24752;3;1;1431;0;581;539;42
3208;1;24756;3;1;1882;2;983;851;132
3208;1;24757;3;1;1142;0;470;383;87
3208;13;24710;3;13;2389;0;1009;938;71
3208;14;24738;3;14;1623;0;699;620;79
3208;15;24735;3;15;1953;0;980;904;76
3208;16;24759;3;16;1301;1;625;532;93
3208;17;24739;3;17;1231;0;595;537;58
3208;18;24736;3;18;897;1;370;334;36
3208;19;24743;3;19;2061;1;983;892;91
3208;20;24737;3;20;1371;0;660;578;82
3208;21;24720;3;21;1223;0;560;519;41
3208;22;24746;3;22;1569;0;797;736;61
3208;2;24714;3;2;553;0;285;250;35
3208;2;24715;3;2;978;0;373;290;83
3208;2;24717;3;2;1727;1;813;750;63
3208;2;24727;3;2;1713;0;779;664;115
3208;2;24742;3;2;1152;0;472;390;82
3208;2;24753;3;2;1684;1;829;669;160
3208;2;24755;3;2;468;0;329;220;109
3208;23;24734;3;23;77;0;47;42;5
3208;24;24754;3;24;16;0;15;15;0
3208;3;24716;3;3;1815;0;937;855;82
3208;3;24726;3;3;474;0;193;167;26
3208;3;24728;3;3;634;0;301;238;63
3208;3;24733;3;3;1623;0;738;623;115
3208;3;24744;3;3;606;0;264;217;47
3208;4;24713;3;4;479;0;242;188;54
3208;4;24748;3;4;601;0;266;236;30
3208;4;24749;3;4;2285;1;1031;940;91
3208;4;24751;3;4;757;0;389;314;75
3208;5;24721;3;5;59;0;37;26;11
3208;5;24741;3;5;2218;0;1156;1043;113
3208;5;24747;3;5;611;0;364;315;49
3208;5;24750;3;5;71;0;36;17;19
3208;6;24730;3;6;1617;0;839;763;76
3208;6;24740;3;6;1244;1;723;573;150
3208;7;24723;3;7;408;0;225;178;47
3208;7;24729;3;7;1285;0;610;556;54
3208;8;24712;3;8;1926;0;889;817;72
3208;8;24722;3;8;1171;0;620;569;51
3208;9;24725;3;9;492;0;322;224;98
3208;9;24758;3;9;1729;1;807;726;81
3209;1;24769;4;1;2043;1;1132;870;262
3209;1;24772;4;1;1455;0;801;641;160
3209;1;24775;4;1;1354;1;757;634;123
3209;1;24795;4;1;2093;0;1097;841;256
3209;1;24800;4;1;2143;9;1369;1104;265
3209;1;24803;4;1;1607;1;692;575;117
3209;1;24810;4;1;2333;0;1186;992;194
3209;1;24814;4;1;1319;0;720;619;101
3209;2;24760;4;2;1505;0;716;603;113
3209;2;24761;4;2;371;0;218;184;34
3209;2;24766;4;2;2008;0;966;845;121
3209;2;24773;4;2;1401;0;795;641;154
3209;2;24788;4;2;1580;1;830;695;135
3209;2;24792;4;2;874;1;424;361;63
3209;2;24793;4;2;917;0;544;462;82
3209;2;24806;4;2;649;0;320;251;69
3209;3;24777;4;3;392;0;160;108;52
3209;3;24780;4;3;744;2;490;422;68
3209;3;24781;4;3;391;0;200;158;42
3209;3;24782;4;3;618;0;322;244;78
3209;3;24791;4;3;998;0;464;401;63
3209;3;24802;4;3;2066;0;1002;841;161
3209;3;24808;4;3;964;0;502;405;97
3209;3;24811;4;3;518;0;259;207;52
3209;4;24770;4;4;1044;0;436;290;146
3209;4;24778;4;4;898;0;381;325;56
3209;4;24785;4;4;840;1;539;439;100
3209;4;24786;4;4;905;3;586;498;88
3209;4;24794;4;4;574;1;274;217;57
3209;4;24799;4;4;421;0;198;148;50
3209;4;24804;4;4;42;0;31;29;2
3209;4;24807;4;4;444;0;198;157;41
3209;5;24762;4;5;776;0;358;315;43
3209;5;24774;4;5;708;0;374;324;50
3209;5;24776;4;5;921;0;454;377;77
3209;5;24779;4;5;67;0;36;26;10
3209;5;24797;4;5;500;0;186;186;0
3209;5;24798;4;5;916;0;384;290;94
3209;5;24805;4;5;1440;1;581;477;104
3209;6;24764;4;6;890;0;408;332;76
3209;6;24783;4;6;875;0;455;389;66
3209;6;24784;4;6;559;1;293;228;65
3209;6;24787;4;6;955;0;428;264;164
3209;6;24790;4;6;214;0;110;90;20
3209;6;24809;4;6;520;0;326;285;41
3209;7;24765;4;7;1265;0;543;423;120
3209;7;24767;4;7;1020;8;640;472;168
3209;7;24789;4;7;1313;0;560;406;154
3209;7;24812;4;7;442;1;265;237;28
3209;8;24771;4;8;433;0;223;157;66
3209;8;24796;4;8;44;0;40;36;4
3209;8;24813;4;8;441;0;219;165;54
3209;9;24763;4;9;499;0;314;238;76
3209;9;24768;4;9;621;0;360;288;72
3209;9;24801;4;9;112;0;31;17;14
3210;10;24845;5;10;995;0;492;451;41
3210;10;24847;5;10;1254;0;648;580;68
3210;10;24860;5;10;314;0;188;138;50
3210;11;24820;5;11;904;0;423;339;84
3210;11;24827;5;11;743;0;367;272;95
3210;11;24861;5;11;871;0;461;356;105
3210;12;24836;5;12;914;0;516;390;126
3210;12;24837;5;12;1208;0;547;485;62
3210;12;24853;5;12;971;0;500;428;72
3210;1;24826;5;1;1059;0;573;495;78
3210;1;24844;5;1;1332;2;526;438;88
3210;1;24849;5;1;2055;0;1133;998;135
3210;1;24855;5;1;1638;3;763;669;94
3210;1;24859;5;1;1458;3;889;665;224
3210;13;24829;5;13;867;0;429;336;93
3210;13;24832;5;13;156;0;115;66;49
3210;13;24835;5;13;73;0;4;4;0
3210;14;24854;5;14;765;3;405;310;95
3210;15;24817;5;15;555;2;288;229;59
3210;16;24843;5;16;464;0;233;190;43
3210;17;24824;5;17;16;0;4;3;1
3210;2;24822;5;2;888;2;507;347;160
3210;2;24828;5;2;1492;3;678;585;93
3210;2;24831;5;2;1560;1;731;630;101
3210;2;24848;5;2;1030;1;583;450;133
3210;2;24857;5;2;1767;0;737;737;0
3210;3;24825;5;3;1589;1;866;740;126
3210;3;24834;5;3;1595;4;848;771;77
3210;3;24840;5;3;554;0;334;302;32
3210;3;24852;5;3;1413;3;711;640;71
3210;4;24838;5;4;1678;3;835;746;89
3210;4;24839;5;4;1748;3;983;873;110
3210;4;24850;5;4;2031;2;1009;875;134
3210;5;24821;5;5;1463;0;646;587;59
3210;5;24856;5;5;1552;1;840;741;99
3210;5;24862;5;5;1514;1;600;516;84
3210;6;24819;5;6;1852;0;833;693;140
3210;6;24842;5;6;1683;0;893;777;116
3210;6;24858;5;6;1599;1;873;819;54
3210;7;24823;5;7;1934;3;1036;856;180
3210;7;24833;5;7;1822;1;847;760;87
3210;7;24841;5;7;1523;0;733;646;87
3210;8;24816;5;8;612;0;340;279;61
3210;8;24818;5;8;1090;0;493;377;116
3210;8;24851;5;8;300;0;155;117;38
3210;9;24815;5;9;529;0;221;191;30
3210;9;24830;5;9;395;2;211;156;55
3210;9;24846;5;9;572;0;294;256;38
3211;10;24879;1;10;1944;0;948;846;102
3211;11;24898;1;11;1327;1;655;600;55
3211;12;24864;1;12;2065;0;845;738;107
3211;1;24866;1;1;1016;0;618;464;154
3211;1;24876;1;1;1847;1;1075;903;172
3211;1;24877;1;1;440;0;245;205;40
3211;1;24893;1;1;1607;0;999;778;221
3211;13;24872;1;13;1520;0;550;490;60
3211;14;24891;1;14;1403;0;713;642;71
3211;15;24869;1;15;1210;0;453;387;66
3211;16;24892;1;16;1700;0;880;804;76
3211;17;24867;1;17;2145;0;1009;896;113
3211;18;24882;1;18;2198;0;957;848;109
3211;19;24888;1;19;1519;1;759;670;89
3211;20;24871;1;20;2200;0;974;851;123
3211;21;24874;1;21;1730;0;763;676;87
3211;22;24887;1;22;38;0;6;6;0
3211;2;24870;1;2;340;0;199;165;34
3211;2;24878;1;2;1786;0;755;755;0
3211;2;24884;1;2;884;0;367;341;26
3211;2;24894;1;2;1432;0;778;619;159
3211;3;24885;1;3;1491;2;613;555;58
3211;3;24889;1;3;2162;1;1057;862;195
3211;3;24897;1;3;2346;0;1077;1020;57
3211;4;24863;1;4;1699;3;824;690;134
3211;4;24883;1;4;774;0;384;359;25
3211;4;24886;1;4;1027;0;554;481;73
3211;5;24873;1;5;1602;0;713;649;64
3211;5;24881;1;5;2089;0;1058;949;109
3211;5;24890;1;5;1404;0;477;385;92
3211;6;24895;1;6;2238;0;1162;1085;77
3211;6;24896;1;6;1045;0;431;373;58
3211;7;24875;1;7;1628;0;722;651;71
3211;7;24880;1;7;1022;0;653;455;198
3211;8;24868;1;8;1677;2;732;642;90
3211;9;24865;1;9;1032;0;354;289;65
3212;10;24915;5;10;1123;1;695;592;103
3212;11;24907;5;11;1302;0;582;485;97
3212;12;24916;5;12;670;0;340;272;68
3212;1;24904;5;1;1661;1;937;798;139
3212;1;24908;5;1;1372;0;777;564;213
3212;1;24911;5;1;1545;0;897;771;126
3212;1;24919;5;1;681;0;320;275;45
3212;1;24920;5;1;1461;5;942;740;202
3212;1;24925;5;1;1640;0;906;731;175
3212;13;24922;5;13;819;0;467;392;75
3212;14;24923;5;14;13;0;4;4;0
3212;2;24901;5;2;1342;2;751;626;125
3212;2;24903;5;2;1245;1;820;670;150
3212;2;24906;5;2;975;0;564;424;140
3212;2;24912;5;2;1024;0;467;183;284
3212;2;24917;5;2;809;0;426;370;56
3212;2;24926;5;2;762;0;469;338;131
3212;3;24914;5;3;925;0;395;296;99
3212;3;24918;5;3;1818;2;978;869;109
3212;3;24924;5;3;1378;0;710;557;153
3212;4;24900;5;4;1237;2;473;371;102
3212;4;24902;5;4;1077;1;597;490;107
3212;4;24921;5;4;919;0;499;443;56
3212;5;24910;5;5;1755;4;942;822;120
3212;6;24905;5;6;1822;1;950;809;141
3212;7;24909;5;7;1649;0;819;701;118
3212;8;24913;5;8;991;0;517;425;92
3212;9;24899;5;9;502;0;275;211;64
3213;10;24955;4;10;510;0;296;266;30
3213;11;24954;4;11;342;0;217;194;23
3213;12;24958;4;12;341;0;238;212;26
3213;1;24938;4;1;1064;0;602;555;47
3213;1;24941;4;1;2016;1;844;742;102
3213;1;24945;4;1;712;0;412;343;69
3213;1;24953;4;1;1718;0;913;726;187
3213;1;24957;4;1;1148;3;666;505;161
3213;1;24964;4;1;412;0;208;174;34
3213;13;24967;4;13;554;0;346;305;41
3213;2;24928;4;2;2008;1;886;736;150
3213;2;24935;4;2;531;0;315;279;36
3213;2;24948;4;2;1246;0;614;603;11
3213;2;24952;4;2;1689;0;988;832;156
3213;2;24956;4;2;1700;0;958;696;262
3213;2;24960;4;2;392;0;254;222;32
3213;3;24949;4;3;1426;1;646;564;82
3213;3;24961;4;3;1103;0;604;482;122
3213;3;24962;4;3;1280;0;760;559;201
3213;3;24963;4;3;735;0;394;285;109
3213;3;24968;4;3;2046;0;855;722;133
3213;3;24969;4;3;397;0;212;178;34
3213;4;24933;4;4;1518;0;693;638;55
3213;4;24934;4;4;2262;1;941;827;114
3213;4;24936;4;4;1076;0;589;461;128
3213;4;24942;4;4;1079;3;604;493;111
3213;4;24943;4;4;691;0;322;221;101
3213;4;24946;4;4;418;0;222;208;14
3213;5;24927;4;5;1667;0;876;804;72
3213;5;24931;4;5;1369;0;672;439;233
3213;5;24932;4;5;433;0;242;214;28
3213;5;24947;4;5;2288;0;1088;956;132
3213;5;24965;4;5;687;0;346;270;76
3213;6;24937;4;6;17;0;12;9;3
3213;6;24939;4;6;426;0;242;203;39
3213;6;24944;4;6;1035;0;471;340;131
3213;6;24951;4;6;1596;2;831;776;55
3213;7;24929;4;7;1660;2;788;726;62
3213;7;24940;4;7;346;0;219;207;12
3213;7;24950;4;7;1324;1;715;607;108
3213;8;24930;4;8;1598;1;775;709;66
3213;8;24959;4;8;471;0;310;263;47
3213;9;24966;4;9;807;0;491;419;72
3214;10;24984;5;10;504;0;268;234;34
3214;10;25035;5;10;1823;0;706;653;53
3214;11;25007;5;11;1691;0;675;637;38
3214;12;24991;5;12;2066;0;837;764;73
3214;1;24971;5;1;706;0;353;288;65
3214;1;24973;5;1;944;0;332;304;28
3214;1;24983;5;1;1724;3;997;815;182
3214;1;24995;5;1;1047;0;544;424;120
3214;1;25003;5;1;585;0;316;229;87
3214;1;25014;5;1;1769;6;1069;818;251
3214;1;25018;5;1;2217;8;1156;875;281
3214;1;25019;5;1;2033;17;1151;896;255
3214;1;25025;5;1;1115;0;689;603;86
3214;1;25034;5;1;1215;1;756;514;242
3214;13;25015;5;13;1919;0;696;638;58
3214;14;25041;5;14;1621;3;561;486;75
3214;15;24988;5;15;1072;1;368;334;34
3214;16;24999;5;16;1872;0;675;619;56
3214;17;25027;5;17;1746;0;604;548;56
3214;18;24989;5;18;2405;0;993;864;129
3214;19;24975;5;19;1160;0;469;416;53
3214;20;25038;5;20;2018;0;713;640;73
3214;21;24998;5;21;1138;0;428;365;63
3214;22;24982;5;22;1235;0;386;354;32
3214;2;24970;5;2;1534;0;474;373;101
3214;2;24977;5;2;1228;6;621;485;136
3214;2;24985;5;2;723;1;365;263;102
3214;2;24992;5;2;1877;0;644;582;62
3214;2;24993;5;2;1653;4;852;664;188
3214;2;24994;5;2;2081;9;1043;811;232
3214;2;25010;5;2;1069;0;604;537;67
3214;2;25029;5;2;537;7;335;201;134
3214;2;25033;5;2;992;0;462;361;101
3214;2;25037;5;2;911;0;461;364;97
3214;23;24972;5;23;1012;0;325;290;35
3214;24;25039;5;24;1878;0;707;636;71
3214;25;25004;5;25;1422;1;565;511;54
3214;26;25016;5;26;1421;0;583;534;49
3214;27;24974;5;27;2074;1;805;720;85
3214;28;25001;5;28;2163;0;821;760;61
3214;29;25008;5;29;2339;0;894;807;87
3214;30;25000;5;30;2384;0;1063;1001;62
3214;31;24986;5;31;1696;0;645;576;69
3214;32;24981;5;32;1517;0;485;424;61
3214;3;24980;5;3;1044;1;642;541;101
3214;3;24987;5;3;1550;0;663;622;41
3214;3;24990;5;3;659;0;344;265;79
3214;3;25006;5;3;1025;2;594;489;105
3214;3;25011;5;3;706;0;260;207;53
3214;3;25013;5;3;1205;0;655;551;104
3214;3;25022;5;3;673;0;242;184;58
3214;3;25030;5;3;870;0;431;327;104
3214;33;25020;5;33;1519;0;619;561;58
3214;34;25017;5;34;92;0;14;14;0
3214;35;25009;5;35;52;0;6;5;1
3214;4;24979;5;4;1360;1;487;448;39
3214;4;24997;5;4;839;0;371;314;57
3214;4;25005;5;4;880;2;527;383;144
3214;4;25023;5;4;346;0;182;128;54
3214;4;25026;5;4;1098;0;589;487;102
3214;5;24976;5;5;1129;0;455;370;85
3214;5;25002;5;5;1231;0;494;408;86
3214;5;25021;5;5;1958;0;643;585;58
3214;6;24996;5;6;934;0;349;296;53
3214;6;25012;5;6;1965;0;744;673;71
3214;6;25024;5;6;700;0;375;309;66
3214;7;24978;5;7;1372;0;578;536;42
3214;7;25031;5;7;1077;0;445;380;65
3214;7;25032;5;7;59;0;24;18;6
3214;8;25036;5;8;1777;0;697;628;69
3214;8;25040;5;8;1251;0;553;449;104
3214;9;25028;5;9;531;0;232;178;54
3214;9;25042;5;9;1865;0;746;689;57
3215;10;25060;4;10;1854;0;784;700;84
3215;11;25051;4;11;1880;0;817;745;72
3215;12;25084;4;12;1654;0;781;708;73
3215;1;25056;4;1;1432;0;759;657;102
3215;1;25057;4;1;1319;0;754;558;196
3215;1;25069;4;1;1905;0;1031;863;168
3215;1;25072;4;1;2175;1;1064;815;249
3215;1;25076;4;1;1676;0;890;777;113
3215;1;25088;4;1;1306;0;716;668;48
3215;13;25085;4;13;1893;0;954;874;80
3215;14;25058;4;14;1554;0;643;565;78
3215;15;25078;4;15;1431;0;686;617;69
3215;16;25075;4;16;1526;0;742;704;38
3215;17;25064;4;17;2089;0;1097;1013;84
3215;18;25067;4;18;2140;0;1126;1033;93
3215;19;25087;4;19;28;0;10;8;2
3215;20;25071;4;20;30;0;22;17;5
3215;2;25046;4;2;1979;0;1038;885;153
3215;2;25049;4;2;573;3;335;256;79
3215;2;25062;4;2;606;0;243;197;46
3215;2;25074;4;2;720;1;452;341;111
3215;2;25081;4;2;1452;0;733;663;70
3215;2;25083;4;2;1415;0;747;644;103
3215;3;25052;4;3;473;0;272;193;79
3215;3;25054;4;3;1401;0;573;430;143
3215;3;25063;4;3;1533;3;792;573;219
3215;3;25068;4;3;519;0;235;165;70
3215;3;25080;4;3;843;0;361;309;52
3215;3;25086;4;3;2100;0;1069;971;98
3215;4;25043;4;4;1356;0;672;562;110
3215;4;25044;4;4;801;0;368;298;70
3215;4;25045;4;4;445;0;231;192;39
3215;4;25061;4;4;1702;0;791;674;117
3215;4;25065;4;4;1170;0;591;491;100
3215;4;25082;4;4;1358;0;648;596;52
3215;5;25050;4;5;1821;0;999;798;201
3215;5;25053;4;5;821;0;438;339;99
3215;5;25055;4;5;2311;2;959;859;100
3215;5;25070;4;5;1375;1;795;666;129
3215;6;25047;4;6;2242;0;1093;1003;90
3215;6;25048;4;6;110;0;66;51;15
3215;6;25066;4;6;889;0;490;364;126
3215;7;25059;4;7;1111;0;578;446;132
3215;7;25077;4;7;1713;0;813;744;69
3215;8;25073;4;8;2205;0;1040;934;106
3215;9;25079;4;9;2073;2;975;893;82
3216;1;25095;3;1;1431;3;817;637;180
3216;1;25097;3;1;1726;6;1086;830;256
3216;1;25107;3;1;596;0;387;295;92
3216;1;25114;3;1;1630;0;700;564;136
3216;1;25120;3;1;1867;1;1159;908;251
3216;1;25123;3;1;1099;0;597;496;101
3216;2;25093;3;2;448;0;242;197;45
3216;2;25094;3;2;878;2;500;383;117
3216;2;25099;3;2;1961;0;895;712;183
3216;2;25105;3;2;668;0;293;219;74
3216;2;25110;3;2;669;0;308;250;58
3216;2;25111;3;2;1895;0;921;757;164
3216;3;25098;3;3;477;0;256;197;59
3216;3;25109;3;3;570;0;259;187;72
3216;3;25119;3;3;1541;1;720;588;132
3216;3;25121;3;3;732;0;394;314;80
3216;3;25122;3;3;1489;0;675;553;122
3216;4;25091;3;4;508;0;178;125;53
3216;4;25101;3;4;1960;0;946;799;147
3216;4;25104;3;4;51;0;35;32;3
3216;4;25112;3;4;1744;0;815;669;146
3216;4;25113;3;4;550;0;262;195;67
3216;5;25089;3;5;701;0;331;240;91
3216;5;25092;3;5;2284;2;1040;853;187
3216;5;25103;3;5;1764;6;903;760;143
3216;6;25090;3;6;1765;0;835;692;143
3216;6;25096;3;6;1582;0;726;596;130
3216;6;25100;3;6;626;0;316;243;73
3216;7;25116;3;7;1404;0;596;482;114
3216;7;25117;3;7;874;0;385;277;108
3216;7;25118;3;7;812;0;340;238;102
3216;8;25102;3;8;1723;0;781;627;154
3216;8;25106;3;8;430;0;247;207;40
3216;8;25108;3;8;701;0;290;242;48
3216;9;25115;3;9;715;0;341;258;83
3217;10;25139;3;10;1308;0;638;558;80
3217;11;25148;3;11;1712;0;827;722;105
3217;12;25137;3;12;1895;0;996;880;116
3217;1;25129;3;1;1949;0;1183;1014;169
3217;1;25136;3;1;1326;0;639;504;135
3217;1;25138;3;1;1573;1;742;645;97
3217;1;25145;3;1;2068;2;1203;780;423
3217;1;25150;3;1;1313;0;747;575;172
3217;2;25124;3;2;792;0;378;301;77
3217;2;25128;3;2;1737;0;897;804;93
3217;2;25134;3;2;1378;0;763;628;135
3217;2;25135;3;2;1430;0;687;520;167
3217;2;25142;3;2;1450;2;783;633;150
3217;3;25130;3;3;1617;2;893;788;105
3217;3;25146;3;3;850;0;425;330;95
3217;3;25152;3;3;703;0;350;277;73
3217;3;25153;3;3;348;0;228;182;46
3217;3;25156;3;3;645;0;336;277;59
3217;4;25131;3;4;1285;0;701;613;88
3217;4;25132;3;4;368;0;195;139;56
3217;4;25140;3;4;435;0;284;215;69
3217;4;25143;3;4;1448;0;657;587;70
3217;4;25151;3;4;592;0;308;254;54
3217;5;25126;3;5;486;0;279;238;41
3217;5;25141;3;5;1844;0;815;728;87
3217;5;25144;3;5;1026;0;496;398;98
3217;6;25125;3;6;1249;0;607;465;142
3217;6;25127;3;6;2049;0;1063;933;130
3217;7;25149;3;7;2088;0;1135;991;144
3217;7;25157;3;7;714;0;336;290;46
3217;8;25147;3;8;1279;0;624;522;102
3217;8;25154;3;8;1845;0;1009;900;109
3217;9;25133;3;9;2095;2;880;755;125
3217;9;25155;3;9;804;0;350;286;64
3218;10;25177;2;10;399;0;148;126;22
3218;11;25164;2;11;881;0;272;230;42
3218;1;25160;2;1;2356;2;1214;1005;209
3218;1;25170;2;1;1882;0;1098;888;210
3218;1;25174;2;1;1856;0;892;692;200
3218;1;25175;2;1;2071;0;949;771;178
3218;1;25180;2;1;1871;1;915;784;131
3218;2;25158;2;2;677;2;290;240;50
3218;2;25167;2;2;568;0;243;193;50
3218;2;25173;2;2;1108;0;508;377;131
3218;2;25176;2;2;1337;0;647;565;82
3218;2;25179;2;2;2302;0;1007;793;214
3218;3;25163;2;3;615;0;264;207;57
3218;3;25166;2;3;876;0;317;266;51
3218;3;25169;2;3;436;0;193;149;44
3218;3;25171;2;3;985;0;422;375;47
3218;3;25178;2;3;650;0;269;200;69
3218;4;25159;2;4;561;0;243;204;39
3218;4;25161;2;4;1950;1;841;674;167
3218;4;25183;2;4;1351;0;601;544;57
3218;5;25162;2;5;1152;0;421;322;99
3218;5;25184;2;5;1099;0;480;429;51
3218;6;25165;2;6;1006;0;391;337;54
3218;6;25181;2;6;85;0;43;26;17
3218;7;25168;2;7;1018;0;448;366;82
3218;7;25185;2;7;7;0;1;1;0
3218;8;25172;2;8;883;0;262;218;44
3218;9;25182;2;9;820;0;274;219;55
3261;10;25190;4;10;2401;0;989;941;48
3261;11;25208;4;11;2406;1;967;907;60
3261;12;25216;4;12;2126;0;795;742;53
3261;1;25229;4;1;1686;0;712;680;32
3261;13;25202;4;13;1783;1;704;667;37
3261;14;25221;4;14;875;0;406;383;23
3261;15;25186;4;15;1249;0;422;386;36
3261;16;25194;4;16;1823;0;774;731;43
3261;17;25192;4;17;2335;1;878;878;0
3261;18;25212;4;18;2189;1;742;699;43
3261;19;25225;4;19;1829;0;937;900;37
3261;20;25232;4;20;1940;1;913;876;37
3261;21;25206;4;21;2181;0;971;928;43
3261;22;25198;4;22;1761;1;820;781;39
3261;2;25214;4;2;1882;0;735;688;47
3261;23;25238;4;23;1329;0;579;552;27
3261;24;25195;4;24;1991;1;835;792;43
3261;25;25236;4;25;2060;1;747;688;59
3261;26;25231;4;26;558;2;246;236;10
3261;27;25237;4;27;2363;0;865;824;41
3261;28;25211;4;28;1090;0;383;356;27
3261;29;25234;4;29;585;1;271;252;19
3261;30;25189;4;30;1832;0;596;549;47
3261;31;25218;4;31;1458;0;431;397;34
3261;32;25197;4;32;1470;0;572;551;21
3261;3;25207;4;3;2029;0;979;931;48
3261;33;25188;4;33;1211;2;436;411;25
3261;34;25193;4;34;2326;0;819;777;42
3261;35;25227;4;35;1430;1;537;490;47
3261;36;25217;4;36;1661;0;541;502;39
3261;37;25205;4;37;998;0;313;292;21
3261;38;25233;4;38;1668;0;747;703;44
3261;39;25219;4;39;1903;0;513;484;29
3261;40;25187;4;40;1032;0;256;239;17
3261;41;25224;4;41;1599;0;629;605;24
3261;42;25210;4;42;1704;0;652;614;38
3261;4;25235;4;4;1814;0;860;819;41
3261;43;25196;4;43;2016;0;830;798;32
3261;44;25204;4;44;1636;1;746;708;38
3261;45;25230;4;45;2137;0;921;868;53
3261;46;25223;4;46;1850;0;727;691;36
3261;47;25200;4;47;1997;0;766;721;45
3261;48;25191;4;48;2179;0;1027;952;75
3261;49;25226;4;49;1813;1;671;634;37
3261;50;25213;4;50;857;0;431;373;58
3261;51;25201;4;51;114;0;38;36;2
3261;52;25209;4;52;44;0;6;6;0
3261;5;25199;4;5;2114;1;905;848;57
3261;53;25239;4;53;30;0;24;14;10
3261;54;25220;4;54;63;0;29;27;2
3261;6;25222;4;6;1684;0;780;729;51
3261;7;25215;4;7;2305;0;1152;1073;79
3261;8;25203;4;8;1366;0;615;580;35
3261;9;25228;4;9;2225;0;1175;1131;44
3262;100;25403;1;100;974;0;386;371;15
3262;101;25311;1;101;2078;1;753;711;42
3262;102;25392;1;102;936;0;358;342;16
3262;10;25323;1;10;1504;0;471;444;27
3262;103;25362;1;103;2227;1;1001;949;52
3262;104;25423;1;104;1652;0;648;624;24
3262;105;25399;1;105;1053;0;434;416;18
3262;106;25294;1;106;1716;0;409;378;31
3262;107;25413;1;107;1706;0;554;527;27
3262;108;25406;1;108;2194;0;803;772;31
3262;109;25300;1;109;2015;0;469;450;19
3262;110;25303;1;110;1229;0;624;601;23
3262;111;25251;1;111;1332;0;577;559;18
3262;112;25431;1;112;1822;0;667;643;24
3262;11;25250;1;11;2301;0;879;845;34
3262;113;25388;1;113;1573;0;611;584;27
3262;114;25276;1;114;1274;0;453;438;15
3262;115;25252;1;115;1793;0;658;629;29
3262;116;25359;1;116;2150;0;843;796;47
3262;117;25254;1;117;2236;0;862;827;35
3262;118;25289;1;118;906;0;343;326;17
3262;119;25387;1;119;1435;0;622;603;19
3262;120;25308;1;120;1557;0;465;439;26
3262;121;25258;1;121;1571;0;678;653;25
3262;122;25275;1;122;2007;0;885;845;40
3262;12;25371;1;12;1490;0;573;531;42
3262;123;25310;1;123;2201;0;1017;982;35
3262;124;25344;1;124;1860;0;776;752;24
3262;125;25272;1;125;2302;2;1028;985;43
3262;1;25273;1;1;1076;0;519;451;68
3262;126;25424;1;126;1084;0;451;438;13
3262;127;25301;1;127;1215;0;532;507;25
3262;128;25309;1;128;2073;0;885;848;37
3262;129;25318;1;129;2421;0;1101;1055;46
3262;130;25407;1;130;2287;0;945;899;46
3262;131;25418;1;131;2185;0;939;902;37
3262;132;25262;1;132;2251;1;920;895;25
3262;13;25255;1;13;2193;0;604;570;34
3262;133;25274;1;133;1731;0;797;763;34
3262;134;25373;1;134;1118;0;417;395;22
3262;135;25293;1;135;1769;0;775;736;39
3262;136;25426;1;136;207;0;80;62;18
3262;137;25270;1;137;2086;0;841;821;20
3262;138;25325;1;138;2128;0;804;768;36
3262;139;25330;1;139;2176;1;891;849;42
3262;140;25410;1;140;1105;0;344;325;19
3262;141;25333;1;141;1843;0;606;576;30
3262;142;25299;1;142;1569;1;584;563;21
3262;14;25356;1;14;2124;0;615;579;36
3262;143;25360;1;143;1548;0;754;738;16
3262;144;25417;1;144;1574;0;681;654;27
3262;145;25287;1;145;1697;0;773;744;29
3262;146;25329;1;146;1637;0;721;700;21
3262;147;25316;1;147;1298;0;485;464;21
3262;148;25340;1;148;1867;0;981;938;43
3262;149;25376;1;149;1013;0;477;453;24
3262;150;25271;1;150;2113;0;907;857;50
3262;151;25361;1;151;1963;1;881;854;27
3262;152;25277;1;152;1910;0;624;592;32
3262;15;25317;1;15;2229;0;892;837;55
3262;153;25352;1;153;2058;1;855;814;41
3262;154;25297;1;154;1603;0;734;705;29
3262;155;25438;1;155;1029;0;286;272;14
3262;156;25322;1;156;2011;1;582;556;26
3262;157;25391;1;157;2178;0;593;557;36
3262;158;25307;1;158;1888;0;782;752;30
3262;159;25346;1;159;2514;1;754;713;41
3262;160;25278;1;160;2270;0;801;769;32
3262;161;25419;1;161;2279;0;1111;1059;52
3262;162;25349;1;162;1306;0;505;489;16
3262;16;25295;1;16;1640;0;650;618;32
3262;163;25400;1;163;1749;0;668;618;50
3262;164;25415;1;164;2377;0;1215;1162;53
3262;165;25279;1;165;2095;0;1126;1070;56
3262;166;25245;1;166;1624;0;819;774;45
3262;167;25296;1;167;2142;0;905;875;30
3262;168;25261;1;168;2301;0;951;920;31
3262;169;25350;1;169;2099;0;948;908;40
3262;170;25381;1;170;1461;0;614;590;24
3262;171;25281;1;171;2321;0;1031;980;51
3262;172;25412;1;172;2226;0;978;941;37
3262;17;25375;1;17;1557;0;541;507;34
3262;173;25377;1;173;2016;0;747;704;43
3262;174;25335;1;174;1543;0;566;528;38
3262;175;25319;1;175;1970;0;710;668;42
3262;176;25385;1;176;2256;0;816;783;33
3262;177;25380;1;177;2285;0;843;804;39
3262;178;25347;1;178;210;0;99;87;12
3262;179;25351;1;179;1695;0;614;581;33
3262;180;25408;1;180;1234;0;341;311;30
3262;181;25382;1;181;912;0;262;235;27
3262;182;25398;1;182;790;0;220;210;10
3262;18;25366;1;18;1913;0;767;730;37
3262;183;25409;1;183;1489;0;672;642;30
3262;184;25304;1;184;1744;0;812;762;50
3262;185;25355;1;185;1064;0;245;226;19
3262;186;25241;1;186;1899;0;553;512;41
3262;187;25312;1;187;1502;0;343;307;36
3262;188;25315;1;188;1433;0;387;367;20
3262;189;25265;1;189;1170;0;319;299;20
3262;190;25269;1;190;144;0;47;40;7
3262;191;25435;1;191;32;0;32;20;12
3262;192;25365;1;192;123;0;49;47;2
3262;19;25353;1;19;1299;0;473;453;20
3262;193;25394;1;193;69;0;16;15;1
3262;194;25327;1;194;68;0;27;27;0
3262;195;25283;1;195;33;0;12;10;2
3262;196;25429;1;196;30;0;26;21;5
3262;197;25405;1;197;8;0;8;5;3
3262;198;25437;1;198;7;0;6;6;0
3262;199;25306;1;199;206;0;86;78;8
3262;200;25379;1;200;32;0;26;22;4
3262;20;25395;1;20;1672;0;635;600;35
3262;21;25422;1;21;1549;0;555;540;15
3262;22;25242;1;22;1264;0;435;397;38
3262;2;25280;1;2;2163;0;858;797;61
3262;23;25411;1;23;1056;0;438;408;30
3262;24;25367;1;24;2358;0;823;788;35
3262;25;25249;1;25;1769;0;648;612;36
3262;26;25337;1;26;714;0;228;214;14
3262;27;25244;1;27;1891;0;669;638;31
3262;28;25384;1;28;1214;0;387;367;20
3262;29;25402;1;29;1317;0;543;515;28
3262;30;25425;1;30;2007;0;738;701;37
3262;31;25324;1;31;2257;0;1015;966;49
3262;32;25336;1;32;2163;0;874;835;39
3262;3;25439;1;3;1405;1;574;508;66
3262;33;25326;1;33;2055;0;751;694;57
3262;34;25248;1;34;1512;0;578;550;28
3262;35;25286;1;35;1228;0;498;482;16
3262;36;25363;1;36;2140;0;656;626;30
3262;37;25389;1;37;1638;0;501;467;34
3262;38;25266;1;38;1696;0;619;584;35
3262;39;25343;1;39;2300;0;837;803;34
3262;40;25341;1;40;1619;0;539;518;21
3262;41;25414;1;41;2129;1;515;510;5
3262;42;25434;1;42;893;0;227;201;26
3262;4;25354;1;4;1626;0;675;613;62
3262;43;25383;1;43;1259;0;459;426;33
3262;44;25243;1;44;2026;0;788;764;24
3262;45;25264;1;45;2334;0;889;815;74
3262;46;25257;1;46;1527;0;558;534;24
3262;47;25393;1;47;2088;0;889;830;59
3262;48;25339;1;48;1877;0;682;652;30
3262;49;25305;1;49;1991;0;798;768;30
3262;50;25328;1;50;1190;0;377;349;28
3262;51;25298;1;51;1708;0;704;678;26
3262;52;25260;1;52;1673;0;722;678;44
3262;5;25401;1;5;1677;0;671;638;33
3262;53;25416;1;53;964;0;407;391;16
3262;54;25369;1;54;2028;1;926;869;57
3262;55;25386;1;55;2386;0;926;926;0
3262;56;25331;1;56;998;0;512;486;26
3262;57;25370;1;57;1554;0;707;675;32
3262;58;25302;1;58;1305;0;501;487;14
3262;59;25420;1;59;1316;0;448;426;22
3262;60;25288;1;60;2331;0;900;866;34
3262;61;25378;1;61;1703;0;706;678;28
3262;62;25342;1;62;1173;0;508;478;30
3262;6;25321;1;6;1256;0;478;457;21
3262;63;25390;1;63;2253;1;852;813;39
3262;64;25334;1;64;1584;1;571;552;19
3262;65;25291;1;65;996;0;286;271;15
3262;66;25358;1;66;1841;0;479;442;37
3262;67;25364;1;67;1852;0;524;499;25
3262;68;25372;1;68;1254;0;461;432;29
3262;69;25404;1;69;2173;0;755;729;26
3262;70;25263;1;70;775;0;304;294;10
3262;71;25240;1;71;1680;0;605;565;40
3262;72;25282;1;72;1666;0;583;555;28
3262;7;25285;1;7;1298;0;366;334;32
3262;73;25290;1;73;1321;1;371;351;20
3262;74;25348;1;74;1893;0;577;536;41
3262;75;25396;1;75;1849;0;734;690;44
3262;76;25259;1;76;603;0;137;125;12
3262;77;25436;1;77;1636;0;434;417;17
3262;78;25268;1;78;1264;0;459;437;22
3262;79;25313;1;79;1885;0;421;395;26
3262;80;25256;1;80;1949;0;566;546;20
3262;81;25320;1;81;1946;0;522;489;33
3262;82;25368;1;82;1603;0;424;397;27
3262;8;25428;1;8;1470;0;478;432;46
3262;83;25332;1;83;1823;0;479;453;26
3262;84;25374;1;84;2007;0;548;511;37
3262;85;25430;1;85;1991;0;579;538;41
3262;86;25246;1;86;910;0;383;363;20
3262;87;25397;1;87;1222;0;555;524;31
3262;88;25432;1;88;1291;0;530;502;28
3262;89;25357;1;89;2000;0;610;583;27
3262;90;25345;1;90;1674;0;511;491;20
3262;91;25314;1;91;1836;0;726;683;43
3262;92;25267;1;92;1555;1;669;644;25
3262;9;25284;1;9;1386;0;477;456;21
3262;93;25421;1;93;1648;1;368;335;33
3262;94;25292;1;94;1804;0;687;665;22
3262;95;25253;1;95;1284;0;262;248;14
3262;96;25427;1;96;1550;0;536;500;36
3262;97;25338;1;97;1929;0;503;477;26
3262;98;25433;1;98;1547;0;572;559;13
3262;99;25247;1;99;1750;0;677;641;36
3263;10;25458;2;10;1724;0;845;792;53
3263;11;25455;2;11;1675;0;832;767;65
3263;12;25456;2;12;1477;1;700;659;41
3263;1;25461;2;1;2023;0;990;943;47
3263;13;25445;2;13;1615;1;704;656;48
3263;14;25452;2;14;2265;0;1123;1043;80
3263;15;25450;2;15;2262;0;1090;1009;81
3263;16;25454;2;16;1242;0;544;510;34
3263;17;25448;2;17;921;0;369;335;34
3263;18;25457;2;18;2163;0;1012;952;60
3263;19;25447;2;19;1416;0;444;435;9
3263;20;25444;2;20;1076;0;448;414;34
3263;21;25453;2;21;566;0;258;242;16
3263;22;25440;2;22;912;0;510;490;20
3263;2;25441;2;2;1249;1;544;498;46
3263;23;25449;2;23;47;0;15;14;1
3263;24;25446;2;24;20;0;3;3;0
3263;25;25451;2;25;21;0;20;13;7
3263;3;25463;2;3;1201;1;576;516;60
3263;4;25464;2;4;1973;0;813;766;47
3263;5;25443;2;5;1488;0;704;650;54
3263;6;25462;2;6;2012;1;894;847;47
3263;7;25442;2;7;1754;0;746;691;55
3263;8;25460;2;8;1026;0;451;414;37
3263;9;25459;2;9;1358;0;607;551;56
