nrk;teryt;adres;lwug;lkw;lkwzu;lgnw;lgw;freq;pgnw
100000;181405;Szkoła Podstawowa w Kańczudze|Kańczuga|ul. Szkolna 7 |37-220 Kańczuga;1131;426;426;16;410;37.67;3.76
100001;181405;Hala Sportowa w Kańczudze|Kańczuga|ul. Parkowa 10 |37-220 Kańczuga;1332;596;596;18;578;44.74;3.02
100002;181406;Zespół Szkół w Chałupkach|Chałupki| 109 |37-200 Przeworsk;635;319;319;12;307;50.24;3.76
100003;181406;Gimnazjum Nr 5 w Gorliczynie|Gorliczyna| 148 |37-200 Przeworsk;1327;694;694;18;676;52.30;2.59
100004;181406;Wiejski dom Kultury w Grzęsce|Grzęska| 536 |37-200 Przeworsk;1602;844;844;23;821;52.68;2.73
100005;181406;Wiejski Dom Kultury w Gwizdaju|Gwizdaj|al. Jana Pawła II 3A |37-200 Przeworsk;246;166;166;3;163;67.48;1.81
100006;181406;Wiejski Dom Kultury w Mirocinie|Mirocin| 386 |37-200 Przeworsk;1060;549;549;33;516;51.79;6.01
100007;181406;Wiejski Dom Kultury w Nowosielcach|Nowosielce| 565 |37-200 Przeworsk;1201;744;744;19;725;61.95;2.55
100008;181406;Zespół Szkół w Rozborzu|Rozbórz| 568 |37-200 Przeworsk;1640;842;842;33;809;51.34;3.92
100009;181406;Wiejski Dom Kultury w Studzianie|Studzian| 302 |37-200 Przeworsk;1309;639;639;34;605;48.82;5.32
100010;181406;Wiejski Dom Kultury w Świętoniowej|Świętoniowa| 229A |37-200 Przeworsk;705;388;388;16;372;55.04;4.12
100011;181406;Wiejski Dom Kultury w Ujeznej|Ujezna| 223 |37-200 Przeworsk;631;358;358;10;348;56.74;2.79
100012;181406;Wiejski Dom Kultury w Urzejowicach|Urzejowice| 484 |37-200 Przeworsk;1450;679;679;20;659;46.83;2.95
100013;181407;Remizo-świetlica w Czercach|Czerce| 130 |37-530 Sieniawa;355;136;136;2;134;38.31;1.47
100014;181407;Remizo-świetlica w Czerwonej Woli|Czerwona Wola| |37-530 Sieniawa;403;201;201;13;188;49.88;6.47
100015;181407;Remizo-świetlica w Dobrej|Dobra| |37-530 Sieniawa;380;161;161;17;144;42.37;10.56
100016;181407;Remizo-świetlica w Dybkowie|Dybków| |37-530 Sieniawa;628;324;324;11;313;51.59;3.40
100017;181407;Dom Ludowy w Leżachowie|Leżachów| |37-530 Sieniawa;395;151;151;5;146;38.23;3.31
100018;181407;Dom Ludowy w Piganach|Pigany| |37-530 Sieniawa;597;216;216;11;205;36.18;5.09
100019;181407;Remizo-świetlica w Rudce|Rudka| |37-530 Sieniawa;602;282;282;12;270;46.84;4.26
100020;181407;Szkoła Podstawowa w Sieniawie|Sieniawa|Rynek 4 |37-530 Sieniawa;1773;885;885;16;869;49.92;1.81
100021;181407;Remizo-świetlica w Wylewie|Wylewa| |37-530 Sieniawa;579;285;285;5;280;49.22;1.75
100022;181408;Zespół Szkół w Tryńczy|Tryńcza| 129 |37-204 Tryńcza;1497;727;727;25;702;48.56;3.44
100023;181408;Wiejski Dom Kultury w Gorzycach|Gorzyce| 88 |37-204 Tryńcza;1047;444;444;16;428;42.41;3.60
100024;181408;Wiejski Dom Kultury w Gniewczynie Łańcuckiej|Gniewczyna Łańcucka| 621 |37-203 Gniewczyna Łańcucka;1669;945;945;29;916;56.62;3.07
100025;181408;Zespół Szkoły i Przedszkola w Jagielle|Jagiełła| 275 |37-203 Gniewczyna Łańcucka;894;440;440;22;418;49.22;5.00
100026;181408;Wiejski Dom Kultury w Głogowcu|Głogowiec| 60 |37-204 Tryńcza;241;137;137;3;134;56.85;2.19
100027;181408;Wiejski Dom Kultury w Gniewczynie Trynieckiej|Gniewczyna Tryniecka| 27 |37-203 Gniewczyna Łańcucka;682;406;406;12;394;59.53;2.96
100028;181408;Szkoła Podstawowa w Ubieszynie|Ubieszyn| 65 |37-204 Tryńcza;579;264;264;10;254;45.60;3.79
100029;181409;Zespół Szkół im. Jana Pawła II w Zarzeczu|Zarzecze| 9A |37-205 Zarzecze;1256;708;708;25;683;56.37;3.53
100030;181409;Szkoła Podstawowa w Siennowie|Siennów| 227 |37-205 Zarzecze;866;381;381;25;356;44.00;6.56
100031;181409;Zespół Szkół im. św. Brata Alberta w Żurawiczkach|Żurawiczki| 82 |37-200 Przeworsk;978;473;473;19;454;48.36;4.02
100032;181409;Szkoła Podstawowa w Maćkówce|Maćkówka| 210 |37-200 Przeworsk;673;393;393;17;376;58.40;4.33
100033;181409;Zespół Szkół w Zarzeczu Szkoła filialna im. Orła Białego w Pełnatyczach|Pełnatycze| 16 |37-205 Zarzecze;580;270;270;11;259;46.55;4.07
100034;181409;Zespół Szkół w Zarzeczu Szkoła filialna im. Kardynała Stefana Wyszyńskiego w Rożniatowie|Rożniatów| 5A |37-205 Zarzecze;532;211;211;9;202;39.66;4.27
100035;181409;Remiza OSP w Zalesiu|Zalesie| |37-205 Zarzecze;329;190;190;11;179;57.75;5.79
100036;181409;Remiza OSP w Kisielowie|Kisielów| |37-205 Zarzecze;328;189;189;3;186;57.62;1.59
100037;181409;Remiza OSP w Łapajówce|Łapajówka| |37-205 Zarzecze;216;125;125;10;115;57.87;8.00
100038;181501;Zespół Szkół w Iwierzycach|Iwierzyce| 188 |39-124 Iwierzyce;821;473;473;17;456;57.61;3.59
100039;181501;Zespół Szkół w Iwierzycach, Szkoła Filialna w Sielcu|Sielec| 51 B |39-120 Sędziszów Małopolski;568;337;337;9;328;59.33;2.67
100040;181501;Szkoła Podstawowa w Olchowej|Olchowa| 3 |39-127 Będziemyśl;987;547;547;15;532;55.42;2.74
100041;181501;Szkoła Podstawowa w Nockowej|Nockowa| 1 |39-124 Iwierzyce;1014;545;545;24;521;53.75;4.40
100042;181501;Szkoła Podstawowa w Nockowej,Szkoła Filialna w Będzienicy|Będzienica| 44 |39-124 Iwierzyce;361;200;200;6;194;55.40;3.00
100043;181501;Szkoła Podstawowa w Bystrzycy, Szkoła Filialna w Wiśniowej|Wiśniowa| 69 |39-124 Iwierzyce;562;259;259;8;251;46.09;3.09
100044;181501;Szkoła Podstawowa w Bystrzycy|Bystrzyca| 52 A |39-124 Iwierzyce;708;393;393;10;383;55.51;2.54
100045;181501;Dom Strażaka w Olimpowie|Olimpów| 57 |39-124 Iwierzyce;438;286;286;5;281;65.30;1.75
100046;181501;Szkoła Podstawowa w Wiercanach|Wiercany| 73 |39-124 Iwierzyce;587;305;305;4;301;51.96;1.31
100047;181502;Dom Strażaka w Ostrowie|Ostrów| 224 |39-103 Ostrów;1297;590;590;26;564;45.49;4.41
100048;181502;Szkoła Podstawowa w Skrzyszowie|Skrzyszów| 190 |39-103 Ostrów;848;317;317;15;302;37.38;4.73
100049;181502;Szkoła Podstawowa w Woli Ocieckiej|Wola Ociecka| 114 |39-104 Ocieka;552;218;218;9;209;39.49;4.13
100050;181502;Szkoła Podstawowa w Ociece|Ocieka| 352 |39-104 Ocieka;1009;476;476;15;461;47.18;3.15
100051;181502;Wiejski Ośrodek Kultury w Bliźnie|Blizna| 68 |39-104 Ocieka;195;72;72;0;72;36.92;0.00
100052;181502;Szkoła Podstawowa w Kamionce|Kamionka| 206 |39-122 Kamionka;693;355;355;14;341;51.23;3.94
100053;181502;Szkoła Podstawowa w Zdżarach|Zdżary| 59 |39-104 Ocieka;217;77;77;1;76;35.48;1.30
100054;181502;Dom Ludowy w Borku Małym|Borek Mały| 41 |39-120 Sędziszów Małopolski;247;126;126;1;125;51.01;0.79
100055;181502;Szkoła Podstawowa w Kozodrzy|Kozodrza| 175 |39-103 Ostrów;653;341;341;15;326;52.22;4.40
100056;181503;Dom Strażaka w Brzezówce|Brzezówka| 160 |39-102 Lubzina;906;380;380;14;366;41.94;3.68
100057;181503;Zespół Szkół w Lubzinie|Lubzina| 188 |39-102 Lubzina;1603;751;751;25;726;46.85;3.33
100058;181503;Dom Strażaka w Łączkach Kucharskich|Łączki Kucharskie| 160 |39-106 Łączki Kucharskie;1097;539;539;19;520;49.13;3.53
100059;181503;Dom Strażaka w Okoninie|Okonin| 29 |39-100 Ropczyce;332;183;183;2;181;55.12;1.09
100060;181503;Zespół Szkół w Niedźwiadzie Dolnej|Niedźwiada| 40 |39-107 Niedźwiada;1093;616;616;17;599;56.36;2.76
100061;181503;Zespół Szkół w Niedźwiadzie Górnej|Niedźwiada| 261 |39-107 Niedźwiada;968;536;536;25;511;55.37;4.66
100062;181503;Zespół Szkół w Małej|Mała| 35 |39-107 Niedźwiada;1081;580;580;21;559;53.65;3.62
100063;181503;Zespół Szkół w Gnojnicy Dolnej|Gnojnica| 268 |39-105 Gnojnica;962;587;587;15;572;61.02;2.56
100064;181503;Zespół Szkół w Gnojnicy Woli|Gnojnica| 504 |39-105 Gnojnica;738;394;394;15;379;53.39;3.81
100065;181503;Dom Strażaka w Ropczycach - Brzyźnie|Ropczyce|ul. Ogrodnicza 36f |39-100 Ropczyce;509;280;280;4;276;55.01;1.43
100066;181503;Szkoła Podstawowa w Ropczycach - Granicach|Ropczyce|ul. Leśna 88 |39-100 Ropczyce;593;340;340;16;324;57.34;4.71
100067;181503;Przedsiębiorstwo Energetyki Cieplnej w Ropczycach|Ropczyce|ul. Piłsudskiego 22 |39-100 Ropczyce;619;357;357;11;346;57.67;3.08
100068;181503;Zespół Szkół Nr 3 w Ropczycach|Ropczyce|ul. Robotnicza 48 |39-100 Ropczyce;1137;608;608;15;593;53.47;2.47
100069;181503;Zespół Szkół Nr 4 w Ropczycach|Ropczyce|ul. 3 Maja 424 |39-100 Ropczyce;1459;814;814;27;787;55.79;3.32
100070;181503;Publiczne Przedszkole Nr 3 w Ropczycach|Ropczyce|ul. Szkolna 33A |39-100 Ropczyce;736;394;394;12;382;53.53;3.05
100071;181503;Dom Strażaka w Ropczycach - Witkowicach|Ropczyce|ul. Sucharskiego 101A |39-100 Ropczyce;1292;742;742;17;725;57.43;2.29
100072;181503;Zespół Szkół Nr 2 w Ropczycach|Ropczyce|ul. Konarskiego 4 |39-100 Ropczyce;1276;669;669;20;649;52.43;2.99
100073;181503;Zespół Szkół Nr 2 w Ropczycach|Ropczyce|ul. Konarskiego 4 |39-100 Ropczyce;584;320;320;1;319;54.79;0.31
100074;181503;Przedszkole Publiczne Nr 2 w Ropczycach|Ropczyce|ul. Armii Krajowej 6 |39-100 Ropczyce;1389;784;784;25;759;56.44;3.19
100075;181503;Zespół Szkół im. ks. dr. J. Zwierza w Ropczycach|Ropczyce|ul. Mickiewicza 14 |39-100 Ropczyce;705;471;471;11;460;66.81;2.34
100076;181503;Centrum Kultury im. Józefa Mehoffera w Ropczycach|Ropczyce|ul. Bursztyna 1 |39-100 Ropczyce;593;325;325;9;316;54.81;2.77
100077;181503;Miejska i Powiatowa Biblioteka Publiczna w Ropczycach|Ropczyce|ul. Grunwaldzka 19 |39-100 Ropczyce;1511;845;845;16;829;55.92;1.89
100078;181504;Liceum Ogólnokształcące Sędziszów Młp.|Sędziszów Małopolski|Fabryczna 5 |39-120 Sędziszów Młp.;742;434;434;13;421;58.49;3.00
100079;181504;Szkoła Podstawowa Nr 3 Sędziszów Młp.|Sędziszów Małopolski|Osiedle Młodych 20 |39-120 Sędziszów Młp.;876;523;523;10;513;59.70;1.91
100080;181504;Szkoła Podstawowa Nr 3 Sędziszów Młp.|Sędziszów Małopolski|Osiedle Młodych 20 |39-120 Sędziszów Młp.;734;447;447;8;439;60.90;1.79
100081;181504;Szkoła Podstawowa Nr 2 Sędziszów Młp.|Sędziszów Małopolski|Rynek 9 |39-120 Sędziszów Młp.;1376;865;865;20;845;62.86;2.31
100082;181504;Gimnazjum w Sędziszowie Młp.|Sędziszów Małopolski|ks. Maciąga 3 |39-120 Sędziszów Młp.;901;523;523;2;521;58.05;0.38
100083;181504;Gimnazjum w Sędziszowie Młp.|Sędziszów Małopolski|Ks. Maciąga 3 |39-120 Sędziszów Małopolski;1322;755;755;4;751;57.11;0.53
100084;181504;Dom Ludowy w Będziemyślu|Będziemyśl| 35 |39-127 Będziemyśl;806;401;401;16;385;49.75;3.99
100085;181504;Szkoła Podstawowa w Boreczku|Boreczek| 46 |39-120 Sędziszów Młp.;292;168;168;4;164;57.53;2.38
100086;181504;Szkoła Podstawowa w Borku Wielkim|Borek Wielki| 254 |39-120 Sędziszów Młp.;1251;687;687;19;668;54.92;2.77
100087;181504;Budynek byłej szkoły w Cierpiszu|Cierpisz| 33 |39-123 Czarna Sędziszowska;150;87;87;1;86;58.00;1.15
100088;181504;Gimnazjum w Czarnej Sędziszowskiej|Czarna Sędziszowska| 145 |39-123 Czarna Sędziszowska;1149;624;624;15;609;54.31;2.40
100089;181504;Szkoła Podstawowa w Górze Ropczyckiej|Góra Ropczycka| 2 |39-120 Sędziszów Młp.;934;559;559;23;536;59.85;4.11
100090;181504;Szkoła Podstawowa w Kawęczynie Sędziszowskim|Kawęczyn Sędziszowski| 73 |39-120 Sędziszów Młp.;779;420;420;14;406;53.92;3.33
100091;181504;Dom Ludowy w Klęczanach|Klęczany| 112 |39-127 Będziemyśl;1184;576;576;15;561;48.65;2.60
100092;181504;Szkoła Podstawowa w Krzywej|Krzywa| 121 |39-120 Sędziszów Młp.;929;507;507;14;493;54.57;2.76
100093;181504;Dom Strażaka w Rudzie|Ruda| 65 |39-122 Kamionka;235;129;129;3;126;54.89;2.33
100094;181504;Szkoła Podstawowa w Szkodnej|Szkodna| 121 |39-126 Zagorzyce;594;345;345;22;323;58.08;6.38
100095;181504;Przedszkole w Wolicy Ługowej|Wolica Ługowa| 70 |39-120 Sędziszów Młp.;567;247;247;6;241;43.56;2.43
100096;181504;Szkoła Podstawowa w Wolicy Piaskowej|Wolica Piaskowa| 76 |39-120 Sędziszów Młp.;1009;565;565;10;555;56.00;1.77
100097;181504;Szkoła Podstawowa w Zagorzycach Dolnych|Zagorzyce| 78 |39-126 Zagorzyce;1346;895;895;18;877;66.49;2.01
100098;181504;Szkoła Podstawowa w Zagorzycach Górnych|Zagorzyce| 175 |39-126 Zagorzyce;1237;776;776;10;766;62.73;1.29
100099;181504;Dom Pomocy Społecznej w Rudzie|Ruda| 102 |39-122 Kamionka;89;53;53;6;47;59.55;11.32
100100;181504;Szpital Powiatowy w Sędziszowie Małopolskim. Zakład Pielęgnacyjno-Opiekuńczy w Sędziszowie Małopolskim|Sędziszów Małopolski|Wyspiańskiego 14 |39-120 Sędziszów Małopolski;77;31;31;2;29;40.26;6.45
100101;181505;Filia GOKiW w Broniszowie|Broniszów| 79 |39-106 Łączki Kucharskie;675;352;352;14;338;52.15;3.98
100102;181505;Budynek wielofunkcyjny w Gliniku|Glinik| 133 |39-106 Łączki Kucharskie;1138;722;722;22;700;63.44;3.05
100103;181505;Gminny Ośrodek Kultury i Wypoczynku w Wielopolu Skrzyńskim|Wielopole Skrzyńskie| 202 |39-110 Wielopole Skrzyńskie;1596;867;867;31;836;54.32;3.58
100104;181505;Filia GOKiW w Brzezinach|Brzeziny| 168 |39-111 Brzeziny;1421;700;700;32;668;49.26;4.57
100105;181505;Szkoła Podstawowa w Brzezinach-Berdechowie|Brzeziny| 382a |39-111 Brzeziny;434;172;172;16;156;39.63;9.30
100106;181505;Filia GOKiW w Nawsiu|Nawsie| 304 |39-110 Wielopole Skrzyńskie;1165;567;567;27;540;48.67;4.76
100107;181601;Urząd Miejski w Dynowie|Dynów|ul. Rynek 2 |36-065 Dynów;1763;839;839;24;815;47.59;2.86
100108;181601;Środowiskowy Dom Samopomocy|Dynów|ul. Jana Pawła II 13 |36-065 Dynów;825;414;414;14;400;50.18;3.38
100109;181601;Liceum Ogólnokształcące|Dynów|ul. 1 - Maja 18 |36-065 Dynów;1599;825;825;17;808;51.59;2.06
100110;181601;Dom Ludowy|Dynów|ul. Bartkówka 120 |36-065 Dynów;715;354;354;13;341;49.51;3.67
100111;181601;Dom Pogodnej Starości|Dynów|Ks. Józefa Ożoga 12A |36-065 Dynów;73;57;57;0;57;78.08;0.00
100112;181602;Szkoła Podstawowa w Błażowej|Błażowa|ul. Armii Krajowej 11 |36-030 Błażowa;1750;936;936;23;913;53.49;2.46
100113;181602;Świetlica w Błażowej Górnej|Błażowa Górna| 204 |36-030 Błażowa;581;253;253;2;251;43.55;0.79
100114;181602;Szkoła Podstawowa w Nowym Borku|Nowy Borek| 331 |36-030 Błażowa;1330;715;715;18;697;53.76;2.52
100115;181602;Szkoła Podstawowa w Błażowej Dolnej|Błażowa Dolna| 196 |36-030 Błażowa;1012;495;495;15;480;48.91;3.03
100116;181602;Szkoła Podstawowa w Piątkowej|Piątkowa| 429 |36-030 Błażowa;700;364;364;10;354;52.00;2.75
100117;181602;Szkoła Podstawowa w Futomie|Futoma| 168 |36-030 Błażowa;1028;571;571;27;544;55.54;4.73
100118;181602;Szkoła Podstawowa w Kąkolówce|Kąkolówka| 468 |36-030 Błażowa;1117;536;536;10;526;47.99;1.87
100119;181602;Szkoła Podstawowa w Białce|Białka| 175 |36-030 Błażowa;484;272;272;6;266;56.20;2.21
100120;181602;Szkoła Podstawowa w Lecce|Lecka| 230 |36-030 Błażowa;708;367;367;14;353;51.84;3.81
100121;181603;Sala widowiskowa przy Urzędzie Miejskim w Boguchwale|Boguchwała|ul. Doktora Tkaczowa 134 |36-040 Boguchwała;2180;1243;1243;18;1225;57.02;1.45
100122;181603;Gimnazjum w Boguchwale|Boguchwała|ul. Doktora Tkaczowa 156 |36-040 Boguchwała;1820;1079;1079;13;1066;59.29;1.20
100123;181603;Przedszkole Publiczne w Boguchwale|Boguchwała|Techniczna 1a |36-040 Boguchwała;761;453;453;12;441;59.53;2.65
100124;181603;Szkoła Podstawowa w Mogielnicy|Mogielnica| 167 |36-040 Boguchwała;976;558;558;10;548;57.17;1.79
100125;181603;Zespół Szkół w Niechobrzu|Niechobrz| 679 |36-047 Niechobrz;2244;1364;1364;20;1344;60.78;1.47
100126;181603;Szkoła Podstawowa w Woli Zgłobieńskiej|Wola Zgłobieńska| 140 |36-046 Zgłobień;1158;644;644;11;633;55.61;1.71
100127;181603;Szkoła Podstawowa w Zgłobniu|Zgłobień| 70 |36-046 Zgłobień;1228;722;722;10;712;58.79;1.39
100128;181603;Szkoła Podstawowa w Nosówce|Nosówka| 186 |36-046 Zgłobień;1102;668;668;8;660;60.62;1.20
100129;181603;Zespół Szkół w Racławówce|Racławówka| 215 |36-047 Niechobrz;1161;702;702;12;690;60.47;1.71
100130;181603;Zespół Szkół w Kielanówce|Kielanówka| 111 |35-106 Rzeszów;1219;798;798;7;791;65.46;0.88
100131;181603;Szkoła Podstawowa w Lutoryżu|Lutoryż| 432 |36-040 Boguchwała;1301;710;710;21;689;54.57;2.96
100132;181603;Szkoła Podstawowa w Zarzeczu|Zarzecze| 133 |36-041 Boguchwała;453;289;289;4;285;63.80;1.38
100133;181603;Niepubliczny Zakład Opieki Zdrowotnej AVEE-med. Zakład Opiekuńczo-Leczniczy|Niechobrz| 972 |36-047 Niechobrz;31;4;4;0;4;12.90;0.00
100134;181603;Dom Spokojnej Starości "Złote Liście"|Zarzecze| 23 |36-041 Boguchwała;45;2;2;0;2;4.44;0.00
100135;181604;Szkoła Podstawowa Nr 2 w Chmielniku|Chmielnik| 316 |36-016 Chmielnik;1413;898;898;21;877;63.55;2.34
100136;181604;Urząd Gminy w Chmielniku|Chmielnik| 50 |36-016 Chmielnik;1437;862;862;26;836;59.99;3.02
100137;181604;Dom Ludowy w Woli Rafałowskiej|Wola Rafałowska| 137 |36-017 Błędowa Tyczyńska;855;435;435;14;421;50.88;3.22
100138;181604;Dom Ludowy w Błędowej Tyczyńskiej|Błędowa Tyczyńska| 29 |36-017 Błędowa Tyczyńska;721;367;367;5;362;50.90;1.36
100139;181604;Dom Ludowy w Zabratówce|Zabratówka| 42 |36-017 Błędowa Tyczyńska;559;279;279;5;274;49.91;1.79
100140;181604;Dom Ludowy w Borówkach|Borówki| 34 |36-016 Chmielnik;227;132;132;5;127;58.15;3.79
100141;181604;Dom Pomocy Społecznej Im. Św. Ojca Pio|Chmielnik| 4 |36-016 Chmielnik;65;56;56;1;55;86.15;1.79
100142;181605;Dom Strażaka w Bachórzu|Bachórz| 82 |36-068 Bachórz;926;369;369;12;357;39.85;3.25
100143;181605;Szkoła Podstawowa w Dąbrówce Starzeńskiej|Dąbrówka Starzeńska| 131 |36-065 Dynów;358;174;174;12;162;48.60;6.90
100144;181605;Zespół Szkół Nr 5 w Dylągowej|Dylągowa| 44 |36-069 Dylągowa;472;182;182;6;176;38.56;3.30
100145;181605;Zespół Szkół Nr 2 w Harcie|Harta| 106 |36-067 Harta;817;356;356;6;350;43.57;1.69
100146;181605;Dom Ludowy w Harcie|Harta| 225 |36-067 Harta;857;456;456;13;443;53.21;2.85
100147;181605;Szkoła Podstawowa w Laskówce|Laskówka| 69 |36-068 Bachórz;327;133;133;3;130;40.67;2.26
100148;181605;Zespół Szkół Nr 3 w Łubnie|Łubno| 82 |36-065 Dynów;990;340;340;23;317;34.34;6.76
100149;181605;Zespół Szkół Nr 4 w Pawłokomie|Pawłokoma| 24 |36-065 Dynów;420;119;119;11;108;28.33;9.24
100150;181605;Szkoła Podstawowa w Ulanicy|Ulanica| 28A |36-065 Dynów;326;166;166;9;157;50.92;5.42
100151;181605;Dom Strażaka w Wyrębach|Wyręby| 52 |36-065 Dynów;155;72;72;1;71;46.45;1.39
100152;181606;Miejsko Gminny Dom Kultury w Głogowie Małopolskim|Głogów Małopolski|Kardynała Stefana Wyszyńskiego 12 |36-060 Głogów Małopolski;987;561;561;13;548;56.84;2.32
100153;181606;Miejsko Gminny Dom Kultury w Głogowie Małopolskim|Głogów Małopolski|Kardynała Stefana Wyszyńskiego 12 |36-060 Głogów Małopolski;1986;1166;1166;24;1142;58.71;2.06
100154;181606;Dom Ludowy w Hucisku|Hucisko| 1 |36-003 Przewrotne;322;157;157;2;155;48.76;1.27
100155;181606;Dom Ludowy w Pogwizdowie Starym|Pogwizdów Stary| 56 |36-130 Raniżów;403;180;180;6;174;44.67;3.33
100156;181606;Zespół Szkół w Przewrotnem|Przewrotne| 589 |36-003 Przewrotne;1386;612;612;21;591;44.16;3.43
100157;181606;Dom Ludowy w Stykowie|Styków| 318 |36-060 Głogów Małopolski;678;365;365;17;348;53.83;4.66
100158;181606;Zespół Szkół w Budach Głogowskich|Budy Głogowskie| 846 |36-060 Głogów Małopolski;1467;780;780;29;751;53.17;3.72
100159;181606;Dom Ludowy w Wysokiej Głogowskiej|Wysoka Głogowska| |36-061 Wysoka Głogowska;1782;1098;1098;24;1074;61.62;2.19
100160;181606;Dom Ludowy w Woli Cichej|Wola Cicha| 151 |36-060 Głogów Małopolski;268;159;159;5;154;59.33;3.14
100161;181606;Dom Ludowy w Zabajce|Zabajka| 145 |36-060 Głogów Małopolski;579;332;332;9;323;57.34;2.71
100162;181606;Dom Strażaka w Lipiu|Lipie| 64 |36-060 Głogów Małopolski;396;244;244;16;228;61.62;6.56
100163;181606;Dom Ludowy w Rogoźnicy|Rogoźnica| 98 |36-060 Głogów Małopolski;489;285;285;8;277;58.28;2.81
100164;181606;Szkoła Podstawowa w Rudnej Małej|Rudna Mała| |36-054 Mrowla;1166;657;657;8;649;56.35;1.22
100165;181606;Remiza OSP w Pogwizdowie Nowym|Pogwizdów Nowy| 252 |36-062 Zaczernie;887;550;550;11;539;62.01;2.00
100166;181606;Dom Ludowy w Miłocinie|Miłocin| 207 |36-062 Zaczernie;610;372;372;8;364;60.98;2.15
100167;181606;Miejsko Gminny Dom Kultury w Głogowie Małopolskim|Głogów Małopolski|Kardynała Stefana Wyszyńskiego 12 |36-060 Głogów Małopolski;1725;1064;1064;18;1046;61.68;1.69
100168;181606;Szpital Specjalistyczny im. Świętej Rodziny w Rudnej Małej|Rudna Mała| 600 |36-060 Głogów Małopolski;44;24;24;0;24;54.55;0.00
100169;181607;Szkoła Podstawowa|Brzezówka| 111 |36-024 Hyżne;433;241;241;9;232;55.66;3.73
100170;181607;Budynek Gimnazjum|Hyżne| 614 |36-024 Hyżne;1122;703;703;32;671;62.66;4.55
100171;181607;Gminny Ośrodek Kultury|Hyżne| 182 |36-024 Hyżne;1141;681;681;21;660;59.68;3.08
100172;181607;Klub Strażaka Nieborów|Hyżne| 791 |36-024 Hyżne;267;181;181;5;176;67.79;2.76
100173;181607;Szkoła Podstawowa|Grzegorzówka| 173 |36-025 Dylągówka;425;230;230;7;223;54.12;3.04
100174;181607;Szkoła Podstawowa|Wólka Hyżneńska| 28 |36-025 Dylągówka;564;315;315;11;304;55.85;3.49
100175;181607;Szkoła Podstawowa|Dylągówka| 29 |36-025 Dylągówka;836;486;486;11;475;58.13;2.26
100176;181607;Szkoła Podstawowa|Szklary| 148 |36-025 Dylągówka;706;348;348;11;337;49.29;3.16
100177;181608;Środowiskowy Dom Samopomocy w Kamieniu|Kamień, Górka| 376 |36-053 Kamień;1017;527;527;11;516;51.82;2.09
100178;181608;Zespół Szkół im. Jana Pawła II w Łowisku|Łowisko| 181 |36-053 Kamień;1130;656;656;8;648;58.05;1.22
100179;181608;Szkoła Podstawowa w Krzywej Wsi|Kamień, Krzywa Wieś| 35 |36-053 Kamień;630;353;353;8;345;56.03;2.27
100180;181608;Szkoła Podstawowa im. św. Floriana w Kamieniu Podlesiu|Kamień, Podlesie| 78A |36-053 Kamień;631;356;356;20;336;56.42;5.62
100181;181608;Szkoła Podstawowa im. Św. Jadwigi Królowej w Kamieniu Prusinie|Kamień, Prusina| 119 |36-053 Kamień;1357;687;687;14;673;50.63;2.04
100182;181608;Zespół Szkół im. św. Stanisława Kostki w Nowym Kamieniu|Nowy Kamień| 26 |36-053 Kamień;773;432;432;6;426;55.89;1.39
100183;181609;Gminny Ośrodek Kultury i Biblioteka w Krasnem|Krasne| 743 |36-007 Krasne;1729;930;930;25;905;53.79;2.69
100184;181609;Szkoła Podstawowa w Krasnem|Krasne| 742 |36-007 Krasne;1711;1043;1043;9;1034;60.96;0.86
100185;181609;Zespół Szkół w Malawie|Malawa| 199 A |36-007 Krasne;1535;970;970;23;947;63.19;2.37
100186;181609;Gminne Przedszkole Publiczne w Malawie|Malawa| 199 B |36-007 Krasne;1075;617;617;19;598;57.40;3.08
100187;181609;Zespół Szkół w Strażowie|Strażów| 270 A |36-073 Strażów;1441;811;811;22;789;56.28;2.71
100188;181609;Zespół Szkół w Palikówce|Palikówka| 271 |36-073 Strażów;991;622;622;9;613;62.76;1.45
100189;181610;Urząd Gminy Lubenia|Lubenia| 131 |36-042 Lubenia;1917;1035;1035;17;1018;53.99;1.64
100190;181610;Dom Kultury Siedliska|Siedliska| 124 |36-042 Lubenia;1420;860;860;18;842;60.56;2.09
100191;181610;Szkoła Podstawowa w Straszydlu|Straszydle| 155 |36-043 Straszydle;1500;785;785;24;761;52.33;3.06
100192;181610;Dom Kultury Sołonka|Sołonka| 26 |36-043 Straszydle;355;205;205;3;202;57.75;1.46
100193;181611;Miejsko Gminny Ośrodek Kultury Sportu i Rekreacji|Sokołów Małopolski|Lubelska 5 |36-050 Sokołów Małopolski;1647;959;959;21;938;58.23;2.19
100194;181611;Zespół Szkół im. Jana Pawła II|Sokołów Małopolski|Lubelska 41 |36-050 Sokołów Małopolski;1630;949;949;27;922;58.22;2.85
100195;181611;Świetlica Wiejska|Markowizna| 34 |36-051 Górno;324;159;159;8;151;49.07;5.03
100196;181611;Samodzielny Publiczny Zespół Zakładów Opieki Zdrowotnej "Sanatorium"|Górno|Rzeszowska 5 |36-051 Górno;443;166;166;10;156;37.47;6.02
100197;181611;Zespół Szkół im. ks. M.Lachora|Górno|Centralna 14 |36-051 Górno;1247;778;778;14;764;62.39;1.80
100198;181611;Zespół Szkół im. Bł. Bronisława Markiewicza|Trzeboś, Trzeboś Górna|Kościelna 1 |36-050 Sokołów Małopolski;1669;896;896;30;866;53.68;3.35
100199;181611;Ochotnicza Straż Pożarna|Nienadówka| 712 |36-052 Nienadówka;2172;1132;1132;47;1085;52.12;4.15
100200;181611;Zespół Szkół im. Królowej Jadwigi|Trzebuska| 196 |36-050 Sokołów Małopolski;906;440;440;19;421;48.57;4.32
100201;181611;Dom Kultury|Wólka Niedźwiedzka| 264 |36-050 Sokołów Małopolski;1445;750;750;23;727;51.90;3.07
100202;181611;Szkoła Podstawowa|Wólka Sokołowska| 65 |36-050 Sokołów Małopolski;561;295;295;12;283;52.58;4.07
100203;181611;Szkoła Podstawowa im. Św. St. Kostki|Trzeboś-Podlas|Podlas 29 |36-050 Sokołów Małopolski;275;93;93;4;89;33.82;4.30
100204;181611;Zespół Szkół w Sokołowie Młp.|Sokołów Małopolski|Lubelska 37 |36-050 Sokołów Małopolski;508;287;287;1;286;56.50;0.35
100205;181611;Świetlica Wiejska|Trzebuska, Kąty| 625 |36-050 Sokołów Małopolski;436;252;252;17;235;57.80;6.75
100206;181612;Dom Strażaka w Świlczy|Świlcza| 151 |36-072 Świlcza;1842;1040;1040;20;1020;56.46;1.92
100207;181612;Dom Strażaka w Świlczy|Świlcza| 151 |36-072 Świlcza;900;532;532;4;528;59.11;0.75
100208;181612;Dom Strażaka w Mrowli|Mrowla| 83 A |36-054 Mrowla;1160;679;679;25;654;58.53;3.68
100209;181612;Zespół Szkół w Rudnej Wielkiej|Rudna Wielka| 60 |36-054 Mrowla;1196;747;747;13;734;62.46;1.74
100210;181612;Publiczna Szkoła Podstawowa Sióstr Nazaretanek w Bziance|Bzianka| 20 |35-213 Rzeszów;493;295;295;13;282;59.84;4.41
100211;181612;Środowiskowy Dom Samopomocy w Woliczce|Woliczka| 64 |36-071 Trzciana;418;251;251;7;244;60.05;2.79
100212;181612;Dom Ludowy w Błędowej Zgłobieńskiej|Błędowa Zgłobieńska| 110 A |36-071 Trzciana;445;217;217;7;210;48.76;3.23
100213;181612;Dom Ludowy w Dąbrowie|Dąbrowa| 36 A |36-071 Trzciana;844;433;433;11;422;51.30;2.54
100214;181612;Zespół Szkół w Trzcianie|Trzciana| 168 |36-071 Trzciana;2003;1095;1095;30;1065;54.67;2.74
100215;181612;Zespół Szkół w Bratkowicach|Bratkowice| 398 |36-055 Bratkowice;1704;953;953;19;934;55.93;1.99
100216;181612;Zespół Szkół w Bratkowicach|Bratkowice| 398 |36-055 Bratkowice;1678;906;906;27;879;53.99;2.98
100217;181613;Gimnazjum w Trzebownisku|Trzebownisko| 968 |36-001 Trzebownisko;921;554;554;16;538;60.15;2.89
100218;181613;Gimnazjum w Trzebownisku|Trzebownisko| 968 |36-001 Trzebownisko;1786;988;988;18;970;55.32;1.82
100219;181613;Zespół Szkół w Zaczerniu|Zaczernie| 249a |36-062 Zaczernie;1741;1134;1134;25;1109;65.13;2.20
100220;181613;Zespół Szkół w Zaczerniu|Zaczernie| 249a |36-062 Zaczernie;944;606;606;15;591;64.19;2.48
100221;181613;Zespół Szkół w Nowej Wsi|Nowa Wieś| 200 |36-001 Trzebownisko;1050;729;729;14;715;69.43;1.92
100222;181613;Dom Ludowy w Tajęcinie|Tajęcina| 39 |36-002 Jasionka;427;233;233;4;229;54.57;1.72
100223;181613;Zespół Szkół w Jasionce|Jasionka| 301 |36-002 Jasionka;1791;1004;1004;25;979;56.06;2.49
100224;181613;Zespół Szkół Nr 1 w Stobiernej|Stobierna| 357 |36-002 Jasionka;1674;900;900;29;871;53.76;3.22
100225;181613;Zespół Szkół Nr 2 w Stobiernej|Stobierna| 954 |36-002 Jasionka;809;416;416;9;407;51.42;2.16
100226;181613;Zespół Szkół w Wólce Podleśnej|Wólka Podleśna| 438 |36-002 Jasionka;1186;662;662;23;639;55.82;3.47
100227;181613;Dom Strażaka w Łukawcu|Łukawiec| 426 |36-004 Łąka;1804;1022;1022;10;1012;56.65;0.98
100228;181613;Zespół Szkół w Łące|Łąka| 224b |36-004 Łąka;1555;844;844;12;832;54.28;1.42
100229;181613;Szkoła Podstawowa w Terliczce|Terliczka| 213 |36-001 Trzebownisko;473;252;252;9;243;53.28;3.57
100230;181614;Miejsko - Gminny Ośrodek Kultury w Tyczynie (holl)|Tyczyn|ul. Mickiewicza 1 |36-020 Tyczyn;1057;650;650;21;629;61.49;3.23
100231;181614;Miejsko - Gminny Ośrodek Kultury w Tyczynie (sala widowiskowa)|Tyczyn|ul. Mickiewicza 1 |36-020 Tyczyn;1754;1079;1079;34;1045;61.52;3.15
100232;181614;Szkoła Podstawowa w Matysówce|Matysówka| 55 |35-330 Rzeszów;1169;651;651;12;639;55.69;1.84
100233;181614;Dom Ludowy w Kielnarowej|Kielnarowa| 57 |36-020 Tyczyn;1453;770;770;16;754;52.99;2.08
100234;181614;Dom Ludowy w Borku Starym|Borek Stary| 84 |36-020 Tyczyn;1397;816;816;22;794;58.41;2.70
100235;181614;Dom Ludowy w Hermanowej|Hermanowa| 225 |36-020 Tyczyn;1100;631;631;15;616;57.36;2.38
100236;181614;Szkoła Podstawowa w Hermanowej|Hermanowa| 212 |36-020 Tyczyn;989;474;474;10;464;47.93;2.11
100237;181701;Zespół Szkół Nr 5 im. Ignacego Łukasiewicza|Sanok|ul. Jagiellońska 22 |38-500 Sanok;1282;568;568;11;557;44.31;1.94
100238;181701;Gimnazjum Nr 2|Sanok|ul. Jana III Sobieskiego 5 |38-500 Sanok;1234;555;555;12;543;44.98;2.16
100239;181701;Szkoła Podstawowa Nr 2|Sanok|ul. Rymanowska 17 |38-500 Sanok;1360;676;676;5;671;49.71;0.74
100240;181701;Państwowa Wyższa Szkoła Zawodowa im J. Grodka (budynek D)|Sanok|ul. Mickiewicza 21 |38-500 Sanok;1223;593;593;5;588;48.49;0.84
100241;181701;Centrum Handlowe "Ryś"|Sanok|ul. Krakowska 2 |38-500 Sanok;1439;782;782;11;771;54.34;1.41
100242;181701;Filia Samorządowego Przedszkola Publicznego Nr 1|Sanok|ul. Piastowska 47 |38-500 Sanok;1718;835;835;20;815;48.60;2.40
100243;181701;Gimnazjum Nr 4|Sanok|ul. Jana Pawła II 25 |38-500 Sanok;1530;740;740;11;729;48.37;1.49
100244;181701;Samorządowe Przedszkole Publiczne Nr 2|Sanok|ul. Sadowa 11 |38-500 Sanok;1530;667;667;17;650;43.59;2.55
100245;181701;Szkoła Podstawowa Nr 4|Sanok|ul. Sadowa 12 |38-500 Sanok;1509;723;723;14;709;47.91;1.94
100246;181701;Żłobek Samorządowy Nr 2|Sanok|ul. Traugutta 23 |38-500 Sanok;1212;530;530;9;521;43.73;1.70
100247;181701;Osiedlowy Dom Kultury "Puchatek"|Sanok|ul. Traugutta 9 |38-500 Sanok;1412;686;686;19;667;48.58;2.77
100248;181701;Żłobek Samorządowy Nr 2|Sanok|ul. Traugutta 23 |38-500 Sanok;1440;624;624;18;606;43.33;2.88
100249;181701;TS "Sanoczanka"|Sanok|ul. Kwiatowa 25 |38-500 Sanok;1395;725;725;15;710;51.97;2.07
100250;181701;Gimnazjum Nr 1|Sanok|ul. Kochanowskiego 2 |38-500 Sanok;1463;810;810;17;793;55.37;2.10
100251;181701;Szkoła Podstawowa Nr 1|Sanok|al. Szwajcarii 5 |38-500 Sanok;1387;703;703;18;685;50.68;2.56
100252;181701;Państwowa Wyższa Szkoła Zawodowa im. J. Grodka|Sanok|ul. Reymonta 6 |38-500 Sanok;1354;598;598;12;586;44.17;2.01
100253;181701;Szkoła Podstawowa Nr 6|Sanok|ul. Przemyska 80 |38-500 Sanok;2002;1001;1001;28;973;50.00;2.80
100254;181701;Samorządowe Przedszkole Publiczne Nr 4|Sanok|ul. Robotnicza 13a |38-500 Sanok;1597;780;780;18;762;48.84;2.31
100255;181701;Szkoła Podstawowa Nr 3|Sanok|ul. Stróżowska 4 |38-500 Sanok;1855;895;895;18;877;48.25;2.01
100256;181701;Gimnazjum Nr 3|Sanok|ul. Lipińskiego 63 |38-500 Sanok;1505;667;667;14;653;44.32;2.10
100257;181701;I Liceum Ogólnokształcące|Sanok|ul.Zagrody 1 |38-500 Sanok;1364;743;743;13;730;54.47;1.75
100258;181701;Szpital Specjalistyczny|Sanok|800 Lecia 26 |38-500 ;183;84;84;9;75;45.90;10.71
100259;181701;Areszt Śledczy|Sanok|Zaułek Dobrego Wojaka Szwejka 4 |38-500 ;114;53;53;14;39;46.49;26.42
100260;181702;Szkoła Podstawowa|Besko|ul. Kolejowa 54 |38-524 Besko;1155;488;488;26;462;42.25;5.33
100261;181702;Gimnazjum|Besko|ul. Kolejowa 54 |38-524 Besko;1002;414;414;13;401;41.32;3.14
100262;181702;Gminny Ośrodek Kultury|Besko|ul. Starowiejska 64 |38-524 Besko;1017;483;483;13;470;47.49;2.69
100263;181702;Szkoła Podstawowa w Besku Filia w Mymoniu|Mymoń|Szkolna 14 |38-524 Besko;300;81;81;6;75;27.00;7.41
100264;181703;Sala narad Urzędu Gminy Bukowsko|Bukowsko| 290 |38-505 Bukowsko;1965;848;848;27;821;43.16;3.18
100265;181703;Zespół Szkół Nowotaniec|Nowotaniec| 77 |38-505 Bukowsko;1310;626;626;20;606;47.79;3.19
100266;181703;Zespół Szkół Pobiedno|Pobiedno| 105 |38-505 Bukowsko;1018;471;471;9;462;46.27;1.91
100267;181704;Urząd Gminy|Komańcza| 166 |38-543 Komańcza;1008;336;336;7;329;33.33;2.08
100268;181704;Szkoła Podstawowa|Wisłok Wielki| 26A |38-543 Komańcza;585;138;139;7;131;23.59;5.07
100269;181704;Ośrodek Kultury|Szczawne| 32 |38-542 Rzepedź;595;146;146;8;138;24.54;5.48
100270;181704;Klub|Nowy Łupków| 46 |38-543 Komańcza;639;182;182;2;180;28.48;1.10
100271;181704;Rzepedzki Ośrodek Kultury|Rzepedź|Osiedle A 19A |38-542 Rzepedź;1303;442;442;14;428;33.92;3.17
100272;181704;Świetlica na terenie ZK|Nowy Łupków| 45 |38-543 Komańcza;154;64;64;12;52;41.56;18.75
100273;181704;Świetlica na terenie OZ Moszczaniec|Moszczaniec| 14 |38-543 Komańcza;252;86;86;6;80;34.13;6.98
100274;181705;Dom Ludowy|Płowce| 78 |38-500 Sanok;547;250;250;4;246;45.70;1.60
100275;181705;Szkoła Podstawowa|Niebieszczany| 492 |38-504 Niebieszczany;1749;857;857;22;835;49.00;2.57
100276;181705;Szkoła Podstawowa|Prusiek| 157 |38-504 Niebieszczany;636;304;304;13;291;47.80;4.28
100277;181705;Szkoła Podstawowa|Markowce| 55 |38-533 Nowosielce;286;125;125;6;119;43.71;4.80
100278;181705;Dom Ludowy|Sanoczek| 205 |38-500 Sanok;631;280;280;7;273;44.37;2.50
100279;181705;Dom Ludowy|Zabłotce| 100 |38-500 Sanok;370;184;184;11;173;49.73;5.98
100280;181705;Szkoła Podstawowa|Pisarowce| 92 |38-533 Nowosielce;866;378;378;9;369;43.65;2.38
100281;181705;Szkoła Podstawowa|Czerteż| 133 |38-500 Sanok;508;235;235;8;227;46.26;3.40
100282;181705;Dom Ludowy|Kostarowce| 224 |38-507 Jurowce;621;314;314;9;305;50.56;2.87
100283;181705;Dom Ludowy|Jurowce| 110 |38-507 Jurowce;1068;458;458;11;447;42.88;2.40
100284;181705;Dom Ludowy|Strachocina| 345A |38-507 Jurowce;906;544;544;23;521;60.04;4.23
100285;181705;Dom Ludowy|Pakoszówka| 224 |38-507 Jurowce;1002;467;467;21;446;46.61;4.50
100286;181705;Dom Ludowy|Falejówka| 174A |38-507 Jurowce;774;289;289;12;277;37.34;4.15
100287;181705;Dom Ludowy|Trepcza|Środkowa 25 |38-500 Sanok;964;408;408;10;398;42.32;2.45
100288;181705;Dom Ludowy|Dębna| 12 |38-503 Mrzygłód;202;97;97;2;95;48.02;2.06
100289;181705;Szkoła Podstawowa|Liszna| 77 |38-500 Sanok;283;110;110;4;106;38.87;3.64
100290;181705;Szkoła Podstawowa|Mrzygłód| 170 |38-503 Mrzygłód;644;265;265;3;262;41.15;1.13
100291;181705;Dom Ludowy|Dobra| 100 |38-503 Mrzygłód;715;260;260;11;249;36.36;4.23
100292;181705;Dom Ludowy|Bykowce|Przemyska 91 |38-500 Sanok;673;305;305;5;300;45.32;1.64
100293;181705;Szkoła Podstawowa|Wujskie| 1 |38-534 Załuż;567;260;260;14;246;45.86;5.38
100294;181706;Urząd Gminy|Tyrawa Wołoska| 175 |38-535 Tyrawa Wołoska;1579;615;615;38;577;38.95;6.18
100295;181707;Szkoła Podstawowa w Zagórzu|Zagórz|ul. Piłsudskiego 70 |38-540 Zagórz;1832;798;798;24;774;43.56;3.01
100296;181707;Szkoła Podstawowa w Zagórzu|Zagórz|ul. Wolności 10 |38-540 Zagórz;2302;1028;1028;29;999;44.66;2.82
100297;181707;Szkoła Podstawowa w Łukowem|Łukowe| 64 |38-516 Tarnawa Dolna;961;314;314;24;290;32.67;7.64
100298;181707;Gimnazjum w Tarnawie Dolnej|Tarnawa Dolna| 28 |38-516 Tarnawa Dolna;1681;742;742;13;729;44.14;1.75
100299;181707;Szkoła Podstawowa w Czaszynie|Czaszyn| 191 |38-516 Tarnawa Dolna;1140;553;553;19;534;48.51;3.44
100300;181707;Szkoła Podstawowa w Porażu|Poraż| 45 |38-540 Zagórz;1076;462;462;26;436;42.94;5.63
100301;181707;Dom Strażaka w Mokrem|Mokre| 116 |38-542 Rzepedź;557;192;192;12;180;34.47;6.25
100302;181707;Szkoła Podstawowa w Zahutyniu|Zahutyń| 111 |38-500 Sanok;948;444;444;18;426;46.84;4.05
100303;181708;Dom Kultury w Zarszynie|Zarszyn|ul. Szkolna 1 |38-530 Zarszyn;1562;657;657;22;635;42.06;3.35
100304;181708;Dom Ludowy w Jaćmierzu|Jaćmierz| 134 |38-530 Zarszyn;1066;461;461;24;437;43.25;5.21
100305;181708;Szkoła Podstawowa w Bażanówce|Bażanówka| 102 |38-530 Zarszyn;633;316;316;8;308;49.92;2.53
100306;181708;Dom Strażaka w Długiem|Długie| 464 |38-530 Zarszyn;1305;637;637;25;612;48.81;3.92
100307;181708;Dom Ludowy w Nowosielcach|Nowosielce| 292 |38-530 Zarszyn;1071;518;518;14;504;48.37;2.70
100308;181708;Szkoła Podstawowa w Pielni|Pielnia| 55 |38-530 Zarszyn;734;302;302;8;294;41.14;2.65
100309;181708;Szkoła Podstawowa w Odrzechowej|Odrzechowa|ul. Szkolna 1 |38-530 Zarszyn;1101;377;377;13;364;34.24;3.45
100310;181801;Ochotnicza Straż Pożarna|Stalowa Wola|ul. Targowa 3 |37-464 Stalowa Wola;1510;822;822;7;815;54.44;0.85
100311;181801;Ochotnicza Straż Pożarna|Stalowa Wola|ul. Jaśminowa 4 |37-464 Stalowa Wola;1816;988;988;23;965;54.41;2.33
100312;181801;Zespół Szkół Nr 4|Stalowa Wola|ul. Rozwadowska 10 |37-464 Stalowa Wola;1853;921;921;18;903;49.70;1.95
100313;181801;Przedszkole Nr 15|Stalowa Wola|ul. Obrońców Westerplatte 1 |37-450 Stalowa Wola;1200;628;628;8;620;52.33;1.27
100314;181801;Publiczna Szkoła Podstawowa Nr 11|Stalowa Wola|ul. Wojska Polskiego 9 |37-450 Stalowa Wola;1233;615;615;5;610;49.88;0.81
100315;181801;Komenda Powiatowa Straży Pożarnej|Stalowa Wola|Aleje Jana Pawła II 27 |37-450 Stalowa Wola;1188;573;573;10;563;48.23;1.75
100316;181801;Mostostal S.A.|Stalowa Wola|Aleje Jana Pawła II 25a |37-450 Stalowa Wola;1143;549;549;13;536;48.03;2.37
100317;181801;Przedszkole Nr 3|Stalowa Wola|ul. Józefa Poniatowskiego 57 |37-450 Stalowa Wola;1348;707;707;19;688;52.45;2.69
100318;181801;Zespół Szkół Nr 3 Publiczna Szkoła Podstawowa Nr 12|Stalowa Wola|ul. Józefa Poniatowskiego 55 |37-450 Stalowa Wola;1486;787;787;8;779;52.96;1.02
100319;181801;Hotel STAL|Stalowa Wola|ul. Komisji Edukacji Narodowej 4 |37-450 Stalowa Wola;1293;725;725;17;708;56.07;2.34
100320;181801;Zespół Szkół Nr 3 Gimnazjum Nr 5|Stalowa Wola|ul. Józefa Poniatowskiego 55 |37-450 Stalowa Wola;1182;581;581;8;573;49.15;1.38
100321;181801;Przedszkole Nr 18|Stalowa Wola|ul. Józefa Poniatowskiego 33 |37-450 Stalowa Wola;1362;762;762;14;748;55.95;1.84
100322;181801;budynek przyległy do Przedszkola Nr 18|Stalowa Wola|ul. Józefa Poniatowskiego 33A |37-450 Stalowa Wola;1590;805;805;24;781;50.63;2.98
100323;181801;Yacht Klub|Stalowa Wola|ul. Wałowa 1 |37-450 Stalowa Wola;1335;657;657;12;645;49.21;1.83
100324;181801;Niepubliczny Zakład Opieki Zdrowotnej "MEDYK" Sp. z o.o.|Stalowa Wola|ul. Józefa Poniatowskiego 31 |37-450 Stalowa Wola;1323;736;736;12;724;55.63;1.63
100325;181801;Warsztat Terapii Zajęciowej przy Stowarzyszeniu "Szansa"|Stalowa Wola|ul. Czarnieckiego 1 |37-450 Stalowa Wola;1322;641;641;10;631;48.49;1.56
100326;181801;NZOZ Ośrodek Rehabilitacji Dzieci Niepełnosprawnych|Stalowa Wola|ul. Czarnieckiego 3 |37-450 Stalowa Wola;1256;605;605;13;592;48.17;2.15
100327;181801;Przedszkole Nr 11|Stalowa Wola|Aleje Jana Pawła II 6 |37-450 Stalowa Wola;1490;792;792;13;779;53.15;1.64
100328;181801;Miejska Biblioteka Publiczna im. M. Wańkowicza|Stalowa Wola|ul. Ks. Jerzego Popiełuszki 10 |37-450 Stalowa Wola;1204;626;626;8;618;51.99;1.28
100329;181801;Zespół Szkół Nr 6 Specjalnych w Stalowej Woli|Stalowa Wola|Aleje Jana Pawła II 21 |37-450 Stalowa Wola;1228;625;625;12;613;50.90;1.92
100330;181801;Spółdzielnia Mieszkaniowa|Stalowa Wola|ul. Generała Leopolda Okulickiego 32 |37-450 Stalowa Wola;1704;896;896;16;880;52.58;1.79
100331;181801;Przedszkole Integracyjne Nr 12|Stalowa Wola|ul. Generała Leopolda Okulickiego 20 |37-450 Stalowa wola;1124;598;598;12;586;53.20;2.01
100332;181801;Publiczna Szkoła Podstawowa Nr 7|Stalowa Wola|ul. Generała Leopolda Okulickiego 14 |37-450 Stalowa Wola;1157;579;579;10;569;50.04;1.73
100333;181801;Klub Spółdzielni Mieszkaniowej EMKA|Stalowa Wola|ul. Żwirki i Wigury 6 |37-450 Stalowa Wola;1993;1039;1039;23;1016;52.13;2.21
100334;181801;Przedszkole Nr 6|Stalowa Wola|ul. Partyzantów 10 |37-450 Stalowa Wola;1020;538;538;14;524;52.75;2.60
100335;181801;Publiczna Szkoła Podstawowa Nr 3|Stalowa Wola|ul. Prymasa Stefana Wyszyńskiego 14 |37-450 Stalowa Wola;1278;656;656;12;644;51.33;1.83
100336;181801;Szkoła Muzyczna|Stalowa Wola|ul. Narutowicza 11 |37-450 Stalowa Wola;1591;844;844;25;819;53.05;2.96
100337;181801;Liceum Ogólnokształcące im. KEN|Stalowa Wola|ul. Staszica 5 |37-450 Stalowa Wola;1745;766;766;13;753;43.90;1.70
100338;181801;Publiczna Szkoła Podstawowa Nr 5|Stalowa Wola|ul. Energetyków 18 |37-450 Stalowa Wola;1266;574;574;8;566;45.34;1.39
100339;181801;Środowiskowy Dom Samopomocy Nr 2 dla osób z zaburzeniami psychicznymi|Stalowa Wola|ul. Melchiora Wańkowicza 72/ 2|37-450 Stalowa Wola;1689;969;969;8;961;57.37;0.83
100340;181801;Publiczna Szkoła Podstawowa Nr 1|Stalowa Wola|ul. Romana Dmowskiego 9 |37-450 Stalowa Wola;1517;681;681;24;657;44.89;3.52
100341;181801;Przedszkole Nr 7|Stalowa Wola|ul. Ks. Jerzego Popiełuszki 29a |37-450 Stalowa Wola;2050;921;921;27;894;44.93;2.93
100342;181801;Bursa Międzyszkolna|Stalowa Wola|Orzeszkowej 2 |37-450 Stalowa Wola;1242;651;651;14;637;52.42;2.15
100343;181801;Wydział Zamiejscowy Nauk o Społeczeństwie KUL w Stalowej Woli-Dziekanat|Stalowa Wola|ul. Ofiar Katynia 6 |37-450 Stalowa Wola;933;422;422;7;415;45.23;1.66
100344;181801;Publiczna Szkoła Podstawowa Nr 4|Stalowa Wola|ul. Niezłomnych 1 |37-450 Stalowa Wola;1920;988;988;25;963;51.46;2.53
100345;181801;SP ZZOZ Powiatowy Szpital Specjalistyczny|Stalowa Wola|Staszica 4 |37-450 Stalowa Wola;264;140;140;4;136;53.03;2.86
100346;181801;Dom Pomocy Społecznej|Stalowa Wola|Romana Dmowskiego 2a |37-450 Stalowa Wola;80;27;27;4;23;33.75;14.81
100347;181801;Zakład Pielęgnacyjno-Opiekuńczy SPZOZ i Wojewódzki Ośrodek Terapii Uzależnienia od Alkoholu i Współuzależnienia|Stalowa Wola|Dąbrowskiego 5 |37-450 Stalowa Wola;100;26;26;0;26;26.00;0.00
100348;181802;Dom Kultury w Bojanowie|Bojanów|ul. Strażacka 1 |37-433 Bojanów;657;313;313;9;304;47.64;2.88
100349;181802;Przedszkole w Bojanowie|Bojanów|ul. Kolbuszowska 11 |37-433 Bojanów;485;249;249;3;246;51.34;1.20
100350;181802;Remiza OSP Laski|Laski| 38 |37-433 Bojanów;271;142;142;4;138;52.40;2.82
100351;181802;Świetlica Wiejska w Korabinie|Korabina| 40a |37-433 Bojanów;291;119;119;5;114;40.89;4.20
100352;181802;Świetlica Wiejska w Cisowym Lesie|Cisów-Las| 31 |37-433 Bojanów;193;107;107;1;106;55.44;0.93
100353;181802;Dom Kultury w Gwoźdźcu|Gwoździec| 147 |37-433 Bojanów;497;215;215;5;210;43.26;2.33
100354;181802;Remiza OSP Stany|Stany|ul. Strażacka 1 |37-433 Bojanów;1272;568;568;19;549;44.65;3.35
100355;181802;Dom Kultury w Maziarni|Maziarnia| 126 |37-433 Bojanów;525;277;277;12;265;52.76;4.33
100356;181802;Dom Kultury w Przyszowie Zapuściu|Przyszów, Zapuście| 23 |37-433 Bojanów;1097;487;487;21;466;44.39;4.31
100357;181802;Świetlica Wiejska w Przyszowie Rudzie|Przyszów, Ruda| 38 |37-433 Bojanów;365;203;203;3;200;55.62;1.48
100358;181802;Remiza OSP Przyszów Burdze|Przyszów, Burdze| 25 |37-433 Bojanów;265;129;129;10;119;48.68;7.75
100359;181803;Dom Kultury w Pysznicy|Pysznica|ul. Wolności 277 |37-403 Pysznica;1887;936;936;21;915;49.60;2.24
100360;181803;Dom Ludowy w Jastkowicach|Jastkowice|ul. Armii Krajowej 18 |37-403 Pysznica;2351;1039;1039;17;1022;44.19;1.64
100361;181803;Budynek byłej szkoły w Brandwicy|Brandwica|ul. Jana Kochanowskiego 50 |37-464 Stalowa Wola;604;280;280;2;278;46.36;0.71
100362;181803;Dom Strażaka w Kłyżowie|Kłyżów|ul. Mickiewicza 46 |37-403 Pysznica;994;500;500;21;479;50.30;4.20
100363;181803;Szkoła Podstawowa im. Orła Białego w Krzakach|Krzaki|ul. Nowa 15 |37-403 Pysznica;884;326;326;19;307;36.88;5.83
100364;181803;Budynek byłej szkoły w Studzieńcu|Studzieniec| 6 |37-403 Pysznica;271;112;112;6;106;41.33;5.36
100365;181803;Budynek byłej Szkoły|Pysznica|ul. Sanowa 40 |37-403 Pysznica;316;130;130;3;127;41.14;2.31
100366;181803;Zespół Szkół w Pysznicy|Pysznica|ul. Sportowa 1 |37-403 Pysznica;1081;515;515;14;501;47.64;2.72
100367;181804;Urząd Gminy|Radomyśl nad Sanem|ul. Rynek Duży 7 |37-455 Radomyśl nad Sanem;1403;590;590;27;563;42.05;4.58
100368;181804;Zespół Szkół|Antoniów| 33 |37-455 Radomyśl nad Sanem;1125;484;484;25;459;43.02;5.17
100369;181804;Wiejski Dom Kultury|Chwałowice| 132 |37-455 Radomyśl nad Sanem;1137;454;454;28;426;39.93;6.17
100370;181804;Publiczna Szkoła Podstawowa|Wola Rzeczycka| 254 |37-455 Radomyśl nad Sanem,;1214;545;545;18;527;44.89;3.30
100371;181804;Zespół Szkół|Rzeczyca Długa| 176 |37-455 Radomyśl nad Sanem;1070;399;399;15;384;37.29;3.76
100372;181805;Gminny Ośrodek Kultury w Zaklikowie|Zaklików|ul. Strażacka 4 |37-470 Zaklików;1461;658;658;20;638;45.04;3.04
100373;181805;Urząd Miejski w Zaklikowie|Zaklików|ul. Zachodnia 15 |37-470 Zaklików;972;419;419;33;386;43.11;7.88
100374;181805;Remiza Ochotniczej Straży Pożarnej w Starych Barakach|Stare Baraki| 59 |37-470 Zaklików;214;64;64;4;60;29.91;6.25
100375;181805;Zespół Szkół w Zdziechowicach Drugich|Zdziechowice Drugie| 212 |37-470 Zaklików;1336;600;600;18;582;44.91;3.00
100376;181805;Szkoła Podstawowa w Łysakowie|Łysaków| 1 |37-470 Zaklików;299;108;108;7;101;36.12;6.48
100377;181805;Budynek Prywatny w Antoniówce|Antoniówka| 5 |37-470 Zaklików;367;152;152;2;150;41.42;1.32
100378;181805;Zespół Szkół w Lipie|Lipa|ul. Szkolna 5 |37-470 Zaklików;1173;483;483;16;467;41.18;3.31
100379;181805;Zespół Szkół w Lipie|Lipa|ul. Szkolna 5 |37-470 Zaklików;993;448;448;15;433;45.12;3.35
100380;181805;Dom Sołecki w Irenie|Irena| 85 |37-470 Zaklików;190;58;58;0;58;30.53;0.00
100381;181805;Dom Pomocy Społecznej dla Dorosłych w Irenie|Irena| 72 |37-470 Zaklików;61;57;57;0;57;93.44;0.00
100382;181806;Publiczna Szkoła Podstawowa im.Por.J.Mączki w Zaleszanach|Zaleszany|Sandomierska 95 |37-415 Zaleszany;1036;488;488;26;462;47.10;5.33
100383;181806;Publiczna Szkoła Podstawowa im.Rodziny Horodyńskich w Zbydniowie|Zbydniów|Sandomierska 210 |37-415 Zaleszany;1039;499;499;18;481;48.03;3.61
100384;181806;Publiczna Szkoła Podstawowa w Turbi|Turbia| 37 |37-415 Zaleszany;1206;535;535;28;507;44.36;5.23
100385;181806;Domu Ludowy w Kępiu Zaleszańskim|Kępie Zaleszańskie| 1 |37-415 Zaleszany;1052;485;485;26;459;46.10;5.36
100386;181806;Dom Ludowy w Skowierzynie|Skowierzyn| 127 |37-415 Zaleszany;698;282;282;16;266;40.40;5.67
100387;181806;Publiczna Szkoła Podstawowa w Kotowej Woli|Kotowa Wola| 1 |37-415 Zaleszany;764;330;330;22;308;43.19;6.67
100388;181806;Publiczna Szkoła Podstawowa im.II Armii Wojska Polskiego w Majdanie Zbydniowskim i Wólce Turebskiej|Majdan Zbydniowski| 1 |37-415 Zaleszany;684;300;300;21;279;43.86;7.00
100389;181806;Publiczna Szkoła Podstawowa w Pilchowie|Pilchów| 241 |37-464 Stalowa Wola;908;443;443;14;429;48.79;3.16
100390;181806;Remiza OSP w Obojnej|Obojna| 13 |37-415 Zaleszany;505;223;223;9;214;44.16;4.04
100391;181806;Dom Ludowy w Dzierdziówce|Dzierdziówka| 161 |37-415 Zaleszany;489;193;193;11;182;39.47;5.70
100392;181806;Remiza OSP w Agatówce|Agatówka|Kalinowa 5 |37-464 Stalowa Wola;342;219;219;8;211;64.04;3.65
100393;181901;Urząd Gminy w Czudcu - Sala Widowiskowa|Czudec|ul. Starowiejska 6 |38-120 Czudec;2437;1496;1496;27;1469;61.39;1.80
100394;181901;Gminna Biblioteka Publiczna w Czudcu|Czudec|ul. Słoneczna 2 |38-120 Czudec;1514;775;775;20;755;51.19;2.58
100395;181901;Dom Ludowy w Babicy|Babica| 97 |38-120 Czudec;1001;558;558;4;554;55.74;0.72
100396;181901;Zespół Szkół w Wyżnem|Wyżne| 39 |38-120 Czudec;1160;555;555;13;542;47.84;2.34
100397;181901;Szkoła Podstawowa w Zaborowie|Zaborów| 99 |38-100 Strzyżów;852;466;466;6;460;54.69;1.29
100398;181901;Szkoła Podstawowa w Nowej Wsi|Nowa Wieś| 152 |38-120 Czudec;684;399;399;10;389;58.33;2.51
100399;181901;Zespół Szkół w Pstrągowej|Pstrągowa| 105 |38-121 Pstrągowa;1528;752;752;25;727;49.21;3.32
100400;181901;Dom Pomocy Społecznej - Filia w Pstrągowej Woli|Pstrągowa| 616 |38-121 Pstrągowa;200;90;90;2;88;45.00;2.22
100401;181902;Urząd Gminy we Frysztaku|Frysztak|ul. Ks. Wojciecha Blajera 20 |38-130 Frysztak;931;488;488;7;481;52.42;1.43
100402;181902;Szkoła Podstawowa im. J. Wybickiego Nr 1 we Frysztaku|Frysztak|ul. Piętniewicza 7 |38-130 Frysztak;1208;556;556;26;530;46.03;4.68
100403;181902;Szkoła Podstawowa w Gliniku Górnym|Glinik Górny| 47 |38-131 Gogołów;695;303;303;6;297;43.60;1.98
100404;181902;Zespół Szkół w Gogołowie|Gogołów| 316 |38-131 Gogołów;921;407;407;19;388;44.19;4.67
100405;181902;Budynek Wiejski w Hucie Gogołowskiej|Huta Gogołowska| 69 |38-131 Gogołów;191;111;111;7;104;58.12;6.31
100406;181902;Zespół Szkół w Stępinie|Stępina| 54 |38-125 Stępina;656;248;248;8;240;37.80;3.23
100407;181902;Szkoła Podstawowa w Cieszynie|Cieszyna| 76 |38-125 Stępina;851;351;351;7;344;41.25;1.99
100408;181902;Budynek Wiejski w Pułankach|Pułanki| 34 |38-130 Frysztak;648;327;327;10;317;50.46;3.06
100409;181902;Budynek Wiejski w Kobylu|Kobyle| 1 |38-130 Frysztak;476;234;234;6;228;49.16;2.56
100410;181902;Gminny Ośrodek Kultury we Frysztaku|Twierdza| 1 |38-130 Frysztak;696;332;332;6;326;47.70;1.81
100411;181902;Zespół Szkół w Lubli|Lubla| 328 |38-130 Frysztak;1164;558;558;36;522;47.94;6.45
100412;181903;Urząd Stanu Cywilnego Niebylec|Niebylec| 183 |38-114 Niebylec;471;276;276;2;274;58.60;0.72
100413;181903;Szkoła Podstawowa im. Krzysztofa Kamila Baczyńskiego w Bliziance|Blizianka| 72 |38-114 Niebylec;325;173;173;8;165;53.23;4.62
100414;181903;Dom Wiejski w Gwoździance|Gwoździanka| 32 |38-114 Niebylec;260;121;121;0;121;46.54;0.00
100415;181903;Zespół Szkół im. Jana Pawła II w Konieczkowej|Konieczkowa| 58 |38-114 Niebylec;1002;572;572;17;555;57.09;2.97
100416;181903;Dom Strażaka w Gwoźnicy Dolnej|Gwoźnica Dolna| 91 |38-116 Gwoźnica Górna;358;190;190;5;185;53.07;2.63
100417;181903;Zespół Szkół im. Juliana Przybosia w Gwoźnicy Górnej|Gwoźnica Górna| 292 |38-116 Gwoźnica Górna;1098;567;567;17;550;51.64;3.00
100418;181903;Zespół Szkół im. Św. Rodziny w Lutczy|Lutcza| 614 |38-112 Lutcza;1795;862;862;25;837;48.02;2.90
100419;181903;Szkoła Podstawowa im. św. Józefa Sebastiana Pelczara w Jaworniku|Jawornik| 108 |38-114 Niebylec;943;506;506;10;496;53.66;1.98
100420;181903;Zespół Szkół im. ks. kard. Stefana Wyszyńskiego w Połomi|Połomia| 125 |38-115 Połomia;1252;655;655;19;636;52.32;2.90
100421;181903;Szkoła Podstawowa im. bł. ks. Bronisława Markiewicza w Baryczce|Baryczka| 213 |38-115 Połomia;793;478;478;9;469;60.28;1.88
100422;181903;Zespół Szkół im. ks. Jana Twardowskiego w Niebylcu|Niebylec| 11 |38-114 Niebylec;216;100;100;3;97;46.30;3.00
100423;181904;Szkoła Podstawowa Nr 1 w Strzyżowie|Strzyżów|ul. gen. Wł. Andersa 4 |38-100 Strzyżów;1582;750;750;18;732;47.41;2.40
100424;181904;Zespoł Szkół Technicznych w Strzyżowie|Strzyżów|ul. Mickiewicza 11 |38-100 Strzyżów;1863;925;925;14;911;49.65;1.51
100425;181904;Miejski Zespół Szkół w Strzyżowie|Strzyżów|ul. Daszyńskiego 4 |38-100 Strzyżów;1372;774;774;10;764;56.41;1.29
100426;181904;Miejsko - Gminne Przedszkole Publiczne w Strzyżowie|Strzyżów|Zawale 11 |38-100 Strzyżów;718;333;333;5;328;46.38;1.50
100427;181904;Dom Kultury "Sokół" w Strzyżowie|Strzyżów|ul. Mostowa 2 |38-100 Strzyżów;1584;742;742;15;727;46.84;2.02
100428;181904;Szkoła Podstawowa w Brzeżance|Brzeżanka| 50 |38-100 Strzyżów;257;110;110;2;108;42.80;1.82
100429;181904;Remiza OSP w Gbiskach|Gbiska| 25 |38-100 Strzyżów;239;72;72;1;71;30.13;1.39
100430;181904;Budynek OSP w Tropii|Tropie| 237 |38-100 Strzyżów;329;131;131;6;125;39.82;4.58
100431;181904;Budynek Wiejski w Łętowni|Łętownia| 34 |38-100 Strzyżów;134;72;72;4;68;53.73;5.56
100432;181904;Szkoła Podstawowa w Gliniku Zaborowskim|Glinik Zaborowski| 92 |38-100 Strzyżów;476;229;229;5;224;48.11;2.18
100433;181904;Szkoła Podstawowa w Gliniku Charzewskim|Glinik Charzewski| 91 |38-100 Strzyżów;671;309;309;4;305;46.05;1.29
100434;181904;Zespół Szkół w Żarnowej|Żarnowa| 90 |38-100 Strzyżów;700;332;332;10;322;47.43;3.01
100435;181904;Zespół Szkół w Godowej|Godowa| 261 |38-100 Strzyżów;1789;808;808;28;780;45.16;3.47
100436;181904;Zespół Szkół w Żyznowie|Żyznów| 124 |38-111 Żyznów;716;349;349;11;338;48.74;3.15
100437;181904;Budynek OSP w Bonarówce|Bonarówka| 10 |38-111 Żyznów;121;56;56;2;54;46.28;3.57
100438;181904;Szkoła Podstawowa Nr 1 w Wysokiej Strzyżowskiej|Wysoka Strzyżowska| 312 |38-123 Wysoka Strzyżowska;779;274;274;6;268;35.17;2.19
100439;181904;Zespół Szkół w Wysokiej Strzyżowskiej|Wysoka Strzyżowska| 127 |38-123 Wysoka Strzyżowska;883;367;367;6;361;41.56;1.63
100440;181904;Zespół Szkół w Dobrzechowie|Dobrzechów| 197 |38-100 Strzyżów;1385;713;713;15;698;51.48;2.10
100441;181904;Zespół Szkół w Grodzisku|Grodzisko| 30 |38-102 Grodzisko;837;346;346;4;342;41.34;1.16
100442;181904;Budynek b. Szkoły Podstawowej w Zawadce|Zawadka| 21 |38-102 Grodzisko;274;135;135;1;134;49.27;0.74
100443;181904;Szpital Powiatowy w Strzyżowie|Strzyżów|700-Lecia Strzyżowa 1 |38-100 Strzyżów;87;27;27;1;26;31.03;3.70
100444;181905;Ośrodek Kultury w Wiśniowej|Wiśniowa| 136 |38-124 Wiśniowa;1325;709;709;12;697;53.51;1.69
100445;181905;Szkoła Podstawowa w Różance|Różanka| 43 |38-102 Grodzisko;781;383;383;11;372;49.04;2.87
100446;181905;Szkoła Podstawowa w Niewodnej|Niewodna| 26 |38-124 Wiśniowa;464;242;242;4;238;52.16;1.65
100447;181905;Szkoła Podstawowa w Tułkowicach|Tułkowice| 32 |38-124 Wiśniowa;338;178;178;7;171;52.66;3.93
100448;181905;Dom Ludowy w Kalembinie|Kalembina| 52 |38-124 Wiśniowa;335;145;145;0;145;43.28;0.00
100449;181905;Szkoła Podstawowa w Markuszowej|Markuszowa| 16 |38-126 Markuszowa;645;253;253;5;248;39.22;1.98
100450;181905;Szkoła Podstawowa w Pstrągówce|Pstrągówka| 128 |38-124 Wiśniowa;464;196;196;2;194;42.24;1.02
100451;181905;Szkoła Podstawowa w Jaszczurowej|Jaszczurowa| 31 |38-124 Wiśniowa;234;97;97;1;96;41.45;1.03
100452;181905;Szkoła Podstawowa w Szufnarowej|Szufnarowa| 101 |38-124 Wiśniowa;953;441;441;14;427;46.27;3.17
100453;181905;Dom Strażaka w Kożuchowie|Kożuchów| 68 |38-124 Wiśniowa;279;157;157;2;155;56.27;1.27
100454;181905;Szkoła Podstawowa w Kozłówku|Kozłówek| 39 |38-126 Markuszowa;364;153;153;4;149;42.03;2.61
100455;181905;Budynek byłej Szkoły Podstawowej w Oparówce|Oparówka| 50 |38-123 Wysoka Strzyżowska;202;56;56;0;56;27.72;0.00
100456;181905;Szkoła Podstawowa w Jazowej|Jazowa| 66 |38-124 Wiśniowa;274;134;134;2;132;48.91;1.49
100457;182001;Miejsko-Gminny Ośrodek Kultury w Baranowie Sandomierskim|Baranów Sandomierski|ul. Fabryczna 37 |39-450 Baranów Sandomierski;1242;641;641;15;626;51.61;2.34
100458;182001;Środowiskowy Dom Kultury w Skopaniu|Skopanie|ul.Kardynała Wyszyńskiego 7 |39-451 Skopanie;2153;1081;1081;20;1061;50.21;1.85
100459;182001;Dom Wiejski w Suchorzowie|Suchorzów|ul.Wspólna 40 |39-450 Baranów Sandomierski;704;339;339;6;333;48.15;1.77
100460;182001;Remiza OSP w Dąbrowicy|Dąbrowica| 185 |39-450 Baranów Sandomierski;985;492;492;11;481;49.95;2.24
100461;182001;Dom Ludowy w Ślęzakach|Ślęzaki| 60 |39-450 Baranów Sandomierski;561;289;289;9;280;51.52;3.11
100462;182001;Dom Ludowy w Knapach|Knapy| 59a |39-451 Skopanie;475;222;222;11;211;46.74;4.95
100463;182001;Dom Ludowy w Woli Baranowskiej|Wola Baranowska|ul. Zachodnia 2 |39-451 Skopanie;1765;893;893;34;859;50.59;3.81
100464;182001;Dom Wiejski w Durdach|Durdy| 1A |39-451 Skopanie;570;258;258;11;247;45.26;4.26
100465;182001;Dom Ludowy w Dymitrowie Dużym|Dymitrów Duży| 99 |39-450 Baranów Sandomierski;303;143;143;10;133;47.19;6.99
100466;182001;Remiza OSP w Dymitrowie Małym|Dymitrów Mały| 75 |39-450 Baranów Sandomierski;245;111;111;4;107;45.31;3.60
100467;182001;Ośrodek Kultury i Sportu w Markach|Marki|ul.Leśna 32 |39-450 Baranów Sandomierski;265;134;134;2;132;50.57;1.49
100468;182001;Remiza OSP w Kaczakach|Kaczaki| 296 |39-450 Baranów Sandomierski;496;203;203;8;195;40.93;3.94
100469;182002;Zespół Szkół w Gorzycach|Gorzyce|ul.Edukacji Narodowej 3 |39-432 Gorzyce;1631;761;761;26;735;46.66;3.42
100470;182002;Środowiskowy Dom Kultury w Gorzycach|Gorzyce|Plac Erazma Mieszczańskiego 10 |39-432 Gorzyce;1280;584;584;21;563;45.62;3.60
100471;182002;Budynek administracyjno-biurowy|Gorzyce|ul.3 Maja 4 |39-432 Gorzyce;1434;635;635;15;620;44.28;2.36
100472;182002;Świetlica Wiejska|Gorzyce|ul. Pańska 1 |39-432 Gorzyce;1174;568;568;24;544;48.38;4.23
100473;182002;Dom Ludowy w Motyczu Poduchownym|Motycze Poduchowne| 88 |39-432 Gorzyce;254;112;112;2;110;44.09;1.79
100474;182002;Świetlica w Zalesiu Gorzyckim|Zalesie Gorzyckie| 74 |39-432 Gorzyce;160;90;90;1;89;56.25;1.11
100475;182002;Dom Kultury we Wrzawach|Wrzawy| 486 |39-432 Gorzyce;1263;515;515;24;491;40.78;4.66
100476;182002;Remiza OSP w Trześni|Trześń|ul.Błonie 4 |39-432 Gorzyce;1244;571;571;17;554;45.90;2.98
100477;182002;Dom Kultury w Sokolnikach|Sokolniki|ul.Sandomierska 84 |39-432 Gorzyce;1513;610;610;15;595;40.32;2.46
100478;182002;Remiza OSP w Orliskach|Orliska| 65 |39-432 Gorzyce;189;89;89;2;87;47.09;2.25
100479;182002;Szkoła Podstawowa w Furmanach|Furmany|ul.Kościelna 2 |39-400 Tarnobrzeg;585;279;279;10;269;47.69;3.58
100480;182003;Zespół Szkół Ogólnokształcących w Grębowie|Grębów| 393 |39-410 Grębów;2022;1019;1019;44;975;50.40;4.32
100481;182003;Filia Szkoły Podstawowej w Zapoledniku|Grębów, Zapolednik| 754A |39-410 Grębów;389;171;171;7;164;43.96;4.09
100482;182003;Filia Szkoły Podstawowej w Jamnicy|Jamnica| 135 |39-410 Grębów;563;316;316;16;300;56.13;5.06
100483;182003;Publiczna Szkoła Podstawowa w Zabrniu|Zabrnie Górne| 582 |39-410 Grębów;1056;395;395;22;373;37.41;5.57
100484;182003;Zespół Szkół w Stalach|Stale| 1 |39-400 Tarnobrzeg;1577;707;707;20;687;44.83;2.83
100485;182003;Publiczna Szkoła Podstawowa w Żupawie|Żupawa| 41 |39-400 Tarnobrzeg;706;305;305;16;289;43.20;5.25
100486;182003;Publiczna Szkoła Podstawowa w Krawcach|Krawce| 167 |39-410 Grębów;625;271;271;10;261;43.36;3.69
100487;182003;Zespół Szkoła Podstawowa i Przedszkole w Wydrzy|Wydrza| 383 |39-410 Grębów;1014;405;405;28;377;39.94;6.91
100488;182004;Szkoła Podstawowa Nr 2|Nowa Dęba|Leśna 40 |39-460 Nowa Dęba;1111;469;469;11;458;42.21;2.35
100489;182004;Miejsko-Gminny Ośrodek Pomocy Społecznej|Nowa Dęba|Mikołaja Reja 3 |39-460 Nowa Dęba;1085;468;468;13;455;43.13;2.78
100490;182004;Samorządowy Ośrodek Kultury|Nowa Dęba|Stefana Żeromskiego 2 |39-460 Nowa Dęba;2073;997;997;24;973;48.09;2.41
100491;182004;Zespół Szkół Nr 1|Nowa Dęba|Mikołaja Reja 7 |39-460 Nowa Dęba;1877;857;857;26;831;45.66;3.03
100492;182004;Zespół Placówek Oświatowych|Nowa Dęba|Bronisława Zybury 4 |39-460 Nowa Dęba;1505;748;748;19;729;49.70;2.54
100493;182004;Remiza Ochotniczej Straży Pożarnej|Nowa Dęba|Strażacka 3 |39-460 Nowa Dęba;1498;683;683;14;669;45.59;2.05
100494;182004;Publiczna Szkoła Podstawowa|Alfredówka| 192 |39-460 Nowa Dęba;622;306;306;10;296;49.20;3.27
100495;182004;Zespół Szkół|Chmielów| 657 |39-442 Chmielów;1659;761;761;39;722;45.87;5.12
100496;182004;Szkoła Podstawowa|Cygany| 70 |39-442 Chmielów;886;415;415;22;393;46.84;5.30
100497;182004;Zespół Szkół|Jadachy| 1 |39-442 Chmielów;1255;587;587;16;571;46.77;2.73
100498;182004;Szkoła Podstawowa|Rozalin| 194 |39-460 Nowa Dęba;549;260;260;3;257;47.36;1.15
100499;182004;Wiejskie Centrum Aktywności|Tarnowska Wola| 240 |39-460 Nowa Dęba;694;345;345;10;335;49.71;2.90
100500;182004;Dom Pomocy Społecznej|Nowa Dęba|Jana Pawła II 7 |39-460 Nowa Dęba;45;33;33;2;31;73.33;6.06
100501;182004;Samodzielny Publiczny Zespół Zakładów Opieki Zdrowotnej|Nowa Dęba|Marii Curie-Skłodowskiej 1A |39-460 Nowa Dęba;118;23;23;1;22;19.49;4.35
100502;182004;Samodzielny Publiczny Zespół Zakładów Opieki Zdrowotnej|Nowa Dęba|Tadeusza Kościuszki 1C |39-460 Nowa Dęba;33;20;20;1;19;60.61;5.00
100503;182004;Samodzielny Publiczny Zespół Zakładów Opieki Zdrowotnej|Nowa Dęba|Rzeszowska 8 |39-460 Nowa Dęba;14;14;14;0;14;100.00;0.00
100504;182004;Oddział Zewnętrzny w Chmielowie Aresztu Śledczego w Nisku|Chmielów| |39-442 Chmielów;168;69;69;12;57;41.07;17.39
100505;182101;Gminny Ośrodek Kultury|Baligród|ul Plac Wolności 11 |38-606 Baligród;1484;656;656;23;633;44.20;3.51
100506;182101;Świetlica|Mchawa| 49 |38-606 Baligród;601;252;252;13;239;41.93;5.16
100507;182101;budynek komunalny|Nowosiółki| 3 |38-604 Hoczew;577;229;229;8;221;39.69;3.49
100508;182101;Jabłonki OZ|Jabłonki| |38-606 Baligród;68;68;68;13;55;100.00;19.12
100509;182102;Urząd Gminy|Cisna| 49 |38-607 Cisna;908;442;442;20;422;48.68;4.52
100510;182102;Szkolne Schronisko Młodzieżowe|Wetlina| 16 |38-608 Wetlina;655;373;373;16;357;56.95;4.29
100511;182103;Szkoła Podstawowa|Lesko|ul. Smolki 2 |38-600 Lesko;1128;583;583;16;567;51.68;2.74
100512;182103;Przedszkole Samorządowe|Lesko|ul. Zygmunta Kaczkowskiego 26 |38-600 Lesko;1268;619;619;22;597;48.82;3.55
100513;182103;Bieszczadzki Dom Kultury|Lesko|ul. Piłsudskiego 1 |38-600 Lesko;1230;559;559;16;543;45.45;2.86
100514;182103;Publiczne Gimnazjum|Lesko|ul. Kościuszki 7 |38-600 Lesko;1044;490;490;11;479;46.93;2.24
100515;182103;Remiza OSP|Jankowce| 109B |38-600 Lesko;739;371;371;22;349;50.20;5.93
100516;182103;Świetlica Wiejska|Huzele| 110 |38-600 Lesko;690;305;305;13;292;44.20;4.26
100517;182103;Szkoła Podstawowa|Bezmiechowa Dolna| 215 |38-600 Lesko;600;279;279;8;271;46.50;2.87
100518;182103;Zespół Szkół Samorządowych|Hoczew| 157 |38-604 Hoczew;755;292;292;11;281;38.68;3.77
100519;182103;Szkoła Podstawowa|Manasterzec| 18 |38-600 Lesko;744;269;270;18;251;36.16;6.69
100520;182103;Zespół Szkół Samorządowych|Średnia Wieś| 172 |38-604 Hoczew;1077;458;458;13;445;42.53;2.84
100521;182103;Szpital Powiatowy|Lesko|Kochanowskiego 2 |38-600 Lesko;60;16;16;1;15;26.67;6.25
100522;182104;Dom Ludowy|Olszanica| 85 |38-722 Olszanica;1293;539;539;9;530;41.69;1.67
100523;182104;Zespół Szkół Publicznych|Uherce Mineralne| 150 |38-623 Uherce Mineralne;1660;784;784;24;760;47.23;3.06
100524;182104;Świetlica Wiejska|Stefkowa| 52A |38-722 Olszanica;540;262;262;6;256;48.52;2.29
100525;182104;Świetlica Wiejska|Wańkowa| 66 |38-711 Ropienka;583;182;182;17;165;31.22;9.34
100526;182104;Zakład Karny|Uherce Mineralne| 153|38-623 Uherce mineralne;407;168;168;20;148;41.28;11.90
100527;182105;Zespół Szkół w Bóbrce|Bóbrka| 50 |38-623 Lesko;679;330;330;15;315;48.60;4.55
100528;182105;Szkoła Podstawowa w Zawozie|Zawóz| 65 |38-610 Polańczyk;315;109;109;5;104;34.60;4.59
100529;182105;Zespół Szkół w Wołkowyi|Wołkowyja|ul. Szkolna 7 |38-610 Polańczyk;754;378;378;19;359;50.13;5.03
100530;182105;Szkolne Schronisko Młodzieżowe w Myczkowie|Myczków| 29 |38-610 Polańczyk;461;204;204;9;195;44.25;4.41
100531;182105;Świetlica wiejska w Polańczyku|Polańczyk|ul. Bieszczadzka 18 |38-610 Polańczyk;995;638;638;14;624;64.12;2.19
100532;182105;Szkoła Podstawowa w Bukowcu|Bukowiec| 37 |38-610 Polańczyk;505;218;218;14;204;43.17;6.42
100533;182105;Szkoła Podstawowa w Berezce|Berezka| 18 |38-610 Polańczyk;700;289;289;11;278;41.29;3.81
100534;182105;Szkoła Podstawowa w Myczkowcach|Myczkowce| 89 |38-623 Lesko;422;203;203;9;194;48.10;4.43
100535;186101;Zespół Szkół Ponadgimnazjalnych Nr 5|Krosno, Turaszówka|ul. Rzeszowska 10 |38-400 Krosno;2346;1219;1219;13;1206;51.96;1.07
100536;186101;Miejski Zespół Szkół Nr 3|Krosno, Polanka|ul.Ks.S.Decowskiego 9 |38-400 Krosno;1793;873;876;13;860;48.69;1.49
100537;186101;Miejski Zespół Szkół Nr 3|Krosno, Polanka|ul. Ks. S.Decowskiego 9 |38-400 Krosno;1984;1080;1080;12;1068;54.44;1.11
100538;186101;Szkoła Podstawowa Nr 3|Krosno, Białobrzegi|ul. M. Konopnickiej 5 |38-400 Krosno;1140;650;650;5;645;57.02;0.77
100539;186101;Dzielnicowy Dom Ludowy|Krosno, Białobrzegi|ul. M. Kopernika 17 |38-400 Krosno;1375;744;744;5;739;54.11;0.67
100540;186101;Miejski Zespół Szkół Nr 1|Krosno, Białobrzegi|ul. J. i S. Magurów 1 |38-400 Krosno;1554;799;799;11;788;51.42;1.38
100541;186101;Regionalne Centrum Kultur Pogranicza|Krosno|ul.Kolejowa 1 |38-400 Krosno;2100;982;982;16;966;46.76;1.63
100542;186101;Miejski Zespół Szkół Nr 6|Krosno|ul. Kletówki 1 |38-400 Krosno;1276;630;630;3;627;49.37;0.48
100543;186101;Zespół Szkół Kształcenia Ustawicznego|Krosno|ul. F. Czajkowskiego 49 |38-400 Krosno;734;363;363;8;355;49.46;2.20
100544;186101;Miejski Zespół Szkół Nr 8|Krosno, Zawodzie|ul. Prochownia 7 |38-400 Krosno;1455;828;828;10;818;56.91;1.21
100545;186101;Miejski Zespół Szkół Nr 8|Krosno, Zawodzie|ul. Prochownia 7 |38-400 Krosno;1300;735;735;5;730;56.54;0.68
100546;186101;Państwowa Wyższa Szkoła Zawodowa|Krosno|ul. Kazimierza Wielkiego 4 |38-400 Krosno;467;272;272;2;270;58.24;0.74
100547;186101;Miejski Zespół Szkół Nr 5|Krosno|ul. Ks. P. Skargi 3 |38-400 Krosno;1586;857;857;22;835;54.04;2.57
100548;186101;Miejski Ośrodek Pomocy Rodzinie|Krosno, Guzikówka|ul. Piastowska 58 |38-400 Krosno;1806;958;958;8;950;53.05;0.84
100549;186101;Dzielnicowy Dom Ludowy PUCHATEK|Krosno, Krościenko Niżne|ul. F. Chopina 8 |38-400 Krosno;1509;777;777;5;772;51.49;0.64
100550;186101;Miejski Zespół Szkół Nr 4 (SP Nr 15)|Krosno, Guzikówka|ul. S. Kisielewskiego 18 |38-400 Krosno;1615;818;818;18;800;50.65;2.20
100551;186101;Miejski Zespół Szkół Nr 4 (SP Nr 15)|Krosno, Guzikówka|ul. S. Kisielewskiego 18 |38-400 Krosno;1112;646;646;7;639;58.09;1.08
100552;186101;Miejski Zespół Szkół Nr 4 (II LO)|Krosno, Guzikówka|ul. S. Kisielewskiego 18 |38-400 Krosno;1427;701;701;5;696;49.12;0.71
100553;186101;Niepubliczny Zakład Opieki Zdrowotnej ,,NASZE ZDROWIE"|Krosno, Guzikówka|ul. Podkarpacka 5a |38-400 Krosno;1241;641;641;7;634;51.65;1.09
100554;186101;Szkoła Podstawowa nr 5|Krosno, Suchodół|ul. Grunwaldzka 15 |38-400 Krosno;2358;1365;1365;19;1346;57.89;1.39
100555;186101;Miejski Zespół Szkół Nr 7|Krosno, Krościenko Niżne|ul. Powstańców Ślaskich 75 |38-400 Krosno;1655;917;917;9;908;55.41;0.98
100556;186101;Zespół Szkół Ponadgimnazjalnych nr 4|Krosno, Krościenko Niżne|ul. Bohaterów Westerplatte 20 |38-400 Krosno;1926;1048;1048;12;1036;54.41;1.15
100557;186101;Miejski Zespół Szkół z Oddziałami Integracyjnymi|Krosno, Krościenko Niżne|ul. Wojska Polskiego 45 |38-400 Krosno;1688;982;982;13;969;58.18;1.32
100558;186101;Miejski Zespół Szkół z Oddziałami Integracyjnymi|Krosno, Krościenko Niżne|ul. Wojska Polskiego 45 |38-400 Krosno;2022;1105;1105;11;1094;54.65;1.00
100559;186101;Dom Pomocy Społecznej Nr 1|Krosno|ul. F. Żwirki i S. Wigury 4a |38-400 Krosno;78;49;49;1;48;62.82;2.04
100560;186101;Dom Pomocy Społecznej Nr 2|Krosno|ul. Kletówki 7 |38-400 Krosno;22;9;9;1;8;40.91;11.11
100561;186101;Wojewódzki Szpital Podkarpacki|Krosno|ul. Korczyńska 57 |38-400 Krosno;274;110;110;3;107;40.15;2.73
100562;186101;Wojewódzki Szpital Podkarpacki|Krosno|ul. Grodzka 45 |38-400 Krosno;80;25;25;1;24;31.25;4.00
100563;186201;Sala Sportowa przy Towarzystwie Budownictwa Społecznego Sp. z o.o|Przemyśl|ul.Wysockiego 24 |37-700 Przemyśl;1158;611;611;6;605;52.76;0.98
100564;186201;Szkoła Podstawowa Nr 6 im. Ojca Świętego Jana Pawła II|Przemyśl|ul. gen. M. Boruty-Spiechowicza 1 |37-700 Przemyśl;1854;952;952;14;938;51.35;1.47
100565;186201;Szkoła Podstawowa Nr 6 im. Ojca Świętego Jana Pawła II|Przemyśl|ul. gen. M. Boruty-Spiechowicza 1 |37-700 Przemyśl;2088;1080;1080;27;1053;51.72;2.50
100566;186201;Gimnazjum Nr 1 im. Orląt Przemyskich|Przemyśl|ul. 3 Maja 38 |37-700 Przemyśl;2080;1039;1039;22;1017;49.95;2.12
100567;186201;Wojewódzki Szpital im. Św. Ojca Pio w Przemyślu - Poradnia Ortopedyczna|Przemyśl|ul. Monte Cassino 18 |37-700 Przemyśl;1025;541;541;9;532;52.78;1.66
100568;186201;Nadleśnictwo Krasiczyn z siedzibą w Przemyślu|Przemyśl|ul. 29 Listopada 12 |37-700 Przemyśl;1418;696;698;16;680;49.08;2.30
100569;186201;II Liceum Ogólnokształcące|Przemyśl|ul. bpa J. Glazera 44 |37-700 Przemyśl;879;470;470;2;468;53.47;0.43
100570;186201;II Liceum Ogólnokształcące|Przemyśl|ul. bpa J. Glazera 44 |37-700 Przemyśl;1997;1063;1063;12;1051;53.23;1.13
100571;186201;Szkoła Podstawowa nr 4|Przemyśl|ul. Św. Jana Nepomucena 10 |37-700 Przemyśl;2087;1101;1101;25;1076;52.76;2.27
100572;186201;Szkoła Podstawowa Nr 4|Przemyśl|ul. Św. Jana Nepomucena 10 |37-700 Przemyśl;2047;1009;1009;21;988;49.29;2.08
100573;186201;Szkoła Podstawowa Nr 14 im. Zjednoczonej Europy|Przemyśl|ul. Borelowskiego 12 |37-700 Przemyśl;1774;948;948;14;934;53.44;1.48
100574;186201;Klub Sportowy "Czuwaj"|Przemyśl|ul. 22 Stycznia 6 |37-700 Przemyśl;1708;901;901;16;885;52.75;1.78
100575;186201;Szkoła Podstawowa Nr 14 im. Zjednoczonej Europy|Przemyśl|ul. Borelowskiego 12 |37-700 Przemyśl;1866;955;955;15;940;51.18;1.57
100576;186201;Przedszkole Miejskie Nr 12|Przemyśl|ul. F. Dolińskiego 4 |37-700 Przemyśl;2259;1258;1258;28;1230;55.69;2.23
100577;186201;MPEC sp. z o.o. (świetlica)|Przemyśl|ul. Płowiecka 8 |37-700 Przemyśl;1782;937;937;13;924;52.58;1.39
100578;186201;Zespół Szkół z Oddziałami Integracyjnymi im. Orląt Lwowskich|Przemyśl|ul. Grunwaldzka 81 |37-700 Przemyśl;1692;927;927;10;917;54.79;1.08
100579;186201;Gimnazjum Nr 5 im. Świętego Jana Kantego|Przemyśl|ul. Grunwaldzka 17 |37-700 Przemyśl;1072;535;535;10;525;49.91;1.87
100580;186201;Specjalny Ośrodek Szkolno-Wychowawczy Nr 2|Przemyśl|ul. Czarnieckiego 27 |37-700 Przemyśl;2189;1001;1001;17;984;45.73;1.70
100581;186201;Szkoła Podstawowa Nr 15|Przemyśl|ul. W. Pola 5 |37-700 Przemyśl;1335;638;638;15;623;47.79;2.35
100582;186201;Szkoła Podstawowa Nr 1|Przemyśl|ul. Sienkiewicza 3 |37-700 Przemyśl;1992;900;900;14;886;45.18;1.56
100583;186201;Gimnazjum Nr 2|Przemyśl|ul. Ratuszowa 1 |37-700 Przemyśl;1167;465;465;12;453;39.85;2.58
100584;186201;Szkoła Podstawowa Nr 11|Przemyśl|ul. Władycze 5 |37-700 Przemyśl;1135;553;553;8;545;48.72;1.45
100585;186201;Przemyski Ośrodek Sportu i Rekreacji|Przemyśl|ul. Mickiewicza 30 |37-700 Przemyśl;2007;776;776;21;755;38.66;2.71
100586;186201;Szkoła Podstawowa Nr 11|Przemyśl|ul. Władycze 5 |37-700 Przemyśl;1329;621;621;12;609;46.73;1.93
100587;186201;I Liceum Ogólnokształcące|Przemyśl|ul. Słowackiego 21 |37-700 Przemyśl;1636;666;666;17;649;40.71;2.55
100588;186201;I Liceum Ogólnokształcące|Przemyśl|ul. Słowackiego 21 |37-700 Przemyśl;846;265;265;9;256;31.32;3.40
100589;186201;Gimnazjum Nr 3 im. Szarych Szeregów|Przemyśl|ul. hm. Izydory Kossowskiej 1 |37-700 Przemyśl;1909;802;802;23;779;42.01;2.87
100590;186201;Gimnazjum Nr 3 im. Szarych Szeregów|Przemyśl|ul. hm. Izydory Kossowskiej 1 |37-700 Przemyśl;1722;794;794;9;785;46.11;1.13
100591;186201;Ośrodek Kopalni Gazu|Przemyśl|ul. Jasińskiego 3 |37-700 Przemyśl;2022;1048;1048;20;1028;51.83;1.91
100592;186201;Przedszkole Miejskie Nr 19|Przemyśl|ul. Ofiar Katynia 4a |37-700 Przemyśl;1338;599;599;14;585;44.77;2.34
100593;186201;Polskie Towarzystwo Walki z Kalectwem Oddział w Przemyślu|Przemyśl|ul. Sobótki 23 |37-700 Przemyśl;527;242;242;5;237;45.92;2.07
100594;186201;Zakład Opiekuńczo - Leczniczy|Przemyśl|Jasińskiego 15 |37-700 Przemyśl;140;58;58;0;58;41.43;0.00
100595;186201;Świetlica Zakładu Karnego|Przemyśl|ul. Rokitniańska 1 |37-700 Przemyśl;156;94;94;11;83;60.26;11.70
100596;186201;Miejski Dom Pomocy Społecznej|Przemyśl|ul. Wysockiego 99 |37-700 Przemyśl;79;48;48;2;46;60.76;4.17
100597;186201;D.P.S. Zgromadzenia Braci Albertynów|Przemyśl|ul. Św. Brata Alberta 1 |37-700 Przemyśl;33;28;28;2;26;84.85;7.14
100598;186201;Miejski Dom Pomocy Społecznej|Przemyśl|ul. Św. Brata Alberta 3 |37-700 Przemyśl;51;29;29;7;22;56.86;24.14
100599;186201;Wojewódzki Szpital im. Św. Ojca Pio w Przemyślu|Przemyśl|ul. Monte Cassino 18 |37-700 Przemyśl;322;163;163;8;155;50.62;4.91
100600;186201;Szpital Miejski w Przemyślu|Przemyśl|ul. Słowackiego 85 |37-700 Przemyśl;154;66;66;1;65;42.86;1.52
100601;186201;Niepubliczny Zakład Opiekuńczo - Leczniczy i Opieki Palitywnej SAN-MED B&K s.c.|Przemyśl|ul. Rogozińskiego 30 |37-700 Przemyśl;39;28;28;0;28;71.79;0.00
100602;186301;Szkoła Podstawowa Nr 1|Rzeszów|ul. Bernardyńska 4 |35-069 Rzeszów;1864;944;944;14;930;50.64;1.48
100603;186301;Gimnazjum Nr 9|Rzeszów|ul. Orzeszkowej 8a |35-006 Rzeszów;1797;886;886;17;869;49.30;1.92
100604;186301;Zespół Szkół Muzycznych Nr 1|Rzeszów|ul. Szopena 32 |35-055 Rzeszów;1654;916;916;8;908;55.38;0.87
100605;186301;I Liceum Ogólnokształcące|Rzeszów|ul. 3 Maja 15 |35-030 Rzeszów;1006;592;592;8;584;58.85;1.35
100606;186301;Przedszkole Publiczne nr 7|Rzeszów|ul. Pułaskiego 3a |35-011 Rzeszów;2130;1366;1366;7;1359;64.13;0.51
100607;186301;Zespół Szkół Ekonomicznych|Rzeszów|ul. Hoffmanowej 13 |35-016 Rzeszów;1879;1052;1052;18;1034;55.99;1.71
100608;186301;Szkoła Podstawowa Nr 17|Rzeszów|ul. Bulwarowa 3 |35-051 Rzeszów;1230;762;762;14;748;61.95;1.84
100609;186301;Zespół Szkół Plastycznych|Rzeszów|ul. Staszica 16a |35-051 Rzeszów;1710;1061;1061;18;1043;62.05;1.70
100610;186301;Miejskie Przedsiębiorstwo Energetyki Cieplnej - Rzeszów Sp. z o.o.|Rzeszów|ul. Staszica 24 |35-051 Rzeszów;1433;760;760;14;746;53.04;1.84
100611;186301;Zespół Szkół Ogólnokształcących nr 2|Rzeszów|ul. Hetmańska 38 |35-045 Rzeszów;1952;1079;1079;12;1067;55.28;1.11
100612;186301;Szkoła Podstawowa nr 10|Rzeszów|ul. Dominikańska 4 |35-077 Rzeszów;1876;1074;1074;16;1058;57.25;1.49
100613;186301;Szkoła Podstawowa nr 10|Rzeszów|ul. Dominikańska 4 |35-077 Rzeszów;1988;1116;1116;10;1106;56.14;0.90
100614;186301;Gimnazjum nr 6|Rzeszów|ul. W. Pola 1 |35-021 Rzeszów;1853;1021;1021;18;1003;55.10;1.76
100615;186301;Zespół Szkół Energetycznych|Rzeszów|ul. Dąbrowskiego 66a |35-040 Rzeszów;1297;645;645;5;640;49.73;0.78
100616;186301;Zespół Szkół Technicznych im. Eugeniusza Kwiatkowskiego|Rzeszów|ul. Matuszczaka 7 |35-083 Rzeszów;1700;1150;1150;10;1140;67.65;0.87
100617;186301;Zespół Szkolno-Przedszkolny nr 4|Rzeszów|ul. Staroniwska 55 |35-101 Rzeszów;2291;1362;1362;14;1348;59.45;1.03
100618;186301;Szkoła Podstawowa Nr 16|Rzeszów|ul. Bohaterów 1 |35-112 Rzeszów;1926;1229;1229;8;1221;63.81;0.65
100619;186301;Szkoła Podstawowa nr 16|Rzeszów|ul. Bohaterów 1 |35-112 Rzeszów;1742;1155;1155;10;1145;66.30;0.87
100620;186301;Przedszkole Publiczne nr 17|Rzeszów|ul. Witkacego 5 |35-111 Rzeszów;2042;1335;1335;23;1312;65.38;1.72
100621;186301;Zespół Szkół nr 3|Rzeszów|ul. Ptasia 2 |35-207 Rzeszów;1429;782;782;13;769;54.72;1.66
100622;186301;Przedszkole Publiczne nr 12|Rzeszów|ul. Rudnickiego 1 |35-225 Rzeszów;1535;844;844;15;829;54.98;1.78
100623;186301;Szkoła Podstawowa nr 8|Rzeszów|ul. Rudnickiego 2 |35-225 Rzeszów;1207;567;567;19;548;46.98;3.35
100624;186301;Zespół Szkół Specjalnych im. UNICEF|Rzeszów|ul. Ofiar Katynia 1 |35-209 Rzeszów;1777;859;859;20;839;48.34;2.33
100625;186301;Zespół Szkół Specjalnych im. UNICEF|Rzeszów|ul. Ofiar Katynia 1 |35-209 Rzeszów;1538;907;907;11;896;58.97;1.21
100626;186301;Przedszkole Publiczne nr 22|Rzeszów|ul. Ofiar Katynia 11 |35-209 Rzeszów;1575;955;955;8;947;60.63;0.84
100627;186301;Zespół Szkolno-Przedszkolny nr 3|Rzeszów|ul. Skrajna 1 |35-231 Rzeszów;1549;1030;1030;19;1011;66.49;1.84
100628;186301;Rzeszowski Dom Kultury|Rzeszów|ul. Staromiejska 43a |35-231 Rzeszów;1512;990;990;11;979;65.48;1.11
100629;186301;Budynek dawnej siedziby Zespołu Szkół Specjalnych im. UNICEF|Rzeszów|ul. Marszałkowska 24a |35-215 Rzeszów;1618;951;951;9;942;58.78;0.95
100630;186301;Budynek dawnej siedziby Zespołu Szkół Specjalnych im. UNICEF|Rzeszów|ul. Marszałkowska 24a |35-215 Rzeszów;1825;1030;1030;15;1015;56.44;1.46
100631;186301;Zespół Szkolno-Przedszkolny nr 9|Rzeszów|ul. Piotra Skargi 3 |35-202 Rzeszów;1765;1076;1076;22;1054;60.96;2.04
100632;186301;Gimnazjum nr 10|Rzeszów|ul. Partyzantów 10a |35-234 Rzeszów;1803;1051;1051;12;1039;58.29;1.14
100633;186301;Zespół Szkolno-Przedszkolny nr 2|Rzeszów|ul. Lwowska 17 |35-301 Rzeszów;1490;793;793;28;765;53.22;3.53
100634;186301;Rzeszowski Dom Kultury|Rzeszów|ul. Konfederatów Barskich 43a |35-321 Rzeszów;1613;935;935;11;924;57.97;1.18
100635;186301;Gimnazjum nr 8|Rzeszów|ul. Miodowa 6 |35-303 Rzeszów;1687;1112;1112;6;1106;65.92;0.54
100636;186301;Gimnazjum nr 8|Rzeszów|ul. Miodowa 6 |35-303 Rzeszów;1595;1065;1065;7;1058;66.77;0.66
100637;186301;Gimnazjum nr 8|Rzeszów|ul. Miodowa 6 |35-303 Rzeszów;1404;904;904;5;899;64.39;0.55
100638;186301;Zespół Szkół nr 2|Rzeszów|al. Rejtana 3 |35-310 Rzeszów;1921;1142;1142;18;1124;59.45;1.58
100639;186301;Uniwersytet Rzeszowski|Rzeszów|al. Rejtana 16c |35-310 Rzeszów;1116;690;690;8;682;61.83;1.16
100640;186301;Zespół Szkół Ogólnokształcących nr 4|Rzeszów|al. Rejtana 30 |35-310 Rzeszów;1551;921;921;9;912;59.38;0.98
100641;186301;Przedszkole Publiczne nr 38|Rzeszów|al. Rejtana 28 |35-310 Rzeszów;1698;990;991;6;984;58.30;0.61
100642;186301;Zespół Szkolno - Przedszkolny Nr 5|Rzeszów|ul. bpa Pelczara 3 |35-312 Rzeszów;1369;742;742;9;733;54.20;1.21
100643;186301;Zespół Szkolno-Przedszkolny nr 5|Rzeszów|ul. bpa Pelczara 3 |35-312 Rzeszów;1611;974;974;6;968;60.46;0.62
100644;186301;Szkoła Podstawowa nr 11|Rzeszów|ul. Podwisłocze 14 |35-309 Rzeszów;1748;1018;1018;12;1006;58.24;1.18
100645;186301;Szkoła Podstawowa nr 11|Rzeszów|ul. Podwisłocze 14 |35-309 Rzeszów;1962;1121;1121;7;1114;57.14;0.62
100646;186301;Przedszkole Publiczne Nr 9|Rzeszów|ul. Podwisłocze 20 |35-309 Rzeszów;1797;1056;1056;14;1042;58.76;1.33
100647;186301;Rzeszowski Dom Kultury|Rzeszów|ul. Jana Olbrachta 120 |35-614 Rzeszów;2264;1475;1475;12;1463;65.15;0.81
100648;186301;Przedszkole Publiczne nr 11|Rzeszów|ul. Mazurska 19 |35-620 Rzeszów;1986;1293;1293;9;1284;65.11;0.70
100649;186301;Zespół Szkół Nr 8|Rzeszów|ul. Słocińska 4 |35-330 Rzeszów;1830;1190;1190;10;1180;65.03;0.84
100650;186301;Zespół Szkół Nr 8|Rzeszów|ul. Słocińska 4 |35-330 Rzeszów;1245;794;794;12;782;63.78;1.51
100651;186301;Dom Pomocy Społecznej dla Kombatantów|Rzeszów|ul. Powstańców Śląskich 4 |35-610 Rzeszów;1747;1111;1111;13;1098;63.59;1.17
100652;186301;Szkoła Podstawowa Nr 24|Rzeszów|ul. Czajkowskiego 11 |35-602 Rzeszów;2115;1354;1354;17;1337;64.02;1.26
100653;186301;Szkoła Podstawowa nr 24|Rzeszów|ul. Czajkowskiego 11 |35-602 Rzeszów;1838;1292;1292;15;1277;70.29;1.16
100654;186301;Rzeszowski Dom Kultury|Rzeszów|ul. Wieniawskiego 84 |35-601 Rzeszów;1792;1281;1281;8;1273;71.48;0.62
100655;186301;Przedszkole Publiczne|Rzeszów|ul. bł. Karoliny 19 |35-119 Rzeszów;1375;959;959;5;954;69.75;0.52
100656;186301;Zespół Szkół Nr 4|Rzeszów|ul. Debicka 288 |35-213 Rzeszów;1900;1120;1120;15;1105;58.95;1.34
100657;186301;Zespół Szkół nr 4|Rzeszów|ul. Dębicka 288 |35-213 Rzeszów;1560;926;926;15;911;59.36;1.62
100658;186301;Zespół Szkół nr 4|Rzeszów|ul. Debicka 288 |35-213 Rzeszów;1320;745;745;11;734;56.44;1.48
100659;186301;Przedszkole Publiczne nr 28|Rzeszów|ul. Obrońców Poczty Gdańskiej 5 |35-509 Rzeszów;1909;1234;1234;14;1220;64.64;1.13
100660;186301;Gimnazjum nr 11|Rzeszów|ul.Starzyńskiego 17 |35-508 Rzeszów;1450;869;869;8;861;59.93;0.92
100661;186301;Szkoła Podstawowa Nr 25|Rzeszów|ul. Starzyńskiego 17 |35-508 Rzeszów;1886;1118;1118;10;1108;59.28;0.89
100662;186301;Szkoła Podstawowa nr 25|Rzeszów|ul. Starzyńskiego 17 |35-508 Rzeszów;1638;1032;1032;14;1018;63.00;1.36
100663;186301;Młodzieżowy Dom Kultury|Rzeszów|ul. Osmeckiego 51 |35-506 Rzeszów;1354;813;813;13;800;60.04;1.60
100664;186301;Szkoła Podstawowa nr 2|Rzeszów|ul. Kamińskiego 12 |35-211 Rzeszów;1538;922;922;13;909;59.95;1.41
100665;186301;Generalna Dyrekcja Dróg Krajowych i Autostrad, Oddział w Rzeszowie|Rzeszów|ul. Legionów 20 |35-111 Rzeszów;1298;782;782;4;778;60.25;0.51
100666;186301;Zespół Szkół Ogólnokształcących nr 3|Rzeszów|ul. Wyspiańskiego 16a |35-111 Rzeszów;1472;934;934;7;927;63.45;0.75
100667;186301;Zespół Szkolno-Przedszkolny nr 6|Rzeszów|al. Krzyżanowskiego 24 |35-329 Rzeszów;1667;1084;1084;9;1075;65.03;0.83
100668;186301;Zespół Szkolno-Przedszkolny nr 6|Rzeszów|al. Krzyżanowskiego 24 |35-329 Rzeszów;1652;1003;1003;13;990;60.71;1.30
100669;186301;Dom Studencki "FILON"|Rzeszów|ul. Cicha 4 |35-326 Rzeszów;1532;901;901;17;884;58.81;1.89
100670;186301;Przedszkole Publiczne nr 43|Rzeszów|ul. Cicha 5 |35-326 Rzeszów;1753;1138;1138;22;1116;64.92;1.93
100671;186301;Dom Strażaka|Rzeszów|ul. Strażacka 9 |35-312 Rzeszów;2150;1371;1371;21;1350;63.77;1.53
100672;186301;Dom Strażaka|Rzeszów|ul. Strażacka 9 |35-312 Rzeszów;2174;1497;1497;13;1484;68.86;0.87
100673;186301;Zespół Szkół nr 6|Rzeszów|ul. Solarza 12 |35-118 Rzeszów;1812;1134;1134;11;1123;62.58;0.97
100674;186301;Zespół Szkół nr 6|Rzeszów|ul. Solarza 12 |35-118 Rzeszów;1700;1109;1109;15;1094;65.24;1.35
100675;186301;Zespół Szkół nr 6|Rzeszów|ul. Solarza 12 |35-118 Rzeszów;1381;874;874;17;857;63.29;1.95
100676;186301;Przedszkole Publiczne nr 40|Rzeszów|ul. Rataja 14 |35-116 Rzeszów;1418;942;942;11;931;66.43;1.17
100677;186301;Rzeszowski Dom Kultury|Rzeszów|ul. Widokowa 1 |35-119 Rzeszów;1874;1193;1193;10;1183;63.66;0.84
100678;186301;Przedszkole Publiczne nr 3|Rzeszów|ul. Krośnieńska 15a |35-505 Rzeszów;1765;1260;1260;15;1245;71.39;1.19
100679;186301;Zespół Szkolno-Przedszkolny nr 1|Rzeszów|ul. Rubinowa 4 |35-322 Rzeszów;1668;966;966;15;951;57.91;1.55
100680;186301;Zespół Szkół nr 5|Rzeszów|ul. Beskidzka 5 |35-083 Rzeszów;1277;717;717;13;704;56.15;1.81
100681;186301;Zespół Szkół nr 5|Rzeszów|ul. Beskidzka 5 |35-083 Rzeszów;1373;921;921;8;913;67.08;0.87
100682;186301;Rzeszowski Dom Kultury|Rzeszów|ul. Kardynała Karola Wojtyły 164 |35-313 Rzeszów;1901;1207;1207;15;1192;63.49;1.24
100683;186301;Zespół Szkół Agroprzedsiębiorczości|Rzeszów|ul. Miłocińska 75 |35-232 Rzeszów;663;470;470;6;464;70.89;1.28
100684;186301;Zespół Szkolno - Przedszkolny nr 7|Rzeszów|ul. Budziwojska 154 |35-317 Rzeszów;2086;1350;1350;24;1326;64.72;1.78
100685;186301;Zespół Szkolno-Przedszkolny nr 7|Rzeszów|ul. Budziwojska 154 |35-317 Rzeszów;1927;1065;1065;24;1041;55.27;2.25
100686;186301;Kliniczny Szpital Wojewódzki Nr 1 im. Fryderyka Chopina ul. Szopena 2 w Rzeszowie|Rzeszów|ul. Szopena 2 |35-055 Rzeszów;408;171;171;4;167;41.91;2.34
100687;186301;Szpital Wojewódzki Nr 2 im. Św. Jadwigi Królowej w Rzeszowie|Rzeszów|ul. Lwowska 60 |35-301 Rzeszów;475;146;146;2;144;30.74;1.37
100688;186301;Szpital Miejski im. Jana Pawła II w Rzeszowie|Rzeszów|ul. Rycerska 4 |35-241 Rzeszów;113;43;43;1;42;38.05;2.33
100689;186301;Podkarpackie Centrum Chorób Płuc w Rzeszowie|Rzeszów|ul. Rycerska 2 |35-241 Rzeszów;87;44;44;2;42;50.57;4.55
100690;186301;Samodzielny Publiczny Zakład Opieki Zdrowotnej Ministerstwa Spraw Wewnętrznych w Rzeszowie|Rzeszów|Krakowska 16 |35-111 Rzeszów;86;40;40;1;39;46.51;2.50
100691;186301;Szpital Specjalistyczny Pro-Familia T. Wapiński Z. Sobieszczański i Wspólnicy SP.J. w Rzeszowie|Rzeszów|Witolda 6B |35-302 Rzeszów;136;5;5;0;5;3.68;0.00
100692;186301;Dom Pomocy Społecznej dla Osób w Podeszłym Wieku oraz Osób Niepełnosprawnych Fizycznie w Rzeszowie|Rzeszów|Sucharskiego 1 |35-222 Rzeszów;86;36;36;5;31;41.86;13.89
100693;186301;Filia Domu Pomocy Społecznej dla Osób w Podeszłym Wieku oraz Osób Niepełnosprawnych Fizycznie w Rzeszowie|Rzeszów|Łabędzia 9 |35-207 Rzeszów;43;14;14;1;13;32.56;7.14
100694;186301;Zakład Karny w Rzeszowie|Rzeszów|Załęska 76 |35-322 Rzeszów;797;335;335;61;274;42.03;18.21
100695;186401;Miejski Ośrodek Sportu i Rekreacji im. Alfreda Freyera|Tarnobrzeg|Aleja Niepodległości 2 |39-400 Tarnobrzeg;1667;790;790;24;766;47.39;3.04
100696;186401;Miejski Ośrodek Sportu i Rekreacji im. Alfreda Freyera|Tarnobrzeg|Aleja Niepodległości 2 |39-400 Tarnobrzeg;1891;861;861;17;844;45.53;1.97
100697;186401;Szkoła Podstawowa Nr 3|Tarnobrzeg|ul.Kochanowskiego 1 |39-400 Tarnobrzeg;1244;583;583;12;571;46.86;2.06
100698;186401;Szkoła Podstawowa Nr 10|Tarnobrzeg|ul.Dąbrowskiej 10 |39-400 Tarnobrzeg;1521;753;753;17;736;49.51;2.26
100699;186401;Szkoła Podstawowa Nr 10|Tarnobrzeg|ul.Dąbrowskiej 10 |39-400 Tarnobrzeg;1670;815;815;8;807;48.80;0.98
100700;186401;Szkoła Podstawowa Nr 10|Tarnobrzeg|ul.Dąbrowskiej 10 |39-400 Tarnobrzeg;1662;729;730;13;716;43.86;1.78
100701;186401;Szkoła Podstawowa Nr 10|Tarnobrzeg|ul.Dąbrowskiej 10 |39-400 Tarnobrzeg;1807;835;835;9;826;46.21;1.08
100702;186401;Administracja Osiedla "Serbinów"|Tarnobrzeg|ul.Zwierzyniecka 3 |39-400 Tarnobrzeg;1541;755;755;13;742;48.99;1.72
100703;186401;Administracja Osiedla "Serbinów"|Tarnobrzeg|ul.Zwierzyniecka 3 |39-400 Tarnobrzeg;1651;774;774;13;761;46.88;1.68
100704;186401;Państwowa Wyższa Szkoła Zawodowa|Tarnobrzeg|ul.Kardynała Wyszyńskiego 10 |39-400 Tarnobrzeg;734;347;347;4;343;47.28;1.15
100705;186401;Państwowa Wyższa Szkoła Zawodowa|Tarnobrzeg|ul.Sienkiewicza 50 |39-400 Tarnobrzeg;522;293;293;4;289;56.13;1.37
100706;186401;Zespół Szkół|Tarnobrzeg|ul.Kopernika 1 |39-400 Tarnobrzeg;1310;729;729;14;715;55.65;1.92
100707;186401;Zespół Szkół Ponadgimnazjalnych Nr 3|Tarnobrzeg|ul.Świętej Barbary 1B |39-400 Tarnobrzeg;1494;799;799;14;785;53.48;1.75
100708;186401;Gimnazjum Nr 2|Tarnobrzeg|ul.Kopernika 18 |39-400 Tarnobrzeg;1389;679;680;6;673;48.88;0.88
100709;186401;Dom Osiedlowy|Tarnobrzeg|ul.Krzywa 2 |39-400 Tarnobrzeg;910;508;508;9;499;55.82;1.77
100710;186401;Dom Osiedlowy|Tarnobrzeg|ul.Nadwiślańska 16 |39-400 Tarnobrzeg;136;87;87;0;87;63.97;0.00
100711;186401;Ochotnicza Straż Pożarna|Tarnobrzeg|ul.Ocicka 89 |39-400 Tarnobrzeg;420;223;223;7;216;53.10;3.14
100712;186401;Gimnazjum Nr 3|Tarnobrzeg|ul.Dekutowskiego 17 |39-400 Tarnobrzeg;1943;984;984;25;959;50.64;2.54
100713;186401;Szkoła Podstawowa Nr 4|Tarnobrzeg|ul.Wyspiańskiego 10 |39-400 Tarnobrzeg;1781;907;907;11;896;50.93;1.21
100714;186401;Szkoła Podstawowa Nr 4|Tarnobrzeg|ul.Wyspiańskiego 10 |39-400 Tarnobrzeg;1855;905;905;22;883;48.79;2.43
100715;186401;Gimnazjum Nr 1|Tarnobrzeg|ul.Jachowicza 4 |39-400 Tarnobrzeg;370;187;187;5;182;50.54;2.67
100716;186401;Państwowa Wyższa Szkoła Zawodowa|Tarnobrzeg|ul.Kardynała Wyszyńskiego 10 |39-400 Tarnobrzeg;889;467;467;6;461;52.53;1.28
100717;186401;Szkoła Podstawowa Nr 9|Tarnobrzeg|ul.Wiejska 4 |39-400 Tarnobrzeg;1400;646;646;10;636;46.14;1.55
100718;186401;Szkoła Podstawowa Nr 9|Tarnobrzeg|ul.Wiejska 4 |39-400 Tarnobrzeg;1092;558;558;3;555;51.10;0.54
100719;186401;Szkoła Podstawowa Nr 9|Tarnobrzeg|ul.Wiejska 4 |39-400 Tarnobrzeg;1251;743;743;8;735;59.39;1.08
100720;186401;Szkoła Podstawowa Nr 7|Tarnobrzeg|ul.Sienkiewicza 215 |39-400 Tarnobrzeg;1777;809;809;13;796;45.53;1.61
100721;186401;Szkoła Podstawowa Nr 8|Tarnobrzeg|ul.Piętaka 53 |39-400 Tarnobrzeg;1303;647;647;13;634;49.65;2.01
100722;186401;Dom Strażaka|Tarnobrzeg|ul.Spokojna 9 |39-400 Tarnobrzeg;784;429;429;12;417;54.72;2.80
100723;186401;Dom Ludowy|Tarnobrzeg|ul.Sielecka 29 |39-400 Tarnobrzeg;435;210;210;6;204;48.28;2.86
100724;186401;Szkoła Podstawowa Nr 11|Tarnobrzeg|ul.Olszowa 1 |39-400 Tarnobrzeg;1256;567;567;12;555;45.14;2.12
100725;186401;Szkoła Podstawowa Nr 9|Tarnobrzeg|ul. Wiejska 4 |39-400 Tarnobrzeg;779;440;440;5;435;56.48;1.14
100726;186401;Dom Pomocy Społecznej|Tarnobrzeg|Kurasia 7 |39-400 Tarnobrzeg;57;17;17;1;16;29.82;5.88
100727;186401;Wojewódzki Szpital im. Zofii z Zamoyskich Tarnowskiej|Tarnobrzeg|Szpitalna 1 |39-400 Tarnobrzeg;151;73;73;3;70;48.34;4.11
100728;186401;Zakład Pielęgnacyjno-Opiekuńczy|Tarnobrzeg|Dekutowskiego 20 |39-400 Tarnobrzeg;71;15;15;1;14;21.13;6.67
100729;200101;Szkoła Podstawowa Nr 6 w Augustowie|Augustów|ul. Tartaczna 21 |16-300 Augustów;958;421;421;11;410;43.95;2.61
100730;200101;Augustowskie Towarzystwo Budownictwa Społecznego "Kodrem" w Augustowie|Augustów|ul. Komunalna 2 |16-300 Augustów;1115;469;469;18;451;42.06;3.84
100731;200101;Augustowskie Centrum Edukacyjne w Augustowie|Augustów|Aleja Kardynała Wyszyńskiego 3 |16-300 Augustów;826;418;418;7;411;50.61;1.67
100732;200101;II Liceum Ogólnokształcące w Augustowie|Augustów|Aleja Kardynała Wyszyńskiego 1 |16-300 Augustów;1063;461;461;12;449;43.37;2.60
100733;200101;Kompleks Hotelowy LOGOS w Augustowie|Augustów|ul. 29 Listopada 9 |16-300 Augustów;747;320;320;11;309;42.84;3.44
100734;200101;Przedszkole Nr 1 w Augustowie|Augustów|ul. Waryńskiego 57 |16-300 Augustów;1195;541;541;17;524;45.27;3.14
100735;200101;Szkoła Muzyczna w Augustowie|Augustów|ul. Wybickiego 1 |16-300 Augustów;1000;468;468;6;462;46.80;1.28
100736;200101;Powiatowy Zarząd Dróg w Augustowie|Augustów|ul. Wojska Polskiego 54 |16-300 Augustów;1055;460;460;5;455;43.60;1.09
100737;200101;Osiedlowy Dom Kultury w Augustowie|Augustów|ul. Hoża 2b |16-300 Augustów;1088;555;555;5;550;51.01;0.90
100738;200101;Centrum Sportu i Rekreacji w Augustowie|Augustów|ul. mjr H. Sucharskiego 15 |16-300 Augustów;1309;524;524;13;511;40.03;2.48
100739;200101;Zespół Szkół Ogólnokształcących w Augustowie|Augustów|ul. Śródmieście 31 |16-300 Augustów;1238;552;552;8;544;44.59;1.45
100740;200101;Miejska Biblioteka Publiczna w Augustowie|Augustów|ul. Hoża 7 |16-300 Augustów;1191;569;569;12;557;47.77;2.11
100741;200101;Zespół Szkół Specjalnych w Augustowie|Augustów|ul. Mickiewicza 2 |16-300 Augustów;1270;632;632;15;617;49.76;2.37
100742;200101;Miejski Dom Kultury w Augustowie|Augustów|Rynek Zygmunta Augusta 9 |16-300 Augustów;1411;763;763;22;741;54.08;2.88
100743;200101;Gimnazjum Nr 1 w Augustowie|Augustów|ul. Młyńska 35 |16-300 Augustów;1494;706;706;19;687;47.26;2.69
100744;200101;Gimnazjum Nr 2 w Augustowie|Augustów|ul. Nowomiejska 41 |16-300 Augustów;1088;520;520;16;504;47.79;3.08
100745;200101;Centrum Informacji Turystycznej w Augustowie|Augustów|Rynek Zygmunta Augusta 44 |16-300 Augustów;1136;542;542;10;532;47.71;1.85
100746;200101;Przedszkole Nr 2 w Augustowie|Augustów|ul. Kopernika 24 |16-300 Augustów;1452;750;750;17;733;51.65;2.27
100747;200101;Filia Nr 1 Miejskiej Biblioteki Publicznej w Augustowie|Augustów|ul. Nowomiejska 100a |16-300 Augustów;973;425;425;15;410;43.68;3.53
100748;200101;Szkoła Podstawowa Nr 2 w Augustowie|Augustów|ul. Rajgrodzka 1 |16-300 Augustów;1171;552;552;16;536;47.14;2.90
100749;200101;Zespół Szkół Samorządowych w Augustowie|Augustów|ul. Mickiewicza 1 |16-300 Augustów;971;441;441;12;429;45.42;2.72
100750;200101;Zakład Opieki Zdrowotnej w Augustowie|Augustów|ul. Szpitalna 12 |16-300 Augustów;105;31;31;1;30;29.52;3.23
100751;200101;Niepubliczny Zakład Opieki Zdrowotnej "Procardia" w Augustowie|Augustów|ul. Marii Konopnickiej 11 |16-300 Augustów;121;104;104;5;99;85.95;4.81
100752;200102;Gminny Ośrodek Kultury|Żarnowo Drugie| 16 |16-300 Augustów;867;421;421;11;410;48.56;2.61
100753;200102;Szkoła Podstawowa|Rutki Nowe| 1 |16-300 Augustów;694;214;214;7;207;30.84;3.27
100754;200102;Gimnazjum|Janówka| 48A |16-300 Augustów;1624;640;640;13;627;39.41;2.03
100755;200102;Szkoła Podstawowa|Netta Pierwsza| 14 |16-320 Bargłów Kościelny;659;277;277;8;269;42.03;2.89
100756;200102;Zespół Szkół|Białobrzegi| 75 |16-300 Augustów;970;327;327;12;315;33.71;3.67
100757;200102;Szkoła Podstawowa|Kolnica| 48 |16-300 Augustów;567;161;161;6;155;28.40;3.73
100758;200103;Urząd Gminy w Bargłowie Kościelnym|Bargłów Kościelny|ul.Augustowska 47 |16-320 Bargłów Kościelny;2264;781;781;25;756;34.50;3.20
100759;200103;Szkoła Podstawowa|Łabętnik| 10 |16-320 Bargłów Kościelny;837;275;275;17;258;32.86;6.18
100760;200103;Szkoła Podstawowa|Kroszewo| 27 |16-320 Bargłów Kościelny;1444;449;449;15;434;31.09;3.34
100761;200104;MGOK w Lipsku|Lipsk|ul. Rynek 23 |16-315 Lipsk;1279;425;425;12;413;33.23;2.82
100762;200104;Szkoła Podstawowa w Bartnikach|Bartniki| 8 |16-315 Lipsk;575;181;181;10;171;31.48;5.52
100763;200104;Szkoła Podstawowa w Rygałówce|Rygałówka| 1 |16-315 Lipsk;609;177;177;10;167;29.06;5.65
100764;200104;MGOK w Lipsku|Lipsk|ul. Rynek 23 |16-315 Lipsk;2036;855;855;32;823;41.99;3.74
100765;200105;Gminny Ośrodek Kultury w Nowince|Nowinka| 26A |16-304 Nowinka;575;234;234;10;224;40.70;4.27
100766;200105;Zespół Szkół w Nowince|Nowinka| 14 |16-304 Nowinka;560;265;265;12;253;47.32;4.53
100767;200105;Szkoła Podstawowa w Monkiniach|Monkinie| 27 |16-304 Nowinka;679;321;321;22;299;47.28;6.85
100768;200105;Szkoła Podstawowa w Olszance|Olszanka| 54 |16-304 Nowinka;604;240;240;16;224;39.74;6.67
100769;200106;Centrum Informacji Turystycznej|Płaska| 57A |16-326 Płaska;1531;623;623;29;594;40.69;4.65
100770;200106;Filia Szkoły Podstawowej im. Jana Pawła II w Płaskiej|Gruszki| 60 |16-326 Płaska;639;241;241;8;233;37.72;3.32
100771;200107;Remiza OSP|Sztabin|ul. Kościuszki 10 |16-310 Sztabin;1870;745;745;27;718;39.84;3.62
100772;200107;Remiza OSP|Jaminy| 21B |16-310 Sztabin;1092;418;418;22;396;38.28;5.26
100773;200107;Zespół Szkół Samorządowych|Krasnybór| 59 |16-310 Sztabin;1327;398;398;12;386;29.99;3.02
100774;200201;Zespół Szkół w Choroszczy (Gimnazjum)|Choroszcz|ul.Powstania Styczniowego 26A |16-070 Choroszcz;2210;1235;1235;31;1204;55.88;2.51
100775;200201;Świetlica Miejsko-Gminnego Centrum Kultury i Sportu w Choroszczy|Choroszcz|ul. Henryka Sienkiewicza 29 |16-070 Choroszcz;1704;916;916;21;895;53.76;2.29
100776;200201;Szkoła Podstawowa w Złotorii|Złotoria| 159A |16-070 Choroszcz;755;387;387;7;380;51.26;1.81
100777;200201;Świetlica wiejska w Rogowie|Rogowo| |16-070 Choroszcz;752;308;308;10;298;40.96;3.25
100778;200201;Szkoła Podstawowa w Kruszewie|Kruszewo| 62 |16-070 Choroszcz;648;243;243;12;231;37.50;4.94
100779;200201;Świetlica wiejska w Barszczewie|Barszczewo| 42 |16-070 Choroszcz;1823;1003;1003;20;983;55.02;1.99
100780;200201;Remiza OSP w Klepaczach|Klepacze|ul.Niewodnicka 19 |15-635 Białystok;1300;820;820;16;804;63.08;1.95
100781;200201;Świetlica wiejska w Łyskach|Łyski| 56 |16-070 Choroszcz;1063;594;594;10;584;55.88;1.68
100782;200201;Remiza OSP w Choroszczy|Choroszcz|ul.Dominikańska 22 |16-070 Choroszcz;961;541;541;6;535;56.30;1.11
100783;200201;Dom Pomocy Społecznej w Choroszczy|Choroszcz|Aleja Niepodległości 4 |16-070 Choroszcz;191;33;33;7;26;17.28;21.21
100784;200201;Samodzielny Publiczny Psychiatryczny Zakład Opieki Zdrowotnej w Choroszczy|Choroszcz|Plac im. dr Zygmunta Brodowicza 1 |16-070 Choroszcz;785;210;210;19;191;26.75;9.05
100785;200202;Gimnazjum|Czarna Białostocka|ul. B. Prusa 1 |16-020 Czarna Białostocka;2046;851;851;24;827;41.59;2.82
100786;200202;Zespół Szkół|Czarna Białostocka|ul. H. Sienkiewicza 7 |16-020 Czarna Białostocka;1838;873;873;20;853;47.50;2.29
100787;200202;Szkoła Podstawowa Nr 2|Czarna Białostocka|ul. R. Traugutta 28 |16-020 Czarna Białostocka;1525;725;725;25;700;47.54;3.45
100788;200202;Dom Kultury|Czarna Białostocka|ul. Kościelna 8 |16-020 Czarna Białostocka;1328;568;568;20;548;42.77;3.52
100789;200202;Wiejski Dom Kultury|Czarna Wieś Kościelna|ul. Wesoła 26 |16-020 Czarna Białostocka;1145;489;489;16;473;42.71;3.27
100790;200202;Centrum Rękodzieła Ludowego|Niemczyn| 42 |16-020 Czarna Białostocka;423;150;150;3;147;35.46;2.00
100791;200202;Budynek Przychodni|Czarna Białostocka|ul.Torowa 1 |16-020 Czarna Białostocka;819;401;401;11;390;48.96;2.74
100792;200203;Wiejski Dom Kultury|Nowe Aleksandrowo|ul. Pogodna 109 |16-002 Dobrzyniewo Duże;1959;1035;1035;21;1014;52.83;2.03
100793;200203;Gminne Centrum Kultury|Dobrzyniewo Duże|ul.Lipowa 71 |16-002 Dobrzyniewo Duże;1113;540;540;25;515;48.52;4.63
100794;200203;Wiejski Dom Kultury|Kozińce| 9 |16-002 Dobrzyniewo Duże;1610;660;660;31;629;40.99;4.70
100795;200203;Szkoła Podstawowa|Pogorzałki| 127 |16-002 Dobrzyniewo Duże;999;383;383;5;378;38.34;1.31
100796;200203;Szkoła Podstawowa|Fasty|ul.Białostocka 5 |15-694 Białystok;1317;712;712;42;670;54.06;5.90
100797;200204;Gminne Centrum Kultury w Gródku|Gródek|ul. Chodkiewiczów 4 |16-040 Gródek;819;355;355;10;345;43.35;2.82
100798;200204;Zespół Szkół w Gródku|Gródek|ul. Chodkiewiczów 18 |16-040 Gródek;813;355;355;7;348;43.67;1.97
100799;200204;Zespół Szkół w Gródku|Gródek|ul. Chodkiewiczów 18 |16-040 Gródek;762;274;274;9;265;35.96;3.28
100800;200204;Świetlica w Słuczance|Słuczanka| 22 |16-040 Gródek;368;108;108;6;102;29.35;5.56
100801;200204;BOBREX w Bobrownikach|Bobrowniki| 80 |16-040 Gródek;219;44;44;2;42;20.09;4.55
100802;200204;Świetlica Ochotniczej Straży Pożarnej w Podozieranach|Podozierany| 37 |16-040 Gródek;214;65;65;4;61;30.37;6.15
100803;200204;Rolnicza Spółdzielnia Produkcyjna w Zubrach|Zubry| 76 |16-040 Gródek;234;83;83;1;82;35.47;1.20
100804;200204;Nadleśnictwo Waliły w Waliłach-Stacji|Waliły-Stacja|Białostocka 3 |16-040 Gródek;547;248;248;3;245;45.34;1.21
100805;200204;Rolnicza Spółdzielnia Produkcyjna w Kołodnie|Kołodno| 41 |16-040 Gródek;313;120;120;6;114;38.34;5.00
100806;200204;Szkoła Podstawowa w Załukach|Załuki| 5 |16-040 Gródek;297;141;141;12;129;47.47;8.51
100807;200205;Świetlica Wiejska w Tryczówce|Tryczówka| 39A |16-061 Juchnowiec Kościelny;1074;453;453;9;444;42.18;1.99
100808;200205;Ośrodek Kultury w Juchnowcu Kościelnym|Juchnowiec Kościelny|ul. Plac Królowej Rodzin 1 |16-061 Juchnowiec Kościelny;833;499;499;9;490;59.90;1.80
100809;200205;Zespół Szkół im. Ks. Jerzego Popiełuszki w Juchnowcu Górnym|Juchnowiec Górny|ul. Szkolna 5 |16-061 Juchnowiec Kościelny;1007;557;557;11;546;55.31;1.97
100810;200205;Świetlica Wiejska w Lewickich|Lewickie| 74 |16-061 Juchnowiec Kościelny;667;414;414;10;404;62.07;2.42
100811;200205;Szkoła Podstawowa im. Ks. Michała Sopoćki w Księżynie|Księżyno|ul. Szkolna 7 |16-001 Kleosin;744;425;425;12;413;57.12;2.82
100812;200205;Szkoła Podstawowa im. Ks. Michała Sopoćki w Księżynie|Księżyno|ul. Szkolna 7 |16-001 Kleosin;939;571;571;13;558;60.81;2.28
100813;200205;Remiza OSP w Hermanówce|Hermanówka| 1A |16-061 Juchnowiec Kościelny;767;441;441;5;436;57.50;1.13
100814;200205;Świetlica Wiejska w Olmontach|Olmonty| 93 |15-603 Białystok;606;365;365;7;358;60.23;1.92
100815;200205;Zespół Szkół im. Jana Pawła II w Kleosinie|Kleosin|ul. Zambrowska 20 |16-001 Kleosin;1553;926;926;12;914;59.63;1.30
100816;200205;Zespół Szkół im. Jana Pawła II w Kleosinie|Kleosin|ul. Zambrowska 20 |16-001 Kleosin;1477;901;901;13;888;61.00;1.44
100817;200205;Zespół Szkół im. Jana Pawła II w Kleosinie|Kleosin|ul. Zambrowska 20 |16-001 Kleosin;827;438;438;4;434;52.96;0.91
100818;200205;Zespół Szkół im. Jana Pawła II w Kleosinie|Kleosin|ul. Zambrowska 20 |16-001 Kleosin;1396;687;687;16;671;49.21;2.33
100819;200205;Dom Pomocy Społecznej w Czerewkach|Czerewki| 1 |16-061 Juchnowiec Kościelny;81;29;29;9;20;35.80;31.03
100820;200206;Szkoła Podstawowa w Łupiance Starej|Łupianka Stara| 1 |18-100 Łapy;780;382;382;9;373;48.97;2.36
100821;200206;Zespół Szkół w Płonce Kościelnej|Płonka Kościelna| 47 |18-100 Łapy;1149;506;506;9;497;44.04;1.78
100822;200206;Zespół Szkół w Łapach (Osse)|Łapy|ul. Letnia 1 |18-100 Łapy;1610;728;728;31;697;45.22;4.26
100823;200206;Niepubliczna Szkoła Podstawowa w Daniłowie Dużym|Daniłowo Duże| 53 |18-112 Poświętne;382;198;198;5;193;51.83;2.53
100824;200206;Wiejski Dom Kultury w Uhowie|Uhowo|ul. Kościelna 42 |18-100 Łapy;1196;646;646;20;626;54.01;3.10
100825;200206;Przedszkole Nr 2 w Łapach|Łapy|ul. Cmentarna 23 |18-100 Łapy;2043;1040;1040;17;1023;50.91;1.63
100826;200206;Przedszkole Nr 2 w Łapach|Łapy|ul. Cmentarna 23 |18-100 Łapy;2170;1119;1119;14;1105;51.57;1.25
100827;200206;Szkoła Podstawowa Nr 2 w Łapach im. M. Kopernika|Łapy|ul Piękna 17 |18-100 Łapy;910;517;517;7;510;56.81;1.35
100828;200206;Gimnazjum Nr 1 w Łapach im. Ppłk. Stanisława Nilskiego-Łapińskiego|Łapy|ul. Jana Matejki 19 |18-100 Łapy;777;420;420;5;415;54.05;1.19
100829;200206;Szkoła Podstawowa Nr 1 w Łapach im. Papieża Jana Pawła II|Łapy|ul. Polna 9 |18-100 Łapy;2288;1246;1246;20;1226;54.46;1.61
100830;200206;Dom Kultury w Łapach|Łapy|ul. Nowy Rynek 15 |18-100 Łapy;924;516;516;9;507;55.84;1.74
100831;200206;I Liceum Ogólnokształcące w Łapach|Łapy|ul. Bohaterów Westerplatte 10 |18-100 Łapy;932;416;416;10;406;44.64;2.40
100832;200206;Gimnazjum Nr 1 w Łapach im. Ppłk. Stanisława Nilskiego-Łapińskiego|Łapy|ul. Jana Matejki 19 |18-100 Łapy;840;475;475;3;472;56.55;0.63
100833;200206;Dom Kultury w Łapach|Łapy|Główna 8 |18-100 Łapy;1880;914;914;24;890;48.62;2.63
100834;200206;Dom Pomocy Społecznej w Uhowie|Uhowo|ul. Surażska 67 |18-100 Łapy;84;41;42;10;31;48.81;24.39
100835;200206;Samodzielny Publiczy Zakład Opieki Zdrowotnej|Łapy|ul. Janusza Korczaka 23 |18-100 Łapy;37;11;11;0;11;29.73;0.00
100836;200207;Gminny Ośrodek Kultury w Michałowie|Michałowo|ul. Białostocka 19 |16-050 Michałowo;1191;481;481;22;459;40.39;4.57
100837;200207;Gminny Zespół Szkół w Michałowie|Michałowo|ul. Sienkiewicza 21 |16-050 Michałowo;1101;437;437;12;425;39.69;2.75
100838;200207;Urząd Miejski w Michałowie|Michałowo|Białostocka 11 |16-050 Michałowo;820;309;309;13;296;37.68;4.21
100839;200207;Dom Ludowy w Sokolu|Sokole| 59 |16-050 Michałowo;279;125;125;4;121;44.80;3.20
100840;200207;Świetlica w Topolanach|Topolany| 29 |16-050 Michałowo;199;45;45;0;45;22.61;0.00
100841;200207;Remiza OSP w Nowej Woli|Nowa Wola| 80 |16-050 Michałowo;411;115;115;5;110;27.98;4.35
100842;200207;Ośrodek Zdrowia w Juszkowym Grodzie|Juszkowy Gród| 20 |16-050 Michałowo;411;103;103;7;96;25.06;6.80
100843;200207;Świetlica na Osiedlu Bondary|Osiedle Bondary| Blok nr 5 |16-050 Michałowo;380;118;118;5;113;31.05;4.24
100844;200207;Ośrodek Zdrowia w Szymkach|Szymki| 104 |16-050 Michałowo;584;181;181;5;176;30.99;2.76
100845;200207;Remiza OSP w Jałówce|Jałówka|Dworna 20 |16-050 Michałowo;284;87;87;2;85;30.63;2.30
100846;200207;Dom Pomocy Społecznej ”Spokojna Przystań” w Garbarach|Garbary| 1 |16-050 Michałowo;71;41;41;7;34;57.75;17.07
100847;200207;Dom Pomocy Społecznej „Jawor” w Jałówce|Garbary|Leśna 11 |16-050 Michałowo;63;31;31;2;29;49.21;6.45
100848;200208;Zespół Szkół w Poświętnem|Gołębie| 11 |18-112 Poświętne;1126;573;573;20;553;50.89;3.49
100849;200208;Świetlica Wiejska w Brzozowie Starym|Brzozowo Stare| 35 |18-112 Poświętne;1031;488;488;9;479;47.33;1.84
100850;200208;Remiza OSP w Pietkowie|Pietkowo| 49 |18-112 Poświętne;780;336;336;10;326;43.08;2.98
100851;200209;Zespół Szkół Sportowych|Supraśl|ul. Józefa Piłsudskiego 1 |16-030 Supraśl;1591;841;841;18;823;52.86;2.14
100852;200209;Zespół Szkół Sportowych|Supraśl|ul. Józefa Piłsudskiego 1 |16-030 Supraśl;1268;718;718;22;696;56.62;3.06
100853;200209;Zespół Szkolno-Przedszkolny|Ogrodniczki|ul. Zagórna 7 |16-030 Supraśl;1594;841;841;23;818;52.76;2.73
100854;200209;Świetlica Strażnicy OSP|Sokołda| 16 |16-030 Supraśl;217;95;95;2;93;43.78;2.11
100855;200209;Zespół Szkół|Sobolewo|ul. Podlaska 8 |15-509 Białystok;1309;639;639;11;628;48.82;1.72
100856;200209;ADAMPOL S.A.|Zaścianki|ul. Usługowa 3 |15-521 Białystok;1952;1051;1051;16;1035;53.84;1.52
100857;200209;Świetlica Środowiskowa|Sobolewo|ul. Szosa Baranowicka 94 |15-509 Białystok;1623;912;912;8;904;56.19;0.88
100858;200209;Świetlica Środowiskowa|Sobolewo|ul. Szosa Baranowicka 94 |15-509 Białystok;986;546;546;10;536;55.38;1.83
100859;200209;Zespół Szkół Sportowych|Supraśl|ul. Józefa Piłsudskiego 1 |16-030 Supraśl;1020;551;551;15;536;54.02;2.72
100860;200210;Miejsko - Gminny Ośrodek Kultury w Surażu|Suraż|ul.Bielska 4 |18-105 Suraż;875;467;467;19;448;53.37;4.07
100861;200210;Siedziba Stowarzyszenia "Nasze Zawyki"|Zawyki| 110 |18-105 Suraż;298;153;153;4;149;51.34;2.61
100862;200210;Świetlica Wiejska w Rynkach|Rynki| 3 |18-105 Suraż;213;125;125;3;122;58.69;2.40
100863;200210;Siedziba Stowarzyszenia "Zielona Szkoła w Doktorcach "|Doktorce| 1 |18-105 Suraż;236;128;128;0;128;54.24;0.00
100864;200211;Urząd Gminy w Turośni Kościelnej|Turośń Kościelna|ul. Białostocka 5 |18-106 Turośń Kościelna;1407;837;837;19;818;59.49;2.27
100865;200211;Szkoła Podstawowa w Turośni Dolnej|Turośń Dolna| 20 |18-106 Turośń Kościelna;779;461;461;14;447;59.18;3.04
100866;200211;Szkoła Podstawowa w Tołczach|Tołcze| 6 |18-106 Turośń Kościelna;1102;534;534;21;513;48.46;3.93
100867;200211;Świetlica wiejska w Baciutach|Baciuty| 41 |18-106 Turośń Kościelna;420;219;219;7;212;52.14;3.20
100868;200211;Świetlica wiejska w Niewodnicy Koryckiej|Niewodnica Korycka|ul. Tadeusza Kościuszki 52 |18-106 Turośń Kościelna;1036;679;679;9;670;65.54;1.33
100869;200212;Zespół Szkół i Przedszkole w Tykocinie|Tykocin|ul. Kochanowskiego 1 |16-080 Tykocin;1595;818;818;26;792;51.29;3.18
100870;200212;Budynek OSP w Jeżewie Starym|Jeżewo Stare| 28 |16-080 Tykocin;684;279;279;7;272;40.79;2.51
100871;200212;Budynek OSP w Sanikach|Saniki| 18A |16-080 Tykocin;437;208;208;8;200;47.60;3.85
100872;200212;Budynek po byłej Szkole Podstawowej w Łaziukach|Łaziuki| 23 |16-080 Tykocin;518;179;179;4;175;34.56;2.23
100873;200212;Budynek OSP w Łopuchowie|Łopuchowo| 14 |16-080 Tykocin;392;161;161;3;158;41.07;1.86
100874;200212;Świetlica wiejska w Siekierkach|Siekierki| 5 |16-080 Tykocin;599;234;234;9;225;39.07;3.85
100875;200212;Zespół Szkół w Radulach|Radule| 87 |16-080 Tykocin;730;273;273;5;268;37.40;1.83
100876;200212;Świetlica wiejska w Sierkach|Sierki| 88 |16-080 Tykocin;234;132;132;4;128;56.41;3.03
100877;200212;Dom Pomocy Społecznej pw. Św. Franciszka z Asyżu|Tykocin|Klasztorna 1 |16-080 Tykocin;40;33;33;1;32;82.50;3.03
100878;200213;Gimnazjum im. Ks. W. Rabczyńskiego|Wasilków|ul. Mickiewicza 2 |16-010 Wasilków;1903;986;986;22;964;51.81;2.23
100879;200213;Szkoła Podstawowa im. króla Zygmunta Augusta|Wasilków|ul. Polna 1/4a |16-010 Wasilków;2163;1075;1075;28;1047;49.70;2.60
100880;200213;Przedszkole|Wasilków|ul. Sienkiewicza 24 |16-010 Wasilków;1435;743;743;9;734;51.78;1.21
100881;200213;Szkoła Podstawowa|Studzianki|ul. Supraślska 2 |16-010 Wasilków;1272;534;534;19;515;41.98;3.56
100882;200213;Szkoła Podstawowa|Sochonie|Kościelna 1 |16-010 Wasilków;1918;1023;1023;21;1002;53.34;2.05
100883;200213;Przedszkole|Wasilków|ul. Polna 1/4c |16-010 Wasilków;1431;814;814;7;807;56.88;0.86
100884;200213;Przedszkole|Wasilków|ul. Polna 1/4c |16-010 Wasilków;1641;875;875;11;864;53.32;1.26
100885;200214;Szkoła Podstawowa w Zabłudowie|Zabłudów|ul. Adama Mickiewicza 20 |16-060 Zabłudów;559;273;273;9;264;48.84;3.30
100886;200214;Szkoła Podstawowa w Dobrzyniówce|Dobrzyniówka| 40 |16-060 Zabłudów;543;190;190;16;174;34.99;8.42
100887;200214;Szkoła Podstawowa w Rafałówce|Rafałówka| 64 |16-060 Zabłudów;734;298;298;11;287;40.60;3.69
100888;200214;Strażnica OSP w Folwarkach Wielkich|Folwarki Wielkie| 7/1 |16-060 Zabłudów;448;193;193;4;189;43.08;2.07
100889;200214;Była Szkoła Podstawowa w Zwierkach|Zwierki| 43 |16-060 Zabłudów;1052;489;489;21;468;46.48;4.29
100890;200214;Wiejski Dom Kultury w Krynickich|Krynickie| 55 |16-060 Zabłudów;490;277;277;7;270;56.53;2.53
100891;200214;Wiejski Dom Kultury w Rybołach|Ryboły| 129 |16-060 Zabłudów;980;312;312;15;297;31.84;4.81
100892;200214;Świetlica Wiejska w Halickich|Halickie| 3 |15-593 Białystok;499;247;247;7;240;49.50;2.83
100893;200214;Szkoła Podstawowa w Zabłudowie|Zabłudów|Adama Mickiewicza 20 |16-060 Zabłudów;974;478;478;14;464;49.08;2.93
100894;200214;Szkoła Podstawowa w Zabłudowie|Zabłudów|Adama Mickiewicza 20 |16-060 Zabłudów;1018;483;483;14;469;47.45;2.90
100895;200215;Sala Widowiskowa Urzędu Gminy Zawady|Zawady|Pl.Wolności 12 |16-075 Zawady;1583;673;673;21;652;42.51;3.12
100896;200215;Świetlica w Nowych Chlebiotkach|Nowe Chlebiotki| 38 |16-075 Zawady;792;297;297;8;289;37.50;2.69
100897;200301;Liceum Ogólnokształcące im. Tadeusza Kościuszki|Bielsk Podlaski|ul. 11 Listopada 6 |17-100 Bielsk Podlaski;936;415;415;9;406;44.34;2.17
100898;200301;Gimnazjum Nr 1 im. Niepodległości Polski|Bielsk Podlaski|ul. Tadeusza Kościuszki 21 |17-100 Bielsk Podlaski;1163;569;569;10;559;48.93;1.76
100899;200301;Bielski Dom Kultury|Bielsk Podlaski|ul. 3 Maja 2 |17-100 Bielsk Podlaski;2018;910;910;24;886;45.09;2.64
100900;200301;Zespół Szkół Nr 1 im. Józefa Klemensa Piłsudskiego|Bielsk Podlaski|ul. Szkolna 12 |17-100 Bielsk Podlaski;1099;552;552;5;547;50.23;0.91
100901;200301;Zespół Szkół im. Adama Mickiewicza|Bielsk Podlaski|ul. Adama Mickiewicza 126 |17-100 Bielsk Podlaski;2121;964;964;21;943;45.45;2.18
100902;200301;Zespół Szkół Nr 3 im. Władysława Stanisława Reymonta|Bielsk Podlaski|ul. Widowska 1 |17-100 Bielsk Podlaski;1996;907;907;20;887;45.44;2.21
100903;200301;Miejska Biblioteka Publiczna|Bielsk Podlaski|ul. Kazimierzowska 14 |17-100 Bielsk Podlaski;2050;912;912;20;892;44.49;2.19
100904;200301;Zespół Szkół z Dodatkową Nauką Języka Białoruskiego im. Jarosława Kostycewicza|Bielsk Podlaski|ul. Józefa Poniatowskiego 9 |17-100 Bielsk Podlaski;1860;871;871;18;853;46.83;2.07
100905;200301;Przedszkole Nr 5 Krasnala Hałabały|Bielsk Podlaski|ul. Tadeusza Kościuszki 16 |17-100 Bielsk Podlaski;939;476;476;15;461;50.69;3.15
100906;200301;Zespół Szkół Nr 4 im. Ziemi Podlaskiej|Bielsk Podlaski|ul. Hołowieska 18 |17-100 Bielsk Podlaski;2189;1080;1080;20;1060;49.34;1.85
100907;200301;Zespół Szkół Specjalnych im. Jana Pawła II|Bielsk Podlaski|ul. Wojska Polskiego 17 |17-100 Bielsk Podlaski;1862;830;830;15;815;44.58;1.81
100908;200301;Szkoła Podstawowa Nr 2 im. kpt. Władysława Wysockiego|Bielsk Podlaski|ul. Władysława Wysockiego 6 |17-100 Bielsk Podlaski;1963;1001;1001;17;984;50.99;1.70
100909;200301;Agencja Restrukturyzacji i Modernizacji Rolnictwa|Bielsk Podlaski|ul. Białowieska 113 D |17-100 Bielsk Podlaski;1074;411;411;10;401;38.27;2.43
100910;200301;Samodzielny Publiczny ZOZ|Bielsk Podlaski|Kleszczelowska 1 |17-100 Bielsk Podlaski;95;35;35;1;34;36.84;2.86
100911;200302;Miejski Ośrodek Kultury w Brańku|Brańsk|ul. Rynek 19 |17-120 Brańsk;1508;768;768;20;748;50.93;2.60
100912;200302;Urząd Miasta w Brańsku|Brańsk|ul. Rynek 8 |17-120 Brańsk;1537;829;829;24;805;53.94;2.90
100913;200302;Dom Pomocy Społecznej im. Jana Pawła II|Brańsk|Jana Pawła II 12 |17-120 Brańsk;97;30;30;10;20;30.93;33.33
100914;200303;Zespół Szkół w Augustowie|Augustowo| 30 |17-100 Bielsk Podlaski;838;285;285;9;276;34.01;3.16
100915;200303;Szkoła Podstawowa im. Jana Pawła II w Łubinie Kościelnym|Łubin Kościelny| 40 |17-100 Bielsk Podlaski;817;370;370;5;365;45.29;1.35
100916;200303;Centrum Kultury Wiejskiej w Dubiażynie|Dubiażyn| 100 |17-106 Orla;691;228;228;9;219;33.00;3.95
100917;200303;Ośrodek Kultury Lokalnej w Pilikach|Piliki| 53 |17-100 Bielsk Podlaski;447;218;218;1;217;48.77;0.46
100918;200303;Sala Konferencyjna Urzędu Gminy w Bielsku Podlaskim|Bielsk Podlaski|ul. Mickiewicza 46 |17-100 Bielsk Podlaski;776;271;271;6;265;34.92;2.21
100919;200303;Ośrodek Kultury Lokalnej w Proniewiczach|Proniewicze| 12 |17-100 Bielsk Podlaski;453;195;195;6;189;43.05;3.08
100920;200303;Remiza Strażacka w Pasynkach|Pasynki| 30 |17-100 Bielsk Podlaski;787;200;200;8;192;25.41;4.00
100921;200303;Wiejski Dom Kultury w Rajsku|Rajsk| 57/2 |17-100 Bielsk Podlaski;761;250;250;11;239;32.85;4.40
100922;200303;Remiza Strażacka w Ploskach|Ploski| 88 |17-100 Bielsk Podlaski;508;130;130;8;122;25.59;6.15
100923;200304;Szkoła Podstawowa w Andryjankach|Andryjanki| 1 |17-111 Boćki;527;187;187;7;180;35.48;3.74
100924;200304;Gminny Ośrodek Kultury w Boćkach|Boćki|ul. Dubieńska 11 |17-111 Boćki;1475;690;690;13;677;46.78;1.88
100925;200304;Wiejski Dom Kultury w Nurcu|Nurzec| 34 |17-111 Boćki;762;232;232;12;220;30.45;5.17
100926;200304;Świetlica Wiejska we wsi Olszewo|Olszewo| 36 |17-111 Boćki;552;242;242;4;238;43.84;1.65
100927;200304;Świetlica Wiejska we wsi Sielc|Sielc| 37 |17-120 Brańsk;500;228;228;6;222;45.60;2.63
100928;200305;Gminny Ośrodek Upowszechniania Kultury w Kalnicy|Kalnica| 54 |17-120 Brańsk;614;259;259;6;253;42.18;2.32
100929;200305;Szkoła Podstawowa w Holonkach, Szkoła Filialna w Chojewie|Chojewo| 109 |17-120 Brańsk;337;183;183;2;181;54.30;1.09
100930;200305;Filia GOUK w Popławach|Popławy| 76 |17-120 Brańsk;798;337;337;9;328;42.23;2.67
100931;200305;Remiza OSP Klichy|Klichy| 98 |17-120 Brańsk;328;178;178;6;172;54.27;3.37
100932;200305;Szkoła Podstawowa w Domanowie|Domanowo| 19a |17-120 Brańsk;924;488;488;18;470;52.81;3.69
100933;200305;Szkoła Podstawowa w Domanowie, Szkoła Filialna w Świrydach|Świrydy| 2 |17-120 Brańsk;662;302;302;6;296;45.62;1.99
100934;200305;Publiczne Gimnazjum w Glinniku|Glinnik| 40c |17-120 Brańsk;713;403;403;10;393;56.52;2.48
100935;200305;Remiza OSP Szmurły|Szmurły| 31 |17-120 Brańsk;401;164;164;7;157;40.90;4.27
100936;200305;Remiza OSP Lubieszcze|Lubieszcze| 39A |17-120 Brańsk;273;152;152;6;146;55.68;3.95
100937;200306;Świetlica Gminnego Ośrodka Kultury w Orli|Orla|ul. Spółdzielcza 1 |17-106 Orla;786;333;333;9;324;42.37;2.70
100938;200306;Zespół Szkół z dodatkowym nauczaniem języka białoruskiego im. Ziemi Orlańskiej w Orli|Orla|ul. Bielska 32 |17-106 Orla;872;269;269;17;252;30.85;6.32
100939;200306;Świetlica wiejska w Paszkowszczyźnie|Paszkowszczyzna| 80 |17-106 Orla;316;94;94;7;87;29.75;7.45
100940;200306;Świetlica wiejska w Dydulach|Dydule| 60 |17-106 Orla;329;98;98;1;97;29.79;1.02
100941;200306;Świetlica wiejska w Wólce Wygonowskiej|Wólka Wygonowska| 62b |17-106 Orla;275;84;84;8;76;30.55;9.52
100942;200307;Świetlica Wiejska|Rudka|ul.Wolności 1 |17-123 Rudka;1246;537;537;15;522;43.10;2.79
100943;200307;Świetlica Wiejska|Koce Borowe| 1 |17-123 Rudka;365;166;166;7;159;45.48;4.22
100944;200308;Szkoła Podstawowa im. Prezydenta Ryszarda Kaczorowskiego w Strabli|Strabla|ul. Wesoła 2A |17-132 Wyszki;815;371;371;17;354;45.52;4.58
100945;200308;Szkoła Podstawowa im. ks. F. J. Falkowskiego w Topczewie|Topczewo|ul. Szkolna 2 |17-132 Wyszki;1298;648;648;17;631;49.92;2.62
100946;200308;Urząd Gminy Wyszki|Wyszki|ul. Piórkowska 2 |17-132 Wyszki;1676;848;848;4;844;50.60;0.47
100947;200401;Zespół Szkół Nr 1 w Grajewie|Grajewo|ul. A. Mickiewicza 3 |19-200 Grajewo;1595;766;766;18;748;48.03;2.35
100948;200401;Szkoła Podstawowa Nr 2 w Grajewie|Grajewo|ul. A. Mickiewicza 2 |19-200 Grajewo;1488;603;603;20;583;40.52;3.32
100949;200401;Przedszkole Miejskie Nr 4 w Grajewie|Grajewo|ul. Ełcka 31 |19-200 Grajewo;1514;626;626;14;612;41.35;2.24
100950;200401;Zespół Szkół Specjalnych w Grajewie|Grajewo|ul. Ełcka 11 |19-200 Grajewo;755;365;365;10;355;48.34;2.74
100951;200401;Publiczne Gimnazjum Nr 1 w Grajewie|Grajewo|ul. Szkolna 12 |19-200 Grajewo;1260;522;522;14;508;41.43;2.68
100952;200401;Szkoła Podstawowa Nr 1 w Grajewie|Grajewo|ul. Szkolna 12 |19-200 Grajewo;1074;450;450;13;437;41.90;2.89
100953;200401;Miejski Dom Kultury w Grajewie|Grajewo|ul. Wojska Polskiego 20 |19-200 Grajewo;1372;595;595;15;580;43.37;2.52
100954;200401;Publiczne Gimnazjum Nr 3 w Grajewie|Grajewo|ul. Konstytucji 3-go Maja 23 |19-200 Grajewo;1587;648;648;21;627;40.83;3.24
100955;200401;Szkoła Podstawowa Nr 4 w Grajewie|Grajewo|ul. Konstytucji 3-go Maja 23 |19-200 Grajewo;1277;574;574;14;560;44.95;2.44
100956;200401;Przedszkole Miejskie Nr 6 w Grajewie|Grajewo|os. Południe 34 |19-200 Grajewo;1229;568;568;19;549;46.22;3.35
100957;200401;Przedszkole Miejskie Nr 2 w Grajewie|Grajewo|ul. Krasickiego 2 |19-200 Grajewo;1519;722;722;32;690;47.53;4.43
100958;200401;Środowiskowy Dom Samopomocy w Grajewie|Grajewo|ul. Konstytucji 3-go Maja 2B |19-200 Grajewo;1507;627;627;14;613;41.61;2.23
100959;200401;Zespół Szkół Nr 2 w Grajewie|Grajewo|ul. Wojska Polskiego 84 |19-200 Grajewo;1146;466;466;18;448;40.66;3.86
100960;200401;Szpital Ogólny w Grajewie|Grajewo|ul. Konstytucji 3 Maja 34 |19-200 Grajewo;89;47;47;7;40;52.81;14.89
100961;200402;Urząd Gminy Grajewo|Grajewo|ul. Komunalna 6 |19-200 Grajewo;899;291;291;17;274;32.37;5.84
100962;200402;Szkoła Podstawowa w Wierzbowie|Wierzbowo| 72 |19-200 Grajewo;969;369;369;9;360;38.08;2.44
100963;200402;Szkoła Podstawowa w Rudzie|Ruda|ul. Szkolna 8 |19-200 Grajewo;637;248;248;8;240;38.93;3.23
100964;200402;Szkoła Podstawowa w Białaszewie|Białaszewo|ul. Mikołaja Kopernika 2 |19-200 Grajewo;822;304;304;8;296;36.98;2.63
100965;200402;Gimnazjum w Danówku|Danówek| 7 |19-200 Grajewo;777;306;306;7;299;39.38;2.29
100966;200402;Świetlica Wiejska w Ciemnoszyjach|Ciemnoszyje| 54 |19-200 Grajewo;540;183;183;9;174;33.89;4.92
100967;200403;Świetlica wiejska w Łojach-Awissa|Łoje-Awissa| 1 |19-213 Radziłów;321;165;167;2;163;51.40;1.21
100968;200403;Świetlica wiejska w Glinkach|Glinki| |19-213 Radziłów;205;66;66;2;64;32.20;3.03
100969;200403;Słucz - Filia nr I Biblioteki Samorządowej|Słucz| |19-213 Radziłów;659;216;216;9;207;32.78;4.17
100970;200403;Szkoła Podstawowa w Kramarzewie|Kramarzewo| 1 |19-213 Radziłów;519;227;227;11;216;43.74;4.85
100971;200403;Szkoła Podstawowa w Klimaszewinicy|Klimaszewnica| 41 |19-213 Radziłów;407;112;112;6;106;27.52;5.36
100972;200403;Szkoła Podstawowa w Mścichach|Mścichy| 33 |19-213 Radziłów;350;116;116;2;114;33.14;1.72
100973;200403;Świetlica wiejska w Karwowie|Karwowo| |19-213 Radziłów;402;187;187;4;183;46.52;2.14
100974;200403;Centrum Kultury w Radziłowie|Radziłów|Plac 500-lecia 15 |19-213 Radziłów;1151;423;423;19;404;36.75;4.49
100975;200404;Urząd Miejski w Rajgrodzie|Rajgród|ul.Warszawska 32 |19-206 Rajgród;1749;627;627;23;604;35.85;3.67
100976;200404;Remiza OSP w Woźnejwsi|Woźnawieś| 85 |19-206 Rajgród;577;171;171;7;164;29.64;4.09
100977;200404;Niepubliczna Szkoła Podstawowa w Bełdzie|Bełda| 37 |19-206 Rajgród;616;160;160;17;143;25.97;10.62
100978;200404;Świetlica Zakładowa Instytutu Technologiczno-Przyrodniczego w Falentach Zakład Doświadczalny w Biebrzy|Biebrza|ul.Spacerowa 2 |19-206 Rajgród;472;154;154;15;139;32.63;9.74
100979;200404;Szkoła Podstawowa w Rydzewie|Rydzewo| 6 |19-206 Rajgród;977;318;318;15;303;32.55;4.72
100980;200405;Zespół Szkolno - Przedszkolny w Szczuczynie|Szczuczyn|ul. Kilińskiego 42 |19-230 Szczuczyn;1125;428;428;21;407;38.04;4.91
100981;200405;Publiczne Gimnazjum w Szczuczynie|Szczuczyn|Plac Tysiąclecia 15 |19-230 Szczuczyn;1094;415;415;13;402;37.93;3.13
100982;200405;Świetlica wiejska w Skajach|Skaje| 53 |19-230 Szczuczyn;640;242;242;10;232;37.81;4.13
100983;200405;Remiza Ochotniczej Straży Pożarnej w Szczuczynie|Szczuczyn|ul. Strażacka 11 |19-230 Szczuczyn;921;350;350;12;338;38.00;3.43
100984;200405;Zespół Szkół w Niećkowie|Niećkowo| 63 |19-230 Szczuczyn;759;264;264;17;247;34.78;6.44
100985;200405;Szkoła Podstawowa w Niedźwiadnej|Niedźwiadna| 49 |19-230 Szczuczyn;617;220;220;18;202;35.66;8.18
100986;200406;Urząd Gminy Wąsosz|Wąsosz|Plac Rzędzina 8 |19-222 Wąsosz;1025;393;393;21;372;38.34;5.34
100987;200406;Szkoła Podstawowa w Ławsku|Ławsk| 107 |19-222 Wąsosz;844;313;313;11;302;37.09;3.51
100988;200406;Szkoła Podstawowa w Sulewie-Kownatach|Sulewo-Kownaty| |19-222 Wąsosz;597;240;240;13;227;40.20;5.42
100989;200406;Gimnazjum w Wąsoszu|Wąsosz|ul.Piaskowa 13 |19-222 Wąsosz;570;224;224;6;218;39.30;2.68
100990;200501;Hajnowski Dom Kultury|Hajnówka|ul. Tamary Sołoniewicz 4 |17-200 Hajnówka;1612;785;785;19;766;48.70;2.42
100991;200501;Zespół Szkół Nr 2 z Oddziałami Integracyjnymi|Hajnówka|ul. Walerego Wróblewskiego 2 |17-200 Hajnówka;1478;587;587;15;572;39.72;2.56
100992;200501;Zespół Szkół Nr 3|Hajnówka|ul. Nowowarszawska 20 |17-200 Hajnówka;1556;695;695;19;676;44.67;2.73
100993;200501;Przedszkole Nr 1|Hajnówka|ul. Władysława Jagiełły 7 |17-200 Hajnówka;1653;668;668;31;637;40.41;4.64
100994;200501;Przedszkole Nr 3 z Oddziałami Integracyjnymi|Hajnówka|ul. Rzeczna 3 |17-200 Hajnówka;1863;822;822;22;800;44.12;2.68
100995;200501;Miejski Ośrodek Pomocy Społecznej|Hajnówka|ul. 11 Listopada 24 |17-200 Hajnówka;855;326;326;10;316;38.13;3.07
100996;200501;Samodzielny Publiczny Zakład Opieki Zdrowotnej|Hajnówka|ul. Doc. Adama Dowgirda 9 |17-200 Hajnówka;957;453;453;7;446;47.34;1.55
100997;200501;Zespół Szkół z Dodatkową Nauką Języka Białoruskiego|Hajnówka|ul. Marszałka Józefa Piłsudskiego 3 |17-200 Hajnówka;1650;741;741;13;728;44.91;1.75
100998;200501;Zespół Szkół Nr 1|Hajnówka|ul. 3 Maja 54 |17-200 Hajnówka;1613;677;677;26;651;41.97;3.84
100999;200501;Zespół Szkół Nr 3|Hajnówka|ul. Nowowarszawska 20 |17-200 Hajnówka;801;371;371;7;364;46.32;1.89
101000;200501;Przedszkole Nr 5 z Oddziałami Żłobkowymi|Hajnówka|ul. Mikołaja Reja 2 |17-200 Hajnówka;1778;806;806;24;782;45.33;2.98
101001;200501;Szkoła Podstawowa Nr 3|Hajnówka|ul. Działowa 1 |17-200 Hajnówka;1838;846;846;30;816;46.03;3.55
101002;200501;Sala konferencyjna Samodzielnego Publicznego Zakładu Opieki Zdrowotnej|Hajnówka|ul. Doc. Adama Dowgirda 9 |17-200 Hajnówka;153;45;45;1;44;29.41;2.22
101003;200501;Świetlica Zakładu Pielęgnacyjno-Opiekuńczego Samodzielnego Publicznego Zakładu Opieki Zdrowotnej|Hajnówka|ul. 11 Listopada 20 |17-200 Hajnówka;44;6;6;0;6;13.64;0.00
101004;200501;Areszt Śledczy|Hajnówka|ul. Warszawska 67 |17-200 Hajnówka;212;121;121;17;104;57.08;14.05
101005;200502;Białowieski Ośrodek Kultury|Białowieża|ul.Sportowa 1 |17-230 Białowieża;1644;747;747;17;730;45.44;2.28
101006;200502;Klub Kultury|Budy| 36a |17-230 Białowieża;253;92;92;2;90;36.36;2.17
101007;200502;Dom Pomocy Społecznej "Rokitnik"|Białowieża|Centura 2 |17-230 Białowieża;50;16;16;2;14;32.00;12.50
101008;200503;Gminny Ośrodek Kultury w Czeremsze|Czeremcha|ul. 1-go Maja 77 |17-240 Czeremcha;2055;839;839;32;807;40.83;3.81
101009;200503;Zespół Szkolno-Przedszkolny w Czeremsze Szkoła Podstawowa|Czeremcha|ul. Szkolna 2 |17-240 Czeremcha;844;256;256;14;242;30.33;5.47
101010;200504;Sala konferencyjna Nr 4 W Urzedzie Gminy Czyże|Czyże| 98 |17-207 Czyże;687;251;251;8;243;36.54;3.19
101011;200504;Świetlica Wiejska w Klejnikach|Klejniki| 51 |17-207 Czyże;454;145;145;5;140;31.94;3.45
101012;200504;Świetlica wiejska w Kuraszewie|Kuraszewo| 14a |17-207 Czyże;503;169;169;4;165;33.60;2.37
101013;200504;Świetlica wiejska w Zbuczu|Zbucz| 65 |17-207 Czyże;285;98;98;3;95;34.39;3.06
101014;200505;Zespół Szkolno-Oświatowy|Dubicze Cerkiewne|ul.Parkowa 30 |17-204 Dubicze Cerkiewne;815;318;320;19;299;39.02;5.97
101015;200505;Świetlica wiejska w Starym Korninie|Stary Kornin| 62 |17-204 Dubicze Cerkiewne;422;142;142;12;130;33.65;8.45
101016;200505;Świetlica wiejska w Wojnówce|Wojnówka| 34 |17-204 Dubicze Cerkiewne;245;78;78;4;74;31.84;5.13
101017;200506;Zespół Szkół w Dubinach|Dubiny|ul. Główna 1b |17-200 Hajnówka;532;205;205;9;196;38.53;4.39
101018;200506;Gminne Centrum Kultury w Dubinach|Dubiny|ul. Główna 116 |17-200 Hajnówka;511;240;240;6;234;46.97;2.50
101019;200506;Świetlica Wiejska w Nowosadach|Nowosady| 114 |17-200 Hajnówka;566;194;194;10;184;34.28;5.15
101020;200506;Szkoła Podstawowa w Nowokorninie|Nowokornino| 147 |17-200 Hajnówka;453;134;134;4;130;29.58;2.99
101021;200506;Świetlica Wiejska w Nowoberezowie|Nowoberezowo| 86 |17-200 Hajnówka;490;161;161;6;155;32.86;3.73
101022;200506;Świetlica Wiejska w Mochnatem|Mochnate| 58 |17-200 Hajnówka;419;148;148;5;143;35.32;3.38
101023;200506;Niepubliczna Szkoła Podstawowa w Orzeszkowie|Orzeszkowo| 2 |17-200 Hajnówka;484;145;145;6;139;29.96;4.14
101024;200507;Miejski Ośrodek Kultury, Sportu i Rekreacji w Kleszczelach|Kleszczele|ul. 1 Maja 19 |17-250 Kleszczele;1358;569;569;18;551;41.90;3.16
101025;200507;Świetlica Wiejska w Policznej|Policzna| 84 |17-250 Kleszczele;194;70;70;3;67;36.08;4.29
101026;200507;Świetlica Wiejska w Daszach|Dasze| 40 |17-250 Kleszczele;368;129;129;5;124;35.05;3.88
101027;200507;Świetlica Wiejska w Sakach|Saki| 35 |17-250 Kleszczele;369;143;143;5;138;38.75;3.50
101028;200508;Urząd Gminy w Narwi|Narew|ul. Mickiewicza 101 |17-210 Narew;1727;672;672;30;642;38.91;4.46
101029;200508;Świetlica wiejska w Łosince|Łosinka| 41 |17-210 Narew;544;157;157;10;147;28.86;6.37
101030;200508;Świetlica wiejska w Tyniewiczach Dużych|Tyniewicze Duże| 57 |17-210 Narew;269;83;83;9;74;30.86;10.84
101031;200508;Świetlica wiejska w Trześciance|Trześcianka| 90 |17-210 Narew;424;150;150;8;142;35.38;5.33
101032;200508;Świetlica wiejska w Janowie|Janowo| 37 |17-210 Narew;242;57;57;1;56;23.55;1.75
101033;200509;Gminny Ośrodek Kultury w Narewce|Narewka|ul. Nowa 3A |17-220 Narewka;958;398;398;13;385;41.54;3.27
101034;200509;Zespół Szkół w Narewce|Narewka|ul. Nowa 4 |17-220 Narewka;849;281;281;6;275;33.10;2.14
101035;200509;Świetlica samorządowa w Siemianówce|Siemianówka|Szkolna 37 |17-220 Narewka;626;246;246;9;237;39.30;3.66
101036;200509;Swietlica samorządowa w Lewkowie Starym|Lewkowo Stare| 62 |17-220 Narewka;861;306;306;6;300;35.54;1.96
101037;200601;Szkoła Podstawowa Nr 1 w Kolnie|Kolno|ul. Wojska Polskiego 22 |18-500 Kolno;606;254;254;11;243;41.91;4.33
101038;200601;Kolneński Ośrodek Kultury i Sportu w Kolnie|Kolno|ul. Marii Konopnickiej 4 |18-500 Kolno;626;264;264;9;255;42.17;3.41
101039;200601;Szkoła Podstawowa Nr 2 w Kolnie|Kolno|ul. Szkolna 8 |18-500 Kolno;1157;454;454;16;438;39.24;3.52
101040;200601;Zakład Doskonalenia Zawodowego w Kolnie|Kolno|ul. Księcia Janusza I 40 |18-500 Kolno;1106;500;500;11;489;45.21;2.20
101041;200601;Zespół Szkół Technicznych w Kolnie|Kolno|ul. Teofila Kubraka 6 |18-500 Kolno;907;394;394;13;381;43.44;3.30
101042;200601;Starostwo Powiatowe w Kolnie|Kolno|ul. 11 Listopada 1 |18-500 Kolno;996;390;390;5;385;39.16;1.28
101043;200601;Zespół Szkół Ponadgimnazjalnych w Kolnie|Kolno|ul. Wojska Polskiego 34 |18-500 Kolno;1057;460;460;21;439;43.52;4.57
101044;200601;Przedszkole Miejskie Nr 4 w Kolnie|Kolno|ul. Wojska Polskiego 65A |18-500 Kolno;1267;587;587;9;578;46.33;1.53
101045;200601;Gimnazjum w Kolnie|Kolno|ul. Marii Dąbrowskiej 4 |18-500 Kolno;718;287;287;9;278;39.97;3.14
101046;200601;Szpital Ogólny w Kolnie|Kolno|Wojska Polskiego 69 |18-500 Kolno;84;17;17;0;17;20.24;0.00
101047;200602;Świetlica w Grabowie|Grabowo|ul. Kpt. Adama Gątkiewicza 31 |18-507 Grabowo;374;160;160;12;148;42.78;7.50
101048;200602;Urząd Gminy w Grabowie|Grabowo|ul. Gen. Władysława Sikorskiego 1 |18-507 Grabowo;864;322;322;13;309;37.27;4.04
101049;200602;Szkoła Podstawowa w Grabowie|Grabowo|ul.Szkolna 7 |18-507 Grabowo;950;392;392;15;377;41.26;3.83
101050;200602;Szkoła Podstawowa w Surałach|Surały| 22 |18-507 Grabowo;452;194;194;7;187;42.92;3.61
101051;200602;Remiza OSP w Siwkach|Siwki| 8 |18-507 Grabowo;259;89;89;3;86;34.36;3.37
101052;200603;Centrum Kulturalno-Rozrywkowe w Czerwonem|Czerwone| 50 |18-500 Kolno;769;286;286;20;266;37.19;6.99
101053;200603;Centrum Kultury Gminy Kolno w Koźle|Kozioł| 41 |18-500 Kolno;606;206;206;11;195;33.99;5.34
101054;200603;Cenrtum Kulturalno-Rozrywkowe w Zabielu|Zabiele| 165 |18-500 Kolno;817;382;382;18;364;46.76;4.71
101055;200603;Szkoła Podstawowa w Janowie|Janowo| 35 |18-500 Kolno;681;224;224;7;217;32.89;3.12
101056;200603;Szkoła Podstawowa w Borkowie|Borkowo| 72 |18-500 Kolno;596;271;271;14;257;45.47;5.17
101057;200603;Szkoła Podstawowa w Wykowie|Wykowo| 14 |18-500 Kolno;655;281;281;10;271;42.90;3.56
101058;200603;Szkoła Podstawowa w Zaskrodziu|Zaskrodzie| 66 |18-500 Kolno;580;239;239;7;232;41.21;2.93
101059;200603;Remiza OSP w Starym Gromadzynie|Stary Gromadzyn| 27A |18-500 Kolno;434;226;226;4;222;52.07;1.77
101060;200603;Centrum Kulturalno-Rozrywkowe w Lachowie|Lachowo| 64 |18-500 Kolno;425;135;135;9;126;31.76;6.67
101061;200603;Szkoła Podstawowa w Lachowie|Lachowo| 21 |18-500 Kolno;775;311;311;13;298;40.13;4.18
101062;200603;Remiza OSP w Kumelsku|Kumelsk| 20 |18-500 Kolno;549;164;164;11;153;29.87;6.71
101063;200604;Szkoła Podstawowa w Kątach|Kąty| 168 |18-516 Mały Płock;816;268;268;8;260;32.84;2.99
101064;200604;Urząd Gminy w Małym Płocku|Mały Płock|ul. Kochanowskiego 15 |18-516 Mały Płock;1405;482;482;19;463;34.31;3.94
101065;200604;Gminny Ośrodek Kultury w Małym Płocku|Mały Płock|ul. Ciborowskiego 38 |18-516 Mały Płock;1420;580;580;29;551;40.85;5.00
101066;200604;Szkoła Podstawowa w Rogienicach Wielkich|Rogienice Wielkie|ul.Długa 1 |18-516 Mały Płock;386;151;151;10;141;39.12;6.62
101067;200605;Urząd Miejski w Stawiskach|Stawiski|ul. Plac Wolności 13/15 |18-520 Stawiski;1057;408;408;15;393;38.60;3.68
101068;200605;Gminny Ośrodek Kultury i Sportu w Stawiskach|Stawiski|ul. Krótka 4 |18-520 Stawiski;831;281;281;13;268;33.81;4.63
101069;200605;Szkoła Podstawowa im. Tadeusza Kościuszki w Stawiskach|Stawiski|ul. Polowa 12 |18-520 Stawiski;975;379;379;6;373;38.87;1.58
101070;200605;Szkoła Filialna w Jurcu Szlacheckim|Jurzec Szlachecki| 53 |18-520 Stawiski;297;142;142;2;140;47.81;1.41
101071;200605;Gimnazjum im. Adama Mickiewicza w Stawiskach|Stawiski|ul. Polowa 26 |18-520 Stawiski;555;182;182;3;179;32.79;1.65
101072;200605;Remiza OSP Wysokie Małe|Wysokie Małe| 3 |18-520 Stawiski;267;120;120;2;118;44.94;1.67
101073;200605;Szkoła Podstawowa w Porytem|Poryte|ul. Szkolna 23 |18-520 Stawiski;703;269;269;13;256;38.26;4.83
101074;200605;Szkoła Filialna w Budach Stawiskich|Budy Stawiskie| 1 |18-520 Stawiski;416;109;109;9;100;26.20;8.26
101075;200606;Gimnazjum im. Adama Mickiewicza w Turośli|Turośl|ul. Jana Pawła II 28A |18-525 Turośl;1056;484;484;21;463;45.83;4.34
101076;200606;Szkoła Podstawowa im. ks. Jana Twardowskiego w Turośli|Turośl|ul. Jana Pawła II 28 |18-525 Turośl;1063;510;510;24;486;47.98;4.71
101077;200606;Szkoła Podstawowa im. Marii Konopnickiej w Ptakach|Ptaki| 27 |18-525 Turośl;642;201;201;10;191;31.31;4.98
101078;200606;Szkoła Podstawowa im. Stanisława Krupki w Lemanie|Leman| 48 |18-525 Turośl;1213;462;462;9;453;38.09;1.95
101079;200701;Urząd Miejski w Jedwabnem|Jedwabne|ul.Żwirki i Wigury 3 |18-420 Jedwabne;873;338;338;20;318;38.72;5.92
101080;200701;Szkoła Podstawowa w Jedwabnem|Jedwabne|ul.Wojska Polskiego 17 |18-420 Jedwabne;886;375;375;9;366;42.33;2.40
101081;200701;Remiza OSP w Burzynie|Burzyn|ul. Cmentarna 5 |18-420 Jedwabne;1021;492;492;10;482;48.19;2.03
101082;200701;Miejsko Gminny Ośrodek Kultury w Jedwabnem|Jedwabne|ul.Piękna 8 |18-420 Jedwabne;954;407;407;15;392;42.66;3.69
101083;200701;Publiczne Gimnazjum w Jedwabnem|Jedwabne|ul. Mickiewicza 2 |18-420 Jedwabne;777;312;312;9;303;40.15;2.88
101084;200702;Szkoła Podstawowa|Jarnuty| 1 |18-400 Łomża;615;289;289;11;278;46.99;3.81
101085;200702;Szkoła Podstawowa|Nowe Kupiski| 137 |18-400 Łomża;1526;740;740;27;713;48.49;3.65
101086;200702;Świetlica Wiejska|Giełczyn|ul. Spokojna 12 |18-400 Łomża;592;270;270;12;258;45.61;4.44
101087;200702;Szkoła Podstawowa|Podgórze|ul. Szkolna 1 |18-400 Łomża;555;198;198;14;184;35.68;7.07
101088;200702;Szkoła Podstawowa|Puchały| 31 |18-400 Łomża;628;272;272;7;265;43.31;2.57
101089;200702;Szkoła Podstawowa|Wygoda|ul. Łomżyńska 2 |18-400 Łomża;1114;468;468;12;456;42.01;2.56
101090;200702;Szkoła Podstawowa|Pniewo|ul. Akacjowa 1 |18-400 Łomża;535;199;199;8;191;37.20;4.02
101091;200702;Szkoła Podstawowa|Czaplice| 59 |18-400 Łomża;423;200;200;12;188;47.28;6.00
101092;200702;Remiza Ochotniczej Straży Pożarnej|Chojny Młode| 1A |18-400 Łomża;480;223;223;8;215;46.46;3.59
101093;200702;Świetlica Wiejska|Jednaczewo|ul. Łomżyńska 77 |18-400 Łomża;443;248;248;9;239;55.98;3.63
101094;200702;Szkoła Podstawowa|Konarzyce|ul. Szkolna 4 |18-400 Łomża;857;477;477;10;467;55.66;2.10
101095;200702;Remiza Ochotniczej Straży Pożarnej|Siemień Nadrzeczny| 40 |18-400 Łomża;298;114;114;2;112;38.26;1.75
101096;200702;Sala Konferencyjna Urzędu Gminy|Łomża|ul. Marii Skłodowskiej Curie 1a |18-400 Łomża;712;385;385;6;379;54.07;1.56
101097;200703;Publiczne Gimnazjum w Miastkowie|Miastkowo|ul. Łomżyńska 10 |18-413 Miastkowo;723;299;299;9;290;41.36;3.01
101098;200703;Publiczne Gimnazjum w Miastkowie|Miastkowo|ul. Łomżyńska 10 |18-413 Miastkowo;840;365;365;19;346;43.45;5.21
101099;200703;Świetlica Wiejska w Miastkowie|Miastkowo|ul.Łomżyńska 32A |18-413 Miastkowo;792;256;256;8;248;32.32;3.12
101100;200703;Szkoła Podstawowa w Rydzewie|Rydzewo|ul.Mazurska 22 |18-413 Miastkowo;1036;433;433;23;410;41.80;5.31
101101;200704;Klub wiejski w Mątwicy|Mątwica| 76 |18-414 Nowogród;416;222;222;5;217;53.37;2.25
101102;200704;Miejsko-Gminny Ośrodek Kultury w Nowogrodzie|Nowogród|Łomżyńska 13 |18-414 Nowogród;1136;493;493;22;471;43.40;4.46
101103;200704;Zespół Szkół Samorządowych w Nowogrodzie|Nowogród|11 Listopada 12 |18-414 Nowogród;823;365;365;19;346;44.35;5.21
101104;200704;Zespół Szkół Samorządowych w Nowogrodzie|Nowogród|11 Listopada 12 |18-414 Nowogród;864;389;389;8;381;45.02;2.06
101105;200705;Szkoła Podstawowa w Piątnicy Poduchownej|Piątnica Poduchowna|ul. Szkolna 29 |18-421 Piątnica Poduchowna;1787;842;842;24;818;47.12;2.85
101106;200705;Publiczne Gimnazjum w Piątnicy Poduchownej|Piątnica Poduchowna|ul. Szkolna 31 |18-421 Piątnica Poduchowna;1164;436;436;14;422;37.46;3.21
101107;200705;Szkoła Podstawowa w Drozdowie|Drozdowo|ul. Główna 15 |18-421 Piątnica Poduchowna;1208;418;418;21;397;34.60;5.02
101108;200705;Szkoła Podstawowa w Jeziorku|Jeziorko| 42 |18-421 Piątnica Poduchowna;1004;385;385;16;369;38.35;4.16
101109;200705;Szkoła Podstawowa w Dobrzyjałowie|Dobrzyjałowo|ul. Zdrojowa 1 |18-421 Piątnica Poduchowna;1011;382;382;16;366;37.78;4.19
101110;200705;Szkoła Podstawowa w Olszynach|Olszyny|ul. Wiśniowa 19 |18-421 Piątnica Poduchowna;514;211;211;8;203;41.05;3.79
101111;200705;Szkoła Podstawowa w Rakowie-Boginiach|Rakowo-Boginie| 49 |18-421 Piątnica Poduchowna;529;154;154;4;150;29.11;2.60
101112;200705;Urząd Gminy Piątnica|Piątnica Poduchowna|ul. Stawiskowska 53 |18-421 Piątnica Poduchowna;1196;428;428;23;405;35.79;5.37
101113;200706;Agroturystyka Wilamowo|Wilamowo| 29 |18-423 Przytuły;368;118;118;3;115;32.07;2.54
101114;200706;Zespół Szkół w Przytułach|Przytuły|ul. Lipowa 28 |18-423 Przytuły;576;230;230;2;228;39.93;0.87
101115;200706;Szkoła Podstawowa w Wagach|Wagi| 16 |18-423 Przytuły;239;132;132;4;128;55.23;3.03
101116;200706;Świetlica Wiejska w Przytułach|Przytuły|ul. Lipowa 1 |18-423 Przytuły;576;233;233;8;225;40.45;3.43
101117;200707;Szkoła Podstawowa w Szczepankowie|Szczepankowo| 20 |18-411 Śniadowo;500;210;210;9;201;42.00;4.29
101118;200707;Szkoła Podstawowa w Szczepankowie|Szczepankowo| 20 |18-411 Śniadowo;788;380;380;14;366;48.22;3.68
101119;200707;Szkoła Podstawowa w Śniadowie|Śniadowo|ul. Łomżyńska 29 |18-411 Śniadowo;970;455;455;16;439;46.91;3.52
101120;200707;Szkoła Podstawowa w Śniadowie|Śniadowo|ul. Łomżyńska 29 |18-411 Śniadowo;1089;531;531;16;515;48.76;3.01
101121;200707;Gminny Ośrodek Kultury w Śniadowie|Śniadowo|ul. Ostrołęcka 13 |18-411 Śniadowo;1085;566;566;11;555;52.17;1.94
101122;200708;Budynek wielofunkcyjny w Bronowie (świetlica)|Bronowo|ul.Mostowa 5 |18-430 Wizna;342;152;152;5;147;44.44;3.29
101123;200708;Publiczna Szkoła Podstawowa w Starym Bożejewie (sala lekcyjna)|Stare Bożejewo| 37 |18-430 Wizna;402;148;148;6;142;36.82;4.05
101124;200708;Budynek wielofunkcyjny w Wiźnie (sala OSP)|Wizna|ul.Plac Kpt. Raginisa 35 |18-430 Wizna;1170;517;517;12;505;44.19;2.32
101125;200708;Gimnazjum w Wiźnie (sala gimnastyczna)|Wizna|ul.Plac Kpt.Raginisa 12 |18-430 Wizna;973;337;337;8;329;34.64;2.37
101126;200708;Szkoła Podstawowa w Rutkach (sala lekcyjna)|Rutki| |18-430 Wizna;570;272;272;4;268;47.72;1.47
101127;200709;Gminny Ośrodek Kultury w Zbójnej|Zbójna|ul.Łomżyńska 44 |18-416 Zbójna;989;379;379;19;360;38.32;5.01
101128;200709;Urząd Gminy w Zbójnej|Zbójna|ul. Łomżyńska 64 |18-416 Zbójna;695;272;272;10;262;39.14;3.68
101129;200709;Szkoła Podstawowa w Dobrym Lesie|Dobry Las| 65 |18-416 Zbójna;688;285;285;7;278;41.42;2.46
101130;200709;Świetlica Wiejska w Kuziach|Kuzie| 92 |18-416 Zbójna;738;257;257;15;242;34.82;5.84
101131;200709;Budynek Ochotniczej Straży Pożarnej w Osowcu|Osowiec| 16 |18-416 Zbójna;396;141;141;6;135;35.61;4.26
101132;200801;Gminny Ośrodek Kultury w Goniądzu|Goniądz|ul. Stary Rynek 23 |19-110 Goniądz;1938;789;789;18;771;40.71;2.28
101133;200801;Szkoła Podstawowa w Downarach|Downary| 52 |19-110 Goniądz;689;295;295;18;277;42.82;6.10
101134;200801;Szkoła Podstawowa w Klewiance|Klewianka| 114 |19-110 Goniądz;630;188;188;8;180;29.84;4.26
101135;200801;Remiza w Osowcu|Osowiec| 59A |19-110 Goniądz;405;162;162;9;153;40.00;5.56
101136;200801;Budynek po Szkole Podstawowej we Wroceniu|Wroceń| 86 |19-110 Goniądz;445;154;154;11;143;34.61;7.14
101137;200802;Zespół Szkolno-Przedszkolny|Jasionówka|ul.Knyszyńska 21B |19-122 Jasionówka;1184;504;504;11;493;42.57;2.18
101138;200802;Gminny Ośrodek Kultury,Sportu i Turystyki|Jasionówka|ul.Rynek 19 |19-122 Jasionówka;1218;522;522;19;503;42.86;3.64
101139;200803;Gminny Ośrodek Kultury w Jaświłach Filia w Dolistowie Starym|Dolistowo Stare| 110 |19-124 Jaświły;1840;597;597;19;578;32.45;3.18
101140;200803;Gminny Ośrodek Kultury w Jaświłach Filia w Brzozowej|Brzozowa| 42 |19-124 Jaświły;915;314;314;9;305;34.32;2.87
101141;200803;Sala Konferencyjna Urzędu Gminy Jaświły|Jaświły| 7 |19-124 Jaświły;1484;593;593;17;576;39.96;2.87
101142;200803;Sala ćwiczeń rehabilitacyjnych w Domu Pomocy Społecznej "Dom Kombatanta" w Mocieszach|Mociesze| 4A |19-124 Jaświły;35;18;18;3;15;51.43;16.67
101143;200804;Urząd Miejski w Knyszynie|Knyszyn|ul. Rynek 39 |19-120 Knyszyn;1683;728;728;25;703;43.26;3.43
101144;200804;Knyszyński Ośrodek Kultury w Knyszynie|Knyszyn|Rynek 39 |19-120 Knyszyn;1608;644;644;35;609;40.05;5.43
101145;200804;Zespół Szkół w Kalinówce Kościelnej|Kalinówka Kościelna| 36 |19-120 Knyszyn;694;292;292;11;281;42.07;3.77
101146;200805;Gminny Ośrodek Kultury w Krypnie|Krypno Wielkie| 9 |19-111 Krypno Kościelne;1754;709;709;26;683;40.42;3.67
101147;200805;Świetlica "Warszawa"|Długołęka| 49 |19-111 Krypno Kościelne;972;409;409;12;397;42.08;2.93
101148;200805;Świetlica wiejska w Zastoczu|Zastocze| 29A |19-111 Krypno Kościelne;510;204;204;1;203;40.00;0.49
101149;200806;Szkoła Podstawowa Nr 2|Mońki|ul. Tysiąclecia 17 |19-100 Mońki;1637;691;691;20;671;42.21;2.89
101150;200806;Zespół Szkół Ogólnokształcących i Zawodowych|Mońki|ul. Tysiąclecia 15 |19-100 Mońki;1725;690;690;18;672;40.00;2.61
101151;200806;Urząd Miejski w Mońkach|Mońki|ul. Juliusza Słowackiego 5a |19-100 Mońki;1606;597;597;14;583;37.17;2.35
101152;200806;Moniecki Ośrodek Kultury|Mońki|ul. Białostocka 25 |19-100 Mońki;1569;620;620;7;613;39.52;1.13
101153;200806;Gimnazjum|Mońki|ul. Leśna 3 |19-100 Mońki;1706;748;748;25;723;43.85;3.34
101154;200806;Zespół Szkół Ogólnokształcących i Zawodowych|Mońki|ul. Szkolna 22 |19-100 Mońki;1777;675;675;23;652;37.99;3.41
101155;200806;Zaespół Szkół w Mońkach|Mońki|ul. Planetarna 13 |19-100 Mońki;1001;450;450;9;441;44.96;2.00
101156;200806;Szkoła Podstawowa w Boguszewie|Boguszewo| 67 |19-100 Mońki;726;235;235;11;224;32.37;4.68
101157;200806;Szkoła Podstawowa w Kuleszach|Kulesze| 144 |19-100 Mońki;814;239;239;7;232;29.36;2.93
101158;200806;Samodzielny Publiczny Zakład Oieki Zdrowotnej w Mońkach|Mońki|Al. Niepodległości 9 |19-100 Mońki;87;42;42;2;40;48.28;4.76
101159;200806;Dom Pomocy Społecznej w Mońkach|Mońki|PCK 15 |19-100 Mońki;30;14;14;0;14;46.67;0.00
101160;200807;Gminny Ośrodek Kultury|Trzcianne|ul. Wojska Polskiego 10 |19-104 Trzcianne;1290;478;478;13;465;37.05;2.72
101161;200807;Gimnazjum|Trzcianne|ul. 3 Maja 9B |19-104 Trzcianne;1286;415;415;20;395;32.27;4.82
101162;200807;Świetlica|Wyszowate| 14 |19-104 Trzcianne;527;174;174;3;171;33.02;1.72
101163;200807;Szkoła Podstawowa|Laskowiec| 46 |19-104 Trzcianne;606;165;165;12;153;27.23;7.27
101164;200901;Szkoła Podstawowa im. mjr Henryka Dobrzańskiego "Hubala" w Sejnach|Sejny|ul. Wojska Polskiego 64 |16-500 Sejny;1442;572;572;16;556;39.67;2.80
101165;200901;Szkoła Podstawowa im. mjr Henryka Dobrzańskiego "Hubala" w Sejnach|Sejny|ul. Wojska Polskiego 64 |16-500 Sejny;1522;696;696;26;670;45.73;3.74
101166;200901;Komenda Powiatowa Państwowej Straży Pożarnej w Sejnach|Sejny|ul. Strażacka 2 |16-500 Sejny;1532;662;662;18;644;43.21;2.72
101167;200901;Samodzielny Publiczny Zakład Opieki Zdrowotnej w Sejnach|Sejny|Dr Edwarda Rittlera 1 |16-500 Sejny;29;12;12;1;11;41.38;8.33
101168;200902;Gimnazjum w Gibach|Giby| 75 |16-506 Giby;898;377;377;12;365;41.98;3.18
101169;200902;Świetlica Wiejska w Pogorzelcu|Pogorzelec| 23 |16-506 Giby;393;183;183;4;179;46.56;2.19
101170;200902;Budynek po Szkole Podstawowej we Frąckach|Frącki| 33 |16-506 Giby;497;217;217;5;212;43.66;2.30
101171;200902;Budynek po Szkole Podstawowej w Zelwie|Zelwa| 21 |16-506 Giby;227;97;97;3;94;42.73;3.09
101172;200902;Gminny Ośrodek Kultury w Gibach|Giby| 74A |16-506 Giby;377;104;104;2;102;27.59;1.92
101173;200903;Szkoła Podstawowa|Krasnopol|ul. W. Polskiego 63 |16-503 Krasnopol;891;285;285;9;276;31.99;3.16
101174;200903;Ośrodek Kultury, Sportu i Rekreacji|Krasnopol|ul. 1 Maja 1 |16-503 Krasnopol;830;391;391;11;380;47.11;2.81
101175;200903;Świetlica Wiejska|Maćkowa Ruda| 22 |16-503 Krasnopol;861;293;293;12;281;34.03;4.10
101176;200903;Budynek po Szkole Podstawowej|Jegliniec| 42 |16-503 Krasnopol;322;89;89;2;87;27.64;2.25
101177;200903;Mieszkanie prywatne|Remieńkiń| 22 |16-503 Krasnopol;263;91;91;3;88;34.60;3.30
101178;200904;Urząd Gminy|Puńsk|ul.Mickiewicza 23 |16-515 Puńsk;1370;375;375;19;356;27.37;5.07
101179;200904;Świetlica|Smolany| 9 |16-515 Puńsk;507;156;156;2;154;30.77;1.28
101180;200904;Szkoła Podstawowa|Widugiery| 19A |16-515 Puńsk;660;172;172;2;170;26.06;1.16
101181;200904;Szkoła Podstawowa|Puńsk|ul.11 Marca 16 |16-515 Puńsk;989;414;414;16;398;41.86;3.86
101182;200905;Urząd Gminy Sejny|Sejny|ul.Świerczewskiego 1 |16-500 Sejny;1555;592;592;7;585;38.07;1.18
101183;200905;Szkoła Podstawowa w Krasnowie|Krasnowo| 17 |16-500 Sejny;410;114;114;1;113;27.80;0.88
101184;200905;Świetlica OSP w Żegarach|Żegary| 40 |16-500 Sejny;414;116;116;3;113;28.02;2.59
101185;200905;Świetlica OSP w Ogrodnikach|Ogrodniki| 14 |16-500 Sejny;250;92;92;3;89;36.80;3.26
101186;200905;Budynek po Szkole Podstawowej w Berżnikach|Berżniki| 45b |16-500 Sejny;733;257;257;9;248;35.06;3.50
101187;201001;Szkoła Podstawowa Nr 1 w Siemiatyczach|Siemiatycze|ul. Ogrodowa 2 |17-300 Siemiatycze;1863;924;924;11;913;49.60;1.19
101188;201001;Siemiatycki Ośrodek Kultury w Siemiatyczach|Siemiatycze|ul. Zaszkolna 1 |17-300 Siemiatycze;1120;509;509;17;492;45.45;3.34
101189;201001;Szkoła Muzyczna I Stopnia w Siemiatyczach|Siemiatycze|ul. Leg. Piłsudskiego 1 |17-300 Siemiatycze;1304;614;614;19;595;47.09;3.09
101190;201001;Zespół Szkół z Oddziałami Integracyjnymi w Siemiatyczach|Siemiatycze|ul. Gen. Wł. Andersa 4 |17-300 Siemiatycze;2027;863;863;17;846;42.58;1.97
101191;201001;Przedszkole Nr 3 w Siemiatyczach|Siemiatycze|ul. 11 Listopada 24 |17-300 Siemiatycze;1890;814;815;25;789;43.07;3.07
101192;201001;Gimnazjum Nr 1 w Siemiatyczach|Siemiatycze|ul. Świętojańska 25 |17-300 Siemiatycze;688;275;275;5;270;39.97;1.82
101193;201001;Przedszkole Nr 5 w Siemiatyczach|Siemiatycze|ul. Gen. Wł. Andersa 9 |17-300 Siemiatycze;1927;881;881;23;858;45.72;2.61
101194;201001;Miejska Biblioteka Publiczna w Siemiatyczach|Siemiatycze|ul. Górna 23A |17-300 Siemiatycze;1002;522;522;7;515;52.10;1.34
101195;201001;Powiatowy Dom Pomocy Społecznej w Siemiatyczach|Siemiatycze|ul. Szpitalna 10 |17-300 Siemiatycze;61;25;25;3;22;40.98;12.00
101196;201001;Samodzielny Publiczny Zakład Opieki Zdrowotnej w Siemiatyczach Szpital Powiatowy w Siemiatyczach|Siemiatycze|ul. Szpitalna 8 |17-300 Siemiatycze;66;13;13;1;12;19.70;7.69
101197;201002;Drohiczyn, ul.Kraszewskiego 13, Kino ,,Daniel", wejście od strony ulicy Jagiellończyka.|Drohiczyn|Kraszewskiego 13 |17-312 Drohiczyn;1748;820;820;27;793;46.91;3.29
101198;201002;Drohiczyn, ul.Kraszewskiego 13, Kino ,,Daniel'', wejście od strony ulicy Kraszewskiego|Drohiczyn|Kraszewskiego 13 |17-312 Drohiczyn;1317;511;511;19;492;38.80;3.72
101199;201002;Szkoła Podstawowa, Miłkowice-Janki 14|Miłkowice-Janki| 14 |17-312 Drohiczyn;802;357;357;17;340;44.51;4.76
101200;201002;Szkoła Podstawowa, Ostrożany 14|Ostrożany| 14 |17-312 Drohiczyn;488;231;231;7;224;47.34;3.03
101201;201002;Szkoła Podstawowa, Śledzianów 1|Śledzianów| 1 |17-312 Drohiczyn;1055;369;369;9;360;34.98;2.44
101202;201003;Gminny Ośrodek Kultury w Dziadkowicach|Dziadkowice|Kąty 22 |17-306 Dziadkowice;873;409;409;5;404;46.85;1.22
101203;201003;Świetlica OSP w Żurobicach|Żurobice|Żurobice 17a |17-306 Dziadkowice;291;96;96;6;90;32.99;6.25
101204;201003;Świetlica Wiejska w Dołubowie|Dołubowo|Dołubowo 34 |17-306 Dziadkowice;624;251;251;4;247;40.22;1.59
101205;201003;Świetlica wiejska w Hornowie|Hornowo|Hornowo 43 |17-306 Dziadkowice;632;243;243;3;240;38.45;1.23
101206;201004;Budynek po byłej szkole w Czarnej Cerkiewnej|Czarna Cerkiewna| 45 |17-315 Grodzisk;454;160;160;9;151;35.24;5.62
101207;201004;Świetlica OSP w Grodzisku|Grodzisk|ul. 1 Maja 6 |17-315 Grodzisk;1029;475;475;18;457;46.16;3.79
101208;201004;Świetlica wiejska Sypnie Nowe|Sypnie Nowe| 43 |17-315 Grodzisk;778;342;342;2;340;43.96;0.58
101209;201004;Świetlica wiejska w Stadnikach|Stadniki| 44 |17-315 Grodzisk;594;271;271;7;264;45.62;2.58
101210;201004;Świetlica wiejska w Makarkach|Makarki| 35 |17-315 Grodzisk;730;316;316;10;306;43.29;3.16
101211;201005;Wiejski Ośrodek Kultury,Sportu i Rekreacji|Wilanowo| 72 |17-307 Mielnik;482;197;197;14;183;40.87;7.11
101212;201005;Świetlica Ochotniczej Straży Pożarnej|Mielnik|ul. Bugowa 10 |17-307 Mielnik;1177;556;556;14;542;47.24;2.52
101213;201005;Świetlica wiejska|Moszczona Królewska| 55 |17-307 Mielnik;586;222;222;7;215;37.88;3.15
101214;201006;Świetlica Wiejska w Milejczycach|Milejczyce|ul. Parkowa 20 |17-332 Milejczyce;833;348;348;11;337;41.78;3.16
101215;201006;Ochotnicza Straż Pożarna w Rogaczach|Rogacze| 11 |17-332 Milejczyce;312;115;115;10;105;36.86;8.70
101216;201006;Budynek byłej szkoły podstawowej w Wałkach|Wałki| 35 |17-332 Milejczyce;237;105;105;14;91;44.30;13.33
101217;201006;Ochotnicza Straż Pożarna w Sobiatynie|Sobiatyno| 70 |17-332 Milejczyce;138;37;37;2;35;26.81;5.41
101218;201006;Świetlica wiejska w Pokaniewie|Pokaniewo| 11 |17-332 Milejczyce;220;88;88;5;83;40.00;5.68
101219;201007;Świetlica OSP w Nurcu-Stacji|Nurzec-Stacja|ul. Nowa 1 |17-330 Nurzec-Stacja;1395;537;537;21;516;38.49;3.91
101220;201007;Zespół Szkolno-Przedszkolny w Nurcu-Stacji|Nurzec-Stacja|ul. Szkolna 6 |17-330 Nurzec-Stacja;1197;329;329;14;315;27.49;4.26
101221;201007;Świetlica wiejska w Siemichoczach|Siemichocze| 57 |17-330 Nurzec-Stacja;646;153;153;14;139;23.68;9.15
101222;201007;Budynek po Szkole Podstawowej w Klukowiczach|Klukowicze| 54 |17-330 Nurzec-Stacja;349;101;101;2;99;28.94;1.98
101223;201008;Świetlica wiejska|Borzymy| 16A |17-322 Perlejewo;206;104;104;1;103;50.49;0.96
101224;201008;Szkoła Podstawowa|Perlejewo| 45 |17-322 Perlejewo;1693;700;700;16;684;41.35;2.29
101225;201008;Nadbużańskie Centrum Turystyczne|Granne| 15 |17-322 Perlejewo;453;168;168;5;163;37.09;2.98
101226;201008;Świetlica wiejska|Kobyla| 4 |17-322 Perlejewo;157;51;51;4;47;32.48;7.84
101227;201009;Gimnazjum Gminne w Siemiatyczach|Siemiatycze|ul. Tadeusza Kościuszki 88 |17-300 Siemiatycze;437;109;109;7;102;24.94;6.42
101228;201009;Szkoła Podstawowa w Czartajewie|Czartajew|ul. Szkolna 4 |17-300 Siemiatycze;595;255;255;12;243;42.86;4.71
101229;201009;Świetlica wiejska w Kłopotach-Bańkach|Kłopoty-Bańki| 10a |17-300 Siemiatycze;660;285;285;9;276;43.18;3.16
101230;201009;Świetlica Wiejska w Krupicach|Krupice| 22 |17-300 Siemiatycze;679;186;186;6;180;27.39;3.23
101231;201009;Świetlica Wiejska w Bacikach Średnich|Baciki Średnie| 49 |17-300 Siemiatycze;1067;377;377;8;369;35.33;2.12
101232;201009;Centrum Kulturalno-Wypoczynkowe w Siemiatyczach-Stacji|Siemiatycze-Stacja|Drohiczńska 35 |17-300 Siemiatycze;969;387;387;10;377;39.94;2.58
101233;201009;Świetlica Wiejska w Wiercieniu Dużym|Wiercień Duży| 17 |17-300 Siemiatycze;325;125;125;2;123;38.46;1.60
101234;201009;Świetlica Wiejska w Skiwach Małych|Skiwy Małe| 26 |17-300 Siemiatycze;374;135;135;2;133;36.10;1.48
101235;201101;Zespół Szkół w Dąbrowie Białostockiej|Dąbrowa Białostocka|ul. Tysiąclecia PP 24 |16-200 Dąbrowa Białostocka;1515;703;703;12;691;46.40;1.71
101236;201101;Miejsko-Gminny Ośrodek Kultury|Dąbrowa Białostocka|ul. Tysiąclecia PP 4 |16-200 Dąbrowa Białostocka;1193;397;397;8;389;33.28;2.02
101237;201101;Szkoła Podstawowa|Dąbrowa Białostocka|ul. Południowa 13 |16-200 Dąbrowa Białostocka;1560;762;762;16;746;48.85;2.10
101238;201101;Gimnazjum w Dąbrowie Białostockiej|Dąbrowa Białostocka|ul. Szkolna 9a |16-200 Dąbrowa Białostocka;1151;577;577;16;561;50.13;2.77
101239;201101;Kino "Lotos"|Dąbrowa Białostocka|ul. Kunawina 1 |16-200 Dąbrowa Białostocka;814;361;361;12;349;44.35;3.32
101240;201101;Gimnazjum w Różanymstoku|Różanystok| 7 |16-200 Dąbrowa Białostocka;1104;420;420;16;404;38.04;3.81
101241;201101;Szkoła Podstawowa w Nierośnie|Nierośno| 33 |16-200 Dąbrowa Białostocka;832;308;308;19;289;37.02;6.17
101242;201101;Szkoła Podstawowa w Zwierzyńcu Wielkim|Zwierzyniec Wielki| 17 |16-200 Dąbrowa Białostocka;788;340;340;17;323;43.15;5.00
101243;201101;Szkoła Podstawowa w Suchodolinie|Suchodolina| 1 |16-200 Dąbrowa Białostocka;628;249;249;6;243;39.65;2.41
101244;201101;Świetlica Wiejska w Reszkowcach|Reszkowce| 28A |16-200 Dąbrowa Białostocka;368;173;173;5;168;47.01;2.89
101245;201101;Samodzielny Publiczny Zakład Opieki Zdrowotnej w Dąbrowie Białostockiej (szpital)|Dąbrowa Białostocka|Skłodowskiej 15 |16-200 Dąbrowa Białostocka;51;33;33;4;29;64.71;12.12
101246;201102;Zespół Szkół Samorządowych|Janów|ul. Białostocka 16 |16-130 Janów;1465;565;565;14;551;38.57;2.48
101247;201102;Szkoła Podstawowa|Białousy| 59 |16-130 Janów;702;282;282;5;277;40.17;1.77
101248;201102;Budynek byłej Szkoły Podstawowej|Nowowola| 32 |16-130 Janów;394;128;128;11;117;32.49;8.59
101249;201102;Urząd Gminy Janów|Janów|ul. Parkowa 3 |16-130 Janów;949;396;396;9;387;41.73;2.27
101250;201103;Świetlica Wiejska w Bombli|Bombla| 41 |16-140 Korycin;333;150;150;4;146;45.05;2.67
101251;201103;Gminny Ośrodek Kultury Sportu i Turystyki w Korycinie|Korycin|ul. Knyszyńska 2a |16-140 Korycin;1994;800;800;8;792;40.12;1.00
101252;201103;Budynek po byłym Domu Nauczyciela w Zabrodziu|Zabrodzie| 1A |16-140 Korycin;354;124;124;3;121;35.03;2.42
101253;201104;Mieszkanie prywatne|Górany| 46 |16-120 Krynki;192;75;75;2;73;39.06;2.67
101254;201104;Mieszkanie prywatne|Kruszyniany| 51 A |16-120 Krynki;398;111;111;5;106;27.89;4.50
101255;201104;Urząd Miejski w Krynkach|Krynki|ul. Garbarska 16 |16-120 Krynki;1290;598;598;15;583;46.36;2.51
101256;201104;Gminny Ośrodek Kultury w Krynkach|Krynki|ul. Grodzieńska 7 |16-120 Krynki;852;346;346;12;334;40.61;3.47
101257;201105;Gminny Ośrodek Kultury i Sportu w Kuźnicy (duża sala)|Kuźnica|ul. Sidrzańska 2 |16-123 Kuźnica;1129;543;543;17;526;48.10;3.13
101258;201105;Gminny Ośrodek Kultury i Sportu w Kuźnicy (mała sala)|Kuźnica|ul. Sidrzańska 2 |16-123 Kuźnica;1014;462;462;20;442;45.56;4.33
101259;201105;Przedszkole w Kuźnicy|Kuźnica|ul. Sokólska 16 |16-123 Kuźnica;432;168;168;5;163;38.89;2.98
101260;201105;Budynek po byłej Szkole Podstawowej|Popławce| 29 |16-123 Kuźnica;426;175;175;4;171;41.08;2.29
101261;201105;Bydynek po byłej Szkole Podstawowej|Klimówka| 23 |16-123 Kuźnica;391;146;146;6;140;37.34;4.11
101262;201106;Budynek Gimnazjum|Nowy Dwór|ul.Kolejowa 2 |16-205 Nowy Dwór;1270;533;533;24;509;41.97;4.50
101263;201106;Świetlica Wiejska|Dubaśno| 4 |16-205 Nowy Dwór;480;186;186;9;177;38.75;4.84
101264;201106;Szkoła Podstawowa|Sieruciowce| 37 |16-205 Nowy Dwór;608;148;148;14;134;24.34;9.46
101265;201107;Budynek po Gimnazjum w Sidrze|Sidra|ul. Kalwińska 6 |16-124 Sidra;1473;591;591;26;565;40.12;4.40
101266;201107;Szkoła Podstawowa w Jacowlanach|Jacowlany| 13 |16-124 Sidra;521;212;212;10;202;40.69;4.72
101267;201107;Szkoła Podstawowa w Majewie|Nowinka| 1 |16-124 Sidra;544;176;176;11;165;32.35;6.25
101268;201107;Budynek parafialny|Zalesie| 25 |16-124 Sidra;502;151;151;6;145;30.08;3.97
101269;201108;Szkoła Podstawowa w Starej Kamionce|Stara Kamionka| 65 |16-100 Sokółka;1071;410;410;11;399;38.28;2.68
101270;201108;Zespół Szkół Integracyjnych|Sokółka|ul. Szkolna 2 |16-100 Sokółka;1058;338;338;14;324;31.95;4.14
101271;201108;Świetlica Wiejska w Sokolanach|Sokolany| |16-100 Sokółka;953;369;369;12;357;38.72;3.25
101272;201108;Szkoła Podstawowa w Starej Rozedrance|Stara Rozedranka| 3 |16-100 Sokółka;1007;351;351;11;340;34.86;3.13
101273;201108;Szkoła Podstawowa w Malawiczach Dolnych|Malawicze Dolne| 56 |16-100 Sokółka;1012;315;315;19;296;31.13;6.03
101274;201108;Niepubliczna Szkoła Podstawowa w Lipinie|Lipina| 103 |16-100 Sokółka;943;321;321;16;305;34.04;4.98
101275;201108;Zespół Szkół Ogólnokształcących|Sokółka|ul. Os. Zielone 2 |16-100 Sokółka;1053;429;429;13;416;40.74;3.03
101276;201108;Zespół Szkół Zawodowych|Sokółka|ul. Os. Zielone 1a |16-100 Sokółka;1000;436;436;17;419;43.60;3.90
101277;201108;Ośrodek Sportu i Rekreacji|Sokółka|ul. Mariańska 31 |16-100 Sokółka;1110;541;541;9;532;48.74;1.66
101278;201108;Gimnazjum Nr 1|Sokółka|ul. Mickiewicza 2a |16-100 Sokółka;726;321;321;10;311;44.21;3.12
101279;201108;Przedszkole Nr 3|Sokółka|ul. Kresowa 73 |16-100 Sokółka;926;418;418;15;403;45.14;3.59
101280;201108;Zespół Szkół|Sokółka|ul. Mickiewicza 11 |16-100 Sokółka;1158;652;652;16;636;56.30;2.45
101281;201108;Przedszkole Nr 1|Sokółka|ul. Sikorskiego 4 |16-100 Sokółka;972;464;464;9;455;47.74;1.94
101282;201108;Zespół Szkół Integracyjnych|Sokółka|ul. Szkolna 2 |16-100 Sokółka;1021;468;468;6;462;45.84;1.28
101283;201108;Zespół Szkół Integracyjnych|Sokółka|ul. Szkolna 2 |16-100 Sokółka;919;425;425;12;413;46.25;2.82
101284;201108;Zespół Szkół Integracyjnych|Sokółka|ul. Szkolna 2 |16-100 Sokółka;995;367;367;3;364;36.88;0.82
101285;201108;Przedszkole Nr 4|Sokółka|ul. Kołłątaja 22 |16-100 Sokółka;971;489;489;11;478;50.36;2.25
101286;201108;Sokólski Ośrodek Kultury|Sokółka|ul. Grodzieńska 1 |16-100 Sokółka;985;436;436;9;427;44.26;2.06
101287;201108;Przedszkole Nr 1|Sokółka|ul. Sikorskiego 4 |16-100 Sokółka;1037;455;455;11;444;43.88;2.42
101288;201108;Przedszkole nr 5|Sokółka|ul. Os. Centrum 18 |16-100 Sokółka;937;440;440;12;428;46.96;2.73
101289;201108;Szkoła Podstawowa Nr 1|Sokółka|ul. Grodzieńska 43 |16-100 Sokółka;1172;557;557;10;547;47.53;1.80
101290;201108;Samodzielny Publiczny Zakład Opieki Zdrowotnej|Sokółka|gen. Władysława Sikorskiego 40 |16-100 Sokółka;55;53;53;4;49;96.36;7.55
101291;201109;Gimnazjum w Suchowoli|Suchowola|ul. Augustowska 2 |16-150 Suchowola;877;357;357;8;349;40.71;2.24
101292;201109;Szkoła Podstawowa|Jatwieź Duża| 29 |16-150 Suchowola;313;130;130;6;124;41.53;4.62
101293;201109;Szkoła Podstawowa|Suchowola|ul. Szkolna 1 |16-150 Suchowola;970;420;420;20;400;43.30;4.76
101294;201109;Szkoła Podstawowa|Suchowola|ul. Szkolna 1 |16-150 Suchowola;866;432;432;14;418;49.88;3.24
101295;201109;Kino "Kometa"|Suchowola|Plac Kościuszki 5 |16-150 Suchowola;1225;460;460;4;456;37.55;0.87
101296;201109;Szkoła Podstawowa|Chodorówka Nowa| 17 |16-150 Suchowola;888;350;350;9;341;39.41;2.57
101297;201109;Szkoła Podstawowa|Wólka| 68 |16-150 Suchowola;710;259;259;9;250;36.48;3.47
101298;201110;Urząd Gminy w Szudziałowie|Szudziałowo|ul. Bankowa 1 |16-113 Szudziałowo;1398;595;595;36;559;42.56;6.05
101299;201110;Remiza OSP w Wierzchlesiu|Wierzchlesie| 94 |16-113 Szudziałowo;350;138;138;9;129;39.43;6.52
101300;201110;Szkoła Podstawowa w Babikach|Babiki| 22A |16-113 Szudziałowo;881;319;319;16;303;36.21;5.02
101301;201201;Gminna Biblioteka Publiczna w Bakałarzewie|Bakałarzewo|ul. Młyńska 11 |16-423 Bakałarzewo;802;375;375;17;358;46.76;4.53
101302;201201;Zespół Szkół w Bakałarzewie|Bakałarzewo|ul. Króla Zygmunta Starego 1 |16-423 Bakałarzewo;668;218;218;5;213;32.63;2.29
101303;201201;Urząd Gminy Bakałarzewo|Bakałarzewo|ul. Rynek 3 |16-423 Bakałarzewo;706;264;264;12;252;37.39;4.55
101304;201201;Szkoła Podstawowa w Zdrębach|Zdręby| 34 |16-423 Bakałarzewo;393;102;102;7;95;25.95;6.86
101305;201202;Urząd Gminy Filipów|Filipów|ul. Garbaska 2 |16-424 Filipów;1407;502;502;20;482;35.68;3.98
101306;201202;Zespół Szkół w Filipowie|Filipów|ul. M. Konopnickiej 6 |16-424 Filipów;1709;589;589;19;570;34.46;3.23
101307;201202;Klub Rolnika w Jemielistem|Jemieliste| 41 |16-424 Filipów;482;187;187;3;184;38.80;1.60
101308;201203;Ochotnicza Straż Pożarna w Bachanowie|Błaskowizna| 13 |16-404 Jeleniewo;317;119;119;10;109;37.54;8.40
101309;201203;Gminna Biblioteka Publiczna|Jeleniewo|ul. Sportowa 1A |16-404 Jeleniewo;1168;545;545;22;523;46.66;4.04
101310;201203;Zespół Szkół|Jeleniewo|ul. Suwalska 51 |16-404 Jeleniewo;1038;408;408;15;393;39.31;3.68
101311;201204;Szkoła Podstawowa|Nowa Pawłówka| 1 |16-427 Przerośl;595;245;245;8;237;41.18;3.27
101312;201204;Urząd Gminy|Przerośl|ul.Rynek 2 |16-427 Przerośl;1164;401;401;16;385;34.45;3.99
101313;201204;Gminny Ośrodek Kultury|Przerośl|ul.Rynek 11 |16-427 Przerośl;666;307;307;7;300;46.10;2.28
101314;201205;Zespół Szkół im.Ludwika Michała Paca|Dowspuda| 10 |16-420 Raczki;557;256;256;15;241;45.96;5.86
101315;201205;Gminny Ośrodek Kultury|Raczki|Plac Kościuszki 15 |16-420 Raczki;1453;607;607;20;587;41.78;3.29
101316;201205;Gminny Ośrodek Kultury|Raczki|Plac Kościuszki 15 |16-420 Raczki;1813;819;819;22;797;45.17;2.69
101317;201205;Remiza OSP|Sucha Wieś| 10 |16-420 Raczki;544;222;222;17;205;40.81;7.66
101318;201205;Remiza OSP|Sidory| 22 |16-420 Raczki;413;149;149;7;142;36.08;4.70
101319;201206;Urząd Gminy Rutka-Tartak|Rutka-Tartak|ul. 3 Maja 13 |16-406 Rutka-Tartak;1704;719;719;31;688;42.19;4.31
101320;201206;Świetlica wiejska|Smolniki| 32 |16-407 Wiżajny;291;145;145;7;138;49.83;4.83
101321;201207;Zespół Szkół|Płociczno-Tartak| 16 |16-402 Suwałki;1150;567;567;15;552;49.30;2.65
101322;201207;Szkoła Podstawowa|Poddubówek| 17 |16-402 Suwałki;430;183;183;4;179;42.56;2.19
101323;201207;Zespół Szkół|Przebród| 15 |16-402 Suwałki;1044;378;378;11;367;36.21;2.91
101324;201207;Urząd Gminy Suwałki|Suwałki|ul. Świerkowa 45 |16-400 Suwałki;2136;981;981;27;954;45.93;2.75
101325;201207;Zespół Szkół|Stary Folwark| 49 |16-402 Suwałki;746;413;413;12;401;55.36;2.91
101326;201207;Szkoła Podstawowa|Nowa Wieś| 40A |16-402 Suwałki;452;202;202;8;194;44.69;3.96
101327;201208;Świetlica Gminna w Szypliszkach|Szypliszki|ul Suwalska 21 |16-411 Szypliszki;1301;476;476;10;466;36.59;2.10
101328;201208;Szkoła Podstawowa w Jasionowie z siedzibą w Żubrynie|Żubryn| 17 |16-411 Szypliszki;484;173;173;6;167;35.74;3.47
101329;201208;Zespół Szkól w Kaletniku|Kaletnik| 46 |16-411 Szypliszki;860;296;296;19;277;34.42;6.42
101330;201208;Szkoła Podstawowa w Becejłach|Becejły| 7 |16-411 Szypliszki;597;248;248;5;243;41.54;2.02
101331;201209;Świetlica Gminna|Wiżajny|ul. Wierzbołowska 3 |16-407 Wiżajny;747;337;337;7;330;45.11;2.08
101332;201209;Publiczne Gimnazjum|Wiżajny|ul. Szkolna 11 |16-407 Wiżajny;860;367;367;11;356;42.67;3.00
101333;201209;Remiza Ochotniczej Straży Pożarnej w Oklinach|Okliny| 16 |16-407 Wiżajny;379;150;150;5;145;39.58;3.33
101334;201301;Gimnazjum w Wysokiem Mazowieckiem|Wysokie Mazowieckie|ul. Ludowa 5 |18-200 Wysokie Mazowieckie;1830;1085;1085;20;1065;59.29;1.84
101335;201301;Szkoła Podstawowa Nr 1 w Wysokiem Mazowieckiem|Wysokie Mazowieckie|ul. Kościelna 1 |18-200 Wysokie Mazowieckie;1496;774;774;15;759;51.74;1.94
101336;201301;Miejski Osrodek Kultury w Wysokiem Mazowieckiem|Wysokie Mazowieckie|ul. Ludowa 19 |18-200 Wysokie Mazowieckie;1687;862;862;23;839;51.10;2.67
101337;201301;Przedszkole Miejskie Nr 1 w Wysokiem Mazowieckiem|Wysokie Mazowieckie|ul.Armii Krajowej 3 |18-200 Wysokie Mazowieckie;1359;676;676;10;666;49.74;1.48
101338;201301;Przedszkole Miejskie Nr 2 w Wysokiem Mazowieckiem|Wysokie Mazowieckie|ul. Wołodyjowskiego 2 |18-200 Wysokie Mazowieckie;1066;560;560;12;548;52.53;2.14
101339;201301;Szpital Ogólny w Wysokiem Mazowieckiem|Wysokie Mazowieckie|ul. Szpitalna 5 -|18-200 Wysokie Mazowieckie;72;30;30;0;30;41.67;0.00
101340;201302;Gimnazjum im. Papieża Jana Pawła II w Ciechanowcu|Ciechanowiec|ul. Sosnowa 2 |18-230 Ciechanowiec;1354;569;569;19;550;42.02;3.34
101341;201302;Budynek byłej Synagogi w Ciechanowcu|Ciechanowiec|ul. Mostowa 6 |18-230 Ciechanowiec;990;427;427;15;412;43.13;3.51
101342;201302;Świetlica Organizacji Społecznych budynek Przedszkola w Ciechanowcu|Ciechanowiec|Mickiewicza 29A |18-230 Ciechanowiec;476;210;210;4;206;44.12;1.90
101343;201302;Szkoła Podstawowa w Ciechanowcu|Ciechanowiec|11 Listopada 5 |18-230 Ciechanowiec;956;399;399;13;386;41.74;3.26
101344;201302;Sala Gimnastyczna przy budynku Szkoły Podstawowej w Ciechanowcu (były COKIS)|Ciechanowiec|11 Listopada 5 |18-230 Ciechanowiec;819;342;342;9;333;41.76;2.63
101345;201302;Świetlica Wiejska w Kosiorkach|Kosiorki| 25 |18-230 Ciechanowiec;363;137;137;7;130;37.74;5.11
101346;201302;Świetlica Wiejska w Wojtkowicach Starych|Wojtkowice Stare| 12A |18-230 Ciechanowiec;366;133;133;2;131;36.34;1.50
101347;201302;Szkoła Podstawowa w Łempicach|Łempice| 13A |18-230 Ciechanowiec;346;191;191;3;188;55.20;1.57
101348;201302;Szkoła Podstawowa w Kocach - Schabach|Koce-Schaby| 24 |18-230 Ciechanowiec;289;168;168;1;167;58.13;0.60
101349;201302;Świetlica Wiejska w Winnej - Poświętnej|Winna-Poświętna| 6 |18-230 Ciechanowiec;210;94;94;3;91;44.76;3.19
101350;201302;Szkoła Podstawowa w Radziszewie Starym|Radziszewo Stare| 9 |18-230 Ciechanowiec;413;187;187;7;180;45.28;3.74
101351;201302;Budynek byłej Szkoły Podstawowej w Czajach - Wólce|Czaje-Wólka| 33 |18-230 Ciechanowiec;178;88;88;2;86;49.44;2.27
101352;201302;Świetlica Wiejska w Pobikrach|Pobikry| 50|18-230 Ciechanowiec;206;102;102;7;95;49.51;6.86
101353;201302;Świetlica Wiejska w Skórcu|Skórzec| 61 |18-230 Ciechanowiec;335;130;130;3;127;38.81;2.31
101354;201302;Dom Pomocy Społecznej w Kozarzach|Kozarze| 63 |18-230 Ciechanowiec;45;35;35;4;31;77.78;11.43
101355;201302;Zakład Opiekuńczo - Leczniczy w Ciechanowcu|Ciechanowiec|Pl. Ks. K. Kluka 4 |18-230 Ciechanowiec;63;7;7;0;7;11.11;0.00
101356;201303;Gminny Ośrodek Kultury w Czyżewie|Czyżew|ul. Mazowiecka 34 |18-220 Czyżew;1449;661;661;21;640;45.62;3.18
101357;201303;Zespół Szkół Ogólnokształcących i Zawodowych w Czyżewie|Czyżew|ul. Niepodległości 3 |18-220 Czyżew;1139;580;580;26;554;50.92;4.48
101358;201303;Zespół Szkół w Rosochatem Kościelnem|Rosochate Kościelne|ul. Mazowiecka 5 |18-220 Czyżew;910;430;430;3;427;47.25;0.70
101359;201303;Szkoła Podstawowa w Dąbrowie Wielkiej|Dąbrowa Wielka| 19 |18-220 Czyżew;612;323;323;6;317;52.78;1.86
101360;201303;Zespół Szkół w Czyżewie|Czyżew|ul.Polna 5 |18-220 Czyżew;1178;617;617;17;600;52.38;2.76
101361;201304;Gminny Ośrodek Kultury w Klukowie|Klukowo|ul. Mazowiecka 14 |18-214 Klukowo;1333;717;717;20;697;53.79;2.79
101362;201304;Szkoła Podstawowa w Kuczynie|Kuczyn| 69 |18-214 Klukowo;1207;652;652;19;633;54.02;2.91
101363;201304;Szkoła Podstawowa w Wyszonkach Kościelnych|Wyszonki Kościelne| 1 |18-214 Klukowo;1150;578;578;14;564;50.26;2.42
101364;201305;Urząd Gminy Kobylin-Borzymy|Kobylin-Borzymy|Główna 11 |18-204 Kobylin-Borzymy;721;351;351;2;349;48.68;0.57
101365;201305;Zespół Szkół w Kobylinie-Borzymach|Kobylin-Borzymy|Lipowa 17 |18-204 Kobylin-Borzymy;684;346;346;6;340;50.58;1.73
101366;201305;Zespół Szkół w Kobylinie-Borzymach|Kobylin-Borzymy|Lipowa 17 |18-204 Kobylin-Borzymy;724;396;396;8;388;54.70;2.02
101367;201305;Szkoła Podstawowa we Wnorach-Kużelach|Wnory-Kużele| 37 |18-208 Kulesze Kościelne;618;310;310;7;303;50.16;2.26
101368;201306;Gimnazjum w Kuleszach Kościelnych|Kulesze Kościelne|ul. Główna 2 |18-208 Kulesze Kościelne;617;330;330;6;324;53.48;1.82
101369;201306;Szkoła Podstawowa w Kuleszach Kościelnych|Kulesze Kościelne|ul. Główna 2 |18-208 Kulesze Kościelne;734;348;348;10;338;47.41;2.87
101370;201306;Urząd Gminy Kulesze Kościelne|Kulesze Kościelne|ul.Główna 6 |18-208 Kulesze Kościelne;697;381;381;9;372;54.66;2.36
101371;201306;Budynek Socjalny w Kalinowie Solkach|Kalinowo Solki| |18-208 Kulesze Kościelne;504;330;330;10;320;65.48;3.03
101372;201307;Urząd Gminy Nowe Piekuty|Nowe Piekuty|ul.Główna 8 |18-212 Nowe Piekuty;989;533;533;18;515;53.89;3.38
101373;201307;Zespół Szkół Nowe Piekuty|Nowe Piekuty|ul.Główna 3 |18-212 Nowe Piekuty;1098;580;580;17;563;52.82;2.93
101374;201307;Zespół Szkół Jabłoń Kościelna|Jabłoń Kościelna|ul.Mazowiecka 1 |18-212 Nowe Piekuty;1112;622;622;17;605;55.94;2.73
101375;201308;Szkoła Podstawowa w Kowalewszczyźnie|Kowalewszczyzna| 29 |18-218 Sokoły;771;288;288;10;278;37.35;3.47
101376;201308;Szkoła Podstawowa w Sokołach|Sokoły|ul. Kościelna 5 |18-218 Sokoły;1390;779;779;11;768;56.04;1.41
101377;201308;Gminny Ośrodek Kultury w Sokołach|Sokoły|ul. Kolejowa 3 |18-218 Sokoły;1353;710;710;17;693;52.48;2.39
101378;201308;Urząd Gminy Sokoły|Sokoły|ul. Rynek Mickiewicza 10 |18-218 Sokoły;1197;591;591;15;576;49.37;2.54
101379;201308;NZOZ MD CARE Sp. z o.o. Centrum Rehabilitacji i Adaptacji w Dworakach-Staśkach|Dworaki-Staśki| 46 |18-218 Sokoły;52;20;20;4;16;38.46;20.00
101380;201309;Ochotnicza Straż Pożarna w Szepietowie|Szepietowo|ul. Henryka Sienkiewicza 52 |18-210 Szepietowo;771;305;305;5;300;39.56;1.64
101381;201309;Gminny Ośrodek Kultury w Szepietowie|Szepietowo|ul. Henryka Sienkiewicza 52 |18-210 Szepietowo;1033;544;544;15;529;52.66;2.76
101382;201309;Ochotnicza Straż Pożarna w Średnicy-Maćkowiętach|Średnica-Maćkowięta| 16 |18-210 Szepietowo;706;360;360;6;354;50.99;1.67
101383;201309;Ochotnicza Straż Pożarna w Dąbrowie-Moczydłach|Dąbrowa-Moczydły| 34 |18-210 Szepietowo;1188;605;605;8;597;50.93;1.32
101384;201309;Szkoła Podstawowa w Dąbrówce Kościelnej|Dąbrówka Kościelna| 35 |18-210 Szepietowo;1287;587;587;11;576;45.61;1.87
101385;201309;Szkoła Podstawowa w Wojnach-Krupach|Wojny-Krupy| 11 |18-210 Szepietowo;793;404;404;9;395;50.95;2.23
101386;201310;Urząd Gminy Wysokie Mazowieckie|Wysokie Mazowieckie|Mickiewicza 1A |18-200 Wysokie Mazowieckie;1470;663;663;14;649;45.10;2.11
101387;201310;Zespół Szkół w Jabłonce Kościelnej|Jabłonka Kościelna| |18-200 Wysokie Mazowieckie;1151;545;545;8;537;47.35;1.47
101388;201310;Remiza OSP w Starej Rusi|Stara Ruś| |18-218 Sokoły;213;137;137;3;134;64.32;2.19
101389;201310;Budynek po Szkole Podstawowej w Dąbrowie-Dzięcieli|Dąbrowa-Dzięciel| |18-200 Wysokie Mazowieckie;302;131;131;6;125;43.38;4.58
101390;201310;Szkoła Podstawowa w Święcku Wielkim|Święck Wielki| |18-200 Wysokie Mazowieckie;305;131;131;6;125;42.95;4.58
101391;201310;Budynek po Szkole Podstawowej w Kalinowie-Czosnowie|Kalinowo-Czosnowo| |18-200 Wysokie Mazowieckie;281;172;172;0;172;61.21;0.00
101392;201310;Szkoła Podstawowa w Jabłonce Kościelnej, Szkoła Filialna w Gołaszach-Puszczy|Gołasze-Puszcza| |18-200 Wysokie Mazowieckie;301;145;145;6;139;48.17;4.14
101393;201310;Wiejski Dom Kultury w Mazurach|Mazury| |18-200 Wysokie Mazowieckie;249;125;125;2;123;50.20;1.60
101394;201401;Szkoła Podstawowa Nr 4 w Zambrowie|Zambrów|Konopnickiej 13 |18-300 Zambrów;1044;579;579;10;569;55.46;1.73
101395;201401;Zespół Szkół Ogólnokształcących w Zambrowie|Zambrów|Konopnickiej 16 |18-300 Zambrów;1960;865;865;22;843;44.13;2.54
101396;201401;Miejskie Przedszkole Nr 4 w Zambrowie|Zambrów|Papieża Jana Pawła II 8A |18-300 Zambrów;1037;518;518;10;508;49.95;1.93
101397;201401;Miejskie Gimnazjum Nr 1 w Zambrowie|Zambrów|Prymasa Wyszyńskiego 6A |18-300 Zambrów;884;397;397;10;387;44.91;2.52
101398;201401;Miejskie Przedszkole Nr 1 w Zambrowie|Zambrów|Sadowa 5 |18-300 Zambrów;1443;578;578;12;566;40.06;2.08
101399;201401;Miejski Ośrodek Kultury w Zambrowie|Zambrów|Prymasa Wyszyńskiego 2A |18-300 Zambrów;1653;789;789;13;776;47.73;1.65
101400;201401;Miejskie Gimnazjum Nr 1 w Zambrowie|Zambrów|Prymasa Wyszyńskiego 6A |18-300 Zambrów;1635;723;723;16;707;44.22;2.21
101401;201401;Szkoła Podstawowa Nr 5 w Zambrowie|Zambrów|Obrońców Zambrowa 6 |18-300 Zambrów;949;486;486;7;479;51.21;1.44
101402;201401;Szkoła Podstawowa Nr 5 w Zambrowie|Zambrów|Obrońców Zambrowa 6 |18-300 Zambrów;834;427;427;8;419;51.20;1.87
101403;201401;Sala Konferencyjna Starostwa Powiatowego w Zambrowie|Zambrów|Fabryczna 3 |18-300 Zambrów;1594;669;669;10;659;41.97;1.49
101404;201401;Szkoła Podstawowa Nr 3 w Zambrowie|Zambrów|Magazynowa 13 |18-300 Zambrów;1661;683;683;17;666;41.12;2.49
101405;201401;Szkoła Podstawowa Nr 3 w Zambrowie|Zambrów|Magazynowa 13 |18-300 Zambrów;1788;673;674;21;652;37.64;3.12
101406;201401;Centrum Obsługi Placówek Opiekuńczo-Wychowawczych w Zambrowie|Zambrów|Aleja Wojska Polskiego 52/2 |18-300 Zambrów;1255;418;418;12;406;33.31;2.87
101407;201401;Szpital Powiatowy w Zambrowie|Zambrów|Papieża Jana Pawła II 3 |18-300 Zambrów;62;36;36;1;35;58.06;2.78
101408;201402;Urząd Gminy w Kołakach Kościelnych|Kołaki Kościelne|ul. Kościelna 11 |18-315 Kołaki Kościelne;693;365;365;8;357;52.67;2.19
101409;201402;Zespół Szkół w Kołakach Kościelnych|Kołaki Kościelne|ul. Kościelna 26 |18-315 Kołaki Kościelne;640;358;358;7;351;55.94;1.96
101410;201402;Sala gimnastyczna przy Zespole Szkół w Kołakach Kościelnych|Kołaki Kościelne|ul. Kościelna 26 |18-315 Kołaki Kościelne;610;323;323;8;315;52.95;2.48
101411;201403;Urząd Gminy Rutki Sala konferencyjna|Rutki-Kossaki|ul.11 Listopada 7 |18-312 Rutki-Kossaki;1244;472;472;20;452;37.94;4.24
101412;201403;Świetlica Wiejska w Zambrzycach - Królach|Zambrzyce-Króle| 6 |18-312 Rutki-Kossaki;978;501;501;10;491;51.23;2.00
101413;201403;Szkoła Podstawowa w Grądach-Woniecko|Grądy-Woniecko| 18 |18-312 Rutki-Kossaki;655;197;197;14;183;30.08;7.11
101414;201403;Szkoła Podstawowa w Kołomyi|Kołomyja| 35 |18-312 Rutki-Kossaki;608;261;261;6;255;42.93;2.30
101415;201403;Urząd Stanu Cywilnego w Rutkach|Rutki-Kossaki|ul.11 Listopada 7 |18-312 Rutki-Kossaki;1114;487;487;17;470;43.72;3.49
101416;201403;Zakład Karny w Grądach-Woniecko|Grądy-Woniecko| 34 |18-312 Rutki-Kossaki;180;88;88;16;72;48.89;18.18
101417;201404;Gminny Ośrodek Kultury w Szumowie|Szumowo|ul. XXX-lecia 2 |18-305 Szumowo;752;390;390;8;382;51.86;2.05
101418;201404;Zespół Szkół w Szumowie|Szumowo|ul. Szkolna 14 |18-305 Szumowo;546;267;267;7;260;48.90;2.62
101419;201404;Szkoła Podstawowa w Srebrnej|Srebrna| 81 |18-305 Szumowo;568;267;267;17;250;47.01;6.37
101420;201404;Szkoła Podstawowa w Pęchratce Polskiej|Pęchratka Polska| 54 |18-305 Szumowo;377;202;202;1;201;53.58;0.50
101421;201404;Remiza Strażacka w Paproci Dużej|Paproć Duża| 54 |18-305 Szumowo;431;157;157;13;144;36.43;8.28
101422;201404;Szkoła Podstawowa w Łętownicy|Łętownica| 68 |18-305 Szumowo;214;93;93;1;92;43.46;1.08
101423;201404;Remiza Strażacka w Ostrożnem|Ostrożne| 53 |18-305 Szumowo;375;192;192;5;187;51.20;2.60
101424;201404;Remiza Strażacka w Głęboczu Wielkim|Głębocz Wielki| 17 |18-305 Szumowo;189;85;85;10;75;44.97;11.76
101425;201404;Remiza Strażacka w Srebrnym Borku|Srebrny Borek| 40 |18-305 Szumowo;280;106;106;2;104;37.86;1.89
101426;201404;Remiza Strażacka w Zarębach Jartuzach|Zaręby-Jartuzy| 16a |18-305 Szumowo;191;92;92;3;89;48.17;3.26
101427;201405;Szkoła Podstawowa w Starym Zakrzewie|Stare Zakrzewo| 15 |18-300 Zambrów;448;225;225;4;221;50.22;1.78
101428;201405;Szkoła Podstawowa w Starym Laskowcu|Stary Laskowiec| 14 |18-300 Zambrów;747;380;380;5;375;50.87;1.32
101429;201405;Szkoła Podstawowa w Osowcu|Osowiec| 22 |18-300 Zambrów;613;229;229;8;221;37.36;3.49
101430;201405;Świetlica Wiejska w Wądołkach-Bućkach|Wądołki-Bućki| 11B |18-300 Zambrów;774;313;313;4;309;40.44;1.28
101431;201405;Szkoła Podstawowa w Porytem-Jabłoni|Poryte-Jabłoń| 103 |18-300 Zambrów;882;346;346;4;342;39.23;1.16
101432;201405;Szkoła Podstawowa w Starym Skarżynie|Stary Skarżyn| 44 |18-300 Zambrów;488;265;265;9;256;54.30;3.40
101433;201405;Świetlica Wiejska w Przeździecko-Mroczkach,|Przeździecko-Mroczki| 5 |18-300 Zambrów;447;209;209;8;201;46.76;3.83
101434;201405;Świetlica Wiejska w Ładach Polnych|Łady Polne| 11B |18-300 Zambrów;487;274;274;3;271;56.26;1.09
101435;201405;Szkoła Podstawowa w Wiśniewie|Wiśniewo| 10 |18-300 Zambrów;915;380;380;0;380;41.53;0.00
101436;201405;Świetlica Wiejska w Woli Zambrowskiej|Wola Zambrowska| 95A |18-300 Zambrów;558;270;270;3;267;48.39;1.11
101437;201405;Świetlica Wiejska w Tabędzu|Tabędz| 16A |18-300 Zambrów;598;291;291;10;281;48.66;3.44
101438;201405;Zakład Karny w Czerwonym Borze|Czerwony Bór| 2 |18-400 Łomża;566;189;189;19;170;33.39;10.05
101439;206101;Szkoła Podstawowa Nr 2|Białystok|ul. Bohaterów Monte Cassino 25 |15-873 Białystok;1319;760;760;20;740;57.62;2.63
101440;206101;Szkoła Podstawowa Nr 2|Białystok|ul. Bohaterów Monte Cassino 25 |15-873 Białystok;1086;634;634;18;616;58.38;2.84
101441;206101;Zespół Szkół Technicznych|Białystok|ul. Stołeczna 21 |15-879 Białystok;1441;796;796;11;785;55.24;1.38
101442;206101;Publiczne Gimnazjum Nr 7|Białystok|ul. Stołeczna 6 |15-879 Białystok;1295;799;799;14;785;61.70;1.75
101443;206101;Szkoła Podstawowa Nr 2|Białystok|ul. Bohaterów Monte Cassino 25 |15-873 Białystok;1147;629;629;11;618;54.84;1.75
101444;206101;IV Liceum Ogólnokształcące|Białystok, Piaski|ul. Zwierzyniecka 9a |15-312 Białystok;1531;869;869;15;854;56.76;1.73
101445;206101;IV Liceum Ogólnokształcące|Białystok|ul. Zwierzyniecka 9a |15-312 Białystok;905;543;543;10;533;60.00;1.84
101446;206101;Szkoła Podstawowa Nr 6|Białystok|ul. Wesoła 11a |15-307 Białystok;1506;1008;1008;13;995;66.93;1.29
101447;206101;Publiczne Gimnazjum Nr 2|Białystok, Piaski|ul. Legionowa 7 |15-281 Białystok;1485;948;948;10;938;63.84;1.05
101448;206101;Publiczne Gimnazjum Nr 2|Białystok, Piaski|ul. Legionowa 7 |15-281 Białystok;1220;690;690;8;682;56.56;1.16
101449;206101;Przedszkole Samorządowe Nr 25|Białystok, Piaski|ul. Waszyngtona 4 |15-274 Białystok;1152;620;620;4;616;53.82;0.65
101450;206101;Przedszkole Samorządowe Nr 52|Białystok, Piaski|ul. Waszyngtona 16 |15-274 Białystok;1411;816;816;7;809;57.83;0.86
101451;206101;Szkoła Podstawowa Nr 34|Białystok|ul. Pogodna 12 |15-365 Bialystok;1710;905;905;13;892;52.92;1.44
101452;206101;Szkoła Podstawowa Nr 34|Białystok|ul. Pogodna 12 |15-354 Białystok;1469;875;875;7;868;59.56;0.80
101453;206101;Zarząd Mienia Komunalnego|Białystok|ul. Bema 89/1 |15-370 Bialystok;1682;875;875;22;853;52.02;2.51
101454;206101;Zespół Szkół Handlowo-Ekonomicznych|Białystok|ul. Bema 105 |15-370 Białystok;1683;1049;1049;11;1038;62.33;1.05
101455;206101;Zespół Szkół Handlowo-Ekonomicznych|Białystok|ul. Bema 105 |15-370 Białystok;1508;710;710;23;687;47.08;3.24
101456;206101;Szkoła Podstawowa Nr 14|Białystok|ul. Pułaskiego 25 |15-337 Białystok;1386;887;887;9;878;64.00;1.01
101457;206101;Szkoła Podstawowa Nr 14|Białystok|ul. Pułaskiego 25 |15-337 Białystok;1227;743;743;6;737;60.55;0.81
101458;206101;Szkoła Podstawowa Nr 14|Białystok|ul. Pułaskiego 25 |15-337 Białystok;1407;876;876;13;863;62.26;1.48
101459;206101;Przedszkole Samorządowe Nr 1|Białystok|ul. Kawaleryjska 70 |15-325 Białystok;1146;703;703;10;693;61.34;1.42
101460;206101;Przedszkole Samorządowe Nr 64|Białystok, Nowe Miasto|ul. Dubois 12 |15-349 Białystok;1594;919;919;28;891;57.65;3.05
101461;206101;Przedszkole Samorządowe Nr 32|Białystok, Nowe Miasto|ul. Pułaskiego 55 |15-338 Białystok;1412;841;841;17;824;59.56;2.02
101462;206101;Szkoła Podstawowa Nr 50|Białystok, Nowe Miasto|ul. Pułaskiego 96 |15-338 Białystok;1444;794;794;20;774;54.99;2.52
101463;206101;Szkoła Podstawowa Nr 50|Białystok, Nowe Miasto|ul. Pułaskiego 96 |15-338 Białystok;1695;906;906;15;891;53.45;1.66
101464;206101;Szkoła Podstawowa Nr 50|Białystok, Nowe Miasto|ul. Pułaskiego 96 |15-337 Białystok;1518;807;807;5;802;53.16;0.62
101465;206101;Szkoła Podstawowa Nr 50|Białystok, Nowe Miasto|ul. Pułaskiego 96 |15-337 Białystok;1803;1131;1131;11;1120;62.73;0.97
101466;206101;Szkoła Podstawowa Nr 50|Białystok, Nowe Miasto|ul. Pułaskiego 96 |15-337 Białystok;1141;715;715;8;707;62.66;1.12
101467;206101;Publiczne Gimnazjum Nr 2|Białystok, Piaski|ul. Legionowa 7 |15-281 Białystok;765;381;381;7;374;49.80;1.84
101468;206101;I Liceum Ogólnokształcące|Białystok|ul. Brukowa 2 |15-889 Białystok;896;427;433;5;422;47.66;1.17
101469;206101;Szkoła Podstawowa Nr 4|Białystok|ul. Częstochowska 6a |15-459 Białystok;1254;581;581;9;572;46.33;1.55
101470;206101;Szkoła Podstawowa Nr 4|Białystok|ul. Częstochowska 6a |15-459 ;1306;657;657;12;645;50.31;1.83
101471;206101;Zespół Szkół Nr 12|Białystok|ul. Krakowska 19 |15-875 Białystok;942;456;456;2;454;48.41;0.44
101472;206101;Przedszkole Samorządowe Nr 10|Białystok|Al. Piłsudskiego 34 |15-446 ;1254;652;652;11;641;51.99;1.69
101473;206101;Niepubliczna Szkoła Podstawowa św. św. Cyryla i Metodego|Białystok|ul. Waryńskiego 30 |15-461 Białystok;1410;594;594;3;591;42.13;0.51
101474;206101;Niepubliczna Szkoła Podstawowa św. św. Cyryla i Metodego|Białystok|ul. Waryńskiego 30 |15-137 Białystok;1442;679;679;13;666;47.09;1.91
101475;206101;Białostocki Ośrodek Sportu i Rekreacji|Białystok|ul. Włókiennicza 4 |15-465 Białystok;1223;652;652;10;642;53.31;1.53
101476;206101;Szkoła Podstawowa Nr 26|Białystok, Białostoczek|ul. Radzymińska 11 |15-863 Białystok;1511;926;926;12;914;61.28;1.30
101477;206101;Przedszkole Samorządowe Nr 55|Białystok, Białostoczek|ul. Kozłowa 25 |15-868 ;1042;608;608;7;601;58.35;1.15
101478;206101;Szkoła Podstawowa Nr 26|Białystok, Białostoczek|ul. Radzymińska 11 |15-863 Białystok;1408;825;826;11;814;58.59;1.33
101479;206101;Publiczne Gimnazjum Nr 16|Białystok, Białostoczek|ul. Sokólska 1 |15-865 Białystok;1418;794;794;14;780;55.99;1.76
101480;206101;Publiczne Gimnazjum Nr 16|Białystok, Białostoczek|ul. Sokólska 1 |15-865 Białystok;1504;941;941;9;932;62.57;0.96
101481;206101;Publiczne Gimnazjum Nr 16|Białystok, Białostoczek|ul. Sokólska 1 |15-865 Białystok;1195;691;691;13;678;57.82;1.88
101482;206101;Zespół Szkół Elektrycznych|Białystok, Białostoczek|Al. Tysiąclecia Państwa Polskiego 14 |15-111 Białystok;1762;1118;1118;6;1112;63.45;0.54
101483;206101;Szkoła Podstawowa Nr 11|Białystok, Białostoczek|ul. Poleska 27 |15-114 Białystok;1236;667;667;11;656;53.96;1.65
101484;206101;Szkoła Podstawowa Nr 11|Białystok, Białostoczek|ul. Poleska 27 |15-114 Białystok;1317;753;753;13;740;57.18;1.73
101485;206101;Zespół Szkół Technicznych i Ogólnokształcących|Białystok|ul. Sienkiewicza 57 |15-002 Białystok;1079;658;658;3;655;60.98;0.46
101486;206101;Zespół Szkół Technicznych i Ogólnokształcących|Białystok|ul. Sienkiewicza 57 |15-002 Białystok;1022;540;540;10;530;52.84;1.85
101487;206101;Publiczne Gimnazjum Nr 4|Białystok|ul. Ciepła 32 |15-472 Białystok;1459;830;830;10;820;56.89;1.20
101488;206101;Żłobek Miejski Nr 3|Białystok, Wygoda|ul. Wasilkowska 4 |15-137 Białystok;1595;906;906;12;894;56.80;1.32
101489;206101;Przedszkole Samorządowe Nr 45|Białystok, Wygoda|ul. Gen. Sosabowskiego 6 |15-182 Białystok;1224;703;703;5;698;57.43;0.71
101490;206101;Zespół Szkół Nr 3 Szkoła Podstawowa Nr 8|Białystok, Wygoda|ul. Jesienna 8 |15-151 Białystok;1520;819;821;10;809;53.88;1.22
101491;206101;Zespół Szkół Nr 3 Szkoła Podstawowa Nr 8|Białystok, Wygoda|ul. Jesienna 8 |15-151 Białystok;1461;765;765;15;750;52.36;1.96
101492;206101;Szkoła Podstawowa Nr 51|Białystok, Wygoda|ul. Kluka 11A |15-197 Białystok;1136;695;695;7;688;61.18;1.01
101493;206101;Szkoła Podstawowa Nr 51|Białystok, Wygoda|ul. Kluka 11A |15-182 Białystok;1460;777;777;19;758;53.22;2.45
101494;206101;Szkoła Podstawowa Nr 51|Białystok, Wygoda|ul. Kluka 11A |15-197 Białystok;1779;1101;1101;24;1077;61.89;2.18
101495;206101;Szkoła Podstawowa Nr 51|Białystok, Wygoda|ul. Kluka 11A |15-197 Białystok;1378;811;811;4;807;58.85;0.49
101496;206101;Zespół Szkół Nr 6 (Publiczne Gimnazjum Nr 12)|Białystok|ul. Pietrasze 29 |15-131 Białystok;1601;1002;1002;15;987;62.59;1.50
101497;206101;Zespół Szkół Nr 6 (Publiczne Gimnazjum Nr 12)|Białystok|ul. Pietrasze 29 |15-131 Białystok;1798;1036;1036;17;1019;57.62;1.64
101498;206101;Zespół Szkół Nr 6 (Publiczne Gimnazjum Nr 12)|Białystok|ul. Pietrasze 29 |15-131 Białystok;1712;1038;1038;8;1030;60.63;0.77
101499;206101;Prywatna Szkoła Podstawowa Nr 1|Białystok|ul. Boruty 18 |15-157 Białystok;1658;1095;1095;10;1085;66.04;0.91
101500;206101;Prywatna Szkoła Podstawowa Nr 1|Białystok|ul. Boruty 18 |15-157 Białystok;1021;647;647;3;644;63.37;0.46
101501;206101;Prywatna Szkoła Podstawowa Nr 1|Białystok|ul. Boruty 18 |15-157 Białystok;1753;1115;1115;12;1103;63.61;1.08
101502;206101;VI Liceum Ogólnokształcące|Białystok, Bojary|ul. Warszawska 8 |15-063 Białystok;857;475;475;6;469;55.43;1.26
101503;206101;Zespół Szkół Ogólnokształcących Nr 3 (III Liceum Ogólnokształcące)|Białystok, Bojary|ul. Pałacowa 2/1 |15-042 Białystok;1330;807;807;6;801;60.68;0.74
101504;206101;Przedszkole Samorządowe Nr 22|Białystok, Bojary|ul. Łąkowa 17 |15-017 Białystok;688;427;427;7;420;62.06;1.64
101505;206101;Zespół Szkół Nr 5 (Szkoła Podstawowa Nr 5)|Białystok, Bojary|ul. Kamienna 15 |15-021 Białystok;1288;827;827;7;820;64.21;0.85
101506;206101;Zespół Szkół Nr 5 (Szkoła Podstawowa Nr 5)|Białystok, Bojary|ul. Kamienna 15 |15-021 Białystok;1534;833;833;6;827;54.30;0.72
101507;206101;Zespół Szkół Budowlano-Geodezyjnych|Białystok, Bojary|ul. Słonimska 47/1 |15-029 Białystok;1567;966;966;17;949;61.65;1.76
101508;206101;Publiczne Gimnazjum Nr 3|Białystok|ul. Spacerowa 6 |15-040 Białystok;1039;599;599;13;586;57.65;2.17
101509;206101;Publiczne Gimnazjum nr 3|Białystok|ul. Spacerowa 6 |15-040 Białystok;1476;782;784;13;769;52.98;1.66
101510;206101;Przedszkole Samorządowe Nr 68|Białystok|ul. Mieszka I 19 |15-054 Białystok;1606;920;920;15;905;57.29;1.63
101511;206101;Szkoła Podstawowa Nr 19|Białystok|ul. Mieszka I 18 |15-054 Białystok;1384;872;872;3;869;63.01;0.34
101512;206101;Szkoła Podstawowa Nr 19|Białystok|ul. Mieszka I 18 |15-054 Białystok;1443;823;823;14;809;57.03;1.70
101513;206101;Szkoła Podstawowa Nr 19|Białystok|ul. Mieszka I 18 |15-054 Białystok;1531;865;865;13;852;56.50;1.50
101514;206101;Szkoła Podstawowa Nr 19|Białystok|ul. Mieszka I 18 |15-054 Białystok;1373;830;830;11;819;60.45;1.33
101515;206101;Zespół Szkół Budowlano-Geodezyjnych|Białystok, Bojary|ul. Słonimska 47/1 |15-029 Białystok;1078;669;669;6;663;62.06;0.90
101516;206101;VIII Liceum Ogólnokształcące|Białystok|ul. Piastowska 5 |15-207 Białystok;1185;677;677;6;671;57.13;0.89
101517;206101;Publiczne Gimnazjum Nr 13|Białystok|ul. Piastowska 3D |15-207 Białystok;1295;695;695;11;684;53.67;1.58
101518;206101;Publiczne Gimnazjum Nr 13|Białystok|ul. Piastowska 3D |15-207 Białystok;1401;820;820;7;813;58.53;0.85
101519;206101;Internat VIII Liceum Ogólnokształcącego|Białystok|ul. Piastowska 5 |15-207 Białystok;1033;508;508;4;504;49.18;0.79
101520;206101;Zespół Szkół Ogólnokształcących Mistrzostwa Sportowego|Białystok|ul. Konopnickiej 3 |15-215 Białystok;1592;944;944;15;929;59.30;1.59
101521;206101;Zespół Szkół Ogólnokształcących Mistrzostwa Sportowego|Białystok|ul. Konopnickiej 3 |15-215 Białystok;1164;735;735;11;724;63.14;1.50
101522;206101;XI Liceum Ogólnokształcące|Białystok|ul. Grottgera 9 |15-225 Białystok;1380;844;844;11;833;61.16;1.30
101523;206101;XI Liceum Ogólnokształcące|Białystok|ul. Grottgera 9 |15-225 Białystok;1281;785;785;15;770;61.28;1.91
101524;206101;Zespół Szkół Nr 2|Białystok|ul. Gdańska 23/1 |15-249 Białystok;1074;669;669;7;662;62.29;1.05
101525;206101;Zespół Szkół Nr 2|Białystok|ul. Gdańska 23/1 |15-249 Białystok;1487;877;877;10;867;58.98;1.14
101526;206101;Szkoła Podstawowa Nr 28|Białystok, Skorupy|ul. Warmińska 55 |15-553 Białystok;1100;614;614;15;599;55.82;2.44
101527;206101;Szkoła Podstawowa Nr 28|Białystok, Skorupy|ul. Warmińska 55 |15-553 Białystok;1203;667;667;9;658;55.44;1.35
101528;206101;Zespół Szkół Nr 1|Białystok, Skorupy|ul. Leśna 30 |15-559 Białystok;1647;941;941;20;921;57.13;2.13
101529;206101;Zespół Szkół Nr 1|Białystok, Skorupy|ul. Leśna 30 |15-559 Białystok;1384;815;815;15;800;58.89;1.84
101530;206101;Zespół Szkół Nr 1|Białystok, Skorupy|ul. Leśna 30 |15-559 Białystok;1309;693;693;9;684;52.94;1.30
101531;206101;Zespół Szkół Ogólnokształcących Nr 8|Białystok, Dojlidy|ul. Żurawia 12 |15-540 Białystok;1138;719;719;6;713;63.18;0.83
101532;206101;Zespół Szkół Ogólnokształcących Nr 8|Białystok, Dojlidy|ul. Żurawia 12 |15-540 Białystok;1094;602;602;14;588;55.03;2.33
101533;206101;Zespół Szkół Nr 4|Białystok, Dojlidy Górne|ul. Dojlidy Górne 48 |15-572 Białystok;1168;670;670;11;659;57.36;1.64
101534;206101;Zespół Szkół Nr 4|Białystok, Dojlidy Górne|ul. Dojlidy Górne 48 |15-572 Białystok;1225;734;734;7;727;59.92;0.95
101535;206101;Zespół Szkół Nr 4|Białystok, Dojlidy Górne|ul. Dojlidy Górne 48 |15-572 Białystok;1033;642;642;10;632;62.15;1.56
101536;206101;Zespół Szkół Sportowych Nr 1|Białystok|ul. Promienna 13a |15-720 Białystok;1243;729;729;9;720;58.65;1.23
101537;206101;Zespół Szkół Nr 16|Białystok|ul. Zwycięstwa 28 |15-703 Białystok;1223;609;609;11;598;49.80;1.81
101538;206101;Zespół Szkół Sportowych Nr 1|Białystok|ul. Promienna 13a |15-720 Białystok;1350;805;805;14;791;59.63;1.74
101539;206101;Zespół Szkół Ogólnokształcących Nr 9|Białystok|ul. Upalna 26 |15-668 Białystok;1484;851;851;16;835;57.35;1.88
101540;206101;Zespół Szkół Ogólnokształcących Nr 9|Białystok|ul. Upalna 26 |15-668 Białystok;1166;678;678;10;668;58.15;1.47
101541;206101;Przedszkole Samorządowe Nr 50|Białystok|ul. Upalna 74 |15-668 Białystok;947;542;542;5;537;57.23;0.92
101542;206101;Szkoła Podstawowa Nr 43|Białystok|ul. Stroma 16 |15-662 Białystok;1452;774;774;8;766;53.31;1.03
101543;206101;Szkoła Podstawowa Nr 43|Białystok|ul. Stroma 16 |15-662 Białystok;1299;677;677;14;663;52.12;2.07
101544;206101;Szkoła Podstawowa Nr 43|Białystok|ul. Stroma 16 |15-662 Białystok;1060;596;596;8;588;56.23;1.34
101545;206101;Przedszkole Samorządowe Nr 39|Białystok|ul. Witosa 22 |15-660 Białystok;1251;723;723;9;714;57.79;1.24
101546;206101;Szkoła Podstawowa Nr 49|Białystok|ul. Armii Krajowej 32 |15-661 Białystok;1758;1039;1039;21;1018;59.10;2.02
101547;206101;Szkoła Podstawowa Nr 49|Białystok|ul. Armii Krajowej 32 |15-661 Białystok;1476;835;835;17;818;56.57;2.04
101548;206101;Szkoła Podstawowa Nr 49|Białystok|ul. Armii Krajowej 32 |15-661 Białystok;1458;858;858;9;849;58.85;1.05
101549;206101;Szkoła Podstawowa Nr 49|Białystok|ul. Armii Krajowej 32 |15-661 Białystok;1752;942;942;25;917;53.77;2.65
101550;206101;Szkoła Podstawowa Nr 49|Białystok|ul. Armii Krajowej 32 |15-661 Białystok;1828;1059;1059;20;1039;57.93;1.89
101551;206101;Szkoła Podstawowa Nr 44|Białystok|ul. Rumiankowa 13 |15-665 Białystok;1277;695;695;10;685;54.42;1.44
101552;206101;Szkoła Podstawowa Nr 44|Białystok|ul. Rumiankowa 13 |15-665 Białystok;1412;807;808;11;796;57.15;1.36
101553;206101;Szkoła Podstawowa Nr 44|Białystok|ul. Rumiankowa 13 |15-665 Białystok;1373;784;784;14;770;57.10;1.79
101554;206101;Przedszkole Samorządowe Nr 79|Białystok|ul. Konwaliowa 8 |15-674 Białystok;1448;774;774;10;764;53.45;1.29
101555;206101;Publiczne Gimnazjum Nr 18|Białystok|ul. Magnoliowa 13 |15-669 Białystok;1402;733;733;17;716;52.28;2.32
101556;206101;Publiczne Gimnazjum Nr 18|Białystok|ul. Magnoliowa 13 |15-669 Białystok;1103;632;632;11;621;57.30;1.74
101557;206101;Publiczne Gimnazjum Nr 18|Białystok|ul. Magnoliowa 13 |15-669 Białystok;1152;642;642;10;632;55.73;1.56
101558;206101;Publiczne Gimnazjum Nr 18|Białystok|ul. Magnoliowa 13 |15-669 Białystok;1312;747;747;11;736;56.94;1.47
101559;206101;V Liceum Ogólnokształcące|Białystok, Starosielce|ul. Miodowa 5 |15-656 Białystok;1282;758;758;7;751;59.13;0.92
101560;206101;V Liceum Ogólnokształcące|Białystok, Starosielce|ul. Miodowa 5 |15-656 Białystok;939;515;515;13;502;54.85;2.52
101561;206101;Szkoła Podstawowa Nr 21|Białystok, Starosielce|ul. Polowa 7/1 |15-612 Białystok;1200;571;571;8;563;47.58;1.40
101562;206101;Szkoła Podstawowa Nr 21|Białystok, Starosielce|ul. Polowa 7/1 |15-612 Białystok;1475;877;877;4;873;59.46;0.46
101563;206101;Szkoła Podstawowa Nr 21|Białystok, Starosielce|ul. Polowa 7/1 |15-612 Białystok;1083;656;656;7;649;60.57;1.07
101564;206101;Świetlica Dziennego Pobytu dla Dzieci przy Dziennym Domu Pomocy Społecznej|Białystok, Starosielce|ul. Barszczańska 18 |15-639 Białystok;1075;470;470;9;461;43.72;1.91
101565;206101;Świetlica Dziennego Pobytu dla Dzieci przy Dziennym Domu Pomocy Społecznej|Białystok, Starosielce|ul. Barszczańska 18 |15-639 Białystok;800;306;306;13;293;38.25;4.25
101566;206101;Zespół Szkół Mechanicznych|Białystok, Antoniuk|ul. Broniewskiego 14 |15-748 Białystok;1310;687;688;14;673;52.44;2.04
101567;206101;Zespół Szkół Mechanicznych|Białystok, Antoniuk|ul. Broniewskiego 14 |15-748 Białystok;1296;570;570;9;561;43.98;1.58
101568;206101;Szkoła Podstawowa Nr 15|Białystok, Antoniuk|ul. Broniewskiego 1 |15-748 Białystok;1219;680;680;14;666;55.78;2.06
101569;206101;Szkoła Podstawowa Nr 15|Białystok, Antoniuk|ul. Broniewskiego 1 |15-748 Białystok;1434;732;786;9;723;51.05;1.23
101570;206101;VII Liceum Ogólnokształcące|Białystok, Antoniuk|ul. Wierzbowa 7 |15-743 Białystok;1214;679;679;9;670;55.93;1.33
101571;206101;VII Liceum Ogólnokształcące|Białystok, Antoniuk|ul. Wierzbowa 7 |15-743 Białystok;1335;602;602;10;592;45.09;1.66
101572;206101;Szkoła Podstawowa Nr 7|Białystok, Antoniuk|ul. Wiatrakowa 18 |15-827 Białystok;1054;577;577;7;570;54.74;1.21
101573;206101;Szkoła Podstawowa Nr 7|Białystok, Antoniuk|ul. Wiatrakowa 18 |15-827 Białystok;1043;609;611;13;596;58.39;2.13
101574;206101;Zespół Szkół Ogólnokształcących Nr 2|Białystok, Antoniuk|ul. Narewska 11 |15-840 Białystok;1184;665;665;6;659;56.17;0.90
101575;206101;Zespół Szkół Ogólnokształcących Nr 2|Białystok, Antoniuk|ul. Narewska 11 |15-840 Białystok;1389;803;803;14;789;57.81;1.74
101576;206101;Zespół Szkół Ogólnokształcących i Technicznych|Białystok, Wysoki Stoczek|ul. Antoniuk Fabryczny 1 |15-762 Białystok;1535;960;961;9;951;62.54;0.94
101577;206101;Zespół Szkół Nr 11|Białystok, Wysoki Stoczek|ul. Rzemieślnicza 12/3 |15-773 Białystok;1414;694;694;14;680;49.08;2.02
101578;206101;Zespół Szkół Nr 11|Białystok, Wysoki Stoczek|ul. Rzemieślnicza 12/3 |15-773 Białystok;1306;758;758;13;745;58.04;1.72
101579;206101;Zespół Szkół Nr 11|Białystok, Wysoki Stoczek|ul. Rzemieślnicza 12/3 |15-773 Białystok;1025;665;665;11;654;64.88;1.65
101580;206101;Szkoła Podstawowa Nr 37|Białystok, Dziesięciny|ul. Jaworowa 8 |15-808 Białystok;938;592;592;2;590;63.11;0.34
101581;206101;Przedszkole Samorządowe Nr 71|Białystok, Dziesięciny|ul. Dziesięciny 50 |15-806 Białystok;1180;787;787;12;775;66.69;1.52
101582;206101;Przedszkole Samorządowe Nr 71|Białystok, Dziesięciny|ul. Dziesięciny 50 |15-806 Białystok;1503;821;821;16;805;54.62;1.95
101583;206101;Przedszkole Samorządowe Nr 56|Białystok, Dziesięciny|ul. Gen. Zygmunta Berlinga 38 |15-814 Białystok;1449;752;752;12;740;51.90;1.60
101584;206101;Szkoła Podstawowa Nr 37|Białystok, Dziesięciny|ul. Jaworowa 8 |15-603 Białystok;1260;683;683;18;665;54.21;2.64
101585;206101;Szkoła Podstawowa Nr 47|Białystok, Dziesięciny|ul. Palmowa 28 |15-795 Białystok;1258;751;751;13;738;59.70;1.73
101586;206101;Szkoła Podstawowa Nr 47|Białystok, Dziesięciny|ul. Palmowa 28 |15-795 Białystok;1045;652;652;8;644;62.39;1.23
101587;206101;Szkoła Podstawowa Nr 47|Białystok, Dziesięciny|ul. Palmowa 28 |15-795 Białystok;1145;571;571;12;559;49.87;2.10
101588;206101;Szkoła Podstawowa Nr 47|Białystok, Dziesięciny|ul. Palmowa 28 |15-795 Białystok;1341;718;718;14;704;53.54;1.95
101589;206101;Przedszkole Samorządowe Nr 73|Białystok, Dziesięciny|ul. Gajowa 66 |15-794 Białystok;877;473;473;13;460;53.93;2.75
101590;206101;Publiczne Gimnazjum Nr 15|Białystok, Dziesięciny|ul. Porzeczkowa 11 |15-815 Białystok;1248;675;675;14;661;54.09;2.07
101591;206101;Publiczne Gimnazjum Nr 15|Białystok, Dziesięciny|ul. Porzeczkowa 11 |15-815 Białystok;1302;690;690;3;687;53.00;0.43
101592;206101;Publiczne Gimnazjum Nr 15|Białystok, Dziesięciny|ul. Porzeczkowa 11 |15-815 Białystok;1360;723;723;11;712;53.16;1.52
101593;206101;Zespół Szkół Zawodowych Nr 5|Białystok, Dziesięciny|ul. Antoniuk Fabryczny 40 |15-741 Białystok;1465;751;751;9;742;51.26;1.20
101594;206101;Zespół Szkół Zawodowych Nr 5|Białystok, Dziesięciny|ul. Antoniuk Fabryczny 40 |15-741 Białystok;1420;690;690;13;677;48.59;1.88
101595;206101;Zespół Szkół Integracyjnych Nr 1|Białystok, Wysoki Stoczek|ul. Łagodna 10 |15-757 Białystok;1194;664;664;9;655;55.61;1.36
101596;206101;Zespół Szkół Integracyjnych Nr 1|Białystok, Wysoki Stoczek|ul. Łagodna 10 |15-757 Białystok;1229;711;711;7;704;57.85;0.98
101597;206101;Zespół Szkół Integracyjnych Nr 1|Białystok, Wysoki Stoczek|ul. Łagodna 10 |15-757 Białystok;1472;911;911;10;901;61.89;1.10
101598;206101;Zespół Szkół Integracyjnych Nr 1|Białystok, Wysoki Stoczek|ul. Łagodna 10 |15-757 Białystok;1314;774;774;12;762;58.90;1.55
101599;206101;Przedszkole Samorządowe Nr 65|Białystok, Wysoki Stoczek|ul. Łagodna 12 |15-757 Białystok;1355;861;861;14;847;63.54;1.63
101600;206101;Zespół Szkolno-Przedszkolny Nr 1 (Szkoła Podstawowa Nr 16)|Białystok, Bacieczki|ul. Strażacka 25 |15-687 Białystok;1877;1140;1140;5;1135;60.74;0.44
101601;206101;Zespół Szkolno-Przedszkolny Nr 1 (Szkoła Podstawowa Nr 16)|Białystok, Bacieczki|ul. Strażacka 25 |15-687 Białystok;1109;626;626;9;617;56.45;1.44
101602;206101;Szkoła Podstawowa Nr 12|Białystok, Bacieczki|ul. Komisji Edukacji Narodowej 1A |15-687 Białystok;1458;757;758;23;734;51.92;3.04
101603;206101;Publiczne Gimnazjum Nr 6|Białystok, Bacieczki|ul. Komisji Edukacji Narodowej 1 |15-687 Białystok;1112;570;570;9;561;51.26;1.58
101604;206101;Publiczne Gimnazjum Nr 6|Białystok, Bacieczki|ul. Komisji Edukacji Narodowej 1 |15-687 Białystok;1379;822;822;11;811;59.61;1.34
101605;206101;Publiczne Gimnazjum Nr 6|Białystok, Bacieczki|ul. Komisji Edukacji Narodowej 1 |15-687 Białystok;1182;652;652;4;648;55.16;0.61
101606;206101;Szkoła Podstawowa Nr 12|Białystok, Bacieczki|ul. Komisji Edukacji Narodowej 1A |15-687 Białystok;1035;490;490;9;481;47.34;1.84
101607;206101;Szkoła Podstawowa Nr 12|Białystok, Bacieczki|ul. Komisji Edukacji Narodowej 1A |15-687 Białystok;1247;670;670;14;656;53.73;2.09
101608;206101;Samodzielny Publiczny ZOZ Wojewódzki Szpital Zespolony im. J. Śniadeckiego (Interna)|Białystok|M. Skłodowskiej-Curie 25 |15-278 Białystok;193;52;52;0;52;26.94;0.00
101609;206101;Samodzielny Publiczny ZOZ Wojewódzki Szpital Zespolony im. J. Śniadeckiego (Neurologia)|Białystok|M. Skłodowskiej-Curie 26 |15-278 Białystok;113;30;30;1;29;26.55;3.33
101610;206101;Samodzielny Publiczny ZOZ Wojewódzki Szpital Zespolony im. J. Śniadeckiego (Oddział Ginekologiczno-Położniczy)|Białystok|Warszawska 15 |15-062 Białystok;50;15;15;0;15;30.00;0.00
101611;206101;Samodzielny Publiczny ZOZ Wojewódzki Szpital Zespolony im. J. Śniadeckiego (Zakład Pielęgnacyjno - Opiekuńczy)|Białystok|Wołodyjowskiego 2/1 |15-309 Białystok;65;19;19;0;19;29.23;0.00
101612;206101;Uniwersytecki Szpital Kliniczny|Białystok|M. Skłodowskiej-Curie 24A |15-278 Białystok;169;115;115;3;112;68.05;2.61
101613;206101;Uniwersytecki Szpital Kliniczny|Białystok|Żurawia 14 |15-504 Białystok;94;67;67;0;67;71.28;0.00
101614;206101;Uniwersytecki Szpital Kliniczny|Białystok|Warszawska 18 |15-062 Białystok;6;6;6;0;6;100.00;0.00
101615;206101;Samodzielny Publiczny Zakład Opieki Zdrowotnej MSW|Białystok|Fabryczna 27 |15-483 Białystok;156;32;32;1;31;20.51;3.12
101616;206101;Samodzielny Szpital Miejski im. PCK|Białystok|Sienkiewicza 79 |15-005 Białystok;78;17;17;1;16;21.79;5.88
101617;206101;Białostockie Centrum Onkologii im. Marii Skłodowskiej - Curie|Białystok|Ogrodowa 12 |15-027 Białystok;104;44;44;2;42;42.31;4.55
101618;206101;Dom Pomocy Społecznej|Białystok|Świerkowa 9 |15-328 Białystok;176;89;89;14;75;50.57;15.73
101619;206101;Zakład Karny|Białystok|Hetmańska 89 |15-727 Białystok;275;103;103;15;88;37.45;14.56
101620;206101;Areszt Śledczy|Białystok|Kopernika 21 |15-377 Białystok;563;242;242;46;196;42.98;19.01
101621;206201;Szkoła Podstawowa Nr 4 w Łomży|Łomża|ul. Kierzkowa 7 |18-400 Łomża;1713;858;858;7;851;50.09;0.82
101622;206201;Zespół Szkół Ekonomicznych i Ogólnokształcących Nr 6 w Łomży|Łomża|ul. Mikołaja Kopernika 16 |18-400 Łomża;1562;787;787;19;768;50.38;2.41
101623;206201;Miejski Ośrodek Pomocy Społecznej w Łomży - KLUB SENIORA|Łomża|ul. Marii Skłodowskiej Curie 2 |18-400 Łomża;1883;773;773;16;757;41.05;2.07
101624;206201;Stowarzyszenie EDUKATOR, Przedszkole Niepubliczne "Mały Artysta" w Łomży|Łomża|ul. Wojska Polskiego 29A |18-400 Łomża;903;328;328;12;316;36.32;3.66
101625;206201;Zespół Szkół Ogólnokształcących w Łomży|Łomża|ul. Bernatowicza 4 |18-400 Łomża;1461;654;654;12;642;44.76;1.83
101626;206201;II Liceum Ogólnokształcące w Łomży|Łomża|ul. Plac Tadeusza Kościuszki 3 |18-400 Łomża;1363;527;527;8;519;38.66;1.52
101627;206201;III Liceum Ogólnokształcące w Łomży|Łomża|ul. Senatorska 13 |18-400 Łomża;1414;653;653;5;648;46.18;0.77
101628;206201;Zespół Szkół Drzewnych i Gimnazjalnych w Łomży|Łomża|ul. Marii Skłodowskiej Curie 5 |18-400 Łomża;712;362;362;1;361;50.84;0.28
101629;206201;Przedszkole Publiczne nr 1 w Łomży|Łomża|ul. Wyzwolenia 1A |18-400 Łomża;1540;827;827;9;818;53.70;1.09
101630;206201;Szkoła Podstawowa Nr 5 w Łomży|Łomża|ul. Polna 40A |18-400 ;1329;651;651;11;640;48.98;1.69
101631;206201;Przedszkole Publiczne TWP "PINOKIO" w Łomży|Łomża|ul. Studencka 11 |18-400 Łomża;2247;1200;1200;11;1189;53.40;0.92
101632;206201;Miejskie Przedsiębiorstwo Komunikacji Z.B. w Łomży|Łomża|ul. Spokojna 9 |18-400 Łomża;1416;593;593;9;584;41.88;1.52
101633;206201;Państwowa Wyższa Szkoła Informatyki i Przedsiębiorczości w Łomży|Łomża|ul. Akademicka 14 |18-400 Łomża;1180;551;551;9;542;46.69;1.63
101634;206201;Niepubliczne Przedszkole "Wesołe Słoneczko" Stowarzyszenie "EDUKATOR" w Łomży|Łomża|ul. Spółdzielcza 74 |18-400 Łomża;1714;842;842;24;818;49.12;2.85
101635;206201;Szkoła Podstawowa Nr 7 w Łomży|Łomża|ul. Adama Mickiewicza 6 |18-400 Łomża;1579;844;844;12;832;53.45;1.42
101636;206201;Publiczne Gimnazjum Nr 1 w Łomży|Łomża|ul. Władysława Reymonta 9 |18-400 Łomża;1469;733;733;20;713;49.90;2.73
101637;206201;Publiczne Gimnazjum Nr 1 w Łomży|Łomża|ul. Władysława Reymonta 9 |18-400 Łomża;1790;756;756;17;739;42.23;2.25
101638;206201;Przedszkole Publiczne Nr 9 w Łomży|Łomża|ul. Bolesława Prusa 11A |18-400 Łomża;1763;871;871;12;859;49.40;1.38
101639;206201;Przedszkole Publiczne Nr 14 w Łomży|Łomża|ul. Kołłątaja 8 |18-400 Łomża;2053;869;869;31;838;42.33;3.57
101640;206201;Przedszkole Publiczne nr 15 w Łomży|Łomża|ul. Kołłątaja 10 |18-400 Łomża;1716;870;870;21;849;50.70;2.41
101641;206201;Szkoła Podstawowa Nr 10 w Łomży|Łomża|ul. Juliana Ursyna Niemcewicza 17 |18-400 Łomża;1731;845;845;11;834;48.82;1.30
101642;206201;Szkoła Podstawowa Nr 10 w Łomży|Łomża|ul. Juliana Ursyna Niemcewicza 17 |18-400 Łomża;1582;781;781;11;770;49.37;1.41
101643;206201;Świetlica Spółdzielni Mieszkaniowej "Perspektywa" w Łomży|Łomża|ul. Kazańska 1 |18-400 Łomża;1747;838;838;14;824;47.97;1.67
101644;206201;Spółdzielnia Mieszkaniowa "Perspektywa" w Łomży|Łomża|ul. Kazańska 1 |18-400 Łomża;2008;1006;1006;17;989;50.10;1.69
101645;206201;Przedszkole Publiczne Nr 10 w Łomży|Łomża|ul. Księżnej Anny 12 |18-400 Łomża;1442;699;699;10;689;48.47;1.43
101646;206201;Przedszkole Publiczne Nr 10 w Łomży|Łomża|ul. Księżnej Anny 12 |18-400 Łomża;1902;906;906;21;885;47.63;2.32
101647;206201;Szkoła Podstawowa Nr 9 w Łomży|Łomża|ul. Księżnej Anny 18 |18-400 Łomża;1936;930;930;12;918;48.04;1.29
101648;206201;Szkoła Podstawowa Nr 9 w Łomży|Łomża|ul. Księżnej Anny 18 |18-400 Łomża;1770;842;842;32;810;47.57;3.80
101649;206201;Zespół Szkół Specjalnych w Łomży|Łomża|ul. Nowogrodzka 4 |18-400 Łomża;780;348;348;3;345;44.62;0.86
101650;206201;Szkoła Podstawowa Nr 5 w Łomży|Łomża|ul. Polna 40A |18-400 Łomża;1197;574;574;13;561;47.95;2.26
101651;206201;Świetlica Spółdzielni Mieszkaniowej "Perspektywa" w Łomży|Łomża|ul. Kazańska 1 |18-400 Łomża;1419;764;764;10;754;53.84;1.31
101652;206201;Szpital Wojewódzki im. Kardynała Stefana Wyszyńskiego w Łomży|Łomża|Al. Józefa Piłsudskiego 11 |18-400 Łomża;152;116;116;3;113;76.32;2.59
101653;206301;Przedszkole nr 1|Suwałki|ul. M. Buczka 41 |16-400 Suwałki;2199;1017;1017;18;999;46.25;1.77
101654;206301;Szkoła Podstawowa nr 4 im. ks. Kazimierza Aleksandra Hamerszmita|Suwałki|ul. Wojska Polskiego 13 |16-400 Suwałki;1563;688;688;27;661;44.02;3.92
101655;206301;Klub Wojskowy 14 Suwalskiego Dywizjonu Artylerii Przeciwpancernej im. Marszałka Józefa Piłsudskiego|Suwałki|ul. Wojska Polskiego 40 |16-400 Suwałki;1468;750;750;10;740;51.09;1.33
101656;206301;I Liceum Ogólnokształcące im. Marii Konopnickiej|Suwałki|ul. A. Mickiewicza 3 |16-400 Suwałki;2071;1070;1070;23;1047;51.67;2.15
101657;206301;Suwalski Ośrodek Doskonalenia Nauczycieli|Suwałki|ul. Kamedulska 3 |16-400 Suwałki;1332;649;649;10;639;48.72;1.54
101658;206301;Biblioteka Publiczna im. Marii Konopnickiej|Suwałki|ul. E. Plater 33A |16-400 Suwałki;1268;643;643;14;629;50.71;2.18
101659;206301;Zespół Szkół nr 8 Szkoła Podstawowa nr 2 im. Aleksandry Piłsudskiej|Suwałki|ul. T. Kościuszki 126 |16-400 Suwałki;2062;893;893;29;864;43.31;3.25
101660;206301;Przedszkole nr 2|Suwałki|ul. L. Waryńskiego 29 |16-400 Suwałki;649;271;271;8;263;41.76;2.95
101661;206301;Suwalska Specjalna Strefa Ekonomiczna|Suwałki|ul. T. Noniewicza 49 |16-400 Suwałki;1116;472;472;19;453;42.29;4.03
101662;206301;Państwowa Wyższa Szkoła Zawodowa im. prof. Edwarda Franciszka Szczepanika|Suwałki|ul. T. Noniewicza 10 |16-400 Suwałki;1353;674;674;8;666;49.82;1.19
101663;206301;Suwalski Ośrodek Kultury|Suwałki|ul. T. Noniewicza 71 |16-400 Suwałki;763;351;351;10;341;46.00;2.85
101664;206301;Naczelna Organizacja Techniczna|Suwałki|ul. 1 Maja 15 |16-400 Suwałki;1710;823;823;15;808;48.13;1.82
101665;206301;Zespół Szkół Technicznych|Suwałki|ul. Sejneńska 33 |16-400 Suwałki;1235;519;519;11;508;42.02;2.12
101666;206301;Zespół Szkół nr 1|Suwałki|ul. T. Noniewicza 83 |16-400 Suwałki;1725;871;871;17;854;50.49;1.95
101667;206301;Suwalska Spółdzielnia Mieszkaniowa|Suwałki|ul. J. Korczaka 2A |16-400 Suwałki;1248;690;690;7;683;55.29;1.01
101668;206301;Przedszkole nr 3|Suwałki|ul. J. Korczaka 4A |16-400 Suwałki;1296;671;671;9;662;51.77;1.34
101669;206301;Filia nr 3 Biblioteki Publicznej|Suwałki|ul. Północna 26 |16-400 Suwałki;1781;784;784;18;766;44.02;2.30
101670;206301;Filia nr 2 Biblioteki Publicznej|Suwałki|ul. Klonowa 41 |16-400 Suwałki;2130;1102;1102;17;1085;51.74;1.54
101671;206301;Poradnia Psychologiczno-Pedagogiczna|Suwałki|ul. Nowomiejska 10 |16-400 Suwałki;1997;971;971;19;952;48.62;1.96
101672;206301;Zespół Szkół nr 9 Szkoła Podstawowa nr 5 im. Alfreda Wierusz-Kowalskiego|Suwałki|ul. Klonowa 51 |16-400 Suwałki;2137;1122;1122;19;1103;52.50;1.69
101673;206301;Zespół Szkół nr 9 Gimnazjum nr 4|Suwałki|ul. Klonowa 51 |16-400 Suwałki;1524;737;737;14;723;48.36;1.90
101674;206301;Przedszkole nr 10 im. Marii Konopnickiej|Suwałki|ul. Nowomiejska 18 |16-400 Suwałki;2034;963;963;9;954;47.35;0.93
101675;206301;Dom Pomocy Społecznej "Kalina"|Suwałki|ul. K. Pułaskiego 66 |16-400 Suwałki;159;87;87;5;82;54.72;5.75
101676;206301;Przedszkole nr 8 z Oddz. Integracyjnymi|Suwałki|ul. A. Putry 4B |16-400 Suwałki;1920;828;828;15;813;43.12;1.81
101677;206301;Przedszkole nr 7|Suwałki|ul. W. Andersa 10 |16-400 Suwałki;1507;700;700;9;691;46.45;1.29
101678;206301;Zespół Szkół nr 7 Szkoła Podstawowa nr 7|Suwałki|ul. R. Minkiewicza 50 |16-400 Suwałki;2060;936;936;24;912;45.44;2.56
101679;206301;Oddział Terenowy Stowarzyszenia OHP|Suwałki|ul. Paca 4 |16-400 Suwałki;1941;958;958;21;937;49.36;2.19
101680;206301;Przedszkole nr 6|Suwałki|ul. A. Wierusza-Kowalskiego 19 |16-400 Suwałki;1387;592;592;7;585;42.68;1.18
101681;206301;Zespół Szkół nr 7 Gimnazjum nr 6 im. Jana Pawła II|Suwałki|ul. R. Minkiewicza 50 |16-400 Suwałki;1931;855;855;17;838;44.28;1.99
101682;206301;Przedszkole nr 5 z Oddz. Integracyjnym|Suwałki|ul. W. Witosa 4 |16-400 Suwałki;1477;650;650;10;640;44.01;1.54
101683;206301;Zespół Szkół nr 10|Suwałki|ul. J. Antoniewicza 5 |16-400 Suwałki;1584;683;683;8;675;43.12;1.17
101684;206301;Międzyzakładowa Spółdzielnia Mieszkaniowa|Suwałki|ul. I. Daszyńskiego 25A |16-400 Suwałki;1469;663;663;19;644;45.13;2.87
101685;206301;Zespół Szkół nr 3 Gimnazjum nr 5 im. gen. bryg. pil. Witolda Urbanowicza|Suwałki|ul. Szpitalna 66 |16-400 Suwałki;1542;649;649;20;629;42.09;3.08
101686;206301;Zespół Szkół Nr 3 Szkoła Podstawowa nr 11|Suwałki|ul. Szpitalna 66 |16-400 Suwałki;1300;598;598;13;585;46.00;2.17
101687;206301;Areszt Śledczy|Suwałki|Wojska Polskiego 29 |16-400 Suwałki;587;240;240;44;196;40.89;18.33
101688;206301;Specjalistyczny Psychiatryczny Samodzielny Publiczny Zakład Opieki Zdrowotnej|Suwałki|Szpitalna 62 |16-400 Suwałki;196;37;37;2;35;18.88;5.41
101689;206301;Szpital Wojewódzki im. dr Ludwika Rydygiera|Suwałki|Szpitalna 60 |16-400 Suwałki;174;51;51;3;48;29.31;5.88
101690;220101;Gminna Biblioteka i Ośrodek Kultury w Borzytuchomiu|Borzytuchom|ul. Czterdziestolecia 2 |77-141 Borzytuchom;1485;662;662;47;615;44.58;7.10
101691;220101;Sala Wiejska|Dąbrówka| 22 |77-100 Bytów;461;141;141;13;128;30.59;9.22
101692;220101;Szkoła Podstawowa w Niedarzynie|Niedarzyno| 21b |77-141 Borzytuchom;421;204;204;18;186;48.46;8.82
101693;220102;Zespół Szkół Ogólnokształcących|Bytów|ul. Gdańska 57 |77-100 Bytów;704;369;369;14;355;52.41;3.79
101694;220102;Szkoła Podstawowa Nr 2|Bytów|ul. Ks. dr Bolesława Domańskiego 13 |77-100 Bytów;973;519;519;7;512;53.34;1.35
101695;220102;Zespół Szkół Ogólnokształcących|Bytów|ul. Gdańska 57 |77-100 Bytów;812;429;429;9;420;52.83;2.10
101696;220102;Starostwo Powiatowe Bytów|Bytów|ul. Ks. dr Bolesława Domańskiego 2 |77-100 Bytów;1141;619;619;19;600;54.25;3.07
101697;220102;Przedszkole|Bytów|ul. Słoneczna 22 |77-100 Bytów;889;428;428;20;408;48.14;4.67
101698;220102;Gimnazjum Nr 2|Bytów|ul. Gen. Władysława Sikorskiego 37 |77-100 Bytów;1170;514;514;11;503;43.93;2.14
101699;220102;Gimnazjum Nr 1|Bytów|ul. Gen. Ludwika Mierosławskiego 7 |77-100 Bytów;1143;677;677;14;663;59.23;2.07
101700;220102;Szkoła Specjalnego Ośrodka Szkolno - Wychowawczego|Bytów|ul. Jana Styp-Rekowskiego 2a |77-100 Bytów;1010;523;523;7;516;51.78;1.34
101701;220102;Zespół Szkół Ekonomiczno - Usługowych|Bytów|ul. Hieronima Derdowskiego 3 |77-100 Bytów;1259;623;623;21;602;49.48;3.37
101702;220102;Zespół Szkół Ekonomiczno - Usługowych - Sala Gimnastyczna|Bytów|ul. Hieronima Derdowskiego 7 |77-100 Bytów;918;381;381;15;366;41.50;3.94
101703;220102;Szkoła Podstawowa Nr 1|Bytów|ul. Młyńska 11 |77-100 Bytów;1013;474;474;15;459;46.79;3.16
101704;220102;Przedszkole Nr 2|Bytów|ul. Jana Bauera 9 |77-100 Bytów;1141;554;554;9;545;48.55;1.62
101705;220102;Zespół Szkół Ponadgimnazjalnych|Bytów|ul. Gen. Władysława Sikorskiego 35 |77-100 Bytów;928;420;420;14;406;45.26;3.33
101706;220102;Szkoła Podstawowa|Gostkowo| 20 |77-114 Gostkowo;785;277;277;11;266;35.29;3.97
101707;220102;Szkoła Podstawowa|Pomysk Wielki| 26 |77-121 Pomysk Wielki;875;365;365;13;352;41.71;3.56
101708;220102;Szkoła Podstawowa Nr 2|Bytów|ul. Ks. dr Bolesława Domańskiego 13 |77-100 Bytów;821;512;512;5;507;62.36;0.98
101709;220102;Świetlica Wiejska|Mądrzechowo|ul. Brylantowa 6 |77-100 Bytów;432;237;237;10;227;54.86;4.22
101710;220102;Świetlica Wiejska|Ząbinowice| 19 |77-100 Bytów;419;192;192;16;176;45.82;8.33
101711;220102;Bytowskie Centrum Kultury|Bytów|ul. Wojska Polskiego 12 |77-100 Bytów;559;245;245;14;231;43.83;5.71
101712;220102;Świetlica Wiejska|Udorpie| 12 |77-100 Bytów;808;406;406;17;389;50.25;4.19
101713;220102;Szkoła Podstawowa|Niezabyszewo| 9 |77-132 Niezabyszewo;636;265;265;11;254;41.67;4.15
101714;220102;Szkoła Podstawowa|Rekowo| 18 |77-131 Rekowo;654;296;296;20;276;45.26;6.76
101715;220102;Szpital Powiatu Bytowskiego Spółka z o.o.|Bytów|Lęborska 13 |77-100 Bytów;77;23;23;1;22;29.87;4.35
101716;220103;Gminne Centrum Kultury i Biblioteka|w Czarnej Dąbrówce|ul.Bytowska 10 |77-116 Czarna Dąbrówka;1404;477;477;39;438;33.97;8.18
101717;220103;Wiejski Dom Kultury|Jasień| 6 |77-122 Jasień;414;214;214;9;205;51.69;4.21
101718;220103;Budynek byłej Szkoły Podstawowej|Mikorowo| 15/2 |76-243 Mikorowo;585;186;186;4;182;31.79;2.15
101719;220103;Zespół Szkół w Rokitach|Rokity| 34 |77-123 Rokity;1224;544;544;23;521;44.44;4.23
101720;220103;Zespół Szkół w Nożynie|Nożyno| 40 |77-115 Nożyno;890;331;331;23;308;37.19;6.95
101721;220104;Urząd Gminy|Kołczygłowy|ul. Słupska 56 |77-140 Kołczygłowy;1008;474;474;13;461;47.02;2.74
101722;220104;Gminny Ośrodek Kultury|Kołczygłowy|ul. Szkolna 1 |77-140 Kołczygłowy;1398;477;477;46;431;34.12;9.64
101723;220104;Budynek Szkoły w Gałęźni Wielkiej|Gałąźnia Wielka| 27 |77-140 Kołczygłowy;396;141;141;19;122;35.61;13.48
101724;220104;Zespoł Szkół w Łubnie|Łubno| 22 |77-140 Kołczygłowy;553;180;180;20;160;32.55;11.11
101725;220105;Zespół Szkół|Borowy Młyn|ul.Kaszubska 1 |77-138 Borowy Młyn;689;325;325;13;312;47.17;4.00
101726;220105;Budynek byłej szkoły|Borzyszkowy| 4 |77-130 Lipnica;906;391;391;24;367;43.16;6.14
101727;220105;Zespół Szkół|Brzeźno Szlacheckie|Jana Pawła II 79 |77-139 Brzeźno Szlacheckie;897;397;397;7;390;44.26;1.76
101728;220105;Zespół Szkół|Lipnica|ul. Szkolna 2 |77-130 Lipnica;981;488;488;17;471;49.75;3.48
101729;220105;Szkoła Podstawowa|Zapceń| 6 |77-130 Lipnica;678;323;323;26;297;47.64;8.05
101730;220106;Sanus S.C w Miastku|Miastko|Osiedle Ceglane 1 |77-200 Miastko;968;443;443;10;433;45.76;2.26
101731;220106;Siedziba Miejsko-Gminnej Komisji ds. Rozwiązywania Problemów Alkoholowych w Miastku|Miastko|Juliana Tuwima 1 |77-200 Miastko;975;464;464;15;449;47.59;3.23
101732;220106;Przedszkole Miejskie Nr 3 w Miastku|Miastko|Juliana Tuwima 2 |77-200 Miastko;1189;544;544;24;520;45.75;4.41
101733;220106;Państwowa Straż Pożarna w Miastku|Miastko|ul. Konstytucji 3 Maja 2a |77-200 Miastko;1106;487;487;14;473;44.03;2.87
101734;220106;Przedszkole Miejskie Nr 1 w Miastku|Miastko|ul. Koszalińska 19 |77-200 Miastko;835;317;317;10;307;37.96;3.15
101735;220106;Zespoł Szkół Ogólnokształcących i Technicznych w Miastku|Miastko|ul. Młodzieżowa 3 |77-200 Miastko;1167;524;524;6;518;44.90;1.15
101736;220106;Szkoła Podstawowa Nr 2 w Miastku|Miastko|ul. Kujawska 1 |77-200 Miastko;1006;427;427;10;417;42.45;2.34
101737;220106;Centrostal Konstrukcje Sp. zo.o w Miastku|Miastko|ul. Kaszubska 20 |77-200 Miastko;1311;522;522;21;501;39.82;4.02
101738;220106;Zespół Szkół w Dretyniu|Dretyń| 26 |77-203 Miastko;1106;357;357;20;337;32.28;5.60
101739;220106;Szkoła Podstawowa w Słosinku|Słosinko| 4 |77-211 Miastko;968;223;223;20;203;23.04;8.97
101740;220106;Szkoła Podstawowa w Świerznie|Świerzno| 4 |77-222 Miastko;995;294;294;15;279;29.55;5.10
101741;220106;Świetlica Wiejska w Trzcinnie|Trzcinno| 8a |77-200 Miastko;838;214;214;7;207;25.54;3.27
101742;220106;Szkoła Podstawowa w Piaszczynie|Piaszczyna| 6-7 |77-207 Miastko;968;277;277;13;264;28.62;4.69
101743;220106;Środowiskowy Dom Samopomocy w Miastku|Miastko|Juliana Tuwima 1 |77-200 Miastko;878;298;298;4;294;33.94;1.34
101744;220106;Szkoła Podstawowa Nr 2 w Miastku|Miastko|ul. Kujawska 1 |77-200 Miastko;1245;483;483;14;469;38.80;2.90
101745;220106;Szpital Miejski w Miastku sp z o.o.|Miastko|Wybickiego 30 |77-200 Miastko;138;51;51;2;49;36.96;3.92
101746;220107;Gminny Ośrodek Kultury|Parchowo|ul. Kartuska 5 |77-124 Parchowo;1409;846;846;30;816;60.04;3.55
101747;220107;Wiejski Dom Kultury|Nakla|Długa 11 6|77-127 Nakla;747;331;331;19;312;44.31;5.74
101748;220107;Budynek po byłej szkole|Chośnica| 7 |77-124 Parchowo;244;111;111;3;108;45.49;2.70
101749;220107;Sala wiejska|Żukówko| 17A |77-121 Pomysk Wielki;337;140;140;6;134;41.54;4.29
101750;220108;Świetlica Wiejska w Studzienicach|Studzienice|ul.Brzozowa 5 |77-143 Studzienice;1392;623;623;11;612;44.76;1.77
101751;220108;Świetlica Wiejska w Półcznie|Półczno| 6 |77-125 Półczno;627;285;285;15;270;45.45;5.26
101752;220108;Ośrodek Kultury Gminy Studzienice w Ugoszczy|Ugoszcz| 12b |77-142 Ugoszcz;773;374;374;15;359;48.38;4.01
101753;220109;Urząd Gminy w Trzebielinie|Trzebielino| 7a |77-235 Trzebielino;1286;476;476;13;463;37.01;2.73
101754;220109;Biblioteka Gminy Trzebielino Filia w Suchorzu|Suchorze| 30 |77-235 Trzebielino;1603;540;540;21;519;33.69;3.89
101755;220109;Chrześcijański Ośrodek dla Osób Uzależnionych "Teen Challenge"|Broczyna| 11 |77-235 Trzebielino;36;21;21;1;20;58.33;4.76
101756;220110;Zespół Szkół|Tuchomie|ul. ks. Jana Hinza 1 |77-133 Tuchomie;1063;445;445;13;432;41.86;2.92
101757;220110;Urząd Gminy|Tuchomie|ul. Jana III Sobieskiego 16 |77-133 Tuchomie;994;332;332;18;314;33.40;5.42
101758;220110;Wiejski Ośrodek Kultury|Trzebiatkowa| 37 |77-134 Tuchomie;650;272;272;9;263;41.85;3.31
101759;220110;Wiejski Ośrodek Kultury|Kramarzyny|ul. Leśna 1 |77-135 Tuchomie;504;220;220;17;203;43.65;7.73
101760;220201;Zespół Szkół Nr 7|Chojnice|ul. Tuwima 2 |89-600 Chojnice;1505;832;832;12;820;55.28;1.44
101761;220201;Szkoła Podstawowa Nr 1|Chojnice|ul. 31 Stycznia 21 |89-600 Chojnice;1361;616;616;16;600;45.26;2.60
101762;220201;Zespół Szkół Ponadgimnazjalnych Nr 1|Chojnice|ul. Kościerska 11 |89-604 Chojnice;1410;756;756;10;746;53.62;1.32
101763;220201;Zespół Szkół Specjalnych|Chojnice|ul. Jana Pawła II 11 |89-604 Chojnice;840;450;450;16;434;53.57;3.56
101764;220201;Szkoła Podstawowa nr 3|Chojnice|ul. Dworcowa 6 |89-620 Chojnice;1732;753;753;25;728;43.48;3.32
101765;220201;Zespół Szkół Ponadgimnazjalnych Nr 2|Chojnice|ul. Angowicka 45 |89-600 Chojnice;2023;881;881;10;871;43.55;1.14
101766;220201;Świetlica Zakładu Energetycznego|Chojnice|ul. 14 Lutego 15 |89-600 Chojnice;1739;955;955;33;922;54.92;3.46
101767;220201;Gimnazjum nr 2|Chojnice|ul. Szpitalna 3 |89-600 Chojnice;1312;504;504;8;496;38.41;1.59
101768;220201;Zespół Szkół|Chojnice|ul. Nowe Miasto 4-6 |89-600 Chojnice;1259;491;491;19;472;39.00;3.87
101769;220201;Gimnazjum nr 1|Chojnice|ul. Młodzieżowa 44 |89-604 Chojnice;1045;506;506;14;492;48.42;2.77
101770;220201;HALA WIDOWISKOWO- SPORTOWA "CENTRUM PARK"|Chojnice|ul. WAGNERA 3 |89-600 Chojnice;1172;663;663;9;654;56.57;1.36
101771;220201;Świetlica Sp-ni Mieszkaniowej|Chojnice|ul. Łanowa 11A |89-620 Chojnice;1538;757;757;28;729;49.22;3.70
101772;220201;Powiatowa Bursa dla Młodzieży Szkolnej|Chojnice|ul. Świętopełka 1 |89-620 Chojnice;1829;953;953;22;931;52.10;2.31
101773;220201;Szkoła Podstawowa Nr 5|Chojnice|ul. Wicka Rogali 18 |89-604 Chojnice;1635;861;861;18;843;52.66;2.09
101774;220201;Świetlica Sp-ni Mieszkaniowej|Chojnice|ul. Młodzieżowa 35 |89-604 Chojnice;1747;910;910;6;904;52.09;0.66
101775;220201;Świetlica Miejskiego Zakładu Energetyki Cieplnej|Chojnice|ul. Ceynowy 15 |89-604 Chojnice;1405;702;702;23;679;49.96;3.28
101776;220201;Świetlica Osiedlowa|Chojnice|ul. Jabłoniowa 43 |89-600 Chojnice;1464;778;778;14;764;53.14;1.80
101777;220201;Przedszkole Niepubliczne z Grupą Żłobkową "MISIOWA AKADEMIA"|Chojnice|ul. Kardynała Stefana Wyszyńskiego 8 |89-600 Chojnice;1740;954;954;14;940;54.83;1.47
101778;220201;Żłobek Miejski|Chojnice|ul. Młodzieżowa 7 |89-604 Chojnice;1396;723;723;13;710;51.79;1.80
101779;220201;Sala konferencyjna Szpitala Specjalistycznego im.J.K. Łukowicza|Chojnice|ul.Leśna 10 |89-600 Chojnice;1265;685;685;16;669;54.15;2.34
101780;220201;Zespół Szkół nr 7|Chojnice|Tuwima 2 |89-600 chojnice;1512;820;820;16;804;54.23;1.95
101781;220201;Świetlica Szpitala Specjalistycznego im. J.K.Łukowicza|Chojnice|Leśna 10 |89-600 Chojnice;110;22;22;0;22;20.00;0.00
101782;220201;Dom Pomocy Społecznej|Chojnice|Leśna 12 |89-600 Chojnice;61;34;34;3;31;55.74;8.82
101783;220201;Świetlica Aresztu Śledczego|Chojnice|Pietruszkowa 4 |89-600 Chojnice;137;50;50;3;47;36.50;6.00
101784;220202;Centrum Kultury i Biblioteki im. Jana Karnowskiego w Brusach|Brusy|ul. Dworcowa 18 |89-632 Brusy;807;479;479;19;460;59.36;3.97
101785;220202;Gimnazjum w Brusach|Brusy|ul. Ogrodowa 2 |89-632 Brusy;824;501;501;12;489;60.80;2.40
101786;220202;Gimnazjum w Brusach|Brusy|ul. Ogrodowa 2 |89-632 Brusy;625;368;368;6;362;58.88;1.63
101787;220202;Ochotnicza Straż Pożarna w Brusach|Brusy|ul. Gdańska 1B |89-632 Brusy;793;441;441;9;432;55.61;2.04
101788;220202;Szkoła Podstawowa im. Jana Pawła II w Brusach|Brusy|ul. Ogrodowa 2 |89-632 Brusy;720;386;386;14;372;53.61;3.63
101789;220202;Urząd Miejski w Brusach|Brusy|ul. Na Zaborach 1 |89-632 Brusy;1325;645;645;23;622;48.68;3.57
101790;220202;Szkoła Podstawowa im. Kard. St. Wyszyńskiego w Leśnie|Leśno|ul. Kard. St. Wyszyńskiego 15 |89-634 Leśno;1462;716;716;22;694;48.97;3.07
101791;220202;Szkoła Podstawowa w Lubni|Lubnia|ul. Szkolna 13 |89-632 Brusy;992;510;510;24;486;51.41;4.71
101792;220202;Szkoła Podstawowa w Zalesiu|Zalesie|Gdańska 26 |89-632 Brusy;459;155;155;6;149;33.77;3.87
101793;220202;Szkoła Podstawowa w Kosobudach|Kosobudy|ul. Szkolna 20 |89-632 Brusy;925;522;522;17;505;56.43;3.26
101794;220202;Szkoła Podstawowa w Męcikale|Męcikał|Szkolna 7 |89-632 Brusy;572;287;287;18;269;50.17;6.27
101795;220202;Szkoła Podstawowa im. Stanisława Sikorskiego w Wielkich Chełmach|Wielkie Chełmy| 35 |89-632 Brusy;562;188;188;4;184;33.45;2.13
101796;220202;Szkoła Podstawowa im. Bł.Ks.Józefa Jankowskiego w Czyczkowach|Czyczkowy|Główna 46 |89-632 Brusy;645;316;316;16;300;48.99;5.06
101797;220203;Wiejski Dom Kultury w Swornegaciach|Swornegacie|ul. Mestwina 10 |89-608 Swornegacie;955;437;437;13;424;45.76;2.97
101798;220203;Zespół Szkół w Charzykowach|Charzykowy|ul. Szkolna 1 |89-606 Charzykowy;1387;776;776;17;759;55.95;2.19
101799;220203;Świetlica Wiejska w Chojniczkach|Chojniczki|ul. Chojnicka 76 |89-606 Charzykowy;911;498;498;12;486;54.67;2.41
101800;220203;Świetlica Wiejska w Kłodawie|Kłodawa| 4 |89-632 Brusy;851;411;411;18;393;48.30;4.38
101801;220203;Świetlica Wiejska w Krojantach|Krojanty|ul. 18 Pułku Ułanów Pomorskich 11 |89-641 Nowa Cerkiew;1000;456;456;14;442;45.60;3.07
101802;220203;Zespół Szkół w Nowej Cerkwi|Nowa Cerkiew|ul. Szkolna 11 |89-641 Nowa Cerkiew;1137;459;459;19;440;40.37;4.14
101803;220203;Zespół Szkół w Pawłowie|Pawłowo|ul. Tucholska 16 |89-620 Chojnice;1114;542;542;20;522;48.65;3.69
101804;220203;Wiejski Dom Kultury w Silnie|Silno|ul. Główna 49 |89-620 Chojnice;767;286;286;11;275;37.29;3.85
101805;220203;Świetlica Wiejska w Racławkach|Racławki| 23 |89-620 Chojnice;535;205;205;11;194;38.32;5.37
101806;220203;Szkoła Podstawowa w Ostrowitem|Ostrowite|ul. Szkolna 3 |89-620 Chojnice;779;220;220;10;210;28.24;4.55
101807;220203;Szkoła Podstawowa w Lichnowach|Lichnowy|ul. Szkolna 15 |89-620 Chojnice;1105;427;427;17;410;38.64;3.98
101808;220203;Gimnazjum w Sławęcinie|Sławęcin|ul. Szkolna 11 |89-620 Chojnice;638;257;257;17;240;40.28;6.61
101809;220203;Szkoła Podstawowa w Ogorzelinach|Ogorzeliny|ul. Obkaska 3 |89-665 Ogorzeliny;892;347;347;42;305;38.90;12.10
101810;220203;Świetlica Wiejska w Nowym Dworze|Nowy Dwór| 19 2|89-665 Ogorzeliny;455;164;164;5;159;36.04;3.05
101811;220203;Szkoła Podstawowa w Nieżychowicach|Nieżychowice| 55 |89-620 Chojnice;1125;435;435;12;423;38.67;2.76
101812;220204;Szkoła Podstawowa Nr 1 w Czersku|Czersk|ul. Dworcowa 8 |89-650 Czersk;1722;856;856;29;827;49.71;3.39
101813;220204;Zespół Szkół im. Jana Pawła II w Czersku|Czersk|ul. Kościuszki 6 |89-650 Czersk;1827;875;875;36;839;47.89;4.11
101814;220204;Remiza OSP w Czersku|Czersk|ul. Starogardzka 42 |89-650 Czersk;1954;983;983;20;963;50.31;2.03
101815;220204;Ośrodek Kultury w Czersku|Czersk|ul. Szkolna 11 |89-650 Czersk;2136;872;872;28;844;40.82;3.21
101816;220204;Liceum Ogólnokształcące im. Wincentego Pola w Czersku|Czersk|ul. Szkolna 3 |89-650 Czersk;1583;610;610;26;584;38.53;4.26
101817;220204;Świetlica Wiejska w Gutowcu|Gutowiec|ul. Czerska 3a |89-642 Rytel;362;154;154;4;150;42.54;2.60
101818;220204;Zespół Szkół w Rytlu Filia w Krzyżu|Krzyż|- 28 |89-642 Rytel;490;204;204;9;195;41.63;4.41
101819;220204;Zespół Szkół w Rytlu|Rytel|ul. Ks.Kowalkowskiego 6 |89-642 Rytel;1597;748;748;41;707;46.84;5.48
101820;220204;Ośrodek Kultury w Rytlu|Rytel|ul. Ks. Kowalkowskiego 11 |89-642 Rytel;478;196;196;8;188;41.00;4.08
101821;220204;Zespół Szkół w Rytlu Filia w Zapędowie|Zapędowo| 12 |89-642 Rytel;317;108;108;0;108;34.07;0.00
101822;220204;Zespół Szkół Ponadgimnazjalnych w Malachinie|Malachin|ul. Główna 11 |89-650 Czersk;668;282;282;13;269;42.22;4.61
101823;220204;Szkoła Podstawowa w Gotelpiu|Gotelp| 12 |89-651 Gotelp;824;294;294;12;282;35.68;4.08
101824;220204;Szkoła Podstawowa w Odrach|Odry|ul. Długa 1 |89-651 Gotelp;593;271;271;13;258;45.70;4.80
101825;220204;Ośrodek Kultury w Łęgu|Łąg|ul. Chojnicka 30 |89-652 Łąg;1889;823;823;16;807;43.57;1.94
101826;220204;Oddział Zewnętrzny Aresztu Śledczego w Chojnicach|Czersk|Dworcowa 29 |89-650 Czersk;57;32;32;12;20;56.14;37.50
101827;220205;Sala gimnastyczna przy Zespole Szkół Publicznych w Konarzynach|Konarzyny|ul.Szkolna 12 |89-607 Konarzyny;1760;786;786;16;770;44.66;2.04
101828;220301;Ośrodek Doradztwa Rolniczego|Człuchów|Osiedle Młodych 9 |77-300 Człuchów;1212;651;651;17;634;53.71;2.61
101829;220301;Gimnazjum nr 1|Człuchów|ul. Szkolna 3 |77-300 Człuchów;1359;713;713;7;706;52.47;0.98
101830;220301;Urząd Miejski|Człuchów|al. Wojska Polskiego 1 |77-300 Człuchów;1200;526;526;18;508;43.83;3.42
101831;220301;Niepubliczne Przedszkole MOTYLEK|Człuchów|ul. Słowackiego 2 |77-300 Człuchów;793;339;339;10;329;42.75;2.95
101832;220301;Przedszkole Niepubliczne BAJKA|Człuchów|ul. Sobieskiego 7 |77-300 Człuchów;1710;828;828;24;804;48.42;2.90
101833;220301;Szkoła Podstawowa nr 1|Człuchów|ul. Średnia 4a 2 |77-300 Człuchów;1660;849;849;32;817;51.14;3.77
101834;220301;Miejski Dom Kultury|Człuchów|ul. Traugutta 2 |77-300 Człuchów;1622;828;828;19;809;51.05;2.29
101835;220301;Wyższa Szkoła Pedagogiczna im. J.Korczaka w Warszawie Wydział Zamiejscowy w Człuchowie|Człuchów|os. Witosa 20 20 |77-300 Człuchów;1687;865;865;15;850;51.27;1.73
101836;220301;Szpital Powiatowy w Człuchowie|Człuchów|Szczecińska 31 |77-300 Człuchów;113;33;33;4;29;29.20;12.12
101837;220302;Czarneńskie Centrum Kultury|Czarne|ul.Kolejowa 14 |77-330 Czarne;1628;684;684;26;658;42.01;3.80
101838;220302;Przedszkole Gminne|Czarne|ul.Parkowa 7 |77-330 Czarne;1541;630;630;32;598;40.88;5.08
101839;220302;Lokal po byłym kasynie wojskowym|Czarne|ul. Świerczewskiego 1 |77-330 Czarne;1330;620;620;21;599;46.62;3.39
101840;220302;Świetlica Wiejska|Nadziejewo| 21 |77-330 Czarne;264;88;88;5;83;33.33;5.68
101841;220302;Świetlica Wiejska|Wyczechy| 18 |77-326 Wyczechy;681;240;240;9;231;35.24;3.75
101842;220302;Międzypokoleniowe Wiejskie Centrum Aktywności|Bińcze| 12 |77-324 Bińcze;544;198;198;15;183;36.40;7.58
101843;220302;Świetlica Wiejska|Domisław| 30a |77-330 Czarne;493;126;126;7;119;25.56;5.56
101844;220302;Klub Animacji Społecznej|Krzemieniewo| 34 |77-330 Czarne;573;183;183;11;172;31.94;6.01
101845;220302;Zakład Karny|Czarne|Pomorska 1 |77-330 Czarne;1286;458;458;63;395;35.61;13.76
101846;220302;Dom Pomocy Społecznej|Czarne|Zamkowa 19 |77-330 Czarne;103;57;57;3;54;55.34;5.26
101847;220303;Szkoła Podstawowa|Polnica| 72 |77-300 Człuchów;1407;493;493;23;470;35.04;4.67
101848;220303;Szkoła Podstawowa|Rychnowy| 5 |77-300 Człuchów;1308;495;495;26;469;37.84;5.25
101849;220303;Szkoła Podstawowa|Wierzchowo-Dworzec|ul. Szkolna 16 |77-300 Człuchów;2014;663;663;47;616;32.92;7.09
101850;220303;Świetlica Wiejska|Mosiny| 26 |77-300 Człuchów;864;276;276;19;257;31.94;6.88
101851;220303;Świetlica Wiejska|Kołdowo| 42 |77-300 Człuchów;1089;480;480;19;461;44.08;3.96
101852;220303;Szkoła Podstawowa|Stołczno| 1 |77-300 Człuchów;829;233;233;11;222;28.11;4.72
101853;220303;Świetlica Wiejska|Barkowo| 31a |77-300 Człuchów;723;210;210;14;196;29.05;6.67
101854;220304;Ośrodek Pomocy Społecznej|Debrzno|ul.Ogrodowa 27 |77-310 Debrzno;858;359;359;16;343;41.84;4.46
101855;220304;Centrum Kultury Sportu i Turystyki|Debrzno|ul.Wojska Polskiego 2 |77-310 Debrzno;1064;365;365;22;343;34.30;6.03
101856;220304;Centrum Kultury Sportu i Turystyki|Debrzno|Wojska Polskiego 2 |77-310 Debrzno;1229;446;446;18;428;36.29;4.04
101857;220304;Ochotnicza Straż Pożarna|Debrzno|Miła 8 |77-310 Debrzno;969;438;438;11;427;45.20;2.51
101858;220304;Świetlica Wiejska Stanisławka|Stanisławka| 10B |77-310 Debrzno;379;65;65;8;57;17.15;12.31
101859;220304;Świetlica Wiejska Strzeczona|Strzeczona| 4A |77-310 Debrzno;524;142;142;10;132;27.10;7.04
101860;220304;Świetlica Wiejska Słupia|Słupia| 38A |77-310 Debrzno;480;134;134;11;123;27.92;8.21
101861;220304;Świetlica Wiejska Uniechów|Uniechów| 18C |77-310 Debrzno;469;127;127;4;123;27.08;3.15
101862;220304;Świetlica Wiejska Cierznie|Cierznie| 20 |77-310 Debrzno;384;148;148;6;142;38.54;4.05
101863;220304;Świetlica Wiejska Nowe Gronowo|Nowe Gronowo| 27 |77-310 Debrzno;367;75;75;4;71;20.44;5.33
101864;220304;Pałac Stare Gronowo|Stare Gronowo| 48 |77-310 Debrzno;547;151;151;4;147;27.61;2.65
101865;220305;Sala Wiejska w Bielsku|Bielsko| 10 |77-220 Koczała;475;156;156;8;148;32.84;5.13
101866;220305;Gminny Ośrodek Kultury w Koczale|Koczała|Klonowa 9 |77-220 Koczała;806;315;315;11;304;39.08;3.49
101867;220305;Zespół Kształcenia i Wychowania w Koczale|Koczała|Szkolna 16 |77-220 Koczała;1006;396;396;23;373;39.36;5.81
101868;220305;Sala Wiejska w Pietrzykowie|Pietrzykowo| 24 |77-220 Koczała;451;155;155;15;140;34.37;9.68
101869;220305;"TEEN CHALLENGE" Chrześcijański Ośrodek dla Osób Uzależnionych|ŁĘKINIA| 17 |77-220 Koczała;51;35;35;3;32;68.63;8.57
101870;220306;Świetlica wiejska|Szczytno| 11 |77-320 Przechlewo;369;89;89;5;84;24.12;5.62
101871;220306;Świetlica Wiejska|Nowa Wieś| 55a |77-320 Przechlewo;619;206;206;11;195;33.28;5.34
101872;220306;Szkoła Podstawowa|Sąpolno| 45 |77-320 Przechlewo;580;250;250;12;238;43.10;4.80
101873;220306;Dom Kultury|Przechlewo|ul. Młyńska 11 |77-320 Przechlewo;939;355;355;9;346;37.81;2.54
101874;220306;Przedszkole|Przechlewo|Osiedle Juźkowa 14 |77-320 Przechlewo;934;422;422;33;389;45.18;7.82
101875;220306;Publiczne Gimnazjum|Przechlewo|Szkolna 4e |77-320 Przechlewo;880;405;405;12;393;46.02;2.96
101876;220306;Świetlica wiejska|Lisewo| 3a |77-320 Przechlewo;273;97;97;8;89;35.53;8.25
101877;220306;Świetlica wiejska|Płaszczyca| 12b |77-320 Przechlewo;275;67;67;6;61;24.36;8.96
101878;220307;Gminne Centrum Kultury Sportu Turystyki i Rekreacji|Rzeczenica|ul.Lipowa 1 |77-304 Rzeczenica;654;240;240;9;231;36.70;3.75
101879;220307;Zespół Szkół w Rzeczenicy|Rzeczenica|ul. Przechlewska 6 |77-304 Rzeczenica;794;263;263;24;239;33.12;9.13
101880;220307;Świetlica wiejska w Brzeziu|Brzezie|Koszalińska 33 |77-304 Rzeczenica;400;149;149;4;145;37.25;2.68
101881;220307;Świetlica wiejska w Międzyborzu|Międzybórz| 22 |77-304 Rzeczenica;425;145;145;10;135;34.12;6.90
101882;220307;Świetlica Wiejska w Gwieździnie|Gwieździn| 18a |77-304 Rzeczenica;427;149;149;9;140;34.89;6.04
101883;220307;Zespół Szkół w Rzeczenicy Filia w Pieniężnicy|Pieniężnica| 55 |77-304 Rzeczenica;280;80;80;5;75;28.57;6.25
101884;220401;Niepubliczne Przedszkole "Bursztynek"|Pruszcz Gdański|ul. Edmunda Pawła Strzeleckiego 4 |83-000 Pruszcz Gdański;1229;763;763;5;758;62.08;0.66
101885;220401;Zespół Szkół Nr 2|Pruszcz Gdański|ul. Tysiąclecia 5 |83-000 Pruszcz Gdański;926;556;556;13;543;60.04;2.34
101886;220401;Pedagogiczna Biblioteka Wojewódzka w Gdańsku Filia w Pruszczu Gdańskim|Pruszcz Gdański|ul. Obrońców Pokoju 6 |83-000 Pruszcz Gdański;2020;1123;1123;18;1105;55.59;1.60
101887;220401;Miejski Ośrodek Pomocy Społecznej|Pruszcz Gdański|ul. Niepodległości 9 |83-000 Pruszcz Gdański;1022;616;616;9;607;60.27;1.46
101888;220401;Przedszkole Publiczne Nr 3 im. Kubusia Puchatka|Pruszcz Gdański|ul. Niepodległości 10 |83-000 Pruszcz Gdański;2029;1052;1052;26;1026;51.85;2.47
101889;220401;Centrum Kultury i Sportu|Pruszcz Gdański|ul.Fryderyka Chopina 34 |83-000 Pruszcz Gdański;997;577;577;6;571;57.87;1.04
101890;220401;Szkoła Podstawowa Nr 3|Pruszcz Gdański|ul. Jana Matejki 1 |83-000 Pruszcz Gdański;1784;1054;1054;20;1034;59.08;1.90
101891;220401;Szkoła Podstawowa Nr 3|Pruszcz Gdański|ul. Jana Matejki 1 |83-000 Pruszcz Gdański;826;358;358;6;352;43.34;1.68
101892;220401;Kasyno Wojskowe|Pruszcz Gdański|ul. Dywizjonu 303 |83-000 Pruszcz Gdański;798;506;506;5;501;63.41;0.99
101893;220401;Zespół Szkół Ogólnokształcących Nr 1|Pruszcz Gdański|ul. Juliana Ursyna Niemcewicza 1 |83-000 Pruszcz Gdański;1139;676;676;14;662;59.35;2.07
101894;220401;Niepubliczne Przedszkole im. Janusza Korczaka|Pruszcz Gdański|ul. Żwirki i Wigury 8 |83-000 Pruszcz Gdański;2229;1278;1278;22;1256;57.34;1.72
101895;220401;Hala Widowiskowo-Sportowa przy ZSO Nr 1|Pruszcz Gdański|ul. Juliana Ursyna Niemcewicza 1 |83-000 Pruszcz Gdański;1124;586;586;16;570;52.14;2.73
101896;220401;Hala Widowiskowo-Sportowa przy ZSO Nr 1|Pruszcz Gdański|ul. Juliana Ursyna Niemcewicza 1 |83-000 Pruszcz Gdański;1011;581;581;6;575;57.47;1.03
101897;220401;Zespół Szkół Nr 4|Pruszcz Gdański|ul. Jana Kasprowicza 16 |83-000 Pruszcz Gdański;1999;1284;1284;19;1265;64.23;1.48
101898;220401;Zespół Szkół Nr 4|Pruszcz Gdański|ul. Jana Kasprowicza 16 |83-000 Pruszcz Gdański;1204;727;727;13;714;60.38;1.79
101899;220401;Przedszkole Niepubliczne "JEDYNECZKA"|Pruszcz Gdański|ul. Jana Kochanowskiego 8 |83-000 Pruszcz Gdański;1208;682;682;13;669;56.46;1.91
101900;220402;Szkoła Podstawowa|Cedry Małe|ul.Żuławska 58 |83-020 Cedry Wielkie;1517;550;550;26;524;36.26;4.73
101901;220402;Żuławski Ośrodek Kultury i Sportu|Cedry Wielkie|ul.Osadników Wojskowych 8 |83-020 Cedry Wielkie;1814;768;768;28;740;42.34;3.65
101902;220402;Szkoła Podstawowa|Trutnowy|ul.Św.Piotra i Pawła 3 |83-020 Cedry Wielkie;1214;501;501;19;482;41.27;3.79
101903;220402;Świetlica Wiejska|Koszwały|ul.Lipowa 15 |83-011 Wiślinka;626;234;234;7;227;37.38;2.99
101904;220403;Urząd Gminy (dawny GOK)|Kolbudy|ul. Staromłyńska 1 |83-050 Kolbudy;2288;1285;1285;35;1250;56.16;2.72
101905;220403;Zespół Kształcenia Podstawowego i Gimnazjalnego|Kolbudy|ul. Gen. Józefa Wybickiego 33 |83-050 Kolbudy;1892;1191;1191;18;1173;62.95;1.51
101906;220403;Szkoła Podstawowa w Pręgowie|Pręgowo|ul. Brzozowa 1 |83-050 Kolbudy;2293;1162;1162;44;1118;50.68;3.79
101907;220403;Budynek gospodarczy (świetlica wiejska)|Bąkowo|ul. Otomińska 6 |83-050 Kolbudy;1962;1137;1137;19;1118;57.95;1.67
101908;220403;Dom Kultury w Kowalach|Kowale|ul. Glazurowa 1 |80-180 Gdańsk;1726;1052;1052;15;1037;60.95;1.43
101909;220403;Niepubliczna Szkoła Podstawowa i Gimnazjum w Kowalach|Kowale|Sadowa 21 |80-180 Gdańsk;746;464;464;5;459;62.20;1.08
101910;220403;Urząd Gminy w Kolbudach (dawny GOK)|Kolbudy|Staromłyńksa 1 |83-050 Kolbudy;792;378;378;10;368;47.73;2.65
101911;220404;Świetlica Wiejska|Jagatowo|Żurawia 27 |83-010 Straszyn;844;392;392;9;383;46.45;2.30
101912;220404;Szkoła Podstawowa im. Romualda Traugutta|Wojanowo|Parkowa 4 |83-000 Pruszcz Gdański;780;239;239;17;222;30.64;7.11
101913;220404;Zespół Szkół im. Ignacego Krasickiego|Straszyn|Starogardzka 48 |83-010 Straszyn;1746;1023;1023;16;1007;58.59;1.56
101914;220404;Zespół Szkół im. Ignacego Krasickiego|Straszyn|Starogardzka 48 |83-010 Straszyn;1656;1027;1027;12;1015;62.02;1.17
101915;220404;Zespół Szkół im. Karola Wojtyły|Rotmanka|Aleja Piłsudskiego 37 |83-010 Straszyn;2040;1416;1416;22;1394;69.41;1.55
101916;220404;Zespół Szkolno-Przedszkolny|Borkowo|Akacjowa 2 |80-180 Gdańsk;2232;1400;1400;12;1388;62.72;0.86
101917;220404;Świetlica Wiejska|Juszkowo|Sportowa 10a |83-000 Pruszcz Gdański;2045;1258;1258;25;1233;61.52;1.99
101918;220404;Szkoła Podstawowa im. Orła Białego|Wiślinka|Szkolna 10 |83-011 Wiślinka;1597;806;806;20;786;50.47;2.48
101919;220404;Centrum Profilaktyki Uzależnień|Rokitnica|Bałtycka 3C |83-021 Wiślina;1306;620;623;23;597;47.47;3.71
101920;220404;Zespół Szkół w Łęgowie|Łęgowo|Szkolna 9 |83-031 Łęgowo;1850;987;987;29;958;53.35;2.94
101921;220404;Ośrodek Kultury, Sportu i Biblioteka Publiczna|Cieplewo|Długa 20a |83-031 Łęgowo;789;454;454;9;445;57.54;1.98
101922;220404;Zespół Szkół Rolniczych Centrum Kształcenia Praktycznego im. Macieja Rataja|Rusocin|Macieja Rataja 12 |83-031 Łęgowo;1031;539;539;17;522;52.28;3.15
101923;220404;Szkoła Podstawowa|Wiślina|Mostowa 5 |83-021 Wiślina;1247;513;513;18;495;41.14;3.51
101924;220405;Remiza Strażacka|Jodłowno|ul. Kasztanowa 21 |83-047 Przywidz;1113;506;506;22;484;45.46;4.35
101925;220405;Gimnazjum|Przywidz|ul. Szkolna 1 |83-047 Przywidz;2155;941;941;55;886;43.67;5.84
101926;220405;Szkoła Podstawowa (Trzepowo)|Borowina|ul. Długa 1 |83-047 Przywidz;1176;475;475;22;453;40.39;4.63
101927;220406;Urząd Gminy w Pszczółkach|Pszczółki|Pomorska 20 |83-032 Pszczółki;1330;623;623;28;595;46.84;4.49
101928;220406;Szkoła Podstawowa w Pszczółkach|Pszczółki|Szkolna 4 |83-032 Pszczółki;1183;573;573;7;566;48.44;1.22
101929;220406;Szkoła Podstawowa w Skowarczu|Skowarcz|Gdańska 9 |83-032 Pszczółki;1085;503;503;22;481;46.36;4.37
101930;220406;Szkoła Podstawowa w Żelisławkach|Żelisławki| 3 |83-032 Pszczółki;637;225;225;15;210;35.32;6.67
101931;220406;Szkoła Podstawowa w Różynach|Różyny|Kościelna 2 |83-031 Łęgowo;1209;583;583;22;561;48.22;3.77
101932;220406;Publicznme Gimnazjum w Pszczółkach|Pszczółki|Pomorska 25 |83-032 Pszczółki;1013;555;555;14;541;54.79;2.52
101933;220406;Fundacja ,,Żyć godnie" Kolnik|Kolnik|Dębowa 4 |83-032 Pszczółki;417;190;190;5;185;45.56;2.63
101934;220407;Zespół Szkół|Suchy Dąb|ul. Sportowa 11 |83-022 Suchy Dąb;1180;512;512;21;491;43.39;4.10
101935;220407;świetlica wiejska|Krzywe Koło| 45 |83-022 Suchy Dąb;1274;395;395;18;377;31.00;4.56
101936;220407;Zespół Szkolno-Przedszkolny|Grabiny-Zameczek|ul. Gdańska 88 |83-022 Suchy Dąb;773;327;327;14;313;42.30;4.28
101937;220408;Szkoła Podstawowa w Czerniewie|Czerniewo| 9 |83-042 Ełganowo;1464;558;558;11;547;38.11;1.97
101938;220408;Szkoła Podstawowa w Mierzeszynie|Mierzeszyn|ul. Wolności 19 |83-041 Mierzeszyn;1448;455;455;32;423;31.42;7.03
101939;220408;Szkoła Podstawowa w Sobowidzu|Sobowidz|ul. Tadeusza Kościuszki 18 |83-033 Sobowidz;1725;640;640;27;613;37.10;4.22
101940;220408;Szkoła Podstawowa w Trąbkach Wielkich|Trąbki Wielkie|ul. Sportowa 19 |83-034 Trąbki Wielkie;2290;896;896;38;858;39.13;4.24
101941;220408;Szkoła Podstawowa w Kłodawie|Kłodawa|ul. Szkolna 10 |83-035 Kłodawa;1171;560;561;18;542;47.82;3.21
101942;220501;Dom Kultury w Chmielnie|Chmielno|ul. Gryfa Pomorskiego 20 |83-333 Chmielno;2028;1181;1181;40;1141;58.23;3.39
101943;220501;Szkoła Podstawowa|Miechucino|ul. Szkolna 1 |83-334 Miechucino;1727;862;862;36;826;49.91;4.18
101944;220501;Szkoła Podstawowa|Borzestowo| 182 |83-335 Borzestowo;701;388;388;13;375;55.35;3.35
101945;220501;Świetlica Wiejska|Garcz|Kartuska 25 |83-333 Chmielno;1093;547;547;18;529;50.05;3.29
101946;220502;Szkoła Podstawowa Nr 2|Kartuzy|ul. Wzgórze Wolności 1 |83-300 Kartuzy;2279;1393;1393;32;1361;61.12;2.30
101947;220502;Szkoła Podstawowa Nr 1|Kartuzy|ul. 3 Maja 14 |83-300 Kartuzy;2262;1121;1121;43;1078;49.56;3.84
101948;220502;Urząd Miejski w Kartuzach|Kartuzy|ul. gen. Józefa Hallera 1 |83-300 Kartuzy;1700;907;907;27;880;53.35;2.98
101949;220502;Gimnazjum Nr 1|Kartuzy|ul. Marszałka Piłsudskiego 10 |83-300 Kartuzy;1674;1023;1023;23;1000;61.11;2.25
101950;220502;Zespół Szkół Ogólnokształcących Nr 2|Kartuzy|osiedle Wybickiego 33 |83-300 Kartuzy;1319;726;726;11;715;55.04;1.52
101951;220502;Zespół Szkół Ogólnokształcących Nr 2|Kartuzy|osiedle Wybickiego 33 |83-300 Kartuzy;1125;652;652;22;630;57.96;3.37
101952;220502;Gminne Przedszkole z Oddziałami Integracyjnymi Akademia Przedszkolaka|Kartuzy|osiedle Wybockiego 33 |83-300 Kartuzy;1123;656;656;12;644;58.41;1.83
101953;220502;Szkoła Podstawowa|Mirachowo|ul.Szkolna 2 |83-329 Mirachowo;1024;497;497;15;482;48.54;3.02
101954;220502;Zespół Szkół|Staniszewo| 2A |83-328 Sianowo;1033;479;479;27;452;46.37;5.64
101955;220502;Ośrodek Geriatryczny|Sianowo| 4 |83-328 Sianowo;1041;516;516;25;491;49.57;4.84
101956;220502;Szkoła Podstawowa|Prokowo|ul.Szkolna 1 |83-300 Kartuzy;1176;558;558;22;536;47.45;3.94
101957;220502;Szkoła Podstawowa|Grzybno|ul.Szkolna 12 |83-300 Kartuzy;1187;652;652;14;638;54.93;2.15
101958;220502;Zespół Kształcenia i Wychowania|Dzierżążno|ul.Edukacji Narodowej 4a |83-332 Dzierżążno;1710;1006;1006;21;985;58.83;2.09
101959;220502;Dom Strażaka|Dzierżążno|ul.Kartuska 31 |83-332 Dzierżążno;909;510;510;8;502;56.11;1.57
101960;220502;Zespół Szkół|Kiełpino|ul.Szkolna 29 |83-307 Kiełpino;1280;698;698;17;681;54.53;2.44
101961;220502;Zespół Szkół|Kiełpino|ul.Szkolna 29 |83-307 Kiełpino;1348;664;664;13;651;49.26;1.96
101962;220502;Szkoła Podstawowa|Łapalice|ul.Szkolna 2 |83-300 Kartuzy;798;412;412;5;407;51.63;1.21
101963;220502;Zespół Kształcenia i Wychowania|Brodnica Górna|ul.Chmieleńska 1 |83-324 Brodnica Górna;1500;743;743;29;714;49.53;3.90
101964;220502;Powiatowe Centrum Zdrowia Sp. z o.o. NZOZ w Kartuzach|Kartuzy|Ceynowy 7 |83-300 Kartuzy;54;12;12;0;12;22.22;0.00
101965;220502;Szpital Specjalistyczny w Kościerzynie Sp. z o.o. Placówka w Dzierżążnie|Dzierżążno|Szpitalna 36 |83-332 Dzierżążno;87;14;14;0;14;16.09;0.00
101966;220503;Zespół Szkół - Szkoła Podstawowa i Publiczne Gimnazjum (sala sportowa)|Przodkowo|ul. Sportowa 1 |83-304 Przodkowo;1410;716;716;19;697;50.78;2.65
101967;220503;Zespół Szkół - Szkoła Podstawowa i Publiczne Gimnazjum|Przodkowo|ul. Sportowa (stołowka ) 1 |83-304 Przodkowo;921;516;516;13;503;56.03;2.52
101968;220503;Zespół Szkół-SPiPG w Czeczewie|Czeczewo|ul. Gdańska 8 |84-208 Kielno;1089;601;601;16;585;55.19;2.66
101969;220503;Zespół Szkół - Szkoła Podstawowa i Publiczne Gimnazjum|Pomieczyno|ul. Kartuska 14 |83-305 Pomieczyno;1470;782;782;32;750;53.20;4.09
101970;220503;Zespół Szkóły Podstawowej i Publicznego Gimnazjum w Przodkowie|Przodkowo|ul. Sportowa 1 ( sala Nr 5) 1 |83-304 Przodkowo;1318;687;687;13;674;52.12;1.89
101971;220504;Zespół Szkół Ponadgimnazjalnych w Sierakowicach|Sierakowice|ul. Dworcowa 3 |83-340 Sierakowice;1244;761;761;29;732;61.17;3.81
101972;220504;Urząd Gminy w Sierakowicach|Sierakowice|ul. Lęborska 30 |83-340 Sierakowice;1941;1177;1177;36;1141;60.64;3.06
101973;220504;Gminny Ośrodek Kultury w Sierakowicach|Sierakowice|ul. Kartuska 27 |83-340 Sierakowice;1857;1021;1021;31;990;54.98;3.04
101974;220504;Szkoła Podstawowa w Sierakowicach|Sierakowice|ul. Kubusia Puchatka 7 |83-340 Sierakowice;870;496;496;17;479;57.01;3.43
101975;220504;Szkoła Podstawowa w Puzdrowie|Puzdrowo| 32 |83-340 Sierakowice;1180;648;648;46;602;54.92;7.10
101976;220504;Zespół Szkół w Gowidlinie|Gowidlino|ul. Wyszyńskiego 5 |83-341 Gowidlino;1603;888;888;50;838;55.40;5.63
101977;220504;Remiza Ochotniczej Straży Pożarnej w Kamienicy Królewskiej|Kamienica Królewska|ul. Królewska 10 |83-342 Kamienica Królewska;837;400;400;22;378;47.79;5.50
101978;220504;Szkoła Podstawowa w Mojuszu|Mojusz| 23 |83-334 Miechucino;915;422;422;25;397;46.12;5.92
101979;220504;Szkoła Podstawowa w Lisich Jamach|Lisie Jamy| 60 A |83-335 Borzestowo;878;427;427;25;402;48.63;5.85
101980;220504;Zespół Szkół w Tuchlinie|Tuchlino| 16 B |83-340 Sierakowice;839;474;474;26;448;56.50;5.49
101981;220504;Gimnazjum Sierakowice|Sierakowice|Spacerowa 14 |83-340 Sierakowice;1238;784;784;28;756;63.33;3.57
101982;220505;Remiza Ochotniczej Straży Pożarnej w Egiertowie,|Egiertowo| 39 |83-312 Hopowo;1416;552;552;39;513;38.98;7.07
101983;220505;Remiza Ochotniczej Straży Pożarnej w Goręczynie|Goręczyno|Kasztelańska 63a |83-311 Goręczyno;2160;994;994;44;950;46.02;4.43
101984;220505;Gminny Ośrodek Kultury - sala na parterze|Somonino|Ceynowy 1a |83-314 Somonino;2208;1173;1173;55;1118;53.12;4.69
101985;220505;Remiza Ochotniczej Straży Pożarnej w Hopowie|Hopowo| 33 |83-312 Hopowo;1360;496;496;27;469;36.47;5.44
101986;220505;Remiza Ochotniczej Straży Pożarnej w Somoninie - sala na I-wszym piętrze|Somonino|Ceynowy 1a |83-314 Somonino;386;195;195;10;185;50.52;5.13
101987;220506;Zespół Kształcenia i Wychowania|Stężyca|ul. Abrahama 2 |83-322 Stężyca;1256;674;674;20;654;53.66;2.97
101988;220506;Zespół Kształcenia i Wychowania|Stężyca|ul. Abrahama 2 |83-322 Stężyca;1203;678;678;34;644;56.36;5.01
101989;220506;Zespół Kształcenia i Wychowania|Kamienica Szlachecka|ul.Długa 13 |83-323 Kamienica Szlachecka;1280;635;635;24;611;49.61;3.78
101990;220506;Zespół Kształcenia i Wychowania|Klukowa Huta|ul. Józefa Wybickiego 6 |83-322 Stężyca;1065;510;510;26;484;47.89;5.10
101991;220506;Zespół Kształcenia i Wychowania|Gołubie|ul. Sambora II 17 |83-316 Gołubie;536;260;260;10;250;48.51;3.85
101992;220506;Zespół Kształcenia i Wychowania|Gołubie|ul.Sambora II 17 |83-316 Gołubie;891;466;466;14;452;52.30;3.00
101993;220506;Zespół Kształcenia i Wychowania|Szymbark|ul. Szkolna 1 |83-315 Szymbark;1017;514;514;19;495;50.54;3.70
101994;220507;Zespół Szkół w Sulęczynie|Sulęczyno|ul. Stefana Żeromskiego 16 |83-320 Sulęczyno;1497;823;823;42;781;54.98;5.10
101995;220507;Zespół Szkół w Mściszewicach|Mściszewice|Szkolna 5 |83-321 Sulęczyno;854;385;385;25;360;45.08;6.49
101996;220507;Szkoła Podstawowa w Węsiorach|Węsiory| 63a |83-320 Sulęczyno;663;327;327;17;310;49.32;5.20
101997;220507;Zespół Szkół w Sulęczynie|Sulęczyno|ul. Stefana Żeromskiego 16 |83-320 Sulęczyno;1011;479;479;18;461;47.38;3.76
101998;220508;Zespół Publicznego Gimnazjum w Chwaszczynie i Szkoły Podstawowej w Chwaszczynie|Chwaszczyno|ul. Mickiewicza 16 |80-209 Chwaszczyno;1429;868;868;21;847;60.74;2.42
101999;220508;Zespół Publicznego Gimnazjum w Chwaszczynie i Szkoły Podstawowej w Chwaszczynie|Chwaszczyno|ul. Mickiewicza 16 |80-209 Chwaszczyno;1289;891;891;10;881;69.12;1.12
102000;220508;Szkoła Podstawowa w Tuchomiu|Tuchom|ul. Gdyńska 106 |80-209 Chwaszczyno;854;486;486;26;460;56.91;5.35
102001;220508;Szkoła Podstawowa w Miszewie|Miszewo|Strażacka 9 |80-297 Banino;676;377;377;10;367;55.77;2.65
102002;220508;Centrum Kulturalno-Sportowe w Małkowie|Małkowo|ul. Pałacowa 92 |83-330 Żukowo;490;252;252;5;247;51.43;1.98
102003;220508;Szkoła Podstawowa w Pępowie|Pępowo|ul. Gdańska 117 |83-330 Żukowo;1263;759;759;16;743;60.10;2.11
102004;220508;Zespół Publicznego Gimnazjum i Szkoły Podstawowej w Baninie - budynek Publicznego Gimnazjum w Baninie|Banino|ul. Lotnicza 15 |80-297 Banino;1370;894;894;15;879;65.26;1.68
102005;220508;Zespół Publicznego Gimnazjum i Szkoły Podstawowej w Baninie - budynek Szkoły Podstawowej im. ks. prałata Józefa Bigusa w Baninie|Banino|ul.Tuchomska 15 |80-297 Banino;1931;1219;1219;13;1206;63.13;1.07
102006;220508;Zespół Publicznego Gimnazjum i Szkoły Podstawowej w Baninie - budynek Publicznego Gimnazjum w Baninie|Banino|ul. Lotnicza 15 |80-297 Banino;983;526;526;12;514;53.51;2.28
102007;220508;Zespół Publicznego Gimnazjum w Leźnie i Szkoły Podstawowej w Leźnie|Leźno|ul. Aleja Lipowa 44 |80-298 Gdańsk-Kokoszki;1890;1004;1004;37;967;53.12;3.69
102008;220508;Szkoła Podstawowa w Niestępowie|Niestępowo|ul. Raduńska 62 |83-331 Przyjaźń;1545;843;843;25;818;54.56;2.97
102009;220508;Zespół Publicznego Gimnazjum w Przyjaźni i Szkoły Podstawowej w Przyjaźni|Przyjaźń|ul. Szkolna 2 |83-331 Przyjaźń;1657;840;840;30;810;50.69;3.57
102010;220508;Szkoła Podstawowa w Skrzeszewie|Skrzeszewo| 3 |83-331 Przyjaźń;1155;408;408;24;384;35.32;5.88
102011;220508;Szkoła Podstawowa w Glinczu|Glincz|ul. Brzozowa 6 |83-330 Żukowo;1134;580;580;15;565;51.15;2.59
102012;220508;Szkoła Podstawowa w Borkowie|Borkowo|ul. Szkolna 2 |83-330 Żukowo;1083;635;635;14;621;58.63;2.20
102013;220508;Szkoła Podstawowa im. Obrońców Wybrzeża w Żukowie - budynek szkoły przy ul. Gdańskiej 66|Żukowo|ul. Gdańska 66 |83-330 Żukowo;1786;1022;1022;23;999;57.22;2.25
102014;220508;Szkoła Podstawowa im. Obrońców Wybrzeża w Żukowie|Żukowo|ul. Gdyńska 7 |83-330 Żukowo;1794;1017;1017;17;1000;56.69;1.67
102015;220508;Publiczne Gimnazjum Nr 2 w Żukowie|Żukowo|ul. Armii Krajowej 2e |83-330 Żukowo;1015;558;558;6;552;54.98;1.08
102016;220508;Publiczne Gimnazjum Nr 2 w Żukowie|Żukowo|ul. Armii Krajowej 2e |83-330 Żukowo;1226;780;780;17;763;63.62;2.18
102017;220601;Szkoła Podstawowa Nr 1|Kościerzyna|ul. 8 Marca 1 |83-400 Kościerzyna;1822;964;964;32;932;52.91;3.32
102018;220601;Zespół Szkół Publicznych Nr 1|Kościerzyna|ul. Marii Skłodowskiej-Curie 19 |83-400 Kościerzyna;1492;823;823;26;797;55.16;3.16
102019;220601;Zespół Szkół Publicznych Nr 1|Kościerzyna|ul. Marii Skłodowskiej-Curie 19 |83-400 Kościerzyna;1464;767;767;13;754;52.39;1.69
102020;220601;Zespół Szkół Publicznych Nr 1|Kościerzyna|ul. Marii Skłodowskiej-Curie 19 |83-400 Kościerzyna;1517;818;818;23;795;53.92;2.81
102021;220601;Zespół Szkół Publicznych nr 1|Kościerzyna|ul. Mari Skłodowskiej-Curie 19 |83-400 Kościerzyna;1497;826;826;13;813;55.18;1.57
102022;220601;Nadleśnictwo Państwowe Kościerzyna|Kościerzyna|ul. Marii Skłodowskiej-Curie 6 |83-400 Kościerzyna;2095;1181;1181;25;1156;56.37;2.12
102023;220601;Zespół Szkół Publicznych Nr 2|Kościerzyna|ul. Szkolna 1 |83-400 Kościerzyna;1975;950;950;23;927;48.10;2.42
102024;220601;Szkoła Podstawowa Nr 2|Kościerzyna|ul. Strzelecka 1 |83-400 Kościerzyna;1924;872;872;45;827;45.32;5.16
102025;220601;Powiatowy Zespół Szkół Nr 1|Kościerzyna|ul. Sikorskiego 1 |83-400 Kościerzyna;1062;443;443;13;430;41.71;2.93
102026;220601;Zespół Szkół Publicznych Nr 3|Kościerzyna|ul. Mestwina II 2 |83-400 Kościerzyna;1955;1022;1022;41;981;52.28;4.01
102027;220601;Szkoła Muzyczna|Kościerzyna|ul. Dworcowa 12 |83-400 Kościerzyna;1144;596;596;17;579;52.10;2.85
102028;220601;Szpital Specjalistyczny|Kościerzyna|Piechowskiego 36 |83-400 Kościerzyna;273;73;73;7;66;26.74;9.59
102029;220602;Gimnazjum im. Kard. S. Wyszyńskiego|Dziemiany|ul. Wyzwolenia 20 |83-425 Dziemiany;1511;818;818;24;794;54.14;2.93
102030;220602;Szkoła Podstawowa im. Gen. St. Sosabowskiego|Kalisz|ul. Pomorska 8 |83-425 Dziemiany;766;375;375;7;368;48.96;1.87
102031;220602;Zespół Kształcenia i Wychowania|Dziemiany|ul. Wyzwolenia 20 |83-425 Dziemiany;1045;498;498;20;478;47.66;4.02
102032;220603;Sala Sportowa w Karsinie|Karsin|Parkowa 10 |83-440 Karsin;2022;1033;1033;47;986;51.09;4.55
102033;220603;Zespół Szkół Nr 2 w Wielu|Wiele|Wicka Rogali 7 |83-441 Karsin;2013;984;984;42;942;48.88;4.27
102034;220603;Szkoła Podstawowa w Osowie|Osowo|Wielewska 23 |83-440 Karsin;653;270;270;7;263;41.35;2.59
102035;220603;Dom Pomocy Społecznej w Cisewiu|Cisewie| 35 |83-440 Cisewie;88;40;40;5;35;45.45;12.50
102036;220604;Zespół Kształcenia w Wielkim Klinczu|Wielki Klincz|ul. Szkolna 10 |83-423 Wielki Klincz;1652;783;783;43;740;47.40;5.49
102037;220604;Szkoła Podstawowa w Niedamowie|Niedamowo| 44 |83-423 Wielki Klincz;670;346;346;6;340;51.64;1.73
102038;220604;Szkoła Podstawowa w Nowym Klinczu|Nowy Klincz| 8 |83-400 Kościerzyna;904;465;465;17;448;51.44;3.66
102039;220604;Sala wiejska w Nowej Wsi Kościerskiej|Nowa Wieś Kościerska| |83-400 Kościerzyna;668;307;307;6;301;45.96;1.95
102040;220604;Zespół Kształcenia w Łubianie|Łubiana|ul. Szkolna 1 |83-407 Łubiana;1714;989;989;25;964;57.70;2.53
102041;220604;Zespół Szkół w Skorzewie|Skorzewo|ul. Peplińskiego 6 |83-400 Kościerzyna;1131;573;573;21;552;50.66;3.66
102042;220604;Zespół Szkół w Wąglikowicach|Wąglikowice|ul. Kościerska 8 |83-406 Wąglikowice;846;437;437;20;417;51.65;4.58
102043;220604;Szkoła Podstawowa w Kaliskach|Kaliska Kościerskie| 32d |83-400 Kościerzyna;771;337;337;13;324;43.71;3.86
102044;220604;Kompleks Wypoczynkowy "SZARLOTA"|Szarlota| 11 |83-400 Kościerzyna;735;339;339;6;333;46.12;1.77
102045;220604;Szkoła Podstawowa w Kornem|Korne| 4 |83-409 Korne;728;367;367;14;353;50.41;3.81
102046;220604;Salka wiejska w Dobrogoszczu|Dobrogoszcz| 89 |83-400 Kościerzyna;810;384;384;9;375;47.41;2.34
102047;220604;Zespół Szkół w Wielkim Podlesiu|Wielki Podleś| 12A |83-423 Wielki Klincz;835;415;415;9;406;49.70;2.17
102048;220605;GOKSiR|Liniewo|ul. Dworcowa 3 |83-420 Liniewo;1434;678;678;18;660;47.28;2.65
102049;220605;Szkoła Podstawowa|Wysin|ul. Wyzwolenia 4 |83-421 Wysin;894;429;429;19;410;47.99;4.43
102050;220605;Szkoła Podstawowa|Głodowo| 16 |83-412 Głodowo;527;208;208;13;195;39.47;6.25
102051;220605;Zespół Oświatowy|Garczyn| 10 |83-420 Liniewo;732;288;288;17;271;39.34;5.90
102052;220606;Urząd Gminy Lipusz|Lipusz|ul.Wybickiego 27 |83-424 Lipusz;974;525;525;18;507;53.90;3.43
102053;220606;Gminny Ośrodek Kultury Sportu i Rekreacji|Lipusz|Młyńska 12 |83-424 Lipusz;881;483;483;16;467;54.82;3.31
102054;220606;Ochotnicza Straż Pożarna|Lipusz|Młyńska 18 |83-424 Lipusz;891;471;471;23;448;52.86;4.88
102055;220607;Zespół Szkół|Nowa Karczma|ul. Szkolna 4 |83-404 Nowa Karczma;975;511;511;17;494;52.41;3.33
102056;220607;Gminny Ośrodek Kultury, Sportu i Rekreacji|Nowa Karczma|Szkolna 5 |83-404 Nowa Karczma;1041;453;453;26;427;43.52;5.74
102057;220607;Zespół Szkół|Lubań| 31 |83-422 Nowy Barkoczyn;768;344;344;15;329;44.79;4.36
102058;220607;Zespół Szkół|Lubań| 31 |83-422 Nowy Barkoczyn;1022;468;468;18;450;45.79;3.85
102059;220607;Zespół Szkół|Grabowo Kościerskie|Starowiejska 68 |83-403 Grabowo Kościerskie;1194;505;505;26;479;42.29;5.15
102060;220608;Zespół Kształcenia i Wychowania Stara Kiszewa|Stara Kiszewa|Tysiąclecia 25 |83-430 Stara Kiszewa;1276;605;605;20;585;47.41;3.31
102061;220608;Świetlica Górne Maliki|Górne Maliki| 1 |83-430 Stara Kiszewa;617;248;248;9;239;40.19;3.63
102062;220608;Świetlica Stary Bukowiec|Stary Bukowiec| 25 |83-431 Stary Bukowiec;655;264;264;8;256;40.31;3.03
102063;220608;Zespół Szkół Stare Polaszki|Stare Polaszki| 33 |83-433 Stare Polaszki;1080;499;499;16;483;46.20;3.21
102064;220608;Urząd Gminy Stara Kiszewa|Stara Kiszewa|Ogrodowa 1 |83-430 Stara Kiszewa;1506;601;601;39;562;39.91;6.49
102065;220701;Budynek Zakładu Utylizacji Odpadów sp. z o.o.|Kwidzyn|ul. Owcza 7 |82-500 Kwidzyn;1607;951;951;24;927;59.18;2.52
102066;220701;Przedszkole Niepubliczne "Promyk"|Kwidzyn|ul. Kazimierza Wielkiego 2 |82-500 Kwidzyn;1300;644;644;21;623;49.54;3.26
102067;220701;Przedszkole Niepubliczne "Promyk"|Kwidzyn|ul. Kazimierza Wielkiego 2 |82-500 Kwidzyn;1782;917;917;22;895;51.46;2.40
102068;220701;Zespół Szkół Ogólnokształcących Nr 1|Kwidzyn|ul. Konarskiego 12 |82-500 Kwidzyn;1467;769;769;18;751;52.42;2.34
102069;220701;Centrum Kształcenia Zawodowego i Ustawicznego (dawna nazwa Zespół Szkół Technicznych)|Kwidzyn|ul. Staszica 27 |82-500 Kwidzyn;1495;776;776;24;752;51.91;3.09
102070;220701;Szkoła Podstawowa Nr 2 sala gimnastyczna|Kwidzyn|ul. Mickiewicza 3 |82-500 Kwidzyn;1321;703;703;12;691;53.22;1.71
102071;220701;Gimnazjum Nr 2|Kwidzyn|ul. Mickiewicza 56B |82-500 Kwidzyn;1454;771;771;19;752;53.03;2.46
102072;220701;Gimnazjum Nr 2|Kwidzyn|ul. Mickiewicza 56B |82-500 Kwidzyn;1081;565;565;18;547;52.27;3.19
102073;220701;Szkoła Podstawowa Nr 6|Kwidzyn|ul. Grunwaldzka 54 |82-500 Kwidzyn;1304;639;639;14;625;49.00;2.19
102074;220701;Przedszkole Niepubliczne Nr 2|Kwidzyn|ul. Kasprowicza 20F |82-500 Kwidzyn;1490;769;769;8;761;51.61;1.04
102075;220701;Zespół Szkół Ogólnokształcących Nr 2|Kwidzyn|ul. Słoneczna 2 |82-500 Kwidzyn;1486;719;719;13;706;48.38;1.81
102076;220701;Hala Widowiskowo - Sportowa|Kwidzyn|ul. Wiejska 1A |82-500 Kwidzyn;1270;647;647;8;639;50.94;1.24
102077;220701;Gimnazjum Nr 3|Kwidzyn|ul. Kamienna 18 |82-500 Kwidzyn;1382;691;691;30;661;50.00;4.34
102078;220701;Gimnazjum Nr 3|Kwidzyn|ul. Kamienna 18 |82-500 Kwidzyn;1422;790;790;28;762;55.56;3.54
102079;220701;Zespół Szkół Gimnazjalnych|Kwidzyn|ul. Hallera 5 |82-500 Kwidzyn;1395;690;690;10;680;49.46;1.45
102080;220701;Kwidzyńskie Centrum Kultury|Kwidzyn|ul. 11 Listopada 13 |82-500 Kwidzyn;1349;493;493;25;468;36.55;5.07
102081;220701;Szkoła Podstawowa Nr 5|Kwidzyn|ul. Hallera 4 |82-500 Kwidzyn;1161;467;467;14;453;40.22;3.00
102082;220701;Zespół Szkół Ponadgimnazjalnych Nr 1|Kwidzyn|ul. Słowiańska 17 |82-500 Kwidzyn;1454;560;560;18;542;38.51;3.21
102083;220701;Zespół Szkół Ponadgimnazjalnych Nr 2|Kwidzyn|ul. Katedralna 5 |82-500 Kwidzyn;1326;505;505;13;492;38.08;2.57
102084;220701;Szkoła Podstawowa Nr 4|Kwidzyn|ul. Warszawska 13 |82-500 kwidzyn;1382;704;704;31;673;50.94;4.40
102085;220701;Dom Pomocy Społecznej|Kwidzyn|Malborska 18 |82-500 Kwidzyn;1083;464;464;21;443;42.84;4.53
102086;220701;„Zdrowie” Sp. z o.o Niepubliczny Zakład Opieki Zdrowotnej|Kwidzyn|ul. Hallera 31 |82-500 Kwidzyn;63;9;9;0;9;14.29;0.00
102087;220701;Dom Pomocy Społecznej|Kwidzyn|ul. Malborska 18 |82-500 Kwidzyn;84;37;37;5;32;44.05;13.51
102088;220701;Zakład Karny|Kwidzyn|ul. Lotnicza 1 |82-500 Kwidzyn;622;178;178;18;160;28.62;10.11
102089;220702;Zespół Szkół|Gardeja|ul. Sportowa 1 |82-520 Gardeja;1783;644;644;23;621;36.12;3.57
102090;220702;Szkoła Podstawowa|Czarne Dolne|ul. Szkolna 7/9 |82-520 Gardeja;1197;338;338;22;316;28.24;6.51
102091;220702;Gimnazjum|Wandowo| 60 |82-520 Gardeja;795;276;276;7;269;34.72;2.54
102092;220702;Szkoła Podstawowa|Trumieje| 12 |82-520 Gardeja;690;164;164;21;143;23.77;12.80
102093;220702;Szkoła Podstawowa|Morawy| 43 |82-520 Gardeja;839;262;262;18;244;31.23;6.87
102094;220702;Szkoła Podstawowa|Otłowiec| 26 |82-520 Gardeja;717;180;180;7;173;25.10;3.89
102095;220702;Szkoła Podstawowa|Cygany| 27 |82-520 Gardeja;464;120;120;10;110;25.86;8.33
102096;220703;Szkoła Podstawowa|Janowo| 42 |82-500 Kwidzyn;692;223;223;11;212;32.23;4.93
102097;220703;Świetlica wiejska|Pastwa| 25 |82-500 Kwidzyn;592;202;202;12;190;34.12;5.94
102098;220703;Szkoła Podstawowa|Korzeniewo|ul. Kwidzyńska 20 |82-500 Kwidzyn;562;237;237;10;227;42.17;4.22
102099;220703;Gimnazjum|Nowy Dwór| 13a |82-500 Kwidzyn;929;349;349;16;333;37.57;4.58
102100;220703;Świetlica wiejska|Mareza|ul. Długa 5 |82-500 Kwidzyn;1207;532;532;18;514;44.08;3.38
102101;220703;Dwór|Górki| 4 |82-500 Kwidzyn;484;223;223;10;213;46.07;4.48
102102;220703;Szkoła Podstawowa|Rakowiec|ul. Szkolna 2 |82-500 Kwidzyn;1550;639;639;41;598;41.23;6.42
102103;220703;Gimnazjum|Licze| 34 |82-500 Kwidzyn;619;174;174;13;161;28.11;7.47
102104;220703;Zielona Szkoła|Brachlewo| 42a |82-500 kwidzyn;654;239;239;11;228;36.54;4.60
102105;220703;Szkoła Podstawowa|Tychnowy| 81 |82-500 Kwidzyn;1221;505;505;16;489;41.36;3.17
102106;220704;Gimnazjum w Prabutach|Prabuty|Grunwaldzka 6 |82-550 Prabuty;624;144;144;15;129;23.08;10.42
102107;220704;Budynek lekcyjny przy Gimnazjum w Prabutach|Prabuty|Grunwaldzka 6 |82-550 Prabuty;855;331;331;12;319;38.71;3.63
102108;220704;Przedszkole Niepubliczne "Miś Uszatek" Beata Lewandowska w Prabutach|Prabuty|Kopernika 2 |82-550 Prabuty;760;282;282;16;266;37.11;5.67
102109;220704;Przedszkole Niepubliczne "Bratek" w Prabutach|Prabuty|Mickiewicza 3 |82-550 Prabuty;640;291;291;11;280;45.47;3.78
102110;220704;Sala gimnastyczna Gimnazjum w Prabutach|Prabuty|Grunwaldzka 6 |82-550 Prabuty;618;253;253;8;245;40.94;3.16
102111;220704;Szkoła Podstawowa Nr 2 w Prabutach (budynek główny-pokój nauczycielski)|Prabuty|Obrońców Westerplatte 11 |82-550 Prabuty;649;297;297;13;284;45.76;4.38
102112;220704;Sala gimnastyczna Szkoły Podstawowej Nr 2 w Prabutach|Prabuty|Obrońców Westerplatte 11 |82-550 Prabuty;550;262;262;5;257;47.64;1.91
102113;220704;Budynek Nauczania Początkowego przy Szkole Podstawowej Nr 2 w Prabutach|Prabuty|Obrońców Westerplatte 11A |82-550 Prabuty;846;285;285;11;274;33.69;3.86
102114;220704;Hala Sportowa przy Szkole Podstawowej Nr 2 w Prabutach|Prabuty|Obrońców Westerplatte 11B |82-550 Prabuty;873;331;331;14;317;37.92;4.23
102115;220704;Klub Nauczyciela w Prabutach|Prabuty|Brzozowa 1 |82-550 Prabuty;882;362;362;15;347;41.04;4.14
102116;220704;Szkoła Podstawowa w Obrzynowie|Obrzynowo| 37 |82-550 Prabuty;809;278;278;18;260;34.36;6.47
102117;220704;Zespół Szkół w Rodowie|Rodowo| 14 |82-550 Prabuty;568;204;204;13;191;35.92;6.37
102118;220704;Świetlica Wiejska w Sypanicy|Sypanica| 36A |82-550 Prabuty;564;172;172;8;164;30.50;4.65
102119;220704;Budynek po Szkole Podstawowej w Kołodziejach|Kołodzieje| 35 |82-550 Prabuty;488;145;145;12;133;29.71;8.28
102120;220704;Zespół Szkół w Trumiejkach|Trumiejki| 42 |82-550 Prabuty;467;105;105;14;91;22.48;13.33
102121;220704;Szpital Specjalistyczny w Prabutach|Prabuty|Kuracyjna 36 |82-550 Prabuty;220;92;92;15;77;41.82;16.30
102122;220705;Specjalny Ośrodek Szkolno-Wychowawczy|Barcice| 66 |82-420 Ryjewo;853;283;283;17;266;33.18;6.01
102123;220705;Zespół Szkół w Ryjewie|Ryjewo|Grunwaldzka 63 |82-420 Ryjewo;1514;546;546;22;524;36.06;4.03
102124;220705;Gminny Ośrodek Kultury w Ryjewie|Ryjewo|Grunwaldzka 70 |82-420 Ryjewo;967;367;367;14;353;37.95;3.81
102125;220705;Szkoła Podstawowa w Straszewie|Straszewo| 55 |82-420 Ryjewo;997;274;274;23;251;27.48;8.39
102126;220705;Dom Pomocy Społecznej w Ryjewie|Ryjewo|Słoneczna 14 |82-420 Ryjewo;53;25;25;9;16;47.17;36.00
102127;220706;Sala posiedzeń Urząd Gminy Sadlinki|Sadlinki|ul. Kwidzyńska 12 |82-522 Sadlinki;1593;655;655;46;609;41.12;7.02
102128;220706;Zespół Szkół w Nebrowie Wielkim|Nebrowo Wielkie|ul. Szkolna 6 |82-522 Sadlinki;1411;513;513;21;492;36.36;4.09
102129;220706;Zespół Szkół w Sadlinkach|Sadlinki|ul. Grudziądzka 14a |82-522 Sadlinki;1486;544;544;23;521;36.61;4.23
102130;220801;Gimnazjum Nr 1 w Lęborku|Lębork|ul. I Armii WP 10 |84-300 Lębork;1520;811;811;17;794;53.36;2.10
102131;220801;Szkoła Podstawowa Nr 8 w Lęborku|Lębork|ul. Plater 13 |84-300 Lębork;1040;570;570;15;555;54.81;2.63
102132;220801;Państwowa Szkoła Muzyczna I stopnia w Lęborku|Lębork|ul. Legionów Polskich 35 |84-300 Lębork;950;530;530;9;521;55.79;1.70
102133;220801;Zespół Szkół Gospodarki Żywnościowej i Agrobiznesu w Lęborku|Lębork|ul. Warszawska 17 |84-300 Lębork;1262;634;634;12;622;50.24;1.89
102134;220801;Zespół Szkół Ogólnokształcących Nr 1 w Lęborku|Lębork|ul. Dygasińskiego 14 |84-300 Lębork;1229;534;534;14;520;43.45;2.62
102135;220801;Przedszkole Nr 9 w Lęborku|Lębork|ul. Mireckiego 9 |84-300 Lębork;1429;786;786;9;777;55.00;1.15
102136;220801;Przedszkole nr 2 w Lęborku|Lębork|ul. Plater 12 |84-300 Lębork;1177;620;620;19;601;52.68;3.06
102137;220801;Szkoła Podstawowa Nr 8 w Lęborku, Wejście A|Lębork|ul. Mireckiego 10 |84-300 Lębork;865;474;474;6;468;54.80;1.27
102138;220801;Przedszkole Nr 1 w Lęborku|Lębork|ul. Czołgistów 37 |84-300 Lębork;1029;584;584;8;576;56.75;1.37
102139;220801;Starostwo Powiatowe w Lęborku|Lębork|ul. Czołgistów 5 |84-300 Lębork;1609;884;884;14;870;54.94;1.58
102140;220801;Zespół Szkół Nr 3 w Lęborku|Lębork|ul. Aleja Wolności 31 |84-300 Lębork;1231;432;432;12;420;35.09;2.78
102141;220801;Specjalny Ośrodek Szkolno-Wychowawczy, Internat w Lęborku|Lębork|ul. Plac Piastowski 6 |84-300 Lębork;1153;491;491;9;482;42.58;1.83
102142;220801;Szkoła Podstawowa Nr 8 w Lęborku, Wejście B|Lębork|ul. Mireckiego 10 |84-300 Lębork;996;448;448;14;434;44.98;3.12
102143;220801;Urząd Miejski w Lęborku|Lębork|ul. Armii Krajowej 14 |84-300 Lębork;1685;803;803;21;782;47.66;2.62
102144;220801;Szkoła Podstawowa Nr 3 w Lęborku|Lębork|ul. Kossaka 103 |84-300 Lębork;1365;542;542;19;523;39.71;3.51
102145;220801;Przedszkole Nr 6 w Lęborku|Lębork|ul. Kardynała Stefana Wyszyńskiego 7 |84-300 Lębork;1800;867;867;30;837;48.17;3.46
102146;220801;Przedszkole Nr 5 w Lęborku|Lębork|ul. Wyspiańskiego 1 |84-300 Lębork;1220;623;623;16;607;51.07;2.57
102147;220801;Szkoła Podstawowa Nr 5 w Lęborku, Wejście A|Lębork|ul. Kościuszki 14 |84-300 Lębork;1289;686;686;18;668;53.22;2.62
102148;220801;Przedszkole Nr 10 w Lęborku|Lębork|ul. Bolesława Krzywoustego 6 |84-300 Lębork;1358;626;626;14;612;46.10;2.24
102149;220801;Szkoła Podstawowa Nr 5 w Lęborku, Sala Gimnastyczna, Wejście B|Lębork|ul. Kościuszki 14 |84-300 Lębork;1275;538;538;16;522;42.20;2.97
102150;220801;Centrum Sportu i Rekreacji Pływalnia Miejska RAFA w Lęborku|Lębork|ul. Olimpijczyków 31 |84-300 Lębork;1555;850;850;27;823;54.66;3.18
102151;220801;Samodzielny Publiczny Specjalistyczny Zakład Opieki Zdrowotnej w Lęborku|Lębork|ul. Juliana Węgrzynowicza 13 |84-300 Lębork;22;9;9;0;9;40.91;0.00
102152;220801;Dom Pomocy Społecznej Nr 1 w Lęborku|Lębork|ul. Mieczysława Stryjewskiego 23 |84-300 Lębork;51;17;17;5;12;33.33;29.41
102153;220801;Dom Pomocy Społecznej Nr 2 w Lęborku|Lębork|ul. I Armii Wojska Polskiego 43 |84-300 Lębork;48;11;11;0;11;22.92;0.00
102154;220802;Szkoła Podstawowa im. Adama Mickiewicza|Łeba|ul. Tysiąclecia 11 |84-360 Łeba;1129;576;576;13;563;51.02;2.26
102155;220802;Miejska Biblioteka Publiczna|Łeba|ul. 11 Listopada 5A |84-360 Łeba;1062;470;470;15;455;44.26;3.19
102156;220802;Urząd Miejski|Łeba|ul. Kościuszki 90 |84-360 Łeba;1045;526;526;16;510;50.33;3.04
102157;220803;Zespół Szkół w Cewicach Szkoła Podstawowa im. ks. E. Roszczynialskiego w Cewicach|Cewice|ul. Juliana Węgrzynowicza 1 |84-312 Cewice;1659;792;792;27;765;47.74;3.41
102158;220803;Szkoła Podstawowa im. Polskich Olimpijczykow w Maszewie Lęborskim|Maszewo Lęborskie|ul. Szkolna 5 |84-315 Cewice;1035;370;370;31;339;35.75;8.38
102159;220803;Szkoła Podstawowa im. Lotników Morskich w Siemirowicach|Siemirowice|ul. Szkolna 15 |84-313 Cewice;1143;583;583;20;563;51.01;3.43
102160;220803;Szkoła Podstawowa w Łebuni|Łebunia|Sportowa 7 |84-311 Cewice;1523;581;581;38;543;38.15;6.54
102161;220804;Gminny Ośrodek Kultury|Nowa Wieś Lęborska|ul. Lęborska 20 |84-351 Nowa Wieś Lęborska;2178;1215;1215;30;1185;55.79;2.47
102162;220804;Przedszkole Michałkowo w Mostach|Mosty|Długa 42A |84-300 Lębork;1324;755;755;13;742;57.02;1.72
102163;220804;Świetlica w Lubowidzu|Lubowidz| 1 |84-300 Lębork;473;193;193;2;191;40.80;1.04
102164;220804;Zespół Szkół w Leśnicach|Leśnice| 18A |84-300 Lębork;764;282;282;11;271;36.91;3.90
102165;220804;Świetlica OSP w Chocielewku|Chocielewko| 24 |84-351 Nowa Wieś Lęborska;409;158;158;21;137;38.63;13.29
102166;220804;Zespół Szkół w Redkowicach|Redkowice| 18 |84-351 Nowa Wieś Lęborska;482;172;172;8;164;35.68;4.65
102167;220804;Szkoła Podstawowa w Janowicach|Janowice| 7 |84-351 Nowa Wieś Lęborska;531;147;147;21;126;27.68;14.29
102168;220804;Świetlica w Krępie Kaszubskiej|Krępa Kaszubska| 59F |84-351 Nowa Wieś Lęborska;463;187;187;6;181;40.39;3.21
102169;220804;Zespół Szkół w Garczegorzu|Garczegorze| 24A |84-351 Nowa Wieś Lęborska;990;386;386;13;373;38.99;3.37
102170;220804;Świetlica w Kębłowie Nowowiejskim|Kębłowo Nowowiejskie| 46 |84-351 Nowa Wieś Lęborska;467;198;198;24;174;42.40;12.12
102171;220804;Zespół Szkół w Łebieniu|Łebień| 93A |84-351 Nowa Wieś Lęborska;956;332;332;11;321;34.73;3.31
102172;220804;Świetlica w Tawęcinie|Tawęcino| 36A |84-351 Nowa Wieś Lęborska;611;172;172;6;166;28.15;3.49
102173;220804;Świetlica w Pogorzelicach|Pogorzelice| 35 |84-300 Lębork;565;190;190;6;184;33.63;3.16
102174;220805;Gminny Ośrodek Kultury i Sportu w Wicku|Wicko|Wicko 39 |84-352 Wicko;2183;849;849;35;814;38.89;4.12
102175;220805;Szkoła Podstawowa w Szczenurzy|Szczenurze| 30 |84-360 Łeba;1489;521;521;16;505;34.99;3.07
102176;220805;Szkoła Podstawowa w Maszewku|Maszewko| 7 |84-352 Wicko;817;209;209;11;198;25.58;5.26
102177;220901;Szkoła Podstawowa nr 3|Malbork|ul. S. Hadyny 18 |82-200 Malbork;1433;761;761;14;747;53.11;1.84
102178;220901;Szkoła Podstawowa nr 3|Malbork|ul. S. Hadyny 18 |82-200 Malbork;1327;752;752;16;736;56.67;2.13
102179;220901;Specjalny Ośrodek Szkolno Wychowawczy|Malbork|ul. Jagiellońska 79/82 |82-200 Malbork;1180;571;571;10;561;48.39;1.75
102180;220901;Powiatowy Urząd Pracy|Malbork|al.Armii Krajowej 70 |82-200 Malbork;1315;508;508;15;493;38.63;2.95
102181;220901;Młodzieżowy Ośrodek Wychowawczy nr 1 im. Tadeusza Kościuszki|Malbork|ul. Jagiellońska 94 |82-200 Malbork;1108;543;543;18;525;49.01;3.31
102182;220901;Zakład Gospodarki Komunalnej i Mieszkaniowej w Malborku Spółka z o.o.|Malbork|ul. Gen. de Gaulle'a 70 |82-200 Malbork;1443;708;708;12;696;49.06;1.69
102183;220901;Przedszkole nr 10|Malbork|ul. W. Reymonta 3 |82-200 Malbork;1596;734;734;13;721;45.99;1.77
102184;220901;Szkoła Podstawowa Nr 5|Malbork|ul. J. Wybickiego 32 |82-200 Malbork;1490;729;729;15;714;48.93;2.06
102185;220901;Szkoła Podstawowa Nr 8|Malbork|ul. Gen. de Gaulle'a 91 |82-200 Malbork;1375;722;722;15;707;52.51;2.08
102186;220901;Gimnazjum Nr 3|Malbork|ul. J. Wybickiego 32 |82-200 Malbork;1921;925;925;24;901;48.15;2.59
102187;220901;Centrum Profilaktyki i Terapii Uzależnień w Malborku|Malbork|ul. Nowowiejskiego 48 |82-200 Malbork;1515;671;671;6;665;44.29;0.89
102188;220901;Przedszkole Niepubliczne "Pod Kasztanami"|Malbork|ul. Zieleniecka 15 |82-200 Malbork;1659;731;731;19;712;44.06;2.60
102189;220901;Zespół Szkół nr 2|Malbork|al. Wojska Polskiego 479 |82-200 Malbork;1178;450;450;16;434;38.20;3.56
102190;220901;Zespół Szkół Ponadgimnazjalnych nr 2|Malbork|al. Wojska Polskiego 493 |82-200 Malbork;1585;695;695;24;671;43.85;3.45
102191;220901;Przedszkole Niepubliczne "Krasnal"|Malbork|ul. F. Chopina 71 |82-200 Malbork;1139;512;512;13;499;44.95;2.54
102192;220901;Zespół Szkół nr 1|Malbork|ul. Tczewska 13 |82-200 Malbork;1435;635;635;12;623;44.25;1.89
102193;220901;Zespół Szkół Katolickich im. św. Jana Pawła II w Malborku|Malbork|ul. W. Reymonta 24 |82-200 Malbork;1792;725;725;19;706;40.46;2.62
102194;220901;Gimnazjum Nr 1|Malbork|ul.S. Żeromskiego 45 |82-200 Malbork;1331;557;557;7;550;41.85;1.26
102195;220901;Przedszkole nr 5|Malbork|ul. W. Witosa 10 |82-200 Malbork;1344;658;658;14;644;48.96;2.13
102196;220901;Szkoła Podstawowa nr 9|Malbork|Plac Narutowicza 15 |82-200 Malbork;1441;696;696;19;677;48.30;2.73
102197;220901;Świetlica Malborskiej Spółdzielni Mieszkaniowej|Malbork|ul. E.Orzeszkowej 1 |82-200 Malbork;1701;885;885;11;874;52.03;1.24
102198;220901;Dom Pomocy Społecznej|Malbork|Juliusza Słowackiego 45 |82-200 Malbork;72;20;20;3;17;27.78;15.00
102199;220901;Zakład Karny|Malbork|Poczty Gdańskiej 19a |82-200 Malbork;229;104;104;15;89;45.41;14.42
102200;220901;Powiatowe Centrum Zdrowia Sp. z o.o Szpital w Malborku|Malbork|Al. Armii Krajowej 105/106 |82-200 Malbork;37;17;17;2;15;45.95;11.76
102201;220903;Świetlica Środowiskowa "Nazaret" w Lichnowach|Lichnowy|ul. Lachowicza 25A |82-224 Lichnowy;1376;491;491;23;468;35.68;4.68
102202;220903;Świetlica wiejska w Lisewie Malborskim|Lisewo Malborskie|ul. 10 Marca 51A |82-224 Lichnowy;1390;435;435;17;418;31.29;3.91
102203;220903;Budynek przy ul. Głównej 5 w Szymankowie|Szymankowo|ul. Główna 5 |82-224 Lichnowy;800;275;275;22;253;34.38;8.00
102204;220904;Urząd Gminy Malbork|Malbork|ul. Ceglana 7 |82-200 Malbork;1251;486;486;10;476;38.85;2.06
102205;220904;Świetlica wiejska w Lasowicach Wielkich|Lasowice Wielkie| |82-200 Malbork;810;298;298;13;285;36.79;4.36
102206;220904;Szkoła Podstawowa w Nowej Wsi|Nowa Wieś Malborska|ul. Moniuszki 24 |82-200 Malbork;927;434;434;11;423;46.82;2.53
102207;220904;Świetlica wiejska w Stogach|Stogi| |82-200 Malbork;703;248;248;2;246;35.28;0.81
102208;220906;Gminny Ośrodek Kultury i Sportu|Miłoradz|ul. Główna 54 |82-213 Miłoradz;1721;577;577;30;547;33.53;5.20
102209;220906;Świetlica Wiejska w Kończewicach|Kończewice| 40 |82-213 Miłoradz;984;370;370;27;343;37.60;7.30
102210;220907;Urząd Miejski|Nowy Staw|ul. Generała Józefa Bema 1 |82-230 Nowy Staw;1781;732;732;38;694;41.10;5.19
102211;220907;Nowostawskie Centrum Kultury i Biblioteki Nowostawski Ośrodek Kultury w Nowym Stawie|Nowy Staw|ul. Jana Pawła II 2 |82-230 Nowy Staw;1573;568;568;35;533;36.11;6.16
102212;220907;Zespół Szkolno-Przedszkolny Szkoła Podstawowa Nr 2 im. Wincentego Pola|Nowy Staw|ul. Gdańska 53 |82-230 Nowy Staw;1596;588;588;22;566;36.84;3.74
102213;220907;Nowostawskie Centrum Kultury i Biblioteki-Świetlica Wiejska w Lipince|Lipinka| 16a |82-230 Nowy Staw;1014;274;274;16;258;27.02;5.84
102214;220908;Gminny Ośrodek Kultury i Sportu w Starym Polu|Stare Pole|Marynarki Wojennej 1B |82-220 Stare Pole;1302;467;467;28;439;35.87;6.00
102215;220908;Zespół Szkół w Starym Polu|Stare Pole|Gen. Józefa Bema 6 |82-220 Stare Pole;1055;463;463;21;442;43.89;4.54
102216;220908;Świetlica wiejska w Królewie|Królewo| |82-220 Stare Pole;1302;429;429;27;402;32.95;6.29
102217;221001;sala narad przy Urzędzie Miasta|Krynica Morska|Górników 15 A |82-120 Krynica Morska;1172;559;559;15;544;47.70;2.68
102218;221002;Urząd Miejski|Nowy Dwór Gdański|Wejhera 3 |82-100 Nowy Dwór Gdański;1248;495;495;10;485;39.66;2.02
102219;221002;Gimnazjum nr 1|Nowy Dwór Gdański|Szkolna 2 |82-100 Nowy Dwór Gdański;1020;477;477;7;470;46.76;1.47
102220;221002;Żuławski Park Historyczny|Nowy Dwór Gdański|Kopernika 17 |82-100 Nowy Dwór Gdański;1450;752;752;7;745;51.86;0.93
102221;221002;Szkoła Podstawowa Nr 2|Nowy Dwór Gdański|Mickiewicza 10 |82-100 Nowy Dwór Gdański;1253;537;537;15;522;42.86;2.79
102222;221002;Miejskie Obiekty Sportowe|Nowy Dwór Gdański|Warszawska 22 |82-100 Nowy Dwór Gdański;1011;450;450;11;439;44.51;2.44
102223;221002;Zespół Szkół Nr 1|Nowy Dwór Gdański|3 Maja 3 |82-100 Nowy Dwór Gdański;851;407;407;16;391;47.83;3.93
102224;221002;Miejskie Przedszkole Nr 4|Nowy Dwór Gdański|Tczewska 6 |82-100 Nowy Dwór Gdański;943;501;501;7;494;53.13;1.40
102225;221002;Zespół Szkół nr 2|Nowy Dwór Gdański|Warszawska 54 |82-100 Nowy Dwór Gdański;854;267;267;10;257;31.26;3.75
102226;221002;Zespół Szkolno- Przedszkolny w Marzęcinie|Marzęcino|Polna 5 |82-100 Nowy Dwór Gdański;699;226;226;7;219;32.33;3.10
102227;221002;Świetlica Wiejska|Kępki| 45 |82-100 Nowy Dwór Gdański;766;240;240;11;229;31.33;4.58
102228;221002;Świetlica w Jazowej|Jazowa| 32A |82-100 Nowy Dwór Gdański;924;284;284;8;276;30.74;2.82
102229;221002;Zespół Szkolno- Przedszkolny w Kmiecinie|Kmiecin|Żuławska 6 |82-100 Nowy Dwór Gdański;1063;431;431;8;423;40.55;1.86
102230;221002;Szkoła Podstawowa w Lubieszewie, Filia Marynowy|Marynowy|Nowodworska 42 |82-100 Nowy Dwór Gdański;765;279;279;8;271;36.47;2.87
102231;221002;Świetlica Wiejska w Lubieszewie|Lubieszewo| 16 |82-100 Nowy Dwór Gdański;1126;430;430;13;417;38.19;3.02
102232;221002;Szpital|Nowy Dwór Gdański|Dworcowa 12 |82-100 Nowy Dwór Gdański;55;8;8;0;8;14.55;0.00
102233;221003;Gminny Dom Kultury i Sportu|Ostaszewo|Kościuszki 34 |82-112 Ostaszewo;1141;452;452;26;426;39.61;5.75
102234;221003;Szkoła Podstawowa|Nowa Cerkiew| 10 |82-112 Ostaszewo;715;229;229;15;214;32.03;6.55
102235;221003;Świetlica Wiejska|Nowa Kościelnica| 42 |82-112 Ostaszewo;662;309;309;12;297;46.68;3.88
102236;221004;Urząd Gminy w Stegnie|Stegna|ul. Gdańska 34 |82-103 Stegna;1817;839;839;12;827;46.18;1.43
102237;221004;Dom Ludowy w Rybinie|Rybina| 63 |82-103 Stegna;486;171;171;12;159;35.19;7.02
102238;221004;Świetlica Wiejska w Tujsku|Tujsk| 34 |82-103 Stegna;953;268;268;17;251;28.12;6.34
102239;221004;Świetlica Wiejska w Dworku|Dworek| 6 |82-103 Stegna;524;154;154;14;140;29.39;9.09
102240;221004;Świetlica Wiejska w Bronowie|Bronowo| 13b |82-103 Stegna;430;120;120;12;108;27.91;10.00
102241;221004;Świetlica Wiejska w Jantarze|Jantar|ul. Gdańska 27a |82-103 Stegna;1258;510;510;12;498;40.54;2.35
102242;221004;Gimnazjum Publiczne w Mikoszewie|Mikoszewo|ul. Gdańska 29 |82-103 Stegna;779;346;346;7;339;44.42;2.02
102243;221004;Zespół Szkolno-Przedszkolny w Drewnicy|Drewnica|ul. Wierzbowa 7 |82-103 Stegna;1533;579;579;13;566;37.77;2.25
102244;221004;Dom Pomocy Społecznej "MORS" w Stegnie|Stegna|Morska 11 |82-103 Stegna;125;56;56;4;52;44.80;7.14
102245;221005;Urząd Gminy w Sztutowie|Sztutowo|ul.Gdańska 55 |82-110 Sztutowo;2376;982;982;44;938;41.33;4.48
102246;221005;Świetlica w Kątach Rybackich|Kąty Rybackie|ul. Rybacka 41A |82-110 Sztutowo;607;258;258;6;252;42.50;2.33
102247;221101;Urząd Miasta|Hel|ul. Wiejska 50 |84-150 Hel;1430;683;683;39;644;47.76;5.71
102248;221101;Zespół Szkół Ogólnokształcących|Hel|ul. Szkolna 1 |84-150 Hel;1424;675;675;13;662;47.40;1.93
102249;221101;115 Szpital Wojskowy z Przychodnią|Hel|Boczna 10 |84-150 Hel;31;26;26;1;25;83.87;3.85
102250;221102;Urząd Miasta|Jastarnia|ul. Portowa 24 |84-140 Jastarnia;2206;1275;1275;51;1224;57.80;4.00
102251;221102;Biuro Informacji Turystycznej|Kuźnica|ul. Gen.J.Hallera 1A |84-130 Jastarnia;493;290;290;4;286;58.82;1.38
102252;221102;Hotel "LIDO" w Juracie|Jurata|ul. Wojska Polskiego 26 |84-141 Jastarnia;406;180;180;4;176;44.33;2.22
102253;221103;Szkoła Podstawowa|Puck|ul. Przebendowskiego 27 |84-100 Puck;1420;717;717;13;704;50.49;1.81
102254;221103;Publiczne Gimnazjum|Puck|ul. Nowy Świat 12 |84-100 Puck;1735;879;879;20;859;50.66;2.28
102255;221103;Specjalny Ośrodek Szkolno-Wychowawczy w Pucku|Puck|ul. Zamkowa 5 |84-100 Puck;1477;700;700;38;662;47.39;5.43
102256;221103;I Liceum Ogólnokształcące im. Stefana Żeromskiego w Pucku|Puck|ul. Morskiego Dywizjonu Lotniczego 18 |84-100 Puck;2304;1154;1154;38;1116;50.09;3.29
102257;221103;Ośrodek Adaptacyjny Puckiego Stowarzyszenia Wspierającego Osoby Niepełnosprawne Umysłowo "Razem"|Puck|ul. Mestwina 32 |84-100 Puck;1862;999;999;25;974;53.65;2.50
102258;221103;Dom Pomocy Społecznej w Pucku|Puck|Aleksandra Majkowskiego 3 |84-100 Puck;58;14;14;1;13;24.14;7.14
102259;221103;Szpital Pucki Sp. z o.o.|Puck|1-go Maja 13A |84-100 Puck;25;3;3;0;3;12.00;0.00
102260;221104;Zespół Szkół Nr 1|Władysławowo|ul. Morska 1 |84-120 Władysławowo;1538;761;761;19;742;49.48;2.50
102261;221104;Urząd Miejski|Władysławowo|ul. Gen.Józefa Hallera 19 |84-120 Władysławowo;1243;560;560;19;541;45.05;3.39
102262;221104;Szkoła Podstawowa Nr 2|Władysławowo|ul. 1000-lecia Państwa Polskiego 2 |84-120 Władysławowo;1826;1010;1010;22;988;55.31;2.18
102263;221104;Dom Parafialny im. bł. Jana Pawła II|Władysławowo|ul. Żeromskiego 30 |84-120 Władysławowo;1652;954;954;28;926;57.75;2.94
102264;221104;Szkoła Podstawowa Nr 3|Władysławowo|ul. Drogowców 1 |84-120 Władysławowo;1778;943;943;24;919;53.04;2.55
102265;221104;Świetlica Stowarzyszenia "BLIZA"|Chałupy|ul. Kaperska 26 |84-120 Władysławowo;325;196;196;5;191;60.31;2.55
102266;221104;Szkoła Podstawowa|Chłapowo|ul. Władysławowska 87 |84-120 Władysławowo;915;486;486;14;472;53.11;2.88
102267;221104;Świetlica|Tupadły|ul. Szkolna 3 |84-104 Jastrzębia Góra;383;190;190;6;184;49.61;3.16
102268;221104;Świetlica Samorządu Mieszkańców|Rozewie|ul. Garnizonowa |84-104 Jastrzębia Góra;207;117;117;3;114;56.52;2.56
102269;221104;Szkoła Podstawowa|Jastrzębia Góra|ul. Słowackiego 4 |84-104 Jastrzębia Góra;857;454;454;7;447;52.98;1.54
102270;221104;Świetlica|Ostrowo|ul. Zabytkowa 2 |84-105 Karwia;508;280;280;11;269;55.12;3.93
102271;221104;Szkoła Podstawowa|Karwia|ul. Wojska Polskiego 47 |84-105 Karwia;798;407;407;15;392;51.00;3.69
102272;221105;Zespół Szkolno-Przedszkolny w Mostach Hala Sportowa ul. Szkolna 16, 81-198 Mosty|Mosty|ul. Szkolna 16 |81-198 Kosakowo;840;486;486;12;474;57.86;2.47
102273;221105;Zespół Szkolno-Przedszkolny w Mostach Hala Sportowa ul. Szkolna 16, 81-198 Mosty|Mosty|ul. Szkolna 16 |81-198 Kosakowo;1431;914;914;12;902;63.87;1.31
102274;221105;Przedszkole w Rewie|Rewa|ul. Koralowa 1 |81-198 Kosakowo;799;443;443;14;429;55.44;3.16
102275;221105;Gminny Dom Kultury w Pierwoszynie|Pierwoszyno|ul. Kaszubska 11 |81-198 Kosakowo;768;519;519;10;509;67.58;1.93
102276;221105;Biblioteka Publiczna Gminy Kosakowo w Kosakowie|Kosakowo|Fiołkowa 2A |81-198 Kosakowo;1151;753;753;14;739;65.42;1.86
102277;221105;Szkoła Podstawowa w Dębogórzu|Dębogórze|Pomorska 30 |81-198 Kosakowo;1453;782;782;25;757;53.82;3.20
102278;221105;Szkoła Podstawowa w Pogórzu|Pogórze|Szkolna 15 |81-198 Kosakowo;2051;1292;1292;12;1280;62.99;0.93
102279;221105;Świetlica Sołecka w Suchym Dworze|Suchy Dwór|Jana Chryzostoma Paska 6 |81-198 Kosakowo;948;655;655;5;650;69.09;0.76
102280;221106;Gimnazjum w Wierzchucinie|Wierzchucino|Abrahama 34 |84-113 Wierzchucino;2097;908;908;52;856;43.30;5.73
102281;221106;Szkoła Podstawowa w Żarnowcu|Żarnowiec|Szkolna 2 |84-110 Krokowa;1286;644;644;32;612;50.08;4.97
102282;221106;Szkoła Podstawowa w Krokowej|Krokowa|Szkola 6 |84-110 Krokowa;2010;953;953;44;909;47.41;4.62
102283;221106;Szkoła Podstawowa w Sławoszynie|Sławoszyno|Floriana Ceynowy 24 |84-110 Krokowa;1731;752;752;44;708;43.44;5.85
102284;221106;Szkoła Podstawowa w Lubocinie|Lubocino| 10 |84-110 Krokowa;898;387;387;33;354;43.10;8.53
102285;221106;Dom Pomocy Społecznej|Lubkowo|Długa 50 |84-110 Krokowa;42;23;23;3;20;54.76;13.04
102286;221107;Szkoła Podstawowa|Leśniewo|ul. Mechowska 2 |84-106 Leśniewo;2212;1018;1018;25;993;46.02;2.46
102287;221107;Zespół Szkół|Mrzezino|ul. Dworcowa 54 |84-123 Połchowo;1861;942;942;58;884;50.62;6.16
102288;221107;Szkoła Podstawowa|Połchowo|ul. Dworcowa 2 |84-123 Połchowo;1026;538;538;16;522;52.44;2.97
102289;221107;Szkoła Podstawowa|Połczyno|ul. Szkolna 21 |84-100 Puck;990;538;538;16;522;54.34;2.97
102290;221107;Zespół Szkół|Starzyno|ul. Żarnowiecka 22 |84-107 Starzyno;1830;743;743;31;712;40.60;4.17
102291;221107;Wiejski Dom Kultury|Strzelno|ul. Bałtycka 14 |84-103 Łebcz;828;398;398;18;380;48.07;4.52
102292;221107;Dom Kaszubski|Swarzewo|ul. Ks. Pronobisa 11 |84-100 Puck;824;433;433;15;418;52.55;3.46
102293;221107;Zespół Szkół|Żelistrzewo|ul. Szkolna 1 |84-100 Puck;1974;1062;1062;27;1035;53.80;2.54
102294;221107;Szkoła Podstawowa|Rekowo Górne|ul. W. Czapiewskiego 1 |84-123 Połchowo;919;448;448;7;441;48.75;1.56
102295;221107;Szkoła Podstawowa|Celbowo| 7 |84-100 Puck;940;394;394;19;375;41.91;4.82
102296;221107;Szkoła Podstawowa|Łebcz|ul. Pucka 27 |84-103 Łebcz;1387;565;565;26;539;40.74;4.60
102297;221107;Szkoła Podstawowa|Gnieżdżewo|ul. Dworcowa 6 |84-100 Puck;931;439;439;11;428;47.15;2.51
102298;221107;Zespół Szkół Ponadgimnazjalnych|Rzucewo| 20 |84-100 Puck;713;262;262;15;247;36.75;5.73
102299;221107;Remiza Ochotniczej Straży Pożarnej|Smolno|ul. Pucka 46 |84-100 Puck;670;286;286;11;275;42.69;3.85
102300;221107;Zespół Szkół w Darzlubiu|Darzlubie|Pucka 74 |84-100 Darzlubie;962;426;426;21;405;44.28;4.93
102301;221107;Szkoła Podstawowa w Mieroszynie|Mieroszyno|Szkolna 2 |84-103 Mieroszyno;664;328;328;7;321;49.40;2.13
102302;221201;Szkoła Podstawowa nr 1|Ustka|ul.Darłowska 18 |76-270 Ustka;1791;942;942;29;913;52.60;3.08
102303;221201;Przedszkole Miejskie nr 3|Ustka|ul. Polna 12 |76-270 Ustka;1067;505;505;12;493;47.33;2.38
102304;221201;Szkoła Podstawowa nr 2|Ustka|ul. Jagiellońska 1 |76-270 Ustka;1791;916;916;30;886;51.14;3.28
102305;221201;Spółdzielnia Mieszkaniowa "Korab"|Ustka|ul. Grunwaldzka 10 |76-270 Ustka;1871;884;884;27;857;47.25;3.05
102306;221201;Gimnazjum|Ustka|ul. Wróblewskiego 7 |76-270 Ustka;1701;873;873;25;848;51.32;2.86
102307;221201;Kino ''Delfin" w Ustce|Ustka|ul. Marynarki Polskiej 82 |76-270 Ustka;1482;649;649;15;634;43.79;2.31
102308;221201;Dom Kultury|Ustka|ul. Kosynierów 19 |76-270 Ustka;1452;757;757;17;740;52.13;2.25
102309;221201;Urząd Miasta|Ustka|ul. Ks. Kard. Wyszyńskiego 3 |76-270 Ustka;1763;937;937;14;923;53.15;1.49
102310;221201;Areszt Śledczy w Słupsku Oddział Zewnętrzny w Ustce|Ustka|Darłowska 1b |76-270 Ustka;299;167;167;25;142;55.85;14.97
102311;221201;Wojewódzki Szpital Specjalistyczny im. Janusza Korczaka w Słupsku Sp. z o.o. Oddział w Ustce|Ustka|Mickiewicza 12 |76-270 Ustka;60;27;27;6;21;45.00;22.22
102312;221202;Centrum Edukacji i Kultury w Damnicy|Damnica|ul.Wincentego Witosa 13 |76-231 Damnica;1498;637;637;24;613;42.52;3.77
102313;221202;Zespół Szkół w Damnie|Damno| 42 |76-231 Damnica;1825;490;490;42;448;26.85;8.57
102314;221202;Zespół Szkół w Zagórzycy|Zagórzyca| 20 |76-231 Damnica;1474;498;498;32;466;33.79;6.43
102315;221203;Urząd Gminy|Dębnica Kaszubska|ul. Zjednoczenia 16a |76-248 Dębnica Kaszubska;1044;373;373;19;354;35.73;5.09
102316;221203;Zespół Szkolno-Przedszkolny|Dębnica Kaszubska|ul. Zjednoczenia 28 |76-248 Dębnica Kaszubska;1511;680;680;21;659;45.00;3.09
102317;221203;Gminny Ośrodek Kultury|Dębnica Kaszubska|Zjednoczenia 55 |76-248 Dębnica Kaszubska;1244;535;535;16;519;43.01;2.99
102318;221203;Szkoła Podstawowa|Borzęcino| 33 |76-248 Dębnica Kaszubska;1251;272;272;21;251;21.74;7.72
102319;221203;Szkoła Podstawowa|Motarzyno| 9a |76-248 Dębnica Kaszubska;662;215;215;22;193;32.48;10.23
102320;221203;Szkoła Podstawowa|Gogolewo| 40 |76-248 Dębnica Kaszubska;546;161;161;9;152;29.49;5.59
102321;221203;Szkoła Podstawowa|Budowo| 52 |76-248 Dębnica Kaszubska;1259;339;339;27;312;26.93;7.96
102322;221204;Gminny Ośrodek Kultury Sala posiedzeń|Główczyce|ul. Kościuszki 15A |76-220 Główczyce;534;200;200;15;185;37.45;7.50
102323;221204;Zespół Szkół Ogólnokształcących|Główczyce|ul. Szkolna 1 |76-220 Główczyce;530;228;228;10;218;43.02;4.39
102324;221204;Zespół Szkół Ogólnokształcących|Główczyce|ul. Szkolna 1 |76-220 Główczyce;501;188;188;11;177;37.52;5.85
102325;221204;Świetlica wiejska|Wielka Wieś| 41 |76-220 Główczyce;488;121;121;1;120;24.80;0.83
102326;221204;Świetlica wiejska|Żoruchowo| 13 |76-220 Główczyce;365;105;105;4;101;28.77;3.81
102327;221204;Świetlica wiejska|Żelkowo| 17 |76-220 Główczyce;474;165;165;7;158;34.81;4.24
102328;221204;Świetlica wiejska|Szczypkowice| 40A |76-220 Główczyce;499;133;133;6;127;26.65;4.51
102329;221204;Sala gimnastyczna Zespołu Szkół|Stowięcino| 15 |76-220 Główczyce;611;237;237;22;215;38.79;9.28
102330;221204;Świetlica wiejska|Podole Wielkie| 18A |76-220 Główczyce;453;118;118;9;109;26.05;7.63
102331;221204;Wiejski Dom Kultury|Pobłocie| 10 |76-220 Główczyce;584;206;206;10;196;35.27;4.85
102332;221204;Wiejski Dom Kultury|Pobłocie| 10 |76-220 Główczyce;541;124;124;9;115;22.92;7.26
102333;221204;Świetlica wiejska|Rzuszcze| 16 |76-220 Główczyce;438;130;130;5;125;29.68;3.85
102334;221204;Swietlica wiejska|Izbica| 34 |76-220 Główczyce;426;122;122;5;117;28.64;4.10
102335;221204;Świetlica wiejska|Rumsko| 20 |76-220 Główczyce;380;86;86;4;82;22.63;4.65
102336;221204;Budynek poszkolny|Będziechowo| 12 |76-220 Główczyce;382;84;84;5;79;21.99;5.95
102337;221205;Biblioteka Publiczna Miasta i Gminy w Kępicach|Kępice|Mariana Buczka 1 parter budynku|77-230 Kępice;662;285;285;17;268;43.05;5.96
102338;221205;Zespół Szkół w Barcinie|Barcino| 59 sala nr 1|77-230 Kępice;498;203;203;22;181;40.76;10.84
102339;221205;Szkoła Podstawowa w Warcinie|Warcino| 21 |77-230 Kępice;383;124;124;5;119;32.38;4.03
102340;221205;Świetlica wiejska w Płocku|Płocko| 25 |77-230 Kępice;363;90;90;5;85;24.79;5.56
102341;221205;Zespół Szkół w Korzybiu|Korzybie|ul. Dworcowa 6 |77-230 Kępice;685;260;260;11;249;37.96;4.23
102342;221205;Zespół Szkół w Biesowicach|Biesowice| 38 |77-230 Kępice;707;232;232;28;204;32.81;12.07
102343;221205;Zespół Szkół w Kępicach|Kępice|ul. Szkolna 1e sala nr 17|77-230 Kępice;473;208;208;5;203;43.97;2.40
102344;221205;Zespół Szkół w Kępicach|Kępice|Szkolna 1e sala nr 14|77-230 Kępice;485;175;175;8;167;36.08;4.57
102345;221205;Gimnazjum w Kepicach|Kępice|Szkolna 1 sala nr 2|77-230 Kępice;424;129;129;6;123;30.42;4.65
102346;221205;Gimnazjum w Kępicach|Kępice|Szkolna 1 sala nr 3|77-230 Kępice;509;248;248;12;236;48.72;4.84
102347;221205;Gimnazjum w Kępicach|Kępice|Szkolna 1 sala nr 4|77-230 Kępice;530;242;242;3;239;45.66;1.24
102348;221205;Świetlica wiejska w Osowie|Osowo| 16A |77-230 Kępice;247;71;71;5;66;28.74;7.04
102349;221205;Świetlica wiejska w Mzdowie|Mzdowo| 25 |77-230 Kępice;297;67;67;2;65;22.56;2.99
102350;221205;Świetlica wiejska w Pustowie|Pustowo| 10 |77-230 Kępice;360;110;110;5;105;30.56;4.55
102351;221205;Zespół Szkół w Barcinie|Barcino| 59 sala nr 2|77-230 Kępice;583;142;142;4;138;24.36;2.82
102352;221206;Wiejski Dom Kultury|Wrząca| 53 |76-251 Kobylnica;1082;269;269;14;255;24.86;5.20
102353;221206;Zespół Szkół Samorządowych w Kobylnicy - sala Forum|Kobylnica|Główna 63 |76-251 Kobylnica;1306;584;584;16;568;44.72;2.74
102354;221206;Zespół Szkół Samorządowych w Sycewicach|Sycewice|ul.Szkolna 1 |76-251 Kobylnica;1309;445;445;21;424;34.00;4.72
102355;221206;Szkoła Podstawowa w Kwakowie|Kwakowo|ul.Słupska 5 |76-251 Kobylnica;1148;399;399;15;384;34.76;3.76
102356;221206;Szkoła Podstawowa w Kończewie|Kończewo|ul.Szkolna 1 |76-251 Kobylnica;1201;365;365;30;335;30.39;8.22
102357;221206;Szkoła Podstawowa w Kobylnicy|Kobylnica|ul.Główna 63 |76-251 Kobylnica;1232;624;624;14;610;50.65;2.24
102358;221206;Gimnazjum w Kobylnicy|Kobylnica|ul.Główna 63 |76-251 Kobylnica;1263;760;760;13;747;60.17;1.71
102359;221206;Zakład Opiekuńczo-Leczniczy Psychiatryczny w Kobylnicy|Kobylnica|Franciszkańska 1 |76-251 Kobylnica;23;16;16;4;12;69.57;25.00
102360;221207;Zespół Szkół w Łupawie|Łupawa| 22 |76-242 Łupawa;1395;432;432;26;406;30.97;6.02
102361;221207;Zespół Szkół w Potęgowie|Potęgowo|ul. Szeroka 16 |76-230 Potęgowo;1748;658;658;33;625;37.64;5.02
102362;221207;Szkoła Podstawowa w Skórowie|Skórowo| 13a |76-230 Potęgowo;745;221;221;22;199;29.66;9.95
102363;221207;Świetlica Wiejska w Rzechcinie|Rzechcino| 36 |76-230 Potęgowo;882;191;191;12;179;21.66;6.28
102364;221207;Świetlica Wiejska w Żochowie|Żochowo| 26B |76-230 Potęgowo;677;165;165;18;147;24.37;10.91
102365;221208;Zespół Szkół|Jezierzyce|Szkolna 3 |76-200 Słupsk;2092;743;743;35;708;35.52;4.71
102366;221208;Szkoła Podstawowa|Wrzeście| 44 |76-200 Słupsk;1030;365;365;26;339;35.44;7.12
102367;221208;Szkoła Podstawowa|Głobino| 47 |76-200 Słupsk;830;358;358;18;340;43.13;5.03
102368;221208;Świetlica Wiejska|Kusowo| 10c |76-200 Słupsk;1279;536;536;19;517;41.91;3.54
102369;221208;Szkoła Podstawowa|Włynkówko|Błękitna 17 |76-200 Słupsk;2087;1053;1053;26;1027;50.46;2.47
102370;221208;Szkoła Podstawowa|Bierkowo|Grodzka 89 |76-200 Słupsk;1070;478;478;23;455;44.67;4.81
102371;221208;Świetlica Wiejska|Swołowo| 41 |76-206 Słupsk;742;213;213;12;201;28.71;5.63
102372;221208;Zespół Szkół|Redzikowo| 16a |76-200 Słupsk;1384;618;618;8;610;44.65;1.29
102373;221208;Zespół Szkół|Siemianice|Słupska 42 |76-200 Słupsk;1940;1064;1064;28;1036;54.85;2.63
102374;221208;Dom Pomocy Społecznej w Lubuczewie|Lubuczewo| 29A |76-200 Słupsk;40;31;31;10;21;77.50;32.26
102375;221209;Świetlica wiejska w Smołdzinie|Smołdzino|ul. Bohaterów Warszawy 30 |76-214 Smołdzino;1683;607;607;33;574;36.07;5.44
102376;221209;Sala Gimnastyczna w Gardnie Wielkiej|Gardna Wielka|Plac Wolności 7 |76-214 Smołdzino;1004;373;373;22;351;37.15;5.90
102377;221210;Świetlica Wiejska w Zaleskich|Zaleskie| 48 |76-270 Ustka;356;150;150;9;141;42.13;6.00
102378;221210;Świetlica Wiejska w Duninowie|Duninowo| 27 |76-270 Ustka;699;317;317;9;308;45.35;2.84
102379;221210;Świetlica Wiejska w Wytownie|Wytowno| 9 |76-270 Ustka;538;191;191;15;176;35.50;7.85
102380;221210;Świetlica Wiejska w Objeździe|Objazda| 77 |76-211 Objazda;770;255;255;16;239;33.12;6.27
102381;221210;Świetlica Wiejska w Charnowie|Charnowo| 35B |76-270 Ustka;411;158;158;8;150;38.44;5.06
102382;221210;Centrum Promocji i Edukacji Słowińskiej Grupy Rybackiej|Przewłoka|ul. Ustecka 8 |76-270 Ustka;751;428;428;12;416;56.99;2.80
102383;221210;Świetlica Wiejska w Grabnie|Grabno|Pałacowa 14 |76-270 Ustka;479;251;251;13;238;52.40;5.18
102384;221210;Świetlica Wiejska w Możdżanowie|Możdżanowo| 1 |76-270 Ustka;172;92;92;1;91;53.49;1.09
102385;221210;Świetlica Wiejska w Starkowie|Starkowo| 5 |76-270 Ustka;176;80;80;3;77;45.45;3.75
102386;221210;Świetlica Wiejska w Pęplinie|Pęplino| 12 |76-270 Ustka;286;95;95;11;84;33.22;11.58
102387;221210;Świetlica Wiejska w Wodnicy|Wodnica| 52 |76-270 Ustka;460;235;235;8;227;51.09;3.40
102388;221210;Świetlica Wiejska w Machowinie|Machowino| 2 |76-270 Ustka;396;171;171;5;166;43.18;2.92
102389;221210;Świetlica Wiejska w Gąbinie|Gąbino|Kasztanowa 3 |76-270 Ustka;441;137;137;15;122;31.07;10.95
102390;221210;Świetlica Wiejska w Rowach|Rowy|ul. Kościelna 2a |76-212 Rowy;497;228;228;5;223;45.88;2.19
102391;221301;Miejska Biblioteka Publiczna|Czarna Woda|ul. Starogardzka 13 |83-262 Czarna Woda;1362;618;618;31;587;45.37;5.02
102392;221301;Przedszkole Publiczne|Czarna Woda|ul. Mostowa 2 |83-262 Czarna Woda;950;484;484;15;469;50.95;3.10
102393;221301;Budynek byłej Szkoły|Czarna Woda, Huta Kalna|ul. Szkolna 2 |83-261 Piece;334;137;137;12;125;41.02;8.76
102394;221302;Zespół Szkół Publicznych|Skórcz|ul. Hallera 1 |83-220 Skórcz;1412;722;722;31;691;51.13;4.29
102395;221302;Miejski Ośrodek Kultury|Skórcz|ul. 27 Stycznia 4 |83-220 Skórcz;1272;597;597;18;579;46.93;3.02
102396;221303;Przedszkole Nr 3|Starogard Gdański|al. Wojska Polskiego 8b |83-200 Starogard Gdański;2227;948;948;26;922;42.57;2.74
102397;221303;Zespół Szkół Publicznych|Starogard Gdański|ul. Dominika 32 |83-200 Starogard Gdański;2157;1134;1134;27;1107;52.57;2.38
102398;221303;Dyrekcja Szpitala|Starogard Gdański|ul. Skarszewska 7 |83-200 Starogard Gdański;1390;712;712;18;694;51.22;2.53
102399;221303;Szkoła Podstawowa Nr 3|Starogard Gdański|ul. Wybickiego 17 |83-200 Starogard Gdański;1973;974;974;18;956;49.37;1.85
102400;221303;I Liceum Ogólnokształcące|Starogard Gdański|ul. Hallera 34 |83-200 Starogard Gdański;1164;431;431;9;422;37.03;2.09
102401;221303;Publiczne Gimnazjum Nr 2|Starogard Gdański|ul. Traugutta 2 |83-200 Starogard Gdański;2110;1044;1044;22;1022;49.48;2.11
102402;221303;Dom Rzemiosła|Starogard Gdański|ul. Chojnicka 2 |83-200 Starogard Gdański;1675;563;563;20;543;33.61;3.55
102403;221303;Środowiskowy Dom Samopomocy|Starogard Gdański|ul. Pelplińska 3 |83-200 Starogard Gdański;1782;689;689;20;669;38.66;2.90
102404;221303;Szkoła Podstawowa Nr 4|Starogard Gdański|al. Jana Pawła II 4 |83-200 Starogard Gdański;1722;670;670;24;646;38.91;3.58
102405;221303;Starogardzkie Centrum Kultury|Starogard Gdański|al. Jana Pawła II 3 |83-200 Starogard Gdański;1668;875;875;20;855;52.46;2.29
102406;221303;Przedszkole Nr 6|Starogard Gdański|al. Jana Pawła II 5 |83-200 Starogard Gdański;1632;862;862;15;847;52.82;1.74
102407;221303;Przedszkole Nr 5|Starogard Gdański|al. Jana Pawła II 8 |83-200 Starogard Gdański;2093;1058;1059;20;1038;50.55;1.89
102408;221303;Spółdzielczy Dom Kultury|Starogard Gdański|ul. Reymonta 1 |83-200 Starogard Gdański;1576;729;729;23;706;46.26;3.16
102409;221303;Publiczne Gimnazjum Nr 1|Starogard Gdański|al. Jana Pawła II 10 |83-200 Starogard Gdański;1260;643;643;9;634;51.03;1.40
102410;221303;Przedszkole Nr 4|Starogard Gdański|ul. Reymonta 7 |83-200 Starogard Gdański;1687;826;826;19;807;48.96;2.30
102411;221303;Przedszkole Nr 10|Starogard Gdański|os. 60-lecia 8 |83-200 Starogard Gdański;1764;954;954;31;923;54.08;3.25
102412;221303;Przedszkole Nr 8|Starogard Gdański|os. Konstytucji 3 Maja 15 |83-200 Starogard Gdański;1815;950;950;18;932;52.34;1.89
102413;221303;Szkoła Podstawowa Nr 1|Starogard Gdański|ul. Zblewska 18 |83-200 Starogard Gdański;1526;882;882;15;867;57.80;1.70
102414;221303;Publiczne Gimnazjum Nr 3|Starogard Gdański|ul. Szwoleżerów 4 |83-200 Starogard Gdański;2195;940;940;27;913;42.82;2.87
102415;221303;Szkoła Podstawowa nr 1|Starogard Gdański|ul. Zblewska 18 |83-200 Starogard Gdański;1366;757;757;12;745;55.42;1.59
102416;221303;Publiczne Gimnazjum Nr 1|Starogard Gdański|al. Jana Pawła II 10 |83-200 Starogard Gdański;1333;698;698;5;693;52.36;0.72
102417;221303;Kociewskie Centrum Zdrowia Sp z o.o. Niepubliczny Zakład Opieki Zdrowotnej Spital św. Jana,|Starogard Gdański|Ulica: Balewskiego 1 |83-200 Starogard Gdański;126;42;42;3;39;33.33;7.14
102418;221303;Szpital dla Nerwowo i Psychicznie Chorych|Starogard Gdański|Skarszewska 7 |83-200 Starogard Gdański;519;180;180;30;150;34.68;16.67
102419;221303;Areszt Śledczy|Starogard Gdański|Kościuszki 30 a |83-200 Starogard Gdański;245;136;136;19;117;55.51;13.97
102420;221303;Dom św. Elżbiety|Starogard Gdański|Hallera 27 |83-200 Starogard Gdański;39;14;14;1;13;35.90;7.14
102421;221304;Publiczna Szkoła Podstawowa w Bobowie|Bobowo|ul. Gdańska 81 |83-212 Bobowo;1160;481;481;19;462;41.47;3.95
102422;221304;Świetlica Wiejska w Grabowie|Grabowo| 39 |83-212 Bobowo;373;173;173;9;164;46.38;5.20
102423;221304;Świetlica Wiejska w Jabłówku|Jabłówko| 13 |83-212 Bobowo;414;136;136;2;134;32.85;1.47
102424;221304;Świetlica Wiejska w Wysokiej|Wysoka| 27 |83-212 Bobowo;364;143;143;7;136;39.29;4.90
102425;221305;Remiza OSP|Kaliska|ul. Nowowiejska 2b |83-260 Kaliska;1834;855;855;27;828;46.62;3.16
102426;221305;Zespół Oświatowo-Wychowawczy|Piece|ul. Kościelna 3 |83-261 Piece;1051;478;478;27;451;45.48;5.65
102427;221305;Gminny Ośrodek Kultury|Kaliska|ul. Długa 18 |83-260 Kaliska;1253;519;519;15;504;41.42;2.89
102428;221306;Publiczne Gminazjum|Lubichowo|ul. Księdza Lorenza 8 |83-240 Lubichowo;1565;700;700;34;666;44.73;4.86
102429;221306;Publiczna Szkoła Podstawowa|Lubichowo|Dworcowa 15 |83-240 Lubichowo;1251;600;600;35;565;47.96;5.83
102430;221306;Publiczna Szkoła Podstawowa|Zelgoszcz|ul. Główna 29 |83-208 Lubichowo;688;281;281;22;259;40.84;7.83
102431;221306;Świetlica|Wda|ul. Szkolna 2 |83-240 Lubichowo;478;220;220;15;205;46.03;6.82
102432;221306;Świetlica|Ocypel|ul. Szkolna 4 |83-240 Lubichowo;543;248;248;10;238;45.67;4.03
102433;221306;Świetlica|Osowo Leśne| 18 |83-240 Lubichowo;397;96;96;5;91;24.18;5.21
102434;221307;Sala widowiskowa w Osiecznej|Osieczna|ul. Plac 1000-lecia 1 |83-242 Osieczna;1256;554;554;36;518;44.11;6.50
102435;221307;Świetlica wiejska w Szlachcie|Szlachta|ul. 3 Maja 28 |83-243 Osieczna;1002;425;425;25;400;42.42;5.88
102436;221308;Remiza OSP w Bukowinach|Bukowiny| 24a |83-221 Osiek;322;129;129;12;117;40.06;9.30
102437;221308;Środowiskowy Dom Samopomocy|Osiek|Wyzwolenia 25 |83-221 Osiek;513;214;214;13;201;41.72;6.07
102438;221308;Remiza Ochotniczej Straży Pożarnej|Osiek|ul.Strażacka 1 |83-221 Osiek;883;441;441;14;427;49.94;3.17
102439;221308;Remiza Ochotniczej Straży Pożarnej|Kasparus| 9 a |83-221 Osiek;366;149;149;4;145;40.71;2.68
102440;221309;Publiczna Szkoła Podstawowa w Skarszewach|Skarszewy|ul. Dworcowa 27 |83-250 Skarszewy;2277;948;948;17;931;41.63;1.79
102441;221309;Zespół Szkół Publicznych w Skarszewach|Skarszewy|ul. Kopernika 3 |83-250 Skarszewy;2043;944;944;45;899;46.21;4.77
102442;221309;Urząd Miejski w Skarszewach|Skarszewy|ul. Plac Gen. J. Hallera 18 |83-250 Skarszewy;1622;631;631;18;613;38.90;2.85
102443;221309;Publiczna Szkoła Podstawowa w Szczodrowie|Szczodrowo|Szkolna 1 |83-250 Skarszewy;748;298;298;16;282;39.84;5.37
102444;221309;Publiczna Szkoła Podstawowa w Więckowach|Więckowy| 25 |83-250 Skarszewy;606;295;295;23;272;48.68;7.80
102445;221309;Zespół Szkół Publicznych w Pogódkach|Pogódki|ul. Szkolna 3 |83-236 Pogódki;1273;572;572;30;542;44.93;5.24
102446;221309;Zespół Szkół Publicznych w Godziszewie|Godziszewo|ul. Gdańska 7 |83-209 Godziszewo;1120;401;401;14;387;35.80;3.49
102447;221309;Publiczna Szkoła Podstawowa w Skarszewach Filia w Bączku|Bączek| 1 |83-250 Skarszewy;513;236;236;5;231;46.00;2.12
102448;221309;Zespół Szkół Rolniczych Centrum Kształcenia Praktycznego w Bolesławowie|Bolesławowo| 15 |83-250 Skarszewy;575;227;227;15;212;39.48;6.61
102449;221310;Świetlica Wiejska w Wielbrandowie|Wielbrandowo|ul. Główna 2 |83-220 Skórcz;716;314;314;14;300;43.85;4.46
102450;221310;Publiczna Szkoła Podstawowa im. Ks. Senatora Feliksa Bolta w Barłożnie|Barłożno| 23 |83-225 Barłożno;1036;397;397;16;381;38.32;4.03
102451;221310;Zespół Szkół Publicznych w Pączewie|Pączewo| 124 |83-213 Pączewo;959;388;388;17;371;40.46;4.38
102452;221310;Publiczna Szkoła Podstawowa w Wielkim Bukowcu|Wielki Bukowiec| 40A |83-220 Skórcz;829;330;330;14;316;39.81;4.24
102453;221311;Publiczne Gimnazjum|Smętowo Graniczne|ul. Gdańska 23 |83-230 Smętowo Graniczne;1257;628;628;28;600;49.96;4.46
102454;221311;Publiczna Szkoła Podstawowa|Kopytkowo| 18 |83-230 Smętowo Graniczne;651;185;185;16;169;28.42;8.65
102455;221311;Świetlica wiejska|Kościelna Jania| 37 |83-230 Smętowo Graniczne;734;248;248;12;236;33.79;4.84
102456;221311;Warsztaty Terapii Zajęciowej|Lalkowy| 10 |83-230 Smętowo Graniczne;438;181;181;7;174;41.32;3.87
102457;221311;Publiczna Szkoła Podstawowa|Kamionka| 11 |83-230 Smętowo Graniczne;505;190;190;16;174;37.62;8.42
102458;221311;Publiczne Gimnazjum|Smętowo Graniczne|ul. Gdańska 23 |83-230 Smętowo Graniczne;581;220;220;13;207;37.87;5.91
102459;221312;Publiczna Szkoła Podstawowa|Dąbrówka|ul. Hermanowska 4 |83-212 Bobowo;691;354;354;11;343;51.23;3.11
102460;221312;Publiczna Szkoła Podstawowa|Jabłowo|ul. Szkolna 5 |83-211 Jabłowo;667;272;272;12;260;40.78;4.41
102461;221312;Świetlica Wiejska|Owidz|ul. Szkolna 13 |83-211 Jabłowo;889;427;427;11;416;48.03;2.58
102462;221312;Świetlica Wiejska|Kolincz|ul. Główna 52 |83-211 Jabłowo;677;338;338;19;319;49.93;5.62
102463;221312;Świetlica Wiejska|Lipinki Szlacheckie|ul. Jana Pawła II 40 |83-211 Jabłowo;363;198;198;5;193;54.55;2.53
102464;221312;Świetlica Wiejska|Klonówka|ul. Kościelna 1 |83-130 Pelplin;334;126;126;9;117;37.72;7.14
102465;221312;Zespół Kształcenia i Wychowania|Rywałd|Szkolna 4 |83-200 Starogard Gdański;754;300;300;8;292;39.79;2.67
102466;221312;Świetlica Wiejska|Zduny| 26 |83-115 Swarożyn;468;181;181;8;173;38.68;4.42
102467;221312;Świetlica Wiejska|Szpęgawsk|Kasztanowa 15 |83-200 Starogard Gdański;329;153;153;9;144;46.50;5.88
102468;221312;Publiczna Szkoła Podstawowa|Trzcińsk| 14 |83-209 Godziszewo;739;312;312;13;299;42.22;4.17
102469;221312;Zespół Szkół Publicznych|Kokoszkowy|Szkolna 24 |83-207 Kokoszkowy;1267;696;696;21;675;54.93;3.02
102470;221312;Świetlica Wiejska|Linowiec| 21 |83-200 Starogard Gdański;307;133;133;9;124;43.32;6.77
102471;221312;Świetlica Wiejska|Krąg| 44 |83-200 Starogard Gdański;814;456;456;19;437;56.02;4.17
102472;221312;Świetlica Wiejska|Nowa Wieś Rzeczna|Rzeczna 18 |83-200 Starogard Gdański;754;420;420;8;412;55.70;1.90
102473;221312;Publiczna Szkoła Podstawowa|Rokocin|Parkowa 2 |83-200 Starogard Gdański;854;478;478;18;460;55.97;3.77
102474;221312;Świetlica Wiejska|Sucumin| 29 |83-200 Starogard Gdański;445;218;218;5;213;48.99;2.29
102475;221312;Zespół Szkół Publicznych|Sumin| 38 |83-200 Starogard Gdański;503;259;259;10;249;51.49;3.86
102476;221312;Świetlica Wiejska|Koteże|Jana Wróblewskiego 5 |83-200 Starogard Gdański;687;419;419;15;404;60.99;3.58
102477;221312;Dom Pomocy Społecznej|Szpęgawsk|Kasztanowa 23 |83-200 Starogard Gdański;119;23;23;4;19;19.33;17.39
102478;221312;Centrum Rehabilitacyjno-Lecznicze Medpharma|Nowa Wieś Rzeczna|Leśna 1a |83-200 Starogard Gdański;46;17;17;1;16;36.96;5.88
102479;221313;Zespół Szkół Publicznych|Kleszczewo Kościerskie| 41 |83-206 Kleszczewo Kościerskie;1409;611;611;30;581;43.36;4.91
102480;221313;Zespół Kształcenia i Wychowania|Pinczyn|ul. Sportowa 8 |83-251 Pinczyn;1263;543;543;31;512;42.99;5.71
102481;221313;Zespół Szkół Publicznych|Borzechowo|ul. Szkolna 3a |83-224 Borzechowo;1174;445;445;22;423;37.90;4.94
102482;221313;Zespół Szkół Publicznych|Zblewo|ul. Kościerska 39 |83-210 Zblewo;1494;637;637;32;605;42.64;5.02
102483;221313;Gminny Ośrodek Kultury|Zblewo|ul. Główna 40 |83-210 Zblewo;1592;837;837;43;794;52.58;5.14
102484;221313;Zespół Szkół Publicznych|Bytonia|ul. Kasztelańska 3 |83-210 Zblewo;790;321;321;23;298;40.63;7.17
102485;221313;Wiejski Dom Kultury|Pinczyn|Semlińska 1B |83-251 Pinczyn;1043;443;443;12;431;42.47;2.71
102486;221401;Szkoła Podstawowa Nr 7|Tczew|ul. Stoczniowców 15A |83-110 Tczew;1970;882;884;22;860;44.77;2.49
102487;221401;Gimnazjum Nr 2|Tczew|ul. Południowa 6 |83-110 Tczew;1614;648;648;27;621;40.15;4.17
102488;221401;Sportowa Szkoła Podstawowa Nr 2|Tczew|ul. Gdańska 2 |83-110 Tczew;2247;987;987;18;969;43.93;1.82
102489;221401;Gimnazjum Nr 3|Tczew|ul. Wł.Jagiełły 8 |83-110 Tczew;1965;1087;1087;27;1060;55.32;2.48
102490;221401;Szkoła Podstawowa Nr 8|Tczew|ul. Armii Krajowej 70 |83-110 Tczew;1259;594;594;16;578;47.18;2.69
102491;221401;Szkoła Podstawowa Nr 8|Tczew|ul. Armii Krajowej 70 |83-110 Tczew;1295;745;745;10;735;57.53;1.34
102492;221401;Przedszkole Nr 8|Tczew|ul. Jodłowa 6 |83-110 Tczew;2008;1082;1082;21;1061;53.88;1.94
102493;221401;Szkoła Podstawowa Nr 12|Tczew|ul. Topolowa 23 |83-110 Tczew;2123;1241;1241;26;1215;58.46;2.10
102494;221401;Przedszkole Niepubliczne "Jarzębinka"|Tczew|ul. Jarzębinowa 4 |83-110 Tczew;1642;800;800;22;778;48.72;2.75
102495;221401;Gimnazjum Nr 3|Tczew|ul. Wł. Jagiełły 8 |83-110 Tczew;2256;1149;1149;41;1108;50.93;3.57
102496;221401;Warsztaty Terapii Zajęciowej|Tczew|ul. Wigury 84 |83-110 Tczew;1565;876;876;15;861;55.97;1.71
102497;221401;Przedszkole Akademia Przedszkolaka|Tczew|ul. Andersena 2F |83-110 Tczew;1038;627;627;7;620;60.40;1.12
102498;221401;"AKADEMIA MELODICA" (żłobek)|Tczew|ul. Kubusia Puchatka 1 |83-110 Tczew;1414;851;851;7;844;60.18;0.82
102499;221401;Szkoła Podstawowa Nr 11|Tczew|ul. Saperska 12 |83-110 Tczew;2049;1067;1067;14;1053;52.07;1.31
102500;221401;Szkoła Podstawowa Nr 11|Tczew|ul. Saperska 12 |83-110 Tczew;2362;1142;1142;26;1116;48.35;2.28
102501;221401;Ośrodek Opiekuńczy|Tczew|ul. Niepodległości 10 |83-110 Tczew;2370;1260;1260;21;1239;53.16;1.67
102502;221401;Specjalny Ośrodek Szkolno-Wychowawczy|Tczew|ul. Grunwaldzka 1 |83-110 Tczew;1508;771;771;18;753;51.13;2.33
102503;221401;Szkoła Podstawowa Nr 5|Tczew|ul. Obrońców Westerplatte 18 |83-110 Tczew;1952;787;787;32;755;40.32;4.07
102504;221401;Forum Inicjatyw Społecznych|Tczew|ul. Łazienna 5 |83-110 Tczew;1808;691;691;31;660;38.22;4.49
102505;221401;Fabryka Sztuk|Tczew|ul. 30 Stycznia 4 |83-110 Tczew;1513;776;776;22;754;51.29;2.84
102506;221401;Szkoła Podstawowa Nr 10|Tczew|ul. Marii Konopnickiej 11 |83-110 Tczew;1771;954;954;22;932;53.87;2.31
102507;221401;Zespół Szkół Rzemieślniczych i Kupieckich|Tczew|ul. Czyżykowska 17 |83-110 Tczew;1604;811;811;12;799;50.56;1.48
102508;221401;Gimnazjum Nr 1|Tczew|ul. Czyżykowska 69 |83-110 Tczew;2313;1165;1165;41;1124;50.37;3.52
102509;221401;Gimnazjum Nr 1|Tczew|ul. Czyżykowska 69 |83-110 Tczew;2050;960;960;30;930;46.83;3.12
102510;221401;"Tęczowe Przedszkole"|Tczew|ul. Józefa Chełmońskiego 1a |83-110 Tczew;2007;1184;1185;18;1166;58.99;1.52
102511;221401;Szpitale Tczewskie S.A.|Tczew|30 Stycznia 57/58 |83-110 Tczew;24;15;15;1;14;62.50;6.67
102512;221401;Szpitale Tczewskie S.A.|Tczew|Paderewskiego 11 |83-110 Tczew;45;9;9;0;9;20.00;0.00
102513;221401;Szpitale Tczewskie S.A.|Tczew|1 Maja 2 |83-110 Tczew;72;28;28;1;27;38.89;3.57
102514;221402;Szkoła Podstawowa w Gniewie|Gniew|ul. Gdańska 16 |83-140 Gniew;797;376;376;11;365;47.18;2.93
102515;221402;Szkoła Podstawowa w Gniewie|Gniew|ul. Gdańska 16 |83-140 Gniew;838;380;380;11;369;45.35;2.89
102516;221402;Szkoła Podstawowa w Gniewie|Gniew|ul. Gdańska 16 |83-140 Gniew;699;270;270;12;258;38.63;4.44
102517;221402;Sień Powiatowej i Miejskiej Biblioteki Publicznej w Gniewie|Gniew|Plac Grunwaldzki 17 |83-140 Gniew;748;277;277;19;258;37.03;6.86
102518;221402;Biuro Referatu Promocji i Informacji Urzędu Miasta i Gminy Gniew|Gniew|Plac Grunwaldzki 16 |83-140 Gniew;453;170;170;8;162;37.53;4.71
102519;221402;Gimnazjum w Gniewie|Gniew|27 Stycznia 19 |83-140 Gniew;846;393;393;12;381;46.45;3.05
102520;221402;Gimnazjum w Gniewie|Gniew|27 Stycznia 19 |83-140 Gniew;907;354;354;15;339;39.03;4.24
102521;221402;Świetlica Wiejska w Kursztynie|Kursztyn| 16 |83-140 Gniew;861;221;221;11;210;25.67;4.98
102522;221402;Szkoła Podstawowa w Polskim Gronowie|Polskie Gronowo| 31 |83-140 Gniew;943;266;266;15;251;28.21;5.64
102523;221402;Szkoła Podstawowa w Piasecznie|Piaseczno| 26 |83-123 Piaseczno;853;306;306;17;289;35.87;5.56
102524;221402;Zespół Szkół w Opaleniu|Opalenie|ul. Ks. Ludwika Warneckiego 10 |83-136 Opalenie;1152;438;438;31;407;38.02;7.08
102525;221402;Filia w Pieniążkowie Zespołu Szkół w Opaleniu|Pieniążkowo| 27 |83-135 Mała Karczma;520;185;185;9;176;35.58;4.86
102526;221402;Filia w Pieniążkowie Zespołu Szkół w Opaleniu|Pieniążkowo| 27 |83-135 Mała Karczma;575;195;195;8;187;33.91;4.10
102527;221402;Świetlica Wiejska w Rakowcu|Rakowiec| 44 |83-135 Mała Karczma;955;319;319;12;307;33.40;3.76
102528;221402;Świetlica Wiejska w Nicponi|Nicponia| 95D |83-140 Gniew;983;422;422;11;411;42.93;2.61
102529;221402;Świetlica DPS w Gniewie|Gniew|Gdańska 23 |83-140 Gniew;88;27;27;5;22;30.68;18.52
102530;221402;Dom Pomocy Społecznej|Wielkie Wyręby| 23 |83-230 Smętowo Graniczne;17;14;14;2;12;82.35;14.29
102531;221403;Świetlica Urzędu Gminy|Morzeszczyn|ul. 22 Lipca 4 |83-132 Morzeszczyn;1260;492;492;26;466;39.05;5.28
102532;221403;Świetlica Domu Strażaka|Nowa Cerkiew| 25A |83-132 Morzeszczyn;719;246;246;13;233;34.21;5.28
102533;221403;Świetlica Wiejska|Lipia Góra| 19C |83-132 Morzeszczyn;851;263;263;11;252;30.90;4.18
102534;221404;Niepubliczny Zakład Opieki Zdrowotnej PELMED Sp. zo.o.,|Pelplin|ul. Wybickiego 14 |83-130 Pelplin;1784;793;793;28;765;44.45;3.53
102535;221404;Zespół Kształcenia i Wychowania Nr1|Pelplin|ul. Sambora 5a |83-130 Pelplin;1601;683;683;26;657;42.66;3.81
102536;221404;Sala Sportowa|Pelplin|ul. Starogardzka 4a |83-130 Pelplin;822;259;259;16;243;31.51;6.18
102537;221404;Zespół Szkół Nr 2|Pelplin|ul. Kościuszki 12A |83-130 Pelplin;1983;806;806;22;784;40.65;2.73
102538;221404;PELKOM Sp. z o.o.|Pelplin|ul. Starogardzka 12 |83-130 Pelplin;1192;509;509;16;493;42.70;3.14
102539;221404;Centrum Kultury we wsi Wielki Garc|Wielki Garc| 39 |83-122 Rudno;755;237;237;21;216;31.39;8.86
102540;221404;Centrum Kultury Wiejskiej|Rudno|ul. Kościelna 6 |83-121 Rudno;1157;447;447;18;429;38.63;4.03
102541;221404;Świetlica Wiejska|Lignowy Szlacheckie| 90 |83-121 Rudno;784;304;304;25;279;38.78;8.22
102542;221404;Świetlica Wiejska|Bielawki| 45 |83-130 Pelplin;576;205;205;12;193;35.59;5.85
102543;221404;Zespół Kształcenia i Wychowania|Rajkowy|ul. Jesionowa 6 |83-130 Pelplin;1243;420;420;25;395;33.79;5.95
102544;221404;Zespół Kształcenia i Wychowania|Kulice|ul. Szkolna 1 |83-130 Pelplin;759;296;296;13;283;39.00;4.39
102545;221404;Dom Pomocy Społecznej|Pelplin|Szpitalna 2 |83-130 Pelplin;137;60;60;3;57;43.80;5.00
102546;221405;Dom Kultury|Subkowy|ul. Wybickiego 22a |83-120 Subkowy;1074;518;518;16;502;48.23;3.09
102547;221405;Zespół Kształcenia Podstawowego i Przedszkolnego|Mała Słońca|ul. Długa 1 |83-120 Subkowy;1053;284;284;19;265;26.97;6.69
102548;221405;Szkoła Filialna|Brzuśce|ul. Milenijna 12 |83-120 Subkowy;1158;428;428;34;394;36.96;7.94
102549;221405;Gimnazjum im. Zjednoczonej Europy|Subkowy|ul. Wybickiego 19b |83-120 Subkowy;863;370;370;20;350;42.87;5.41
102550;221406;Świetlica Wiejska|Tczewskie Łąki|ul. Szkolna 2 |83-110 Tczew;666;325;325;8;317;48.80;2.46
102551;221406;Świetlica Wiejska|Bałdowo|ul. Piękna 1 |83-110 Tczew;623;360;360;7;353;57.78;1.94
102552;221406;Świetlica Wiejska|Czarlin|ul. Szkolna 13 |83-110 Tczew;671;337;337;14;323;50.22;4.15
102553;221406;Zespół Kształcenia i Wychowania|Swarożyn|ul. Wyzwolenia 18 |83-115 Swarożyn;1250;495;495;21;474;39.60;4.24
102554;221406;Świetlica Wiejska|Boroszewo| 34 |83-115 Swarożyn;535;242;242;17;225;45.23;7.02
102555;221406;Zespół Kształcenia i Wychowania|Turze|ul. Kościelna 7 |83-113 Turze;1210;480;480;23;457;39.67;4.79
102556;221406;Świetlica Wiejska|Dalwin| 22 |83-113 Turze;675;264;264;11;253;39.11;4.17
102557;221406;Szkoła Podstawowa|Lubiszewo|ul. Sambora 3 |83-112 Lubiszewo;693;350;350;9;341;50.51;2.57
102558;221406;Gimnazjum|Dąbrówka| 37 |83-111 Miłobądz;798;444;444;19;425;55.64;4.28
102559;221406;Świetlica wiejska|Rokitki|ul. Kasztanowa 24 |83-112 Lubiszewo;1162;581;581;14;567;50.00;2.41
102560;221406;Szkoła Podstawowa|Miłobądz|ul. Szkolna 6 |83-111 Miłobądz;1746;676;676;28;648;38.72;4.14
102561;221406;Dom Pomocy Społecznej|Damaszka| 1 |83-209 Godziszewo;72;53;53;10;43;73.61;18.87
102562;221406;Dom Pomocy Społecznej|Stanisławie| 31 |83-112 Lubiszewo;28;8;8;2;6;28.57;25.00
102563;221501;Szkoła Podstawowa nr 6|Reda|ul. Gniewowska 33 |84-240 Reda;1972;1161;1161;26;1135;58.87;2.24
102564;221501;Szkoła Podstawowa nr 2|Reda|ul. A. Zawadzkiego 10 |84-240 Reda;1484;907;907;44;863;61.12;4.85
102565;221501;Szkoła Podstawowa nr 2|Reda|ul. A. Zawadzkiego 10 |84-240 Reda;1634;1010;1010;16;994;61.81;1.58
102566;221501;Miejska Biblioteka Publiczna|Reda|ul. H. Derdowskiego 3 |84-240 Reda;1867;992;992;24;968;53.13;2.42
102567;221501;Gimnazjum Nr 1|Reda|ul. Łąkowa 36/38 |84-240 Reda;1738;960;960;29;931;55.24;3.02
102568;221501;Gimnazjum Nr 1|Reda|ul. Łąkowa 36/38 |84-240 Reda;1725;1012;1012;18;994;58.67;1.78
102569;221501;Szkoła Podstawowa nr 5|Reda|ul. Rekowska 36 |84-240 Reda;1891;978;978;48;930;51.72;4.91
102570;221501;Szkoła Podstawowa nr 3|Reda|ul. Brzozowa 30 |84-240 Reda;1943;1146;1146;21;1125;58.98;1.83
102571;221501;Szkoła Podstawowa nr 3|Reda|ul. Brzozowa 30 |84-240 Reda;1824;1020;1020;25;995;55.92;2.45
102572;221501;Szkoła Podstawowa nr 2|Reda|A. Zawadzkiego 10 |84-240 ;1417;878;878;20;858;61.96;2.28
102573;221502;Szkoła Podstawowa Nr 1|Rumia|ul. Kościelna 6 |84-230 Rumia;1701;1102;1102;13;1089;64.79;1.18
102574;221502;Powiatowy Zespół Placówek Szkolno-Rewalidacyjno-Wychowawczych|Rumia|ul. Sabata 12 |84-230 Rumia;1579;742;742;25;717;46.99;3.37
102575;221502;Zespół Szkół Ponadgimnazjalnych Nr 2 (sala gimnastyczna)|Rumia|ul. Grunwaldzka 57 |84-230 Rumia;1563;794;795;21;773;50.80;2.64
102576;221502;Gimnazjum Nr 2|Rumia|ul. Świętojańska 11 |84-230 Rumia;1856;1177;1177;23;1154;63.42;1.95
102577;221502;Zespół Szkół Ponadgimnazjalnych Nr 1|Rumia|ul. Starowiejska 4 |84-230 Rumia;1678;992;992;22;970;59.12;2.22
102578;221502;Szkoła Podstawowa Nr 6|Rumia|ul. Sienkiewicza 30 |84-230 Rumia;1646;1030;1030;13;1017;62.58;1.26
102579;221502;Gimnazjum Nr 4|Rumia|ul. Stefana Batorego 29 |84-230 Rumia;1706;1015;1015;29;986;59.50;2.86
102580;221502;Gimnazjum Nr 1|Rumia|ul. Rodziewiczówny 10 |84-230 Rumia;1807;1079;1079;7;1072;59.71;0.65
102581;221502;Zespół Szkół Ogólnokształcących|Rumia|ul. Stoczniowców 6 |84-230 Rumia;1859;1119;1119;28;1091;60.19;2.50
102582;221502;"ISKIERKA" Przedszkole Niepubliczne|Rumia|ul. Dokerów 5 |84-230 Rumia;1952;1195;1195;34;1161;61.22;2.85
102583;221502;Ekologiczna Szkoła Społeczna|Rumia|ul. Kujawska 8a |84-230 Rumia;1823;1135;1135;27;1108;62.26;2.38
102584;221502;Hala Widowiskowo-Sportowa|Rumia|ul. Mickiewicza 49 |84-230 Rumia;1714;1059;1059;14;1045;61.79;1.32
102585;221502;Szkoła Podstawowa Nr 10|Rumia|ul. Górnicza 19 |84-230 Rumia;1772;1064;1064;17;1047;60.05;1.60
102586;221502;Przedszkole Niepubliczne "JANOWIACZEK"|Rumia|ul. Pomorska 27 |84-230 Rumia;1742;1127;1127;19;1108;64.70;1.69
102587;221502;Szkoła Podstawowa Nr 1 (sala gimnastyczna)|Rumia|ul. Kościelna 6 |84-230 Rumia;1511;869;869;24;845;57.51;2.76
102588;221502;Gimnazjum Nr 2 (sala gimnastyczna)|Rumia|ul. Świętojańska 11 |84-230 Rumia;1900;1150;1150;14;1136;60.53;1.22
102589;221502;CARITAS Archidiecezji Gdańskiej - Centrum im. Św. s. Faustyny|Rumia|ul. Księdza Lucjana Gierosa 8A |84-230 Rumia;1591;914;914;25;889;57.45;2.74
102590;221502;Szkoła Podstawowa Nr 1 (wejście od ul. Świętopełka)|Rumia|Kościelna 6 |84-230 Rumia;1543;906;906;19;887;58.72;2.10
102591;221502;Zespół Szkół Ponadgimnzajalnych Nr 2|Rumia|Grunwaldzka 57 |84-230 Rumia;1737;940;940;29;911;54.12;3.09
102592;221502;Szkoła Podstawowa Nr 6|Rumia|Sienkiewicza 30 |84-230 Rumia;1672;995;995;22;973;59.51;2.21
102593;221502;Gimnazjum Nr 1|Rumia|Rodziewiczówny 10 |84-230 Rumia;2026;1206;1206;33;1173;59.53;2.74
102594;221503;Świetlica Zakładu Energetycznego|Wejherowo|ul. Przemysłowa 18 |84-200 Wejherowo;1781;952;952;27;925;53.45;2.84
102595;221503;Przedszkole Samorządowe Nr 2|Wejherowo|ul. Derdowskiego 1 |84-200 Wejherowo;1826;1019;1019;23;996;55.81;2.26
102596;221503;Zespół Szkół Nr 3|Wejherowo|ul. Nanicka 22 |84-200 Wejherowo;1823;1080;1080;25;1055;59.24;2.31
102597;221503;Wejherowski Zarząd Nieruchomości Komunalnych (ZUK)|Wejherowo|ul. Obrońców Helu 1 |84-200 Wejherowo;1822;1054;1054;22;1032;57.85;2.09
102598;221503;Społeczna Szkoła Podstawowa Nr 1 i Gimnazjum Społeczne Nr 1|Wejherowo|ul. Obrońców Wybrzeża 1 |84-200 Wejherowo;1909;1140;1140;18;1122;59.72;1.58
102599;221503;Miejska Biblioteka Publiczna|Wejherowo|ul. Kaszubska 14 |84-200 Wejherowo;1935;1094;1094;24;1070;56.54;2.19
102600;221503;Przedszkole Niepubliczne "Bajka"|Wejherowo|Osiedle Kaszubskie 28 |84-200 Wejherowo;1985;1095;1095;24;1071;55.16;2.19
102601;221503;Zespół Szkół Ogólnokształcących Nr 2|Wejherowo|Osiedle Kaszubskie 27 |84-200 Wejherowo;1861;1033;1033;7;1026;55.51;0.68
102602;221503;Zespół Szkół Nr 2|Wejherowo|Gdańska 30 |84-200 Wejherowo;1532;834;834;21;813;54.44;2.52
102603;221503;Zespół Szkół Nr 2|Wejherowo|ul. Gdańska 30 |84-200 Wejherowo;1837;1056;1056;25;1031;57.49;2.37
102604;221503;Zespół Szkół Nr 2|Wejherowo|ul. Gdańska 30 |84-200 Wejherowo;1743;822;822;10;812;47.16;1.22
102605;221503;Zespół Szkół Nr 1|Wejherowo|ul. Śmiechowska 36 |84-200 Wejherowo;1643;855;855;12;843;52.04;1.40
102606;221503;Zespół Szkół Nr 1|Wejherowo|ul. Śmiechowska 36 |84-200 Wejherowo;1801;1046;1046;15;1031;58.08;1.43
102607;221503;Zespół Szkół Nr 1|Wejherowo|ul. Śmiechowska 36 |84-200 Wejherowo;1621;812;812;22;790;50.09;2.71
102608;221503;Muzeum Piśmiennictwa i Muzyki Kaszbsko- Pomorskiej|Wejherowo|ul. Zamkowa 2A |84-200 Wejherowo;1584;768;768;21;747;48.48;2.73
102609;221503;Wejherowskie Towarzystwo Budownictwa Społecznego|Wejherowo|ul. Parkowa 2A 20|84-200 Wejherowo;1570;739;739;17;722;47.07;2.30
102610;221503;Zespół Szkół Ponadgimnazjalnych Nr 2|Wejherowo|ul. Strzelecka 9 |84-200 Wejherowo;1634;743;743;25;718;45.47;3.36
102611;221503;Gimnazjum nr 1|Wejherowo|ul. Sobieskiego 300 |84-200 Wejherowo;1661;788;788;18;770;47.44;2.28
102612;221503;Zespół Szkół Ponadgimnazjalnych Nr 1|Wejherowo|ul. Bukowa 1 |84-200 Wejherowo;1748;1006;1006;25;981;57.55;2.49
102613;221503;Szkoła Podstawowa Nr 9|Wejherowo|Osiedle 1000 lecia PP 15 |84-200 Wejherowo;1616;858;858;12;846;53.09;1.40
102614;221503;Zasadnicza Szkoła Zawodowa Nr 5, Specjalny Ośrodek Szkolno-Wychowawczy Nr 1|Wejherowo|ul. Sobieskiego 279 |84-200 Wejherowo;1753;994;994;14;980;56.70;1.41
102615;221503;Areszt Śledczy|Wejherowo|Sobieskiego 302 |84-200 Wejherowo;354;181;181;28;153;51.13;15.47
102616;221503;Szpital Specjalistyczny|Wejherowo|Jagalskiego 10 |84-200 Wejherowo;268;70;70;1;69;26.12;1.43
102617;221503;Dom Pomocy Społecznej|Wejherowo|Św. Jacka 14 |84-200 Wejherowo;44;33;33;6;27;75.00;18.18
102618;221503;Dom Pomocy Społecznej|Wejherowo|Przebendowskiego 1 |84-200 Wejherowo;55;30;30;3;27;54.55;10.00
102619;221504;Zespół Szkół Stołówka szkolna|Choczewo|ul. Szkolna 2 |84-210 Choczewo;1091;589;589;19;570;53.99;3.23
102620;221504;Zespół Szkół|Choczewo|ul. Szkolna 2 |84-210 Choczewo;1280;418;418;23;395;32.66;5.50
102621;221504;Świetlica|Łętowo| 2 |84-210 Choczewo;501;131;131;14;117;26.15;10.69
102622;221504;Sala gimnastyczna byłej szkoły|Zwartowo| 19b |84-210 Choczewo;567;172;172;17;155;30.34;9.88
102623;221504;Szkoła Podstawowa|Ciekocino| 11 |84-210 Choczewo;602;149;149;13;136;24.75;8.72
102624;221504;Budynek byłej szkoły|Sasino|ul. Cisowa 6 |84-210 Choczewo;388;154;154;13;141;39.69;8.44
102625;221504;Oddział Tymczasowego Zakwaterowania Skazanych|Zwartowo| 25 |84-210 Choczewo;30;30;30;5;25;100.00;16.67
102626;221505;Samorządowy Zespół Szkół|Gniewino|ul. Szkolna 1 |84-250 Gniewino;1654;715;715;29;686;43.23;4.06
102627;221505;Centrum Kultury,Sportu,Turystyki i Biblioteka|Gniewino|ul. Sportowa 1 |84-250 Gniewino;767;308;308;11;297;40.16;3.57
102628;221505;Samorządowy Zespół Szkół|Kostkowo|ul. Księdza Galasa 1 |84-251 Gniewino;1676;581;581;32;549;34.67;5.51
102629;221505;Ochotnicza Straż Pożarna|Nadole|ul. Strażacka 20 |84-250 Gniewino;282;163;163;2;161;57.80;1.23
102630;221505;Dom Sołecki|Rybno|ul. Dębowa 7 |84-251 Gniewino;845;330;330;8;322;39.05;2.42
102631;221505;Dom Pomocy Społecznej|Strzebielinek| 15 |84-250 Gniewino;107;44;44;4;40;41.12;9.09
102632;221506;Zespół Szkół w Lini|Linia|Szkolna 1 |84-223 Linia;1471;684;684;50;634;46.50;7.31
102633;221506;Zespół Szkół w Lini|Linia|Szkolna 1 |84-223 Linia;749;347;347;16;331;46.33;4.61
102634;221506;Zespół Szkół w Strzepczu|Strzepcz|Heronima Derdowskiego 3 |84-223 Linia;1788;854;854;45;809;47.76;5.27
102635;221506;Szkoła Podstawowa w Niepoczołowicach|Niepoczołowice| 29 |84-223 Linia;528;289;289;10;279;54.73;3.46
102636;221507;Szkoła Podstawowa w Luzinie (nowa część szkoły)|Luzino|ul. Szkolna 13 |84-242 Luzino;2015;1142;1142;48;1094;56.67;4.20
102637;221507;Szkoła Podstawowa w Luzinie (stara część szkoły)|Luzino|ul. Szkolna 13 |84-242 Luzino;1361;749;749;26;723;55.03;3.47
102638;221507;Gimnazjum Publiczne w Luzinie|Luzino|ul. Mickiewicza 22 |84-242 Luzino;2116;1202;1202;31;1171;56.81;2.58
102639;221507;Szkoła Podstawowa w Wyszecinie|Wyszecino|ul. Szkolna 2 |84-242 Luzino;1025;394;394;23;371;38.44;5.84
102640;221507;Szkoła Podstawowa w Sychowie|Sychowo|Szkolna 4 |84-242 Luzino;1558;704;704;52;652;45.19;7.39
102641;221507;Szkoła Podstawowa w Kębłowie (budynek szkoły)|Kębłowo|ul. Wiejska 49 |84-242 Luzino;1376;680;680;39;641;49.42;5.74
102642;221507;Szkoła Podstawowa w Kębłowie (budynek sali gimnastycznej)|Kębłowo|ul. Wiejska 49 |84-242 Luzino;1325;575;575;22;553;43.40;3.83
102643;221508;Zespół Szkół w Bożympolu Wielkim|Bożepole Wielkie|Szkolna 1 |84-214 Bożepole Wielkie;893;363;363;13;350;40.65;3.58
102644;221508;Zespół Szkół w Bożympolu Wielkim|Bożepole Wielkie|Szkolna 1 |84-214 Bożepole Wielkie;1132;527;527;21;506;46.55;3.98
102645;221508;Szkoła Podstawowa|Brzeźno Lęborskie| 43a |84-213 Brzeźno Lęborskie;665;210;210;7;203;31.58;3.33
102646;221508;Świetlica wiejska|Kaczkowo| 18A |84-218 Łęczyce;776;275;275;11;264;35.44;4.00
102647;221508;Zespół Szkół w Łęczycach|Łęczyce|Topolowa 1 |84-218 Łęczyce;565;212;212;3;209;37.52;1.42
102648;221508;Zespół Szkół w Łęczycach|Łęczyce|Topolowa 1 |84-218 Łęczyce;1136;507;507;19;488;44.63;3.75
102649;221508;Zespół Kształcenia i Wychowania w Rozłazinie|Rozłazino|Długa 21 |84-218 Łęczyce;859;387;387;18;369;45.05;4.65
102650;221508;Świetlica wiejska Nawcz|Nawcz| 34 |84-218 Łęczyce;462;203;203;9;194;43.94;4.43
102651;221508;Zespół Szkół i Przesdzkola|Strzebielino Osiedle|M.C.Skłodowskiej 1 |84-220 Strzebielino;1298;643;643;25;618;49.54;3.89
102652;221508;Zespół Szkół i Przedszkola|Strzebielino-Osiedle|M.C. Skłodowskiej 1 |84-220 Strzebielino;1007;482;482;18;464;47.86;3.73
102653;221509;Zespół Szkolno-Przedszkolny w Szemudzie|Szemud|ul. Szkolna 4 |84-217 Szemud;2035;1045;1045;48;997;51.35;4.59
102654;221509;Zespół Szkół w Kielnie|Kielno|ul. Szkolna 4 |84-208 Kielno;2090;1095;1095;65;1030;52.39;5.94
102655;221509;Szkoła Podstawowa w Łebnie|Łebno|ul. Szkolna 1 |84-217 Szemud;1619;729;729;45;684;45.03;6.17
102656;221509;Zespół Szkół w Bojanie|Bojano|ul. Józefa Wybickiego 38 |84-207 Koleczkowo;2069;1281;1281;40;1241;61.91;3.12
102657;221509;Zespół Szkół w Kielnie|Kielno|ul. Szkolna 4 |84-208 Kielno;903;522;522;19;503;57.81;3.64
102658;221509;Zespół Szkolno-Przedszkolny w Szemudzie|Szemud|ul. Szkolna 4 |84-217 Szemud;2126;1020;1020;61;959;47.98;5.98
102659;221509;Zespół Szkolno-Przedszkolny w Koleczkowie|Koleczkowo|ul. Wejherowska 24 |84-207 Koleczkowo;1135;649;649;12;637;57.18;1.85
102660;221510;Samorządowa Szkoła Podstawowa Bolszewo|Bolszewo|ul. Szkolna 7 |84-239 Bolszewo;845;448;448;15;433;53.02;3.35
102661;221510;Samorządowa Szkoła Podstawowa Bolszewo|Bolszewo|ul. Szkolna 7 |84-239 Bolszewo;937;490;490;21;469;52.29;4.29
102662;221510;Samorządowa Szkoła Podstawowa Bolszewo|Bolszewo|ul. Szkolna 7 |84-239 Bolszewo;981;501;501;22;479;51.07;4.39
102663;221510;Samorządowe Gimnazjum Bolszewo|Bolszewo|ul. Leśna 35 |84-239 Bolszewo;828;493;493;12;481;59.54;2.43
102664;221510;Samorządowe Gimnazjum Bolszewo|Bolszewo|ul. Leśna 35 |84-239 Bolszewo;746;424;424;9;415;56.84;2.12
102665;221510;Samorządowe Gimnazjum Bolszewo|Bolszewo|ul. Leśna 35 |84-239 Bolszewo;572;316;316;20;296;55.24;6.33
102666;221510;Samorządowe Gimnazjum Bolszewo|Bolszewo|ul. Leśna 35 |84-239 Bolszewo;798;424;424;16;408;53.13;3.77
102667;221510;Dworek Drzewiarza Gościcino|Gościcino|ul. Drzewiarza 2 |84-241 Gościcino;736;334;334;13;321;45.38;3.89
102668;221510;Dworek Drzewiarza Gościcino|Gościcino|ul. Drzewiarza 2 |84-241 Gościcino;690;339;339;12;327;49.13;3.54
102669;221510;Samorządowa Szkoła Podstawowa Gościcino|Gościcino|ul. Wejherowska 22 |84-241 Gościcino;638;324;324;6;318;50.78;1.85
102670;221510;Samorządowa Szkoła Podstawowa Gościcino|Gościcino|ul. Wejherowska 22 |84-241 Gościcino;757;369;369;17;352;48.75;4.61
102671;221510;Samorządowa Szkoła Podstwowa Gościcino|Gościcino|ul. Wejherowska 22 |84-241 Gościcino;705;289;289;8;281;40.99;2.77
102672;221510;Samorządowa Szkoła Podstwowa Gościcino|Gościcino|ul. Wejherowska 22 |84-241 Gościcino;836;437;437;26;411;52.27;5.95
102673;221510;Samorządowa Szkoła Podstwowa Orle|Orle|ul. Nadrzeczna 19 |84-252 Zamostne;665;411;411;12;399;61.80;2.92
102674;221510;Samorządowa Szkoła Podstwowa Orle|Orle|ul. Nadrzeczna 19 |84-252 Zamostne;829;407;407;9;398;49.10;2.21
102675;221510;Samorządowa Szkoła Podstwowa Gowino|Gowino|ul. Wejherowska 60 |84-200 Wejherowo;1088;594;594;22;572;54.60;3.70
102676;221510;Świetlica w budynku Agory Kąpino|Kąpino|ul. Wiejska 29 |84-200 Wejherowo;736;447;447;6;441;60.73;1.34
102677;221510;Świetlica Wiejska Zbychowo|Zbychowo|ul. Kamienna 2 |84-200 Wejherowo;924;501;501;22;479;54.22;4.39
102678;221510;Samorządowa Szkoła Podstawowa Gowino|Gowino|ul. Wejherowska 60 |84-200 Wejherowo;699;286;286;19;267;40.92;6.64
102679;221510;Samorządowa Szkoła Podstwowa Nowy Dwór Wejherowski|Nowy Dwór Wejherowski|ul. Szkolna 1 |84-206 Nowy Dwór Wejherowski;1080;512;512;16;496;47.41;3.12
102680;221510;Świetlica wiejska przy remizie OSP w Kniewie|Kniewo|ul. Aleja Lipowa 14 |84-252 Zamostne;1049;520;520;19;501;49.57;3.65
102681;221601;Szkoła Podstawowa im. Tysiąclecia Państwa Polskiego w Dzierzgoniu - budynek główny|Dzierzgoń|ul. Krzywa 17 |82-440 Dzierzgoń;1488;551;551;33;518;37.03;5.99
102682;221601;Sala Sportowa Zespołu Szkół im. K.C. Norwida w Dzierzgoniu|Dzierzgoń|ul. Zawadzkiego 15 |82-440 Dzierzgoń;1401;481;481;22;459;34.33;4.57
102683;221601;Świetlica Nowiec|Nowiec| 6 |82-440 Dzierzgoń;247;62;62;1;61;25.10;1.61
102684;221601;Szkoła Podstawowa im. Świętego Wojciecha w Bągarcie|Bągart| 3 |82-440 Dzierzgoń;310;122;122;6;116;39.35;4.92
102685;221601;Świetlica Jasna|Jasna| 17 |82-440 Dzierzgoń;472;128;128;9;119;27.12;7.03
102686;221601;Świetlica Żulawka Sztumska|Żuławka Sztumska| 25 |82-440 Dzierzgoń;364;142;142;12;130;39.01;8.45
102687;221601;Szkoła Podstawowa w Bruku - sala gimnastyczna|Bruk| 1 |82-440 Dzierzgoń;389;105;105;7;98;26.99;6.67
102688;221601;Świetlica Ankamaty|Ankamaty| 1 |82-440 Dzierzgoń;297;70;70;4;66;23.57;5.71
102689;221601;Świetlica Stanowo|Stanowo| 1 |82-440 Dzierzgoń;380;115;115;10;105;30.26;8.70
102690;221601;Świetlica Tywęzy|Tywęzy| 16 |82-440 Dzierzgoń;194;50;50;2;48;25.77;4.00
102691;221601;Świetlica Morany|Morany| |82-440 Dzierzgoń;257;78;78;5;73;30.35;6.41
102692;221601;Szkoła Podstawowa im. Tysiąclecia Państwa Polskiego w Dzierzgoniu Centrum sportowo-rekreacyjne|Dzierzgoń|Krzywa 17 |82-440 Dzierzgoń;1582;553;553;29;524;34.96;5.24
102693;221602;Zespół Szkół w Mikołajkach Pomorskich|Mikołajki Pomorskie|Szreibera 10-12 |82-433 Mikołajki Pomorskie;1263;542;542;32;510;42.91;5.90
102694;221602;Gminny Ośrodek Kultury w Mikołajkach Pomorskich|Mikołajki Pomorskie|Szreibera 13 |82-433 Mikołajki Pomorskiw;554;154;154;6;148;27.80;3.90
102695;221602;Świetlica Krasna Łąka|Krasna Łąka| 28d |82-433 Mikołajki Pomorskie;445;109;109;6;103;24.49;5.50
102696;221602;Świetlica Cieszymowo|Cieszymowo| 1 |82-433 Mikołajki Pomorskie;609;104;104;7;97;17.08;6.73
102697;221603;Świetlica Wiejska|Stare Miasto| 36 |82-450 Stary Dzierzgoń;541;123;123;6;117;22.74;4.88
102698;221603;Gminne Centrum Kulturalno-Biblioteczne|Stary Dzierzgoń| 22A |82-450 Stary Dzierzgoń;690;215;215;9;206;31.16;4.19
102699;221603;Szkoła Podstawowa|Myślice| 16 |82-450 Stary Dzierzgoń;901;225;225;11;214;24.97;4.89
102700;221603;Świetlica Wiejska|Lubochowo| 54A |82-450 Stary Dzierzgoń;531;112;112;10;102;21.09;8.93
102701;221603;Gimnazjum Publiczne im. Zygmunta Steinborn|Przezmark| 32 |82-450 Stary Dzierzgoń;596;165;165;10;155;27.68;6.06
102702;221604;Gminny Ośrodek Kultury w Starym Targu|Stary Targ|ul. 22 Lipca 1 |82-410 Stary Targ;924;324;324;16;308;35.06;4.94
102703;221604;Zespół Szkół w Starym Targu|Stary Targ|Świerczewskiego 37A |82-410 Stary Targ;1012;229;229;5;224;22.63;2.18
102704;221604;Świetlica Wiejska w Waplewie Wielkim|Waplewo Wielkie| 18 |82-410 Stary Targ;874;240;240;16;224;27.46;6.67
102705;221604;Szkoła Podstawowa w Szropach|Szropy| 40 |82-410 Stary Targ;1002;257;257;4;253;25.65;1.56
102706;221604;Remiza OSP w Dąbrówce Malborskiej|Dąbrówka Malborska| 65 |82-410 Stary Targ;792;237;237;16;221;29.92;6.75
102707;221604;Świetlica Wiejska w Bukowie|Bukowo| 9 |82-410 Stary Targ;408;153;153;14;139;37.50;9.15
102708;221605;Budynek po Szkołe Podstawowej w Piekle|Piekło| 30 |82-400 Sztum;429;155;155;4;151;36.13;2.58
102709;221605;Zespół Szkół w Gościszewie|Gościszewo| 75 |82-400 Sztum;1323;522;522;27;495;39.46;5.17
102710;221605;Zespół Szkół w Czerninie|Czernin|ul. Donimirskich 19 |82-400 Sztum;1711;617;617;18;599;36.06;2.92
102711;221605;Szkoła Podstawowa w Nowej Wsi|Nowa Wieś| 60 |82-400 Sztum;724;257;257;7;250;35.50;2.72
102712;221605;Biblioteka w Postolinie|Postolin| 14B |82-400 Sztum;505;137;137;3;134;27.13;2.19
102713;221605;Gimnazjum nr 1 w Sztumie|Sztum|ul. Sienkiewicza 54 |82-400 Sztum;1401;652;652;19;633;46.54;2.91
102714;221605;Szkoła Podstawowa Nr 2 w Sztumie|Sztum|ul. Reja 15A |82-400 Sztum;2155;951;951;31;920;44.13;3.26
102715;221605;Biblioteka w Sztumie|Sztum|ul. Mickiewicza 23 |82-400 Sztum;1026;406;406;7;399;39.57;1.72
102716;221605;Siedziba Starostwa Powiatowego w Sztumie|Sztum|ul. Mickiewicza 31 |82-400 Sztum;764;382;382;14;368;50.00;3.66
102717;221605;Urząd Stanu Cywilnego w Sztumie|Sztum|ul. Mickiewicza 39 |82-400 Sztum;1706;761;761;14;747;44.61;1.84
102718;221605;Zespół Szkół Zawodowych|Barlewiczki| 13 |82-400 Sztum;1327;576;576;24;552;43.41;4.17
102719;221605;Świetlica Straży Pożarnej w Sztumie|Sztum|ul. Sienkiewicza 27 |82-400 Sztum;1195;520;520;13;507;43.51;2.50
102720;221605;Szpital Polski Sztum|Sztum|Reja 12 |82-400 Sztum;223;51;51;2;49;22.87;3.92
102721;221605;Zakład Karny w Sztumie|Sztum|Nowowiejskiego 14 |82-400 Sztum;857;405;405;52;353;47.26;12.84
102722;226101;Szkoła Podstawowa Nr 20|Gdańsk, Brzeźno|ul. Wczasy 3 |80-509 Gdańsk 26;1733;1102;1102;12;1090;63.59;1.09
102723;226101;Projektornia Gdański Archipelag Kultury|Gdańsk, Brzeźno|ul. Dworska 29A |80-506 Gdańsk 26;1808;1040;1040;18;1022;57.52;1.73
102724;226101;STOWARZYSZENIE SZKOŁY GEDANENSIS|Gdańsk, Brzeźno|ul. Dworska 34 |80-506 Gdańsk 26;1565;821;821;11;810;52.46;1.34
102725;226101;STOWARZYSZENIE SZKOŁY GEDANENSIS|Gdańsk, Brzeźno|ul. Dworska 34 |80-506 Gdańsk 26;1829;1009;1009;21;988;55.17;2.08
102726;226101;Zespół Szkół Ogólnokształcących Nr 10|Gdańsk, Brzeźno|ul. Krasickiego 10 |80-515 Gdańsk 26;1845;1168;1168;11;1157;63.31;0.94
102727;226101;Zespół Szkół Ogólnokształcących Nr 10|Gdańsk, Brzeźno|ul. Krasickiego 10 |80-515 Gdańsk 26;1890;1112;1112;21;1091;58.84;1.89
102728;226101;Zespół Szkół Morskich|Gdańsk, Nowy Port|ul. Wyzwolenia 8 |80-537 Gdańsk 4;2235;1333;1333;17;1316;59.64;1.28
102729;226101;Zespół Szkół Ogólnokształcących Nr 5|Gdańsk, Nowy Port|ul. Na Zaspę 31A |80-546 Gdańsk 4;1577;879;879;12;867;55.74;1.37
102730;226101;Zespół Szkół Ogólnokształcących Nr 5|Gdańsk, Nowy Port|ul. Na Zaspę 31A |80-546 Gdańsk 4;1292;611;611;18;593;47.29;2.95
102731;226101;Szkoła Podstawowa Nr 55|Gdańsk, Nowy Port|ul. Wolności 6A |80-538 Gdańsk 4;1536;690;690;21;669;44.92;3.04
102732;226101;Szkoła Podstawowa Nr 55|Gdańsk, Nowy Port|ul. Wolności 6A |80-538 Gdańsk 4;1521;717;717;15;702;47.14;2.09
102733;226101;Gdańska Organizacja Turystyczna|Gdańsk, Letnica|ul. Uczniowska 22 |80-530 Gdańsk 4;1014;389;389;10;379;38.36;2.57
102734;226101;Dom Sztuki - Gdański Archipelag Kultury|Gdańsk, Stogi|ul. Stryjewskiego 25 |80-625 Gdańsk 8;1956;967;967;25;942;49.44;2.59
102735;226101;Dom Sztuki - Gdański Archipelag Kultury|Gdańsk, Stogi|ul. Stryjewskiego 25 |80-625 Gdańsk 8;1914;927;927;11;916;48.43;1.19
102736;226101;Szkoła Podstawowa Nr 11|Gdańsk, Stogi|ul. Stryjewskiego 28 |80-620 Gdańsk 8;1935;924;924;20;904;47.75;2.16
102737;226101;Szkoła Podstawowa Nr 11|Gdańsk, Stogi|ul. Stryjewskiego 28 |80-620 Gdańsk 8;1724;855;855;19;836;49.59;2.22
102738;226101;Gimnazjum Nr 11|Gdańsk, Stogi|ul. Kłosowa 3 |80-627 Gdańsk 8;1797;980;980;23;957;54.54;2.35
102739;226101;Szkoła Podstawowa Nr 61|Gdańsk, Przeróbka|ul. Sienna 26 |80-605 Gdańsk 8;1712;836;836;17;819;48.83;2.03
102740;226101;Szkoła Podstawowa Nr 61|Gdańsk, Przeróbka|ul. Sienna 26 |80-605 Gdańsk 8;1885;993;994;20;973;52.68;2.01
102741;226101;Szkoła Podstawowa Nr 62|Gdańsk, Krakowiec|ul. Kępna 38 |80-635 Gdańsk 8;1493;708;708;28;680;47.42;3.95
102742;226101;Zespół Kształcenia Podstawowego i Przedszkolnego Nr 1|Gdańsk, Wyspa Sobieszewska|ul. Tęczowa 6 |80-680 Gdańsk 40;1167;619;619;9;610;53.04;1.45
102743;226101;Zespół Kształcenia Podstawowego i Gimnazjalnego Nr 25|Gdańsk, Wyspa Sobieszewska|ul. Boguckiego 44 |80-690 Gdańsk 40;1504;727;727;16;711;48.34;2.20
102744;226101;Szkoła Podstawowa Nr 29 Fundacji Familijny Poznań|Gdańsk, Rudniki|ul. Miałki Szlak 74 |80-717 Gdańsk 50;1064;424;424;9;415;39.85;2.12
102745;226101;Zespół Szkół Samochodowych|Gdańsk, Śródmieście|ul. Elbląska 54/64 |80-724 Gdańsk 50;620;278;278;3;275;44.84;1.08
102746;226101;Szkoła Podstawowa Nr 59|Gdańsk, Olszynka|ul. Modra 2 |80-736 Gdańsk 50;1902;924;924;13;911;48.58;1.41
102747;226101;Zespół Kształcenia Podstawowego i Gimnazjalnego Nr 5|Gdańsk, Orunia|ul. Małomiejska 8A |80-037 Gdańsk 9;1561;577;577;14;563;36.96;2.43
102748;226101;Zespół Kształcenia Podstawowego i Gimnazjalnego Nr 5|Gdańsk, Orunia|ul. Małomiejska 8A |80-037 Gdańsk 9;1531;844;844;11;833;55.13;1.30
102749;226101;Zespół Kształcenia Podstawowego i Gimnazjalnego Nr 5|Gdańsk, Orunia|ul. Małomiejska 8A |80-037 Gdańsk 9;1504;813;813;9;804;54.06;1.11
102750;226101;Szkoła Podstawowa Nr 16|Gdańsk, Orunia|ul. Ubocze 3 |80-052 Gdańsk 9;1102;435;435;15;420;39.47;3.45
102751;226101;Szkoła Podstawowa Nr 16|Gdańsk, Orunia|ul. Ubocze 3 |80-052 Gdańsk 9;984;419;419;10;409;42.58;2.39
102752;226101;Gimnazjum Nr 10|Gdańsk, Orunia|ul. Gościnna 17 |80-032 Gdańsk 9;1501;638;638;23;615;42.50;3.61
102753;226101;Centrum Kształcenia Zawodowego i Ustawicznego Nr 2|Gdańsk, Orunia|ul. Smoleńska 5/7 |80-058 Gdańsk 9;1117;558;558;12;546;49.96;2.15
102754;226101;Centrum Kształcenia Zawodowego i Ustawicznego Nr 2|Gdańsk, Orunia|ul. Smoleńska 5/7 |80-058 Gdańsk 9;1235;567;567;16;551;45.91;2.82
102755;226101;Przedszkole Nr 24|Gdańsk, Orunia|Trakt Św. Wojciecha 320 |80-001 Gdańsk 9;832;408;408;17;391;49.04;4.17
102756;226101;Szkoła Podstawowa Nr 40|Gdańsk, Św.Wojciech|ul. Stroma 19 |80-012 Gdańsk 9;703;399;399;7;392;56.76;1.75
102757;226101;I Liceum Ogólnokształcące|Gdańsk, Śródmieście|ul. Wały Piastowskie 6 |80-855 Gdańsk 50;1408;758;758;14;744;53.84;1.85
102758;226101;Ogólnokształcąca Szkoła Muzyczna I i II Stopnia|Gdańsk, Śródmieście|ul. Gnilna 3 |80-847 Gdańsk 50;985;633;633;6;627;64.26;0.95
102759;226101;Nadbałtyckie Centrum Kultury|Gdańsk, Śródmieście|ul. Korzenna 33/35 |80-851 Gdańsk 50;1036;665;665;5;660;64.19;0.75
102760;226101;Zespół Szkół Łączności|Gdańsk, Śródmieście|ul. Podwale Staromiejskie 51/52 |80-845 Gdańsk 50;1494;836;836;12;824;55.96;1.44
102761;226101;Szkoła Podstawowa Nr 50|Gdańsk, Śródmieście|ul. Grobla IV 8 |80-837 Gdańsk 50;1302;777;777;6;771;59.68;0.77
102762;226101;Szkoła Podstawowa Nr 50|Gdańsk, Śródmieście|ul. Grobla IV 8 |80-837 Gdańsk 50;1301;816;816;8;808;62.72;0.98
102763;226101;Pałac Młodzieży|Gdańsk, Śródmieście|ul. Ogarna 56 |80-826 Gdańsk 50;1581;953;953;5;948;60.28;0.52
102764;226101;Gimnazjum Nr 8|Gdańsk, Śródmieście|ul. Żabi Kruk 5 |80-822 Gdańsk 50;1287;681;681;8;673;52.91;1.17
102765;226101;Bursa Gdańska|Gdańsk, Śródmieście|ul. Lastadia 41 |80-880 Gdańsk 50;970;573;573;6;567;59.07;1.05
102766;226101;Szkoła Podstawowa Nr 65|Gdańsk, Śródmieście|ul. Śluza 6 |80-770 Gdańsk 50;1403;714;714;9;705;50.89;1.26
102767;226101;Szkoła Podstawowa Nr 65|Gdańsk, Śródmieście|ul. Śluza 6 |80-770 Gdańsk 50;1730;766;766;19;747;44.28;2.48
102768;226101;Szkoła Podstawowa Nr 4|Gdańsk, Śródmieście|ul. Łąkowa 61 |80-769 Gdańsk 50;1690;771;771;11;760;45.62;1.43
102769;226101;Gdańska Szkoła Podstawowa "LINGWISTA"|Gdańsk, Śródmieście|ul. Św. Barbary 1 |80-753 Gdańsk 50;1572;833;833;15;818;52.99;1.80
102770;226101;Szkoły Ekonomiczno-Handlowe|Gdańsk, Śródmieście|ul. Seredyńskiego 1A |80-753 Gdańsk 50;1537;836;836;11;825;54.39;1.32
102771;226101;Zespół Szkół Ogólnokształcących Nr 6|Gdańsk, Śródmieście|ul. Głęboka 11 |80-759 Gdańsk 50;1254;735;735;12;723;58.61;1.63
102772;226101;Urząd Miejski w Gdańsku|Gdańsk, Śródmieście|ul. 3 Maja 9 |80-802 Gdańsk 50;843;388;388;6;382;46.03;1.55
102773;226101;Szkoła Podstawowa Nr 21|Gdańsk, Śródmieście|ul. Na Stoku 43 |80-811 Gdańsk 50;1797;856;856;18;838;47.63;2.10
102774;226101;Szkoła Podstawowa Nr 86|Gdańsk, Łostowice|ul. Wielkopolska 20 |80-180 Gdańsk 42;2262;1479;1479;7;1472;65.38;0.47
102775;226101;Szkoła Podstawowa Nr 86|Gdańsk, Łostowice|ul. Wielkopolska 20 |80-180 Gdańsk 42;1013;530;530;7;523;52.32;1.32
102776;226101;Szkoła Podstawowa Nr 12|Gdańsk, Łostowice|ul. Człuchowska 6 |80-180 Gdańsk 42;1709;1141;1141;8;1133;66.76;0.70
102777;226101;Szkoła Podstawowa Nr 12|Gdańsk, Łostowice|ul. Człuchowska 6 |80-180 Gdańsk 42;1656;1064;1064;7;1057;64.25;0.66
102778;226101;Szkoła Podstawowa Nr 12|Gdańsk, Łostowice|ul. Człuchowska 6 |80-180 Gdańsk 42;1876;1264;1264;6;1258;67.38;0.47
102779;226101;Szkoła Podstawowa Nr 12|Gdańsk, Łostowice|ul. Człuchowska 6 |80-180 Gdańsk 42;2207;1296;1296;8;1288;58.72;0.62
102780;226101;Spółdzielnia Mieszkaniowa "Ujeścisko"|Gdańsk, Łostowice|ul. Płocka 6 |80-180 Gdańsk 42;2406;1704;1704;23;1681;70.82;1.35
102781;226101;Przedszkole Niepubliczne SŁONECZNA KRAINA|Gdańsk, Łostowice|ul. Lubelska 3A |80-180 Gdańsk 42;916;528;528;6;522;57.64;1.14
102782;226101;Zespół Kształcenia Podstawowego i Gimnazjalnego Nr 2|Gdańsk, Jasień|ul. Stolema 59 |80-177 Gdańsk 16;2210;1513;1513;14;1499;68.46;0.93
102783;226101;Szkoła Podstawowa Nr 86|Gdańsk, Łostowice|ul. Wielkopolska 20 |80-180 Gdańsk 42;1673;909;909;7;902;54.33;0.77
102784;226101;Szkoła Podstawowa Nr 86|Gdańsk, Łostowice|ul. Wielkopolska 20 |80-180 Gdańsk 42;2002;1148;1148;7;1141;57.34;0.61
102785;226101;Szkoła Podstawowa Nr 86|Gdańsk, Łostowice|ul. Wielkopolska 20 |80-180 Gdańsk 42;1780;1213;1213;6;1207;68.15;0.49
102786;226101;Zespół Kształcenia Podstawowego i Gimnazjalnego Nr 6|Gdańsk, Chełm|ul. Hoene 6 |80-041 Gdańsk 7;2005;1341;1341;12;1329;66.88;0.89
102787;226101;Zespół Kształcenia Podstawowego i Gimnazjalnego Nr 6|Gdańsk, Chełm|ul. Hoene 6 |80-041 Gdańsk 7;1977;1365;1365;9;1356;69.04;0.66
102788;226101;Zespół Kształcenia Podstawowego i Gimnazjalnego Nr 6|Gdańsk, Chełm|ul. Hoene 6 |80-041 Gdańsk 7;2143;1484;1484;7;1477;69.25;0.47
102789;226101;Zespół Kształcenia Podstawowego i Gimnazjalnego Nr 6|Gdańsk, Chełm|ul. Hoene 6 |80-041 Gdańsk 7;1974;1383;1383;10;1373;70.06;0.72
102790;226101;Zespół Kształcenia Podstawowego i Gimnazjalnego Nr 6|Gdańsk, Chełm|ul. Hoene 6 |80-041 Gdańsk 7;1786;1246;1246;13;1233;69.76;1.04
102791;226101;Morskie Przedszkole Niepubliczne|Gdańsk, Chełm|ul. Rogalińska 17 |80-809 Gdańsk 20;1909;1341;1341;13;1328;70.25;0.97
102792;226101;Morskie Przedszkole Niepubliczne|Gdańsk, Chełm|ul. Rogalińska 17 |80-809 Gdańsk 20;2131;1252;1252;15;1237;58.75;1.20
102793;226101;Szkoła Podstawowa Nr 47|Gdańsk, Chełm|ul. Reformacka 18 |80-808 Gdańsk 20;1559;872;872;12;860;55.93;1.38
102794;226101;Szkoła Podstawowa Nr 47|Gdańsk, Chełm|ul. Reformacka 18 |80-808 Gdańsk 20;1545;928;928;14;914;60.06;1.51
102795;226101;Przedszkole Niepubliczne "RADOSNY ZAKĄTEK"|Gdańsk, Chełm|ul. Chałubińskiego 18 |80-807 Gdańsk 20;1780;1167;1167;18;1149;65.56;1.54
102796;226101;Zespół Szkół Ogólnokształcących Nr 7|Gdańsk, Chełm|ul. Chałubińskiego 13 |80-807 Gdańsk 20;1736;1074;1074;16;1058;61.87;1.49
102797;226101;Zespół Szkół Ogólnokształcących Nr 7|Gdańsk, Chełm|ul. Chałubińskiego 13 |80-807 Gdańsk 20;2034;1371;1371;16;1355;67.40;1.17
102798;226101;Zespół Szkół Ogólnokształcących Nr 7|Gdańsk, Chełm|ul. Chałubińskiego 13 |80-807 Gdańsk 20;1583;1146;1146;7;1139;72.39;0.61
102799;226101;Szkoła Podstawowa Nr 8|Gdańsk, Chełm|ul. Dragana 22 |80-807 Gdańsk 20;2297;1429;1429;16;1413;62.21;1.12
102800;226101;Szkoła Podstawowa Nr 8|Gdańsk, Chełm|ul. Dragana 22 |80-807 Gdańsk 20;2131;1420;1420;13;1407;66.64;0.92
102801;226101;Szkoła Podstawowa Nr 8|Gdańsk, Chełm|ul. Dragana 2 |80-807 Gdańsk 20;2340;1539;1539;26;1513;65.77;1.69
102802;226101;Szkoła Podstawowa Nr 8|Gdańsk, Chełm|ul. Dragana 2 |80-807 Gdańsk 20;2207;1428;1428;13;1415;64.70;0.91
102803;226101;Zespół Kształcenia Podstawowego i Gimnazjalnego Nr 2|Gdańsk, Jasień|ul. Stolema 59 |80-177 Gdańsk 16;1765;1222;1222;6;1216;69.24;0.49
102804;226101;Szkoła Podstawowa Nr 85|Gdańsk, Jasień|ul. Stolema 59 |80-177 Gdańsk 16;2403;1392;1392;13;1379;57.93;0.93
102805;226101;Szkoła Podstawowa Nr 85|Gdańsk, Jasień|ul. Stolema 59 |80-177 Gdańsk 16;1941;1371;1371;19;1352;70.63;1.39
102806;226101;Szkoła Podstawowa Nr 85|Gdańsk, Jasień|ul. Stolema 59 |80-177 Gdańsk 16;1978;1340;1340;17;1323;67.75;1.27
102807;226101;Zespół Kształcenia Podstawowego i Gimnazjalnego Nr 2|Gdańsk, Jasień|ul. Stolema 59 |80-177 Gdańsk 16;1718;1048;1048;5;1043;61.00;0.48
102808;226101;Szkoła Podstawowa Nr 8|Gdańsk, Chełm|ul. Dragana 2 |80-807 Gdańsk 20;2104;1540;1540;10;1530;73.19;0.65
102809;226101;Szkolne Schronisko Młodzieżowe Filia|Gdańsk, Siedlce|ul. Kartuska 245B |80-122 Gdańsk 18;1959;1141;1141;9;1132;58.24;0.79
102810;226101;Szkoła Podstawowa Nr 14|Gdańsk, Siedlce|ul. Kartuska 126A |80-104 Gdańsk 18;1298;687;687;8;679;52.93;1.16
102811;226101;Szkoła Podstawowa Nr 14|Gdańsk, Siedlce|ul. Kartuska 126A |80-104 Gdańsk 18;1596;965;965;15;950;60.46;1.55
102812;226101;Szkoła Podstawowa Nr 58|Gdańsk, Siedlce|ul. Skarpowa 3 |80-145 Gdańsk 48;2037;1232;1232;19;1213;60.48;1.54
102813;226101;Szkoła Podstawowa Nr 58|Gdańsk, Siedlce|ul. Skarpowa 3 |80-145 Gdańsk 48;1833;1033;1033;10;1023;56.36;0.97
102814;226101;Gimnazjum Nr 2|Gdańsk, Siedlce|ul. Kartuska 32/34 |80-104 Gdańsk 18;1792;1086;1086;9;1077;60.60;0.83
102815;226101;Scena Muzyczna Gdański Archipelag Kultury|Gdańsk, Siedlce|ul.Powstańców Warszawskich 25 |80-152 Gdańsk 18;848;460;460;4;456;54.25;0.87
102816;226101;Gdański Zarząd Nieruchomości Komunalnych|Gdańsk, Suchanino|ul. Cygańska Góra 1 |80-171 Gdańsk 48;1418;910;910;21;889;64.17;2.31
102817;226101;Gimnazjum Nr 29|Gdańsk, Suchanino|ul. Beethovena 20 |80-171 Gdańsk 48;1476;948;948;7;941;64.23;0.74
102818;226101;Gimnazjum Nr 29|Gdańsk, Suchanino|ul. Beethovena 20 |80-171 Gdańsk 48;1386;897;897;10;887;64.72;1.11
102819;226101;Szkoła Podstawowa Nr 42|Gdańsk, Suchanino|ul. Czajkowskiego 1 |80-169 Gdańsk 48;1701;1054;1054;21;1033;61.96;1.99
102820;226101;Szkoła Podstawowa Nr 42|Gdańsk, Suchanino|ul. Czajkowskiego 1 |80-169 Gdańsk 48;1529;965;965;11;954;63.11;1.14
102821;226101;Szkoła Podstawowa Nr 42|Gdańsk, Suchanino|ul. Czajkowskiego 1 |80-169 Gdańsk 48;1550;995;995;9;986;64.19;0.90
102822;226101;Zespół Kształcenia Podstawowego i Gimnazjalnego Nr 20|Gdańsk, Piecki-Migowo|ul. Gojawiczyńskiej 10 |80-286 Gdańsk 44;1832;1248;1248;6;1242;68.12;0.48
102823;226101;Zespół Kształcenia Podstawowego i Gimnazjalnego Nr 20|Gdańsk, Piecki-Migowo|ul. Gojawiczyńskiej 10 |80-286 Gdańsk 44;1292;863;863;6;857;66.80;0.70
102824;226101;Zespół Kształcenia Podstawowego i Gimnazjalnego Nr 20|Gdańsk, Piecki-Migowo|ul. Gojawiczyńskiej 10 |80-286 Gdańsk 44;1689;1158;1158;8;1150;68.56;0.69
102825;226101;XX Liceum Ogólnokształcące|Gdańsk, Piecki-Migowo|ul. Dobrowolskiego 6 |80-286 Gdańsk 44;2073;1355;1355;12;1343;65.36;0.89
102826;226101;Zespół Kształcenia Podstawowego i Gimnazjalnego Nr 21|Gdańsk, Piecki-Migowo|ul. Marusarzówny 10 |80-288 Gdańsk 44;2134;1558;1558;9;1549;73.01;0.58
102827;226101;Zespół Kształcenia Podstawowego i Gimnazjalnego Nr 21|Gdańsk, Piecki-Migowo|ul. Marusarzówny 10 |80-288 Gdańsk 44;2268;1550;1550;14;1536;68.34;0.90
102828;226101;Zespół Kształcenia Podstawowego i Gimnazjalnego Nr 21|Gdańsk, Piecki-Migowo|ul. Marusarzówny 10 |80-288 Gdańsk 44;2272;1537;1537;15;1522;67.65;0.98
102829;226101;Zespół Kształcenia Podstawowego i Gimnazjalnego Nr 21|Gdańsk, Piecki-Migowo|ul. Marusarzówny 10 |80-288 Gdańsk 44;2486;1645;1645;13;1632;66.17;0.79
102830;226101;Zespół Kształcenia Podstawowego i Gimnazjalnego Nr 21|Gdańsk, Piecki-Migowo|ul. Marusarzówny 10 |80-288 Gdańsk 44;2396;1643;1643;14;1629;68.57;0.85
102831;226101;Niepubliczny Zakład Opieki Zdrowotnej "PRZYCHODNIA MORENA" Sp. z o.o.|Gdańsk, Piecki-Migowo|ul. Jaśkowa Dolina 105 |80-286 Gdańsk 44;1935;1339;1339;19;1320;69.20;1.42
102832;226101;Scena Muzyczna Gdański Archipelag Kultury|Gdańsk, Siedlce|ul. Powstańców Warszawskich 25 |80-152 Gdańsk 18;1925;1340;1340;9;1331;69.61;0.67
102833;226101;Szkoła Podstawowa Nr 15|Gdańsk, Aniołki|ul. Smoluchowskiego 13 |80-214 Gdańsk 6;981;531;531;7;524;54.13;1.32
102834;226101;Szkoła Podstawowa Nr 15|Gdańsk, Aniołki|ul. Smoluchowskiego 13 |80-214 Gdańsk 6;992;529;529;3;526;53.33;0.57
102835;226101;Szkoła Podstawowa Nr 69|Gdańsk, Młyniska|ul. Zielony Trójkąt 1 |80-869 Gdańsk 50;1594;952;953;18;934;59.72;1.89
102836;226101;Szkoła Podstawowa Nr 69|Gdańsk, Młyniska|ul. Zielony Trójkąt 1 |80-869 Gdańsk 50;967;487;487;14;473;50.36;2.87
102837;226101;Zespół Kształcenia Podstawowego i Gimnazjalnego Nr 24|Gdańsk, Brętowo|ul. Leśna Góra 2 |80-281 Gdańsk 44;2348;1595;1595;12;1583;67.93;0.75
102838;226101;Zespół Kształcenia Podstawowego i Gimnazjalnego Nr 24|Gdańsk, Brętowo|ul. Leśna Góra 2 |80-281 Gdańsk 44;2240;1412;1412;15;1397;63.04;1.06
102839;226101;Szkoły im. Św. Jana de La Salle|Gdańsk, Brętowo|ul. Słowackiego 101 |80-281 Gdańsk 44;1567;1043;1043;4;1039;66.56;0.38
102840;226101;Szkoła Podstawowa Nr 27|Gdańsk, Wrzeszcz Górny|ul. Srebrniki 10 |80-282 Gdańsk 6;1871;1226;1226;9;1217;65.53;0.73
102841;226101;Szkoła Podstawowa Nr 39|Gdańsk, Wrzeszcz Górny|ul. Obywatelska 1 |80-259 Gdańsk 6;2258;1268;1268;13;1255;56.16;1.03
102842;226101;Szkoła Podstawowa Nr 39|Gdańsk, Wrzeszcz Górny|ul. Obywatelska 1 |80-259 Gdańsk 6;2032;1239;1239;20;1219;60.97;1.61
102843;226101;III Liceum Ogólnokształcące|Gdańsk, Wrzeszcz Górny|ul. Topolowa 7 |80-255 Gdańsk 6;1591;1074;1074;7;1067;67.50;0.65
102844;226101;Szkoła Podstawowa Nr 45|Gdańsk, Wrzeszcz Górny|ul. Matki Polki 3A |80-251 Gdańsk 6;2020;1166;1166;9;1157;57.72;0.77
102845;226101;Zarząd Dróg i Zieleni|Gdańsk, Wrzeszcz Górny|ul. Partyzantów 36 |80-254 Gdańsk 6;1435;808;808;10;798;56.31;1.24
102846;226101;Zakład Komunikacji Miejskiej Sp. z o.o.|Gdańsk, Wrzeszcz Górny|ul. Jaśkowa Dolina 2 |80-252 Gdańsk 6;1653;971;971;7;964;58.74;0.72
102847;226101;Polska Akademia Nauk Oddział w Gdańsku|Gdańsk, Wrzeszcz Górny|ul. Jaśkowa Dolina 31 |80-286 Gdańsk 6;1698;1076;1076;9;1067;63.37;0.84
102848;226101;Gimnazjum Nr 26|Gdańsk, Wrzeszcz Górny|ul. Traugutta 92 |80-226 Gdańsk 6;1311;745;745;15;730;56.83;2.01
102849;226101;Pomorskie Szkoły Rzemiosł|Gdańsk, Wrzeszcz Górny|ul. Sobieskiego 90 |80-216 Gdańsk 6;797;523;523;5;518;65.62;0.96
102850;226101;Szkoły Okrętowe i Ogólnokształcące "CONRADINUM"|Gdańsk, Wrzeszcz Górny|ul. Piramowicza 1/2 |80-218 Gdańsk 6;1205;689;689;6;683;57.18;0.87
102851;226101;Szkoła Podstawowa Nr 17|Gdańsk, Wrzeszcz Górny|ul. Czarnieckiego 2 |80-239 Gdańsk 6;1581;946;946;9;937;59.84;0.95
102852;226101;Centrum Kształcenia Zawodowego i Ustawicznego Nr 1|Gdańsk, Wrzeszcz Dolny|al. Hallera 16/18 |80-426 Gdańsk 6;1144;663;663;7;656;57.95;1.06
102853;226101;Centrum Kształcenia Zawodowego i Ustawicznego Nr 1|Gdańsk, Wrzeszcz Dolny|al. Hallera 16/18 |80-426 Gdańsk 6;1258;741;741;8;733;58.90;1.08
102854;226101;WINDA - Gdański Archipelag Kultury|Gdańsk, Wrzeszcz Dolny|ul. Racławicka 17 |80-406 Gdańsk 6;1542;901;901;20;881;58.43;2.22
102855;226101;Szkoła Podstawowa Nr 52|Gdańsk, Wrzeszcz Dolny|ul. Kościuszki 111 |80-427 Gdańsk 6;1960;1193;1193;14;1179;60.87;1.17
102856;226101;Szkoła Podstawowa Nr 52|Gdańsk, Wrzeszcz Dolny|ul. Kościuszki 111 |80-427 Gdańsk 6;2001;1180;1180;19;1161;58.97;1.61
102857;226101;Gimnazjum Nr 12|Gdańsk, Wrzeszcz Dolny|ul. Wrzeszczańska 29 |80-409 Gdańsk 6;1850;1110;1110;18;1092;60.00;1.62
102858;226101;Szkoła Podstawowa Nr 24|Gdańsk, Wrzeszcz Dolny|ul. Lilli Wenedy 19 |80-419 Gdańsk 6;1656;1007;1007;11;996;60.81;1.09
102859;226101;Ogólnokształcąca Szkoła Baletowa|Gdańsk, Wrzeszcz Dolny|al. Legionów 3 |80-441 Gdańsk 6;1704;1011;1011;6;1005;59.33;0.59
102860;226101;Zespół Szkół Gastronomiczno-Hotelarskich|Gdańsk, Wrzeszcz Dolny|al. Legionów 7 |80-441 Gdańsk 6;1776;921;921;22;899;51.86;2.39
102861;226101;Szkoła Podstawowa Nr 49|Gdańsk, Wrzeszcz Dolny|al. Legionów 11 |80-441 Gdańsk 6;1767;1069;1069;9;1060;60.50;0.84
102862;226101;XIX Liceum Ogólnokształcące|Gdańsk, Wrzeszcz Dolny|ul. Pestalozziego 11/13 |80-445 Gdańsk 6;1672;967;967;13;954;57.83;1.34
102863;226101;II Liceum Ogólnokształcące|Gdańsk, Wrzeszcz Dolny|ul. Pestalozziego 7/9 |80-445 Gdańsk 6;1605;874;874;12;862;54.45;1.37
102864;226101;Zespół Szkół Ogólnokształcących Nr 1|Gdańsk, Strzyża|ul. Wilka-Krzyżanowskiego 8 |80-271 Gdańsk 6;1116;783;783;13;770;70.16;1.66
102865;226101;Rada Dzielnicy Strzyża|Gdańsk, Strzyża|ul. Sychty 12/14 |80-276 Gdańsk 6;1347;928;928;7;921;68.89;0.75
102866;226101;Państwowe Szkoły Budownictwa|Gdańsk, Strzyża|al. Grunwaldzka 238 |80-266 Gdańsk 6;1188;793;793;6;787;66.75;0.76
102867;226101;Zespół Szkół Ogólnokształcących Nr 1|Gdańsk, Strzyża|ul. Wilka-Krzyżanowskiego 6 |80-271 Gdańsk 6;987;620;620;8;612;62.82;1.29
102868;226101;Zespół Kształcenia Podstawowego i Gimnazjalnego Nr 12|Gdańsk, Zaspa Rozstaje|ul. Burzyńskiego 10 |80-462 Gdańsk 22;2208;1522;1522;12;1510;68.93;0.79
102869;226101;Zespół Kształcenia Podstawowego i Gimnazjalnego Nr 12|Gdańsk, Zaspa Rozstaje|ul. Burzyńskiego 10 |80-462 Gdańsk 22;1927;1328;1328;16;1312;68.92;1.20
102870;226101;Niepubliczna Szkoła Podstawowa NASZA SZKOŁA z Przedszkolem|Gdańsk, Zaspa Rozstaje|ul. Ciołkowskiego 10 |80-463 Gdańsk 22;2023;1344;1344;9;1335;66.44;0.67
102871;226101;Zespół Szkół Ogólnokształcących Nr 8|Gdańsk, Zaspa Rozstaje|ul. Meissnera 9 |80-462 Gdańsk 22;1965;1289;1289;10;1279;65.60;0.78
102872;226101;Zespół Szkół Ogólnokształcących Nr 8|Gdańsk, Zaspa Rozstaje|ul. Meissnera 9 |80-462 Gdańsk 22;1284;937;937;5;932;72.98;0.53
102873;226101;Klub "Szafir"|Gdańsk, Zaspa Rozstaje|ul. Kombatantów 4 |80-464 Gdańsk 22;1400;935;935;12;923;66.79;1.28
102874;226101;XV Liceum Ogólnokształcące|Gdańsk, Zaspa Młyniec|ul. Pilotów 7 |80-460 Gdańsk 22;1740;1144;1144;7;1137;65.75;0.61
102875;226101;XV Liceum Ogólnokształcące|Gdańsk, Zaspa Młyniec|ul. Pilotów 7 |80-460 Gdańsk 22;2016;1348;1348;15;1333;66.87;1.11
102876;226101;Zespół Kształcenia Podstawowego i Gimnazjalnego Nr 13|Gdańsk, Zaspa Młyniec|ul. Startowa 9 |80-461 Gdańsk 22;1761;1163;1163;16;1147;66.04;1.38
102877;226101;Zespół Kształcenia Podstawowego i Gimnazjalnego Nr 13|Gdańsk, Zaspa Młyniec|ul. Startowa 9 |80-461 Gdańsk 22;1513;1050;1050;10;1040;69.40;0.95
102878;226101;Przedszkole Nr 86|Gdańsk, Zaspa Młyniec|ul. Dywizjonu 303 nr 27 |80-462 Gdańsk 22;2149;1493;1493;13;1480;69.47;0.87
102879;226101;Przedszkole Nr 86|Gdańsk, Zaspa Młyniec|ul. Dywizjonu 303 nr 27 |80-462 Gdańsk 22;2176;1522;1522;15;1507;69.94;0.99
102880;226101;Szkoła Podstawowa Nr 80|Gdańsk, Przymorze Wielkie|ul. Opolska 9 |80-395 Gdańsk 53;1865;1120;1120;13;1107;60.05;1.16
102881;226101;Szkoła Podstawowa Nr 80|Gdańsk, Przymorze Wielkie|ul. Opolska 9 |80-395 Gdańsk 53;1872;1088;1088;6;1082;58.12;0.55
102882;226101;Szkoła Podstawowa Nr 79|Gdańsk, Przymorze Wielkie|ul. Kołobrzeska 49 |80-391 Gdańsk 53;1772;1203;1203;11;1192;67.89;0.91
102883;226101;Szkoła Podstawowa Nr 79|Gdańsk, Przymorze Wielkie|ul. Kołobrzeska 49 |80-391 Gdańsk 53;1933;1093;1093;15;1078;56.54;1.37
102884;226101;Zespół Kształcenia Podstawowego i Gimnazjalnego Nr 33|Gdańsk, Przymorze Wielkie|ul. Kołobrzeska 75 |80-396 Gdańsk 53;2232;1315;1315;9;1306;58.92;0.68
102885;226101;Zespół Kształcenia Podstawowego i Gimnazjalnego Nr 33|Gdańsk, Przymorze Wielkie|ul. Kołobrzeska 75 |80-396 Gdańsk 53;1724;1000;1000;12;988;58.00;1.20
102886;226101;Ogólnokształcące Szkoły Sportowe|Gdańsk, Przymorze Wielkie|ul. Kołobrzeska 77 |80-396 Gdańsk 53;2244;1433;1433;14;1419;63.86;0.98
102887;226101;Zespół Szkół Zawodowych Nr 9|Gdańsk, Przymorze Wielkie|ul. Dąbrowszczaków 35 |80-365 Gdańsk 53;1845;1207;1207;5;1202;65.42;0.41
102888;226101;Szkoła Podstawowa Nr 44|Gdańsk, Przymorze Wielkie|ul. Jagiellońska 24 |80-366 Gdańsk 53;1490;961;962;7;954;64.50;0.73
102889;226101;Gimnazjum Nr 19|Gdańsk, Przymorze Wielkie|ul. Jagiellońska 5 |80-371 Gdańsk 53;2094;1293;1293;6;1287;61.75;0.46
102890;226101;Gimnazjum Nr 19|Gdańsk, Przymorze Wielkie|ul. Jagiellońska 5 |80-371 Gdańsk 53;2007;1216;1216;17;1199;60.59;1.40
102891;226101;Szkoła Podstawowa Nr 76|Gdańsk, Przymorze Wielkie|ul. Jagiellońska 14 |80-371 Gdańsk 53;1963;1222;1222;4;1218;62.25;0.33
102892;226101;Szkoła Podstawowa Nr 76|Gdańsk, Przymorze Wielkie|ul. Jagiellońska 14 |80-371 Gdańsk 53;1691;1007;1007;15;992;59.55;1.49
102893;226101;Wojewódzka i Miejska Biblioteka Publiczna Ośrodek Czytelnictwa Chorych i Niepełnosprawnych|Gdańsk, Przymorze Małe|ul. Czerwony Dwór 21 |80-376 Gdańsk 53;1909;1164;1164;20;1144;60.97;1.72
102894;226101;Wojewódzka i Miejska Biblioteka Publiczna Filia Nr 11|Gdańsk, Przymorze Małe|ul. Czerwony Dwór 21 |80-376 Gdańsk 53;2379;1572;1572;17;1555;66.08;1.08
102895;226101;Gimnazjum Nr 20|Gdańsk, Przymorze Małe|ul. Zgody II 6 |80-380 Gdańsk 53;2456;1693;1693;13;1680;68.93;0.77
102896;226101;Gimnazjum Nr 20|Gdańsk, Przymorze Małe|ul. Zgody II 6 |80-380 Gdańsk 53;2385;1597;1597;14;1583;66.96;0.88
102897;226101;Osiedlowy Dom Kultury PSM "Kolejarz"|Gdańsk, Przymorze Małe|ul. Kołobrzeska 25E |80-390 Gdańsk 53;1570;991;991;10;981;63.12;1.01
102898;226101;Szkoła Podstawowa Nr 46|Gdańsk, Przymorze Małe|ul. Arkońska 17 |80-387 Gdańsk 53;1978;1269;1269;9;1260;64.16;0.71
102899;226101;Szkoła Podstawowa Nr 82|Gdańsk, Matarnia|ul. Radarowa 26 |80-298 Gdańsk 16;2415;1552;1552;13;1539;64.27;0.84
102900;226101;Zespół Kształcenia Podstawowego i Gimnazjalnego Nr 23|Gdańsk, Matarnia|ul. Słabego 6 |80-298 Gdańsk 16;2347;1464;1464;19;1445;62.38;1.30
102901;226101;Szkoła Podstawowa Nr 83|Gdańsk, Kokoszki|ul. Stokłosy 1 |80-298 Gdańsk 16;1967;1199;1199;36;1163;60.96;3.00
102902;226101;Szkoła Podstawowa Nr 83|Gdańsk, Kokoszki|ul. Stokłosy 1 |80-298 Gdańsk 16;1940;1190;1190;12;1178;61.34;1.01
102903;226101;Szkoła Podstawowa Nr 84|Gdańsk, Kokoszki|ul. Otomińska 72 |80-178 Gdańsk 16;1260;901;901;20;881;71.51;2.22
102904;226101;Szkoła Podstawowa Nr 84|Gdańsk, Kokoszki|ul. Otomińska 72 |80-178 Gdańsk 16;1318;976;976;16;960;74.05;1.64
102905;226101;Szkoła Podstawowa Nr 60|Gdańsk, Jelitkowo-Tysiąclecia|ul. Chłopska 64 |80-350 Gdańsk 5;1915;1199;1199;14;1185;62.61;1.17
102906;226101;Szkoła Podstawowa Nr 60|Gdańsk, Jelitkowo-Tysiąclecia|ul. Chłopska 64 |80-350 Gdańsk 5;1939;1056;1056;7;1049;54.46;0.66
102907;226101;Zespół Kształcenia Podstawowego i Gimnazjalnego Nr 7|Gdańsk, Wejhera|ul. Orłowska 13 |80-347 Gdańsk 5;1877;1201;1201;6;1195;63.99;0.50
102908;226101;Zespół Kształcenia Podstawowego i Gimnazjalnego Nr 7|Gdańsk, Wejhera|ul. Orłowska 13 |80-347 Gdańsk 5;1647;949;949;14;935;57.62;1.48
102909;226101;Zespół Szkół Sportowych i Ogólnokształcących|Gdańsk, Żabianka|ul. Subisława 22 |80-354 Gdańsk 5;1918;1285;1285;9;1276;67.00;0.70
102910;226101;Zespół Szkół Sportowych i Ogólnokształcących|Gdańsk, Żabianka|ul. Subisława 22 |80-354 Gdańsk 5;1887;1228;1228;17;1211;65.08;1.38
102911;226101;Zespół Kształcenia Podstawowego i Gimnazjalnego Nr 8|Gdańsk, Żabianka|ul. Szyprów 3 |80-335 Gdańsk 5;1961;1320;1320;8;1312;67.31;0.61
102912;226101;Zespół Kształcenia Podstawowego i Gimnazjalnego Nr 8|Gdańsk, Żabianka|ul. Szyprów 3 |80-335 Gdańsk 5;1851;1222;1222;5;1217;66.02;0.41
102913;226101;Zespół Szkół Architektury Krajobrazu i Handlowo-Usługowych|Gdańsk, Oliwa|ul. Czyżewskiego 31 |80-336 Gdańsk 5;1655;1015;1015;12;1003;61.33;1.18
102914;226101;RSM "BUDOWLANI" Klub Osiedlowy AD-REM|Gdańsk, Oliwa|ul. Czyżewskiego 12 |80-336 Gdańsk 5;1808;1138;1138;6;1132;62.94;0.53
102915;226101;Akademia Wychowania Fizycznego i Sportu|Gdańsk, Oliwa|ul. Czyżewskiego 30A |80-336 Gdańsk 5;1945;1103;1103;12;1091;56.71;1.09
102916;226101;Szkoła Podstawowa Nr 23|Gdańsk, Oliwa|ul. Opacka 7 |80-330 Gdańsk 5;1645;918;918;22;896;55.81;2.40
102917;226101;Szkoła Podstawowa dla Chłopców Fregata|Gdańsk, Oliwa|ul. Cystersów 13 |80-330 Gdańsk 5;1471;831;831;14;817;56.49;1.68
102918;226101;V Liceum Ogólnokształcące|Gdańsk, Oliwa|ul. Polanki 130 |80-322 Gdańsk 5;1521;942;942;9;933;61.93;0.96
102919;226101;Zespół Kształcenia Podstawowego i Gimnazjalnego Nr 17 z klasami sportowymi|Gdańsk, Oliwa|ul. Wąsowicza 30 |80-318 Gdańsk 5;1819;1139;1139;12;1127;62.62;1.05
102920;226101;Zespół Szkół Specjalnych Nr 2|Gdańsk, Oliwa|ul. Wita Stwosza 23 |80-312 Gdańsk 5;1266;806;806;7;799;63.67;0.87
102921;226101;Wydział Prawa i Administracji Uniwersytet Gdański|Gdańsk, Oliwa|ul. Bażyńskiego 6 |80-309 Gdańsk 5;603;406;406;2;404;67.33;0.49
102922;226101;Zespół Kształcenia Podstawowego i Gimnazjalnego Nr 26 z Klasami Sportowymi|Gdańsk, VII Dwór|ul. VII Dwór 6 |80-301 Gdańsk 5;1480;989;989;11;978;66.82;1.11
102923;226101;Zespół Kształcenia Podstawowego i Gimnazjalnego Nr 26 z Klasami Sportowymi|Gdańsk, VII Dwór|ul. VII Dwór 6 |80-301 Gdańsk 5;1658;1124;1124;9;1115;67.79;0.80
102924;226101;Szkoła Podstawowa Nr 81|Gdańsk, Osowa|ul. Siedleckiego 14 |80-299 Gdańsk 24;2256;1647;1647;6;1641;73.01;0.36
102925;226101;Szkoła Podstawowa Nr 81|Gdańsk, Osowa|ul. Siedleckiego 14 |80-299 Gdańsk 24;2120;1451;1452;12;1439;68.44;0.83
102926;226101;Szkoła Podstawowa Nr 81|Gdańsk, Osowa|ul. Siedleckiego 14 |80-299 Gdańsk 24;2384;1729;1733;16;1713;72.53;0.93
102927;226101;Zespół Szkół Ogólnokształcących Nr 2|Gdańsk, Osowa|ul. Wodnika 57 |80-299 Gdańsk 24;2134;1582;1582;17;1565;74.13;1.07
102928;226101;Zespół Szkół Ogólnokształcących Nr 2|Gdańsk, Osowa|ul. Wodnika 57 |80-299 Gdańsk 24;2209;1570;1570;10;1560;71.07;0.64
102929;226101;Dom Pomocy Społecznej "Ostoja"|Gdańsk, Stogi|ul. Hoża 4 |80-628 Gdańsk 8;35;21;21;2;19;60.00;9.52
102930;226101;Zakład Karny|Gdańsk, Przeróbka|ul. Siennicka 23 |80-705 Gdańsk 50;601;253;253;31;222;42.10;12.25
102931;226101;Areszt Śledczy|Gdańsk, Śródmieście|ul. Kurkowa 12 |80-803 Gdańsk 50;816;475;475;73;402;58.21;15.37
102932;226101;COPERNICUS PL Sp. z o.o. Szpital im. Mikołaja Kopernika|Gdańsk, Śródmieście|ul. Nowe Ogrody 1/6 |80-803 Gdańsk 50;300;33;33;1;32;11.00;3.03
102933;226101;SPZOZ Ministerstwa Spraw Wewnętrznych w Gdańsku, NZOZ Pomorskie Centrum Toksykologii|Gdańsk, Siedlce|ul. Kartuska 4/6 |80-104 Gdańsk 18;30;26;26;2;24;86.67;7.69
102934;226101;COPERNICUS PL Sp. z o.o. Szpital im. Mikołaja Kopernika|Gdańsk, Siedlce|ul. Powstańców Warszawskich 1/2 |80-152 Gdańsk 18;54;20;20;2;18;37.04;10.00
102935;226101;Uniwersyteckie Centrum Kliniczne|Gdańsk, Aniołki|ul. Smoluchowskiego 17 |80-211 Gdańsk 6;450;86;86;5;81;19.11;5.81
102936;226101;Pomorskie Centrum Chorób Zakaźnych i Gruźlicy Sp. z o.o.|Gdańsk, Aniołki|ul. Smoluchowskiego 18 |80-214 Gdańsk 6;132;50;50;0;50;37.88;0.00
102937;226101;Wojewódzki Szpital Psychiatryczny im. prof. Tadeusza Bilikiewicza|Gdańsk, Wrzeszcz Górny|ul. Srebrniki 17 |80-282 Gdańsk 6;301;120;120;2;118;39.87;1.67
102938;226101;Uniwersyteckie Centrum Kliniczne|Gdańsk, Wrzeszcz Górny|al. Zwycięstwa 30 |80-219 Gdańsk 6;67;34;34;3;31;50.75;8.82
102939;226101;Uniwersyteckie Centrum Kliniczne|Gdańsk, Wrzeszcz Dolny|ul. Kliniczna 1A |80-402 Gdańsk 6;106;55;55;0;55;51.89;0.00
102940;226101;COPERNICUS PL Sp. z o.o. Szpital Św. Wojciecha|Gdańsk, Zaspa Rozstaje|al. Jana Pawła II 50 |80-462 Gdańsk 22;394;108;108;2;106;27.41;1.85
102941;226101;Stowarzyszenie Domu Opieki "Złota Jesień"|Gdańsk, Zaspa Młyniec|ul. Hynka 12 |80-465 Gdańsk 22;80;45;45;5;40;56.25;11.11
102942;226101;Centrum Pomocowe Caritas im. Jana Pawła II|Gdańsk, Przymorze Małe|ul. Fromborska 24 |80-389 Gdańsk 53;70;41;41;3;38;58.57;7.32
102943;226101;Stowarzyszenie MONAR Ośrodek Leczenia, Terapii i Rehabilitacji Uzależnień dla Dzieci i Młodzieży w Gdańsku|Gdańsk, Matarnia|ul. Agrarna 2 |80-298 Gdańsk 16;16;16;16;2;14;100.00;12.50
102944;226101;Dom Pomocy Społecznej|Gdańsk, Oliwa|ul. Polanki 121 |80-308 Gdańsk 5;96;38;38;1;37;39.58;2.63
102945;226101;7 Szpital Marynarki Wojennej z Przychodnią SP ZOZ|Gdańsk, VII Dwór|ul. Polanki 117 |80-308 Gdańsk 5;119;60;60;1;59;50.42;1.67
102946;226101;Dom Studencki Nr 3|Gdańsk, Wrzeszcz Górny|ul. Do Studzienki 32 |80-227 Gdańsk 6;318;290;290;4;286;91.19;1.38
102947;226101;Dom Studencki Nr 8|Gdańsk, Wrzeszcz Dolny|ul. Wyspiańskiego 5A |80-434 Gdańsk 6;345;331;331;3;328;95.94;0.91
102948;226201;Zespół Szkół Ekologicznych|Gdynia|ul. Chylońska 237 |81-007 Gdynia;1643;993;993;20;973;60.44;2.01
102949;226201;Zespół Szkół nr 9|Gdynia|ul. Chylońska 227 |81-007 Gdynia;1610;1053;1053;20;1033;65.40;1.90
102950;226201;Zespół Szkół Ekologicznych|Gdynia|Chylońska 237 |81-007 Gdynia;1596;987;987;13;974;61.84;1.32
102951;226201;Zespół Szkół nr 9|Gdynia|ul. Chylońska 227 |81-007 Gdynia;1430;750;750;12;738;52.45;1.60
102952;226201;Gimnazjum nr 3|Gdynia|ul. Gospodarska 1 |81-068 Gdynia;1907;1102;1102;20;1082;57.79;1.81
102953;226201;Przedszkole nr 32|Gdynia|ul. Kcyńska 6 |81-005 Gdynia;1957;1190;1190;24;1166;60.81;2.02
102954;226201;Szkoła Podstawowa nr 16|Gdynia|ul. Chabrowa 43 |81-079 Gdynia;2293;1435;1465;30;1405;62.58;2.09
102955;226201;Szkoła Podstawowa nr 16|Gdynia|ul. Chabrowa 43 |81-079 Gdynia;1543;996;996;27;969;64.55;2.71
102956;226201;Przedszkole nr 46|Gdynia|ul. Pusta 9 |81-078 Gdynia;1683;1046;1046;8;1038;62.15;0.76
102957;226201;Przedszkole nr 21|Gdynia|ul. Demptowska 46 |81-094 Gdynia;1247;748;748;10;738;59.98;1.34
102958;226201;Kolegium Miejskie - Centrum Kształcenia Ustawicznego|Gdynia|ul. Raduńska 21 |81-057 Gdynia;1794;1035;1035;10;1025;57.69;0.97
102959;226201;Szkoła Podstawowa nr 40|Gdynia|ul. Rozewska 33 |81-055 Gdynia;2007;1147;1147;16;1131;57.15;1.39
102960;226201;Szkoła Podstawowa nr 40|Gdynia|ul. Rozewska 33 |81-055 Gdynia;1811;1104;1104;17;1087;60.96;1.54
102961;226201;Zespół Szkół Ogólnokształcących nr 5|Gdynia|ul. Wejherowska 55 |81-049 Gdynia;1543;938;938;18;920;60.79;1.92
102962;226201;Gimnazjum nr 3|Gdynia|ul. Gospodarska 1 |81-068 Gdynia;1858;974;974;27;947;52.42;2.77
102963;226201;Zespół Placówek Specjalistycznych|Gdynia|ul. Wejherowska 65 |81-049 Gdynia;1937;1120;1120;16;1104;57.82;1.43
102964;226201;Przedszkole nr 27|Gdynia|ul. Wiejska 30 |81-058 Gdynia;1572;959;959;7;952;61.01;0.73
102965;226201;Przedszkole nr 26|Gdynia|ul. Starogardzka 10a |81-050 Gdynia;1883;1065;1065;20;1045;56.56;1.88
102966;226201;Szkoła Podstawowa nr 10|Gdynia|ul. Morska 192 |81-222 Gdynia;1684;1016;1016;36;980;60.33;3.54
102967;226201;Przedszkole nr 31|Gdynia|ul. Zamenhofa 8 |81-218 Gdynia;2030;1036;1036;37;999;51.03;3.57
102968;226201;Szkoła Podstawowa nr 10|Gdynia|ul. Morska 192 |81-222 Gdynia;1734;814;814;27;787;46.94;3.32
102969;226201;IV Liceum Ogólnokształcące|Gdynia|ul. Morska 186 |81-216 Gdynia;1573;884;884;3;881;56.20;0.34
102970;226201;IV Liceum Ogólnokształcące|Gdynia|ul. Morska 186 |81-216 Gdynia;1105;617;621;8;609;55.84;1.30
102971;226201;Szkoła Podstawowa nr 29|Gdynia|ul. Ściegiennego 8 |81-257 Gdynia;1986;1136;1136;9;1127;57.20;0.79
102972;226201;Zespół Szkół Chłodniczych i Elektronicznych|Gdynia|ul. Sambora 48 |81-201 Gdynia;2164;1277;1277;15;1262;59.01;1.17
102973;226201;Gimnazjum nr 4|Gdynia|ul. Okrzei 6 |81-228 Gdynia;2126;1129;1129;25;1104;53.10;2.21
102974;226201;Zespół Szkół Chłodniczych i Elektronicznych|Gdynia|ul. Sambora 48 |81-201 Gdynia;858;547;547;8;539;63.75;1.46
102975;226201;Szkoła Podstawowa nr 17|Gdynia|ul. Grabowo 12 |81-265 Gdynia;2072;1220;1220;13;1207;58.88;1.07
102976;226201;Zespół Szkół Hotelarsko-Gastronomicznych|Gdynia|ul. Morska 77 |81-222 Gdynia;1620;978;978;19;959;60.37;1.94
102977;226201;Zespół Szkół Usługowych|Gdynia|ul. Morska 75 |81-222 Gdynia;663;424;424;6;418;63.95;1.42
102978;226201;Zespół Szkół Ogólnokształcących nr 2|Gdynia|ul. Wolności 22B |81-327 Gdynia;1552;1003;1003;8;995;64.63;0.80
102979;226201;Gimnazjum nr 2|Gdynia|ul. Wolności 25 |81-327 Gdynia;999;590;590;7;583;59.06;1.19
102980;226201;Strefa Płatnego Parkowania|Gdynia|ul. Białostocka 3 |81-310 Gdynia;990;623;623;9;614;62.93;1.44
102981;226201;Szkoła Podstawowa nr 26|Gdynia|ul. Tatrzańska 40 |81-313 Gdynia;953;654;654;7;647;68.63;1.07
102982;226201;ABK nr 4|Gdynia|ul. Warszawska 67A |81-309 Gdynia;790;484;484;6;478;61.27;1.24
102983;226201;Zespół Szkół Specjalnych nr 17|Gdynia|ul. Witomińska 25/27 |81-311 Gdynia;1482;939;939;14;925;63.36;1.49
102984;226201;I Akademickie LO|Gdynia|ul. Narcyzowa 6 |81-653 Gdynia;2190;1396;1396;27;1369;63.74;1.93
102985;226201;I Akademickie LO|Gdynia|ul. Narcyzowa 6 |81-653 Gdynia;1691;1040;1040;20;1020;61.50;1.92
102986;226201;Przedszkole nr 13|Gdynia|ul. Widna 15 |81-649 Gdynia;1670;751;751;33;718;44.97;4.39
102987;226201;Szkoła Podstawowa nr 35|Gdynia|ul. Uczniowska 1 |81-647 Gdynia;1732;921;921;20;901;53.18;2.17
102988;226201;Spółdzielnia Mieszkaniowa Senior|Gdynia|ul. Chwarznieńska 136/138 |81-602 Gdynia;1069;643;643;13;630;60.15;2.02
102989;226201;Zespół Szkół nr 7|Gdynia|ul. Stawna 4/6 |81-629 Gdynia;2230;1462;1462;10;1452;65.56;0.68
102990;226201;Zespół Szkół nr 7|Gdynia|ul. Stawna 4/6 |81-629 Gdynia;1977;1291;1291;15;1276;65.30;1.16
102991;226201;Zespół Szkół nr 7|Gdynia|ul. Stawna 4/6 |81-629 Gdynia;1966;1328;1328;9;1319;67.55;0.68
102992;226201;Obwodowy Urząd Miar|Gdynia|ul. Słoneczna 59a |81-605 Gdynia;753;476;476;6;470;63.21;1.26
102993;226201;Zespół Szkół nr 15|Gdynia|ul. Jowisza 60 |81-601 Gdynia;1384;820;820;2;818;59.25;0.24
102994;226201;Zespół Szkół nr 15|Gdynia|ul. Jowisza 60 |81-601 Gdynia;2149;1543;1543;18;1525;71.80;1.17
102995;226201;Szkoła Podstawowa nr 37|Gdynia|ul. Wiczlińska 93 |81-578 Gdynia;1726;1092;1092;13;1079;63.27;1.19
102996;226201;Szkoła Podstawowa nr 37|Gdynia|ul. Wiczlińska 93 |81-589 Gdynia;2156;1454;1459;13;1441;67.44;0.89
102997;226201;Zespół Szkół nr 14|Gdynia|ul. Nagietkowa 73 |81-589 Gdynia;1674;1130;1130;18;1112;67.50;1.59
102998;226201;Zespół Szkół nr 14|Gdynia|ul. Nagietkowa 73 |81-589 Gdynia;1984;1409;1410;8;1401;71.02;0.57
102999;226201;Zespół Szkół nr 14|Gdynia|ul. Nagietkowa 73 |81-589 Gdynia;2140;1457;1457;12;1445;68.08;0.82
103000;226201;Zespół Wczesnej Edukacji nr 1|Gdynia|ul. Wiczlińska 33 |81-578 Gdynia;1668;1206;1206;7;1199;72.30;0.58
103001;226201;Zespół Wczesnej Edukacji nr 1|Gdynia|ul. Wiczlińska 33 |81-578 Gdynia;2077;1384;1384;18;1366;66.63;1.30
103002;226201;Zespół Wczesnej Edukacji nr 1|Gdynia|ul. Wiczlińska 33 |81-578 Gdynia;1767;1061;1061;13;1048;60.05;1.23
103003;226201;Zespół Szkół nr 13|Gdynia|ul. Chwaszczyńska 26 |81-571 Gdynia;2311;1635;1635;8;1627;70.75;0.49
103004;226201;Zespół Szkół nr 13|Gdynia|ul. Chwaszczyńska 26 |81-571 Gdynia;2147;1556;1569;7;1549;72.47;0.45
103005;226201;Szkoła Podstawowa nr 20|Gdynia|ul. Starodworcowa 36 |81-575 Gdynia;2185;1413;1413;14;1399;64.67;0.99
103006;226201;Szkoła Podstawowa nr 20|Gdynia|ul. Starodworcowa 36 |81-575 Gdynia;1517;1087;1087;4;1083;71.65;0.37
103007;226201;Przedszkole nr 44|Gdynia|ul. Tatarczana 4 |81-591 Gdynia;1057;742;742;4;738;70.20;0.54
103008;226201;Przedszkole nr 44|Gdynia|ul. Tatarczana 4 |81-591 Gdynia;1892;1285;1285;12;1273;67.92;0.93
103009;226201;Zespół Szkół nr 10|Gdynia|ul. Staffa 10 |81-597 Gdynia;2021;1361;1361;22;1339;67.34;1.62
103010;226201;Zespół Szkół nr 10|Gdynia|ul. Staffa 10 |81-597 Gdynia;1988;1302;1302;24;1278;65.49;1.84
103011;226201;Zespół Szkół nr 13|Gdynia|ul. Chwaszczyńska 26 |81-571 Gdynia;1863;1238;1239;23;1215;66.45;1.86
103012;226201;Przedszkole nr 44|Gdynia|ul. Tatarczana 4 |81-591 Gdynia;2377;1546;1579;9;1537;65.04;0.58
103013;226201;Zespół Szkół nr 6|Gdynia|ul. Wrocławska 52 |81-508 Gdynia;2148;1323;1323;6;1317;61.59;0.45
103014;226201;Szkoła Podstawowa nr 13|Gdynia|ul. Halicka 8 |81-506 Gdynia;2256;1331;1331;20;1311;59.00;1.50
103015;226201;Zespół Szkół nr 6|Gdynia|ul. Wrocławska 52 |81-553 Gdynia;1074;721;721;10;711;67.13;1.39
103016;226201;Zespół Szkół nr 6|Gdynia|ul. Wrocławska 52 |81-547 Gdynia;1492;1003;1003;13;990;67.23;1.30
103017;226201;Zespół Szkół Administracyjno-Ekonomicznych|Gdynia|ul. Orłowska 57 |81-542 Gdynia;1286;903;903;17;886;70.22;1.88
103018;226201;Zespół Szkół nr 5|Gdynia|ul. Orłowska 27/33 |81-522 Gdynia;1862;1313;1313;6;1307;70.52;0.46
103019;226201;Szkoła Podstawowa nr 34|Gdynia|ul. Cylkowskiego 5 |81-465 Gdynia;2200;1423;1423;17;1406;64.68;1.19
103020;226201;Przedszkole nr 24|Gdynia|ul. Korczaka 22 |81-473 Gdynia;2468;1732;1732;10;1722;70.18;0.58
103021;226201;Szkoła Podstawowa nr 34|Gdynia|ul. Cylkowskiego 5 |81-465 Gdynia;2161;1312;1312;23;1289;60.71;1.75
103022;226201;Zespół Szkół Ogólnokształcących nr 6|Gdynia|ul. Hallera 9 |81-453 Gdynia;1480;958;958;7;951;64.73;0.73
103023;226201;Przedszkole nr 22|Gdynia|ul. Hallera 37 |81-428 Gdynia;1480;770;771;15;755;52.03;1.95
103024;226201;Szkoła Muzyczna I i II Stopnia|Gdynia|ul. Bp. Dominika 13a |81-402 Gdynia;1544;892;892;6;886;57.77;0.67
103025;226201;VI Liceum Ogólnokształcące|Gdynia|ul. Kopernika 34 |81-424 Gdynia;1188;728;728;9;719;61.28;1.24
103026;226201;Szkoła Podstawowa nr 23|Gdynia|ul. Grottgera 19 |81-438 Gdynia;1094;686;686;8;678;62.71;1.17
103027;226201;Zespół Szkół Ogólnokształcących nr 1|Gdynia|ul. Legionów 27 |81-405 Gdynia;1267;826;826;6;820;65.19;0.73
103028;226201;Zespół Szkół Ogólnokształcących nr 1|Gdynia|ul. Legionów 27 |81-405 Gdynia;1413;899;899;17;882;63.62;1.89
103029;226201;b. Młodzieżowy Dom Kultury|Gdynia|ul. Bema 33 |81-381 Gdynia;955;637;637;7;630;66.70;1.10
103030;226201;Szkoła Podstawowa nr 18|Gdynia|ul. Krasickiego 28 |81-385 Gdynia;1421;963;963;3;960;67.77;0.31
103031;226201;Przedszkole nr 25|Gdynia|ul. Necla 14 |81-377 Gdynia;1081;760;760;9;751;70.31;1.18
103032;226201;X Liceum Ogólnokształcące|Gdynia|ul. Władysława IV 58 |81-384 Gdynia;1207;756;756;11;745;62.63;1.46
103033;226201;Zespół Sportowych Szkół Ogólnokształcących|Gdynia|ul. Władysława IV 54 |81-384 Gdynia;1006;589;589;4;585;58.55;0.68
103034;226201;Zespół Sportowych Szkół Ogólnokształcących|Gdynia|ul. Władysława IV 54 |81-384 Gdynia;994;602;602;5;597;60.56;0.83
103035;226201;Przedszkole nr 7|Gdynia|ul. Władysława IV 56 |81-384 Gdynia;707;433;433;12;421;61.24;2.77
103036;226201;IX Liceum Ogólnokształcące|Gdynia|ul. Żeromskiego 31 |81-346 Gdynia;1371;895;895;8;887;65.28;0.89
103037;226201;Gdyńskie Centrum Organizacji Pozarządowych|Gdynia|ul. 3 Maja 27/31 |81-364 Gdynia;865;590;590;7;583;68.21;1.19
103038;226201;IX Liceum Ogólnokształcące|Gdynia|ul. Żeromskiego 31 |81-346 Gdynia;766;484;484;2;482;63.19;0.41
103039;226201;Zakład Ubezpieczeń Społecznych|Gdynia|ul. Władysława IV 24 |81-361 Gdynia;1250;796;796;9;787;63.68;1.13
103040;226201;Gimnazjum nr 1|Gdynia|ul. 10 Lutego 26 |81-364 Gdynia;970;613;613;9;604;63.20;1.47
103041;226201;Szkoła Podstawowa nr 21|Gdynia|ul. Jana z Kolna 5 |81-351 Gdynia;1658;998;998;14;984;60.19;1.40
103042;226201;Zespół Szkół Rzemiosła i Handlu|Gdynia|ul. Śmidowicza 49 |81-127 Gdynia;1069;486;486;10;476;45.46;2.06
103043;226201;Szkoła Podstawowa nr 33|Gdynia|ul. Godebskiego 8 |81-134 Gdynia;1644;1018;1018;23;995;61.92;2.26
103044;226201;Przedszkole nr 35|Gdynia|ul. Płk. Dąbka 167 |81-167 Gdynia;1845;1139;1139;21;1118;61.73;1.84
103045;226201;Szkoła Podstawowa nr 33|Gdynia|ul. Godebskiego 8 |81-134 Gdynia;2054;1342;1342;13;1329;65.34;0.97
103046;226201;Szkoła Podstawowa nr 33|Gdynia|ul. Godebskiego 8 |81-134 Gdynia;1263;770;770;8;762;60.97;1.04
103047;226201;Przedszkole nr 11|Gdynia|ul. Bosmańska 26a |81-116 Gdynia;2208;1310;1310;33;1277;59.33;2.52
103048;226201;V Liceum Ogólnokształcące|Gdynia|ul. Dickmana 14 |81-109 Gdynia;1579;889;889;20;869;56.30;2.25
103049;226201;Szkoła Podstawowa nr 28|Gdynia|ul. Zielona 53 |81-197 Gdynia;1748;1067;1067;19;1048;61.04;1.78
103050;226201;Przedszkole nr 42|Gdynia|ul. Płk. Dąbka 199A |81-167 Gdynia;1303;774;774;9;765;59.40;1.16
103051;226201;Przedszkole nr 47|Gdynia|ul. Maciejewicza 9 |81-189 Gdynia;1054;648;648;5;643;61.48;0.77
103052;226201;Zespół Szkół Ogólnokształcących nr 4|Gdynia|ul. Płk. Dąbka 207 |81-167 Gdynia;1782;1129;1129;17;1112;63.36;1.51
103053;226201;Szkoła Podstawowa nr 6|Gdynia|ul. Cechowa 22 |81-194 Gdynia;2238;1470;1470;18;1452;65.68;1.22
103054;226201;Przedszkole nr 18|Gdynia|ul. Krawiecka 35 |81-178 Gdynia;2012;1220;1220;20;1200;60.64;1.64
103055;226201;Przedszkole nr 48|Gdynia|ul. Unruga 86 |81-181 Gdynia;2190;1352;1352;14;1338;61.74;1.04
103056;226201;Szkoła Podstawowa nr 39|Gdynia|ul. Unruga 88 |81-181 Gdynia;1140;764;764;16;748;67.02;2.09
103057;226201;Szkoła Podstawowa nr 39|Gdynia|ul. Unruga 88 |81-181 Gdynia;1567;1017;1017;12;1005;64.90;1.18
103058;226201;Zespół Szkół nr 12|Gdynia|ul. Sucharskiego 10 |81-157 Gdynia;2121;1330;1330;20;1310;62.71;1.50
103059;226201;Zespół Szkół nr 11|Gdynia|ul. Porębskiego 21 |81-185 Gdynia;1756;1110;1110;29;1081;63.21;2.61
103060;226201;Przedszkole nr 29|Gdynia|ul. Unruga 53 |81-181 Gdynia;2176;1385;1385;20;1365;63.65;1.44
103061;226201;Zespół Szkół nr 11|Gdynia|ul. Porębskiego 21 |81-185 Gdynia;1429;910;910;17;893;63.68;1.87
103062;226201;Przedszkole nr 49|Gdynia|ul. Steyera 2 |81-185 Gdynia;1979;1223;1223;15;1208;61.80;1.23
103063;226201;Firma Samochodowa "KAJA"|Gdynia|ul. Unruga 182 |81-153 Gdynia;1614;940;940;18;922;58.24;1.91
103064;226201;Firma Samochodowa "KAJA"|Gdynia|ul. Unruga 182 |81-153 Gdynia;1919;973;973;13;960;50.70;1.34
103065;226201;Szpitale Wojewódzkie w Gdyni Sp. z o.o.|Gdynia|Wójta Radtkego 1 |81-348 Gdynia;167;64;64;2;62;38.32;3.12
103066;226201;Szpitale Wojewódzkie w Gdyni Sp. z o.o.|Gdynia|Powstania Styczniowego 1 |81-519 Gdynia;126;65;65;3;62;51.59;4.62
103067;226201;Uniwersyteckie Centrum Medycyny Morskiej i Tropikalnej|Gdynia|Powstania Styczniowego 9B |81-519 Gdynia;45;33;33;2;31;73.33;6.06
103068;226201;Dom Pomocy Społecznej|Gdynia|Pawia 31 |81-078 Gdynia;70;33;33;1;32;47.14;3.03
103069;226301;Przedszkole Miejskie nr 25 "Kubuś Puchatek"|Słupsk|ul. Powstańców Wielkopolskich 1 |76-200 Słupsk;1142;675;675;7;668;59.11;1.04
103070;226301;Zespół Szkół Ponadgimnazjalnych nr 1 im. Noblistów Polskich|Słupsk|ul. Szczecińska 60 |76-200 Słupsk;1821;1018;1018;14;1004;55.90;1.38
103071;226301;Przedszkole Miejskie nr 31 "Bajkowa Kraina"|Słupsk|ul. Witosa 1 |76-200 Słupsk;1917;1026;1026;20;1006;53.52;1.95
103072;226301;Zespół Szkół Ogólnokształcących nr 3|Słupsk|ul. Zaborowskiej 2 |76-200 Słupsk;1823;1003;1003;15;988;55.02;1.50
103073;226301;Szkoła Podstawowa z Oddziałami Integracyjnymi nr 10 im. Polonii|Słupsk|ul. Kulczyńskiego 1a |76-200 Słupsk;2104;1209;1209;18;1191;57.46;1.49
103074;226301;Przedszkole Miejskie nr 19|Słupsk|ul. Norwida 4 |76-200 Słupsk;1745;1027;1028;32;995;58.85;3.12
103075;226301;Przychodnia Rejonowa|Słupsk|ul. 11 Listopada 7 |76-200 Słupsk;1944;1116;1116;20;1096;57.41;1.79
103076;226301;Zespół Szkół Agrotechnicznych|Słupsk|ul. Szczecińska 36 |76-200 Słupsk;2142;1236;1236;28;1208;57.70;2.27
103077;226301;Szkoła Podstawowa nr 8 im. Żołnierzy Armii Krajowej|Słupsk|ul. Grottgera 10a |76-200 Słupsk;1936;1048;1048;31;1017;54.13;2.96
103078;226301;Państwowa Szkoła Muzyczna I i II st.|Słupsk|ul. Szczecińska 106 |76-200 Słupsk;1279;637;637;11;626;49.80;1.73
103079;226301;Słupski Ośrodek Kultury|Słupsk|ul. Braci Gierymskich 1 |76-200 Słupsk;2152;1099;1099;18;1081;51.07;1.64
103080;226301;Gimnazjum nr 2 im. Ks. Jana Twardowskiego|Słupsk|ul. Sobieskiego 3 |76-200 Słupsk;1824;821;821;12;809;45.01;1.46
103081;226301;Przedszkole Miejskie nr 10 "Świat Fantazji"|Słupsk|ul. Zygmunta Augusta 10 |76-200 Słupsk;1957;1006;1006;18;988;51.41;1.79
103082;226301;I Społeczna Szkoła Postawowa STO|Słupsk|ul. Zygmunta Augusta 8 |76-200 Słupsk;1134;501;501;15;486;44.18;2.99
103083;226301;Szkoła Podstawowa nr 3 im. Janusza Karczaka|Słupsk|ul. Banacha 5 |76-200 Słupsk;1551;782;782;20;762;50.42;2.56
103084;226301;Przedszkole Miejskie nr 23 "Promyczek"|Słupsk|ul. Wazów 1a |76-200 Słupsk;1259;628;628;10;618;49.88;1.59
103085;226301;Gimnazjum z Oddziałami Integracyjnymi nr 4 im. Orła Białego|Słupsk|ul. Banacha 17 |76-200 Słupsk;1180;553;553;11;542;46.86;1.99
103086;226301;Młodzieżowe Centrum Kultury|Słupsk|Al. 3 Maja 22 |76-200 Słupsk;1940;1122;1122;16;1106;57.84;1.43
103087;226301;Przedszkole Miejskie nr 24 "Słupski Niedźwiadek Szczęścia"|Słupsk|Al. 3 Maja 15 |76-200 Słupsk;1573;935;935;18;917;59.44;1.93
103088;226301;Zespół Szkół Budowlanych im. Inżynierów Polskich|Słupsk|ul. Królowej Jadwigi 3 |76-200 Słupsk;1479;790;790;17;773;53.41;2.15
103089;226301;Szkoła Podstawowa z Oddziałami Integracyjnymi nr 4 im. Gustawa Morcinka|Słupsk|ul. Leszczyńskiego 17 |76-200 Słupsk;1782;835;835;11;824;46.86;1.32
103090;226301;Przedszkole Miejskie nr 15|Słupsk|ul. Wiatraczna 6 |76-200 Słupsk;1949;1102;1102;11;1091;56.54;1.00
103091;226301;Szkoła Podstawowa z Oddziałami Przyszpitalnymi nr 9 im. kmdra por. Stanisława Hryniewieckiego|Słupsk|ul. Małachowskiego 9 |76-200 Słupsk;1792;661;661;9;652;36.89;1.36
103092;226301;II Liceum Ogólnokształcące z Oddziałami Dwujęzycznymi im. Adama Mickiewicza w Zespole Szkół Ogólnokształcacych nr 2|Słupsk|ul. Mickiewicza 32 |76-200 Słupsk;1808;687;687;21;666;38.00;3.06
103093;226301;Przedszkole Miejskie nr 5|Słupsk|ul. Niemcewicza 9 |76-200 Słupsk;1735;640;640;32;608;36.89;5.00
103094;226301;Gimnazjum nr 3 z Oddziałami Dwujęzycznymi im. Adama Mickiewicza w Zespole Szkół Ogólnokształcących nr 2|Słupsk|ul. Prusa 1 |76-200 Słupsk;1803;716;716;25;691;39.71;3.49
103095;226301;Ośrodek Sportowo-Rekreacyjny przy Specjalnym Ośrodku Szkolno-Wychowawczym|Słupsk|ul. Niedziałkowskiego 2 |76-200 Słupsk;1651;718;718;20;698;43.49;2.79
103096;226301;Urząd Miejski|Słupsk|Plac Zwycięstwa 1 |76-200 Słupsk;1108;583;583;6;577;52.62;1.03
103097;226301;Szkoła Podstawowa nr 6 im. Ludwika Waryńskiego|Słupsk|ul. Starzyńskiego 6 |76-200 Słupsk;1168;475;475;14;461;40.67;2.95
103098;226301;Pedagogiczna Biblioteka Wojewódzka|Słupsk|ul. Jaracza 18a |76-200 Słupsk;1462;520;520;18;502;35.57;3.46
103099;226301;V Liceum Ogólnokształcące im. Zbigniewa Herberta|Słupsk|ul. Deotymy 15a |76-200 Słupsk;1591;680;680;15;665;42.74;2.21
103100;226301;Szkoła Podstawowa nr 1 im. Henryka Sienkiewicza|Słupsk|ul. Lutosławskiego 23 |76-200 Słupsk;1929;919;919;25;894;47.64;2.72
103101;226301;Zespół Szkół Technicznych|Słupsk|ul. Szymanowskiego 5 |76-200 Słupsk;1780;879;879;14;865;49.38;1.59
103102;226301;Szkoła Podstawowa nr 2 im. Tadeusza Kościuszki|Słupsk|ul. Henryka Pobożnego 2 |76-200 Słupsk;1398;568;568;15;553;40.63;2.64
103103;226301;Zespół Szkół Ekonomicznych i Technicznych im. Stanisława Staszica|Słupsk|ul. Patryzantów 24 |76-200 Słupsk;1795;720;720;18;702;40.11;2.50
103104;226301;Wojewódzki Zespół Szkół Policealnych|Słupsk|ul. Bałtycka 29 |76-200 Słupsk;666;322;322;3;319;48.35;0.93
103105;226301;Przedszkole Miejskie nr 2|Słupsk|ul. Zamkowa 6 |76-200 Słupsk;1918;1034;1034;27;1007;53.91;2.61
103106;226301;Niepubliczna Szkoła Podstawowa Nr 7|Słupsk|ul. Kilińskiego 38 |76-200 Słupsk;1856;932;933;23;909;50.22;2.47
103107;226301;Gimnazjum nr 5 im. Sejmu Polskiego|Słupsk|ul. Prof. Lotha 3 |76-200 Słupsk;2151;1032;1032;24;1008;47.98;2.33
103108;226301;Przedszkole Miejskie z Oddziałami Integracyjnymi nr 32 "Tęczowa Dolina"|Słupsk|ul. Kasztanowa 1 |76-200 Słupsk;1916;1104;1105;13;1091;57.62;1.18
103109;226301;Akademia Pomorska|Słupsk|ul. Arciszewskiego 22a |76-200 Słupsk;1535;851;851;17;834;55.44;2.00
103110;226301;Szkoła Podstawowa z Oddziałami Integracynymi nr 5 im. Gryfitów|Słupsk|ul. Hubalczyków 7 |76-200 Słupsk;1944;1136;1136;14;1122;58.44;1.23
103111;226301;Przedszkole Miejskie nr 11 "Calineczka"|Słupsk|ul. Kosynierów Gdyńskich 6 |76-200 Słupsk;1939;1067;1067;9;1058;55.03;0.84
103112;226301;Wojewódzki Szpital Specjalistyczny im. Janusza Korczaka|Słupsk|ul. Hubalczyków 1 |76-200 Słupsk;154;47;47;0;47;30.52;0.00
103113;226301;Areszt Śledczy|Słupsk|ul. Sądowa 1 |76-200 Słupsk;148;82;82;7;75;55.41;8.54
103114;226301;Dom Pomocy Społecznej "Leśna Oaza"|Słupsk|ul. Leśna 8 |76-200 Słupsk;59;18;18;4;14;30.51;22.22
103115;226301;Samodzielny Publiczny Specjalistyczny Psychiatryczny Zakład Opieki Zdrowotnej|Słupsk|ul. Obrońców Wybrzeża 4 |76-200 Słupsk;62;11;11;2;9;17.74;18.18
103116;226401;Zespół Szkół Nr 3|Sopot|ul. Jana Jerzego Haffnera 55 |81-715 Sopot;1092;665;665;6;659;60.90;0.90
103117;226401;Państwowa Galeria Sztuki|Sopot|Plac Zdrojowy 2 |81-718 Sopot;947;631;631;9;622;66.63;1.43
103118;226401;Zespół Szkół Handlowych|Sopot|ul. Tadeusza Kościuszki 18/20 |81-704 Sopot;1057;657;657;3;654;62.16;0.46
103119;226401;Wojewódzki Zespół Reumatologiczny Zakład Rehabilitacji Leczniczej|Sopot|Plac Zdrojowy 3 |81-759 Sopot;1198;751;751;9;742;62.69;1.20
103120;226401;Centrum Kształcenia Ustawicznego|Sopot|ul. Tadeusza Kościuszki 22/24 |81-704 Sopot;1132;731;731;6;725;64.58;0.82
103121;226401;Zespół Szkół Specjalnych Nr 5|Sopot|ul. Kazimierza Wielkiego 14 |81-780 Sopot;1769;1092;1092;17;1075;61.73;1.56
103122;226401;Muzeum Sopotu|Sopot|ul. Księcia Józefa Poniatowskiego 8 |81-724 Sopot;1058;701;701;13;688;66.26;1.85
103123;226401;Szkoła Podstawowa Nr 8|Sopot|ul. 3 Maja 41 |81-743 Sopot;1798;1156;1156;10;1146;64.29;0.87
103124;226401;Przedszkole Nr 8|Sopot|ul. Jana z Kolna 3 |81-742 Sopot;2214;1453;1453;12;1441;65.63;0.83
103125;226401;Szkoła Podstawowa Nr 1 (wejście od ul. Bocznej)|Sopot|ul. Armii Krajowej 50/54 |81-843 Sopot;1825;1182;1182;11;1171;64.77;0.93
103126;226401;Szkoła Podstawowa Nr 1 (wejście od ul. Armii Krajowej)|Sopot|ul. Armii Krajowej 50/54 |81-843 Sopot;1405;943;943;10;933;67.12;1.06
103127;226401;Dom Pomocy Społecznej|Sopot|ul. Adama Mickiewicza 49 |81-866 Sopot;1282;910;911;9;901;70.98;0.99
103128;226401;II Liceum Ogólnokształcące|Sopot|Al. Niepodległości 751 |81-838 Sopot;1884;1112;1112;21;1091;59.02;1.89
103129;226401;Uniwersytet Gdański|Sopot|ul. Armii Krajowej 119/121 |81-824 Sopot;1496;912;912;9;903;60.96;0.99
103130;226401;Przedszkole Nr 2|Sopot|ul. 23 Marca 90 |81-820 Sopot;1828;1181;1181;11;1170;64.61;0.93
103131;226401;Sopockie Ognisko Plastyczne|Sopot|ul. Księżycowa 3b |81-821 Sopot;1279;744;744;15;729;58.17;2.02
103132;226401;Spółdzielnia Mieszkaniowa im. Józefa Ignacego Kraszewskego Klub Potok|Sopot|ul. Józefa Ignacego Kraszewskiego 31 |81-815 Sopot;1734;1164;1164;16;1148;67.13;1.37
103133;226401;Gimnazjum Nr 2|Sopot|ul. Wejherowska 1 |81-816 Sopot;995;583;583;5;578;58.59;0.86
103134;226401;Miejska Biblioteka Publiczna Filia Nr 8|Sopot|ul. Mazowiecka 26 |81-862 Sopot;1501;1025;1025;7;1018;68.29;0.68
103135;226401;Szkoła Podstawowa Nr 9|Sopot|ul. Oskara Kolberga 15 |81-881 Sopot;1489;1002;1002;7;995;67.29;0.70
103136;226401;Przedszkole Nr 12|Sopot|ul. Oskara Kolberga 8 |81-881 Sopot;1518;1047;1047;11;1036;68.97;1.05
103137;226401;Wojewódzki Zespół Reumatologiczny|Sopot|Grunwaldzka 1-3 |81-759 ;65;44;44;3;41;67.69;6.82
103138;229801;Baltica|| | ;17;17;17;3;14;100.00;17.65
103139;229801;Le Quy Don|| | ;17;17;17;1;16;100.00;5.88
103140;229901;Oceania|| | ;20;20;20;1;19;100.00;5.00
103141;229901;Baltic Beta|| | ;48;48;48;1;47;100.00;2.08
103142;229901;LOTOS Petrobaltic|| | ;64;64;64;1;63;100.00;1.56
103143;240101;Przedszkole Miejskie Nr 15|Będzin|ul. Barlickiego 75 |42-506 Będzin;767;351;351;14;337;45.76;3.99
103144;240101;Szkoła Podstawowa Nr 6|Będzin|ul. Marii Konopnickiej 13 |42-506 Będzin;1691;668;668;26;642;39.50;3.89
103145;240101;Miejski Zespół Szkół Nr 3|Będzin|ul. Hugo Kołłątaja 63 |42-506 Będzin;927;518;518;5;513;55.88;0.97
103146;240101;Przedszkole Miejskie Nr 14|Będzin|ul. Romualda Traugutta 1 |42-506 Będzin;1192;621;621;13;608;52.10;2.09
103147;240101;Ośrodek Kultury Filia w Grodźcu|Będzin|ul. Juliusza Słowackiego 2 |42-506 Będzin;2053;975;976;21;954;47.49;2.15
103148;240101;Przedszkole Miejskie Nr 2|Będzin|ul. Turniejowa 5 |42-500 Będzin;1394;766;766;13;753;54.95;1.70
103149;240101;Miejski Zespół Szkół Nr 1|Będzin|ul. Wolności 51 |42-500 Będzin;657;420;420;2;418;63.93;0.48
103150;240101;Przedszkole Miejskie Nr 2|Będzin|ul. Turniejowa 5 |42-500 Będzin;1838;1188;1188;8;1180;64.64;0.67
103151;240101;Miejski Zespół Szkół Nr 1|Będzin|ul. Wolności 51 |42-500 Będzin;1233;782;782;7;775;63.42;0.90
103152;240101;Remsen Investments Sp. z o.o. S.K.A Warszawa, Oddział Południe|Będzin|ul. Brzozowicka 47/49 |42-500 Będzin;620;382;382;6;376;61.61;1.57
103153;240101;Miejski Zespół Szkół nr 4 Hala Sportowa|Będzin|ul. Jedności 38 |42-504 Będzin;1806;910;910;17;893;50.39;1.87
103154;240101;Ochotnicza Straż Pożarna Łagisza|Będzin|ul. Pokoju 44 |42-504 Będzin;948;511;511;4;507;53.90;0.78
103155;240101;Przedszkole Miejskie Nr 11|Będzin|ul. Podłosie 10 |42-504 Będzin;813;402;402;3;399;49.45;0.75
103156;240101;Szkoła Podstawowa nr 11|Będzin|ul. Władysława Broniewskiego 12 |42-500 Będzin;1273;674;674;16;658;52.95;2.37
103157;240101;Powiatowy Młodzieżowy Dom Kultury|Będzin|ul. Powstańców Śląskich 1 |42-500 Będzin;950;496;496;12;484;52.21;2.42
103158;240101;Spółdzielnia Mieszkaniowa "Wspólnota" Klub Rytm|Będzin|ul. Zwycięstwa 12 |42-500 Będzin;812;417;417;8;409;51.35;1.92
103159;240101;Miejski Zespół Szkól Nr 2|Będzin|ul. Rewolucjonistów 18 |42-500 Będzin;1679;955;955;26;929;56.88;2.72
103160;240101;Przedszkole Miejskie nr 5|Będzin|ul. Zwycięstwa 21 |42-500 Będzin;1926;877;877;28;849;45.53;3.19
103161;240101;Miejski Zespół Szkól Nr 2|Będzin|ul. Rewolucjonistów 18 |42-500 Będzin;1620;938;938;13;925;57.90;1.39
103162;240101;Przedszkole Miejskie Nr 13|Będzin|ul. Józefa Skalskiego 4 |42-500 Będzin;1246;712;712;20;692;57.14;2.81
103163;240101;Przedszkole Miejskie Nr 13|Będzin|ul. Józefa Skalskiego 4 |42-500 Będzin;1199;696;696;14;682;58.05;2.01
103164;240101;Miejski Zespół Szkół Nr 2|Będzin|ul. Rewolucjonistów 18 |42-500 Będzin;829;407;407;3;404;49.10;0.74
103165;240101;Szkoła Podstawowa nr 1|Będzin|ul. Szkolna 3 |42-500 Będzin;1543;964;964;11;953;62.48;1.14
103166;240101;Szkoła Podstawowa nr 1|Będzin|ul. Szkolna 3 |42-500 Będzin;1598;919;919;17;902;57.51;1.85
103167;240101;I Liceum Ogólnokształcące im. Mikołaja Kopernika|Będzin|ul. Mikołaja Kopernika 2 |42-500 Będzin;1871;785;785;22;763;41.96;2.80
103168;240101;Ośrodek Kultury|Będzin|ul. Stanisława Małachowskiego 43 |42-500 Będzin;1709;671;671;20;651;39.26;2.98
103169;240101;Zespół Szkół Techniczno - Usługowych|Będzin|ul. 11 Listopada 3 |42-500 Będzin;931;425;425;9;416;45.65;2.12
103170;240101;Przedszkole Miejskie Nr 1|Będzin|ul. Zawale 7 |42-500 Będzin;1501;578;578;17;561;38.51;2.94
103171;240101;II Liceum Ogólnokształcące im. St. Wyspiańskiego|Będzin|ul. Teatralna 5 |42-500 Będzin;695;310;310;8;302;44.60;2.58
103172;240101;Szkoła Podstawowa Nr 4 Hala Sportowa|Będzin|ul. Wawrzyńca Stalickiego 1 |42-500 Będzin;1356;612;612;9;603;45.13;1.47
103173;240101;GPW S.A. Stacja Uzdatniania Wody Będzin|Będzin|ul. Siemońska 45 |42-500 Będzin;1361;686;686;15;671;50.40;2.19
103174;240101;Przedszkole Miejskie Nr 6|Będzin|ul. Wawrzyńca Stalickiego 10a |42-500 Będzin;1364;663;663;20;643;48.61;3.02
103175;240101;Szkoła Podstawowa Nr 4 Sala Gimnastyczna|Będzin|ul. Wawrzyńca Stalickiego 1 |42-500 Będzin;1109;514;514;18;496;46.35;3.50
103176;240101;Szkoła Podstawowa Nr 8|Będzin|ul. Orla 4 |42-500 Będzin;1471;749;749;6;743;50.92;0.80
103177;240101;Przedszkole Miejskie Nr 10|Będzin|ul. Kielecka 11 |42-500 Będzin;1685;949;949;18;931;56.32;1.90
103178;240101;Dom Pomocy Społecznej|Będzin|Fryderyka Chopina 1 |42-506 Będzin;60;24;24;8;16;40.00;33.33
103179;240101;PZZOZ Szpital w Będzinie|Będzin|Stanisława Małachowskiego 12 |42-500 Będzin;77;24;24;1;23;31.17;4.17
103180;240102;Dom Pomocy Społecznej "Senior"|Czeladź|ul. Szpitalna 5A |41-250 Czeladź;1198;597;597;14;583;49.83;2.35
103181;240102;Przedszkole Nr 11|Czeladź|ul. Kombatantów 2 |41-250 Czeladź;1323;693;693;15;678;52.38;2.16
103182;240102;Miejski Ośrodek Pomocy Społecznej|Czeladź|ul. 17 Lipca 27 |41-250 Czeladź;1294;680;680;16;664;52.55;2.35
103183;240102;Miejski Zespół Szkół|Czeladź|ul. Szkolna 6 |41-250 Czeladź;1424;598;598;19;579;41.99;3.18
103184;240102;Przedszkole Nr 7|Czeladź|ul. Waryńskiego 19 |41-250 Czeladź;1070;473;474;16;457;44.21;3.38
103185;240102;Przedszkole nr 4|Czeladź|ul. Miasta Auby 14 |41-250 Czeladź;1467;712;712;23;689;48.53;3.23
103186;240102;Gimnazjum Nr 2|Czeladź|ul. Katowicka 42 |41-250 Czeladź;1559;968;968;17;951;62.09;1.76
103187;240102;Szkoła Podstawowa Nr 1|Czeladź|ul. Reymonta 80 |41-250 Czeladź;1490;766;766;13;753;51.41;1.70
103188;240102;Przedszkole Nr 9|Czeladź|ul. 35 Lecia PRL 8 |41-250 Czeladź;1153;672;672;6;666;58.28;0.89
103189;240102;Szkoła Podstawowa nr 3|Czeladź|ul. Staszica 47 |41-250 Czeladź;1144;630;630;14;616;55.07;2.22
103190;240102;Żłobek Miejski|Czeladź|ul. 35 Lecia PRL 6 |41-250 Czeladź;1075;487;487;24;463;45.30;4.93
103191;240102;Muzeum Miejskie Saturn|Czeladź|ul. Dehnelów 10 |41-250 Czeladź;1172;561;561;20;541;47.87;3.57
103192;240102;Muzeum Miejskie "Saturn|Czeladź, Piaski|ul. Dehnelów 10 |41-253 Czeladź, Piaski;1054;595;595;18;577;56.45;3.03
103193;240102;Galeria Sztuki Współczesnej "Elektrownia"|Czeladź|ul. Dehnelów 45 |41-250 Czeladź;1091;580;580;3;577;53.16;0.52
103194;240102;Siedziba Zarządu KS Górnik Piaski|Czeladź, Piaski|ul. Mickiewicza |41-253 Czeladź, Piaski;1280;673;673;13;660;52.58;1.93
103195;240102;Miejski Ośrodek Pomocy Społecznej|Czeladź, Piaski|ul. Zwycięstwa 6 |41-253 Czeladź, Piaski;1374;678;678;15;663;49.34;2.21
103196;240102;Przedszkole nr 10|Czeladź, Piaski|ul. Żeromskiego 19 |41-253 Czeladź, Piaski;1234;573;573;13;560;46.43;2.27
103197;240102;Gimnazjum nr 3|Czeladź|ul. Lwowska 2 |41-253 Czeladź;1129;785;785;15;770;69.53;1.91
103198;240102;Szkoła Podstawowa nr 7|Czeladź|ul. Spacerowa 2 |41-253 Czeladź;1139;622;622;6;616;54.61;0.96
103199;240102;Przedszkole nr 5|Czeladź|ul. Krótka 1 |41-253 Czeladź;1115;675;675;12;663;60.54;1.78
103200;240102;Szkoła Podstaowa nr 7|Czeladź|ul. Spacerowa 2 |41-253 Czeladź;1195;684;684;14;670;57.24;2.05
103201;240102;Szpital w Czeladzi|Czeladź|Szpitalna 40 |41-250 Czeladź;197;53;53;2;51;26.90;3.77
103202;240103;Szkoła Podstawowa Nr 1|Wojkowice|ul. Jana III Sobieskiego 29 |42-580 Wojkowice;1389;693;693;9;684;49.89;1.30
103203;240103;TLEN Wojkowice|Wojkowice|ul. Jana III Sobieskiego 125 |42-580 Wojkowice;1085;388;388;14;374;35.76;3.61
103204;240103;Gimnazjum|Wojkowice|ul. Jana III Sobieskiego 211b |42-580 Wojkowice;1915;947;947;21;926;49.45;2.22
103205;240103;Urząd Miasta|Wojkowice|ul. Jana III Sobieskiego 290a |42-580 Wojkowice;1163;569;569;16;553;48.93;2.81
103206;240103;Miejski Ośrodek Kultury|Wojkowice|ul. Jaworznik 6 |42-580 Wojkowice;1866;1091;1091;28;1063;58.47;2.57
103207;240103;Zakład Karny|Wojkowice|Jana III Sobieskiego 298 |42-580 Wojkowice;561;204;204;21;183;36.36;10.29
103208;240103;Zakład Karny Oddział Aresztu Śledczego|Wojkowice|Jana III Sobieskiego 298 |42-580 Wojkowice;369;210;210;43;167;56.91;20.48
103209;240104;Gminny Ośrodek Kultury|Bobrowniki|ul. Sienkiewicza 121A |42-583 Bobrowniki;1339;722;722;12;710;53.92;1.66
103210;240104;Przedszkole Publiczne|Bobrowniki|ul. 1 Maja 73a |42-583 Bobrowniki;1207;568;568;7;561;47.06;1.23
103211;240104;Zespół Szkolno - Przedszkolny|Dobieszowice|ul. Kościuszki 32 |42-584 Dobieszowice;1600;812;812;13;799;50.75;1.60
103212;240104;Remiza OSP|Myszkowice|ul. Strażacka 1 |42-595 Sączów;348;161;161;2;159;46.26;1.24
103213;240104;Gminny Ośrodek Kultury Filia w Rogoźniku - "Sołtysówka"|Rogoźnik|ul. Kościuszki 56 |42-582 Rogoźnik;1238;694;694;36;658;56.06;5.19
103214;240104;Przedszkole Publiczne|Rogoźnik|ul. Zacisze 1 |42-582 Rogoźnik;1229;644;644;17;627;52.40;2.64
103215;240104;Zespół Szkolno - Przedszkolny|Sączów|ul. Szkolna 5 |42-595 Sączów;1144;577;577;13;564;50.44;2.25
103216;240104;Gimnazjum Publiczne|Siemonia|ul. Kościuszki 71 |42-595 Sączów;773;455;455;17;438;58.86;3.74
103217;240104;Remiza OSP|Twardowice|ul. Wolności 31 |42-595 Sączów;352;186;186;3;183;52.84;1.61
103218;240104;Remiza OSP|Wymysłów|ul. Kościuszki 21 |42-584 Dobieszowice;499;275;275;3;272;55.11;1.09
103219;240105;Gminna Biblioteka Publiczna w Mierzęcicach|Mierzęcice|ul.Wolności 62a |42-460 Mierzęcice;992;472;472;10;462;47.58;2.12
103220;240105;Szkoła Podstawowa w Przeczycach|Przeczyce|ul. Tysiąclecia 6 |42-460 Mierzęcice;1181;510;510;11;499;43.18;2.16
103221;240105;Szkoła Podstawowa w Toporowicach|Toporowice|ul. Czerwonego Zagłębia 6 |42-460 Mierzęcice;772;384;384;13;371;49.74;3.39
103222;240105;Zespół Szkolno - Przedszkolny w Nowej Wsi|Nowa Wieś|ul. Aleksandra Zawadzkiego 161 |42-460 Mierzęcice;827;429;429;8;421;51.87;1.86
103223;240105;Szkoła Podstawowa w Boguchwałowicach|Boguchwałowice|ul. Mariana Buczka 1 |42-460 Mierzęcice;637;297;297;8;289;46.62;2.69
103224;240105;Remiza OSP w Sadowiu|Sadowie|ul. Dworska 3 B |42-460 Mierzęcice;493;240;240;10;230;48.68;4.17
103225;240105;Szkoła Podstawowa Nr 2 w Mierzęcicach|Mierzęcice|ul. Kolejowa 122 |42-460 Mierzęcice;696;376;376;10;366;54.02;2.66
103226;240105;Siedziba OSP w Mierzęcicach II|Mierzęcice|ul. Kolejowa 4 |42-460 Mierzęcice;524;237;237;6;231;45.23;2.53
103227;240106;Szkoła Podstawowa w Dąbiu|Dąbie|ul. Pocztowa 39 |42-504 Będzin;883;470;470;14;456;53.23;2.98
103228;240106;Remiza Ochotniczej Straży Pożarnej w Goląszy - Brzękowicach|Brzękowice Górne| 2 |42-504 Będzin;583;277;277;6;271;47.51;2.17
103229;240106;Remiza Ochotniczej Straży Pożarnej w Górze Siewierskiej|Góra Siewierska|ul. Szopena 5 |42-575 Strzyżowice;778;431;431;8;423;55.40;1.86
103230;240106;Szkoła Podstawowa w Gródkowie|Grodków|ul. Leśna 2 |42-575 Strzyżowice;764;452;452;10;442;59.16;2.21
103231;240106;Budynek byłej Szkoły Podstawowej w Malinowicach|Malinowice|ul. Szkolna 23 |42-512 Psary;610;336;336;12;324;55.08;3.57
103232;240106;Dom Kultury w Preczowie|Preczów|ul. Dębowa 1 |42-512 Psary;761;423;423;6;417;55.58;1.42
103233;240106;Gimnazjum w Psarach|Psary|ul. Szkolna 32 |42-512 Psary;2270;1135;1135;23;1112;50.00;2.03
103234;240106;Szkoła Podstawowa w Sarnowie|Sarnów|ul. Szkolna 5 |42-512 Psary;1506;835;835;35;800;55.44;4.19
103235;240106;Szkoła Podstawowa w Strzyżowicach|Strzyżowice|ul. 1 Maja 17 |42-575 Strzyżowice;1520;806;806;12;794;53.03;1.49
103236;240107;Liceum Ogólnokształcące w Siewierzu|Siewierz|ul. Kościuszki 15 |42-470 Siewierz;2459;1230;1230;31;1199;50.02;2.52
103237;240107;Miejsko-Gminne Centrum Kultury, Sportu i Turystyki w Siewierzu|Siewierz|ul. Słowackiego 2a |42-470 Siewierz;2087;1209;1209;19;1190;57.93;1.57
103238;240107;Centrum Kulturalno-Edukacyjne w Brudzowicach|Brudzowice, Szkolna|ul. Szkolna 2 |42-470 Siewierz;991;413;413;13;400;41.68;3.15
103239;240107;Budynek szkolny w Dziewkach|Dziewki| 52 |42-470 Siewierz;598;299;299;12;287;50.00;4.01
103240;240107;Zespół Szkolno-Przedszkolny w Wojkowicach Kościelnych|Wojkowice Kościelne|ul. Zachodnia 4 |42-510 Wojkowice Kościelne;2195;1090;1090;30;1060;49.66;2.75
103241;240107;Zespół Szkolno-Przedszkolny w Żelisławicach|Żelisławice|ul. Przyszłości 9 |42-470 Siewierz;1455;659;659;15;644;45.29;2.28
103242;240107;Remiza Ochotniczej Straży Pożarnej w Gołuchowicach|Gołuchowice| 82 |42-470 Siewierz;327;157;157;2;155;48.01;1.27
103243;240107;Szpital Chorób Płuc w Siewierzu Sp. z o.o.|Siewierz|Zbigniewa Oleśnickiego 21 |42-470 Siewierz;31;6;6;0;6;19.35;0.00
103244;240108;Szkoła Podstawowa im. Jana Baranowskiego|Sławków|ul. Browarna 55 |41-260 Sławków;1188;625;625;13;612;52.61;2.08
103245;240108;Szkoła Podstawowa im. Jana Baranowskiego|Sławków|ul. Browarna 55 |41-260 Sławków;1080;571;571;11;560;52.87;1.93
103246;240108;Zespół Szkół im. Jana Pawła II|Sławków|ul. gen. Władysława Sikorskiego 4 |41-260 Sławków;1204;669;669;24;645;55.56;3.59
103247;240108;Miejska Biblioteka Publiczna|Sławków|ul. gen. Władysława Sikorskiego 4 |41-260 Sławków;1136;584;584;15;569;51.41;2.57
103248;240108;Szkolne Schronisko Młodzieżowe|Sławków, Niwa|ul. Niwa 45 |41-260 Sławków;1105;592;592;12;580;53.57;2.03
103249;240201;Zespół Szkoły Podstawowej i Gimnazjum Nr 1|Szczyrk|ul. Szkolna 9 |43-370 Szczyrk;1586;919;919;12;907;57.94;1.31
103250;240201;Miejski Ośrodek Kultury, Promocji i Informacji|Szczyrk|ul. Myśliwska 34 |43-370 Szczyrk;1394;776;776;16;760;55.67;2.06
103251;240201;Zespół Szkoły Podstawowej i Gimnazjum Nr 2|Szczyrk|ul. Myśliwska 154 |43-370 Szczyrk;681;432;432;16;416;63.44;3.70
103252;240201;Zespół Szkoły Podstawowej i Gimnazjum Nr 2|Szczyrk|Myśliwska 154 |43-370 Szczyrk;1062;577;577;17;560;54.33;2.95
103253;240202;Dom Strażaka|Bestwina|ul. Kościelna 41 |43-512 Bestwina;1884;1116;1116;24;1092;59.24;2.15
103254;240202;Szkoła Podstawowa|Bestwina|ul. Szkolna 11 |43-512 Bestwina;1910;1138;1138;25;1113;59.58;2.20
103255;240202;Szkoła Podstawowa|Bestwinka|ul. Dworkowa 3 |43-512 Bestwina;1321;764;764;15;749;57.83;1.96
103256;240202;Szkoła Podstawowa|Janowice|ul. Korczaka 2 |43-512 Bestwina;1405;868;868;18;850;61.78;2.07
103257;240202;Szkoła Podstawowa|Kaniów|ul. Batalionów Chłopskich 15 |43-514 Kaniów;1334;720;720;26;694;53.97;3.61
103258;240202;Szkoła Podstawowa|Kaniów|ul. Batalionów Chłopskich 15 |43-514 Kaniów;1261;751;751;18;733;59.56;2.40
103259;240203;Urząd Gminy (Biblioteka)|Buczkowice|ul. Lipowska 730 |43-374 Buczkowice;1765;1048;1048;15;1033;59.38;1.43
103260;240203;Urząd Gminy (Sala Posiedzeń)|Buczkowice|ul. Lipowska 730 |43-374 Buczkowice;1698;1026;1026;24;1002;60.42;2.34
103261;240203;Szkoła Podstawowa (Świetlica)|Rybarzowice|ul. Beskidzka 242 |43-378 Rybarzowice;1140;714;714;17;697;62.63;2.38
103262;240203;Szkoła Podstawowa (Sala Lekcyjna Nr 3)|Rybarzowice|ul. Beskidzka 242 |43-378 Rybarzowice;1583;854;854;24;830;53.95;2.81
103263;240203;Szkoła Podstawowa (Świetlica)|Godziszka|ul. Beskidzka 162 |43-376 Godziszka;1848;987;987;20;967;53.41;2.03
103264;240203;Szkoła Podstawowa (Sala Lekcyjna Nr 1)|Kalna|ul. Widokowa 66 |43-376 Godziszka;703;439;439;13;426;62.45;2.96
103265;240204;Gimnazjum Publiczne Nr 1|Czechowice-Dziedzice|ul. Polna 33 |43-502 Czechowice-Dziedzice;1951;1163;1163;18;1145;59.61;1.55
103266;240204;Szkoła Podstawowa Nr 2|Czechowice-Dziedzice|ul. Węglowa 54 |43-502 Czechowice-Dziedzice;1660;921;921;20;901;55.48;2.17
103267;240204;Zespół Szkół "Silesia"|Czechowice-Dziedzice|ul. Nad Białką 1e |43-502 Czechowice-Dziedzice;1828;853;853;26;827;46.66;3.05
103268;240204;Zespół Szkół Technicznych i Licealnych|Czechowice-Dziedzice|ul. R. Traugutta 11 |43-502 Czechowice-Dziedzice;1890;1103;1103;19;1084;58.36;1.72
103269;240204;Przedszkole Publiczne Nr 4|Czechowice-Dziedzice|ul. K.P. Tetmajera 18 |43-502 Czechowice-Dziedzice;1822;1096;1096;18;1078;60.15;1.64
103270;240204;Szkoła Podstawowa Nr 7|Czechowice-Dziedzice|ul. Szkolna 6 |43-502 Czechowice-Dziedzice;1790;1060;1060;13;1047;59.22;1.23
103271;240204;Strażnica OSP "Dziedzice"|Czechowice-Dziedzice|ul. Strażacka 1 |43-502 Czechowice-Dziedzice;961;527;527;4;523;54.84;0.76
103272;240204;Liceum Ogólnokształcące|Czechowice-Dziedzice|ul. M. Konopnickiej 9 |43-502 Czechowice-Dziedzice;2021;1137;1137;30;1107;56.26;2.64
103273;240204;Szkoła Podstawowa Nr 5|Czechowice-Dziedzice|ul. Klasztorna 21 |43-502 Czechowice-Dziedzice;1947;1207;1207;14;1193;61.99;1.16
103274;240204;Strażnica OSP "Czechowice"|Czechowice-Dziedzice|ul. Barlickiego 24 |43-502 Czechowice-Dziedzice;2005;1023;1023;20;1003;51.02;1.96
103275;240204;Szkoła Podstawowa Nr 4|Czechowice-Dziedzice|ul. Studencka 2 |43-502 Czechowice-Dziedzice;1702;857;857;20;837;50.35;2.33
103276;240204;Gimnazjum Publiczne Nr 3|Czechowice-Dziedzice|ul. I. Łukasiewicza 37 |43-502 Czechowice-Dziedzice;1349;705;705;14;691;52.26;1.99
103277;240204;Przedszkole Publiczne Nr 3|Czechowice-Dziedzice|ul. Junacka 2 |43-502 Czechowice-Dziedzice;1470;825;825;15;810;56.12;1.82
103278;240204;Strażnica OSP "Czechowice"|Czechowice-Dziedzice|ul. Zamkowa 74 |43-502 Czechowice-Dziedzice;1341;771;771;22;749;57.49;2.85
103279;240204;Szkoła Podstawowa Nr 3|Czechowice-Dziedzice|ul. Lipowska 26 |43-502 Czechowice-Dziedzice;1947;1285;1285;33;1252;66.00;2.57
103280;240204;Zespół Szkolno Przedszkolny Nr 1|Czechowice-Dziedzice|ul. Chłopska 70 |43-502 Czechowice-Dziedzice;2083;1247;1247;34;1213;59.87;2.73
103281;240204;Strażnica OSP|Zabrzeg|ul. T. Gazdy 3 |43-516 Zabrzeg;1347;816;816;14;802;60.58;1.72
103282;240204;Zespół Szkół|Zabrzeg|ul. K. Pytla 1 |43-516 Zabrzeg;1301;783;783;17;766;60.18;2.17
103283;240204;Szkoła Podstawowa Nr 2|Ligota|ul. Miliardowicka 46 |43-518 Ligota;1724;992;992;23;969;57.54;2.32
103284;240204;Szkoła Podstawowa Nr 3|Ligota|ul. Bory 2 |43-518 Ligota;828;478;478;11;467;57.73;2.30
103285;240204;Zespół Szkół|Ligota|ul. Bielska 17 |43-518 Ligota;1158;675;675;24;651;58.29;3.56
103286;240204;Zespół Szkolno-Przedszkolny|Bronów|ul. Kolorowa 2 |43-502 Czechowice-Dziedzice;862;572;572;14;558;66.36;2.45
103287;240204;Dom Pomocy Społecznej|Czechowice-Dziedzice|ul. Zacisze 28 |43-502 ;24;17;17;1;16;70.83;5.88
103288;240205;Zespół Szkolno-Przedzkolny w Wieszczętach|Bielowicko, Wieszczeta| 50 |43-386 Świętoszówka;888;481;481;14;467;54.17;2.91
103289;240205;Gminny Ośrodek Kultury w Jasienicy Filia w Bierach|Biery| 219 |43-386 Świętoszówka;1026;671;671;17;654;65.40;2.53
103290;240205;Zespół Szkolno-Przedrzedszkolny w Grodźcu|Grodziec| 9 |43-386 Świętoszówka;980;558;559;11;547;56.94;1.97
103291;240205;Zespół Szkolno-Przedszkolny w Iłownicy|Iłownica| 127 |43-394 Rudzica;789;415;415;10;405;52.60;2.41
103292;240205;Zespół Szkolno-Przedszkolny w Jasienicy|Jasienica| 271 |00-000 Jasienica;1701;967;967;21;946;56.85;2.17
103293;240205;Urząd Gminy w Jasienicy|Jasienica| 159 |43-385 Jasienica;1772;1013;1013;21;992;57.17;2.07
103294;240205;Budynek sportowo-kulturalny w Jasienicy|Jasienica| 1360 |43-385 Jasienica;687;420;420;3;417;61.14;0.71
103295;240205;Ochotnicza Straż Pożarna w Landeku|Landek| 79 |43-394 Rudzica;461;244;244;7;237;52.93;2.87
103296;240205;Gminny Ośrodek Kultury w Jasienicy filia w Rudzicy|Rudzica| 124 |43-394 Rudzica;1416;851;851;16;835;60.10;1.88
103297;240205;Gimnazjum im. Jana Pawła II w Rudzicy|Rudzica| 52 |43-394 Rudzica;881;517;517;7;510;58.68;1.35
103298;240205;Szkoła Podstawowa w Świętoszówce filia Łazy|Łazy| 41 |43-386 Świętoszówka;702;415;415;18;397;59.12;4.34
103299;240205;Gminny Ośrodek Kultury w Jasienicy filia Mazańcowice|Mazańcowice| 347 |43-391 Mazańcowice;1050;695;695;11;684;66.19;1.58
103300;240205;Zespół Szkolno-Przedszkolny w Mazańcowicach|Mazańcowice| 162 |43-391 Mazańcowice;831;488;488;6;482;58.72;1.23
103301;240205;Ochotnicza Straż Pożarna w Mazańcowicach|Mazańcowice| 350 |43-391 Mazańcowice;931;601;601;5;596;64.55;0.83
103302;240205;Budynek Kulturalno-sportowy w Międzyrzeczu Dolnym|Międzyrzecze Dolne| 214 |43-392 Międzyrzecze Górne;875;480;480;13;467;54.86;2.71
103303;240205;Zespół Szkolno-Przedszkolny w Międzyrzeczu Górnym|Międzyrzecze Górne| 81 |43-392 Międzyrzecze Górne;800;495;495;13;482;61.88;2.63
103304;240205;Gminny Ośrodek Kultury w Jasienicy filia w Międzyrzeczu Górnym "Chata Międzyrzecze"|Międzyrzecze Górne| 511 |43-392 Międzyrzecze Górne;1160;698;698;38;660;60.17;5.44
103305;240205;Ochotnicza Straż Pożarna w Roztropicach|Roztropce| 145 |43-394 Rudzica;573;276;276;10;266;48.17;3.62
103306;240205;Zespół Szkolno-Przedrzedszkolny w Świętoszówce|Świętoszówka| 40 |43-386 Świętoszówka;494;273;273;9;264;55.26;3.30
103307;240206;Szkoła Podstawowa Nr 1 im. Marii Dąbrowskiej|Jaworze|ul. Szkolna 180 |43-384 Jaworze;1723;1046;1048;27;1019;60.71;2.58
103308;240206;Szkoła Podstawowa Nr 1 im. Marii Dąbrowskiej|Jaworze|ul. Szkolna 180 |43-384 Jaworze;1632;913;914;16;897;55.94;1.75
103309;240206;Szkoła Podstawowa Nr 1 im. Marii Dąbrowskiej|Jaworze|Szkolna 180 |43-384 Jaworze;2195;1363;1363;12;1351;62.10;0.88
103310;240206;Beskidzki Zespół Leczniczo-Rehabilitacyjny w Jaworzu|Jaworze|Słoneczna 83 |43-384 Jaworze;101;70;70;3;67;69.31;4.29
103311;240207;Szkoła Podstawowa Nr 1 /nowy segment budynku/|Kozy|Plac Ks. K. Kochaja 1 |43-340 Kozy;2116;1315;1316;24;1291;62.15;1.83
103312;240207;Szkoła Podstawowa Nr 1 /stary segment budynku/|Kozy|Plac Ks. K. Kochaja 1 |43-340 Kozy;1717;1080;1080;14;1066;62.90;1.30
103313;240207;Szkoła Podstawowa Nr 2|Kozy|ul. Przecznia 1 |43-340 Kozy;1833;1052;1052;20;1032;57.39;1.90
103314;240207;Pałac w Kozach - czytelnia|Kozy|ul. Krakowska 5 |43-340 Kozy;2185;1335;1335;40;1295;61.10;3.00
103315;240207;Strażnica OSP|Kozy|ul. Bielska 15 |43-340 Kozy;2138;1211;1212;24;1187;56.64;1.98
103316;240208;Zespół Szkół|Bujaków|ul. Szkolna 13 |43-356 Kobiernice;1802;1021;1021;13;1008;56.66;1.27
103317;240208;Szkoła Podstawowa|Czaniec|ul. Kardynała Karola Wojtyły 32 |43-354 Czaniec;1333;762;762;22;740;57.16;2.89
103318;240208;Szkoła Podstawowa|Czaniec|ul. Kardynała Karola Wojtyły 32 |43-354 Czaniec;1509;881;881;19;862;58.38;2.16
103319;240208;Szkoła Podstawowa|Czaniec|ul. Kardynała Karola Wojtyły 32 |43-354 Czaniec;1670;1005;1005;15;990;60.18;1.49
103320;240208;Zespół Szkół|Kobiernice|ul.Szkolna 1 |43-356 Kobiernice;1823;953;953;31;922;52.28;3.25
103321;240208;Zespół Szkół|Kobiernice|ul.Szkolna 1 |43-356 Kobiernice;967;528;528;7;521;54.60;1.33
103322;240208;Urząd Gminy Porąbka|Porąbka|ul.Krakowska 3 |43-353 Porąbka;1593;905;905;42;863;56.81;4.64
103323;240208;Wiejski Dom Kultury|Porąbka|ul.Rynek 22 |43-353 Porąbka;1603;881;881;33;848;54.96;3.75
103324;240209;Urząd Gminy w Wilamowicach|Wilamowice|Rynek 1 |43-330 Wilamowice;2367;1485;1485;32;1453;62.74;2.15
103325;240209;Zespół Szkolno-Przedszkolny w Starej Wsi - budynek przedszkola w Dankowicach|Dankowice|ul. św. Wojciecha 25 |43-331 Dankowice;2259;1285;1285;33;1252;56.88;2.57
103326;240209;Zespół Szkolno - Przedszkolny Hecznarowice|Hecznarowice|ul. Krakowska 110 |43-330 Wilamowice;1914;1199;1199;37;1162;62.64;3.09
103327;240209;Gimnazjum Pisarzowice|Pisarzowice|ul. św. Floriana 28 |43-332 Pisarzowice;1800;1103;1103;26;1077;61.28;2.36
103328;240209;Gimnazjum Pisarzowice|Pisarzowice|ul. św. Floriana 28 |43-332 Pisarzowice;1661;933;933;26;907;56.17;2.79
103329;240209;Gimnazjum Pisarzowice|Pisarzowice|ul. św. Floriana 28 |43-332 Pisarzowice;873;462;462;16;446;52.92;3.46
103330;240209;Zespół Szkolno - Przedszkolny Stara Wieś|Stara Wieś|ul. Dolna 12 |43-330 Wilamowice;1622;961;961;36;925;59.25;3.75
103331;240209;Dom Ludowy w Zasolu Bielańskim|Zasole Bielańskie|ul. Piękna 64 |43-330 Wilamowice;685;390;390;23;367;56.93;5.90
103332;240210;Gimnazjum|Wilkowice|ul. Szkolna 8 |43-365 Wilkowice;1440;804;804;12;792;55.83;1.49
103333;240210;Przedszkole Publiczne|Wilkowice|ul. Strażacka 13 |43-365 Wilkowice;1321;741;741;9;732;56.09;1.21
103334;240210;Szkoła Podstawowa|Wilkowice|ul. Kościelna 10 |43-365 Wilkowice;1373;813;813;17;796;59.21;2.09
103335;240210;Urząd Gminy|Wilkowice|ul. Wyzwolenia 25 |43-365 Wilkowice;1258;732;732;17;715;58.19;2.32
103336;240210;Przedszkole Publiczne|Bystra|ul. Przedszkolna 3 |43-360 Bystra;1304;848;848;11;837;65.03;1.30
103337;240210;Szkoła Podstawowa|Bystra|ul. Klimczoka 68 |43-360 Bystra;2080;1252;1252;8;1244;60.19;0.64
103338;240210;Szkoła Podstawowa|Meszna|ul. Szkolna 1 |43-360 Bystra;1703;951;951;12;939;55.84;1.26
103339;240210;Szpital Kolejowy w Wilkowicach|Wilkowice|Żywiecka 19 -|43-365 Wilkowice;124;60;60;2;58;48.39;3.33
103340;240210;Centrum Pulmonologii i Torakochirurgii w Bystrej|Bystra|Juliana Fałata 2 -|43-360 Bystra;147;98;98;4;94;66.67;4.08
103341;240210;Dom Pomocy Społecznej w Wilkowicach|Wilkowice|Kościelna 5 -|43-365 Wilkowice;51;33;33;4;29;64.71;12.12
103342;240210;Rodzinny Dom "Senior"|Bystra|Szczyrkowska 136 -|43-360 Bystra;36;9;9;0;9;25.00;0.00
103343;240301;PPG Polifarb Cieszyn S.A.|Cieszyn|ul. Chemików 4 |43-400 Cieszyn;750;345;345;6;339;46.00;1.74
103344;240301;Ochotnicza Straż Pożarna|Cieszyn|ul. Motokrosowa 18 |43-400 Cieszyn;737;402;402;5;397;54.55;1.24
103345;240301;Zespół Szkół Technicznych|Cieszyn|ul. Frysztacka 48 |43-400 Cieszyn;1160;649;649;12;637;55.95;1.85
103346;240301;Szkoła Podstawowa Nr 6|Cieszyn|ul. Katowicka 68 |43-400 Cieszyn;1908;1151;1151;12;1139;60.32;1.04
103347;240301;Niepubliczne Przedszkole im. Jasia i Małgosi|Cieszyn|ul. Przepilińskiego 5 |43-400 Cieszyn;946;556;556;9;547;58.77;1.62
103348;240301;Ochotnicza Straż Pożarna|Cieszyn|ul. Kościuszki 3 |43-400 Cieszyn;1739;999;999;17;982;57.45;1.70
103349;240301;Ochotnicza Straż Pożarna|Cieszyn|ul. Bielska 160A |43-400 Cieszyn;929;540;540;28;512;58.13;5.19
103350;240301;Przedszkole Nr 19|Cieszyn|ul. Skrajna 5 |43-400 Cieszyn;1575;871;871;14;857;55.30;1.61
103351;240301;Gimnazjum Nr 2 z Oddziałami Integracyjnymi im. J. Kubisza|Cieszyn|ul. Szymanowskiego 9 |43-400 Cieszyn;967;534;534;18;516;55.22;3.37
103352;240301;Szkoła Podstawowa Nr 2|Cieszyn|ul. Chopina 37 |43-400 Cieszyn;1310;712;712;16;696;54.35;2.25
103353;240301;Przedszkole Nr 20|Cieszyn|ul. św. Jerzego 4 |43-400 Cieszyn;1703;950;950;16;934;55.78;1.68
103354;240301;Gimnazjum Nr 1|Cieszyn|ul. Michejdy 1 |43-400 Cieszyn;1090;489;489;8;481;44.86;1.64
103355;240301;Zespół Szkół Budowlanych im. gen. Grota Roweckiego|Cieszyn|pl. Dominikański 1 |43-400 Cieszyn;734;361;361;12;349;49.18;3.32
103356;240301;Zespół Szkół Ekonomiczno - Gastronomicznych|Cieszyn|pl. Londzina 3 |43-400 Cieszyn;1137;544;544;16;528;47.85;2.94
103357;240301;II Liceum Ogólnokształcące im. M. Kopernika|Cieszyn|pl. Wolności 7B |43-400 Cieszyn;1134;586;586;6;580;51.68;1.02
103358;240301;Szkolne Schronisko Młodzieżowe|Cieszyn|ul. Błogocka 24 |43-400 Cieszyn;1684;883;883;18;865;52.43;2.04
103359;240301;Żłobki Miejskie Oddział Nr 1|Cieszyn|ul. Trzanowskiego 2 |43-400 Cieszyn;1664;770;770;21;749;46.27;2.73
103360;240301;Przedszkole Nr 16|Cieszyn|ul. Bielska 75 |43-400 Cieszyn;1587;852;852;27;825;53.69;3.17
103361;240301;Spółdzielnia Mieszkaniowa "Cieszynianka"|Cieszyn|ul. Kossak-Szatkowskiej 6 |43-400 Cieszyn;1746;1089;1089;10;1079;62.37;0.92
103362;240301;Przedszkole Nr 18|Cieszyn|ul. Kossak-Szatkowskiej 6 |43-400 Cieszyn;1139;673;673;20;653;59.09;2.97
103363;240301;Ochotnicza Straż Pożarna|Cieszyn|ul. gen. Józefa Hallera 161 |43-400 Cieszyn;1633;1070;1070;12;1058;65.52;1.12
103364;240301;Szpital Śląski|Cieszyn|Bielska 4 |43-400 ;402;77;77;0;77;19.15;0.00
103365;240301;Powiatowy Dom Pomocy Społecznej "Pogodna Jesień"|Cieszyn|Korfantego 1 |43-400 ;70;35;35;1;34;50.00;2.86
103366;240301;Zakład Karny|Cieszyn|Bolesława Chrobrego 2 |43-400 Cieszyn;381;167;167;22;145;43.83;13.17
103367;240302;Szkoła Podstawowa Nr 3|Ustroń, Polana|ul. Polańska 25 |43-450 Ustroń;1163;587;587;9;578;50.47;1.53
103368;240302;Państwowe Gospodarstwo Leśne Lasy Państwowe Nadleśnictwo|Ustroń, Poniwiec|ul. 3 Maja 108 |43-450 Ustroń;767;400;400;4;396;52.15;1.00
103369;240302;Przedszkole Nr 7|Ustroń|ul. K.I.Gałczyńskiego 16 |43-450 Ustroń;2110;1207;1207;16;1191;57.20;1.33
103370;240302;Szkoła Podstawowa Nr 1|Ustroń|ul. Partyzantów 2 |43-450 Ustroń;1411;845;845;15;830;59.89;1.78
103371;240302;Szkoła Podstawowa Nr 2|Ustroń|ul. Ignacego Daszyńskiego 31 |43-450 Ustroń;2089;1158;1158;27;1131;55.43;2.33
103372;240302;Przedszkole Nr 4|Ustroń, Hermanice|ul. Wiśniowa 13 |43-450 Ustroń;2034;1135;1135;16;1119;55.80;1.41
103373;240302;Szkoła Podstawowa nr 5|Ustroń, Lipowiec|ul. Szkolna 1 |43-450 Ustroń;1286;665;665;24;641;51.71;3.61
103374;240302;Szkoła Podstawowa Nr 6|Ustroń, Nierodzim|ul. Józefa Kreta 6 |43-450 Ustroń;1231;665;665;17;648;54.02;2.56
103375;240302;Gimnazjum Nr 2|Ustroń|ul. Ignacego Daszyńskiego 31 |43-450 Ustroń;1005;590;590;6;584;58.71;1.02
103376;240302;Przedsiębiorswo Uzdrowiskowe "USTROŃ" S.A.|Ustroń|Sanatoryjna 7 |43-450 Ustroń;1199;656;656;15;641;54.71;2.29
103377;240302;Śląskie Centrum Reumatologii, Rehabilitacji i Zapobiegania Niepełnosprawności im.gen.Jerzego Ziętka|Ustroń|Szpitalna 11 |43-450 Ustroń;182;129;129;4;125;70.88;3.10
103378;240302;Śląskie Centrum Rehabilitacji i Prewencji w Ustroniu|Ustroń|Zdrojowa 6 |43-450 Ustroń;143;100;100;1;99;69.93;1.00
103379;240302;Miejski Dom Spokojnej Starości|Ustroń|Słoneczna 10 |43-450 Ustroń;33;33;33;7;26;100.00;21.21
103380;240303;Państwowa Szkoła Muzyczna I stopnia w Cieszynie Filia w Wiśle|Wisła|ul. 1 Maja 66 |43-460 Wisła;562;273;273;7;266;48.58;2.56
103381;240303;Szkoła Podstawowa Nr 1|Wisła|Plac Hoffa 5 |43-460 Wisła;1219;626;626;17;609;51.35;2.72
103382;240303;Szkoła Podstawowa Nr 1|Wisła|Plac Hoffa 5 |43-460 Wisła;1187;638;638;12;626;53.75;1.88
103383;240303;Szkoła Podstawowa Nr 5|Wisła|ul. Jawornik 58 |43-460 Wisła;1176;608;608;22;586;51.70;3.62
103384;240303;Szkoła Podstawowa Nr 4|Wisła|ul. Kopydło 74 |43-460 Wisła;2020;914;914;16;898;45.25;1.75
103385;240303;Remiza OSP Wisła-Malinka|Wisła|ul. Malinka 18 |43-460 Wisła;1425;598;598;8;590;41.96;1.34
103386;240303;Remiza OSP Wisła-Czarne|Wisła|ul. Biała Wisełka 22 |43-460 Wisła;656;325;325;6;319;49.54;1.85
103387;240303;Klub Sportowy "Wisła"|Wisła|ul. Wyzwolenia 67 |43-460 Wisła;1027;500;500;9;491;48.69;1.80
103388;240304;Świetlica przy Klasztorze oo Franciszkanów w Górkach Wielkich - Sojka|Górki Wielkie|Zofii Kossak 130 |43-436 Górki Wielkie;1232;677;677;17;660;54.95;2.51
103389;240304;Zespół Szkół Publicznych w Górkach Wielkich|Górki Wielkie|Szkolna 1 |43-436 Górki Wielkie;1353;742;742;13;729;54.84;1.75
103390;240304;Zespół Szkół Publicznych w Górkach Wielkich|Górki Wielkie|Szkolna 1 |43-436 Górki Wielkie;1230;610;610;27;583;49.59;4.43
103391;240304;Szkoła Podstawowa Nr 1 w Brennej Leśnicy|Brenna|Leśnica 103 |43-438 Brenna;787;437;437;19;418;55.53;4.35
103392;240304;Gimnazjum w Brennej|Brenna|Górecka 224 |43-438 Brenna;978;480;480;10;470;49.08;2.08
103393;240304;Gimnazjum w Brennej|Brenna|Górecka 224 |43-438 Brenna;1090;500;500;15;485;45.87;3.00
103394;240304;Budynek Amfiteatru w Brennej Centrum|Brenna|Malinowa 2b |43-438 Brenna;2095;1054;1054;28;1026;50.31;2.66
103395;240305;Szkoła Podstawowa Nr 1|Chybie|ul. Bielska 80 |43-520 Chybie;1769;1046;1046;31;1015;59.13;2.96
103396;240305;Szkoła Podstawowa Nr 1|Chybie|ul. Bielska 80 |43-520 Chybie;1559;769;769;20;749;49.33;2.60
103397;240305;Dom Kultury|Chybie|ul. Cieszyńska 2 |43-520 Chybie;1465;764;764;36;728;52.15;4.71
103398;240305;Szkoła Podstawowa im. Pawła Kojzara w Mnichu|Mnich|ul. Kopernika 12 |43-520 Chybie;1913;1081;1081;44;1037;56.51;4.07
103399;240305;Zespół Szkolno-Przedszkolny w Zaborzu|Zaborze|ul. K. Miarki 7 |43-520 Chybie;815;457;457;25;432;56.07;5.47
103400;240306;"Stara Szkoła"|Dębowiec|Szkolna 5 |43-426 Dębowiec;1488;820;820;33;787;55.11;4.02
103401;240306;Remiza Ochotniczej Straży Pożarnej|Kostkowice|Dworska 1 |43-426 Dębowiec;413;213;213;4;209;51.57;1.88
103402;240306;Remiza Ochotniczej Straży Pożarnej|Simoradz|Sportowa 9 |43-426 Dębowiec;819;406;406;10;396;49.57;2.46
103403;240306;Szkoła Podstawowa|Iskrzyczyn|Mirów 6 |43-426 Dębowiec;507;256;256;5;251;50.49;1.95
103404;240306;Środowiskowy Ośrodek Kultury|Ogrodzona| 32 |43-426 Dębowiec;1321;692;692;24;668;52.38;3.47
103405;240307;Gimnazjum|Goleszów|ul. Szkolna 2 |43-440 Goleszów;1393;752;752;14;738;53.98;1.86
103406;240307;Dom Kultury|Goleszów|ul. Cieszyńska 25 |43-440 Goleszów;1341;684;684;15;669;51.01;2.19
103407;240307;Dom Ludowy|Goleszów|ul. Osiedlowa 13 |43-440 Goleszów;799;416;416;13;403;52.07;3.12
103408;240307;OSP|Bażanowice|ul. Cieszyńska 17 |43-440 Goleszów;979;445;445;8;437;45.45;1.80
103409;240307;OSP|Kozakowice Górne|ul. dra Andrzeja Cinciały 35 |43-440 Goleszów;567;290;290;2;288;51.15;0.69
103410;240307;Szkoła Podstawowa|Kisielów|ul. Wiejska 8 |43-440 Goleszów;573;300;300;4;296;52.36;1.33
103411;240307;OSP|Godziszów| 150 |43-440 Goleszów;487;222;222;5;217;45.59;2.25
103412;240307;Szkoła Podstawowa|Dzięgielów|ul. Cieszyńska 4 |43-445 Dzięgielów;1076;611;611;7;604;56.78;1.15
103413;240307;Punkt Przedszkolny|Puńców|ul. Szkolna 2 |43-400 Cieszyn;1305;654;654;12;642;50.11;1.83
103414;240307;Świetlica Gminna|Cisownica|Cisowa 122 |43-440 Goleszów;1389;684;684;9;675;49.24;1.32
103415;240307;Świetlica Gminna|Leszna Górna|ul. Główna 54 |43-445 Dzięgielów;436;217;217;8;209;49.77;3.69
103416;240307;Ewangelicki Dom Opieki "EMAUS"|Dzięgielów|ks. Karola Kulisza 47 |43-445 Dzięgielów;100;57;57;0;57;57.00;0.00
103417;240308;Dom Wiejski|Brzezówka|ul. Jagodowa 3 |43-418 Pogwizdów;562;253;253;7;246;45.02;2.77
103418;240308;Szkoła Podstawowa|Hażlach|ul. Kościelna 2 |43-419 Hażlach;1887;994;994;22;972;52.68;2.21
103419;240308;Szkoła Podstawowa|Kończyce Wielkie|ul. Kościelna 12 |43-419 Hażlach;1494;792;792;18;774;53.01;2.27
103420;240308;Szkoła Podstawowa|Pogwizdów|ul. Katowicka 34 |43-418 Pogwizdów;1745;917;917;15;902;52.55;1.64
103421;240308;Dom Kultury|Pogwizdów|ul. Północna 5 |43-418 Pogwizdów;1070;509;509;15;494;47.57;2.95
103422;240308;Dom Wiejski|Rudnik|ul. Leśna 3 |43-419 Hażlach;372;195;195;7;188;52.42;3.59
103423;240308;Szkoła Podstawowa|Zamarski|ul. Szkolna 1 |43-419 Hażlach;1101;553;553;28;525;50.23;5.06
103424;240309;Gminny Ośrodek Kultury,Promocji,Informacji Turystycznej i Biblioteki Publicznej w Istebnej|Istebna| 68 |43-470 Istebna;2049;1161;1161;36;1125;56.66;3.10
103425;240309;Gimnazjum im. Jana Pawła II w Istebnej|Istebna| 1345 |43-470 Istebna;1850;979;979;33;946;52.92;3.37
103426;240309;Szkoła Podstawowa nr 1 im. Jana Twardowskiego w Jaworzynce|Jaworzynka| 366 |43-476 Jaworzynka;1205;689;689;32;657;57.18;4.64
103427;240309;Szkoła Podstawowa nr 1 im. Jana Twardowskiego w Jaworzynce|Jaworzynka| 366 |43-476 Jaworzynka;1196;589;589;33;556;49.25;5.60
103428;240309;Szkoła Podstawowa nr 1 im. Stanisława Wyspiańskiego w Koniakowie|Koniaków| 280 |43-474 Koniaków;1659;819;819;32;787;49.37;3.91
103429;240309;Szkoła Podstawowa nr 1 im. Stanisława Wyspiańskiego w Koniakowie|Koniaków| 280 |43-474 Koniaków;1152;542;542;29;513;47.05;5.35
103430;240310;Zespół Szkół Technicznych i Ogólnokształcących w Skoczowie|Skoczów|ul. Bielska 34 |43-430 Skoczów;1321;747;747;11;736;56.55;1.47
103431;240310;Zespół Szkół Technicznych i Ogólnokształcących w Skoczowie|Skoczów|Bielska 34 |43-430 Skoczów;710;385;385;4;381;54.23;1.04
103432;240310;Szkoła Podstawowa nr 3 im. Jana Pawla II w Skoczowie|Skoczów|Osiedlowa 1 |43-430 Skoczów;961;447;447;16;431;46.51;3.58
103433;240310;Skoczowski Ośrodek Sportu i Rekreacji - Stadion Miejski "BESKID" im. Rudolfa Kukucza|Skoczów|ul. Sportowa 6 |43-430 Skoczów;505;210;210;8;202;41.58;3.81
103434;240310;Skoczowskie Przedsiębiorstwo Komunalne Sp. z o.o.|Skoczów|Krzywa 4 |43-430 Skoczów;662;371;371;9;362;56.04;2.43
103435;240310;Przedszkole Publiczne nr 4 w Skoczowie z oddziałami zamiejscowymi w Międzyświeciu|Skoczów|ul. Gustawa Morcinka 20 |43-430 Skoczów;926;428;428;7;421;46.22;1.64
103436;240310;Zespół Szkół nr 1 w Skoczowie|Skoczów|ul. Gustawa Morcinka 20 |43-430 Skoczów;2289;1229;1229;28;1201;53.69;2.28
103437;240310;Przedszkole Publiczne nr 2 w Skoczowie|Skoczów|ul. Targowa 19 |43-430 Skoczów;1125;572;572;14;558;50.84;2.45
103438;240310;Zespół Szkół nr 3 w Skoczowie|Skoczów|ul. Mickiewicza 11 |43-430 Skoczów;1275;691;691;11;680;54.20;1.59
103439;240310;Gimnazjum nr 2 w Skoczowie|Skoczów|ul. Bielska 17 |43-430 Skoczów;1496;783;783;13;770;52.34;1.66
103440;240310;Zespół Szkolno - Przedszkolny|Kiczyce|ul. Długa 52 |43-430 Skoczów;876;450;450;9;441;51.37;2.00
103441;240310;Zespół Szkół w Pierśćcu|Pierściec|ul. Jerzego Tomanka 8 |43-430 Skoczów;1064;567;567;16;551;53.29;2.82
103442;240310;Zespół Szkół w Pierśćcu|Pierściec|ul. Jerzego Tomanka 8 |43-430 Skoczów;438;255;255;4;251;58.22;1.57
103443;240310;Ochotnicza Straż Pożarna w Kowalach|Kowale|ul. Pożarnicza 2 |43-430 Skoczów;535;282;282;7;275;52.71;2.48
103444;240310;Zespół Szkolno - Przedszkolny w Pogórzu|Pogórze|ul. Zamek 8 |43-430 Skoczów;1391;739;739;25;714;53.13;3.38
103445;240310;Dom Rolnika w Harbutowicach|Harbutowice|ul.Chabrowa 6 |43-430 Skoczów;723;378;378;2;376;52.28;0.53
103446;240310;Świetlica Wiejska w Bładnicach|Bładnice Dolne|Świetlicowa 2 |43-430 Skoczów;667;347;347;8;339;52.02;2.31
103447;240310;Filia Przedszkola Publicznego nr 4 w Międzyświeciu|Międzyświeć|ul. Malinowa 2 |43-430 Skoczów;1252;611;611;16;595;48.80;2.62
103448;240310;Oddział Zamiejscowy Przedszkola Publicznego w Ochabach|Wiślica|ul. Powiatowa 85 |43-430 Skoczów;580;297;297;8;289;51.21;2.69
103449;240310;Przedszkole Publiczne w Ochabach|Ochaby Małe|ul. Gołyska 12 |43-430 Skoczów;641;348;348;9;339;54.29;2.59
103450;240310;Przedszkole Publiczne w Ochabach|Ochaby Małe|ul. Gołyska 12 |43-430 Skoczów;1024;555;555;21;534;54.20;3.78
103451;240310;Powiatowy Dom Pomocy Społecznej "Feniks"|Skoczów|Sportowa 13 |43-430 Skoczów;39;17;17;2;15;43.59;11.76
103452;240310;Powiatowy Dom Pomocy Społecznej w Pogórzu|Pogórze|Zamek 132 |43-430 Skoczów;65;32;32;8;24;49.23;25.00
103453;240310;Centrum Psychiatrii w Katowicach - Oddział Terapii Uzależnienia od Alkoholu|Skoczów|Katowicka 21 |43-430 Skoczów;20;8;8;0;8;40.00;0.00
103454;240311;Gimnazjum|Strumień|ul. 1 Maja 38 |43-246 Strumień;1454;858;858;18;840;59.01;2.10
103455;240311;Szkoła Podstawowa|Strumień|ul. Młyńska 8 |43-246 Strumień;1307;782;782;18;764;59.83;2.30
103456;240311;Zespół Szkół (wejście od ul. Głównej)|Pruchna|ul. Główna 60 |43-523 Pruchna;893;446;446;9;437;49.94;2.02
103457;240311;Zespół Szkół (wejście od ul. Szkolnej)|Pruchna|ul. Główna 60 |43-523 Pruchna;1133;624;624;18;606;55.08;2.88
103458;240311;Zespół Szkół|Drogomyśl|ul. Główna 15 |43-424 Drogomyśl;1762;899;899;32;867;51.02;3.56
103459;240311;Świetlica Wiejska|Bąków|ul. Osiedlowa 1 |43-246 Strumień;1388;794;794;13;781;57.20;1.64
103460;240311;Zespół Szkolno-Przedszkolny|Zabłocie|ul. Bielska 36 |43-246 Strumień;1106;574;574;27;547;51.90;4.70
103461;240311;Przedszkole|Zbytków|ul. Wyzwolenia 49 |43-246 Zbytków;1092;708;708;20;688;64.84;2.82
103462;240312;Remiza OSP|Marklowice Górne|ul. Szkolna 10 |43-410 Zebrzydowice;854;493;493;5;488;57.73;1.01
103463;240312;Szkoła Podstawowa|Zebrzydowice|ul. Orzeszkowej 73 |43-410 Zebrzydowice;1514;880;880;23;857;58.12;2.61
103464;240312;Urząd Gminy|Zebrzydowice|ul. Ks. Janusza 6 |43-410 Zebrzydowice;1344;782;782;15;767;58.18;1.92
103465;240312;Urząd Gminy|Zebrzydowice|ul. Ks. Janusza 6 |43-410 Zebrzydowice;1445;911;911;21;890;63.04;2.31
103466;240312;Szkoła Podstawowa|Kończyce Małe|ul. Jagiellońska 56 |43-410 Zebrzydowice;1362;807;807;22;785;59.25;2.73
103467;240312;Szkoła Podstawowa|Kończyce Małe|ul. Jagiellońska 56 |43-410 Zebrzydowice;1220;711;711;14;697;58.28;1.97
103468;240312;Zespół Szkół|Kaczyce|ul. Harcerska 13 |43-417 Kaczyce;1248;708;708;17;691;56.73;2.40
103469;240312;Zespół Szkół|Kaczyce|ul. Harcerska 13 |43-417 Kaczyce;1178;573;573;23;550;48.64;4.01
103470;240401;Ochotnicza Straż Pożarna|Blachownia|ul. Plac Wolności 2 |42-290 Blachownia;2113;1111;1111;24;1087;52.58;2.16
103471;240401;Szkoła Podstawowa Nr 1|Blachownia|ul.Sienkiewicza 8 |42-290 Blachownia;2141;1073;1073;26;1047;50.12;2.42
103472;240401;Hala widowiskowo - sportowa w Blachowni|Blachownia|ul.Sportowa 1 |42-290 Blachownia;2093;952;952;40;912;45.48;4.20
103473;240401;Zespół Szkolno-Przedszkolny w Blachowni|Blachownia|ul.Wspólna 5 |42-290 Blachownia;1398;752;752;19;733;53.79;2.53
103474;240401;Zespół Szkolno-Przedszkolny w Łojkach|Łojki|ul.Długa 48 |42-290 Blachownia;2197;1026;1026;29;997;46.70;2.83
103475;240401;Publiczna Szkoła Podstawowa|Cisie|ul.Cisiańska 46 |42-290 Blachownia;569;252;252;7;245;44.29;2.78
103476;240401;Szpital im. Rudolfa Weigla|Blachownia|ul. Sosnowa 16 |42-290 ;47;13;13;1;12;27.66;7.69
103477;240401;Dom Pomocy Społecznej|Blachownia|ul. Sienkiewicza 6 |42-290 ;115;52;52;9;43;45.22;17.31
103478;240402;Zespół Szkół|Dąbrowa Zielona|Pl. Kościuszki 49 |42-265 ;1202;547;547;34;513;45.51;6.22
103479;240402;Szkoła Podstawowa|Olbrachcice| 146 |42-265 ;1107;378;378;17;361;34.15;4.50
103480;240402;Remiza OSP|Cielętniki|ul. Placowa 2 |42-265 ;360;143;143;9;134;39.72;6.29
103481;240402;Środowiskowy Dom Samopomocy|Soborzyce|Pl. Wolności 1 |42-265 ;718;327;327;16;311;45.54;4.89
103482;240403;Filia Gminnej Biblioteki Publicznej|Żuraw|ul. Kościelna 19 |42-253 Janów;667;296;296;8;288;44.38;2.70
103483;240403;Szkoła Podstawowa|Lusławice| 70 |42-253 Janów;313;167;167;5;162;53.35;2.99
103484;240403;Szkoła Podstawowa im. Św. St. Kostki|Lgoczanka| 1a |42-253 Janów;720;300;300;8;292;41.67;2.67
103485;240403;Gimnazjum im. Armii Krajowej|Piasek|ul. Żurawska 2 |42-253 Janów;705;258;258;8;250;36.60;3.10
103486;240403;Szkolne Schronisko Młodzieżowe|Siedlec|ul. Szkolna 8 |42-253 Janów;448;192;192;8;184;42.86;4.17
103487;240403;Zespół Szkolno-Przedszkolny|Janów|Szkolna 2 |42-253 Janów;1171;593;593;12;581;50.64;2.02
103488;240403;Przedszkole|Złoty Potok|Plac Chrzciciela 31 |42-253 Janów;895;450;450;13;437;50.28;2.89
103489;240404;Gminny Ośrodek Kultury Sportu i Rekreacji|Kamienica Polska|ul. Konopnickiej 135 |42-260 Kamienica Polska;1491;735;735;18;717;49.30;2.45
103490;240404;Gminna Hala Sportowa|Kamienica Polska|ul. Konopnickiej 12B |42-260 Kamienica Polska;1192;631;631;15;616;52.94;2.38
103491;240404;Przedszkole|Rudnik Wielki|ul. Słoneczna 186 |42-260 Kamienica Polska;775;336;336;6;330;43.35;1.79
103492;240404;Szkoła Podstawowa|Osiny|ul. Częstochowska 165 |42-260 Kamienica Polska;657;304;304;15;289;46.27;4.93
103493;240404;Przedszkole|Zawisna| 69 |42-260 Kamienica Polska;494;205;205;10;195;41.50;4.88
103494;240405;Szkoła Kłomnice|Kłomnice|ul. Szkolna 1 |42-270 Kłomnice;2385;1234;1234;23;1211;51.74;1.86
103495;240405;Gminny Ośrodek Kultury Kłomnice|Kłomnice|ul. Częstochowska 96 |42-270 Kłomnice;685;267;267;22;245;38.98;8.24
103496;240405;Szkoła Witkowice|Witkowice|ul. Częstochowska 22 |42-270 Kłomnice;982;492;494;16;476;50.10;3.25
103497;240405;Strażnica OSP Nieznanice|Nieznanice|ul. Sobieskiego 1a |42-270 Kłomnice;480;211;211;9;202;43.96;4.27
103498;240405;Świetlica OSP Zdrowa|Zdrowa|ul. Kłomnicka 31 |42-270 Kłomnice;501;210;210;12;198;41.92;5.71
103499;240405;Szkoła Skrzydlów|Skrzydlów|ul. Główna 6a |42-270 Kłomnice;1041;493;494;13;480;47.36;2.64
103500;240405;Przedszkole Rzeki Wielkie|Rzeki Wielkie|ul. Główna 11 |42-270 Kłomnice;541;239;239;11;228;44.18;4.60
103501;240405;Szkoła Rzerzęczyce|Rzerzęczyce|ul. Skrzydlowska 91 |42-270 Kłomnice;1591;742;742;18;724;46.64;2.43
103502;240405;Szkoła Garnek|Garnek|ul. Szkolna 18 |42-270 Kłomnice;1276;539;539;27;512;42.24;5.01
103503;240405;Szkoła Zawada|Zawada|ul. Częstochowska 8 |42-270 Kłomnice;876;387;387;13;374;44.18;3.36
103504;240405;Szkoła Konary|Konary|ul. Szkolna 3 |42-270 Kłomnice;501;232;232;10;222;46.31;4.31
103505;240405;Strażnica OSP Pacierzów|Pacierzów|ul. Częstochowska 29 |42-270 Kłomnice;395;188;188;3;185;47.59;1.60
103506;240406;Szkoła Podstawowa Nr 2|Koniecpol|ul. Szkolna 17 |42-230 ;1378;637;637;11;626;46.23;1.73
103507;240406;Szkoła Podstawowa Nr 1|Koniecpol|ul. Mickiewicza 26 |42-230 ;1921;900;900;38;862;46.85;4.22
103508;240406;Katolickie Stowarzyszenie Niepełnosprawnych|Stary Koniecpol|ul. Częstochowska 150 |42-230 Koniecpol;834;261;261;14;247;31.29;5.36
103509;240406;Szkoła Podstawowa|Łysiny|ul. Szkolna 14 |42-230 Koniecpol;1127;432;432;50;382;38.33;11.57
103510;240406;Remiza OSP|Kuźnica Grodziska|ul. Centralna 128 |42-230 Koniecpol;486;151;151;10;141;31.07;6.62
103511;240406;Szkoła Podstawowa|Rudniki| 1A |42-230 Koniecpol;296;105;105;8;97;35.47;7.62
103512;240406;Hala Sportowa przy Szkole Podstawowej Nr 2|Koniecpol|ul. Szkolna 17 |42-230 ;2192;944;944;37;907;43.07;3.92
103513;240407;Zespół Szkolno-Przedszkolny|Aleksandria Pierwsza|ul. Gościnna 130 |42-274 ;752;325;325;14;311;43.22;4.31
103514;240407;Zespół Szkolno-Przedszkolny|Aleksandria Pierwsza|ul. Gościnna 130 |42-274 ;674;321;321;17;304;47.63;5.30
103515;240407;Zespół Szkolno-Przedszkolny|Kopalnia|ul. Szkolna 2 |42-274 ;482;237;237;10;227;49.17;4.22
103516;240407;Zespół Szkolno-Przedszkolny|Kopalnia|ul. Szkolna 2 |42-274 ;543;237;237;6;231;43.65;2.53
103517;240407;Zespół Szkolno-Przedszkolny|Hutki| 161 |42-274 ;819;377;377;18;359;46.03;4.77
103518;240407;Szkoła Podstawowa w Jamkach-Korzonku|Korzonek| 4 |42-274 ;547;219;219;6;213;40.04;2.74
103519;240407;Hala Sportowa|Konopiska|ul. Sportowa 7a |42-274 ;1164;578;578;17;561;49.66;2.94
103520;240407;Hala Sportowa|Konopiska|ul. Sportowa 7a |42-274 ;1201;618;618;17;601;51.46;2.75
103521;240407;Filia GCKiR|Korzonek| 87 |42-274 ;480;200;200;9;191;41.67;4.50
103522;240407;Szkoła Podstawowa|Łaziec| 66 |42-274 ;822;328;328;15;313;39.90;4.57
103523;240407;Zespół Szkolno-Przedszkolny|Rększowice| 78 |42-274 ;765;333;333;11;322;43.53;3.30
103524;240407;Dom Koła Gospodyń Wiejskich "Wygodzianka"|Wygoda| 17 |42-274 ;501;250;250;7;243;49.90;2.80
103525;240408;Zespół Szkół|Kruszyna|ul. Pocztowa 2 |42-282 ;1352;678;678;22;656;50.15;3.24
103526;240408;Zespół Szkolno-Przedszkolny|Lgota Mała|ul.Szkolna 1/3 |42-282 Kruszyna;920;408;408;16;392;44.35;3.92
103527;240408;Zespół Szkół|Widzów|ul.Żwirki i Wigury 16 |42-282 Kruszyna;993;425;425;11;414;42.80;2.59
103528;240408;Szkoła Podstawowa|Jacków| 3 |42-282 Kruszyna;744;343;343;15;328;46.10;4.37
103529;240409;Remiza OSP|Biała Wielka| 153 |42-235 Lelów;395;163;163;7;156;41.27;4.29
103530;240409;Szkoła Podstawowa|Drochlin| 73 |42-235 Lelów;433;165;165;16;149;38.11;9.70
103531;240409;Gimnazjum|Lelów|ul. Szczekocińska 41 |42-235 ;1299;632;632;21;611;48.65;3.32
103532;240409;Szkoła Podstawowa|Nakło| 197 |42-235 Lelów;485;176;176;12;164;36.29;6.82
103533;240409;Świetlica Wiejska|Podlesie| 99 |42-235 Lelów;662;250;250;14;236;37.76;5.60
103534;240409;Remiza OSP|Staromieście| 26 |42-235 Lelów;849;455;455;11;444;53.59;2.42
103535;240409;Dom Pomocy Społecznej|Lelów|ul. Szczekocińska 19 |42-235 ;67;52;52;7;45;77.61;13.46
103536;240410;Urząd Gminy|Mstów|ul. 16 Stycznia 14 |42-244 Mstów;803;432;432;9;423;53.80;2.08
103537;240410;Zespół Szkolno-Przedszkolny|Jaskrów|ul. Starowiejska 2 |42-244 Mstów;1512;832;832;7;825;55.03;0.84
103538;240410;Szkoła Podstawowa|Kuchary|ul. Główna 18 |42-244 Mstów;776;354;354;6;348;45.62;1.69
103539;240410;Szkoła Podstawowa|Mokrzesz|ul. Kościelna 24 |42-244 Mstów;746;289;289;11;278;38.74;3.81
103540;240410;Szkoła Podstawowa|Krasice|ul. Strażacka 7 |42-244 Mstów;529;220;220;16;204;41.59;7.27
103541;240410;Zespół Szkolno-Przedszkolny|Małusy Wielkie| 19 |42-244 Mstów;623;271;271;7;264;43.50;2.58
103542;240410;Szkoła Podstawowa|Brzyszów| 50 |42-244 Mstow;709;359;359;11;348;50.63;3.06
103543;240410;Zespół Szkół|Mstów|ul. Partyzantów 2 |42-244 Mstów;1458;778;778;9;769;53.36;1.16
103544;240410;Zespół Szkolno-Przedszkolny|Zawada|ul. Główna 18 |42-244 Mstów;744;331;331;9;322;44.49;2.72
103545;240410;Przedszkole|Siedlec|Kazimierza Wielkiego 63 |42-244 Mstów;444;239;239;8;231;53.83;3.35
103546;240410;Przedszkole|Kobyłczyce| 23 |42-244 Mstów;402;156;156;7;149;38.81;4.49
103547;240411;Zespół Szkolno-Przedszkolny|Lubojna|ul. Strażacka 20 |42-233 Mykanów;1419;777;777;26;751;54.76;3.35
103548;240411;Zespół Szkół|Czarny Las|ul. Szkolna 6 |42-233 Mykanów;1517;848;848;22;826;55.90;2.59
103549;240411;Zespół Szkół|Stary Cykarzew|ul. Szkolna 12 |42-231 Stary Cykarzew;1493;700;700;21;679;46.89;3.00
103550;240411;Szkoła Podstawowa|Stary Broniszew|ul. Kwiatowa 28 |42-231 Stary Cykarzew;923;389;389;12;377;42.15;3.08
103551;240411;Zespół Szkolno-Przedszkolny|Borowno|ul. Armii Ludowej 6/8 |42-233 Mykanów;1492;796;796;20;776;53.35;2.51
103552;240411;Zespół Szkolno-Przedszkolny|Mykanów|ul. Słoneczna 114 |42-233 Mykanów;873;508;508;14;494;58.19;2.76
103553;240411;Publiczna Szkoła Podstawowa SPSK|Rybna|ul. Szkolna 5 |42-231 Stary Cykarzew;1073;563;563;18;545;52.47;3.20
103554;240411;Szkoła Podstawowa|Radostków Kolonia|ul. Szkolna 1 |42-233 Mykanów;804;399;399;12;387;49.63;3.01
103555;240411;Szkoła Podstawowa|Wierzchowisko|ul. Długa 110 |42-233 Mykanów;996;628;628;15;613;63.05;2.39
103556;240411;Przedszkole|Kuźnica Kiedrzyńska|ul. Witosa 120 |42-233 Mykanów;629;370;370;14;356;58.82;3.78
103557;240411;Szkoła Podstawowa|Stary Kocin|ul. Kręta 91 |42-231 Stary Cykarzew;650;297;297;25;272;45.69;8.42
103558;240412;Szkoła Podstawowa|Biskupice|ul. Szkolna 4 |42-256 Olsztyn;758;331;331;11;320;43.67;3.32
103559;240412;Zespół Szkół|Kusięta| 208 |42-256 Olsztyn;1000;507;507;16;491;50.70;3.16
103560;240412;Urząd Gminy Olsztyn|Olsztyn|Pl. Piłsudskiego 10 |42-256 Olsztyn;2325;1306;1306;34;1272;56.17;2.60
103561;240412;Szkoła Podstawowa|Turów|ul. Szkolna 12 |42-256 Olsztyn;695;355;355;10;345;51.08;2.82
103562;240412;Zespół Szkół|Zrębice|ul. Główna 143 |42-256 Olsztyn;968;385;385;12;373;39.77;3.12
103563;240412;Świetlica środowiskowa|Przymiłowice|ul. Zamkowa 118 |42-256 Olsztyn;695;341;341;5;336;49.06;1.47
103564;240412;Dom Pomocy Społecznej|Turów|ul. Joachimowska 85 |42-256 Olsztyn;57;30;30;2;28;52.63;6.67
103565;240413;Gminne Centrum Kultury, Informacji i Rekreacji|Poczesna|ul. Modrzewiowa 3 |42-262 Poczesna;1505;859;859;7;852;57.08;0.81
103566;240413;Remiza OSP|Nierada|ul. Targowa 103 |42-262 Poczesna;1292;506;506;19;487;39.16;3.75
103567;240413;Zespół Szkolno-Przedszkolny|Słowik|ul. Podlaska 4 |42-263 Wrzosowa;1159;630;630;8;622;54.36;1.27
103568;240413;Zespół Szkół|Huta Stara B|ul. Mickiewicza 12 |42-263 Wrzosowa;1962;909;909;15;894;46.33;1.65
103569;240413;Świetlica|Brzeziny Nowe|ul. Biała 33 |42-263 Wrzosowa;956;519;519;17;502;54.29;3.28
103570;240413;Zespół Szkół|Wrzosowa|ul. Szkolna 4 |42-263 Wrzosowa;1612;849;849;15;834;52.67;1.77
103571;240413;Wiejskie Centrum Kultury i Rekreacji w Bargłach|Bargły|ul. Śląska 84 |42-262 Poczesna;550;295;295;9;286;53.64;3.05
103572;240413;Świetlica wiejska|Nowa Wieś|ul. Częstochowska 8 |42-262 Poczesna;509;260;260;4;256;51.08;1.54
103573;240413;Szkoła Podstawowa w Poczesnej|Kolonia Poczesna|ul. Szkolna 2 |42-262 Poczesna;892;429;429;21;408;48.09;4.90
103574;240414;Niepubliczna Szkoła Podstawowa|Wola Mokrzeska|ul. Główna 7 |42-248 Przyrów;344;135;135;6;129;39.24;4.44
103575;240414;Zespół Szkolno-Przedszkolny - Hala sportowa|Przyrów|ul. Szkolna 44 |42-248 Przyrów;1138;558;558;13;545;49.03;2.33
103576;240414;Strażnica OSP|Zarębice| 35 |42-248 Przyrów;514;181;181;3;178;35.21;1.66
103577;240414;Niepubliczna Szkoła Podstawowa|Zalesice|ul. Nadrzeczna 3 |42-250 Przyrów;326;125;125;6;119;38.34;4.80
103578;240414;Wiejska Izba Obrzędowa|Sygontka|ul. Kościelna 2 |42-250 Przyrów;532;238;238;12;226;44.74;5.04
103579;240414;Strażnica OSP|Wiercica| 76 |42-250 Przyrów;369;153;153;10;143;41.46;6.54
103580;240415;Szkoła Podstawowa im. G.Morcinka|Rędziny|ul. Szkolna 7 |42-242 ;2013;1058;1058;30;1028;52.56;2.84
103581;240415;Gminny Ośrodek Kultury|Rędziny|ul. Mickiewicza 7 |42-242 ;1937;963;963;24;939;49.72;2.49
103582;240415;Filia GOK|Marianka Rędzińska|ul. Srebrna 17 |42-242 Rędziny;463;210;210;10;200;45.36;4.76
103583;240415;Zespół Szkolno-Przedszkolny|Rudniki|ul. Szkolna 11 |42-240 Rudniki;1295;589;589;14;575;45.48;2.38
103584;240415;Szkoła Podstawowa im. Korczaka|Kościelec|ul. Wolności 93 |42-240 Rudniki;1660;735;735;40;695;44.28;5.44
103585;240415;Szkoła Podstawowa im. Marii Konopnickiej|Konin|ul. Kielecka 37 |42-240 Rudniki;749;341;341;13;328;45.53;3.81
103586;240416;Świetlica Środowiskowa|Starcza|ul. Szkolna 1 |42-261 Starcza;576;283;283;11;272;49.13;3.89
103587;240416;Świetlica Wiejska|Starcza|ul. Sportowa 7 |42-261 Starcza;569;318;318;12;306;55.89;3.77
103588;240416;Świetlica Wiejska|Własna|ul. Stawowa 1 |42-261 Starcza;704;365;365;18;347;51.85;4.93
103589;240416;Remiza OSP|Rudnik Mały|ul. Śląska 50 |42-261 Starcza;424;206;206;13;193;48.58;6.31
103590;240501;Miejskie Przedszkole Nr 13|Knurów|ul.Piłsudczyków 4 |44-196 Knurów;1579;927;927;9;918;58.71;0.97
103591;240501;Miejskie Przedszkole Nr 2|Knurów|ul.Lotników 3 |44-196 Knurów;1044;542;542;6;536;51.92;1.11
103592;240501;Miejska Szkoła Podstawowa Nr 9|Knurów|ul.Aleja Lipowa 12 |44-196 Knurów;1957;1217;1217;38;1179;62.19;3.12
103593;240501;Miejskie Gimnazjum Nr 3|Knurów|ul.Aleja Lipowa 12 |44-196 Knurów;1004;520;520;11;509;51.79;2.12
103594;240501;Miejskie Przedszkole Nr 12|Knurów|ul.Armii Krajowej 5 |44-194 Knurów;1005;568;568;13;555;56.52;2.29
103595;240501;Miejska Szkoła Podstawowa Nr 7|Knurów|ul.Jedności Narodowej 5 1|44-194 Knurów;1020;539;539;9;530;52.84;1.67
103596;240501;Miejska Szkoła Podstawowa Nr 7|Knurów|ul.Jedności Narodowej 5 2|44-194 Knurów;1223;650;650;10;640;53.15;1.54
103597;240501;Miejska Szkoła Podstwawowa Nr 6|Knurów|ul.Stefana Batorego 5 2|44-194 Knurów;1457;709;709;22;687;48.66;3.10
103598;240501;Miejskie Gimnazjum Nr 2|Knurów|ul.Stefana Batorego 7 |44-194 Knurów;1504;777;777;28;749;51.66;3.60
103599;240501;Miejska Szkoła Podstawowa Nr 6|Knurów|ul.Stefana Batorego 5 1|44-194 Knurów;1692;803;803;20;783;47.46;2.49
103600;240501;Zespół Szkół im.I.J.Paderewskiego L.O.|Knurów|ul.1 -go Maja 21 1|44-194 Knurów;1606;883;883;15;868;54.98;1.70
103601;240501;Miejska Szkoła Podstawowa Nr 2|Knurów|ul.Wilsona 22 1|44-190 Knurów;1721;854;854;16;838;49.62;1.87
103602;240501;Miejska Szkoła Podstawowa Nr 2|Knurów|ul.Wilsona 22 2|44-190 Knurów;1851;1004;1004;14;990;54.24;1.39
103603;240501;Zespół Szkół im.I.J.Paderewskiego L.O.|Knurów|ul.1-go Maja 21 2|44-194 Knurów;1558;888;888;11;877;57.00;1.24
103604;240501;Miejskie Gimnazjum Nr 1|Knurów|ul.Ks.Alojzego Koziełka 7 |44-190 Knurów;1368;709;709;22;687;51.83;3.10
103605;240501;Miejska Szkoła Podstawowa Nr 1|Knurów|ul.Słoniny 1 |44-190 Knurów;1789;804;804;36;768;44.94;4.48
103606;240501;Fundacja Rozwoju Lokalnego|Knurów|ul.Dworcowa 38a |44-190 Knurów;1180;525;525;25;500;44.49;4.76
103607;240501;Zespół Szkolno-Przedszkolny, Miejska Szkoła Podstawowa Nr 3|Knurów|ul.Michalskiego 27 |44-193 Knurów;1382;767;767;18;749;55.50;2.35
103608;240501;Miejskie Gimnazjum Nr 4|Knurów|ul.Kilińskiego 6 |44-193 Knurów;1776;847;847;29;818;47.69;3.42
103609;240501;Dom Kultury|Knurów|ul.Górnicza 1 |44-193 Knurów;1189;477;477;24;453;40.12;5.03
103610;240501;Miejska Szkoła Podstawowa Nr 4|Knurów|Kilińskiego 6 |44-193 Knurów;1187;493;493;28;465;41.53;5.68
103611;240501;Szpital w Knurowie Sp. z o.o. w budynku głównym Szpitala w Knurowie|Knurów|Niepodległości 8 |44-190 Knurów;67;43;43;2;41;64.18;4.65
103612;240502;Przedszkole Miejskie Nr 1|Pyskowice|ul. Oświęcimska 28 |44-120 Pyskowice;2005;920;920;20;900;45.89;2.17
103613;240502;Miejska Biblioteka Publiczna - Filia Nr 1|Pyskowice|ul. Traugutta 53 |44-120 Pyskowice;1044;517;517;23;494;49.52;4.45
103614;240502;Ratusz|Pyskowice|ul. Rynek 1 |44-120 Pyskowice;2024;929;929;25;904;45.90;2.69
103615;240502;Szkoła Podstawowa Nr 4|Pyskowice|ul. Wojska Polskiego 23 |44-120 Pyskowice;1756;887;887;22;865;50.51;2.48
103616;240502;Miejska Biblioteka Publiczna|Pyskowice|Plac Józefa Piłsudskiego 1 |44-120 Pyskowice;1910;851;851;23;828;44.55;2.70
103617;240502;Hala Widowiskowo-Sportowa im. H.Wagnera|Pyskowice|ul. Strzelców Bytomskich 1A |44-120 Pyskowice;1772;715;715;27;688;40.35;3.78
103618;240502;Świetlica Osiedlowa|Pyskowice|ul. Wojska Polskiego 3 |44-120 Pyskowice;1921;763;763;25;738;39.72;3.28
103619;240502;Przedszkole Miejskie Nr 5|Pyskowice|ul. Szopena 9B |44-120 Pyskowice;1947;1010;1010;19;991;51.87;1.88
103620;240502;Szpital w Pyskowicach Spółka z o.o.|Pyskowice|Szpitalna 2 |44-120 Pyskowice;59;31;31;0;31;52.54;0.00
103621;240503;Szkoła Podstawowa|Gierałtowice|ul. Powstańców Śląskich 41 |44-186 Gierałtowice;1934;1035;1035;22;1013;53.52;2.13
103622;240503;Szkoła Podstawowa|Gierałtowice|ul. Powstańców Śląskich 41 |44-186 Gierałtowice;1197;673;673;18;655;56.22;2.67
103623;240503;Szkoła Podstawowa|Przyszowice|ul. Szkolna 4 |44-178 Przyszowice;1635;979;979;23;956;59.88;2.35
103624;240503;Szkoła Podstawowa|Przyszowice|ul. Szkolna 4 |44-178 Przyszowice;0;0;0;0;0;-99;-99
103625;240503;Szkoła Podstawowa|Paniówki|ul. Zwycięstwa 44 |44-177 Paniówki;2104;1392;1392;35;1357;66.16;2.51
103626;240503;Szkoła Podstawowa|Chudów|ul. Szkolna 52 |44-177 Paniówki;1238;741;741;25;716;59.85;3.37
103627;240504;Świetlica Wiejska w Nieborowicach|Nieborowice|ul. Główna 48a |44-144 Żernica;748;423;423;11;412;56.55;2.60
103628;240504;Świetlica Wiejska w Leboszowicach|Leboszowice|ul. Wiejska 14 |44-145 Pilchowice;482;266;266;8;258;55.19;3.01
103629;240504;Świetlica Wiejska przy OSP w Pilchowicach|Pilchowice|ul. Strażaków 3 |44-145 Pilchowice;2308;1039;1039;29;1010;45.02;2.79
103630;240504;Zespół Szkolno - Przedszkolny w Stanicy|Stanica|ul. Gliwicka 18 |44-145 Pilchowice;1189;502;502;17;485;42.22;3.39
103631;240504;Świetlica Wilcza|Wilcza|ul. Karola Miarki 123 |44-189 Wilcza;1641;828;828;31;797;50.46;3.74
103632;240504;Dom Kultury Żernica|Żernica|Szafranka 9 |44-144 Żernica;2312;1147;1147;29;1118;49.61;2.53
103633;240504;Kuźnia Nieborowska DPS "Zameczek"|Kuźnia Nieborowska|Knurowska 13 |44-144 Żernica;334;152;152;3;149;45.51;1.97
103634;240504;Szpital Chorób Płuc w Pilchowicach|Pilchowice|Dworcowa 31 |44-145 Pilchowice;90;29;29;0;29;32.22;0.00
103635;240505;Zespół Szkolno-Przedszkolny Rudziniec|Rudziniec|ul. Gliwicka 5 |44-160 Rudziniec;1287;586;586;34;552;45.53;5.80
103636;240505;Szkoła Podstawowa Bojszów|Bojszów|ul. Szkolna 23 |44-160 Rudziniec;1164;530;530;14;516;45.53;2.64
103637;240505;Szkoła Podstawowa Rudno|Rudno|ul. Szkolna 9 |44-160 Rudziniec;884;372;372;25;347;42.08;6.72
103638;240505;Szkoła Podstawowa Kleszczów|Kleszczów|ul. Szkolna 23 |44-164 Gliwice 21;722;411;411;10;401;56.93;2.43
103639;240505;Budynek świetlicy wiejskiej Rzeczyce|Rzeczyce|ul. Kolejowa 10 |44-164 Gliwice 21;689;257;257;10;247;37.30;3.89
103640;240505;Szkoła Podstawowa Bycina|Bycina|ul. Szkolna 13 |44-120 Pyskowice;733;285;285;14;271;38.88;4.91
103641;240505;budynek byłej szkoły podstawowej Taciszów|Taciszów|ul. Szkolna 2 |44-171 Rudziniec;437;188;188;4;184;43.02;2.13
103642;240505;Zespół Szkono-Przedszkolny, Pławniowice|Pławniowice|ul. Gliwicka 107 |44-171 Rudziniec;722;259;259;6;253;35.87;2.32
103643;240505;Gminny Ośrodek Kultury Poniszowice|Poniszowice|ul. Parkowa 11 |44-172 Rudziniec;1289;554;554;33;521;42.98;5.96
103644;240505;Szkoła Podstawowa Chechło|Chechło|ul. Szkolna 1 |44-172 Rudziniec;753;268;268;10;258;35.59;3.73
103645;240506;Gimanazjum im. Unii Europejskiej w Sośnicowicach|Sośnicowice|ul. Gimnazjalna 6 |44-153 Sośnicowice;753;325;325;11;314;43.16;3.38
103646;240506;Świetlica Rady Sołeckiej w Trachach|Trachy|ul. Raciborska 31 |44-153 Sośnicowice;667;248;248;8;240;37.18;3.23
103647;240506;Szkoła Podstawowa w Sierakowicach|Sierakowice|ul. Wiejska 1 |44-156 Sośnicowice;945;412;412;11;401;43.60;2.67
103648;240506;Szkoła Podstawowa w Kozłowie|Kozłów|ul. Marcina 33 |44-153 Sośnicowice;862;351;351;12;339;40.72;3.42
103649;240506;Gminne Przedszkole w Łanach Wielkich|Łany Wielkie|ul. Wiejska 9 |44-153 Sośnicowice;572;203;203;8;195;35.49;3.94
103650;240506;Gminne Przedszkole w Smolnicy|Smolnica|ul. Szkolna 1 |44-153 Sośnicowice;1025;567;567;11;556;55.32;1.94
103651;240506;Gminne Przedszkole w Rachowicach|Rachowice|ul. Wiejska 111 |44-156 Sośnicowice;588;264;264;10;254;44.90;3.79
103652;240506;Szkoła Podstawowa w Bargłówce|Bargłówka|ul. Raciborska 67 |44-153 Sośnicowice;585;262;262;9;253;44.79;3.44
103653;240506;Gimnazjum im. Unii Europejskiej w Sośnicowicach|Sośnicowice|Gimnazjalna 6 |44-153 Sośnicowice;904;399;399;15;384;44.14;3.76
103654;240507;Szkoła Podstawowa im.Gustawa Morcinka w Toszku|Toszek|ul.Wilkowicka 2 |44-180 Toszek;1511;765;765;22;743;50.63;2.88
103655;240507;Gimnazjum im.Ireny Sendler w Toszku|Toszek|ul.Dworcowa 27 |44-180 Toszek;1380;608;608;14;594;44.06;2.30
103656;240507;Gimnazjum im.Ireny Sendler w Toszku|Toszek|ul.Dworcowa 27 |44-180 Toszek;1013;390;390;8;382;38.50;2.05
103657;240507;Szkoła Podstawowa im.Gustawa Morcinka w Toszku|Toszek|ul.Wilkowicka 2 |44-180 Toszek;979;382;382;18;364;39.02;4.71
103658;240507;Szkoła Podstawowa w Kotulinie|Kotulin|ul.Gliwicka 13 |44-180 Toszek;1150;517;517;9;508;44.96;1.74
103659;240507;Szkoła Podstawowa w Paczynie|Paczyna|ul.Wiejska 80 |44-120 Pyskowice;977;310;310;18;292;31.73;5.81
103660;240507;Szkoła Podstawowa im. Królowej Jadwigi w Pniowie|Pniów|ul.Szkolna 4 1|44-120 Pyskowice;593;217;217;9;208;36.59;4.15
103661;240507;Szpital Psychiatryczny w Toszku|Toszek|Gliwicka 5 |44-180 Toszek;333;71;71;9;62;21.32;12.68
103662;240508;Gminny Ośrodek Kultury|Wielowieś|ul. Główna 47 |44-187 Wielowieś;2201;822;822;27;795;37.35;3.28
103663;240508;Szkoła Podstawowa|Świbie|ul. Szkolna 2 |44-187 Wielowieś;1944;666;666;28;638;34.26;4.20
103664;240508;Świetlica wiejska|Sieroty|ul. Kościelna 17 |44-187 Wielowieś;622;208;208;14;194;33.44;6.73
103665;240508;Caritas Diecezji Gliwickiej Dom Pomocy Społecznej|Wiśnicze|Wiejska 42a |44-187 Wielowieś;92;41;41;2;39;44.57;4.88
103666;240601;Zespół Szkół Nr 1|Kłobuck|ul. Zamkowa 6 |42-100 Kłobuck;1369;691;691;29;662;50.47;4.20
103667;240601;Zespół Szkół Nr 2|Kłobuck|ul. 3 Maja 33 |42-100 Kłobuck;1409;799;799;19;780;56.71;2.38
103668;240601;Gimnazjum|Kłobuck|ul. Bohaterów Bitwy pod Mokrą 4 |42-100 Kłobuck;1769;914;914;21;893;51.67;2.30
103669;240601;Szkoła Podstawowa Nr 1|Kłobuck|ul. Baczyńskiego 2 |42-100 Kłobuck;1105;505;505;17;488;45.70;3.37
103670;240601;Szkoła Podstawowa Nr 2|Kłobuck|ul. Szkolna 1 |42-100 Kłobuck;1208;662;662;12;650;54.80;1.81
103671;240601;Przychodnia Rejonowa nr 1|Kłobuck|ul. Staszica 28 |42-100 Kłobuck;831;492;492;11;481;59.21;2.24
103672;240601;Publiczna Szkoła Podstawowa Stowarzyszenia Przyjaciół Szkół Katolickich|Lgota|ul. Południowa 138 |42-100 Kłobuck;734;391;391;9;382;53.27;2.30
103673;240601;Zespół Szkół|Libidza|ul. Olszyńskiego 2 |42-125 Kamyk;695;290;290;16;274;41.73;5.52
103674;240601;Zespół Szkolno-Przedszkolny|Kamyk|ul. Szkolna 5 |42-125 ;1950;962;962;31;931;49.33;3.22
103675;240601;Zespół Szkół|Biała|ul. Częstochowska 73 |42-125 Kamyk;1184;607;607;16;591;51.27;2.64
103676;240601;Zespół Szkolno-Przedszkolny|Łobodno|ul. Sienkiewicza 69 |42-125 Kamyk;1462;617;617;33;584;42.20;5.35
103677;240601;Publiczna Szkoła Podstawowa Stowarzyszenia Przyjaciół Szkół Katolickich|Kłobuck|ul. Witosa 21 |42-100 ;582;267;267;11;256;45.88;4.12
103678;240601;Zespół Szkół Nr 1|Kłobuck|ul. Zamkowa 6 |42-100 ;1134;683;683;9;674;60.23;1.32
103679;240601;Zespół Szkół Nr 3|Kłobuck|ul. Ks. Skorupki 46 |42-100 ;850;425;425;11;414;50.00;2.59
103680;240601;Państwowe Gospodarstwo Leśne Lasy Państwowe|Kłobuck|ul. Zakrzewska 85 |42-100 ;546;209;209;3;206;38.28;1.44
103681;240601;Szpital Rejonowy|Kłobuck|ul. 11 Listopada 5E |42-100 ;17;17;17;1;16;100.00;5.88
103682;240602;Dom Kultury|Krzepice|ul. Częstochowska 26 |42-160 Krzepice;1068;542;542;17;525;50.75;3.14
103683;240602;Zespół Szkół Liceum Ogólnokształcące|Krzepice|ul. Ryły 26 |42-160 Krzepice;1551;769;769;21;748;49.58;2.73
103684;240602;Remiza OSP|Krzepice|ul. Kuków 79 |42-160 Krzepice;330;141;141;2;139;42.73;1.42
103685;240602;Szkoła Podstawowa Nr 2|Krzepice|ul. Skłodowskiej 21 |42-160 Krzepice;961;442;442;12;430;45.99;2.71
103686;240602;Budynek b. Szkoły Podstawowej|Dankowice Drugie| 30 |42-160 Krzepice;613;220;220;6;214;35.89;2.73
103687;240602;Zespół Szkół|Starokrzepice|ul. Oleska 250 |42-161 Krzepice;1368;646;646;9;637;47.22;1.39
103688;240602;Szkoła Podstawowa|Zajączki Pierwsze| 50 |42-160 Krzepice;685;310;310;11;299;45.26;3.55
103689;240602;Remiza OSP|Zajączki Drugie|ul. Główna 140 |42-160 Krzepice;1097;495;495;22;473;45.12;4.44
103690;240602;Szpital Rejonowy im. Dr. Anki|Krzepice|ul. Szkolna 1 |42-160 ;24;12;12;1;11;50.00;8.33
103691;240603;Gminny Ośrodek Kultury|Lipie|ul. Częstochowska 95 |42-165 ;1787;833;833;40;793;46.61;4.80
103692;240603;Remiza Ochotniczej Straży Pożarnej|Parzymiechy|ul. Częstochowska 2 |42-164 ;1658;800;800;15;785;48.25;1.88
103693;240603;Zespół Szkolno-Przedszkolny|Lindów| 42 |42-165 Lipie;851;368;368;15;353;43.24;4.08
103694;240603;Szkoła Podstawowa|Rębielice Szlacheckie| 93 |42-165 Lipie;566;239;239;9;230;42.23;3.77
103695;240603;Lokal szkolny Zespołu Szkolno-Przedszkolnego w Lipiu|Natolin| 51 |42-165 Lipie;461;216;216;11;205;46.85;5.09
103696;240604;Gimnazjum|Miedźno|ul. Szkolna 1 |42-120 Miedźno;458;226;226;10;216;49.34;4.42
103697;240604;Gimnazjum|Miedźno|ul. Szkolna 1 |42-120 ;801;396;396;15;381;49.44;3.79
103698;240604;Szkoła Podstawowa|Miedźno|ul. Szkolna 1 |42-120 ;843;418;418;12;406;49.58;2.87
103699;240604;Gminny Ośrodek Kultury|Miedźno|ul. Gen. Juliana Filipowicza 5 |42-120 ;494;203;203;9;194;41.09;4.43
103700;240604;Zespół Szkół|Ostrowy nad Okszą|ul. Szkolna 6 |42-122 ;838;449;449;19;430;53.58;4.23
103701;240604;Zespół Szkół|Ostrowy nad Okszą|ul. Szkolna 6 |42-122 ;964;500;500;17;483;51.87;3.40
103702;240604;Świetlica w budynku po byłej Szkole Podstawowej|Kołaczkowice| 110 |42-120 Miedźno;495;237;238;7;230;47.88;2.95
103703;240604;Zespół Szkolno-Przedszkolny|Mokra| 194 |42-122 Miedźno;637;247;247;11;236;38.78;4.45
103704;240604;Świetlica przy OSP|Borowa| 60a |42-120 Miedźno;397;165;165;5;160;41.56;3.03
103705;240604;Świetlica w budynku po byłej Szkole Podstawowej|Władysławów|ul. Turystyczna 122 |42-120 Miedźno;291;110;110;0;110;37.80;0.00
103706;240605;Gimnazjum w Opatowie|Opatów|ul. Szkolna 5 |42-152 Opatów;998;455;455;16;439;45.59;3.52
103707;240605;Gimnazjum w Opatowie|Opatów|ul. Szkolna 5 |42-152 Opatów;475;177;177;5;172;37.26;2.82
103708;240605;Szkoła Podstawowa w Iwanowicach Dużych|Iwanowice Duże|ul. Częstochowska 63 |42-152 Opatów;776;310;310;22;288;39.95;7.10
103709;240605;Szkoła Podstawowa w Waleńczowie|Waleńczów|ul. Szkolna 19 |42-151 Waleńczów;908;445;445;13;432;49.01;2.92
103710;240605;Szkoła Podstawowa w Wilkowiecku|Wilkowiecko|ul. Szkolna 1 |42-152 Opatów;883;381;381;5;376;43.15;1.31
103711;240605;Szkoła Podstawowa w Złochowicach|Złochowice|ul. Wesoła 3 |42-151 Waleńczów;1012;461;461;16;445;45.55;3.47
103712;240605;Remiza OSP w Zwierzyńcu Pierwszym|Zwierzyniec Pierwszy|ul. Jasna 5 |42-152 Opatów;512;189;189;18;171;36.91;9.52
103713;240606;Gminny Ośrodek Kultury i Sportu|Panki|ul. 1 Maja 8 |42-140 ;1039;519;519;9;510;49.95;1.73
103714;240606;Szkoła Podstawowa|Panki|ul. Tysiąclecia 17 |42-140 ;1229;537;537;17;520;43.69;3.17
103715;240606;Szkoła Podstawowa|Aleksandrów| 31 |42-140 Panki;758;323;323;13;310;42.61;4.02
103716;240606;Szkoła Podstawowa|Konieczki| 64 |42-140 Panki;1111;467;467;18;449;42.03;3.85
103717;240607;Gminny Zespół Szkolno-Przedszkolny Nr 1|Popów|ul. Długosza 7 |42-110 Popów;1292;627;627;16;611;48.53;2.55
103718;240607;Gminny Zespół Szkolno-Przedszkolny Nr 3|Rębielice Królewskie|ul. Szkolna 1 |42-110 Popów;691;290;290;25;265;41.97;8.62
103719;240607;Gminny Zespół Szkolno-Przedszkolny Nr 2|Wąsosz Górny|ul. Witosa 11 |42-110 Popów;1240;455;455;16;439;36.69;3.52
103720;240607;Gminny Zespół Szkolno-Przedszkolny Nr 4|Więcki|ul. Szkolna 1 |42-110 Popów;732;247;247;10;237;33.74;4.05
103721;240607;Gimnazjum Nr 1|Zawady|ul. Szkolna 8 |42-110 Popów;985;406;406;18;388;41.22;4.43
103722;240607;Oddział Zewnętrzny Wąsosz Górny przy Areszcie Śledczym w Częstochowie|Wąsosz Górny|ul. Powstańców 150 |42-110 ;101;43;43;3;40;42.57;6.98
103723;240608;Zespół Szkół w Przystajni|Przystajń|ul. Szkolna 9 |42-141 Przystajń;1898;886;886;29;857;46.68;3.27
103724;240608;Gminny Ośrodek Kultury, Sportu i Rekreacji w Przystajni|Przystajń|ul. Targowa 5 |42-141 Przystajń;1621;576;576;27;549;35.53;4.69
103725;240608;Publiczna Szkoła Podstawowa w Borze Zajacińskim|Bór Zajaciński| 78 |42-142 Bór Zajaciński;799;280;280;17;263;35.04;6.07
103726;240608;Strażnica OSP w Ługach-Radłach|Ługi-Radły|ul. Leśna 1A |42-142 Ługi-Radły;567;245;245;9;236;43.21;3.67
103727;240609;Zespół Szkół|Wręczyca Wielka|ul. Szkolna 11 |42-130 Wręczyca Wielka;2313;1165;1165;30;1135;50.37;2.58
103728;240609;Szkoła Podstawowa|Grodzisko|ul. Kłobucka 1 |42-130 Wręczyca Wielka;862;450;450;16;434;52.20;3.56
103729;240609;Szkoła Podstawowa|Borowe|ul. Długa 75 |42-133 Węglowice;1903;762;762;41;721;40.04;5.38
103730;240609;Zespół Szkolno-Przedszkolny|Kalej|ul. Szkolna 1 |42-130 Wręczyca Wielka;2340;1078;1078;46;1032;46.07;4.27
103731;240609;Zespół Szkół|Węglowice| 3 |42-133 Węglowice;1928;879;879;18;861;45.59;2.05
103732;240609;Szkoła Podstawowa|Kuleje|ul. Szkolna 1 |42-134 Truskolasy;1128;497;497;13;484;44.06;2.62
103733;240609;Oddział Przedszkola|Piła Pierwsza| 4 |42-134 Truskolasy;587;240;240;15;225;40.89;6.25
103734;240609;Zespół Szkół|Truskolasy|ul. Szkolna 3 |42-134 Truskolasy;2260;920;920;49;871;40.71;5.33
103735;240609;OSP|Hutka|ul. Dolna 2 |42-134 Truskolasy;517;219;219;9;210;42.36;4.11
103736;240609;Zespół Szkół|Wręczyca Wielka|ul. Szkolna 11 |42-130 Wręczyca Wielka;527;211;211;14;197;40.04;6.64
103737;240701;OSP|Lubliniec|ul. Sokoła 13 |42-700 Lubliniec;1765;952;952;19;933;53.94;2.00
103738;240701;Siedziba Zespołu Pieśni i Tańca "HALKA"|Lubliniec|ul. Stalmacha 12 |42-700 Lubliniec;1103;584;584;7;577;52.95;1.20
103739;240701;Świetlica przy Domu Parafialnym|Lubliniec|ul. Kokotek 22 |42-700 Lubliniec;245;132;132;3;129;53.88;2.27
103740;240701;Basen Kryty|Lubliniec|ul. Powstańców Śląskich 42 |42-700 Lubliniec;1945;957;957;19;938;49.20;1.99
103741;240701;Państwowa Szkoła Muzyczna I stopnia im. J. Garści|Lubliniec|Plac K. Mańki 9 |42-700 Lubliniec;915;461;461;15;446;50.38;3.25
103742;240701;Miejski Dom Kultury|Lubliniec|ul. Plebiscytowa 9 |42-700 Lubliniec;1083;475;475;25;450;43.86;5.26
103743;240701;Gimnazjum Nr 1|Lubliniec|ul. Wilimowskiego 8 |42-700 Lubliniec;1913;807;807;16;791;42.19;1.98
103744;240701;Przedszkole Miejskie Nr 1|Lubliniec|ul. Słoneczna 13 |42-700 Lubliniec;1397;766;766;16;750;54.83;2.09
103745;240701;Zespół Szkół im. Św. Edyty Stein Katolickiego Stowarzyszenia Wychowawców|Lubliniec|ul. Marszałka Piłsudskiego 8 |42-700 Lubliniec;1786;988;988;29;959;55.32;2.94
103746;240701;Przedszkole Miejskie Nr 8|Lubliniec|ul. Uchodźców 34 |42-700 Lubliniec;1748;940;940;18;922;53.78;1.91
103747;240701;Przedszkole Miejskie Nr 4|Lubliniec|ul. Wawrzyńca Hajdy 20 |42-700 Lubliniec;777;433;433;7;426;55.73;1.62
103748;240701;Szkoła Podstawowa Nr 3|Lubliniec|ul. Zwycięstwa 32 |42-700 Lubliniec;1824;934;935;20;914;51.21;2.14
103749;240701;Gimnazjum Nr 2|Lubliniec|ul. Droniowicka 45 |42-700 Lubliniec;1815;1073;1073;18;1055;59.12;1.68
103750;240701;Dom Pomocy Społecznej "Dom Kombatanta"|Lubliniec|ul.Cyrana 10 |42-700 ;177;60;60;7;53;33.90;11.67
103751;240701;Zakład Karny|Lubliniec|ul. Sobieskiego 6 |42-700 ;201;117;117;16;101;58.21;13.68
103752;240701;Samodzielny Publiczny Zespół Opieki Zdrowotnej|Lubliniec|ul. Grunwaldzka 9 |42-700 ;33;22;22;2;20;66.67;9.09
103753;240701;Wojewódzki Szpital Neuropsychiatryczny im. dr Emila Cyrana|Lubliniec|ul. Grunwaldzka 48 |42-700 ;84;82;82;1;81;97.62;1.22
103754;240701;Dom Pomocy Społecznej|Lubliniec|ul. Kochcicka 14 |42-700 ;162;43;43;6;37;26.54;13.95
103755;240702;Zespół Placówek Oświatowych|Boronów|ul. Poznańska 2 |42-283 ;1374;624;624;22;602;45.41;3.53
103756;240702;Zespół Placówek Oświatowych|Boronów|ul. Poznańska 2 |42-283 ;1391;672;672;16;656;48.31;2.38
103757;240703;Urząd Gminy|Ciasna|ul. Nowa 1a |42-793 ;2297;758;758;23;735;33.00;3.03
103758;240703;Szkoła Podstawowa|Glinica|ul. Asfaltowa 6 |42-793 Ciasna;792;336;336;14;322;42.42;4.17
103759;240703;Hala Sportowa|Sieraków Śląski|al. Parkowa 2 |42-793 Ciasna;1851;593;593;17;576;32.04;2.87
103760;240703;Szkoła Podstawowa|Wędzina|ul. Szkolna 23 |42-793 Ciasna;518;153;153;5;148;29.54;3.27
103761;240703;Szkoła Podstawowa|Zborowskie|ul. Myśliwska 1 |42-793 Ciasna;839;210;210;10;200;25.03;4.76
103762;240703;Zakład Karny|Sieraków Śląski|ul. Cegielniana 13 |42-793 ;479;215;215;35;180;44.89;16.28
103763;240704;Gminne Centrum Kultury i Informacji|Herby|ul. Lubliniecka 31 |42-284 Herby;1939;1021;1021;24;997;52.66;2.35
103764;240704;Szkoła Podstawowa|Olszyna|ul.Szkolna 4 |42-284 Herby;958;461;461;16;445;48.12;3.47
103765;240704;Szkoła Podstawowa|Lisów|ul.Szkolna 2 |42-714 Lisów;2018;885;885;37;848;43.86;4.18
103766;240704;Szkoła Podstawowa|Hadra|ul.Szkolna 29 |42-714 Lisów;562;237;237;12;225;42.17;5.06
103767;240704;Zakład Karny|Herby|ul. Krótka 28 |42-284 Herby;414;161;161;35;126;38.89;21.74
103768;240705;Wiejski Dom Spotkań|Droniowice|ul. Ogrodowa 7 |42-700 Lubliniec;519;180;180;6;174;34.68;3.33
103769;240705;Budynek byłej szkoły|Jawornica|ul. Szkolna 3 |42-700 Lubliniec;476;205;205;7;198;43.07;3.41
103770;240705;Gminne Centrum Kultury i Informacji|Kochanowice|ul. Lubliniecka 5 |42-713 Kochanowice;1687;774;774;14;760;45.88;1.81
103771;240705;Zespół Szkolno - Przedszkolny|Kochcice|ul. Parkowa 45 |42-713 Kochanowice;1780;678;678;16;662;38.09;2.36
103772;240705;Zespół Szkół|Lubecko|ul. Lipska 21 |42-700 Lubliniec;649;260;260;8;252;40.06;3.08
103773;240705;Dom Spotkań|Lubockie|ul. Szkolna 13 |42-713 Kochanowice;472;168;168;8;160;35.59;4.76
103774;240705;Oddział Rehabilitacji, Balneologii i Medycyny Fizykalnej|Kochcice|ul. Zamkowa 1 |42-713 ;110;88;88;5;83;80.00;5.68
103775;240706;Urząd Gminy|Koszęcin|ul. Powstańców Śląskich 10 |42-286 ;1980;1003;1003;37;966;50.66;3.69
103776;240706;Szkoła Podstawowa|Koszęcin|ul. Sobieskiego 7 |42-286 ;2013;1113;1113;24;1089;55.29;2.16
103777;240706;Zespół Szkół|Strzebiń|ul. Lompy 9 |42-288 Koszęcin;1623;734;734;17;717;45.22;2.32
103778;240706;Dom Strażaka|Strzebiń|ul. 1 Maja 23a |42-288 Koszęcin;1192;482;482;7;475;40.44;1.45
103779;240706;Szkoła Podstawowa|Sadów|ul. Powstańców Śląskich 72 |42-700 Lubliniec;1452;653;653;26;627;44.97;3.98
103780;240706;Szkoła Podstawowa|Rusinowice|ul. 1 Maja 29 |42-700 Lubliniec;1214;594;594;18;576;48.93;3.03
103781;240707;Świetlica dla dzieci i młodzieży|Pawonków|ul. Zawadzkiego 6 |42-772 Pawonków;1208;477;477;11;466;39.49;2.31
103782;240707;Przedszkole|Łagiewniki Wielkie|ul. Lompy 20 |42-772 Pawonków;516;202;202;9;193;39.15;4.46
103783;240707;Szkoła Podstawowa|Lisowice|ul. Mickiewicza 22 |42-700 Lubliniec;1309;558;558;9;549;42.63;1.61
103784;240707;Szkoła Podstawowa|Kośmidry|ul. Szkolna 3 |42-772 Pawonków;780;315;315;8;307;40.38;2.54
103785;240707;Szkoła Podstawowa|Łagiewniki Małe|ul. Lubliniecka 30 |42-772 Pawonków;930;300;300;20;280;32.26;6.67
103786;240707;Szkoła Podstawowa|Gwoździany|ul. Lubliniecka 5 |42-772 Pawonków;589;180;180;10;170;30.56;5.56
103787;240708;Miejsko-Gminny Ośrodek Kultury|Woźniki|ul. Górna 5 |42-289 Woźniki;1240;581;581;19;562;46.85;3.27
103788;240708;Miejsko-Gminny Ośrodek Kultury|Woźniki|ul. Górna 5 |42-289 Woźniki;1290;604;604;20;584;46.82;3.31
103789;240708;Szkoła Podstawowa|Woźniki|ul. Szkolna 5 |42-289 Woźniki;710;353;353;16;337;49.72;4.53
103790;240708;Szkoła Podstawowa|Psary|ul. Główna 91 |42-287 Lubsza;1062;562;562;28;534;52.92;4.98
103791;240708;Szkoła Podstawowa|Kamienica|ul. Częstochowska 42 |42-287 Lubsza;680;326;326;13;313;47.94;3.99
103792;240708;Szkoła Podstawowa|Lubsza|ul. Szkolna 1 |42-287 Lubsza;763;345;345;13;332;45.22;3.77
103793;240708;OSP|Piasek|ul. Strażacka 2 |42-287 Lubsza;259;140;140;2;138;54.05;1.43
103794;240708;Budynek Szkoły Podstawowej prowadzonej przez Stowarzyszenie|Kamieńskie Młyny|ul. Szkolna 10 |42-287 Lubsza;506;258;258;13;245;50.99;5.04
103795;240708;Budynek GS|Woźniki|ul. Asfaltowa 58 |42-289 Woźniki;362;182;182;2;180;50.28;1.10
103796;240708;Szkoła Podstawowa|Psary|ul. Główna 91 |42-287 Lubsza;907;395;395;14;381;43.55;3.54
103797;240801;Szkoła Podstawowa nr 5 im. Powstańców Śląskich|Łaziska Górne|ul. Szkolna 4 |43-173 Łaziska Górne;821;510;510;2;508;62.12;0.39
103798;240801;Szkoła Podstawowa nr 5 im. Powstańców Śląskich|Łaziska Górne|ul. Szkolna 4 |43-173 Łaziska Górne;892;527;527;15;512;59.08;2.85
103799;240801;Miejski Dom Kultury ( Filia Łaziska Średnie)|Łaziska Górne|ul. Pstrowskiego 17 |43-173 Łaziska Górne;868;441;441;10;431;50.81;2.27
103800;240801;Gimnazjum nr 3 im. "Przyjaciół Ziemi"|Łaziska Górne|ul. Powstańców 6 |43-173 Łaziska Górne;841;466;466;11;455;55.41;2.36
103801;240801;Powiatowa i Miejska Biblioteka Publiczna ( Filia w Łaziskach Średnich)|Łaziska Górne|ul. Wyszyńskiego 8 |43-173 Łaziska Górne;720;286;286;8;278;39.72;2.80
103802;240801;Szkoła Podstawowa nr 6 z Oddziałami Integracyjnymi im. Jana Pawła II|Łaziska Górne|ul. Wyrska 4 |43-173 Łaziska Górne;844;466;466;14;452;55.21;3.00
103803;240801;Szkoła Podstawowa nr 6 z Oddziałami Integracyjnymi im. Jana Pawła II|Łaziska Górne|ul. Wyrska 4 |43-173 Łaziska Górne;818;465;465;12;453;56.85;2.58
103804;240801;Gimnazjum nr 3 im. "Przyjaciół Ziemi"|Łaziska Górne|ul. Powstańców 6 |43-173 Łaziska Górne;910;404;404;10;394;44.40;2.48
103805;240801;Szkoła Podstawowa nr 6 z Oddziałami Integracyjnymi im. Jana Pawła II|Łaziska Górne|ul. Wyrska 4 |43-173 Łazoska Górne;855;448;448;4;444;52.40;0.89
103806;240801;Zespół Szkół im. Piastów Śląskich|Łaziska Górne|ul. Cieszyńska 12 |43-170 Łaziska Górne;864;452;452;8;444;52.31;1.77
103807;240801;Przedszkole nr 2 Integracyjne|Łaziska Górne|ul. Miodowa 11 |43-170 Łaziska Górne;887;506;506;6;500;57.05;1.19
103808;240801;Salon Samochodowy|Łaziska Górne|ul. Leśna 1 |43-170 Łaziska Górne;889;624;624;18;606;70.19;2.88
103809;240801;Zespół Szkół Energetycznych i Usługowych|Łaziska Górne|ul. Chopina 11b |43-170 Łaziska Górne;782;423;423;10;413;54.09;2.36
103810;240801;Miejski Dom Kultury|Łaziska Górne|ul. Świerczewskiego 2 |43-170 Łaziska Górne;802;487;487;8;479;60.72;1.64
103811;240801;Przedszkole nr 5 im. Przyjaciół Bohaterów Bajek|Łaziska Górne|ul. Chopina 1 |43-170 Łaziska Górne;697;378;378;14;364;54.23;3.70
103812;240801;Szkoła Podstawowa nr 1|Łaziska Górne|ul.Dworcowa 4 |43-170 Łaziska Górne;772;444;444;5;439;57.51;1.13
103813;240801;Miejski Dom Kultury|Łaziska Górne|ul.Świerczewskiego 2 |43-170 Łaziska Górne;682;383;383;5;378;56.16;1.31
103814;240801;Powiatowa i Miejska Biblioteka Publiczna|Łaziska Górne|ul. Świerczewskiego 1 |43-170 Łaziska Górne;777;416;416;13;403;53.54;3.12
103815;240801;Gimnazjum nr 1 im. Mikołaja Kopernika|Łaziska Górne|ul. Ogrodowa 48 |43-170 Łaziska Górne;723;396;396;10;386;54.77;2.53
103816;240801;Szkoła Podstawowa nr 1|Łaziska Górne|ul. Dworcowa 4 |43-170 Łaziska Górne;920;495;495;11;484;53.80;2.22
103817;240801;Gimnazjum nr 1 im. Mikołaja Kopernika|Łaziska Górne|ul.Ogrodowa 48 |43-170 Łaziska Górne;849;415;415;12;403;48.88;2.89
103818;240802;Miejski Dom Kultury|Mikołów|Rynek 19 |43-190 Mikołów;1234;558;558;19;539;45.22;3.41
103819;240802;Dom Katecheczny|Mikołów|ul. Okrzei 14a |43-190 Mikołów;1313;756;756;7;749;57.58;0.93
103820;240802;Sąd Rejonowy|Mikołów|ul. kard. Wyszyńskiego 4 |43-190 Mikołów;1216;738;738;17;721;60.69;2.30
103821;240802;Przedszkole nr 2|Mikołów|ul.Jansa 2 |43-190 Mikołów;912;445;445;10;435;48.79;2.25
103822;240802;Gimnazjum nr 2|Mikołów|ul. Krakowska 30 |43-190 Mikołów;1230;681;681;9;672;55.37;1.32
103823;240802;Gimnazjum nr 2|Mikołów|ul. Krakowska 30 |43-190 Mikołów;1643;920;920;10;910;56.00;1.09
103824;240802;Szkoła Podstawowa nr 3|Mikołów|ul. Bandurskiego 1 |43-190 Mikołów;1898;1212;1212;10;1202;63.86;0.83
103825;240802;Szkoła Podstawowa nr 3|Mikołów|ul. Bandurskiego 1 |43-190 Mikołów;2137;1200;1200;19;1181;56.15;1.58
103826;240802;Gimnazjum nr 1|Mikołów|ul. Konstytucji 3 Maja 20 |43-190 Mikołów;2041;1276;1276;21;1255;62.52;1.65
103827;240802;Liceum Ogólnokształcące|Mikołów|ul. Żwirki i Wigury 25 |43-190 Mikołów;1834;1055;1055;40;1015;57.52;3.79
103828;240802;Liceum Ogólnokształcące|Mikołów|ul. Żwirki i Wigury 25 |43-190 Mikołów;1496;730;730;20;710;48.80;2.74
103829;240802;Zespół Szkół Technicznych|Mikołów|ul. Rybnicka 44 |43-190 Mikołów;1170;622;622;7;615;53.16;1.13
103830;240802;Szkoła Podstawowa nr 5|Mikołów|ul. Katowicka 24 |43-190 Mikołów;1113;599;599;21;578;53.82;3.51
103831;240802;Biurowiec w zarządzie ZGL|Mikołów|ul. kard. S. Wyszyńskiego 13 |43-190 Mikołów;932;568;568;8;560;60.94;1.41
103832;240802;Szkoła Podstawowa nr 4|Mikołów, Kamionka|ul. Katowicka 122 |43-190 Mikołów;2118;1405;1405;17;1388;66.34;1.21
103833;240802;Zespół Szkolno-Przedszkolny|Mikołów,|ul. Skalna 12 |43-190 Mikołów;1375;839;839;13;826;61.02;1.55
103834;240802;Szkoła Podstawowa nr 7|Mikołów,Mokre|ul. Zamkowa 1 |43-190 Mikołów;2150;1187;1187;16;1171;55.21;1.35
103835;240802;Biblioteka|Mikołów, Śmiłowice|ul. Gliwicka 102 |43-190 Mikołów;823;451;451;9;442;54.80;2.00
103836;240802;Szkoła Podstawowa nr 8|Mikołów, Paniowy|ul. Wolności 30 |43-190 Mikołów;1289;808;808;35;773;62.68;4.33
103837;240802;Zespół Szkół nr 2|Mikołów, Borowa Wieś|Gliwicka 299 |43-190 Mikołów;1849;1079;1079;12;1067;58.36;1.11
103838;240802;Zespół Szkół nr 3|Mikołów|Szkolna 1 |43-196 Mikołów;1628;958;958;17;941;58.85;1.77
103839;240802;Szpital Powiatowy|Mikołów|Waryńskiego 4 |43-190 Mikołów;112;35;35;1;34;31.25;2.86
103840;240802;Szpital św. Józefa|Mikołów|Okrzei 27 |43-190 Mikołów;133;38;38;1;37;28.57;2.63
103841;240802;Ośrodek dla Niepełnosprawnych Miłosierdzie Boże-Dom Pomocy Społecznej|Mikołów|Gliwicka 366 |43-190 Mikołów;133;67;67;6;61;50.38;8.96
103842;240803;Miejski Ośrodek Kultury|Orzesze|ul.Rynek 1 |43-180 Orzesze;910;512;512;10;502;56.26;1.95
103843;240803;Miejski Ośrodek Kultury|Orzesze|ul.Rynek 1 |43-180 Orzesze;846;493;493;9;484;58.27;1.83
103844;240803;Zespół Szkół|Orzesze|ul.K.Miarki 1a |43-180 Orzesze;961;522;522;11;511;54.32;2.11
103845;240803;Szkoła Podstawowa Nr 2|Orzesze|ul.Bukowina 19-21 |43-180 Orzesze;839;435;435;3;432;51.85;0.69
103846;240803;Szkoła Podstawowa Nr 2|Orzesze|ul.Bukowina 19-21 |43-180 Orzesze;914;517;517;8;509;56.56;1.55
103847;240803;Przedszkole Nr 2|Orzesze|ul.Miła 1a |43-180 Orzesze;943;532;532;13;519;56.42;2.44
103848;240803;Szkoła Podstawowa Nr 4|Orzesze, Jaśkowice|ul.Stuska 10 |43-180 Orzesze;1046;555;555;4;551;53.06;0.72
103849;240803;Szkoła Podstawowa Nr 4|Orzesze, Jaśkowice|ul.Stuska 10 |43-180 Orzesze;946;504;504;4;500;53.28;0.79
103850;240803;Gimnazjum Nr 3|Orzesze, Gardawice|ul.Uczniowska 1 |43-180 Orzesze;1588;922;922;32;890;58.06;3.47
103851;240803;Szkoła Podstawowa Nr 8|Orzesze, Mościska|ul.Bolesława Chrobrego 64 |43-180 Orzesze;757;486;486;17;469;64.20;3.50
103852;240803;Szkoła Podstawowa Nr 10|Orzesze, Woszczyce|ul.Norwida 2 |43-180 Orzesze;1192;642;642;12;630;53.86;1.87
103853;240803;Gimnazjum Nr 2|Orzesze, Zawada|ul.Szkolna 44 |43-180 Orzesze;1526;827;827;26;801;54.19;3.14
103854;240803;Szkoła Podstawowa Nr 6|Orzesze, Zawiść|ul.1000-Lecia 1 |43-180 Orzesze;1554;924;924;15;909;59.46;1.62
103855;240803;Szkoła Podstawowa Nr 5|Orzesze, Zazdrość|ul.Żorska 101 |43-180 Orzesze;943;569;569;11;558;60.34;1.93
103856;240803;Szkoła Podstawowa Nr 9|Orzesze, Zgoń|ul.Kobiórska 1 |43-180 Orzesze;878;580;580;16;564;66.06;2.76
103857;240803;Szpital Chorób Płuc|Orzesze|ul.Gliwicka 20 |43-180 Orzesze;45;25;25;2;23;55.56;8.00
103858;240804;Gimnazjum im.Noblistów Polskich|Ornontowice|ul. Zwycięstwa 7c |43-178 Ornontowice;1504;902;902;17;885;59.97;1.88
103859;240804;Gimnazjum im.Noblistów Polskich|Ornontowice|ul. Zwycięstwa 7c |43-178 Ornontowice;1504;807;807;30;777;53.66;3.72
103860;240804;Gimnazjum im.Noblistów Polskich|Ornontowice|Zwycięstwa 7c |43-178 Ornontowice;1589;879;879;27;852;55.32;3.07
103861;240805;Pawilon Handlowy|Wyry|ul. Dąbrowszczaków 58 |43-175 Wyry;1141;673;673;15;658;58.98;2.23
103862;240805;Zespół Szkół w Wyrach|Wyry|ul. Aleksandra Puszkina 10 |43-175 Wyry;732;439;439;10;429;59.97;2.28
103863;240805;Zespół Szkół w Wyrach|Wyry|ul. Aleksandra Puszkina 10 |43-175 Wyry;1188;686;686;8;678;57.74;1.17
103864;240805;Dom Kultury w Gostyni|Gostyń|ul. Pszczyńska 366 |43-176 Gostyń;1309;839;839;17;822;64.09;2.03
103865;240805;Zespół Szkół w Gostyni|Gostyń|ul. Rybnicka 141 |43-176 Gostyń;808;485;485;9;476;60.02;1.86
103866;240805;Zespół Szkół w Gostyni|Gostyń|ul. Rybnicka 141 |43-176 Gostyń;836;514;514;11;503;61.48;2.14
103867;240901;Szkoła Podstawowa Nr 7|Myszków|Pińczycka 2 |42-300 Myszków;1041;442;442;13;429;42.46;2.94
103868;240901;Przedszkole nr 2|Myszków|Pułaskiego 7a |42-300 Myszków;1376;707;707;11;696;51.38;1.56
103869;240901;Zespół Szkół Publicznych Nr 1|Myszków|Leśna 1 |42-300 Myszków;1141;507;507;15;492;44.43;2.96
103870;240901;Zespół Szkół Publicznych nr 1|Myszków|Leśna 1 |42-300 Myszków;1121;559;559;13;546;49.87;2.33
103871;240901;Przedszkole nr 2|Myszków|Pułaskiego 7a |42-300 Myszków;821;376;376;14;362;45.80;3.72
103872;240901;Szkoła Podstawowa nr 4|Myszków|Jedwabna 93 |42-300 Myszków;1302;617;617;8;609;47.39;1.30
103873;240901;Zespół Szkolno-Przedszkolny nr 4|Myszków|Traugutta 43 |42-300 Myszków;1510;690;690;8;682;45.70;1.16
103874;240901;Ochotnicza Straż Pożarna|Myszków|Pogodna 4 |42-300 Myszków;770;313;313;15;298;40.65;4.79
103875;240901;Środowiskowy Dom Samopomocy|Myszków|Millenium 19c |42-300 Myszków;1460;716;716;24;692;49.04;3.35
103876;240901;Zespół Szkół Publicznych nr 2|Myszków|Jaworznicka 34 |42-300 Myszków;1152;587;587;10;577;50.95;1.70
103877;240901;Zespół Szkół Publicznych Nr 5|Myszków|Sikorskiego 20a |42-300 Myszków;1416;563;563;24;539;39.76;4.26
103878;240901;Zespół Szkół Publicznych nr 5|Myszków|Sikorskiego 20a |42-300 Myszków;1757;811;811;11;800;46.16;1.36
103879;240901;Liceum Ogólnokształcące|Myszków|11 Listopada 19 |42-300 Myszków;1619;623;623;20;603;38.48;3.21
103880;240901;Myszkowska Spółdzielnia Mieszkaniowa|Myszków|11 Listopada 7 |42-300 Myszków;1237;572;572;10;562;46.24;1.75
103881;240901;Zespół Szkół Publicznych nr 3|Myszków|Kościuszki 30 |42-300 Myszków;788;408;408;13;395;51.78;3.19
103882;240901;Przedszkole nr 5|Myszków|Stalowa 1 |42-300 Myszków;976;522;522;9;513;53.48;1.72
103883;240901;Przedszkole nr 5|Myszków|Stalowa 1 |42-300 Myszków;909;462;462;8;454;50.83;1.73
103884;240901;Szkoła Podstawowa nr 6|Myszków|Wapienna 2 |42-300 Myszków;1560;587;587;24;563;37.63;4.09
103885;240901;Świetlica Rejonu Energetycznego|Myszków|Jana Pawła II 32 |42-300 Myszków;1149;625;625;9;616;54.40;1.44
103886;240901;Przedszkole nr 1|Myszków|Majora Sucharskiego 32 |42-300 Myszków;1465;715;715;19;696;48.81;2.66
103887;240901;Środowiskowy Dom Samopomocy|Myszków|Gałczyńskiego 7 |42-300 Myszków;1483;652;652;14;638;43.96;2.15
103888;240901;Szpital Powiatowy|Myszków|Aleja Wolności 29 |42-300 ;58;19;19;0;19;32.76;0.00
103889;240902;Szkoła Podstawowa|Cynków|ul. Strażacka 1 |42-350 42-350 Koziegłowy;966;299;299;11;288;30.95;3.68
103890;240902;Dom Ludowy|Gniazdów|ul. Szkolna 5 |42-350 42-350 Koziegłowy;770;344;344;12;332;44.68;3.49
103891;240902;Miejsko-Gminny Ośrodek Promocji Kultury|Koziegłowy|ul. Żarecka 28 |42-350 42-350 Koziegłowy;1301;559;559;9;550;42.97;1.61
103892;240902;Zespół Szkół|Koziegłowy|ul. 3 Maja 12 |42-350 42-350 Koziegłowy;721;386;386;9;377;53.54;2.33
103893;240902;Szkoła Podstawowa|Koziegłówki|ul. Lipowa 6 |42-350 42-350 Koziegłowy;742;301;301;10;291;40.57;3.32
103894;240902;Szkoła Podstawowa|Mysłów|ul. Myszkowska 22 |42-350 42-350 Koziegłowy;932;352;352;22;330;37.77;6.25
103895;240902;Zespół Szkół w Lgocie Górnej|Lgota Mokrzesz|ul. Szkolna 3 |42-350 42-350 Koziegłowy;2111;927;927;19;908;43.91;2.05
103896;240902;Zespół Szkół|Pińczyce|ul. Śląska 3 |42-350 42-350 Koziegłowy;1782;797;797;34;763;44.73;4.27
103897;240902;OSP|Markowice|ul. Świętego Floriana 2 |42-350 42-350 Koziegłowy;643;221;221;5;216;34.37;2.26
103898;240902;OSP|Rzeniszów|ul. Leśników 11 |42-350 42-350 Koziegłowy;862;359;360;11;348;41.65;3.06
103899;240902;Szkoła Podstawowa|Siedlec Duży|ul. Jana Pawła II 34 |42-350 42-350 Koziegłowy;1043;431;431;17;414;41.32;3.94
103900;240903;Szkoła Podstawowa|Niegowa|ul. Szkolna 36 |42-320 ;1219;653;653;38;615;53.57;5.82
103901;240903;Szkoła Podstawowa|Niegowa|ul. Szkolna 36 |42-320 ;1047;504;504;29;475;48.14;5.75
103902;240903;Szkoła Podstawowa|Ludwinów| 30 |42-320 ;838;314;314;14;300;37.47;4.46
103903;240903;Zespół Szkolno-Przedszkolny|Sokolniki| 76 |42-320 ;709;410;410;10;400;57.83;2.44
103904;240903;Szkoła Podstawowa|Dąbrowno| 50 |42-320 ;381;192;192;10;182;50.39;5.21
103905;240903;Szkoła Podstawowa|Bliżyce| 63 |42-320 ;465;235;235;4;231;50.54;1.70
103906;240904;Szkoła Podstawowa|Poraj|ul. Górnicza 18 |42-360 Poraj;1742;978;978;19;959;56.14;1.94
103907;240904;Urząd Gminy|Poraj|ul. Jasna 21 |42-360 Poraj;1878;935;935;25;910;49.79;2.67
103908;240904;Szkoła Podstawowa|Jastrząb|ul. Mickiewicza 1 |42-360 Poraj;1098;408;408;20;388;37.16;4.90
103909;240904;Szkoła Podstawowa|Choroń|ul. Szkolna 9 |42-360 Poraj;1054;512;512;15;497;48.58;2.93
103910;240904;Szkoła Podstawowa|Kuźnica Stara| 4 |42-360 Poraj;566;241;241;17;224;42.58;7.05
103911;240904;Niepubliczna Szkoła Podstawowa|Masłońskie|ul. Sportowa 11 |42-360 Poraj;525;258;258;4;254;49.14;1.55
103912;240904;Szkoła Podstawowa|Żarki-Letnisko|ul. Szkolna 20 |42-311 Żarki-Letnisko;2121;1201;1201;23;1178;56.62;1.92
103913;240905;Miejsko-Gminny Ośrodek Kultury|Żarki|ul. Moniuszki 2 |42-310 Żarki;1277;631;631;21;610;49.41;3.33
103914;240905;Szkoła Podstawowa im. Władysława Szafera|Żarki|ul. Częstochowska 61 |42-310 Żarki;639;312;312;4;308;48.83;1.28
103915;240905;Gimnazjum im. Jana Pawła II|Żarki|ul. Ofiar Katynia 3 |42-310 Żarki;1285;652;652;15;637;50.74;2.30
103916;240905;Zespół Szkół im. Tadeusza Kościuszki|Żarki, Olesiów|ul. Myszkowska 50 |42-310 Żarki;523;256;256;3;253;48.95;1.17
103917;240905;Szkoła Podstawowa im. Jana Pawła II|Jaworznik|ul. Szkolna 35 |42-310 Żarki;633;278;278;8;270;43.92;2.88
103918;240905;Szkoła Podstawowa im. Integracji Europejskiej|Przybynów|ul. Szkolna 2 |42-310 Żarki;932;344;344;10;334;36.91;2.91
103919;240905;Szkoła Podstawowa w Zawadzie|Zawada| 56 |42-310 Żarki;705;216;216;18;198;30.64;8.33
103920;240905;Świetlica Wiejska "Przystań"|Wysoka Lelowska|ul. Częstochowska 95 |42-310 Żarki;485;189;189;9;180;38.97;4.76
103921;240905;Filia Przedszkola Publicznego w Żarkach|Kotowice|ul. Zamkowa 13 |42-310 Żarki;395;162;162;6;156;41.01;3.70
103922;241001;Sanatorium "Wrzos"|Goczałkowice-Zdrój|ul. Uzdrowiskowa 54 |43-230 Goczałkowice-Zdrój;1248;726;727;14;712;58.17;1.93
103923;241001;Przedszkole Nr1|Goczałkowice-Zdrój|ul. Szkolna 15 |43-230 Goczałkowice-Zdrój;1076;621;621;16;605;57.71;2.58
103924;241001;Szkoła Podstawowa Nr 1|Goczałkowice-Zdrój|ul. Powstańców Śląskich 3 |43-230 Goczałkowice-Zdrój;1090;646;646;16;630;59.27;2.48
103925;241001;Gimnazjum|Goczałkowice-Zdrój|ul. Powstańców Śląskich 3 |43-230 Goczałkowice-Zdrój;1445;804;804;23;781;55.64;2.86
103926;241001;Budynek Administracyjny Zakładu Produkcji Wody|Goczałkowice-Zdrój|ul. Jeziorna 5 |43-230 Goczałkowice-Zdrój;439;260;260;7;253;59.23;2.69
103927;241001;Zespół Sanatoryjno-Szpitalny Rehabilitacji Narządu Ruchu „Gwarek”|Goczałkowice-Zdrój|Uzdrowiskowa 51 |43-230 Goczałkowice-Zdrój;207;158;158;5;153;76.33;3.16
103928;241001;Szpital Reumatologiczno-Rehabilitacyjny|Goczałkowice-Zdrój|Uzdrowiskowa 55 |43-230 Goczałkowice-Zdrój;322;245;245;3;242;76.09;1.22
103929;241002;Gminny Dom Kultury w Kobiórze|Kobiór|ul.Centralna 16 |43-210 Kobiór;1037;574;574;10;564;55.35;1.74
103930;241002;Szkoła Podstawowa w Kobiórze|Kobiór|ul. Tuwima 33 |43-210 Kobiór;1478;883;883;11;872;59.74;1.25
103931;241002;Szkoła Podstawowa w Kobiórze|Kobiór|ul. Tuwima 33 |43-210 Kobiór;1340;868;869;8;860;64.78;0.92
103932;241003;Dom Socjalny|Grzawa|ul. Księża 19 |43-227 Miedźna;515;300;300;9;291;58.25;3.00
103933;241003;Zespół Szkół w Miedźnej|Miedźna|ul. Szkolna 24 |43-227 Miedźna;1178;766;766;20;746;65.03;2.61
103934;241003;Szkoła Podstawowa|Frydek|ul. Miodowa 17 |43-227 Miedźna;884;533;533;13;520;60.29;2.44
103935;241003;Liceum Ogólnokształcące|Gilowice|ul. Wojciecha Korfantego 38 |43-227 Miedźna;1177;716;716;11;705;60.83;1.54
103936;241003;Dom Kultury|Wola|ul. Pszczyńska 110 |43-225 Wola;1488;1026;1026;22;1004;68.95;2.14
103937;241003;Szkoła Podstawowa nr 1|Wola|ul. Górnicza 47 |43-225 Wola;1485;745;745;29;716;50.17;3.89
103938;241003;Szkoła Podstawowa nr 1|Wola|ul. Górnicza 47 |43-225 Wola;1477;703;703;22;681;47.60;3.13
103939;241003;Szkoła Podstawowa Nr 2|Wola|ul. Lipowa 3 |43-225 Wola;954;486;486;18;468;50.94;3.70
103940;241003;Szkoła Podstawowa Nr 2|Wola|ul. Lipowa 3 |43-225 Wola;916;486;486;13;473;53.06;2.67
103941;241003;Szkoła Podstawowa|Góra|ul. Pszczyńska 34 |43-227 Miedźna;1496;839;839;20;819;56.08;2.38
103942;241003;Szkoła Podstawowa|Góra|ul. Pszczyńska 34 |43-227 Miedźna;744;397;397;11;386;53.36;2.77
103943;241004;Centrum Kultury Pawłowice|Pawłowice|ul. Zjednoczenia 67 |43-250 Pawłowice;992;668;669;13;655;67.34;1.95
103944;241004;Centrum Kultury Pawłowice|Pawłowice|ul. Zjednoczenia 67 |43-250 Pawłowice;1095;742;742;23;719;67.76;3.10
103945;241004;Centrum Kultury Pawłowice|Pawłowice|ul. Zjednoczenia 67 |43-250 Pawłowice;912;508;508;18;490;55.70;3.54
103946;241004;Szkoła Podstawowa nr 2|Pawłowice|ul. Pukowca 4 |43-251 Pawłowice;954;541;541;17;524;56.71;3.14
103947;241004;Szkoła Podstawowa nr 2|Pawłowice|ul. Pukowca 4 |43-251 Pawłowice;893;473;473;15;458;52.97;3.17
103948;241004;Zespół Szkół Ogólnokształcących|Pawłowice|ul. Pukowca 5 |43-251 Pawłowice;767;413;413;9;404;53.85;2.18
103949;241004;Dom Kultury-Osiedle|Pawłowice|ul. Ludowego Wojska Polskiego 11 |43-251 Pawłowice;896;513;513;16;497;57.25;3.12
103950;241004;Dom Kultury-Osiedle|Pawłowice|ul. Ludowego Wojska Polskiego 11 |43-251 Pawłowice;857;463;463;9;454;54.03;1.94
103951;241004;Dom Strażaka w Pielgrzymowicach|Pielgrzymowice|ul. Zebrzydowicka 14 |43-252 Golasowice;1107;647;647;17;630;58.45;2.63
103952;241004;Dom Strażaka w Pielgrzymowicach|Pielgrzymowice|ul. Zebrzydowicka 14 |43-252 Golasowice;951;579;579;13;566;60.88;2.25
103953;241004;Szkoła Podstawowa|Warszowice|ul. Pszczyńska 2 |43-254 Warszowice;848;514;514;16;498;60.61;3.11
103954;241004;Szkoła Podstawowa|Warszowice|ul. Pszczyńska 2 |43-254 Warszowice;694;393;393;5;388;56.63;1.27
103955;241004;Dom Strażaka w Golasowicach|Golasowice|ul. Kraszewskiego 2 |43-252 Golasowice;1096;571;571;7;564;52.10;1.23
103956;241004;Zespół Szkolno-Przedszkolny|Krzyżowice|ul. Szkolna 7 |43-254 Warszowice;786;464;464;11;453;59.03;2.37
103957;241004;Dom Ludowy Jarząbkowice|Jarząbkowice|ul. Rolnicza 1 |43-252 Golasowice;502;247;247;6;241;49.20;2.43
103958;241004;Dom Ludowy Pniówek|Pniówek|ul. Kanarkowa 2 |43-251 Pawłowice;435;246;246;7;239;56.55;2.85
103959;241005;Szkoła Podstawowa Nr 1 im. Książąt Pszczyńskich|Pszczyna|ul. ks. biskupa Bogedaina 1 |43-200 Pszczyna;1169;566;566;20;546;48.42;3.53
103960;241005;Przedszkole Publiczne Nr 2 im. Juliana Tuwima|Pszczyna|ul. L. Zamenhofa 12 |43-200 Pszczyna;1337;711;711;18;693;53.18;2.53
103961;241005;Powiatowy Zespół Szkół Nr 2 im. Karola Miarki|Pszczyna|ul. ks. biskupa Bogedaina 20 |43-200 Pszczyna;911;523;523;15;508;57.41;2.87
103962;241005;Pszczyńskie Towarzystwo Budownictwa Społecznego|Pszczyna|ul. Jana Kilińskiego 5a |43-200 Pszczyna;1122;596;596;17;579;53.12;2.85
103963;241005;Szkoła Podstawowa Nr 18 z oddziałami integracyjnymi im.ks.J. Twardowskiego|Pszczyna|ul. Księżycowa 25 |43-200 Pszczyna;1430;857;857;18;839;59.93;2.10
103964;241005;Szkoła Podstawowa Nr 18 z oddziałami integracyjnymi im. ks. J. Twardowskiego|Pszczyna|ul. Księżycowa 25 |43-200 Pszczyna;1392;901;901;12;889;64.73;1.33
103965;241005;Zespół Szkół Nr 1|Pszczyna|ul. Kazimierza Wielkiego 5 |43-200 Pszczyna;1636;941;941;7;934;57.52;0.74
103966;241005;Zespół Szkół Nr 1|Pszczyna|ul. Kazimierza Wielkiego 5 |43-200 Pszczyna;1479;864;864;16;848;58.42;1.85
103967;241005;Publiczne Gimnazjum Nr 4|Pszczyna|ul. Marii Konopnickiej 44 |43-200 Pszczyna;1781;1122;1122;10;1112;63.00;0.89
103968;241005;Przedszkole Publiczne Nr 4|Pszczyna|ul. Narcyzów 30 |43-200 Pszczyna;1634;996;996;16;980;60.95;1.61
103969;241005;Szkoła Podstawowa Nr 2 im. Jadwigi Śląskiej|Pszczyna|ul. Katowicka 47 |43-200 Pszczyna;1529;898;898;13;885;58.73;1.45
103970;241005;Przedszkole Publiczne Nr 8|Pszczyna|ul. Jana Kupca 1 |43-200 Pszczyna;1607;903;903;10;893;56.19;1.11
103971;241005;Zespół Szkół Nr 2|Pszczyna|ul. Staromiejska 41 |43-200 Pszczyna;1738;1027;1027;24;1003;59.09;2.34
103972;241005;Powiatowy Zespół Szkół Nr 2 im. Karola Miarki|Pszczyna|ul. Karola Szymanowskiego 12 |43-200 Pszczyna;1544;863;864;15;848;55.89;1.74
103973;241005;Ośrodek Kultury|Czarków|ul. Powstańców Śląskich 25a |43-211 Piasek;1645;936;937;52;884;56.90;5.56
103974;241005;"Sołtysówka"|Piasek|ul. Mjr. Henryka Sucharskiego 1 |43-211 Piasek;1402;809;809;19;790;57.70;2.35
103975;241005;Zespół Szkolno-Przedszkolny|Piasek|ul. Szkolna 4 |43-211 Piasek;1264;796;796;14;782;62.97;1.76
103976;241005;Szkoła Podstawowa Nr 19|Brzeźce|ul. Pokoju 2 |43-200 Pszczyna;857;530;530;14;516;61.84;2.64
103977;241005;Szkoła Podstawowa Nr 11|Poręba|ul. Gen. Karola Świerczewskiego 8 |43-200 Pszczyna;811;492;492;12;480;60.67;2.44
103978;241005;Zespół Szkolno-Przedszkolny|Jankowice|ul. Baziowa 17 |43-215 Jankowice;1174;749;749;19;730;63.80;2.54
103979;241005;Zespół Szkolno-Przedszkolny|Jankowice|ul. Baziowa 17 |43-215 Jankowice;1048;660;660;16;644;62.98;2.42
103980;241005;Zespół Szkolno-Przedszkolny|Studzienice|ul. Klemensa Szewczyka 74 |43-215 Studzienice;1442;808;808;19;789;56.03;2.35
103981;241005;Szkoła Podstawowa Nr 7 im. Żołnierzy Września|Ćwiklice|ul. Męczenników Oświęcimskich 71 |43-229 Ćwiklice;1564;878;878;13;865;56.14;1.48
103982;241005;Ośrodek Kultury|Ćwiklice|ul. Aleksandra Zawadzkiego 15 |43-229 Ćwiklice;693;376;376;4;372;54.26;1.06
103983;241005;Ośrodek Kultury|Rudołtowice|ul. Anieli Krzywoń 6 |43-229 Ćwiklice;885;486;486;18;468;54.92;3.70
103984;241005;Zespół Szkolno-Przedszkolny|Łąka|ul. Grzegorza Fitelberga 1 |43-241 Łąka;1153;639;639;16;623;55.42;2.50
103985;241005;Zespół Szkolna-Przedszkolny|Łąka|ul. Grzegorza Fitelberga 1 |43-241 Łąka;1235;737;737;17;720;59.68;2.31
103986;241005;Zespół Szkolno-Przedszkolny|Wisła Wielka|ul. Hodowców 38 |43-243 Wisła Wielka;1429;863;863;30;833;60.39;3.48
103987;241005;Szkoła Podstawowa Nr 13|Wisła Mała|ul. Sokola 10 |43-243 Wisła Wielka;1364;746;746;21;725;54.69;2.82
103988;241005;Przedszkole Publiczne Nr 14|Studzionka|ul. Jedności 7 |43-245 Studzionka;1771;1031;1031;39;992;58.22;3.78
103989;241005;"CENTRUM DIALIZA" Sp. z o.o. NZOZ Szpital w Pszczynie|Pszczyna|dr. Witolda Antesa 11 |43-200 Pszczyna;151;51;51;1;50;33.77;1.96
103990;241006;Szkoła Podstawowa w Kobielicach|Kobielice|ul. Topolowa 61 |43-262 Radostowice;1054;562;562;5;557;53.32;0.89
103991;241006;Remizo - świetlica w Kryrach|Kryry|ul. Wyzwolenia 116 |43-265 Mizerów;1096;721;721;7;714;65.78;0.97
103992;241006;Zespół Szkolno-Przedszkolny w Mizerowie|Mizerów|ul. Nadrzeczna 31 |43-265 Mizerów;1131;649;649;13;636;57.38;2.00
103993;241006;Szkoła Podstawowa w Radostowicach|Radostowice|ul. Dworcowa 56 |43-262 Radostowice;1331;796;796;19;777;59.80;2.39
103994;241006;Zespół Szkolno-Przedszkolny w Rudziczce|Rudziczka|ul. Woszczycka 20 |43-267 Suszec;1060;639;639;13;626;60.28;2.03
103995;241006;Gimnazjum Publiczne w Suszcu|Suszec|ul. Szkolna 130 |43-267 Suszec;1611;1027;1027;27;1000;63.75;2.63
103996;241006;Boisko piłkarskie w Suszcu - Budynek socjalny|Suszec|Piaskowa 33 |43-267 Suszec;740;345;345;10;335;46.62;2.90
103997;241006;Gimnazjum Publiczne w Suszcu|Suszec|ul. Szkolna 130 |43-267 Suszec;1062;667;667;12;655;62.81;1.80
103998;241101;Szkoła Podstawowa Nr 3|Racibórz|ul. Kapitana Serafina Myśliwca 16 |47-400 Racibórz;2102;975;975;40;935;46.38;4.10
103999;241101;Zespół Szkolno-Przedszkolny Nr 2|Racibórz|ul. Juliana Tuwima 1 |47-400 Racibórz;2078;975;975;27;948;46.92;2.77
104000;241101;Zespół Szkolno-Przedszkolny Nr 4|Racibórz|ul. Bojanowska 5 |47-400 Racibórz;1899;773;773;29;744;40.71;3.75
104001;241101;Remiza OSP|Racibórz|ul. Podmiejska 21 |47-400 Racibórz;473;198;198;6;192;41.86;3.03
104002;241101;Zespół Szkolno-Przedszkolny Nr 1|Racibórz|ul. Henryka Jordana 6 |47-400 Racibórz;1798;754;754;25;729;41.94;3.32
104003;241101;Gimnazjum Nr 5|Racibórz|ul. Opawska 81 |47-400 Racibórz;2202;939;939;22;917;42.64;2.34
104004;241101;II Liceum Ogólnokształcące|Racibórz|ul. Kardynała Stefana Wyszyńskiego 3 |47-400 Racibórz;1689;689;689;22;667;40.79;3.19
104005;241101;Gimnazjum Nr 5|Racibórz|ul. Opawska 81 |47-400 Racibórz;1637;736;736;18;718;44.96;2.45
104006;241101;Przedszkole Nr 14|Racibórz|ul. Słoneczna 31 |47-400 Racibórz;2194;910;910;32;878;41.48;3.52
104007;241101;Szkoła Podstawowa Nr 15|Racibórz|ul. Juliusza Słowackiego 48 |47-400 Racibórz;1956;1093;1093;23;1070;55.88;2.10
104008;241101;Szkoła Podstawowa Nr 15 - wejście boczne, do sali gimnastycznej|Racibórz|ul. Juliusza Słowackiego 48 |47-400 Racibórz;1295;664;664;15;649;51.27;2.26
104009;241101;Szkoła Podstawowa Nr 18 - wejście boczne|Racibórz|ul. Ocicka 52 |47-400 Racibórz;1752;904;904;26;878;51.60;2.88
104010;241101;Gimnazjum Nr 3|Racibórz|ul. Żorska 2 |47-400 Racibórz;1634;855;855;22;833;52.33;2.57
104011;241101;Szkoła Podstawowa Nr 18|Racibórz|ul. Ocicka 52 |47-400 Racibórz;1873;908;908;17;891;48.48;1.87
104012;241101;Szkoła Podstawowa Nr 13|Racibórz|ul. ks. Stanisława Staszica 12 |47-400 Racibórz;2004;947;947;28;919;47.26;2.96
104013;241101;Gimnazjum Nr 1|Racibórz|ul. Jana Kasprowicza 4 |47-400 Racibórz;1608;699;699;23;676;43.47;3.29
104014;241101;Szkoła Podstawowa Nr 4|Racibórz|ul. Wojska Polskiego 8 |47-400 Racibórz;1691;755;755;15;740;44.65;1.99
104015;241101;Centrum Kształcenia Zawodowego i Ustawicznego Nr 1|Racibórz|ul. Gimnazjalna 3 |47-400 Racibórz;1820;799;799;21;778;43.90;2.63
104016;241101;Zespół Szkół Ogólnokształcących Mistrzostwa Sportowego - Budynek A|Racibórz|ul. Kozielska 19 |47-400 Racibórz;2192;805;805;18;787;36.72;2.24
104017;241101;Centrum Kształcenia Zawodowego i Ustawicznego Nr 1|Racibórz|ul. Wileńska 6 |47-400 Racibórz;1841;946;946;25;921;51.39;2.64
104018;241101;Szkoła Podstawowa Nr 1|Racibórz|ul. Elżbiety 14 |47-400 Racibórz;1939;1031;1031;30;1001;53.17;2.91
104019;241101;Zespół Szkolno-Przedszkolny Nr 3|Racibórz|ul. Sudecka 2 |47-400 Racibórz;1605;641;641;13;628;39.94;2.03
104020;241101;Gimnazjum Nr 2|Racibórz|ul. Elżbiety 14 |47-400 Racibórz;1613;691;691;24;667;42.84;3.47
104021;241101;Szkoła Podstawowa Nr 1|Racibórz|ul. Cecylii 30 |47-400 Racibórz;1540;770;770;25;745;50.00;3.25
104022;241101;Dom Pomocy Społecznej|Racibórz|Plac Króla Władysława Jagiełły 3 |47-400 Racibórz;127;68;68;3;65;53.54;4.41
104023;241101;Dom Pomocy Społecznej "ZŁOTA JESIEŃ"|Racibórz|Franciszka Grzonki 1 |47-400 ;196;79;79;4;75;40.31;5.06
104024;241101;Szpital Rejonowy|Racibórz|Gamowska 3 |47-400 ;194;87;87;2;85;44.85;2.30
104025;241101;Zakład Karny|Racibórz|Josepha von Eichendorffa 14 |47-400 ;781;365;365;14;351;46.73;3.84
104026;241102;Dom Kultury|Kobyla|ul. Główna 78 |44-285 Kornowac;870;439;439;21;418;50.46;4.78
104027;241102;Publiczne Gimnazjum|Kornowac|ul. Starowiejska 66 |44-285 Kornowac;756;314;314;16;298;41.53;5.10
104028;241102;Przedszkole Publiczne|Łańce|ul. Szkolna 23 |44-285 Kornowac;467;201;201;6;195;43.04;2.99
104029;241102;Zespół Szkolno-Przedszkolny|Pogrzebień|ul. Pamiątki 25 |44-285 Kornowac;1076;589;589;19;570;54.74;3.23
104030;241102;Zespół Szkolno-Przedszkolny|Rzuchów|ul. Karola Miarki 8 |44-285 Kornowac;865;384;384;9;375;44.39;2.34
104031;241103;Przedszkole w Bojanowie|Bojanów|ul. Raciborska 21 |47-470 Krzanowice;611;161;161;14;147;26.35;8.70
104032;241103;Zespół Szkolno-Przedszkolny w Borucinie|Borucin|ul. Bończyka 13 |47-470 Krzanowice;978;284;284;14;270;29.04;4.93
104033;241103;Miejski Ośrodek Kultury w Krzanowicach|Krzanowice|ul. Zawadzkiego 3 |47-470 Krzanowice;1244;428;428;13;415;34.41;3.04
104034;241103;OSP Krzanowice|Krzanowice|ul. 15 Grudnia 20 |47-470 Krzanowice;868;320;320;15;305;36.87;4.69
104035;241103;Oddział Zamiejscowy Przedszkola w Pietraszynie|Pietraszyn|ul. Wesoła 6 |47-470 Krzanowice;301;126;126;1;125;41.86;0.79
104036;241103;Zespół Szkolno-Przedszkolny w Wojnowicach|Wojnowice|ul. Polna 2 |47-470 Krzanowice;725;260;260;5;255;35.86;1.92
104037;241104;Centrum Kultury w Tworkowie|Tworków|ul. Zamkowa 48 |47-451 Tworków;2273;661;661;36;625;29.08;5.45
104038;241104;Sala Narad Urzędu Gminy w Krzyżanowicach|Krzyżanowice|ul.Główna 5 |47-450 Krzyżanowice;1987;843;843;25;818;42.43;2.97
104039;241104;Szkoła Podstawowa w Zabełkowie|Zabełków|ul. J.Rymera 7 |47-460 Chałupki;694;257;257;6;251;37.03;2.33
104040;241104;Zespół Szkół Ogólnokształcących w Bieńkowicach|Bieńkowice|ul.Szkolna 1 |47-451 Tworków;1349;495;495;26;469;36.69;5.25
104041;241104;Zespół Szkolno-Przedszkolny w Owsiszczach|Owsiszcze|ul.Szkolna 1 |47-450 Krzyżanowice;888;302;302;6;296;34.01;1.99
104042;241104;budynek byłego Przedszkola w Rudyszwałdzie|Rudyszwałd|ul.Główna 31 |47-460 Chałupki;603;222;222;5;217;36.82;2.25
104043;241104;Zespół Szkół Ogólnokształcących w Chałupkach|Chałupki|ul.Szkolna 7 |47-460 Chałupki;1349;562;562;25;537;41.66;4.45
104044;241105;Zespół Szkół Ogólnokształcących w Kuźni Raciborskiej|Kuźnia Raciborska|ul. Piaskowa 28 |47-420 Kuźnia Raciborska;1296;474;474;29;445;36.57;6.12
104045;241105;Zespół Szkół Ogólnokształcących w Kuźni Raciborskiej|Kuźnia Raciborska|ul. Piaskowa 28 |47-420 Kuźnia Raciborska;1339;474;474;21;453;35.40;4.43
104046;241105;Miejski Ośrodek Kultury, Sportu i Rekreacji w Kuźni Raciborskiej|Kuźnia Raciborska|ul. Klasztorna 9 |47-420 Kuźnia Raciborska;1559;576;576;14;562;36.95;2.43
104047;241105;Świetlica Ochotniczej Straży Pożarnej w Turzu|Turze|ul. Raciborska 68 |47-420 Kuźnia Raciborska;2074;617;617;44;573;29.75;7.13
104048;241105;Zespół Szkół Ogólnokształcących w Rudach|Rudy|ul. Rogera 2 |47-430 Rudy;2319;972;972;23;949;41.91;2.37
104049;241105;Zespół Szkół Ogólnokształcących w Rudach|Rudy|ul. Rogera 2 |47-430 Rudy;875;352;352;6;346;40.23;1.70
104050;241106;SALA GIMNASTYCZNA|Babice|ul. Wiejska 68 |47-440 Nędza;712;305;305;29;276;42.84;9.51
104051;241106;SALA GIMNASTYCZNA|Górki Śląskie|ul. Ofiar Oświęcimskich 57 |47-440 Nędza;803;434;434;17;417;54.05;3.92
104052;241106;SALA GIMNASTYCZNA|Zawada Książęca|ul. Szkolna 2 |47-440 Nędza;1059;310;310;7;303;29.27;2.26
104053;241106;Sala przy GOSiR|Nędza|ul. Sportowa 10 |47-440 Nędza;926;328;328;12;316;35.42;3.66
104054;241106;SALA przy OSP|Nędza|ul. Strażacka 2 |47-440 Nędza;797;241;241;12;229;30.24;4.98
104055;241106;STRAŻNICA OSP|Szymocice|ul. Gliwicka 20 |47-440 Nędza;241;130;130;2;128;53.94;1.54
104056;241106;SALA przy Zespole Szkolno - Gimnazjalnym|Nędza|ul. Leśna 2 |47-440 Nędza;1007;430;430;15;415;42.70;3.49
104057;241106;PRZEDSZKOLE|Łęg|ul. Wyzwolenia 8 |47-440 Nędza;364;120;120;1;119;32.97;0.83
104058;241107;Centrum Społeczno-Kulturalne w Pietrowicach Wielkich|Pietrowice Wielkie|ul. 1 Maja 8b |47-480 Pietrowice Wielkie;2167;856;856;32;824;39.50;3.74
104059;241107;Zespół Szkolno-Przedszkolny w Pawłowie|Pawłów|ul. Pietrowicka 16 |47-480 Pietrowice Wielkie;899;311;311;10;301;34.59;3.22
104060;241107;Zespół Szkolno-Przedszkolny w Krowiarkach|Krowiarki|ul. Szkolna 19 |47-480 Pietrowice Wielkie;845;200;200;7;193;23.67;3.50
104061;241107;Wiejskie Centrum Kultury|Maków|ul. Szkolna 1 |47-480 Pietrowice Wielkie;517;182;182;4;178;35.20;2.20
104062;241107;Publiczna Szkoła Podstawowa w Pietrowicach Wielkich Szkoła Filialna w Cyprzanowie|Cyprzanów|ul. Szkolna 1 |47-480 Pietrowice Wielkie;610;204;204;14;190;33.44;6.86
104063;241107;Zespół Szkolno-Przedszkolny w Samborowicach|Samborowice|ul. Szkolna 1 |47-470 Krzanowice;532;212;212;6;206;39.85;2.83
104064;241108;Gminne Centrum Informacji|Rudnik|ul. Mickiewicza 2 |47-411 Rudnik;1131;432;432;13;419;38.20;3.01
104065;241108;Szkoła Podstawowa|Gamów|ul. Długa 48 |47-411 Rudnik;364;178;178;1;177;48.90;0.56
104066;241108;Szkoła Podstawowa|Szonowice|ul. Marii Konopnickiej 2 |47-411 Rudnik;896;247;247;10;237;27.57;4.05
104067;241108;Górnośląskie Centrum Kultury i Spotkań im. J.v.Eichendorffa (budynek byłej szkoły)|Łubowice|ul. Zamkowa 1 |47-411 Rudnik;1307;484;484;20;464;37.03;4.13
104068;241108;Dom Kultury|Sławików|ul. Parkowa 1 |47-411 Rudnik;513;126;126;3;123;24.56;2.38
104069;241201;Szkoła Podstawowa nr 3|Czerwionka-Leszczyny|ul. Broniewskiego 11 |44-238 Czerwionka-Leszczyny;1487;671;671;21;650;45.12;3.13
104070;241201;Przedszkole nr 3|Czerwionka-Leszczyny|ul. Mostowa 3 |44-238 Czerwionka-Leszczyny;1480;599;599;32;567;40.47;5.34
104071;241201;Gimnazjum nr 2|Czerwionka-Leszczyny|ul. Ogrodowa 6 |44-238 Czerwionka-Leszczyny;1524;649;649;28;621;42.59;4.31
104072;241201;Dom Kultury|Czerwionka-Leszczyny|ul. Ligonia 2A |44-238 Czerwionka-Leszczyny;1538;684;684;19;665;44.47;2.78
104073;241201;Klub Mieszkańców "Krokus"|Czerwionka-Leszczyny|ul. Chopina 3 |44-238 Czerwionka-Leszczyny;1448;711;711;22;689;49.10;3.09
104074;241201;Zespół Szkół nr 1 Gimnazjum nr 1|Czerwionka-Leszczyny|ul. Księdza Pojdy 77C |44-238 Czerwionka-Leszczyny;1811;1082;1082;22;1060;59.75;2.03
104075;241201;Miejski Ośrodek Kultury|Czerwionka-Leszczyny|ul. Wolności 2 |44-230 Czerwionka-Leszczyny;1895;696;696;37;659;36.73;5.32
104076;241201;Zespół Szkół nr 3 Gimnazjum nr 4|Czerwionka-Leszczyny|ul. Szkolna 3 |44-230 Czerwionka-Leszczyny;1807;913;913;33;880;50.53;3.61
104077;241201;Zespół Szkół nr 2 Gimnazjum nr 3|Czerwionka-Leszczyny|ul. Furgoła 71 |44-230 Czerwionka-Leszczyny;1497;752;752;21;731;50.23;2.79
104078;241201;Przedszkole nr 10|Czerwionka-Leszczyny|ul. Jana Pawła II 18 |44-230 Czerwionka-Leszczyny;1292;674;674;30;644;52.17;4.45
104079;241201;Przedszkole nr 7|Czerwionka-Leszczyny|ul. Młyńska 2 |44-230 Czerwionka-Leszczyny;1367;707;707;22;685;51.72;3.11
104080;241201;Zespół Szkół nr 4 Gimnazjum nr 5|Czerwionka-Leszczyny|ul. Gliwicka 2 |44-230 Czerwionka-Leszczyny;1740;936;936;32;904;53.79;3.42
104081;241201;Szkoła Podstawowa nr 8|Czerwionka-Leszczyny|ul. Prosta 17 |44-230 Czerwionka-Leszczyny;1474;815;815;22;793;55.29;2.70
104082;241201;Gimnazjum nr 6|Czerwionka-Leszczyny|ul. Kołłątaja 1 |44-230 Czerwionka-Leszczyny;1662;908;908;20;888;54.63;2.20
104083;241201;Zespół Szkół nr 5 Szkoła Podstawowa|Bełk|ul. Szymochy 16 |44-230 Czerwionka-Leszczyny;1212;595;595;23;572;49.09;3.87
104084;241201;Zespół Szkół nr 5 Gimnazjum nr 7|Bełk|ul. Szymochy 16 |44-230 Czerwionka-Leszczyny;1546;790;790;20;770;51.10;2.53
104085;241201;Szkoła Podstawowa|Książenice|ul. Księdza Pojdy 100 |44-213 Rybnik;2124;1222;1222;31;1191;57.53;2.54
104086;241201;Szkoła Podstawowa|Palowice|ul. Dębowa 3 |44-246 Żory;1195;614;614;13;601;51.38;2.12
104087;241201;Szkoła Podstawowa|Przegędza|ul. Szkolna 1 |44-238 Czerwionka-Leszczyny;1366;752;752;14;738;55.05;1.86
104088;241201;Szkoła Podstawowa|Stanowice|ul. Szkolna 17A |44-230 Czerwionka-Leszczyny;1929;1146;1146;24;1122;59.41;2.09
104089;241201;Szkoła Podstawowa|Szczejkowice|ul. Wiejska 20 |44-246 Żory;1349;754;754;24;730;55.89;3.18
104090;241202;Ośrodek Kultury i Sportu|Gaszowice|ul. Rydułtowska 7 |44-293 Gaszowice;1481;842;842;18;824;56.85;2.14
104091;241202;Szkoła Podstawowa im. Tadeusza Kościuszki|Gaszowice|ul. Rydułtowska 8 |44-293 Gaszowice;898;496;496;17;479;55.23;3.43
104092;241202;Gimnazjum im. Ziemi Śląskiej|Piece|ul. Rydułtowska 9 |44-293 Piece;814;399;399;10;389;49.02;2.51
104093;241202;Zespół Szkolno-Przedszkolny|Szczerbice|ul. Szkolna 6 |44-293 Szczerbice;995;487;487;12;475;48.94;2.46
104094;241202;Zespół Szkolno-Przedszkolny|Szczerbice|ul. Szkolna 6 |44-293 Szczerbice;870;449;449;11;438;51.61;2.45
104095;241202;Szkoła Podstawowa im. Henryka Mikołaja Góreckiego|Czernica|ul. Wolności 41 |44-282 Czernica;1731;846;846;19;827;48.87;2.25
104096;241202;Szkoła Podstawowa im. Henryka Mikołaja Góreckiego|Czernica|ul. Wolności 41 |44-282 Czernica;596;287;287;8;279;48.15;2.79
104097;241203;Szkoła Podstawowa w Jejkowicach|Jejkowice|ul. Główna 42 |44-290 Jejkowice;1001;525;525;23;502;52.45;4.38
104098;241203;Szkoła Podstawowa w Jejkowicach|Jejkowice|ul. Główna 42 |44-290 Jejkowice;1021;632;632;8;624;61.90;1.27
104099;241203;Gimnazjum w Jejkowicach|Jejkowice|ul. Główna 42 |44-290 Jejkowice;1119;644;644;19;625;57.55;2.95
104100;241204;Szkoła Podstawowa|Adamowice|ul. Szkolna 7 |47-435 Raszczyce;768;390;390;13;377;50.78;3.33
104101;241204;Szkoła Podstawowa|Bogunice|ul. Szkolna 5 |44-295 Lyski;624;319;319;3;316;51.12;0.94
104102;241204;Remiza OSP|Dzimierz|ul. Sportowa |44-295 Lyski;426;195;195;4;191;45.77;2.05
104103;241204;Gminna Biblioteka Publiczna|Lyski|ul. Rybnicka 2 |44-295 Lyski;1440;835;835;20;815;57.99;2.40
104104;241204;Świetlica Środowiskowa|Nowa Wieś|ul. Rybnicka |44-295 Lyski;364;218;218;7;211;59.89;3.21
104105;241204;Szkoła Podstawowa|Pstrążna|ul. Szkolna 5 |44-284 Pstrążna;800;382;382;14;368;47.75;3.66
104106;241204;Szkoła Podstawowa|Raszczyce|ul. Szkolna 3 |47-435 Raszczyce;912;412;412;14;398;45.18;3.40
104107;241204;Przedszkole|Sumina|ul. Dworcowa 11 |44-295 Lyski;761;360;360;6;354;47.31;1.67
104108;241204;Filia Świetlicy Środowiskowej|Zwonowice|ul. Sumińska 1 |44-292 Rybnik;1124;568;568;24;544;50.53;4.23
104109;241204;Filia Świetlicy Środowiskowej|Żytna|ul. Rybnicka |47-435 Raszczyce;470;198;198;5;193;42.13;2.53
104110;241204;Dom Pomocy Społecznej|Lyski|ul. Rybnicka 7 |44-295 Lyski;84;38;38;9;29;45.24;23.68
104111;241205;Szkoła Podstawowa nr 1 im. Ludwika Holesza w Świerklanach|Świerklany|ul. Boryńska 6 |44-266 Świerklany;1886;1098;1098;20;1078;58.22;1.82
104112;241205;Szkoła Podstawowa nr 1 im. Ludwika Holesza w Świerklanach|Świerklany|ul. Boryńska 6 |44-266 Świerklany;1441;850;850;27;823;58.99;3.18
104113;241205;Gimnazjum im. Karola Miarki w Świerklanach|Świerklany|ul. 3 Maja 20 |44-266 Świerklany;1660;893;893;24;869;53.80;2.69
104114;241205;Gimnazjum im. Karola Miarki w Świerklanach|Świerklany|ul. 3 Maja 20 |44-266 Świerklany;1142;694;694;24;670;60.77;3.46
104115;241205;Szkoła Podstawowa im. Stanisława Staszica w Jankowicach|Jankowice|ul. Równoległa 5 |44-264 Jankowice;1884;993;993;33;960;52.71;3.32
104116;241205;Szkoła Podstawowa im. Stanisława Staszica w Jankowicach|Jankowice|ul. Równoległa 5 |44-264 Jankowice;1310;774;774;31;743;59.08;4.01
104117;241301;Publiczna Szkoła Podstawowa Nr 1 w Kaletach|Kalety|ul. 1 Maja 6 |42-660 Kalety;1884;805;805;24;781;42.73;2.98
104118;241301;Miejski Dom Kultury w Kaletach|Kalety|ul. Lubliniecka 2 |42-660 Kalety;695;275;275;15;260;39.57;5.45
104119;241301;były Zespół Szkół w Kaletach|Kalety, Jędrysek|ul. Ks. Rogowskiego 43 |42-660 Kalety;2335;1122;1122;46;1076;48.05;4.10
104120;241301;Klub w Kaletach - Drutarni|Kalety, Drutarnia|ul. Koszęcińska 33 |42-660 Kalety;0;0;0;0;0;-99;-99
104121;241301;Publiczna Szkoła Podstawowa Nr 2 w Kaletach-Miotku|Kalety, Miotek|ul. Orzeszkowej 10 |42-660 Kalety;1710;832;832;12;820;48.65;1.44
104122;241302;Świetlica Publicznego Gimnazjum|Miasteczko Śląskie|ul. Dworcowa 8 |42-610 Miasteczko Śląskie;1561;811;811;19;792;51.95;2.34
104123;241302;Publiczne Gimnazjum|Miasteczko Śląskie|ul. Dworcowa 8 |42-610 Miasteczko Śląskie;1144;529;529;17;512;46.24;3.21
104124;241302;Miejski Ośrodek Kultury|Miasteczko Śląskie|ul. Srebrna 24 |42-610 Miasteczko Śląskie;1230;512;512;15;497;41.63;2.93
104125;241302;Szkoła Podstawowa Nr 2|Miasteczko Śląskie|ul. Harcerska 5 |42-610 Miasteczko Śląskie;1393;606;606;13;593;43.50;2.15
104126;241302;Strażnica OSP Brynica|Miasteczko Śląskie|ul. Władysława Łokietka 5 |42-610 Miasteczko Śląskie;432;226;226;8;218;52.31;3.54
104127;241303;Zespół Szkół Techniczno-Ekonomicznych|Radzionków|ul. Nałkowskiej 2 |41-922 Radzionków;847;422;422;14;408;49.82;3.32
104128;241303;Zespół Szkół Techniczno-Ekonomicznych|Radzionków|ul. Nałkowskiej 2 |41-922 Radzionków;808;275;275;16;259;34.03;5.82
104129;241303;Zespół Szkół Podstawowo-Gimnazjalnych|Radzionków|ul. Sikorskiego 8a |41-922 Radzionków;823;476;476;5;471;57.84;1.05
104130;241303;Zespół Szkół Podstawowo-Gimnazjalnych|Radzionków|ul. Sikorskiego 8a |41-922 Radzionków;1041;690;690;6;684;66.28;0.87
104131;241303;Przedszkole nr 4|Radzionków|ul. Kużaja 15 |41-922 Radzionków;928;397;397;18;379;42.78;4.53
104132;241303;Szkoła Podstawowa nr 2 im. Jana Pawła II|Radzionków|ul. Szymały 36 |41-922 Radzionków;901;498;498;15;483;55.27;3.01
104133;241303;Szkoła Podstawowa nr 2 im. Jana Pawła II|Radzionków|ul. Szymały 36 |41-922 Radzionków;937;520;520;21;499;55.50;4.04
104134;241303;Gimnazjum im. Ojca Ludwika Wrodarczyka|Radzionków|ul. Krzywa 18 |41-922 Radzionków;935;562;562;12;550;60.11;2.14
104135;241303;Gimnazjum im. Ojca Ludwika Wrodarczyka|Radzionków|ul. Krzywa 18 |41-922 Radzionków;812;444;444;10;434;54.68;2.25
104136;241303;Centrum Kultury "Karolinka"|Radzionków|pl. Jana Pawła II 2 |41-922 Radzionków;872;493;493;13;480;56.54;2.64
104137;241303;Centrum Kultury "Karolinka"|Radzionków|pl. Jana Pawła II 2 |41-922 Radzionków;939;547;547;24;523;58.25;4.39
104138;241303;Szkoła Podstawowa nr 1 im. Adama Mickiewicza|Radzionków|ul. ks. dra J. Knosały 16 |41-922 Radzionków;963;550;550;23;527;57.11;4.18
104139;241303;Szkoła Podstawowa nr 1 im. Adama Mickiewicza|Radzionków|ul. ks. dra J. Knosały 16 |41-922 Radzionków;1085;630;630;18;612;58.06;2.86
104140;241303;Liceum Ogólnokształcące im. Powstańców Ślaskich|Radzionków|pl. Jana Pawła II 8 |41-922 Radzionków;841;430;430;13;417;51.13;3.02
104141;241303;Liceum Ogólnokształcące im. Powstańców Śląskich|Radzionków|pl. Jana Pawła II 8 |41-922 Radzionków;859;482;482;6;476;56.11;1.24
104142;241304;Zespół Szkolno-Przedszkolny Nr 2|Tarnowskie Góry|ul. Jagodowa 72 |42-609 Tarnowskie Góry;1007;495;495;18;477;49.16;3.64
104143;241304;Szkoła Podstawowa Nr 13|Tarnowskie Góry|ul. Armii Krajowej 1 |42-609 Tarnowskie Góry;1733;926;926;19;907;53.43;2.05
104144;241304;Szkoła Podstawowa Nr 13|Tarnowskie Góry|ul. Armii Krajowej 1 |42-609 Tarnowskie Góry;1325;731;731;20;711;55.17;2.74
104145;241304;Szkoła Podstawowa Nr 13|Tarnowskie Góry|ul. Armii Krajowej 1 |42-609 Tarnowskie Góry;1327;637;637;17;620;48.00;2.67
104146;241304;Zespół Szkolno-Przedszkolny Nr 1|Tarnowskie Góry|ul. Słowackiego 34 |42-600 Tarnowskie Góry;1333;597;597;21;576;44.79;3.52
104147;241304;Szkoła Podstawowa Nr 5|Tarnowskie Góry|ul. Leśna 23 |42-600 Tarnowskie Góry;1899;964;964;18;946;50.76;1.87
104148;241304;Szkoła Podstawowa Nr 5|Tarnowskie Góry|ul. Leśna 23 |42-600 Tarnowskie Góry;1927;1030;1030;27;1003;53.45;2.62
104149;241304;Publiczne Gimnazjum Nr 3|Tarnowskie Góry|ul. Zaciszna 17 |42-606 Tarnowskie Góry;1962;1198;1198;19;1179;61.06;1.59
104150;241304;Publiczne Gimnazjum Nr 3|Tarnowskie Góry|ul. Zaciszna 17 |42-606 Tarnowskie Góry;2144;1204;1204;27;1177;56.16;2.24
104151;241304;Szkoła Podstawowa Nr 11|Tarnowskie Góry|ul. Korola 38a |42-605 Tarnowskie Góry;1692;858;858;19;839;50.71;2.21
104152;241304;Szkoła Podstawowa Nr 11|Tarnowskie Góry|ul. Korola 38a |42-605 Tarnowskie Góry;1623;960;960;14;946;59.15;1.46
104153;241304;Świetlica Miejska Nr 1|Tarnowskie Góry|ul. Witosa 61 |42-603 Tarnowskie Góry;1837;984;984;19;965;53.57;1.93
104154;241304;Zespół Szkolno-Przedszkolny Nr 4|Tarnowskie Góry|ul. Powstańców Warszawskich 42 |42-680 Tarnowskie Góry;1952;1063;1063;14;1049;54.46;1.32
104155;241304;Świetlica Miejska Nr 3|Tarnowskie Góry|ul. Pastuszki 9 |42-612 Tarnowskie Góry;843;553;553;7;546;65.60;1.27
104156;241304;Publiczne Gimnazjum Nr 4|Tarnowskie Góry|ul. Janasa 11 |42-612 Tarnowskie Góry;2146;1245;1245;19;1226;58.01;1.53
104157;241304;Publiczne Gimnazjum Nr 4|Tarnowskie Góry|ul. Janasa 11 |42-612 Tarnowskie Góry;2069;1252;1252;16;1236;60.51;1.28
104158;241304;Publiczne Gimnazjum Nr 4|Tarnowskie Góry|ul. Janasa 11 |42-612 Tarnowskie Góry;1913;1141;1141;21;1120;59.64;1.84
104159;241304;Szkoła Podstawowa Nr 15|Tarnowskie Góry|ul. Litewska 6 |42-612 Tarnowskie Góry;1866;1098;1098;17;1081;58.84;1.55
104160;241304;Szkoła Podstawowa Nr 15|Tarnowskie Góry|ul. Litewska 6 |42-612 Tarnowskie Góry;2027;1264;1264;18;1246;62.36;1.42
104161;241304;I Liceum Ogólnokształcące im. Stefanii Sempołowskiej|Tarnowskie Góry|ul. Opolska 28 |42-600 Tarnowskie Góry;2104;1175;1175;20;1155;55.85;1.70
104162;241304;Szkoła Podstwowa Nr 3|Tarnowskie Góry|ul. Wyspiańskiego 1 |42-600 Tarnowskie Góry;2229;1355;1355;13;1342;60.79;0.96
104163;241304;Powiatowy Młodzieżowy Dom Kultury im. H. Jordana|Tarnowskie Góry|Gliwicka 36 |42-600 Tarnowskie Góry;2320;1338;1338;21;1317;57.67;1.57
104164;241304;Tarnogórskie Centrum Kultury|Tarnowskie Góry|ul. Sobieskiego 7 |42-600 Tarnowskie Góry;2157;883;883;21;862;40.94;2.38
104165;241304;Tarnogórskie Centrum Kultury|Tarnowskie Góry|ul. Sobieskiego 7 |42-600 Tarnowskie Góry;2017;858;858;28;830;42.54;3.26
104166;241304;Szkoła Podstawowa Nr 9|Tarnowskie Góry|ul. Korczaka 2 |42-600 Tarnowskie Góry;2244;1221;1221;13;1208;54.41;1.06
104167;241304;Zespół Szkół Techniczno-Usługowych im. Jana Pawła II|Tarnowskie Góry|ul. Pokoju 14 |42-600 Tarnowskie Góry;2053;962;963;14;948;46.86;1.46
104168;241304;Dom Pomocy Społecznej dla Osób Przewlekle Psychicznie Chorych prowadzony przez ZG.SS.Boromeuszek|Tarnowskie Góry|Gliwicka 22 |42-600 Tarnowskie Góry;46;19;19;4;15;41.30;21.05
104169;241304;Szpital Św.Kamila Zakonu Ojców Kamilianów|Tarnowskie Góry|Bytomska 22 |42-606 Tarnowskie Góry;48;5;5;0;5;10.42;0.00
104170;241304;Areszt ŚledczyTarnowskie Góry|Tarnowskie Góry|Opolska 17a |42-600 Tarnowskie Góry;318;161;161;13;148;50.63;8.07
104171;241304;Dom Pomocy Społecznej "Przyjażń"|Tarnowskie Góry|Włoska 24 |42-612 Tarnowskie Góry;120;34;34;2;32;28.33;5.88
104172;241304;Wielospecjalistyczny Szpital Powiatowy S.A. w Tarnowskich Górach|Tarnowskie Góry|Opolska 21 |42-600 Tarnowskie Góry;28;16;16;0;16;57.14;0.00
104173;241304;Wielospecjalistyczny Szpital Powiatowy S.A. w Tarnowskich Górach|Tarnowskie Góry|Pyskowicka 47-51 |42-612 Tarnowskie Góry;227;58;58;2;56;25.55;3.45
104174;241304;Samodzielny Publiczny Zakład Opieki Zdrowotnej "REPTY" Górnośląskie Centrum Rehabilitacji im. gen. J. Ziętka|Tarnowskie Góry|Śniadeckiego 1 |42-612 Tarnowskie Góry;536;298;298;15;283;55.60;5.03
104175;241305;Sala posiedzeń Rady Gminy|Krupski Młyn|ul. Główna 5 |42-693 Krupski Młyn;806;439;439;13;426;54.47;2.96
104176;241305;Gminny Ośrodek Kultury, Sportu i Rekreacji|Krupski Młyn|ul. Zawadzkiego 3 |42-693 Krupski Młyn;564;323;323;5;318;57.27;1.55
104177;241305;Świetlica Osiedlowa|Krupski Młyn|Kolonia Ziętek 2 |42-693 Krupski Młyn;540;220;220;5;215;40.74;2.27
104178;241305;Szkoła Podstawowa|Potępa|ul. Tarnogórska 12 |42-693 Krupski Młyn;784;409;409;15;394;52.17;3.67
104179;241306;Niepubliczna Szkoła Podstawowa w Pyrzowicach|Pyrzowice|ul. Wolności 46 |42-625 Ożarowice;666;344;344;14;330;51.65;4.07
104180;241306;Szkoła Podstawowa w Zendku|Zendek|ul. Główna 126 |42-625 Ożarowice;944;480;480;13;467;50.85;2.71
104181;241306;Gimnazjum w Ożarowicach|Ożarowice|ul. Szkolna 10 |42-625 Ożarowice;1304;707;707;20;687;54.22;2.83
104182;241306;Szkoła Podstawowa w Tąpkowicach|Tąpkowice|ul. Kopernika 2 |42-624 Tąpkowice;1660;938;938;27;911;56.51;2.88
104183;241307;Zespół Szkół Rolniczych|Nakło Śląskie|ul. Morcinka 9 |42-620 Nakło Śląskie;1174;571;571;21;550;48.64;3.68
104184;241307;Zespół Szkół|Nakło Śląskie|ul. Dworcowa 2 |42-620 Nakło Śląskie;1954;943;943;26;917;48.26;2.76
104185;241307;Szkoła Podstawowa|Nowe Chechło|ul. Lasowicka 103 |42-622 Świerklaniec;1366;681;681;13;668;49.85;1.91
104186;241307;Szkoła Podstawowa|Orzech|ul. Brzechwy 8 |42-622 Świerklaniec;1698;928;928;32;896;54.65;3.45
104187;241307;Szkoła Podstawowa|Świerklaniec|ul. Młyńska 7 |42-622 Świerklaniec;1951;1054;1054;13;1041;54.02;1.23
104188;241307;Koło Gospodyń Wiejskich - świetlica|Świerklaniec|ul. Oświęcimska 7 |42-622 Świerklaniec;1335;699;699;12;687;52.36;1.72
104189;241308;Gminny Ośrodek Kultury|Tworóg|ul. Zamkowa 1 |42-690 Tworóg;1159;534;534;18;516;46.07;3.37
104190;241308;Szkoła Podstawowa im. Powstańców Śląskich w Tworogu|Tworóg|ul. Szkolna 15 |42-690 Tworóg;917;417;417;9;408;45.47;2.16
104191;241308;Gminne Przedszkole w Tworogu oddział zamiejscowy w Kotach|Koty|ul. Szkolna 2 |42-690 Tworóg;690;304;304;7;297;44.06;2.30
104192;241308;Budynek Wielofunkcyjny|Nowa Wieś Tworoska|ul. Jaśminowa 42 |42-690 Tworóg;652;315;315;13;302;48.31;4.13
104193;241308;Zespół Szkolno-Przedszkolny w Boruszowicach Szkoła Podstawowa im. Jana Pawła II|Boruszowice|ul. Szkolna 2 |42-690 Tworóg;1363;656;656;6;650;48.13;0.91
104194;241308;Zespół Szkół Leśnych i Ekologicznych im. Stanisława Morawskiego w Brynku|Brynek|ul. Park 5 |42-690 Tworóg;408;204;204;6;198;50.00;2.94
104195;241308;Budynek Wielofunkcyjny|Połomia|ul. Bytomska 42 |42-690 Tworóg;409;186;186;5;181;45.48;2.69
104196;241308;Zespół Szkolno-Przedszkolny Szkoła Podstawowa w Wojsce|Wojska|Szkolna 12 |42-690 Tworóg;588;268;268;11;257;45.58;4.10
104197;241308;Budynek Wielofunkcyjny|Świniowice|Wiejska 77 |42-690 Tworóg;347;136;136;1;135;39.19;0.74
104198;241309;Gminna Biblioteka Publiczna/Centrum Usług Publicznych w Zbrosławicach|Zbrosławice|ul. Oświęcimska 2A |42-674 Zbrosławice;2007;1031;1031;28;1003;51.37;2.72
104199;241309;Gminna Bibloteka Publiczna/Centrum Usług Publicznych w Zbrosławicach|Ptakowice|ul. Oświęcimska 2A |42-674 Zbrosławice;514;224;224;13;211;43.58;5.80
104200;241309;Zespół Szkolno Przedszkolny w Miedarach|Miedary|ul. Główna 26 |42-676 Zbrosławice;1552;593;593;21;572;38.21;3.54
104201;241309;Zespół Szkół Ogólnokształcących im. Jana Pawła II w Kamieńcu|Kamieniec|ul. Gliwicka 6 |42-674 Zbrosławice;1066;422;422;23;399;39.59;5.45
104202;241309;Szkoła Podstawowa w Kopienicy|Kopienica|ul. 1 Maja 3 |42-674 Zbrosławice;1398;463;463;22;441;33.12;4.75
104203;241309;Świetlica Stacji Uzdatniania Wody Zawada w Karchowicach|Karchowice|ul. Bytomska 6 |42-674 Zbrosławice;577;239;239;9;230;41.42;3.77
104204;241309;Świetlica Gminna w Ziemięcicach|Ziemięcice|ul. Mikulczycka 14 |42-675 Zbrosławice;1398;616;616;20;596;44.06;3.25
104205;241309;Szkoła Podstawowa w Czekanowie|Czekanów|ul. Szkolna 26 |42-677 Zbrosławice;765;304;304;9;295;39.74;2.96
104206;241309;Świetlica Gminna w Wieszowie|Wieszowa|ul. Bytomska 154 |42-672 Zbrosławice;1962;788;788;13;775;40.16;1.65
104207;241309;OSP Świętoszowice|Świętoszowice|ul. Mikulczycka 93A |42-674 Zbrosławice;907;501;501;9;492;55.24;1.80
104208;241309;Dom Pomocy Społecznej prowadzony przez Ojców Kamilianów w Zbrosławicach|Zbrosławice|Wolności 34 |42-674 Zbrosławice;66;22;22;5;17;33.33;22.73
104209;241309;Dom Pomocy Społecznej w Miedarach|Miedary|Zamkowa 7 |42-676 Zbrosławice;17;15;15;2;13;88.24;13.33
104210;241401;Liceum Ogólnokształcące im. Powstańców Śląskich w Bieruniu|Bieruń|ul. Licealna 17 |43-150 Bieruń Stary;1365;775;775;17;758;56.78;2.19
104211;241401;Liceum Ogólnokształcące im. Powstańców Śląskich w Bieruniu|Bieruń|ul. Licealna 17 |43-150 Bieruń Stary;1181;682;682;18;664;57.75;2.64
104212;241401;Gimnazjum Nr 2 w Bieruniu|Bieruń|ul. Licealna 17a |43-150 Bieruń Stary;950;361;361;11;350;38.00;3.05
104213;241401;Dom Kultury "Gama" w Bieruniu|Bieruń|ul. Chemików 45 |43-150 Bieruń Stary;868;441;441;11;430;50.81;2.49
104214;241401;Szkoła Podstawowa Nr 1 w Bieruniu|Bieruń|ul. Krakowska 28 |43-150 Bieruń Stary;1192;731;731;13;718;61.33;1.78
104215;241401;Szkoła Podstawowa Nr 1 w Bieruniu|Bieruń|ul. Krakowska 28 |43-150 Bieruń Stary;1233;734;734;17;717;59.53;2.32
104216;241401;Przedszkole Nr 1 w Bieruniu|Bieruń|ul. Kamienna 17 |43-155 Bieruń Nowy;979;542;542;21;521;55.36;3.87
104217;241401;Powiatowy Zespół Szkół w Bieruniu|Bieruń|ul. Granitowa 130 |43-155 Bieruń Nowy;1002;525;525;8;517;52.40;1.52
104218;241401;Powiatowy Zespół Szkół w Bieruniu|Bieruń|ul. Granitowa 130 |43-155 Bieruń Nowy;1115;624;641;16;608;55.96;2.56
104219;241401;Szkoła Podstawowa Nr 3 w Bieruniu|Bieruń|ul. Węglowa 11 |43-155 Bieruń Nowy;1087;591;591;9;582;54.37;1.52
104220;241401;Szkoła Podstawowa Nr 3 w Bieruniu|Bieruń|ul. Węglowa 11 |43-155 Bieruń Nowy;963;498;498;17;481;51.71;3.41
104221;241401;Gimnazjum Nr 1 w Bieruniu|Bieruń|ul. Warszawska 294 |43-155 Bieruń Nowy;864;444;444;14;430;51.39;3.15
104222;241401;Gimnazjum Nr 1 w Bieruniu|Bieruń|ul. Warszawska 294 |43-155 Bieruń Nowy;981;609;609;14;595;62.08;2.30
104223;241401;Gimnazjum nr 1 w Bieruniu|Bieruń|ul. Warszawska 294 |43-155 Bieruń Nowy;773;429;429;14;415;55.50;3.26
104224;241401;Gimnazjum nr 1 w Bieruniu|Bieruń|ul. Warszawska 294 |43-155 Bieruń Nowy;888;504;504;15;489;56.76;2.98
104225;241402;Biblioteka Miejska|Imielin|ul. Imielińska 92 sala nr 1|41-407 Imielin;1799;1076;1076;36;1040;59.81;3.35
104226;241402;Biblioteka Miejska|Imielin|ul. Imielińska 92 sala nr 5|41-407 Imielin;1829;1036;1036;23;1013;56.64;2.22
104227;241402;Urząd Miasta Imielin|Imielin|ul. Imielińska 81 sala nr 11|41-407 Imielin;1574;936;936;24;912;59.47;2.56
104228;241402;Urząd Miasta Imielin|Imielin|ul. Imielińska 81 sala nr 21|41-407 Imielin;1692;973;973;20;953;57.51;2.06
104229;241403;Gimnazjum z Oddziałami Integracyjnymi Nr 2|Lędziny|ul. Hołdunowska 72 |43-143 Lędziny;1536;885;885;25;860;57.62;2.82
104230;241403;Gimnazjum z Oddziałami Integracyjnymi Nr 2|Lędziny|ul. Hołdunowska 72 |43-143 Lędziny;688;298;298;4;294;43.31;1.34
104231;241403;Szkoła Podstawowa Nr 3|Lędziny|ul. Hołdunowska 13 |43-143 Lędziny;930;511;511;20;491;54.95;3.91
104232;241403;Szkoła Podstawowa Nr 3|Lędziny|ul. Hołdunowska 13 |43-143 Lędziny;1549;718;718;31;687;46.35;4.32
104233;241403;Szkoła Podstawowa Nr 3|Lędziny|ul. Hołdunowska 13 |43-143 Lędziny;1687;924;924;36;888;54.77;3.90
104234;241403;Plac Farski|Lędziny|ul. Lędzińska 88 |43-140 Lędziny;1562;877;877;27;850;56.15;3.08
104235;241403;Ochotnicza Straż Pożarna|Lędziny|ul. Księdza Kontnego 32 |43-140 Lędziny;1047;626;626;16;610;59.79;2.56
104236;241403;Powiatowy Zespół Szkół|Lędziny|ul. Pokoju 4 |43-140 Lędziny;1664;782;785;16;766;47.00;2.05
104237;241403;Zespół Szkół|Lędziny|ul. Goławiecka 36 |43-144 Lędziny;857;496;496;15;481;57.88;3.02
104238;241403;Górki|Lędziny|ul. Szenwalda 49 |43-144 Lędziny;376;223;223;5;218;59.31;2.24
104239;241403;Szkoła Podstawowa z Oddziałami Integracyjnymi nr 1|Lędziny|ul. Paderewskiego 5 |43-140 Lędziny;1072;646;646;17;629;60.26;2.63
104240;241404;Szkoła Podstawowa|Bojszowy|ul. Świętego Jana 33 |43-220 Bojszowy;869;576;576;6;570;66.28;1.04
104241;241404;Szkoła Podstawowa|Bojszowy|ul. Świetęgo Jana 33 |43-220 Bojszowy;802;524;524;10;514;65.34;1.91
104242;241404;Urząd Gminy Bojszowy|Bojszowy|ul. Gaikowa 35 |43-220 Bojszowy;780;495;495;5;490;63.46;1.01
104243;241404;Gminne Gimnazjum w Bojszowach|Bojszowy|ul. Świętego Jana 33a |43-220 Bojszowy;746;411;411;15;396;55.09;3.65
104244;241404;Szkoła Podstawowa|Międzyrzecze|ul. Żubrów 13 |43-220 Bojszowy;721;438;438;6;432;60.75;1.37
104245;241404;Gminna Szkoła Podstawowa|Świerczyniec|ul. Sierpowa 38 |43-220 Bojszowy;383;245;245;5;240;63.97;2.04
104246;241404;Gminna Szkoła Podstawowa|Świerczyniec|ul. Sierpowa 38 |43-220 Bojszowy;625;401;401;17;384;64.16;4.24
104247;241404;Gminna Szkoła Podstawowa|Świerczyniec|ul. Sierpowa 38 |43-220 Bojszowy;994;643;643;14;629;64.69;2.18
104248;241405;Zespół Szkół - Gimnazjum|Chełm Śląski|ul. Śląska 12 |41-403 Chełm Śląski;1504;873;873;23;850;58.05;2.63
104249;241405;Szkoła Podstawowa Nr 2|Chełm Śląski|ul. Kolberga 1 |41-403 Chełm Śląski;2289;1325;1325;21;1304;57.89;1.58
104250;241405;Zespół Szkolno - Przedszkolny|Chełm Śląski|ul. Górnośląska 45 |41-403 Chełm Śląski;1013;579;579;7;572;57.16;1.21
104251;241501;Miejski Ośrodek Kultury|Pszów|Traugutta 1 |44-370 Pszów;2309;1227;1227;30;1197;53.14;2.44
104252;241501;Gościniec Pszowski (d. Hotel Miejski)|Pszów|Traugutta 48 |44-370 Pszów;2093;798;798;35;763;38.13;4.39
104253;241501;Gimnazjum|Pszów|Niepodległości 99 |44-370 Pszów;2397;1383;1383;18;1365;57.70;1.30
104254;241501;Szkoła Podstawowa Nr 2|Pszów|K. Miarki 16 |44-370 Pszów;2200;975;975;26;949;44.32;2.67
104255;241501;Szkoła Podstawowa Nr 3|Pszów|Armii Krajowej 54 |44-370 Pszów;2201;1178;1178;31;1147;53.52;2.63
104256;241502;Szkoła Podstawowa Nr 3|Radlin|ul. Józefa Rymera 170 |44-310 Radlin;1873;932;933;29;903;49.76;3.11
104257;241502;Szkoła Podstawowa Nr 3|Radlin|ul. Józefa Rymera 170 |44-310 Radlin;1665;908;909;24;884;54.53;2.64
104258;241502;MOSIR "Sokolnia"|Radlin|ul. Sokolska 6 |44-310 Radlin;929;489;489;14;475;52.64;2.86
104259;241502;Miejski Ośrodek Kultury|Radlin|ul. Mariacka 9 |44-310 Radlin;2001;1150;1150;18;1132;57.47;1.57
104260;241502;Zespół Szkół Sportowych|Radlin|ul. mjr Piotra Iwanowicza Rogozina 55 |44-310 Radlin;1750;948;948;22;926;54.17;2.32
104261;241502;MOSIR Dom Sportu|Radlin|ul. Wojciecha Korfantego 17 |44-310 Radlin;931;489;489;11;478;52.52;2.25
104262;241502;MOSIR Dom Sportu|Radlin|ul. Wojciecha Korfantego 17 |44-310 Radlin;1892;975;975;43;932;51.53;4.41
104263;241502;Przedszkole Publiczne nr 2|Radlin|ul. Andrzeja Mielęckiego 13 |44-310 Radlin;1940;843;843;44;799;43.45;5.22
104264;241502;Hala Zborna Koksowni "Radlin"|Radlin|ul. Hutnicza 1 |44-310 Radlin;952;475;475;14;461;49.89;2.95
104265;241502;NZOZ „SANUS”|Radlin|ul. Władysława Orkana 8 |44-310 Radlin;20;7;7;2;5;35.00;28.57
104266;241503;Biblioteka Publiczna Miasta Rydułtowy|Rydułtowy|ul. Adama Mickiewicza 33 |44-280 Rydułtowy;1738;811;811;19;792;46.66;2.34
104267;241503;Urząd Stanu Cywilnego|Rydułtowy|ul. Raciborska 369 |44-280 Rydułtowy;1550;795;795;35;760;51.29;4.40
104268;241503;Zespół Szkół Ponadgimnazjalnych Nr 2|Rydułtowy|ul. Obywatelska 30 |44-280 Rydułtowy;738;369;369;15;354;50.00;4.07
104269;241503;Publiczne Przedszkole nr 4|Rydułtowy|Osiedle Orłowiec 37 |44-280 Rydułtowy;1559;743;743;26;717;47.66;3.50
104270;241503;Szkoła Podstawowa Nr 3|Rydułtowy|ul. Radoszowska 3 |44-280 Rydułtowy;1710;944;944;29;915;55.20;3.07
104271;241503;Publiczne Przedszkole Nr 1|Rydułtowy|ul. Jana Kochanowskiego 25 |44-280 Rydułtowy;1426;716;716;16;700;50.21;2.23
104272;241503;Gimnazjum Nr 1|Rydułtowy|ul. Strzelców Bytomskich 13 |44-280 Rydułtowy;977;525;525;14;511;53.74;2.67
104273;241503;Ochotnicza Straż Pożarna|Rydułtowy|ul. Radoszowska 35 |44-280 Rydułtowy;1435;755;755;18;737;52.61;2.38
104274;241503;Liceum Ogólnokształcące w Rydułtowach|Rydułtowy|ul. Skalna 1 |44-280 Rydułtowy;1512;756;756;21;735;50.00;2.78
104275;241503;Urząd Miasta Rydułtowy|Rydułtowy|ul. Ofiar Terroru 36 |44-280 Rydułtowy;859;524;524;9;515;61.00;1.72
104276;241503;Szkoła Podstawowa Nr 1|Rydułtowy|ul. Św. Maksymiliana Kolbe 5 |44-280 Rydułtowy;1709;853;853;22;831;49.91;2.58
104277;241503;Szkoła Podstawowa Nr 1|Rydułtowy|ul. Św. Maksymiliana Kolbe 5 |44-280 Rydułtowy;1624;870;870;34;836;53.57;3.91
104278;241503;Szpital Powiatowego Publicznego Zakładu Opieki Zdrowotnej w Rydułtowach i Wodzisławiu Śląskim|Rydułtowy|Plebiscytowa 47 |44-280 Rydułtowy;155;44;44;1;43;28.39;2.27
104279;241504;Zespół Szkół nr 2 w Wodzisławiu Śląskim|Wodzisław Śląski|ul. Wałowa 5 |44-300 Wodzisław Śląski;1499;778;778;11;767;51.90;1.41
104280;241504;Zespół Szkół nr 2 w Wodzisławiu Śląskim|Wodzisław Śląski|ul. Wałowa 5 |44-300 Wodzisław Śląski;1598;960;960;13;947;60.08;1.35
104281;241504;Zespół Placówek Szkolno-Wychowawczo-Rewalidacyjnych w Wodzisławiu Śląskim|Wodzisław Śląski|ul. Mikołaja Kopernika 71 |44-300 Wodzisław Śląski;1626;984;984;11;973;60.52;1.12
104282;241504;Szkoła Podstawowa nr 3 w Wodzisławiu Śląskim|Wodzisław Śląski|ul. 26 Marca 9 |44-300 Wodzisław Śląski;1988;864;864;28;836;43.46;3.24
104283;241504;Zespół Szkolno-Przedszkolny nr 7 w Wodzisławiu Śląskim|Wodzisław Śląski|ul. Tysiąclecia 25 |44-300 Wodzisław Śląski;2042;891;891;36;855;43.63;4.04
104284;241504;Zespół Szkół Ponadgimnazjalnych w Wodzisławiu Śląskim|Wodzisław Śląski|ul. Kardynała Stefana Wyszyńskiego 41 |44-300 Wodzisław Śląski;1631;858;858;18;840;52.61;2.10
104285;241504;Gimnazjum nr 2 w Wodzisławiu Śląskim|Wodzisław Śląski|ul. 26 Marca 66 |44-300 Wodzisław Śląski;2182;1039;1039;36;1003;47.62;3.46
104286;241504;Zespół Poradni Specjalistycznych w Wodzisławiu Śląskim|Wodzisław Śląski|ul. 26 Marca 164 |44-286 Wodzisław Śląski;1818;909;909;14;895;50.00;1.54
104287;241504;Publiczne Przedszkole nr 19 w Wodzisławiu Śląskim|Wodzisław Śląski|Osiedle XXX Lecia PRL 30 |44-286 Wodzisław Śląski;1619;967;967;17;950;59.73;1.76
104288;241504;Szkoła Podstawowa nr 10 w Wodzisławiu Śląskim|Wodzisław Śląski|Osiedle XXX Lecia PRL 63 |44-286 Wodzisław Śląski;2005;1142;1142;26;1116;56.96;2.28
104289;241504;Publiczne Przedszkole nr 16 w Wodzisławiu Śląskim|Wodzisław Śląski|ul. Przemysława 10 |44-286 Wodzisław Śląski;1435;802;802;16;786;55.89;2.00
104290;241504;Publiczne Przedszkole nr 15 w Wodzisławiu Śląskim|Wodzisław Śląski|ul. Przemysława 20 |44-286 Wodzisław Śląski;1833;979;979;15;964;53.41;1.53
104291;241504;Zespół Szkolno-Przedszkolny nr 4 w Wodzisławiu Śląskim|Wodzisław Śląski|ul. Górnicza 7 |44-300 Wodzisław Śląski;1156;507;507;24;483;43.86;4.73
104292;241504;Szkoła Podstawowa nr 2 w Wodzisławiu Śląskim|Wodzisław Śląski|ul. Ks. Antoniego Roboty 7 |44-300 Wodzisław Śląski;1267;773;773;13;760;61.01;1.68
104293;241504;Szkoła Podstawowa nr 2 w Wodzisławiu Śląskim|Wodzisław Śląski|ul. Ks. Antoniego Roboty 7 |44-300 Wodzisław Śląski;1186;674;674;24;650;56.83;3.56
104294;241504;Zespół Szkolno-Przedszkolny nr 2 w Wodzisławiu Śląskim|Wodzisław Śląski|ul. Jastrzębska 136 |44-304 Wodzisław Śląski;1594;896;896;17;879;56.21;1.90
104295;241504;Zespół Szkolno-Przedszkolny nr 2 w Wodzisławiu Śląskim|Wodzisław Śląski|ul. Jastrzębska 136 |44-304 Wodzisław Śląski;1355;723;723;18;705;53.36;2.49
104296;241504;Zespół Szkół nr 1 w Wodzisławiu Śląskim|Wodzisław Śląski|ul. Armii Ludowej 11 |44-304 Wodzisław Śląski;1982;952;952;35;917;48.03;3.68
104297;241504;Zespół Szkolno-Przedszkolny nr 6 w Wodzisławiu Śląskim|Wodzisław Śląski|ul. Młodzieżowa 47 |44-373 Wodzisław Śląski;1996;1034;1034;34;1000;51.80;3.29
104298;241504;Zespół Szkolno-Przedszkolny nr 1 w Wodzisławiu Śląskim|Wodzisław Śląski|ul. Konwaliowa 4 |44-373 Wodzisław Śląski;1953;952;952;29;923;48.75;3.05
104299;241504;Zespół Szkolno-Przedszkolny nr 3 w Wodzisławiu Śląskim|Wodzisław Śląski|ul. Marii Skłodowskiej Curie 3 |44-313 Wodzisław Śląski;2331;1252;1252;23;1229;53.71;1.84
104300;241504;Zespół Szkolno-Przedszkolny nr 3 w Wodzisławiu Śląskim|Wodzisław Śląski|ul. Marii Skłodowskiej Curie 3 |44-313 Wodzisław Śląski;903;468;468;7;461;51.83;1.50
104301;241504;Zespół Szkono-Przedszkolny nr 5 w Wodzisławiu Śląskim|Wodzisław Śląski|ul. Bolesława Chrobrego 308 |44-313 Wodzisław Śląski;1216;642;642;24;618;52.80;3.74
104302;241504;Powiatowy Publiczny Zakład Opieki Zdrowotnej w Rydułdowach i w Wodzisławiu Śląskim z siedzibą w Wodzisławiu Śląskim|Wodzisław Śląski|ul. 26 Marca 51 |44-300 Wodzisław Śląski;36;25;25;1;24;69.44;4.00
104303;241504;Wojewódzki Szpital Chorób Płuc w Wodzisławiu Śląskim|Wodzisław Śląski|ul. Bracka 13 |44-300 Wodzisław Śląski;54;33;33;4;29;61.11;12.12
104304;241505;Remiza OSP|Godów|ul. Gliniki 10 |44-340 Godów;778;440;440;9;431;56.56;2.05
104305;241505;Remiza OSP|Godów|ul. Gliniki 10 |44-340 Godów;781;416;416;8;408;53.27;1.92
104306;241505;Zespół Szkół|Gołkowice|ul. 1 Maja 101a |44-341 Godów;777;401;401;12;389;51.61;2.99
104307;241505;Zespół Szkół|Gołkowice|ul. 1 Maja 101a |44-341 Godów;659;412;412;7;405;62.52;1.70
104308;241505;Zespół Szkół|Gołkowice|ul. 1 Maja 101a |44-341 Godów;856;495;495;18;477;57.83;3.64
104309;241505;Zespół Szkół|Gołkowice|ul. 1 Maja 101a |44-341 Godów;787;482;482;11;471;61.25;2.28
104310;241505;Szkoła Podstawowa|Krostoszowice|ul. G. Morcinka 4 |44-348 Godów;484;249;249;15;234;51.45;6.02
104311;241505;Szkoła Podstawowa|Krostoszowice|G. Morcinka 4 |44-348 Godów;506;271;271;6;265;53.56;2.21
104312;241505;Zespół Szkolno-Przedszkolny|Łaziska|ul. Powstańców Śl. 151 |44-340 Godów;744;437;437;7;430;58.74;1.60
104313;241505;Zespół Szkolno-Przedszkolny|Łaziska|ul. Powstańców Śl. 151 |44-340 Godów;691;437;437;18;419;63.24;4.12
104314;241505;Zespół Szkolno-Przedszkolny|Skrbeńsko|ul. Szkolna 1 |44-341 Godów;745;462;462;13;449;62.01;2.81
104315;241505;Zespół Szkół|Skrzyszów|ul. 1 Maja 177 |44-348 Godów;795;444;444;10;434;55.85;2.25
104316;241505;Zespół Szkół|Skrzyszów|ul. 1 Maja 177 |44-348 Godów;732;386;386;13;373;52.73;3.37
104317;241505;Zespół Szkół|Skrzyszów|ul. 1 Maja 177 |44-348 Godów;741;352;352;5;347;47.50;1.42
104318;241505;Zespół Szkół|Skrzyszów|ul. 1 Maja 177 |44-348 Godów;705;369;369;12;357;52.34;3.25
104319;241505;Dom Seniora Gwarek|Skrzyszów|Dębowa 13c |44-348 Godów;27;14;14;0;14;51.85;0.00
104320;241506;Remiza Strażacka|Bełsznica|ul. Raciborska 53 |44-362 Rogów;879;462;462;16;446;52.56;3.46
104321;241506;Szkoła Podstawowa|Bluszczów|ul. Wiejska 8 |44-362 Rogów;805;389;389;10;379;48.32;2.57
104322;241506;Wiejski Dom Kultury|Czyżowice|ul. Strażacka 8a |44-352 Czyżowice;1348;724;724;15;709;53.71;2.07
104323;241506;Remiza Strażacka|Czyżowice|ul.Strażacka 8 |44-352 Czyżowice;1385;723;723;14;709;52.20;1.94
104324;241506;Sala gimnastyczna przy Gimnazjum w Gorzycach|Gorzyce|ul. Bogumińska 1d |44-350 Gorzyce;1619;858;858;10;848;53.00;1.17
104325;241506;Świetlica Wiejska|Gorzyce|ul. 7 kwietnia 2 |44-350 Gorzyce;781;370;370;11;359;47.38;2.97
104326;241506;Zespół Szkolno-Przedszkolny|Gorzyczki|ul. Wiejska 30 |44-350 Gorzyce;1578;730;730;19;711;46.26;2.60
104327;241506;Szkoła Podstawowa nr 2 w Gorzycach|Gorzyczki|ul. Leśna 46 |44-350 Gorzyce;850;377;377;15;362;44.35;3.98
104328;241506;Świetlica Wiejska|Odra|ul. Główna 10 |44-362 Rogów;801;306;306;6;300;38.20;1.96
104329;241506;Wiejski Dom Kultury|Olza|ul. Szkolna 7 |44-353 Olza;831;397;397;17;380;47.77;4.28
104330;241506;Szkoła Podstawowa|Rogów|ul. Szkolna 2 |44-362 Rogów;861;399;399;15;384;46.34;3.76
104331;241506;Gimnazjum|Rogów|ul. Szkolna 2 |44-362 Rogów;1623;872;872;20;852;53.73;2.29
104332;241506;Szkoła Podstawowa|Turza Śląska|ul. Ligonia 2b |44-351 Turza Śląska;1350;736;736;17;719;54.52;2.31
104333;241506;Gimnazjum|Turza Śląska|ul. Ligonia 2b |44-351 Turza Śląska;1377;754;754;8;746;54.76;1.06
104334;241506;Dom Pomocy Społecznej|Gorzyce|Bogumińska 22 |44-350 Gorzyce;210;84;84;19;65;40.00;22.62
104335;241507;Gminny Ośrodek Kultury|Lubomia|ul. Mickiewicza 4 |44-360 Lubomia;1690;720;720;13;707;42.60;1.81
104336;241507;Gminny Ośrodek Kultury|Lubomia|ul. Mickiewicza 4 |44-360 Lubomia;1282;538;538;12;526;41.97;2.23
104337;241507;Świetlica|Grabówka|ul.Bordynowska 2b |44-360 Lubomia;280;112;112;5;107;40.00;4.46
104338;241507;Wiejski Dom Kultury|Syrynia|ul. 3 Maja 65 |44-361 Lubomia;1371;666;666;41;625;48.58;6.16
104339;241507;Wiejski Dom Kultury|Syrynia|ul. 3 Maja 65 |44-361 Lubomia;1225;596;596;19;577;48.65;3.19
104340;241507;Szkoła Podstawowa|Nieboczowy|ul.Rzeczna 20 |44-360 Lubomia;244;110;110;7;103;45.08;6.36
104341;241507;Świetlica OSP|Buków|ul.Główna 24a |44-360 Lubomia;267;104;104;2;102;38.95;1.92
104342;241508;Szkoła Podstawowa Nr 1|Marklowice, Marklowice Dolne|ul. Wyzwolenia 160 |44-321 Marklowice;976;568;568;18;550;58.20;3.17
104343;241508;Szkoła Podstawowa Nr 1|Marklowice|ul. Wyzwolenia 160 |44-321 Marklowice;938;536;536;14;522;57.14;2.61
104344;241508;Budynek Ochotniczej Straży Pożarnej|Marklowice|ul. Krakusa 1 |44-321 Marklowice;1073;528;528;19;509;49.21;3.60
104345;241508;Szkoła Podstawowa Nr 2|Marklowice, Marklowice-Chałupki|ul. Wiosny Ludów 78 |44-321 ;1333;794;794;23;771;59.56;2.90
104346;241509;Urząd Gminy|Mszana|ul. 1 Maja 81 |44-325 Mszana;1570;879;879;31;848;55.99;3.53
104347;241509;Urząd Gminy|Mszana|ul. 1 Maja 81 |44-325 Mszana;1391;811;811;29;782;58.30;3.58
104348;241509;Szkoła Podstawowa|Połomia|ul. Szkolna 21 |44-323 Połomia;2096;1286;1286;62;1224;61.35;4.82
104349;241509;Zespół Szkół|Gogołowa|ul. Wiejska 89 |44-323 Połomia;832;501;501;20;481;60.22;3.99
104350;241601;Miejski Ośrodek Kultury (parter)|Poręba|ul. Adama Mickiewicza 2 |42-480 Poręba;767;394;394;15;379;51.37;3.81
104351;241601;Miejski Ośrodek Kultury (parter)|Poręba|ul. Adama Mickiewicza 2 |42-480 Poręba;1199;569;569;22;547;47.46;3.87
104352;241601;Miejski Zespół Szkół (stary segment budynku)|Poręba|ul. Ludowego Wojska Polskiego 4 |42-480 Poręba;1314;608;608;20;588;46.27;3.29
104353;241601;Miejski Zespół Szkół (nowy segment budynku)|Poręba|ul. Ludowego Wojska Polskiego 4 |42-480 Poręba;1168;581;581;16;565;49.74;2.75
104354;241601;Szkoła Podstawowa nr 2|Poręba|ul. Wiedzy 3 |42-480 Poręba;1268;628;628;7;621;49.53;1.11
104355;241601;Szkoła Podstawowa nr 3|Poręba|ul. Generała Ziętka 44 |42-480 Poręba;821;389;389;13;376;47.38;3.34
104356;241601;Remiza OSP|Poręba|ul. Kopernika 66 |42-480 Poręba;640;302;302;14;288;47.19;4.64
104357;241602;Zespół Szkół im. Oskara Langego|Zawiercie|ul. Rataja 30 |42-400 ;1148;549;549;7;542;47.82;1.28
104358;241602;Zespół Szkół im. Oskara Langego|Zawiercie|ul. Rataja 30 |42-400 ;1056;496;496;7;489;46.97;1.41
104359;241602;Szkoła Podstawowa Nr 7|Zawiercie|ul. Oświatowa 55 |42-400 ;903;508;508;10;498;56.26;1.97
104360;241602;Szkoła Podstawowa Nr 7|Zawiercie|ul. Oświatowa 55 |42-400 ;996;559;559;5;554;56.12;0.89
104361;241602;Remiza Ochotniczej Straży Pożarnej|Zawiercie, Blanowice|ul. Olendry 10 |42-400 ;1241;616;616;13;603;49.64;2.11
104362;241602;Remiza Ochotniczej Straży Pożarnej|Zawiercie, Skarżyce|ul. Skarżycka 4 |42-400 ;561;300;300;10;290;53.48;3.33
104363;241602;Remiza Ochotniczej Straży Pożarnej|Zawiercie, Żerkowice|ul. Fredry 1 |42-400 ;736;322;322;5;317;43.75;1.55
104364;241602;Remiza Ochotniczej Straży Pożarnej|Zawiercie, Bzów|ul. Poległych 27 |42-400 ;759;452;452;7;445;59.55;1.55
104365;241602;Przedszkole Integracyjne Nr 3|Zawiercie|ul. Kardynała Wyszyńskiego 5 |42-400 ;1133;608;608;6;602;53.66;0.99
104366;241602;Przedszkole Integracyjne Nr 3|Zawiercie|ul. Kardynała Wyszyńskiego 5 |42-400 ;975;507;507;13;494;52.00;2.56
104367;241602;Szkoła Podstawowa Nr 4|Zawiercie|ul. Powstańców Śląskich 18 |42-400 ;1151;619;619;6;613;53.78;0.97
104368;241602;II Liceum Ogólnokształcące|Zawiercie|ul. Daszyńskiego 2 |42-400 ;1154;610;610;12;598;52.86;1.97
104369;241602;Szkoła Podstawowa Nr 5|Zawiercie|ul. Paderewskiego 49 |42-400 ;1580;781;781;9;772;49.43;1.15
104370;241602;II Liceum Ogólnokształcące|Zawiercie|ul. Daszyńskiego 2 |42-400 ;794;420;420;4;416;52.90;0.95
104371;241602;Gimnazjum Nr 3|Zawiercie|ul. Marii Skłodowskiej-Curie 16 |42-400 ;1136;627;627;5;622;55.19;0.80
104372;241602;Gimnazjum Nr 3|Zawiercie|ul. Marii Skłodowskiej-Curie 16 |42-400 ;1106;631;631;1;630;57.05;0.16
104373;241602;Regionalne Centrum Kształcenia Ustawicznego w Sosnowcu, Filia Zawiercie|Zawiercie|ul. Żabia 19b |42-400 ;1075;552;552;15;537;51.35;2.72
104374;241602;Zespół Szkół, Gimnazjum Nr 6 i Szkoła Podstawowa Nr 13|Zawiercie|ul. Filaretów 9 |42-400 ;1055;555;555;10;545;52.61;1.80
104375;241602;Zespół Szkół, Gimnazjum Nr 6 i Szkoła Podstawowa Nr 13|Zawiercie|ul. Filaretów 9 |42-400 ;1168;552;552;14;538;47.26;2.54
104376;241602;Szkoła Podstawowa Nr 11|Zawiercie|ul. Zarzecze 2 |42-400 ;1341;673;673;12;661;50.19;1.78
104377;241602;Zespół Szkół i Placówek im. Hugona Kołłątaja|Zawiercie|ul. Miodowa 1 |42-400 ;1241;625;625;4;621;50.36;0.64
104378;241602;Zespół Szkół im. Gen. Józefa Bema|Zawiercie|ul. Parkowa 7 |42-400 ;1377;767;767;26;741;55.70;3.39
104379;241602;Zespół Szkół im. Gen. Józefa Bema, budynek Nr 2|Zawiercie|ul. Parkowa 2 |42-400 ;908;440;440;8;432;48.46;1.82
104380;241602;Przedszkole Nr 15|Zawiercie|ul. Wierzbowa 27 |42-400 42;1014;531;531;13;518;52.37;2.45
104381;241602;Gimnazjum Nr 2|Zawiercie|ul. Niedziałkowskiego 21 |42-400 ;1089;566;566;4;562;51.97;0.71
104382;241602;Gimnazjum Nr 1|Zawiercie|ul. 11 Listopada 22 |42-400 ;1105;523;523;9;514;47.33;1.72
104383;241602;Przedszkole Nr 2|Zawiercie|ul. Marszałkowska 28 |42-400 ;1303;388;388;8;380;29.78;2.06
104384;241602;Szkoła Podstawowa Nr 6|Zawiercie|ul. Wierzbowa 4 |42-400 ;906;422;422;4;418;46.58;0.95
104385;241602;Szkoła Podstawowa Nr 6|Zawiercie|ul. Wierzbowa 4 |42-400 ;909;439;439;8;431;48.29;1.82
104386;241602;Przedszkole Nr 8|Zawiercie|ul. Wierzbowa 8 |42-400 ;1115;598;598;5;593;53.63;0.84
104387;241602;Ośrodek Sportu i Rekreacji|Zawiercie|ul. Moniuszki 10 |42-400 ;888;291;291;5;286;32.77;1.72
104388;241602;Ośrodek Sportu i Rekreacji|Zawiercie|ul. Moniuszki 10 |42-400 ;894;332;332;11;321;37.14;3.31
104389;241602;Przedszkole Nr 1|Zawiercie|ul. Paderewskiego 57 |42-400 ;1549;719;719;19;700;46.42;2.64
104390;241602;Przedszkole Nr 4|Zawiercie|ul. Gałczyńskiego 5 |42-400 ;950;529;529;8;521;55.68;1.51
104391;241602;Szkoła Podstawowa nr 9|Zawiercie|ul. Piłsudskiego 117 |42-400 ;909;551;551;3;548;60.62;0.54
104392;241602;Przedszkole Nr 5|Zawiercie|ul. Moniuszki 9 |42-400 ;1084;473;473;9;464;43.63;1.90
104393;241602;Miejski Ośrodek Kultury "CENTRUM"|Zawiercie|ul. Piastowska 1 |42-400 ;989;497;497;7;490;50.25;1.41
104394;241602;Szkoła Podstawowa Nr 9|Zawiercie|ul. Piłsudskiego 117 |42-400 ;975;440;440;12;428;45.13;2.73
104395;241602;Szkoła Podstawowa Nr 9|Zawiercie|ul. Piłsudskiego 117 |42-400 ;1166;558;558;21;537;47.86;3.76
104396;241602;Dom Pomocy Społecznej|Zawiercie|ul. Rzemieślnicza 9 |42-400 ;109;54;54;5;49;49.54;9.26
104397;241602;Szpital Powiatowy|Zawiercie|ul. Miodowa 14 |42-400 ;74;35;35;2;33;47.30;5.71
104398;241603;Urząd Gminy|Irządze| 124 |42-446 Irządze;1396;579;579;16;563;41.48;2.76
104399;241603;Agronomówka|Woźniki| 34 |42-446 Irządze;480;220;220;6;214;45.83;2.73
104400;241603;Remiza OSP|Witów| 165 |42-446 Irządze;382;156;156;13;143;40.84;8.33
104401;241604;Gimnazjum w Kroczycach|Kroczyce|ul. Sienkiewicza 7 |42-425 Kroczyce;1492;745;745;27;718;49.93;3.62
104402;241604;Szkoła Podstawowa Fundacji "Elementarz"|Dzibice| 62 |42-425 Kroczyce;569;246;246;12;234;43.23;4.88
104403;241604;Szkoła Podstawowa|Pradła|ul. Batalionów Chłopskich 14 |42-425 Kroczyce;1257;540;540;20;520;42.96;3.70
104404;241604;Szkoła Podstawowa Fundacji "Elementarz" z Oddziałem Przedszkolnym|Siamoszyce| 7 |42-425 Kroczyce;772;340;340;9;331;44.04;2.65
104405;241604;Szkoła Podstawowa|Kroczyce|ul. Kościuszki 29 |42-425 Kroczyce;1087;493;493;13;480;45.35;2.64
104406;241605;Zespół Szkół Nr 1|Łazy|ul. Szkolna 1 |42-450 Łazy;1692;926;926;19;907;54.73;2.05
104407;241605;Dom Kultury "Kolejarz"|Łazy|ul. Kościuszki 5 |42-450 Łazy;1586;860;860;30;830;54.22;3.49
104408;241605;Szkoła Podstawowa Nr 3|Łazy|ul. 19 Stycznia 14 |42-450 Łazy;903;491;491;22;469;54.37;4.48
104409;241605;Szkoła Podstawowa Nr 3|Łazy|ul. 19 Stycznia 14 |42-450 Łazy;1506;751;751;17;734;49.87;2.26
104410;241605;Niepubliczna Szkoła Podstawowa|Grabowa|ul. Szkolna 37 |42-450 Łazy;637;242;242;12;230;37.99;4.96
104411;241605;Zespół Szkół Nr 2|Niegowonice|ul. Szkolna 11 |42-450 Łazy;2077;1032;1032;35;997;49.69;3.39
104412;241605;Niepubliczna Szkoła Podstawowa|Rokitno Szlacheckie|ul. Szkolna 2 |42-450 Łazy;994;492;492;13;479;49.50;2.64
104413;241605;Niepubliczna Szkoła Podstawowa|Ciągowice|ul. Zwycięstwa 72 |42-450 Łazy;926;488;488;14;474;52.70;2.87
104414;241605;Szkoła Podstawowa|Wysoka|ul. Adama Mickiewicza 8 |42-450 Łazy;1173;505;505;15;490;43.05;2.97
104415;241605;Zespół Szkół Nr 3|Chruszczobród|ul. Adama Mickiewicza 113 |42-450 Łazy;1632;754;754;10;744;46.20;1.33
104416;241606;Miejsko-Gminny Ośrodek Kultury w Ogrodzieńcu|Ogrodzieniec|Plac Wolności 24 |42-440 Ogrodzieniec;1554;849;849;15;834;54.63;1.77
104417;241606;Zespół Szkolno-Przedszkolny w Ogrodzieńcu|Ogrodzieniec|ul. Kościuszki 67 |42-440 Ogrodzieniec;1559;833;833;14;819;53.43;1.68
104418;241606;Gimnazjum Publiczne w Ogrodzieńcu|Ogrodzieniec|Osiedle Elizy Orzeszkowej 13 |42-440 Ogrodzieniec;1241;613;613;12;601;49.40;1.96
104419;241606;Szkoła Podstawowa w Ryczowie|Ryczów|ul. Armii Krajowej 26 |42-440 Ogrodzieniec;1172;482;482;15;467;41.13;3.11
104420;241606;Szkoła Podstawowa Fundacji Elementarz w Podzamczu|Podzamcze|ul. Szkolna 6 |42-440 Ogrodzieniec;824;425;425;8;417;51.58;1.88
104421;241606;Szkoła Podstawowa w Gieble|Giebło|ul. Edukacyjna 6 |42-440 Ogrodzieniec;1419;748;748;22;726;52.71;2.94
104422;241607;Remiza Ochotniczej Straży Pożarnej|Dobraków| 48 |42-439 Żarnowiec;636;319;319;2;317;50.16;0.63
104423;241607;Remiza Ochotniczej Straży Pożarnej|Kidów|ul. Szkolna 5 |42-436 Pilica;635;343;343;5;338;54.02;1.46
104424;241607;Szkoła Podstawowa|Pilica|ul. 17 Stycznia 2a |42-436 Pilica;2041;1096;1096;17;1079;53.70;1.55
104425;241607;Przedszkole|Pilica|ul. Senatorska 17 |42-436 Pilica;941;452;452;14;438;48.03;3.10
104426;241607;Szkoła Podstawowa|Dzwono-Sierbowice| 2 |42-436 Pilica;876;413;413;7;406;47.15;1.69
104427;241607;Szkoła Podstawowa|Sławniów|ul. Długa 9 |42-436 Pilica;1028;501;501;8;493;48.74;1.60
104428;241607;Szkoła Podstawowa|Wierbka|ul. Szkolna 3 |42-436 Pilica;1153;584;584;15;569;50.65;2.57
104429;241608;Szkoła Podstawowa Nr 1|Szczekociny|ul. Senatorska 22 |42-445 Szczekociny;822;392;392;9;383;47.69;2.30
104430;241608;Szkoła Podstawowa Nr 1|Szczekociny|ul. Senatorska 22 |42-445 Szczekociny;610;248;248;13;235;40.66;5.24
104431;241608;Miejsko-Gminny Ośrodek Kutury i Sportu|Szczekociny|ul. Krakowska 23 |42-445 Szczekociny;845;421;421;14;407;49.82;3.33
104432;241608;Budynek byłej Szkoły Podstawowej Nr 2|Szczekociny|ul. Śląska 86 |42-445 Szczekociny;905;506;506;11;495;55.91;2.17
104433;241608;Remiza OSP|Bonowice| 83 |42-445 Szczekociny;405;172;172;4;168;42.47;2.33
104434;241608;Wiejskie Centrum Kultury|Starzyny| 20 |42-445 Szczekociny;362;162;162;6;156;44.75;3.70
104435;241608;Remiza OSP|Przyłęk| 27 |42-445 Szczekociny;226;99;99;6;93;43.81;6.06
104436;241608;Remiza OSP|Drużykowa| 103 |42-445 Szczekociny;315;135;135;8;127;42.86;5.93
104437;241608;Zespół Szkół|Goleniowy|ul. Kościuszki 20 |42-445 Szczekociny;635;334;334;9;325;52.60;2.69
104438;241608;Zespół Szkół|Rokitno| 34 |42-445 Szczekociny;722;333;333;15;318;46.12;4.50
104439;241608;Zespół Szkół|Rokitno| 34 |42-445 Szczekociny;345;168;168;4;164;48.70;2.38
104440;241608;Remiza OSP|Siedliska| 19 |42-445 Szczekociny;495;207;207;8;199;41.82;3.86
104441;241609;Remiza OSP|Góra Włodowska|ul. Strażacka 5 |42-421 Włodowice;461;186;186;3;183;40.35;1.61
104442;241609;Szkoła Podstawowa|Rudniki|ul. Szkolna 11 |42-421 Włodowice;1356;621;621;5;616;45.80;0.81
104443;241609;Szkoła Podstawowa|Włodowice|ul. Krakowska 13 |42-421 Włodowice;1428;725;725;14;711;50.77;1.93
104444;241609;Filia Szkoły Podstawowej we Włodowicach|Zdów|ul. Topolowa 1 |42-421 Włodowice;680;252;252;12;240;37.06;4.76
104445;241609;Świetlica Wiejska|Rzędkowice|ul. Wiejska 2 |42-421 Włodowice;430;189;189;2;187;43.95;1.06
104446;241610;Dom Kultury|Żarnowiec|ul. Rynek 9 |42-439 ;853;458;458;7;451;53.69;1.53
104447;241610;Szkoła Podstawowa|Chlina| 135a |42-439 Żarnowiec;813;351;351;29;322;43.17;8.26
104448;241610;Szkoła Podstawowa|Wola Libertowska| 26a |42-439 Żarnowiec;416;170;170;7;163;40.87;4.12
104449;241610;Szkoła Podstawowa|Otola| 57 |42-439 Żarnowiec;520;270;270;11;259;51.92;4.07
104450;241610;Szkoła Podstawowa|Małoszyce| 84 |42-439 Żarnowiec;258;114;114;5;109;44.19;4.39
104451;241610;Remiza Ochotniczej Straży Pożarnej|Łany Wielkie| |42-439 Żarnowiec;636;298;298;6;292;46.86;2.01
104452;241610;Szkoła Podstawowa|Koryczany| 106 |42-439 Żarnowiec;337;176;176;4;172;52.23;2.27
104453;241701;Liceum Ogólnokształcące im. Kopernika|Żywiec|ul. Słowackiego 2 |34-300 Żywiec;1217;615;615;6;609;50.53;0.98
104454;241701;Szkoła Podstawowa Nr 5|Żywiec|ul. Powstańców Śląskich 4 |34-300 Żywiec;1087;631;631;11;620;58.05;1.74
104455;241701;Szkoła Podstawowa Nr 5|Żywiec|ul. Powstańców Śląskich 4 |34-300 Żywiec;1214;682;682;13;669;56.18;1.91
104456;241701;Miejskie Centrum Kultury Klub "AKWARIUM"|Żywiec|Os. 700-lecia 9B |34-300 Żywiec;1178;662;662;13;649;56.20;1.96
104457;241701;Zespół Szkół Mechaniczno-Elektrycznych|Żywiec|ul. KEN 3 |34-300 Żywiec;1246;727;727;17;710;58.35;2.34
104458;241701;Zespół Szkolno-Przedszkolny Nr 2|Żywiec|ul. Niezapominajki 14 |34-300 Żywiec;1123;612;612;23;589;54.50;3.76
104459;241701;Zespół Szkolno-Przedszkolny Nr 1|Żywiec|ul. Moszczanicka 26 |34-300 Żywiec;1215;692;692;11;681;56.95;1.59
104460;241701;Specjalny Ośrodek Szkolno Wychowawczy|Żywiec|ul. Kopernika 77 |34-300 Żywiec;1277;760;760;8;752;59.51;1.05
104461;241701;Szkoła Podstawowa Nr 3|Żywiec|ul. M. C. Skłodowskiej 2 |34-300 Żywiec;1181;645;645;7;638;54.61;1.09
104462;241701;Miejskie Centrum Kultury Klub Środowiskowy|Żywiec|ul. Sporyska 39 |34-300 Żywiec;1265;735;735;24;711;58.10;3.27
104463;241701;Miejskie Centrum Kultury Klub "Śrubka"|Żywiec|ul. Grunwaldzka 13 |34-300 Żywiec;712;422;422;3;419;59.27;0.71
104464;241701;Klub Środowiskowy|Żywiec|ul. Kocurowska 61 |34-300 Żywiec;558;322;322;6;316;57.71;1.86
104465;241701;Przedszkole Nr 10|Żywiec|ul. Browar Kolonia 44 |34-300 Żywiec;1171;648;648;13;635;55.34;2.01
104466;241701;Szkoła Podstawowa Nr 1|Żywiec|ul. Ks. Pr. St. Słonki 14 |34-300 Żywiec;1334;730;730;14;716;54.72;1.92
104467;241701;Gimnazjum Nr 1|Żywiec|ul. Dworcowa 26 |34-300 Żywiec;1318;707;707;15;692;53.64;2.12
104468;241701;Zespół Szkół Budowlano-Drzewnych|Żywiec|ul. Szkolna 2 |34-300 Żywiec;1327;699;699;18;681;52.68;2.58
104469;241701;Szkoła Podstawowa Nr 9|Żywiec|ul. Podlesie 63 |34-300 Żywiec;1053;507;507;10;497;48.15;1.97
104470;241701;Przedszkole Nr 9|Żywiec|ul. Poniatowskiego 12 |34-300 Żywiec;1200;679;679;11;668;56.58;1.62
104471;241701;Miejski Ośrodek Sportu i Rekreacji|Żywiec|ul. Zielona 7 |34-300 Żywiec;1093;599;599;15;584;54.80;2.50
104472;241701;Przedszkole Nr 11|Żywiec|Os. Parkowe 16 |34-300 Żywiec;1100;610;610;14;596;55.45;2.30
104473;241701;Gimnazjum Nr 2|Żywiec|ul. Zielona 1 |34-300 Żywiec;1183;695;695;16;679;58.75;2.30
104474;241701;Zespół Szkół Ekonomiczno-Gastronomicznych|Żywiec|ul. Mickiewicza 6 |34-300 Żywiec;1177;653;653;17;636;55.48;2.60
104475;241701;Szpital Powiatowy|Żywiec|Sienkiewicza 52 |34-300 Żywiec;82;57;57;1;56;69.51;1.75
104476;241701;Dom Pomocy Społecznej|Żywiec|Śliżowy Potok 8 |34-300 Żywiec;89;61;61;8;53;68.54;13.11
104477;241702;Zespól Szkolno-Przedszkolny|Czernichów|ul. Turystyczna 8 |34-311 Czernichów;1487;852;852;38;814;57.30;4.46
104478;241702;Zespół Szkół|Międzybrodzie Żywieckie|ul. Beskidzka 27 |34-312 Międzybrodzie Bialskie;1203;711;711;17;694;59.10;2.39
104479;241702;Zespół Szkół|Międzybrodzie Bialskie|ul. Bielska 2 |34-312 Międzybrodzie Bialskie;1586;936;936;28;908;59.02;2.99
104480;241702;Zespół Szkół Sala gimnastyczna|Międzybrodzie Bialskie|ul. Bielska 2 |34-312 Międzybrodzie Bialskie;938;552;552;9;543;58.85;1.63
104481;241702;Psychiatryczny Zakład Opiekuńczo-Leczniczy|Międzybrodzie Bialskie|ul. Graniczna 7 |34-312 Międzybrodzie Bialskie;119;56;56;2;54;47.06;3.57
104482;241703;Dom Ludowy w Rychwałdzie|Rychwałd|ul. Beskidzka 41 |34-322 Gilowice;1282;679;679;10;669;52.96;1.47
104483;241703;Sala Narad Urzędu Gminy Gilowice|Gilowice|ul. Krakowska 40 |34-322 Gilowice;1652;957;957;26;931;57.93;2.72
104484;241703;Gminny Ośrodek Kultury w Gilowicach|Gilowice|ul. Krakowska 40 |34-322 Gilowice;1924;1086;1086;20;1066;56.44;1.84
104485;241704;Przedszkole w Krzyżowej|Krzyżowa|ul. Jana Pawła II 228 |34-335 Krzyżowa;1137;565;565;21;544;49.69;3.72
104486;241704;Zespół Szkół Nr 5 w Korbielowie|Korbielów|ul. Beskidzka 40 |34-335 Krzyżowa;933;409;409;10;399;43.84;2.44
104487;241704;Zespół Szkół Nr 2 w Jeleśni|Jeleśnia|ul. Żywiecka 17 |34-340 Jeleśnia;1628;828;828;28;800;50.86;3.38
104488;241704;Zespół Szkół Nr 1 w Jeleśni|Jeleśnia|ul. Rynek 11 |34-340 Jeleśnia;1638;867;867;29;838;52.93;3.34
104489;241704;Zespół Szkół Nr 4 w Sopotni Wielkiej|Sopotnia Wielka| 289 |34-340 Jeleśnia;1326;589;589;32;557;44.42;5.43
104490;241704;Zespół Szkół Nr 6 w Sopotni Małej|Sopotnia Mała| 201 |34-340 Jeleśnia;981;441;441;17;424;44.95;3.85
104491;241704;Środowiskowy Dom Samopomocy w Pewli Wielkiej|Pewel Wielka| 485 |34-340 Jeleśnia;1210;618;618;26;592;51.07;4.21
104492;241704;Filia Niepublicznej Szkoły Podstawowej w Krzyżówkach|Krzyżówki| 377 |34-335 Krzyżowa;202;88;88;2;86;43.56;2.27
104493;241704;Szkoła Podstawowa w Mutnem|Mutne| 59 |34-340 Jeleśnia;375;199;199;7;192;53.07;3.52
104494;241704;Zespół Szkół Nr 7 w Przyborowie|Przyborów| 187 |34-340 Jeleśnia;1336;666;666;37;629;49.85;5.56
104495;241704;Niepubliczna Szkoła Podstawowa w Koszarawie Bystrej|Koszarawa Bystra| 74 |34-332 Koszarawa;85;45;45;2;43;52.94;4.44
104496;241705;Zespół Gimanazjalno-Przedszkolny w Koszarawie|Koszarawa| 142 |34-332 Koszarawa;695;317;317;14;303;45.61;4.42
104497;241705;Zespół Gimnazjalno-Przedszkolny w Koszarawie|Koszarawa| 142 |34-332 Koszarawa;674;326;326;5;321;48.37;1.53
104498;241705;Zespół Szkolno-Przedszkolny w Koszarawie|Koszarawa| 434 |34-332 Koszarawa;523;258;258;14;244;49.33;5.43
104499;241705;Niepubliczna Szkoła Podstawowa Fundacji Królowej Świętej Jadwigi w Koszarawie Bystrej|Koszarawa| 675 |34-332 Koszarawa;166;87;87;3;84;52.41;3.45
104500;241706;Szkoła Podstawowa|Lipowa| 771 |34-324 Lipowa;2167;1145;1145;45;1100;52.84;3.93
104501;241706;Szkoła Podstawowa|Lipowa| 771 |34-324 Lipowa;1483;746;746;40;706;50.30;5.36
104502;241706;Szkoła Podstawowa|Leśna| 68 |34-300 Żywiec;1746;849;849;33;816;48.63;3.89
104503;241706;Szkoła Podstawowa|Twardorzeczka| 333 |34-324 Lipowa;1095;596;596;14;582;54.43;2.35
104504;241706;Szkoła Podstawowa|Sienna| 5 |34-300 Żywiec;768;399;399;18;381;51.95;4.51
104505;241706;Zespół Szkolno-Przedszkolny|Słotwina| 31 |34-324 Lipowa;635;366;366;8;358;57.64;2.19
104506;241706;Remiza OSP|Ostre| 137 |34-324 Lipowa;378;189;189;4;185;50.00;2.12
104507;241707;Sala Sesyjna w Urzędzie Gminy|Łękawica|ul. Wspólna 24 |34-321 Łękawica;1773;1004;1005;31;973;56.63;3.09
104508;241707;Szkoła Podstawowa w Kocierzu Moszczanickim|Kocierz Moszczanicki|ul. Beskidzka 56 |34-321 Łękawica;812;461;461;12;449;56.77;2.60
104509;241707;Budynek komunalny|Kocierz Rychwałdzki|ul. Turystyczna 17 |34-321 Łękawica;247;119;119;1;118;48.18;0.84
104510;241707;Szkoła Podstawowa w Okrajniku|Łękawica|ul. Żywiecka 82 |34-321 Łękawica;701;377;377;15;362;53.78;3.98
104511;241708;Zespół Szkół Ogólnokształcących|Łodygowice|Piłsudskiego 121 |34-325 Łodygowice;2168;1274;1274;35;1239;58.76;2.75
104512;241708;Gminny Ośrodek Kultury|Łodygowice|Plac Wolności 5 |34-325 Łodygowice;1431;890;890;17;873;62.19;1.91
104513;241708;Gminny Ośrodek Kultury|Łodygowice|Plac Wolności 5 |34-325 Łodygowice;2095;1191;1191;39;1152;56.85;3.27
104514;241708;Remiza OSP w Biernej|Bierna|Kopernika 34 |34-325 Łodygowice;808;397;397;12;385;49.13;3.02
104515;241708;Zespół Szkolno-Przedszkolny|Zarzecze|Staszica 8 |34-326 Zarzecze;1074;642;642;13;629;59.78;2.02
104516;241708;Zespół Szkół|Pietrzykowice|Kościuszki 120 |34-326 Pietrzykowice;1622;866;866;22;844;53.39;2.54
104517;241708;Remiza OSP|Pietrzykowice|Jana Pawła II 91 |34-326 Pietrzykowice;1983;1109;1109;28;1081;55.93;2.52
104518;241709;Szkoła Podstawowa Milówka|Milówka|ul. Dworcowa 3 |34-360 Milówka;2025;1125;1125;49;1076;55.56;4.36
104519;241709;Szkoła Podstawowa Milówka|Milówka|ul. Dworcowa 3 |34-360 Milówka;1581;895;895;29;866;56.61;3.24
104520;241709;Szkoła Podstawowa nr 2 w Kamesznicy|Kamesznica|ul. Sportowa 382 |34-383 Kamesznica;1104;535;535;32;503;48.46;5.98
104521;241709;Zespół Szkolno - Przedszkolny w Kamesznicy (SP nr 1)|Kamesznica|ul. Parkowa 70 |34-383 Kamesznica;1120;583;583;21;562;52.05;3.60
104522;241709;Szkoła Podstawowa w Szarem|Szare| 51 |34-383 Kamesznica;617;254;254;7;247;41.17;2.76
104523;241709;Szkoła Podstawowa w Nieledwi|Nieledwia|ul. Górska 297 |34-360 Milówka;774;271;271;11;260;35.01;4.06
104524;241709;Szkoła Podstawowa w Lalikach|Laliki| 365 |34-373 Zwardoń;798;328;328;11;317;41.10;3.35
104525;241710;Dom Wielofunkcyjny w Brzuśniku|Brzuśnik| 233 |34-382 Bystra;860;461;461;6;455;53.60;1.30
104526;241710;Dom Ludowy w Bystrej|Bystra| 13 |34-382 Bystra;758;405;405;11;394;53.43;2.72
104527;241710;Szkoła Podstawowa im. Franciszka Polaka w Juszczynie|Juszczyna| 275 |34-382 Bystra;1376;757;757;60;697;55.01;7.93
104528;241710;Dom Ludowy w Przybędzy|Przybędza|3 Maja 75 |34-381 Radziechowy;794;393;393;12;381;49.50;3.05
104529;241710;Strażnica OSP w Radziechowach|Radziechowy|Główna 23 |34-381 Radziechowy;1472;767;767;19;748;52.11;2.48
104530;241710;Przedszkole (góra) w Radziechowach|Radziechowy|Św. Marcina 740 |34-381 Radziechowy;2113;1047;1047;31;1016;49.55;2.96
104531;241710;Salka katechetyczna na plebanii w Wieprzu|Wieprz|Kościelna 680 |34-382 Bystra;1396;733;733;23;710;52.51;3.14
104532;241710;Szkoła Podstawowa im. Jana Klicha w Wieprzu|Wieprz|Szkolna 800 |34-382 Bystra;1570;744;744;21;723;47.39;2.82
104533;241711;Szkoła Podstawowa|Rajcza| 54a |34-370 Rajcza;352;171;171;5;166;48.58;2.92
104534;241711;Szkoła Podstawowa|Rajcza|Rynek 2 |34-370 Rajcza;1735;803;803;25;778;46.28;3.11
104535;241711;Szkoła Podstawowa|Rajcza|Rynek 2 |34-370 Rajcza;639;357;357;7;350;55.87;1.96
104536;241711;Szkoła Podstawowa|Rycerka Dolna| 134b |34-370 Rajcza;1174;517;517;15;502;44.04;2.90
104537;241711;Zespół Szkół|Rycerka Górna| 183 |34-370 Rajcza;1194;518;518;19;499;43.38;3.67
104538;241711;Szkoła Podstawowa|Sól| 111 |34-370 Rajcza;1010;466;466;8;458;46.14;1.72
104539;241711;Świetlica Środowiskowa|Sól-Kiczora| 297 |34-370 Rajcza;384;195;195;7;188;50.78;3.59
104540;241711;Zespół Szkół|Zwardoń| 2b |34-373 Zwardoń;702;273;273;14;259;38.89;5.13
104541;241711;Samodzielny Publiczny Zakład Opiekuńczo-Leczniczy w Rajczy|Rajcza|Ujsolska 35 |34-370 Rajcza;94;10;10;1;9;10.64;10.00
104542;241712;Gminny Ośrodek Kultury "Jemioła"|Ślemień|ul. Krakowska 124 |34-323 Ślemień;1683;970;970;27;943;57.64;2.78
104543;241712;Remiza Ochotniczej Straży Pożarnej|Kocoń|ul. Żywiecka 38 |34-323 Ślemień;559;313;313;14;299;55.99;4.47
104544;241712;Filia Szkoły Podstawowej|Las|ul. Zakopiańska 59 |34-323 Ślemień;653;358;358;10;348;54.82;2.79
104545;241713;Urząd Gminy|Świnna|ul. Wspólna 13 |34-331 Świnna;1590;865;865;38;827;54.40;4.39
104546;241713;Zespół Szkolno-Przedszkolny im. Jerzego Kukuczki|Pewel Mała|ul. Jana Pawła II 15 |34-331 Świnna;1204;674;674;21;653;55.98;3.12
104547;241713;Zespół Szkolno-Przedszkolny im. ks. Bronisława Markiewicza|Pewel Ślemieńska|ul. Krakowska 169 |34-331 Świnna;1246;639;639;34;605;51.28;5.32
104548;241713;Zespół Szkolno-Przedszkolny im. Janusza Korczaka|Trzebinia|ul. Beskidzka 158 |34-300 Żywiec;1382;747;747;32;715;54.05;4.28
104549;241713;REMIZA OSP W RYCHWAŁDKU|Rychwałdek|ul. Szkolna 19 |34-331 Świnna;683;366;366;7;359;53.59;1.91
104550;241713;REMIZA OSP W PRZYŁĘKOWIE|Przyłęków|ul. Wspólna 36 |34-331 Świnna;326;150;150;7;143;46.01;4.67
104551;241714;Szkoła Podstawowa|Złatna| 95 |34-371 Ujsoły;621;267;267;13;254;43.00;4.87
104552;241714;Szkoła Podstawowa|Glinka| 68 |34-371 Ujsoły;684;289;289;25;264;42.25;8.65
104553;241714;Szkoła Podstawowa|Soblówka| 191 |34-371 Ujsoły;531;253;253;12;241;47.65;4.74
104554;241714;Gimnazjum|Ujsoły|ul. Księdza Prałata Piotrowskiego 6 |34-371 Ujsoły;995;435;435;12;423;43.72;2.76
104555;241714;Gimnazjum|Ujsoły|ul. Księdza Prałata Piotrowskiego 6 |34-371 Ujsoły;919;452;452;12;440;49.18;2.65
104556;241715;Zespół Szkół Publicznych|Cisiec|ul. Szkolna 6 |34-350 Węgierska Górka;1267;696;696;25;671;54.93;3.59
104557;241715;Zespół Szkół Publicznych|Cisiec|ul. Szkolna 6 |34-350 Węgierska Górka;1367;798;798;22;776;58.38;2.76
104558;241715;Szkoła Podstawowa|Węgierska Górka|ul. Zielona 41 |34-350 Węgierska Górka;1722;1002;1002;31;971;58.19;3.09
104559;241715;OSP Węgierska Górka|Węgierska Górka|ul. Kościuszki 19 A|34-350 Węgierska Górka;1668;936;936;14;922;56.12;1.50
104560;241715;Szkoła Podstawowa|Żabnica|ul. Szkolna 6 |34-350 Węgierska Górka;906;426;426;8;418;47.02;1.88
104561;241715;Szkoła Podstawowa|Żabnica|ul. Szkolna 6 |34-350 Węgierska Górka;1586;800;800;32;768;50.44;4.00
104562;241715;Szkoła Podstawowa Nr 1|Cięcina|ul. Świetej Katarzyny 20 |34-350 Węgierska Górka;1776;1035;1035;33;1002;58.28;3.19
104563;241715;Szkoła Podstawowa Nr 1|Cięcina|ul. Świętej Katarzyny 20 |34-350 Węgierska Górka;1669;912;912;31;881;54.64;3.40
104564;246101;Gimnazjum Nr 14|Bielsko-Biała|ul. Mazańcowicka 34 |43-300 Bielsko-Biała;1909;1138;1138;14;1124;59.61;1.23
104565;246101;"AQUA" S.A. Oczyszczalnia Ścieków|Bielsko-Biała|ul. Bestwińska 63 |43-300 Bielsko-Biała;2203;1364;1364;17;1347;61.92;1.25
104566;246101;Przedszkole Nr 40|Bielsko-Biała|ul. Komorowicka 338 |43-300 Bielsko-Biała;2173;1261;1261;28;1233;58.03;2.22
104567;246101;Szkoła Podstawowa Nr 29|Bielsko-Biała|ul. Czereśniowa 20 |43-300 Bielsko-Biała;2137;1338;1338;15;1323;62.61;1.12
104568;246101;Dom Kultury w Hałcnowie|Bielsko-Biała|ul. Siostry M. Szewczyk 1 |43-300 Bielsko-Biała;2329;1408;1408;24;1384;60.46;1.70
104569;246101;Szkoła Podstawowa Nr 28|Bielsko-Biała|ul. Wyzwolenia 343 |43-300 Bielsko-Biała;2197;1325;1325;24;1301;60.31;1.81
104570;246101;Gimnazjum Nr 6|Bielsko-Biała|ul. Witosa 96 |43-300 Bielsko-Biała;2225;1231;1231;16;1215;55.33;1.30
104571;246101;Przedszkole Nr 5|Bielsko-Biała|ul. Montażowa 5 |43-300 Bielsko-Biała;2227;1308;1308;31;1277;58.73;2.37
104572;246101;Zespół Szkół Budowlanych|Bielsko-Biała|ul. Budowlanych 4 |43-300 Bielsko-Biała;1877;938;938;15;923;49.97;1.60
104573;246101;Liceum Ogólnokształcące im. M. Kopernika|Bielsko-Biała|ul. Listopadowa 70 |43-300 Bielsko-Biała;1723;976;976;12;964;56.65;1.23
104574;246101;Zespół Szkół Podstawowo-Gimnazjalny Nr 1|Bielsko-Biała|ul. Norwida 30 |43-300 Bielsko-Biała;1733;981;981;16;965;56.61;1.63
104575;246101;Przedszkole Nr 4|Bielsko-Biała|ul. Kazimierza Wielkiego 12 |43-300 Bielsko-Biała;1673;917;917;17;900;54.81;1.85
104576;246101;Zespół Szkół Podstawowo-Gimnazjalny Nr 1|Bielsko-Biała|ul. Norwida 30 |43-300 Bielsko-Biała;1860;1110;1110;19;1091;59.68;1.71
104577;246101;Sala Klubu Sportowego GWARDIA|Bielsko-Biała|ul. Jaskrowa 13 |43-300 Bielsko-Biała;2121;1013;1013;17;996;47.76;1.68
104578;246101;Siedziba Rady Osiedla ''Wapienica''|Bielsko-Biała|ul. Cieszyńska 388 |43-300 Bielsko-Biała;2242;1320;1320;22;1298;58.88;1.67
104579;246101;Szkoła Podstawowa Nr 32|Bielsko-Biała|ul. Cieszyńska 393 |43-300 Bielsko-Biała;2008;1204;1204;19;1185;59.96;1.58
104580;246101;Biuro Nadleśnictwa|Bielsko-Biała|ul. Kopytko 13 |43-300 Bielsko-Biała;2269;1441;1441;22;1419;63.51;1.53
104581;246101;NZOZ Przychodnia Lekarska ''IKAR" sp. z o.o.|Bielsko-Biała|ul. Ikara 6 |43-300 Bielsko-Biała;1326;808;808;8;800;60.94;0.99
104582;246101;Siedziba Rady Osiedla ''Polskich Skrzydeł"|Bielsko-Biała|ul. Ikara 2 |43-300 Bielsko-Biała;1316;825;825;9;816;62.69;1.09
104583;246101;Szkoła Podstawowa Nr 1|Bielsko-Biała|ul. Dywizji Kościuszkowskiej 2 |43-300 Bielsko-Biała;2024;1197;1197;12;1185;59.14;1.00
104584;246101;Szkoła Podstawowa Nr 1|Bielsko-Biała|ul. Dywizji Kościuszkowskiej 2 |43-300 Bielsko-Biała;2246;1322;1322;21;1301;58.86;1.59
104585;246101;Szkoła Podstawowa Nr 6|Bielsko-Biała|ul. Brodzińskiego 3 |43-300 Bielsko-Biała;1926;1010;1010;17;993;52.44;1.68
104586;246101;Gimnazjum Nr 13|Bielsko-Biała|ul. Bratków 6 |43-300 Bielsko-Biała;2118;1269;1269;23;1246;59.92;1.81
104587;246101;Środowiskowe Centrum Pomocy Klub Samopomocy|Bielsko-Biała|ul. Piastowska 86 |43-300 Bielsko-Biała;1898;1114;1114;21;1093;58.69;1.89
104588;246101;Gimnazjum Nr 16|Bielsko-Biała|ul. Asnyka 30 |43-300 Bielsko-Biała;1336;805;805;8;797;60.25;0.99
104589;246101;Siedziba Rady Osiedla "Stare Bielsko"|Bielsko-Biała|ul. Sobieskiego 307A |43-300 Bielsko-Biała;1670;1088;1088;20;1068;65.15;1.84
104590;246101;Szkoła Podstawowa Nr 31|Bielsko-Biała|ul. Zapłocie Duże 1 |43-300 Bielsko-Biała;1850;1168;1168;13;1155;63.14;1.11
104591;246101;Zespół Szkół Samochodowych i Ogólnokształcących|Bielsko-Biała|ul. Filarowa 52 |43-300 Bielsko-Biała;1656;1048;1048;11;1037;63.29;1.05
104592;246101;Zespół Szkół Ekonomicznych im. M. Kaleckiego|Bielsko-Biała|ul. Komorowicka 27 |43-300 Bielsko-Biała;1182;532;532;13;519;45.01;2.44
104593;246101;NZOZ Przychodnia "Trójka" S.C.|Bielsko-Biała|ul. Staszica 1 |43-300 Bielsko-Biała;1615;692;692;23;669;42.85;3.32
104594;246101;Gimnazjum Nr 11|Bielsko-Biała|ul. Plater 3 |43-300 Bielsko-Biała;1998;1195;1195;18;1177;59.81;1.51
104595;246101;Zespół Szkół Gastronomicznych i Handlowych|Bielsko-Biała|ul. Wyspiańskiego 5 |43-300 Bielsko-Biała;1927;1064;1064;16;1048;55.22;1.50
104596;246101;Zespół Szkół Gastronomicznych i Handlowych|Bielsko-Biała|ul. Sobieskiego 15 |43-300 Bielsko-Biała;1842;921;936;0;921;50.00;0.00
104597;246101;Zespół Szkół Elektronicznych, Elektrycznych i Mechanicznych im. J. Śniadeckiego|Bielsko-Biała|ul. Słowackiego 24 |43-300 Bielsko-Biała;1959;894;894;21;873;45.64;2.35
104598;246101;Dom Kultury "Włókniarzy"|Bielsko-Biała|ul. 1 Maja 12 |43-300 Bielsko-Biała;1704;979;979;17;962;57.45;1.74
104599;246101;Urząd Miejski w Bielsku-Białej|Bielsko-Biała|plac Ratuszowy 6 |43-300 Bielsko-Biała;2124;1319;1319;20;1299;62.10;1.52
104600;246101;Zespół Szkół Ogrodniczych|Bielsko-Biała|ul. Akademii Umiejętności 1 |43-300 Bielsko-Biała;1683;976;976;15;961;57.99;1.54
104601;246101;Środowiskowe Centrum Pomocy Klub Samopomocy|Bielsko-Biała|ul. Milusińskich 6 |43-300 Bielsko-Biała;1825;1055;1055;17;1038;57.81;1.61
104602;246101;Szkoła Podstawowa Nr 27|Bielsko-Biała|ul. Kossak-Szczuckiej 19 |43-300 Bielsko-Biała;1774;1147;1147;16;1131;64.66;1.39
104603;246101;Szkoła Podstawowa Nr 27|Bielsko-Biała|ul. Kossak-Szczuckiej 19 |43-300 Bielsko-Biała;1731;976;976;7;969;56.38;0.72
104604;246101;Zespół Szkół Technicznych i Handlowych|Bielsko-Biała|ul. Lompy 11 |43-300 Bielsko-Biała;1644;866;866;1;865;52.68;0.12
104605;246101;Przedszkole nr 38|Bielsko-Biała|ul. Grażyny 19 |43-300 Bielsko-Biała;2053;1102;1102;19;1083;53.68;1.72
104606;246101;Powiatowy Urząd Pracy|Bielsko-Biała|ul. Partyzantów 55 |43-300 Bielsko-Biała;1836;934;934;12;922;50.87;1.28
104607;246101;Bielska Szkoła Rzemiosł|Bielsko-Biała|ul. Gorkiego 7 |43-300 Bielsko-Biała;1750;1054;1054;10;1044;60.23;0.95
104608;246101;Szkoła Podstawowa Nr 20|Bielsko-Biała|ul. Lenartowicza 17 |43-300 Bielsko-Biała;1607;986;986;21;965;61.36;2.13
104609;246101;Przedszkole Integracyjne Nr 2|Bielsko-Biała|ul. Łagodna 16 |43-300 Bielsko-Biała;1600;1004;1004;12;992;62.75;1.20
104610;246101;Szkola Podstawowa Nr 33|Bielsko-Biała|ul. Łagodna 26 |43-300 Bielsko-Biała;1724;1088;1088;12;1076;63.11;1.10
104611;246101;Przedszkole Nr 50|Bielsko-Biała|ul. Łagodna 27a |43-300 Bielsko-Biała;1756;1078;1078;16;1062;61.39;1.48
104612;246101;Zespół Szkół Ogólnokształcących|Bielsko-Biała|ul. Jutrzenki 13 |43-300 Bielsko-Biała;1606;988;988;14;974;61.52;1.42
104613;246101;Zespół Szkół Ogólnokształcących|Bielsko-Biała|ul. Jutrzenki 13 |43-300 Bielsko-Biała;2196;1450;1450;8;1442;66.03;0.55
104614;246101;Szkoła Podstawowa Nr 13|Bielsko-Biała|ul. Lipnicka 226 |43-300 Bielsko-Biała;1406;892;892;6;886;63.44;0.67
104615;246101;Miejski Dom Kultury|Bielsko-Biała|ul. Podgórna 29 |43-300 Bielsko-Biała;1444;863;863;15;848;59.76;1.74
104616;246101;Miejski Dom Kultury|Bielsko-Biała|ul. Podgórna 29 |43-300 Bielsko-Biała;2005;1416;1416;24;1392;70.62;1.69
104617;246101;Przedszkole nr 24|Bielsko-Biała|ul. Sempołowskiej 52 |43-300 Bielsko-Biała;1551;891;891;11;880;57.45;1.23
104618;246101;Gimnazjum Nr 1|Bielsko-Biała|ul. Straconki 25 |43-300 Bielsko-Biała;1707;1043;1043;8;1035;61.10;0.77
104619;246101;Przedszkole Nr 6|Bielsko-Biała|ul. Góralska 4 |43-300 Bielsko-Biała;1732;1083;1083;7;1076;62.53;0.65
104620;246101;Miejski Dom Kultury|Bielsko-Biała|ul. Żywiecka 302 |43-300 Bielsko-Biała;2280;1405;1405;14;1391;61.62;1.00
104621;246101;Szkoła Podstawowa Nr 26|Bielsko-Biała|ul. Złoty Potok 7 |43-300 Bielsko-Biała;1864;1259;1259;20;1239;67.54;1.59
104622;246101;Szkoła Podstawowa Nr 26|Bielsko-Biała|ul. Złoty Potok 7 |43-300 Bielsko-Biała;869;552;552;5;547;63.52;0.91
104623;246101;Siedziba Rady Osiedla Aleksandrowice|Bielsko-Biała|ul. Wrzosowa 20 |43-300 Bielsko-Biała;1476;951;951;3;948;64.43;0.32
104624;246101;Zespół Szkół Ogólnokształcących im. Armii Krajowej|Bielsko-Biała|ul. Sternicza 4 |43-300 Bielsko-Biała;2178;1353;1353;12;1341;62.12;0.89
104625;246101;Przedszkole Nr 55|Bielsko-Biała|ul. Sternicza 4 |43-300 Bielsko-Biała;2006;1227;1227;22;1205;61.17;1.79
104626;246101;Środowiskowe Centrum Pomocy Dom Dziennego Pobytu|Bielsko-Biała|ul. Sternicza 8a |43-300 Bielsko-Biała;2204;1251;1251;38;1213;56.76;3.04
104627;246101;Szkoła Podstawowa nr 37|Bielsko-Biała|ul. Doliny Miętusiej 5 |43-300 Bielsko-Biała;2194;1405;1405;21;1384;64.04;1.49
104628;246101;Szkoła Podstawowa nr 37|Bielsko-Biała|ul. Doliny Miętusiej 5 |43-300 Bielsko-Biała;1973;1243;1243;7;1236;63.00;0.56
104629;246101;Szkoła Podstawowa nr 37|Bielsko-Biała|ul. Doliny Miętusiej 5 |43-300 Bielsko-Biała;1941;1198;1198;12;1186;61.72;1.00
104630;246101;Szkoła Podstawowa nr 37|Bielsko-Biała|ul. Doliny Miętusiej 5 |43-300 Bielsko-Biała;1970;1231;1231;7;1224;62.49;0.57
104631;246101;Siedziba Rady Osiedla "Kamienica"|Bielsko-Biała|ul. Karpacka 119 |43-300 Bielsko-Biała;1472;971;971;4;967;65.96;0.41
104632;246101;ZIAD Bielsko-Biała S.A.|Bielsko-Biała|Al. Armii Krajowej 220 |43-300 Bielsko-Biała;1666;1025;1025;5;1020;61.52;0.49
104633;246101;Sala gimnastyczna Zespołu Szkół Podstwawo-Gimnazjalnym|Bielsko-Biała|ul. Karpacka 127 |43-300 Bielsko-Biała;1501;1043;1043;7;1036;69.49;0.67
104634;246101;Dom Kultury "Mikuszowice Ślaskie"|Bielsko-Biała|ul. Olszówka 20 |43-300 Bielsko-Biała;2107;1264;1264;9;1255;59.99;0.71
104635;246101;Szkoła Podstawowa Nr 25|Bielsko-Biała|ul. Pocztowa 28a |43-300 Bielsko-Biała;2038;1229;1229;11;1218;60.30;0.90
104636;246101;Akademia Techniczno-Humanistyczna|Bielsko-Biała|ul. Willowa 2- Budynek B-27 |43-300 Bielsko-Biała;1915;1180;1180;16;1164;61.62;1.36
104637;246101;Dom Pomocy Społecznej dla Osób Starszych|Bielsko-Biała|Żywiecka 15 |43-300 Bielsko-Biała;52;45;45;2;43;86.54;4.44
104638;246101;Areszt Śledczy|Bielsko-Biała|Słowackiego 15a |43-300 Bielsko-Biała;197;120;120;7;113;60.91;5.83
104639;246101;Beskidzkie Centrum Onkologii im. Jana Pawła II - Szpital Miejski|Bielsko-Biała|Wyspiańskiego 21 |43-300 Bielsko-Biała;162;71;71;3;68;43.83;4.23
104640;246101;Beskidzkie Centrum Onkologii im. Jana Pawła II - Szpital Miejski|Bielsko-Biała|Wyzwolenia 18 |43-300 Bielsko-Biała;92;55;55;3;52;59.78;5.45
104641;246101;Beskidzkie Centrum Onkologii im. Jana Pawła II - Szpital Miejski|Bielsko-Biała|E. Plater 17 |43-300 Bielsko-Biała;59;14;14;0;14;23.73;0.00
104642;246101;Szpital Wojewódzki|Bielsko-Biała|Armii Krajowej 101 |43-300 Bielsko-Biała;444;234;234;10;224;52.70;4.27
104643;246101;Dom Pomocy Społecznej "Dom Nauczyciela"|Bielsko-Biała|Pocztowa 14a |43-300 Bielsko-Biała;90;63;63;3;60;70.00;4.76
104644;246201;Szkoła Podstawowa Nr 33|Bytom|ul. Matki Ewy 9 |41-923 Bytom;2057;982;982;14;968;47.74;1.43
104645;246201;Szkoła Podstawowa Nr 33|Bytom|ul. Matki Ewy 9 |41-923 Bytom;2300;1011;1011;29;982;43.96;2.87
104646;246201;Szkoła Podstawowa Nr 33|Bytom|ul. Matki Ewy 9 |41-923 Bytom;1965;702;702;18;684;35.73;2.56
104647;246201;Szkoła Podstawowa Nr 54|Bytom|ul. Reptowska 86 |41-923 Bytom;2120;1170;1170;14;1156;55.19;1.20
104648;246201;Szkoła Podstawowa Nr 54|Bytom|ul. Reptowska 86 |41-923 Bytom;2276;1165;1165;26;1139;51.19;2.23
104649;246201;Dom Pomocy Społecznej "KOMBATANT"|Bytom|ul. Stolarzowicka 33 |41-923 Bytom;2189;1305;1305;19;1286;59.62;1.46
104650;246201;Zespół Szkół Ogólnokształcących Nr 5|Bytom|ul. Nickla 19 |41-923 Bytom;1995;1006;1006;14;992;50.43;1.39
104651;246201;Zespół Szkół Ogólnokształcących Nr 5|Bytom|ul. Nickla 19 |41-923 Bytom;2055;1188;1188;20;1168;57.81;1.68
104652;246201;Zespół Szkół Ogólnokształcących Nr 5|Bytom|ul. Nickla 19 |41-923 Bytom;1685;970;970;7;963;57.57;0.72
104653;246201;Szkoła Podstawowa Nr 21|Bytom|ul. Racławicka 17 |41-906 Bytom;1297;287;287;29;258;22.13;10.10
104654;246201;Młodzieżowy Dom Kultury Nr 2|Bytom|ul. Popiełuszki 9 |41-906 Bytom;1687;769;769;22;747;45.58;2.86
104655;246201;Gimnazjum Nr 8|Bytom|ul. Worpie 14-16 |41-906 Bytom;1934;936;936;19;917;48.40;2.03
104656;246201;Szkoła Podstawowa Nr 16|Bytom|ul. Rataja 3 |41-906 Bytom;1520;461;461;16;445;30.33;3.47
104657;246201;Zespół Szkół Specjalnych Nr 3|Bytom|ul. Konstytucji 20-22 |41-905 Bytom;1838;303;303;25;278;16.49;8.25
104658;246201;Szkoła Podstawowa Nr 44|Bytom|ul. Grota-Roweckiego 6 |41-907 Bytom;1985;791;791;24;767;39.85;3.03
104659;246201;Szkoła Podstawowa Nr 44|Bytom|ul. Grota-Roweckiego 6 |41-907 Bytom;2149;1055;1055;20;1035;49.09;1.90
104660;246201;Szkoła Podstawowa Nr 44|Bytom|ul. Grota-Roweckiego 6 |41-907 Bytom;1929;1001;1001;20;981;51.89;2.00
104661;246201;Zespół Szkół Technicznych i Ogólnokształcących|Bytom|ul. Frycza Modrzewskiego 5 |41-907 Bytom;1890;709;709;17;692;37.51;2.40
104662;246201;Szkoła Podstawowa Nr 45|Bytom|ul. Zakątek 20 |41-907 Bytom;2082;1033;1033;23;1010;49.62;2.23
104663;246201;Szkoła Podstawowa Nr 45|Bytom|ul. Zakątek 20 |41-907 Bytom;1808;802;802;14;788;44.36;1.75
104664;246201;Gimnazjum Nr 7|Bytom|ul. Karpacka 27 |41-907 Bytom;1868;998;998;6;992;53.43;0.60
104665;246201;Gimnazjum Nr 7|Bytom|ul. Karpacka 27 |41-907 Bytom;2072;1090;1090;21;1069;52.61;1.93
104666;246201;Zespół Ogólnokształcących Szkół Społecznych|Bytom|ul. Skrajna 14a |41-907 Bytom;2265;1142;1142;20;1122;50.42;1.75
104667;246201;Gimnazjum Nr 9|Bytom|ul. Świętochłowicka 12 |41-909 Bytom;2170;875;875;26;849;40.32;2.97
104668;246201;Szkoła Podstawowa Nr 28|Bytom|ul. Armii Krajowej 40 |41-909 Bytom;2145;821;821;36;785;38.28;4.38
104669;246201;Szkoła Podstawowa Nr 28|Bytom|ul. Armii Krajowej 40 |41-909 Bytom;2164;1159;1159;20;1139;53.56;1.73
104670;246201;Ochotnicza Straż Pożarna w Górnikach|Bytom|ul. Żołnierska 41 |41-936 Bytom;804;319;319;5;314;39.68;1.57
104671;246201;Szkoła Podstawowa Nr 43|Bytom|ul. Suchogórska 98 |41-936 Bytom;1272;557;557;16;541;43.79;2.87
104672;246201;Placówka Opiekuńczo-Wychowawcza "Szansa dla Dziecka"|Bytom|Plac Jana 13 |41-936 Bytom;1457;712;712;13;699;48.87;1.83
104673;246201;Szkoła Podstawowa Nr 38|Bytom|ul. Korczaka 1 |41-935 Bytom;1365;758;758;11;747;55.53;1.45
104674;246201;Szkoła Podstawowa Nr 38|Bytom|ul. Korczaka 1 |41-935 Bytom;1200;680;680;14;666;56.67;2.06
104675;246201;Gimnazjum Nr 11|Bytom|ul. Tysiąclecia 7 |41-933 Bytom;2002;1014;1014;21;993;50.65;2.07
104676;246201;Gimnazjum Nr 11|Bytom|ul. Tysiąclecia 7 |41-933 Bytom;0;0;0;0;0;-99;-99
104677;246201;Szkoła Podstawowa Nr 23|Bytom|ul. Wojciechowskiego 6 |41-933 Bytom;2081;965;965;23;942;46.37;2.38
104678;246201;Szkoła Podstawowa Nr 37|Bytom|ul. Narutowicza 9 |41-933 Bytom;1954;887;887;26;861;45.39;2.93
104679;246201;Szkoła Podstawowa Nr 37|Bytom|ul. Narutowicza 9 |41-933 Bytom;1999;832;832;22;810;41.62;2.64
104680;246201;Zespół Szkół Ogólnokształcących Nr 11|Bytom|ul. Szymały 124 |41-933 Bytom;2136;1222;1222;25;1197;57.21;2.05
104681;246201;Zespół Szkół Ogólnokształcących Nr 11|Bytom|ul. Szymały 124 |41-933 Bytom;1932;1105;1105;12;1093;57.19;1.09
104682;246201;Zespół Szkół Ogólnokształcących Nr 11|Bytom|ul. Szymały 124 |41-933 Bytom;1766;955;955;15;940;54.08;1.57
104683;246201;Spółdzielnia Mieszkaniowa "Nasz Dom"|Bytom|ul. Szymały 126 |41-933 Bytom;1586;649;649;22;627;40.92;3.39
104684;246201;Państwowe Szkoły Budownictwa - Zespół Szkół|Bytom|ul. Powstańców Śląskich 10 |41-902 Bytom;2199;979;979;21;958;44.52;2.15
104685;246201;Zespół Szkół Mistrzostwa Sportowego|Bytom|ul. Powstańców Śląskich 2 |41-902 Bytom;2057;960;960;35;925;46.67;3.65
104686;246201;Zespół Szkół Specjalnych Nr 6|Bytom|ul. Orląt Lwowskich 12b |41-902 Bytom;1957;943;943;27;916;48.19;2.86
104687;246201;Szkoła Podstawowa Nr 46|Bytom|ul. Prusa 10 |41-902 Bytom;1839;813;813;20;793;44.21;2.46
104688;246201;Szkoła Podstawowa Nr 46|Bytom|ul. Prusa 10 |41-902 Bytom;1848;800;800;16;784;43.29;2.00
104689;246201;Zespół Szkół Gastronomiczno-Hotelarskich|Bytom|ul. Żeromskiego 26 |41-902 Bytom;1314;589;589;13;576;44.82;2.21
104690;246201;Szkoła Podstawowa Nr 9|Bytom|ul. Matejki 15 |41-902 Bytom;1826;864;864;18;846;47.32;2.08
104691;246201;Szkoła Podstawowa Nr 9|Bytom|ul. Matejki 15 |41-902 Bytom;1829;688;688;18;670;37.62;2.62
104692;246201;Szkoła Podstawowa Nr 6|Bytom|ul. Królowej Jadwigi 2 |41-902 Bytom;1583;589;589;13;576;37.21;2.21
104693;246201;Szkoła Podstawowa Nr 6|Bytom|ul. Królowej Jadwigi 2 |41-902 Bytom;1628;533;533;21;512;32.74;3.94
104694;246201;Technikum Nr 4|Bytom|ul. Katowicka /wejście od Placu Klasztornego/ 35 |41-902 Bytom;1416;456;456;9;447;32.20;1.97
104695;246201;Technikum Nr 4|Bytom|ul. Katowicka /wejście od Placu Klasztornego/ 35 |41-902 Bytom;1448;566;566;14;552;39.09;2.47
104696;246201;Przedszkole Miejskie Nr 14|Bytom|ul. Prokopa 3 |41-902 Bytom;1790;935;935;27;908;52.23;2.89
104697;246201;Regionalny Ośroderk Metodyczno-Edukacyjny METIS|Bytom|ul. Chorzowska 22 |41-902 Bytom;1859;883;883;16;867;47.50;1.81
104698;246201;Zespół Szkół Nr 1|Bytom|ul. Arki Bożka 21 |41-902 Bytom;1795;1063;1063;16;1047;59.22;1.51
104699;246201;Szkoła Podstawowa Nr 51 z Oddziałami Integracyjnymi|Bytom|ul. Łużycka 12a |41-902 Bytom;2169;1204;1204;16;1188;55.51;1.33
104700;246201;Szkoła Podstawowa Nr 51 z Oddziałami Integracyjnymi|Bytom|ul. Łużycka 12a |41-902 Bytom;2144;1223;1223;17;1206;57.04;1.39
104701;246201;Urząd Skarbowy|Bytom|ul. Wrocławska 92 |41-902 Bytom;2288;1154;1154;23;1131;50.44;1.99
104702;246201;Zespół Szkół Ogólnokształcących Nr 7|Bytom|ul. Siemiradzkiego 9 |41-902 Bytom;1931;855;855;27;828;44.28;3.16
104703;246201;Zespół Szkół Ogólnokształcących Nr 7|Bytom|ul. Siemiradzkiego 9 |41-902 Bytom;1784;790;790;25;765;44.28;3.16
104704;246201;Zespół Szkół Ogólnokształcących Nr 7|Bytom|ul. Siemiradzkiego 9 |41-902 Bytom;1888;1004;1004;12;992;53.18;1.20
104705;246201;Szkoła Podstawowa Nr 5|Bytom|Aleja Legionów 6 |41-902 Bytom;1729;764;764;12;752;44.19;1.57
104706;246201;Szkoła Podstawowa Nr 5|Bytom|Aleja Legionów 6 |41-902 Bytom;1886;661;661;23;638;35.05;3.48
104707;246201;Gimnazjum Nr 1 z Oddziałami Integracyjnymi|Bytom|ul. Tarnogórska 2 |41-902 Bytom;1637;793;793;10;783;48.44;1.26
104708;246201;I Liceum Ogólnokształcące|Bytom|ul. Strzelców Bytomskich 11 |41-902 Bytom;1702;693;693;28;665;40.72;4.04
104709;246201;Zakład Budynków Miejskich Sp. z o.o.|Bytom|ul. Kolejowa 2a |41-902 Bytom;1852;941;941;12;929;50.81;1.28
104710;246201;Ogólnokształcąca Szkoła Muzyczna|Bytom|ul. Moniuszki 17 |41-902 Bytom;1832;793;793;30;763;43.29;3.78
104711;246201;IV Liceum Ogólnokształcące|Bytom|Plac Sikorskiego 1 |41-902 Bytom;1027;450;450;11;439;43.82;2.44
104712;246201;Szkoła Podstawowa Nr 3|Bytom|ul. Strażacka 2 |41-902 Bytom;1456;606;606;15;591;41.62;2.48
104713;246201;DOM POMOCY SPOŁECZNEJ EWANGELICKI DOM OPIEKI "OSTOJA POKOJU"|Bytom|ul. Matki Ewy 1 |41-923 Bytom;79;34;34;2;32;43.04;5.88
104714;246201;MIEJSKI OŚRODEK OPIEKUŃCZY|Bytom|pl. Szpitalny 1 |41-923 Bytom;62;5;5;1;4;8.06;20.00
104715;246201;DOM POMOCY SPOŁECZNEJ STOWARZYSZENIA "POMOCNA DŁOŃ", DOM SENIORA "DOLOMITY"|Bytom|Strzelców Bytomskich 450 |41-935 Bytom;102;35;35;6;29;34.31;17.14
104716;246201;CENTRUM POMOCY PW. DUCHA ŚWIĘTEGO|Bytom|Krakowska 30 |41-902 Bytom;69;37;37;1;36;53.62;2.70
104717;246201;SZPITAL SPECJALISTYCZNY NR 1|Bytom|Żeromskiego 7 |41-902 Bytom;115;49;49;2;47;42.61;4.08
104718;246201;SZPITAL SPECJALISTYCZNY NR 1 /BUDYNEK ALEJA LEGIONÓW 49/|Bytom|Żeromskiego 7 |41-902 Bytom;99;21;21;0;21;21.21;0.00
104719;246201;SZPITAL SPECJALISTYCZNY NR 2|Bytom|Batorego 15 |41-902 Bytom;207;99;99;5;94;47.83;5.05
104720;246201;WOJEWÓDZKI SZPITAL SPECJALISTYCZNY NR 4|Bytom|al. Legionów 10 |41-902 Bytom;257;97;97;8;89;37.74;8.25
104721;246201;ARESZT ŚLEDCZY|Bytom|Wrocławska 4 |41-902 Bytom;229;111;111;12;99;48.47;10.81
104722;246201;DOM POMOCY SPOŁECZNEJ DLA DOROSŁYCH|Bytom|Dworcowa 7 |41-902 Bytom;100;51;51;4;47;51.00;7.84
104723;246201;ZAKŁAD OPIEKUŃCZO-LECZNICZY DLA PRZEWLEKLE CHORYCH ZGROMADZENIA SŁUŻEBNIC N.S.J.|Bytom|Piekarska 59 |41-902 Bytom;66;26;26;0;26;39.39;0.00
104724;246301;Szkoła Podstawowa Nr 25|Chorzów|ul. Główna 21 |41-503 Chorzów;1796;841;841;15;826;46.83;1.78
104725;246301;Szkoła Podstawowa Nr 24|Chorzów|ul. 17 Sierpnia 1 |41-503 Chorzów;949;433;433;15;418;45.63;3.46
104726;246301;Zespół Szkół Ogólnokształcących Nr 2|Chorzów|ul. Harcerska 2 |41-503 Chorzów;2026;950;950;13;937;46.89;1.37
104727;246301;Szkoła Podstawowa Nr 29|Chorzów|ul. Lwowska 36 |41-500 Chorzów;1720;879;879;12;867;51.10;1.37
104728;246301;Gimnazjum Nr 5|Chorzów|ul. 11 Listopada 21 |41-500 Chorzów;1503;552;552;18;534;36.73;3.26
104729;246301;Gimnazjum Nr 5|Chorzów|ul. 11 Listopada 21 |41-500 Chorzów;1581;888;888;12;876;56.17;1.35
104730;246301;Gimnazjum Nr 5|Chorzów|ul. 11 Listopada 21 |41-500 Chorzów;1600;785;785;24;761;49.06;3.06
104731;246301;Szkoła Podstawowa Nr 17|Chorzów|ul. Łagiewnicka 18 |41-500 Chorzów;1429;507;507;20;487;35.48;3.94
104732;246301;Szkoła Podstawowa Nr 17|Chorzów|ul. Łagiewnicka 18 |41-500 Chorzów;1580;940;941;11;929;59.49;1.17
104733;246301;Szkoła Podstawowa Nr 17|Chorzów|ul. Łagiewnicka 18 |41-500 Chorzów;1452;794;794;22;772;54.68;2.77
104734;246301;Zespół Szkół Technicznych i Ogólnokształcących Nr 4|Chorzów|ul. Św. Piotra 1 |41-500 Chorzów;1892;748;748;35;713;39.53;4.68
104735;246301;Zespół Szkół Nr 3|Chorzów|ul. 3 Maja 16 |41-500 Chorzów;1702;622;622;17;605;36.55;2.73
104736;246301;Zespół Szkół Nr 3|Chorzów|ul. 3 Maja 16 |41-500 Chorzów;1914;891;891;20;871;46.55;2.24
104737;246301;Szkoła Podstawowa Nr 15|Chorzów|ul. 3 Maja 78 |41-500 Chorzów;1771;868;868;18;850;49.01;2.07
104738;246301;Gimnazjum Nr 4|Chorzów|ul. Śląska 3 |41-500 Chorzów;2067;1024;1024;39;985;49.54;3.81
104739;246301;Gimnazjum Nr 4|Chorzów|ul. Śląska 3 |41-500 Chorzów;1870;1043;1043;23;1020;55.78;2.21
104740;246301;Gimnazjum Nr 4|Chorzów|ul. Śląska 3 |41-500 Chorzów;2041;1211;1211;20;1191;59.33;1.65
104741;246301;Szkoła Podstawowa Nr 13|Chorzów|ul. Dr Wincentego Styczyńskiego 32 |41-500 Chorzów;2002;840;840;21;819;41.96;2.50
104742;246301;Szkoła Podstawowa Nr 13|Chorzów|ul. Dr Wincentego Styczyńskiego 32 |41-500 Chorzów;1962;992;992;20;972;50.56;2.02
104743;246301;Gimnazjum nr 1|Chorzów|ul. gen.H. Dąbrowskiego 53 |41-500 Chorzów;1475;752;752;10;742;50.98;1.33
104744;246301;Szkoła Podstawowa Nr 1|Chorzów|ul. Gen. Henryka Dąbrowskiego 41 |41-500 Chorzów;938;337;337;13;324;35.93;3.86
104745;246301;Szkoła Podstawowa Nr 1|Chorzów|ul. Gen. Henryka Dąbrowskiego 41 |41-500 Chorzów;1377;833;833;17;816;60.49;2.04
104746;246301;Zespól Szkół Technicznych Nr 2|Chorzów|ul. Powstańców 6a |41-500 Chorzów;1265;437;437;10;427;34.55;2.29
104747;246301;Zespół Szkół Technicznych Nr 2|Chorzów|ul. Powstańców 6a |41-500 Chorzów;1059;468;468;6;462;44.19;1.28
104748;246301;Zespół Szkół Technicznych Nr 2|Chorzów|ul. Powstańców 6a |41-500 Chorzów;1079;549;549;5;544;50.88;0.91
104749;246301;Zespół Szkół Ekonomicznych im. Oskara Langego|Chorzów|ul. Ludwika Urbanowicza 2 |41-500 Chorzów;1621;853;853;18;835;52.62;2.11
104750;246301;Zespół Szkół Ekonomicznych im. Oskara Langego|Chorzów|ul. Ludwika Urbanowicza 2 |41-500 Chorzów;1897;1145;1145;20;1125;60.36;1.75
104751;246301;Zespół Szkół Gastronomiczno-Usługowych|Chorzów|ul. Katowicka 64 |41-500 Chorzów;1793;841;841;18;823;46.90;2.14
104752;246301;Szkoła Podstawowa Nr 29|Chorzów|ul. Lwowska 36 |41-500 Chorzów;1763;946;946;21;925;53.66;2.22
104753;246301;Zespół Szkół Sportowych Nr 1|Chorzów|ul. Ryszki 55 |41-500 Chorzów;1614;899;899;7;892;55.70;0.78
104754;246301;Zespół Szkół Sportowych Nr 1|Chorzów|ul. Ryszki 55 |41-500 Chorzów;1668;1070;1070;14;1056;64.15;1.31
104755;246301;Klub Młodzieżowy Ch.S.M.|Chorzów|ul. Młodzieżowa 29 |41-500 Chorzów;1509;1027;1027;13;1014;68.06;1.27
104756;246301;Klub Młodzieżowy Ch. S.M|Chorzów|ul. Młodzieżowa 29 |41-500 Chorzów;1427;810;810;11;799;56.76;1.36
104757;246301;Zespół Szkół Technicznych i Ogólnokształcących Nr 1|Chorzów|ul. Sportowa 23 |41-500 Chorzów;1540;905;905;5;900;58.77;0.55
104758;246301;Zespół Szkół Sportowych Nr 2|Chorzów|ul. Wolności 133 |41-500 Chorzów;1765;720;720;19;701;40.79;2.64
104759;246301;Zespół Szkół Sportowych Nr 2|Chorzów|ul. Wolności 133 |41-500 Chorzów;1761;751;751;9;742;42.65;1.20
104760;246301;Chorzowski Centrum Wspierania Organizacji Pozarządowych|Chorzów|ul. Powstańców 70/3 |41-500 Chorzów;1432;751;751;7;744;52.44;0.93
104761;246301;Chorzowski Centrum Wspierania Organizacji Pozarządowych|Chorzów|ul. Powstańców 70/3 |41-500 Chorzów;1279;480;480;10;470;37.53;2.08
104762;246301;Szkoła Podstawowa Nr 37|Chorzów|ul. Ratuszowa 20 |41-506 Chorzów;1444;670;670;25;645;46.40;3.73
104763;246301;Szkoła Podstawowa Nr 37|Chorzów|ul. Ratuszowa 20 |41-506 Chorzów;1506;491;491;12;479;32.60;2.44
104764;246301;Szkoła Podstawowa Nr 37|Chorzów|ul. Ratuszowa 20 |41-506 Chorzów;1638;967;967;6;961;59.04;0.62
104765;246301;Zespól Szkół Nr 2 im. J.Brzechwy|Chorzów|ul. Dyrekcyjna 3 |41-506 Chorzów;1627;643;643;5;638;39.52;0.78
104766;246301;Szkoła Podstawowa Nr 34|Chorzów|ul. Kaliny 55 |41-506 Chorzów;1297;451;451;12;439;34.77;2.66
104767;246301;Szkoła Podstawowa Nr 34|Chorzów|ul. Kaliny 55 |41-506 Chorzów;1402;762;762;19;743;54.35;2.49
104768;246301;Szkoła Podstawowa Nr 32|Chorzów|ul. Kaliny 61 |41-506 Chorzów;1585;871;871;8;863;54.95;0.92
104769;246301;Akademicki Zespól Szkół Ogólnokształcących Nr 2|Chorzów|ul. Farna 5-7 |41-506 Chorzów;1264;664;664;11;653;52.53;1.66
104770;246301;Akademicki Zespól Szkół Ogólnokształcących Nr 2|Chorzów|ul. Farna 5-7 |41-506 Chorzów;1295;651;651;10;641;50.27;1.54
104771;246301;Gimnazjum Nr 8|Chorzów|ul. ks.J.Czempiela 52 |41-506 Chorzów;1418;808;808;20;788;56.98;2.48
104772;246301;Gimnazjum Nr 8|Chorzów|ul. ks.J.Czempiela 52 |41-506 Chorzów;1306;733;733;11;722;56.13;1.50
104773;246301;Przedszkole Nr 16 Integracyjne|Chorzów|ul. Brzozowa 9 |41-506 Chorzów;1862;1136;1136;14;1122;61.01;1.23
104774;246301;Szkoła Podstawowa Nr 12 z Oddziałami Integracyjnymi|Chorzów|ul. Skrajna 2 |41-506 Chorzów;1766;952;952;21;931;53.91;2.21
104775;246301;Szkoła Podstawowa Nr 12 z Oddziałami Integracyjnymi|Chorzów|ul. Skrajna 2 |41-506 Chorzów;1692;764;764;17;747;45.15;2.23
104776;246301;Szkoła Podstawowa Nr 12 z Oddziałami Integracyjnymi|Chorzów|ul. Skrajna 2 |41-506 Chorzów;1655;773;773;19;754;46.71;2.46
104777;246301;Polski Związek Niewidomych Dom Pomocy Społecznej im. Kazimierza Jaworka|Chorzów|Siemianowicka 101 |41-500 Chorzów;137;53;53;5;48;38.69;9.43
104778;246301;Dom Pomocy Społecznej Św. Wincentego prowadzony przez zgromadzenia Sióstr Miłosierdzia Św. Wincentego a Paulo|Chorzów|Powstańców 45 |41-500 Chorzów;64;26;26;0;26;40.62;0.00
104779;246301;Dom Pomocy Społecznej „Nadzieja”|Chorzów|Wandy 64 |41-500 Chorzów;57;48;48;1;47;84.21;2.08
104780;246301;Samodzielny Publiczny Zakład Opieki Zdrowotnej Zespół Szpitali Miejskich|Chorzów|Karola Miarki 40 |41-500 Chorzów;67;23;23;1;22;34.33;4.35
104781;246301;Samodzielny Publiczny Zakład Opieki Zdrowotnej Zespół Szpitali Miejskich|Chorzów|Strzelców Bytomskich 11 |41-500 Chorzów;209;105;105;4;101;50.24;3.81
104782;246301;Szpital Specjalistyczny|Chorzów|Zjednoczenia 10 |41-500 Chorzów;102;34;34;5;29;33.33;14.71
104783;246301;„AMICUS” sp. z o.o. Zakład Pielęgnacyjno -Opiekuńczy NZOZ|Chorzów|Szpitalna 25 |41-506 Chorzów;62;23;23;6;17;37.10;26.09
104784;246301;Ośrodek św. Florian Caritas Archidiecezji Katowickiej|Chorzów|Harcerska 3 |41-500 Chorzów;47;44;44;7;37;93.62;15.91
104785;246301;Dom Polskiego Czerwonego Krzyża|41-500|Plac Piastowski 19 |41-500 Chorzów;38;16;16;0;16;42.11;0.00
104786;246301;MEDI-system Sp. z o.o.|Chorzów|Główna 31 |41-500 Chorzów;58;9;9;0;9;15.52;0.00
104787;246301;BETAMED Medical Active Care|Chorzów|Ratuszowa 20A |41-506 Chorzów;42;11;11;2;9;26.19;18.18
104788;246401;Zespół Szkół Zawodowych Specjalnych|Częstochowa|ul. Krótka 22 |42-202 ;1083;347;347;8;339;32.04;2.31
104789;246401;Zespół Szkół Zawodowych Specjalnych|Częstochowa|ul. Krótka 22 |42-202 ;1184;471;471;9;462;39.78;1.91
104790;246401;Zespół Szkół im. Jana Kochanowskiego|Częstochowa|ul. Warszawska 142 |42-202 ;514;193;193;5;188;37.55;2.59
104791;246401;Szkoła Podstawowa nr 12|Częstochowa|ul. Warszawska 27/31 |42-202 ;922;426;426;6;420;46.20;1.41
104792;246401;Szkoła Podstawowa nr 12|Częstochowa|ul. Warszawska 27/31 |42-202 ;1181;487;487;11;476;41.24;2.26
104793;246401;Zespół Gimnazjów|Częstochowa|ul. Krakowska 29 |42-202 ;1420;507;507;17;490;35.70;3.35
104794;246401;V LO im. A. Mickiewicza|Częstochowa|ul. Krakowska 29 |42-202 ;1472;513;513;9;504;34.85;1.75
104795;246401;Szkoła Podstawowa nr 35|Częstochowa|ul. Ogrodowa 50/64 |42-202 ;949;320;320;2;318;33.72;0.62
104796;246401;I LO im. J. Słowackiego|Częstochowa|al. Kościuszki 8 |42-202 ;1254;632;632;9;623;50.40;1.42
104797;246401;IX L.O. im. C.K. Norwida|Częstochowa|ul. Jasnogórska 8 |42-202 ;1370;793;793;18;775;57.88;2.27
104798;246401;Rejonowy Zespół Pomocy Społecznej nr 2|Częstochowa|ul. Staszica 10 |42-202 ;1081;595;595;5;590;55.04;0.84
104799;246401;Techniczne Zakłady Naukowe|Częstochowa|ul. Jasnogórska 84/90 |42-217 ;936;555;555;2;553;59.29;0.36
104800;246401;IV LO im. H. Sienkiewicza|Częstochowa|Aleja Najświętszej Maryi Panny 56 |42-217 ;714;414;414;7;407;57.98;1.69
104801;246401;Urząd Miasta Częstochowy|Częstochowa|ul. Waszyngtona 5 |42-217 ;1184;554;554;6;548;46.79;1.08
104802;246401;Szkola Podstawowa nr 14|Częstochowa|ul. Waszyngtona 62 |42-217 ;1451;736;736;4;732;50.72;0.54
104803;246401;Szkoła Podstawowa nr 39|Częstochowa|ul. Kopernika 79/87 |42-217 ;1355;766;766;10;756;56.53;1.31
104804;246401;VII LO im. M. Kopernika|Częstochowa|ul. Nowowiejskiego 18 |42-217 ;1662;884;884;12;872;53.19;1.36
104805;246401;Świetlica Oddz. Eksploatacji ZGM TBS sp. z o.o.|Częstochowa|ul. Nowowiejskiego 26 |42-217 ;973;557;557;8;549;57.25;1.44
104806;246401;Gimnazjum nr 9|Częstochowa|ul. Jana III Sobieskiego 15 |42-217 ;1578;833;833;12;821;52.79;1.44
104807;246401;Gimnazjum nr 9|Częstochowa|ul. Jana III Sobieskiego 15 |42-217 ;1947;1107;1107;23;1084;56.86;2.08
104808;246401;Szkoła Podstawowa nr 33|Częstochowa|ul. Goszczyńskiego 9/11 |42-217 ;1515;854;854;11;843;56.37;1.29
104809;246401;Szkoła Podstawowa nr 33|Częstochowa|ul. Goszczyńskiego 9/11 |42-217 ;1654;847;847;10;837;51.21;1.18
104810;246401;Miejskie Przedszkole nr 35|Częstochowa|ul. 1 Maja 5/7 |42-202 ;2035;1084;1084;27;1057;53.27;2.49
104811;246401;Zespół Szkół Gastronomicznych|Częstochowa|al. Worcella 1 |42-202 ;785;499;499;6;493;63.57;1.20
104812;246401;Zespół Szkół Gastronomicznych|Częstochowa|ul. Worcella 1 |42-202 ;1420;805;805;10;795;56.69;1.24
104813;246401;Gimnazjum nr 5|Częstochowa|ul. Worcella 20/22 |42-202 ;1208;741;741;8;733;61.34;1.08
104814;246401;Szkoła Podstawowa nr 1|Częstochowa|ul. Księżycowa 6 |42-202 ;1170;658;658;9;649;56.24;1.37
104815;246401;Miejskie Przedszkole nr 11|Częstochowa|ul. Kurpińskiego-Ponurego 6 |42-215 ;1595;953;953;7;946;59.75;0.73
104816;246401;Szkoła Podstawowa nr 42|Częstochowa|Aleja Armii Krajowej 68a |42-215 ;1216;659;659;4;655;54.19;0.61
104817;246401;Szkoła Podstawowa nr 42|Częstochowa|Aleja Armii Krajowej 68a |42-215 ;1050;570;570;13;557;54.29;2.28
104818;246401;Szkoła Podstawowa nr 42|Częstochowa|Aleja Armii Krajowej 68a |42-215 ;1455;793;793;9;784;54.50;1.13
104819;246401;Żłobek Miejski|Częstochowa|Aleja Armii Krajowej 66a |42-215 ;1420;853;853;8;845;60.07;0.94
104820;246401;II LO im. R. Traugutta|Częstochowa|ul. Kilińskiego 62 |42-218 ;728;436;436;6;430;59.89;1.38
104821;246401;Gimnazjum nr 12|Częstochowa|ul. Okólna 31/39 |42-218 ;1820;1172;1172;12;1160;64.40;1.02
104822;246401;Gimnazjum nr 12|Częstochowa|ul. Okólna 31/39 |42-218 ;1747;1179;1179;1;1178;67.49;0.08
104823;246401;Miejskie Przedszkole nr 12|Częstochowa|ul. Broniewskiego 18 |42-218 ;1681;973;973;12;961;57.88;1.23
104824;246401;Miejskie Przedszkole nr 42|Częstochowa|ul. Polskiego Czerwonego Krzyża 16 |42-218 ;1808;1121;1121;13;1108;62.00;1.16
104825;246401;Szkoła Podstawowa nr 31|Częstochowa|ul. Polskiego Czerwonego Krzyża 18 |42-218 ;2025;1251;1251;23;1228;61.78;1.84
104826;246401;Szkoła Podstawowa nr 31|Częstochowa|ul. Polskiego czerwonego Krzyża 18 |42-218 ;2258;1445;1445;18;1427;63.99;1.25
104827;246401;Szkoła Podstawowa nr 30|Częstochowa|ul. Ludowa 58 |42-215 ;1511;932;932;8;924;61.68;0.86
104828;246401;Szkoła Podstawowa nr 30|Częstochowa|ul. Ludowa 58 |42-215 ;868;552;552;10;542;63.59;1.81
104829;246401;Szkoła Podstawowa nr 38|Częstochowa|ul. Sikorskiego 56 |42-200 ;1884;1166;1166;15;1151;61.89;1.29
104830;246401;Szkoła Podstawowa nr 38|Częstochowa|ul. Sikorskiego 56 |42-200 ;1550;1083;1083;6;1077;69.87;0.55
104831;246401;Miejskie Przedszkole nr 38|Częstochowa|ul. Okulickiego 63 |42-218 ;1745;1080;1080;5;1075;61.89;0.46
104832;246401;Zespół Szkół Technicznych|Częstochowa|Aleja Jana Pawła II 126/130 |42-200 ;1723;981;981;7;974;56.94;0.71
104833;246401;Szkoła Podstawowa nr 2|Częstochowa|ul. Baczyńskiego 2a |42-224 ;1985;1178;1178;5;1173;59.35;0.42
104834;246401;Gimnazjum nr 2|Częstochowa|ul. Baczyńskiego 2a |42-224 ;1690;980;980;10;970;57.99;1.02
104835;246401;Gimnazjum nr 2|Częstochowa|ul. Baczyńskiego 2a |42-224 ;1862;1104;1104;15;1089;59.29;1.36
104836;246401;Gimnazjum nr 3|Częstochowa|ul. Schillera 5 |42-224 ;1784;1084;1084;13;1071;60.76;1.20
104837;246401;Gimnazjum nr 3|Częstochowa|ul. Schillera 5 |42-224 ;1722;982;982;12;970;57.03;1.22
104838;246401;Szkoła Podstawowa nr 48|Częstochowa|ul. Schillera 5 |42-224 ;984;569;569;9;560;57.83;1.58
104839;246401;Szkoła Podstawowa nr 48|Częstochowa|ul. Schillera 5 |42-224 ;1724;1025;1025;9;1016;59.45;0.88
104840;246401;Spółdzielnia Mieszkaniowa "Segment"|Częstochowa|ul. Kutrzeby 32 |42-224 ;432;294;294;1;293;68.06;0.34
104841;246401;Miejskie Przedszkole nr 16|Częstochowa|ul. Starzyńskiego 9 |42-224 ;1805;1055;1055;15;1040;58.45;1.42
104842;246401;Szkoła Podstawowa nr 50|Częstochowa|ul. Starzyńskiego 10 |42-224 ;1666;912;912;10;902;54.74;1.10
104843;246401;Szkoła Podstawowa nr 50|Częstochowa|ul. Starzyńskiego 10 |42-224 ;1863;1228;1228;7;1221;65.92;0.57
104844;246401;Gimnazjum nr 1|Częstochowa|ul. Starzyńskiego 10 |42-224 ;1576;887;887;8;879;56.28;0.90
104845;246401;Gimnazjum nr 1|Częstochowa|ul. Starzyńskiego 10 |42-224 ;1553;900;900;9;891;57.95;1.00
104846;246401;Zespół Szkół nr 1|Częstochowa|ul. Kukuczki 30 |42-224 ;1402;858;858;5;853;61.20;0.58
104847;246401;VIII LO Samorządowe|Częstochowa|ul. Kukuczki 30 |42-224 ;1059;646;646;2;644;61.00;0.31
104848;246401;Zespół Szkolno-Przedszkolny|Częstochowa|ul. Połaniecka 50 |42-209 ;951;448;448;7;441;47.11;1.56
104849;246401;Wojewódzki Inspektorat Ochrony Środowiska|Częstochowa|ul. Rząsawska 24/28 |42-209 ;777;364;364;3;361;46.85;0.82
104850;246401;Szkoła Podstawowa nr 25|Częstochowa|ul. Rędzińska 23 |42-209 ;1251;696;696;10;686;55.64;1.44
104851;246401;Dom Pomocy Społecznej|Częstochowa|ul. Kontkiewicza 2 |42-209 ;1215;701;701;11;690;57.70;1.57
104852;246401;Szkoła Podstawowa nr 24|Częstochowa|ul. Hubermana 7 |42-209 ;1264;749;749;8;741;59.26;1.07
104853;246401;Gimnazjum nr 20|Częstochowa|ul. Hubermana 7 |42-209 ;1409;830;830;13;817;58.91;1.57
104854;246401;Zespół Szkół im. Jana Kochanowskiego|Częstochowa|ul. Warszawska 142 |42-202 ;302;147;147;1;146;48.68;0.68
104855;246401;Szkoła Podstawowa nr 22|Częstochowa|ul. Żabia 1 |42-202 ;1155;529;529;7;522;45.80;1.32
104856;246401;Zespół Szkolno-Przedszkolny nr 2|Częstochowa|ul. Olsztyńska 42 |42-202 ;1416;712;712;17;695;50.28;2.39
104857;246401;Gimnazjum nr 17|Częstochowa|ul. Legionów 23 |42-202 ;1266;597;597;16;581;47.16;2.68
104858;246401;Gimnazjum nr 17|Częstochowa|ul. Legionów 23 |42-202 ;1403;717;717;18;699;51.10;2.51
104859;246401;Zespół Szkół nr 15|Częstochowa|ul. Orla 4/8 |42-202 ;1985;1038;1038;12;1026;52.29;1.16
104860;246401;Zespół Szkół nr 3|Częstochowa|ul. Rozdolna 5 |42-202 ;1826;1019;1019;16;1003;55.81;1.57
104861;246401;Szkoła Podstawowa nr 8|Częstochowa|ul. Szczytowa 28/30 |42-216 ;1468;548;548;12;536;37.33;2.19
104862;246401;Szkoła Podstawowa nr 8|Częstochowa|ul. Szczytowa 28/30 |42-216 ;1705;859;859;11;848;50.38;1.28
104863;246401;Zespół Szkół Technicznych i Ogólnokształcących|Częstochowa|Aleja Niepodległości 16/18 |42-216 ;2002;1105;1105;19;1086;55.19;1.72
104864;246401;Szkoła Podstawowa nr 17|Częstochowa|Aleja Wojska Polskiego 130 |42-207 ;1505;731;731;15;716;48.57;2.05
104865;246401;Szkoła Podstawowa nr 17|Częstochowa|Aleja Wojska Polskiego 130 |42-207 ;1031;549;549;11;538;53.25;2.00
104866;246401;Szkoła Podstawowa nr 32|Częstochowa|ul. Przerwy-Tetmajera 40 |42-207 ;2068;942;942;25;917;45.55;2.65
104867;246401;Gimnazjum nr 7|Częstochowa|ul. Zamenhofa 23 |42-207 ;1547;802;802;20;782;51.84;2.49
104868;246401;Gimnazjum nr 7|Częstochowa|ul. Zamenhofa 23 |42-207 ;1201;527;527;7;520;43.88;1.33
104869;246401;Zespół Szkół im. B. Prusa|Częstochowa|ul. Prusa 20 |42-207 ;2001;1035;1035;22;1013;51.72;2.13
104870;246401;VI LO im. J. Dąbrowskiego|Częstochowa|ul. Łukasińskiego 40 |42-207 ;1076;329;329;9;320;30.58;2.74
104871;246401;Zespół Szkolno-Przedszkolny nr 3|Częstochowa|ul. Łukasińskiego 70/74 |42-207 ;1565;863;863;23;840;55.14;2.67
104872;246401;Zespół Szkolno-Przedszkolny nr 3|Częstochowa|ul. Łukasińskiego 70/74 |42-207 ;1125;544;544;14;530;48.36;2.57
104873;246401;Szkoła Podstawowa nr 34|Częstochowa|ul. Dąbrowskiej 5/9 |42-208 ;1770;1017;1017;11;1006;57.46;1.08
104874;246401;Szkoła Podstawowa nr 34|Częstochowa|ul. Dąbrowskiej 5/9 |42-208 ;1288;699;699;15;684;54.27;2.15
104875;246401;Szkoła Podstawowa nr 34|Częstochowa|ul. Dąbrowskiej 5/9 |42-208 ;1656;882;882;11;871;53.26;1.25
104876;246401;Miejskie Przedszkole nr 6|Częstochowa|ul. Sosnowa 22/28 |42-216 ;1239;727;727;15;712;58.68;2.06
104877;246401;Świetlica MPK|Częstochowa|Aleja Niepodległości 30 |42-216 ;2178;1053;1053;13;1040;48.35;1.23
104878;246401;Szkoła Podstawowa nr 36|Częstochowa|ul. Kasztanowa 7/9 |42-216 ;2049;1147;1147;11;1136;55.98;0.96
104879;246401;Gimnazjum nr 18|Częstochowa|ul. Orkana 95/109 |42-229 ;1908;1100;1100;13;1087;57.65;1.18
104880;246401;Gimnazjum nr 18|Częstochowa|ul. Orkana 95/109 |42-229 ;1617;902;902;8;894;55.78;0.89
104881;246401;Szkoła Podstawowa nr 53|Częstochowa|ul. Orkana 95/109 |42-229 ;2112;1137;1137;23;1114;53.84;2.02
104882;246401;Szkoła Podstawowa nr 53|Częstochowa|ul. Orkana 95/109 |42-229 ;1950;1113;1113;11;1102;57.08;0.99
104883;246401;Miejskie Przedszkole nr 20|Częstochowa|ul. Wierzbowa 20 |42-216 ;1552;874;874;12;862;56.31;1.37
104884;246401;Miejskie Przedszkole nr 20|Częstochowa|ul. Wierzbowa 20 |42-216 ;1391;748;748;12;736;53.77;1.60
104885;246401;Szkoła Podstawowa nr 49|Częstochowa|ul. Jesienna 42 |42-208 ;729;442;442;4;438;60.63;0.90
104886;246401;Szkoła Podstawowa nr 49|Częstochowa|ul. Jesienna 42 |42-208 ;1696;952;952;15;937;56.13;1.58
104887;246401;Szkoła Podstawowa nr 26|Częstochowa|ul. Rakowska 42 |42-208 ;1914;1050;1050;15;1035;54.86;1.43
104888;246401;Szkoła Podstawowa nr 26|Częstochowa|ul. Rakowska 42 |42-208 ;1998;1102;1102;10;1092;55.16;0.91
104889;246401;Miejskie Przedszkole nr 19|Częstochowa|ul. Szkolna 1 |42-208 ;1895;1016;1016;9;1007;53.61;0.89
104890;246401;Rodzinny Ogród Działkowy Wypalanki|Częstochowa|ul. Bór 201 |42-202 ;702;381;381;8;373;54.27;2.10
104891;246401;Zespół Szkół nr 2|Częstochowa|ul. Wirażowa 8 |42-202 ;735;370;370;7;363;50.34;1.89
104892;246401;Remiza Ochotniczej Straży Pożarnej w Kuźnicy Marianowej|Częstochowa|ul. Zdrowa 80/82 |42-200 ;842;457;457;8;449;54.28;1.75
104893;246401;Szkoła Podstawowa nr 52|Częstochowa|ul. Powstańców Warszawy 144a |42-271 ;1526;698;698;16;682;45.74;2.29
104894;246401;Szkoła Podstawowa nr 52|Częstochowa|ul. Powstańców Warszawy 144a |42-271 ;1722;740;740;15;725;42.97;2.03
104895;246401;Środowiskowy Dom Samopomocy|Częstochowa|ul. Lakowa 101 |42-280 ;534;268;268;4;264;50.19;1.49
104896;246401;Miejskie Przedszkole nr 9|Częstochowa|ul. Sabinowska 81/83 |42-202 ;980;567;567;8;559;57.86;1.41
104897;246401;Szkoła Podstawowa nr 21|Częstochowa|ul. Sabinowska 7/9 |42-202 ;1216;685;685;6;679;56.33;0.88
104898;246401;Gimnazjum nr 16|Częstochowa|ul. Ułańska 5/7 |42-202 ;1810;1017;1017;9;1008;56.19;0.88
104899;246401;Gimnazjum nr 16|Częstochowa|ul. Ułańska 5/7 |42-280 ;1806;953;953;17;936;52.77;1.78
104900;246401;Centralna Szkoła Państwowej Straży Pożarnej|Częstochowa|ul. Sabinowska 62/64 |42-280 ;1392;806;806;6;800;57.90;0.74
104901;246401;Centralna Szkoła Państwowej Straży Pożarnej|Częstochowa|ul. Sabinowska 62/64 |42-280 ;1344;780;780;14;766;58.04;1.79
104902;246401;Szkoła Podstawowa nr 47|Częstochowa|ul. Przestrzenna 68/70 |42-202 ;1067;545;545;8;537;51.08;1.47
104903;246401;Szkoła Podstawowa nr 11|Częstochowa|ul. Festynowa 24 |42-202 ;1432;727;727;7;720;50.77;0.96
104904;246401;Gimnazjum nr 11|Częstochowa|ul. Festynowa 24 |42-202 ;1741;903;903;14;889;51.87;1.55
104905;246401;Szkoła Podstawowa nr 46|Częstochowa|ul. Szamotowa 8 |42-202 ;1105;617;617;14;603;55.84;2.27
104906;246401;Szkoła Podstawowa nr 37|Częstochowa|ul. Wielkoborska 54 |42-221 ;2040;1123;1123;21;1102;55.05;1.87
104907;246401;Szkoła Podstawowa nr 13|Częstochowa|ul. Wręczycka 111/115 |42-221 ;2075;1271;1271;16;1255;61.25;1.26
104908;246401;Szkoła Podstawowa nr 13|Częstochowa|ul. Wręczycka 111/115 |42-226 ;1705;1066;1066;12;1054;62.52;1.13
104909;246401;Szkoła Podstawowa nr 13|Częstochowa|ul. Wręczycka 111/115 |42-226 ;1901;1319;1319;9;1310;69.38;0.68
104910;246401;Szkoła Podstawowa nr 29|Częstochowa|ul. Św. Rocha 221 |42-209 ;1915;1215;1215;11;1204;63.45;0.91
104911;246401;Gimnazjum nr 14|Częstochowa|ul. Św. Rocha 221 |42-202 ;1887;1285;1285;11;1274;68.10;0.86
104912;246401;Zespół Szkół Ekonomicznych|Częstochowa|ul. Św. Augustyna 28/30 |42-226 ;774;392;392;5;387;50.65;1.28
104913;246401;Zespół Szkolno-Przedszkolny nr 5|Częstochowa|ul. Św. Barbary 32 |42-226 ;2116;1279;1279;11;1268;60.44;0.86
104914;246401;Zakład Opiekuńczo-Leczniczy prowadzony przez Zgromadzenie Małych Sióstr NSM "Honoratek"|Częstochowa|ul. Ogrodowa 35 |42-202 ;123;61;61;0;61;49.59;0.00
104915;246401;Miejski Szpital Zespolony|Częstochowa|ul. Mickiewicza 12 |42-200 ;77;35;35;1;34;45.45;2.86
104916;246401;Wojewódzki Szpital Specjalistyczny im. Najświętszej Maryi Panny|Częstochowa|ul. Polskiego Czerwonego Krzyża 7 |42-200 ;157;77;77;4;73;49.04;5.19
104917;246401;Wojewódzki Szpital Specjalistyczny im. Najświętszej Maryi Panny w Częstochowie|Częstochowa|ul. Bialska 104/118 |42-200 ;240;74;74;3;71;30.83;4.05
104918;246401;Dom Pomocy Społecznej pw. Św. Antoniego Zgromadzenia Sióstr Miłosierdzia|Częstochowa|ul. Wieluńska 1 |42-200 ;135;80;80;0;80;59.26;0.00
104919;246401;Miejski Szpital Zespolony|Częstochowa|ul. Mirowska 15 |42-200 ;136;79;79;2;77;58.09;2.53
104920;246401;Areszt Śledczy w Częstochowie|Częstochowa|ul. Mirowska 22 |42-200 ;173;95;95;15;80;54.91;15.79
104921;246401;Wojewódzki Szpital Specjalistyczny im. Najświętszej Maryi Panny w Częstochowie|Częstochowa|Aleja Pokoju 44 |42-200 ;68;40;40;2;38;58.82;5.00
104922;246401;Dom Pomocy Społecznej|Częstochowa|ul. Kontkiewicza 2 |42-200 ;112;61;61;13;48;54.46;21.31
104923;246401;Miejski Szpital Zespolony|Częstochowa|ul. Bony 1/3 |42-226 ;85;12;12;0;12;14.12;0.00
104924;246501;V LO|Dąbrowa Górnicza|ul. Czapińskiego 8 |41-300 Dąbrowa Górnicza;1438;855;855;9;846;59.46;1.05
104925;246501;Szkoła Podstawowa NR 3|Dąbrowa Górnicza|ul. Mireckiego 1 |41-300 Dąbrowa Górnicza;601;320;320;8;312;53.24;2.50
104926;246501;Zespół Szkół nr 7|Dąbrowa Górnicza|ul. Jaworowa 6 |41-300 Dąbrowa Górnicza;1619;949;949;17;932;58.62;1.79
104927;246501;Zespół Szkół Nr 7|Dąbrowa Górnicza|ul. Jaworowa 6 |41-300 Dąbrowa Górnicza;1726;894;894;10;884;51.80;1.12
104928;246501;ADM Nr 2 SM "Lokator"|Dąbrowa Górnicza|ul. Jaworowa 2 |41-300 Dąbrowa Górnicza;1907;1077;1077;17;1060;56.48;1.58
104929;246501;Klub "Krąg"|Dąbrowa Górnicza|ul. Ludowa 19A |41-300 Dąbrowa Górnicza;2032;1108;1108;24;1084;54.53;2.17
104930;246501;Szkoła Podstawowa Nr 3|Dąbrowa Górnicza|ul. Mireckiego 1 |41-300 Dąbrowa Górnicza;1438;850;850;7;843;59.11;0.82
104931;246501;Zespół Szkół Sportowych|Dąbrowa Górnicza|ul. Chopina 34 |41-300 Dąbrowa Górnicza;1305;702;702;7;695;53.79;1.00
104932;246501;Zespół Szkół Sportowych|Dąbrowa Górnicza|ul. Chopina 34 |41-300 Dąbrowa Górnicza;1976;1151;1151;15;1136;58.25;1.30
104933;246501;Zespół Szkół Sportowych|Dąbrowa Górnicza|ul. Chopina 34 |41-300 Dąbrowa Górnicza;1935;1014;1014;20;994;52.40;1.97
104934;246501;Młodzieżowy Ośrodek Pracy Twórczej|Dąbrowa Górnicza|ul. 3 Maja 30 |41-300 Dąbrowa Górnicza;1293;682;682;14;668;52.75;2.05
104935;246501;II LO|Dąbrowa Górnicza|ul. Górnicza 17 |41-300 Dąbrowa Górnicza;1570;700;700;14;686;44.59;2.00
104936;246501;Szpital Specjalistyczny im.Sz.Starkiewicza|Dąbrowa Górnicza|Szpitalna 13 |41-300 ;302;86;86;5;81;28.48;5.81
104937;246501;Szkoła Podstawowa Nr 10|Dąbrowa Górnicza|ul. Górników Redenu 4 |41-300 Dąbrowa Górnicza;1146;586;586;11;575;51.13;1.88
104938;246501;Szkoła Podstawowa Nr 10|Dąbrowa Górnicza|ul. Górników Redenu 4 |41-300 Dąbrowa Górnicza;1723;954;954;6;948;55.37;0.63
104939;246501;Gimnazjum Nr 1|Dąbrowa Górnicza|ul. Królowej Jadwigi 11 |41-300 Dąbrowa Górnicza;1888;990;990;25;965;52.44;2.53
104940;246501;Szkoła Podstawowa Nr 20|Dąbrowa Górnicza|ul.Karola Adamieckiego 12 |41-300 Dąbrowa Górnicza;1419;735;735;12;723;51.80;1.63
104941;246501;Szkoła Podstawowa Nr 20|Dąbrowa Górnicza|ul.Karola Adamieckiego 12 |41-300 Dąbrowa Górnicza;1059;564;564;11;553;53.26;1.95
104942;246501;Budynek byłej Szkoły Muzycznej|Dąbrowa Górnicza|ul. Wojska Polskiego 52 |41-300 Dąbrowa Górnicza;1767;967;967;21;946;54.73;2.17
104943;246501;I Liceum Ogółnokształcące|Dąbrowa Górnicza|ul. Kopernika 40 |41-300 Dąbrowa Górnicza;1924;1027;1027;11;1016;53.38;1.07
104944;246501;Szkoła Podstawowa Nr 8|Dąbrowa Górnicza|ul. Krasińskiego 34 |41-300 Dąbrowa Górnicza;902;492;492;3;489;54.55;0.61
104945;246501;Przedszkole Nr 6|Dąbrowa Górnicza|ul. Robotnicza 33 |41-300 Dąbrowa Górnicza;1489;683;683;11;672;45.87;1.61
104946;246501;Zespół Szkół Nr 4|Dąbrowa Górnicza|ul. Łęknice 35 |41-303 Dąbrowa Górnicza;1997;1062;1062;24;1038;53.18;2.26
104947;246501;Zespół Szkół Nr 4|Dąbrowa Górnicza|ul. Łęknice 35 |41-303 Dąbrowa Górnicza;1471;799;799;5;794;54.32;0.63
104948;246501;Zespół Szkół Nr 1|Dąbrowa Górnicza|ul. Konopnickiej 56 |41-300 Dąbrowa Górnicza;1523;935;935;13;922;61.39;1.39
104949;246501;Placówka Opiekuńczo - Wychowawcza|Dąbrowa Górnicza|ul. Jasna 29 |41-303 Dąbrowa Górnicza;559;300;300;6;294;53.67;2.00
104950;246501;Klub "Helikon"|Dąbrowa Górnicza|ul. Wojska Polskiego 26 |41-300 Dąbrowa Górnicza;1561;915;915;9;906;58.62;0.98
104951;246501;Zespół Szkół Ekonomicznych|Dąbrowa Górnicza|ul. Aleja Józefa Piłsudskiego 5 |41-300 Dąbrowa Górnicza;1432;685;685;15;670;47.84;2.19
104952;246501;Zespół Szkół Ekonomicznych|Dąbrowa Górnicza|ul. Aleja Józefa Piłsudskiego 5 |41-300 Dąbrowa Górnicza;2272;1159;1159;20;1139;51.01;1.73
104953;246501;Gimnazjum Nr 4|Dąbrowa Górnicza|ul. Wyspiańskiego 1 |41-300 Dąbrowa Górnicza;1918;965;965;24;941;50.31;2.49
104954;246501;Szkoła Podstawowa Nr 8|Dąbrowa Górnicza|ul. Krasińskiego 34 |41-300 Dąbrowa Górnicza;1704;917;917;10;907;53.81;1.09
104955;246501;Przedszkole nr 11|Dąbrowa Górnicza|ul. Krasińskiego 35 |41-300 Dąbrowa Górnicza;1206;662;662;3;659;54.89;0.45
104956;246501;Dom Pomocy Społecznej|Dąbrowa Górnicza|Norwida 1 |41-300 ;108;47;47;2;45;43.52;4.26
104957;246501;Zespół Szkół Nr 2|Dąbrowa Górnicza|ul. Aleja Józefa Piłsudskiego 24 |41-303 Dąbrowa Górnicza;1845;1079;1079;12;1067;58.48;1.11
104958;246501;Zespół Szkół Nr 2|Dąbrowa Górnicza|ul. Aleja Józefa Piłsudskiego 24 |41-303 Dąbrowa Górnicza;1114;667;667;8;659;59.87;1.20
104959;246501;Zespół Szkół Nr 2|Dąbrowa Górnicza|ul. Aleja Józefa Piłsudskiego 24 |41-303 Dąbrowa Górnicza;1068;647;647;7;640;60.58;1.08
104960;246501;Zespół Szkół Nr 3|Dąbrowa Górnicza|ul. Gustawa Morcinka 4 |41-303 Dąbrowa Górnicza;1690;976;976;16;960;57.75;1.64
104961;246501;Zespół Szkół Nr 3|Dąbrowa Górnicza|ul. Gustawa Morcinka 4 |41-303 Dąbrowa Górnicza;1792;963;963;18;945;53.74;1.87
104962;246501;Przedszkole Nr 14|Dąbrowa Górnicza|ul. Tysiąclecia 25A |41-303 Dąbrowa Górnicza;1900;1033;1033;15;1018;54.37;1.45
104963;246501;Klub "Unikat"|Dąbrowa Górnicza|ul. Kasprzaka 46 |41-303 Dąbrowa Górnicza;1994;1096;1096;19;1077;54.96;1.73
104964;246501;Szkoła Podstawowa Nr 12|Dąbrowa Górnicza|ul. Tysiąclecia 25 |41-303 Dąbrowa Górnicza;966;548;548;9;539;56.73;1.64
104965;246501;Szkoła Podstawowa Nr 12|Dąbrowa Górnicza|ul. Tysiąclecia 25 |41-303 Dąbrowa Górnicza;1765;981;981;11;970;55.58;1.12
104966;246501;Przedszkole nr 12|Dąbrowa Górnicza|ul. Krasickiego 1 |41-303 Dąbrowa Górnicza;1249;581;581;10;571;46.52;1.72
104967;246501;Zespół Szkół Ogólnokształcących Nr 2|Dąbrowa Górnicza|ul. Prusa 3 |41-303 Dąbrowa Górnicza;1439;646;646;16;630;44.89;2.48
104968;246501;Zespół Szkół Ogólnokształcących Nr 2|Dąbrowa Górnicza|ul. Prusa 3 |41-303 Dąbrowa Górnicza;853;403;403;7;396;47.25;1.74
104969;246501;Szkoła Podstawowa Nr 18|Dąbrowa Górnicza|ul. Aleja Józefa Piłsudskiego 73 |41-303 Dąbrowa Górnicza;1786;991;991;18;973;55.49;1.82
104970;246501;Szkoła Podstawowa Nr 18|Dąbrowa Górnicza|ul. Aleja Józefa Piłsudskiego 73 |41-303 Dąbrowa Górnicza;2040;907;907;15;892;44.46;1.65
104971;246501;Szkoła Podstawowa Nr 11|Dąbrowa Górnicza|ul. Aleja Józefa Piłsudskiego 103 |41-303 Dąbrowa Górnicza;2264;980;980;15;965;43.29;1.53
104972;246501;Zespół Szkół Plastycznych|Dąbrowa Górnicza|ul. Kosmonautów 8 |41-303 Dąbrowa Górnicza;1263;641;641;16;625;50.75;2.50
104973;246501;Szkoła Podstawowa Nr 25|Dąbrowa Górnicza, Ujejsce|ul. Mieszka I 20 |42-520 Dąbrowa Górnicza;1827;927;927;20;907;50.74;2.16
104974;246501;Szkoła Podstawowa Nr 35|Dąbrowa Górnicza, Trzebiesławice|ul. Uczniowska 24 |42-520 Dąbrowa Górnicza;860;417;417;3;414;48.49;0.72
104975;246501;Szkoła Podstawowa nr 21|Dąbrowa Górnicza, Ząbkowice|ul. Gospodarcza 1 |42-520 Dąbrowa Górnicza;1384;646;646;12;634;46.68;1.86
104976;246501;Dom Kultury|Dąbrowa Górnicza, Ząbkowice|ul. Chemiczna 2 |42-520 Dąbrowa Górnicza;1698;904;904;22;882;53.24;2.43
104977;246501;Dom Kultury|Dąbrowa Górnicza, Ząbkowice|ul. Chemiczna 2 |42-520 Dąbrowa Górnicza;751;394;394;3;391;52.46;0.76
104978;246501;Gimnazjum nr 9|Dąbrowa Górnicza, Ząbkowice|ul. Aleja Zwycięstwa 44 |42-520 Dąbrowa Górnicza;2357;1291;1291;15;1276;54.77;1.16
104979;246501;Szkoła Podstawowa Nr 31|Dąbrowa Górnicza, Ząbkowice|ul. Aleja Zwycięstwa 77 |42-520 Dąbrowa Górnicza;1096;458;458;19;439;41.79;4.15
104980;246501;Szkoła Podstawowa Nr 31|Dąbrowa Górnicza, Ząbkowice|ul. Aleja Zwycięstwa 77 |42-520 Dąbrowa Górnicza;1495;673;673;15;658;45.02;2.23
104981;246501;Szkoła Podstawowa Nr 23|Dąbrowa Górnicza, Tucznawa|ul. Idzikowskiego 139 |42-520 Dąbrowa Górnicza;1975;1092;1092;20;1072;55.29;1.83
104982;246501;Świetlica Klub|Dąbrowa Górnicza, Łęka|ul. Przelotowa 185A |42-523 Dąbrowa Górnicza;614;306;306;4;302;49.84;1.31
104983;246501;Szkoła Podstawowa Nr 28|Dąbrowa Górnicza, Okradzionów|ul. Górna 1 |42-524 Dąbrowa Górnicza;1010;526;526;10;516;52.08;1.90
104984;246501;Szkoła Podstawowa Nr 27|Dąbrowa Górnicza, Błędów|ul. Żołnierska 188 |42-525 Dąbrowa Górnicza;1462;748;748;19;729;51.16;2.54
104985;246501;Szkoła Podstawowa nr 2|Dąbrowa Górnicza, Strzemieszyce|ul. Sportowa 16 |42-530 Dąbrowa Górnicza;1810;936;936;15;921;51.71;1.60
104986;246501;Szkoła Podstawowa nr 17|Dąbrowa Górnicza, Strzemieszyce|ul. Ofiar Katynia 76 |42-530 Dąbrowa Górnicza;2077;928;928;20;908;44.68;2.16
104987;246501;Gimnazjum Nr 10|Dąbrowa Górnicza, Strzemieszyce Wielkie|ul. Obrońców Pokoju 7 |42-530 Dąbrowa Górnicza;1282;640;640;9;631;49.92;1.41
104988;246501;Szkoła Podstawowa Nr 5|Dąbrowa Górnicza, Strzemieszyce|ul. Strzemieszycka 390 |42-530 Dąbrowa Górnicza;1695;842;842;14;828;49.68;1.66
104989;246501;Świetlica Środowiskowa|Dąbrowa Górnicza, Strzemieszyce|ul. Główna 61 |42-530 Dąbrowa Górnicza;1192;480;480;6;474;40.27;1.25
104990;246501;Szkoła Podstawowa Nr 26|Dąbrowa Górnicza, Łosień|ul. Gołonoska 23 |42-523 Dąbrowa Górnicza;1211;564;564;5;559;46.57;0.89
104991;246601;Warsztaty Terapii Zajęciowej Caritas Diecezji Gliwickiej|Gliwice|ul. Toszecka 179 |44-109 Gliwice;0;0;0;0;0;-99;-99
104992;246601;Szkoła Podstawowa nr 29|Gliwice|ul. Staromiejska 24 |44-109 Gliwice;1343;646;646;11;635;48.10;1.70
104993;246601;Gimnazjum nr 19|Gliwice|ul. Główna 30 |44-109 Gliwice;969;366;366;9;357;37.77;2.46
104994;246601;Szkoła Podstawowa nr 32|Gliwice|ul. Wrzosowa 14 |44-109 Gliwice;1096;581;581;14;567;53.01;2.41
104995;246601;Szkoła Podstawowa nr 32|Gliwice|ul. Wrzosowa 14 |44-109 Gliwice;1154;494;494;16;478;42.81;3.24
104996;246601;Szkoła Podstawowa nr 38|Gliwice|ul. Partyzantów 25 |44-113 Gliwice;1255;645;645;21;624;51.39;3.26
104997;246601;Szkoła Podstawowa nr 38|Gliwice|ul. Partyzantów 25 |44-113 Gliwice;1201;592;592;8;584;49.29;1.35
104998;246601;Zespół Szkół Ogólnokształcących nr 2|Gliwice|ul. Partyzantów 25 |44-113 Gliwice;1261;605;605;9;596;47.98;1.49
104999;246601;Zespół Szkół Ogólnokształcących nr 2|Gliwice|ul. Partyzantów 25 |44-113 Gliwice;1280;805;805;9;796;62.89;1.12
105000;246601;Przedszkole Miejskie nr 38|Gliwice|ul. Literatów 41 |44-113 Gliwice;1535;954;954;10;944;62.15;1.05
105001;246601;Przedszkole Miejskie nr 38|Gliwice|ul. Literatów 41 |44-113 Gliwice;1641;840;840;22;818;51.19;2.62
105002;246601;Zespół Szkół Ogólnokształcąco - Ekonomicznych|Gliwice|ul. Syriusza 30 |44-117 Gliwice;1582;952;952;12;940;60.18;1.26
105003;246601;Zespół Szkół Ogólnokształcąco - Ekonomicznych|Gliwice|ul. Syriusza 30 |44-117 Gliwice;1681;998;998;14;984;59.37;1.40
105004;246601;Zespół Szkół Ogólnokształcąco - Ekonomicznych|Gliwice|ul. Syriusza 30 |44-117 Gliwice;1614;985;985;13;972;61.03;1.32
105005;246601;Zespół Szkolno - Przedszkolny nr 2|Gliwice|ul. Kopernika 63 |44-117 Gliwice;1361;800;800;12;788;58.78;1.50
105006;246601;Zespół Szkolno - Przedszkolny nr 2|Gliwice|ul. Kopernika 63 |44-117 Gliwice;1256;766;766;19;747;60.99;2.48
105007;246601;Zespół Szkolno - Przedszkolny nr 2|Gliwice|ul. Kopernika 63 |44-117 Gliwice;1443;795;795;13;782;55.09;1.64
105008;246601;Gimnazjum nr 3|Gliwice|ul. Jasnogórska 15/17 |44-101 Gliwice;892;571;571;11;560;64.01;1.93
105009;246601;Centrum Kształcenia Zawodowego i Ustawicznego nr 1|Gliwice|ul. Kozielska 1 |44-101 Gliwice;1538;861;861;11;850;55.98;1.28
105010;246601;Zespół Szkół Ogólnokształcących nr 1|Gliwice|ul. Kozielska 1a |44-121 Gliwice;1787;1044;1044;22;1022;58.42;2.11
105011;246601;Zespół Szkolno - Przedszkolny nr 5|Gliwice|ul. Kozielska 39 |44-121 Gliwice;1509;961;961;10;951;63.68;1.04
105012;246601;Zespół Szkolno - Przedszkolny nr 5|Gliwice|ul. Kozielska 39 |44-121 Gliwice;1404;873;873;16;857;62.18;1.83
105013;246601;Zespół Szkolno - Przedszkolny nr 5|Gliwice|ul. Kozielska 39 |44-121 Gliwice;1649;1020;1020;8;1012;61.86;0.78
105014;246601;Zespół Szkolno - Przedszkolny nr 7|Gliwice|ul. Ligonia 36 |44-100 Gliwice;1305;890;890;10;880;68.20;1.12
105015;246601;Zespół Szkolno - Przedszkolny nr 4|Gliwice|ul. Paderewskiego 70 |44-105 Gliwice;1415;907;907;10;897;64.10;1.10
105016;246601;Zespół Szkolno - Przedszkolny nr 4|Gliwice|ul. Obrońców Pokoju 4 |44-105 Gliwice;1414;951;951;6;945;67.26;0.63
105017;246601;Zespół Szkolno - Przedszkolny nr 4|Gliwice|ul. Obrońców Pokoju 4 |44-105 Gliwice;1431;877;877;8;869;61.29;0.91
105018;246601;Szkoła Podstawowa nr 13|Gliwice|ul. Elsnera 25 |44-105 Gliwice;1322;899;899;14;885;68.00;1.56
105019;246601;Szkoła Podstawowa nr 13|Gliwice|ul. Elsnera 25 |44-105 Gliwice;1355;803;803;10;793;59.26;1.25
105020;246601;Zespół Szkół Ogólnokształcących nr 4|Gliwice|ul. Orląt Śląskich 25 |44-105 Gliwice;1060;629;629;7;622;59.34;1.11
105021;246601;Zespół Szkół Ogólnokształcących nr 4|Gliwice|ul. Orląt Śląskich 25 |44-105 Gliwice;1082;615;615;11;604;56.84;1.79
105022;246601;Przedszkole Miejskie nr 3|Gliwice|ul. Grottgera 23A |44-102 Gliwice;953;552;552;10;542;57.92;1.81
105023;246601;Szkoła Podstawowa nr 7|Gliwice|ul. Tarnogórska 59 |44-102 Gliwice;968;466;466;6;460;48.14;1.29
105024;246601;Szkoła Podstawowa nr 20|Gliwice|ul. Śliwki 8 |44-102 Gliwice;1306;543;543;12;531;41.58;2.21
105025;246601;Filia nr 20 Miejskiej Biblioteki Publicznej|Gliwice|ul. Bernardyńska 2 |44-102 Gliwice;1320;546;546;16;530;41.36;2.93
105026;246601;Szkoła Podstawowa nr 20|Gliwice|ul. Śliwki 8 |44-102 Gliwice;1343;516;516;18;498;38.42;3.49
105027;246601;Zespół Szkół Technicznych i Ogólokształcących|Gliwice|ul. Warszawska 35 |44-102 Gliwice;1018;584;584;14;570;57.37;2.40
105028;246601;Zespół Szkół Ogólnokształcących Specjalnych nr 7|Gliwice|ul. Gierymskiego 7 |44-102 Gliwice;1210;517;517;13;504;42.73;2.51
105029;246601;Szkoła Podstawowa nr 7|Gliwice|ul. Tarnogórska 59 |44-102 Gliwice;1635;1032;1032;18;1014;63.12;1.74
105030;246601;Szkoła Podstawowa nr 7|Gliwice|ul. Tarnogórska 59 |44-102 Gliwice;1670;894;894;16;878;53.53;1.79
105031;246601;Górnośląskie Centrum Edukacyjne|Gliwice|ul. Okrzei 20 |44-100 Gliwice;1549;904;904;18;886;58.36;1.99
105032;246601;Przedszkole Miejskie nr 18|Gliwice|ul. Brzozowa 50 |44-106 Gliwice;1701;881;881;13;868;51.79;1.48
105033;246601;Zespół Szkół Techniczno-Informatycznych|Gliwice|ul. Chorzowska 5 |44-106 Gliwice;1588;828;828;13;815;52.14;1.57
105034;246601;Zespół Szkół Ogólnokształcących nr 3|Gliwice|ul. Wróblewskiego 9 |44-106 Gliwice;1573;848;848;14;834;53.91;1.65
105035;246601;Gimnazjum nr 10|Gliwice|ul. Lipowa 29 |44-102 Gliwice;1424;726;726;16;710;50.98;2.20
105036;246601;Gimnazjum nr 10|Gliwice|ul. Lipowa 29 |44-102 Gliwice;1441;745;745;17;728;51.70;2.28
105037;246601;Gimnazjum nr 10|Gliwice|ul. Lipowa 29 |44-102 Gliwice;1311;721;721;22;699;55.00;3.05
105038;246601;Przedszkole Miejskie nr 4|Gliwice|ul. Barlickiego 16 |44-100 Gliwice;1121;604;604;12;592;53.88;1.99
105039;246601;Przedszkole Niepubliczne "Stokrotka"|Gliwice|ul. Studzienna 1 |44-100 Gliwice;1582;929;929;17;912;58.72;1.83
105040;246601;Szkoła Podstawowa nr 28|Gliwice|ul. Księdza Strzody 4 |44-100 Gliwice;1232;655;655;7;648;53.17;1.07
105041;246601;Szkoła Podstawowa nr 28|Gliwice|ul. Księdza Strzody 4 |44-101 Gliwice;1059;568;568;15;553;53.64;2.64
105042;246601;Zespół Szkół Gimnazjalnych|Gliwice|ul. Ziemowita 12 |44-100 Gliwice;1161;681;681;14;667;58.66;2.06
105043;246601;Zespół Szkół Ogólnokształcących nr 11|Gliwice|ul. Górnych Wałów 29 |44-100 Gliwice;1286;715;715;11;704;55.60;1.54
105044;246601;Zespół Szkół Ogólnokształcących nr 11|Gliwice|ul. Górnych Wałów 29 |44-100 Gliwice;1386;789;789;6;783;56.93;0.76
105045;246601;Szkoła Podstawowa nr 23|Gliwice|ul. Sikornik 1 |44-122 Gliwice;1211;685;685;5;680;56.56;0.73
105046;246601;Szkoła Podstawowa nr 9|Gliwice|ul. Jana III Sobieskiego 14 |44-100 Gliwice;1393;852;852;17;835;61.16;2.00
105047;246601;Szkoła Podstawowa z Oddziałami Integracyjnymi nr 21|Gliwice|ul. Reymonta 18a |44-103 Gliwice;1647;787;787;10;777;47.78;1.27
105048;246601;Szkoła Podstawowa z Oddziałami Integracyjnymi nr 21|Gliwice|ul. Reymonta 18a |44-103 Gliwice;1694;807;807;19;788;47.64;2.35
105049;246601;Szkoła Podstawowa z Oddziałami Integracyjnymi nr 21|Gliwice|ul. Reymonta 18a |44-103 Gliwice;1810;941;941;31;910;51.99;3.29
105050;246601;Szkoła Podstawowa z Oddziałami Integracyjnymi nr 21|Gliwice|ul. Reymonta 18a |44-103 Gliwice;1603;579;579;22;557;36.12;3.80
105051;246601;Przedszkole Miejskie nr 22|Gliwice|ul. Żeromskiego 26 |44-119 Gliwice;809;338;338;18;320;41.78;5.33
105052;246601;Szkoła Podstawowa nr 14|Gliwice|ul. Jedności 35 |44-119 Gliwice;1244;668;668;14;654;53.70;2.10
105053;246601;Szkoła Podstawowa nr 14|Gliwice|ul. Jedności 35 |44-119 Gliwice;1246;626;626;9;617;50.24;1.44
105054;246601;Zespół Szkół Ogólnokształcących nr 14|Gliwice|ul. Przedwiośnie 2 |44-119 Gliwice;1554;801;801;12;789;51.54;1.50
105055;246601;Zespół Szkół Ogólnokształcących nr 14|Gliwice|ul. Przedwiośnie 2 |44-119 Gliwice;1596;851;851;10;841;53.32;1.18
105056;246601;Zespół Przedszkoli Miejskich nr 1|Gliwice|ul. Wiślana 12 |44-119 Gliwice;1366;724;724;12;712;53.00;1.66
105057;246601;Zespół Przedszkoli Miejskich nr 1|Gliwice|ul. Młodopolska 4 |44-119 Gliwice;1041;526;526;8;518;50.53;1.52
105058;246601;Szkoła Podstawowa nr 11|Gliwice|ul. Pocztowa 31 |44-100 Gliwice;1627;741;741;12;729;45.54;1.62
105059;246601;Zespół Szkolno - Przedszkolny nr 6|Gliwice|ul. Sportowa 17 |44-100 Gliwice;1587;534;534;12;522;33.65;2.25
105060;246601;Zespół Szkolno - Przedszkolny nr 6|Gliwice|ul. Robotnicza 6 |44-101 Gliwice;651;314;314;5;309;48.23;1.59
105061;246601;Politechnika Śląska Kolegium Pedagogiczne|Gliwice|ul. Hutnicza 9-9A |44-100 Gliwice;1205;547;547;14;533;45.39;2.56
105062;246601;Politechnika Śląska Kolegium Pedagogiczne|Gliwice|ul. Hutnicza 9-9A |44-100 Gliwice;1348;572;572;12;560;42.43;2.10
105063;246601;Politechnika Śląska Wydział Automatyki, Elektroniki i Informatyki|Gliwice|ul. Akademicka 16 |44-100 Gliwice;917;504;504;9;495;54.96;1.79
105064;246601;Szkoła Podstawowa nr 28|Gliwice|ul. Księdza Strzody 4 |44-100 Gliwice;902;479;479;3;476;53.10;0.63
105065;246601;Zespół Szkół Ogólnokształcących nr 10|Gliwice|ul. Zimnej Wody 8 |44-100 Gliwice;733;411;411;11;400;56.07;2.68
105066;246601;Zespół Szkół Ogólnokształcących nr 10|Gliwice|ul. Zimnej Wody 8 |44-100 Gliwice;792;464;464;4;460;58.59;0.86
105067;246601;Szkoła Podstawowa nr 8|Gliwice|ul. Spacerowa 6 |44-141 Gliwice;1082;621;621;11;610;57.39;1.77
105068;246601;Szkoła Podstawowa nr 8|Gliwice|ul. Spacerowa 6 |44-141 Gliwice;1207;667;667;17;650;55.26;2.55
105069;246601;Szkoła Podstawowa nr 2|Gliwice|ul. Goździkowa 2 |44-152 Gliwice;974;499;499;11;488;51.23;2.20
105070;246601;Szkoła Podstawowa z Oddziałami Integracyjnymi nr 3|Gliwice|ul. Daszyńskiego 424 |44-151 Gliwice;1174;605;605;12;593;51.53;1.98
105071;246601;Szkoła Podstawowa z Oddziałami Integracyjnymi nr 3|Gliwice|ul. Daszyńskiego 424 |44-151 Gliwice;1227;551;551;12;539;44.91;2.18
105072;246601;Zespół Szkół Ogólnokształcących nr 12|Gliwice|ul. Płocka 16 |44-164 Gliwice;987;523;523;9;514;52.99;1.72
105073;246601;Zespół Szkół Ogólnokształcących nr 12|Gliwice|ul. Płocka 16 |44-164 Gliwice;945;518;518;14;504;54.81;2.70
105074;246601;Zespół Szkół Ogólnokształcących nr 13|Gliwice|ul. Gomułki 16a |44-121 Gliwice;1719;1107;1107;10;1097;64.40;0.90
105075;246601;Zespół Szkół Ogólnokształcących nr 13|Gliwice|ul. Gomułki 16a |44-121 Gliwice;1837;1234;1234;7;1227;67.17;0.57
105076;246601;Zespół Szkół Ogólnokształcących nr 13|Gliwice|ul. Gomułki 16a |44-121 Gliwice;1642;1121;1121;15;1106;68.27;1.34
105077;246601;Zespół Szkół Specjalnych|Gliwice|ul. Dolnej Wsi 74 |44-100 Gliwice;1692;932;932;16;916;55.08;1.72
105078;246601;Zespół Szkolno - Przedszkolny nr 7|Gliwice|ul. Ligonia 36 |44-100 Gliwice;1416;843;843;6;837;59.53;0.71
105079;246601;Zespół Szkolno - Przedszkolny nr 7|Gliwice|ul. Mickiewicza 65 |44-100 Gliwice;807;546;546;9;537;67.66;1.65
105080;246601;Szkoła Podstawowa nr 9|Gliwice|ul. Jana III Sobieskiego 14 |44-100 Gliwice;866;553;553;4;549;63.86;0.72
105081;246601;Zespół Szkolno - Przedszkolny nr 3|Gliwice|ul. Pszczyńska 18 |44-100 Gliwice;1252;638;638;8;630;50.96;1.25
105082;246601;Zespół Szkolno - Przedszkolny nr 3|Gliwice|ul. Pszczyńska 18 |44-100 Gliwice;1423;862;862;10;852;60.58;1.16
105083;246601;Zespół Szkół Budowlano - Ceramicznych|Gliwice|ul. Bojkowska 16 |44-122 Gliwice;1148;505;505;14;491;43.99;2.77
105084;246601;Zespół Szkół Budowlano - Ceramicznych|Gliwice|ul. Bojkowska 16 |44-122 Gliwice;1353;782;782;7;775;57.80;0.90
105085;246601;Zespół Szkolno - Przedszkolny nr 3|Gliwice|ul. Żwirki i Wigury 85 |44-122 Gliwice;900;498;498;9;489;55.33;1.81
105086;246601;Zespół Szkolno - Przedszkolny nr 1|Gliwice|ul. Kilińskiego 1 |44-122 Gliwice;1558;748;748;16;732;48.01;2.14
105087;246601;Zespół Szkół Samochodowych|Gliwice|ul. Kilińskiego 24a |44-122 Gliwice;834;361;361;6;355;43.29;1.66
105088;246601;Gimnazjum nr 4|Gliwice|ul. Asnyka 36 |44-122 Gliwice;1075;610;610;10;600;56.74;1.64
105089;246601;Gimnazjum nr 4|Gliwice|ul. Asnyka 36 |44-122 Gliwice;1182;706;706;3;703;59.73;0.42
105090;246601;Zespół Szkolno - Przedszkolny nr 3|Gliwice|ul. Żwirki i Wigury 85 |44-122 Gliwice;1337;793;793;8;785;59.31;1.01
105091;246601;Przedszkole Miejskie nr 6|Gliwice|ul. Młodych Patriotów 10 |44-122 Gliwice;1086;647;647;11;636;59.58;1.70
105092;246601;Przedszkole Miejskie nr 6|Gliwice|ul. Młodych Patriotów 10 |44-122 Gliwice;1607;956;956;7;949;59.49;0.73
105093;246601;Szkoła Podstawowa nr 23|Gliwice|ul. Sikornik 1 |44-122 Gliwice;1150;697;697;10;687;60.61;1.43
105094;246601;Szkoła Podstawowa nr 23|Gliwice|ul. Sikornik 1 |44-122 Gliwice;1029;519;519;5;514;50.44;0.96
105095;246601;Zespół Szkół Ogólnokształcących nr 5|Gliwice|ul. Sikornik 34 |44-122 Gliwice;1410;805;805;6;799;57.09;0.75
105096;246601;Zespół Szkół Ogólnokształcących nr 5|Gliwice|ul. Sikornik 34 |44-122 Gliwice;1411;884;884;10;874;62.65;1.13
105097;246601;Zespół Szkół Ogólnokształcących nr 5|Gliwice|ul. Sikornik 34 |44-122 Gliwice;1634;923;923;15;908;56.49;1.63
105098;246601;Szkoła Podstawowa nr 41|Gliwice|ul. Kormoranów 23 |44-122 Gliwice;1302;820;820;10;810;62.98;1.22
105099;246601;Szkoła Podstawowa nr 41|Gliwice|ul. Kormoranów 23 |44-122 Gliwice;1296;715;715;17;698;55.17;2.38
105100;246601;Szkoła Podstawowa nr 41|Gliwice|ul. Kormoranów 23 |44-122 Gliwice;1335;795;795;12;783;59.55;1.51
105101;246601;Szpital Wielospecjalistyczny Sp. z o.o.|Gliwice|Kościuszki 1 |44-100 Gliwice;50;24;24;1;23;48.00;4.17
105102;246601;Gliwickie Centrum Medyczne Sp. z o.o.|Gliwice|Kościuszki 29 |44-100 Gliwice;55;22;22;1;21;40.00;4.55
105103;246601;Szpital Miejski nr 4 Sp. z o.o.|Gliwice|Zygmunta Starego 20 |44-100 Gliwice;77;31;31;1;30;40.26;3.23
105104;246601;VITO - MED Sp. z o.o.|Gliwice|Radiowa 2 |44-100 Gliwice;55;20;20;0;20;36.36;0.00
105105;246601;VITO - MED Sp. z o.o. Zakład Opiekuńczo-Leczniczy|Gliwice|Kozielska 8 |44-100 Gliwice;61;10;10;3;7;16.39;30.00
105106;246601;Niepubliczny Zakład Opieki Zdrowotnej - Hospicjum Miłosierdzia Bożego|Gliwice|Daszyńskiego 29 |44-100 Gliwice;25;9;9;0;9;36.00;0.00
105107;246601;Centrum Onkologii - Instytut im. Marii Skłodowskiej-Curie Oddział w Gliwicach|Gliwice|Wybrzeże Armii Krajowej 15 |44-100 Gliwice;260;112;112;6;106;43.08;5.36
105108;246601;Dom Pomocy Społecznej "OPOKA"|Gliwice|Pszczyńska 100 |44-100 Gliwice;51;22;22;1;21;43.14;4.55
105109;246601;Dom Pomocy Społecznej "NASZ DOM"|Gliwice|Derkacza 10 |44-100 Gliwice;114;64;64;14;50;56.14;21.88
105110;246601;Areszt Śledczy w Gliwicach|Gliwice|Wieczorka 10 |44-100 Gliwice;322;198;198;29;169;61.49;14.65
105111;246701;Zespół Szkół Nr 8|Jastrzębie-Zdrój|ul. Edukacyjna 13 |44-335 Jastrzębie-Zdrój;2096;1162;1162;17;1145;55.44;1.46
105112;246701;Zespół Szkół Nr 12|Jastrzębie-Zdrój|Os. 1000-lecia 9 |44-335 Jastrzębie-Zdrój;2231;1180;1180;39;1141;52.89;3.31
105113;246701;Zespół Szkół Nr 12|Jastrzębie-Zdrój|Os. 1000-lecia 9 |44-335 Jastrzębie-Zdrój;2017;818;818;26;792;40.56;3.18
105114;246701;Szkoła Podstawowa Nr 1|Jastrzębie-Zdrój|ul. Pszczyńska 125 |44-335 Jastrzębie-Zdrój;1351;880;880;15;865;65.14;1.70
105115;246701;Szkoła Podstawowa Nr 1|Jastrzębie-Zdrój|ul. Pszczyńska 125 |44-335 Jastrzębie-Zdrój;1381;838;838;20;818;60.68;2.39
105116;246701;Publiczne Przedszkole Nr 16|Jastrzębie-Zdrój|ul. Ruchu Oporu 25 |44-335 Jastrzębie-Zdrój;1823;1047;1047;25;1022;57.43;2.39
105117;246701;Publiczne Przedszkole nr 16|Jastrzębie-Zdrój|ul. Ruchu Oporu 25 |44-335 Jastrzębie-Zdrój;1548;759;759;15;744;49.03;1.98
105118;246701;Dom Strażaka|Jastrzębie-Zdrój|ul. Rostków 7 |44-335 Jastrzębie-Zdrój;1966;1222;1222;35;1187;62.16;2.86
105119;246701;Zespół Szkół Nr 13|Jastrzębie-Zdrój|ul. Świerczewskiego 34 |44-335 Jastrzębie-Zdrój;1092;588;588;27;561;53.85;4.59
105120;246701;Gimnazjum Nr 8|Jastrzębie-Zdrój|ul. Katowicka 35 |44-335 Jastrzębie-Zdrój;1619;950;950;22;928;58.68;2.32
105121;246701;Gimnazjum Nr 8|Jastrzębie-Zdrój|ul. Katowicka 35 |44-335 Jastrzębie-Zdrój;1645;985;985;16;969;59.88;1.62
105122;246701;Zespół Szkół Nr 2|Jastrzębie-Zdrój|ul. Poznańska 1A |44-335 Jastrzębie-Zdrój;2231;1287;1287;25;1262;57.69;1.94
105123;246701;Zespół Szkół Nr 2|Jastrzębie-Zdrój|ul. Poznańska 1A |44-335 Jastrzębie-Zdrój;2219;1337;1337;21;1316;60.25;1.57
105124;246701;Zespół Szkół Mistrzostwa Sportowego|Jastrzębie-Zdrój|ul. Piastów 15 |44-335 Jastrzębie-Zdrój;1631;768;768;32;736;47.09;4.17
105125;246701;Zespół Szkół Mistrzostwa Sportowego|Jastrzębie-Zdrój|ul. Piastów 15 |44-335 Jastrzębie-Zdrój;1672;627;627;20;607;37.50;3.19
105126;246701;Zespół Szkół Mistrzostwa Sportowego|Jastrzębie-Zdrój|ul. Piastów 15 |44-335 Jastrzębie-Zdrój;1145;658;658;15;643;57.47;2.28
105127;246701;Szkoła Podstawowa Nr 4|Jastrzębie-Zdrój|ul. Tadeusza Kościuszki 19 |44-335 Jastrzębie-Zdrój;2183;1016;1016;25;991;46.54;2.46
105128;246701;Szkoła Podstawowa Nr 4|Jastrzębie-Zdrój|ul. Tadeusza Kościuszki 19 |44-335 Jastrzębie-Zdrój;1954;1119;1119;21;1098;57.27;1.88
105129;246701;Zespół Szkół Zawodowych|Jastrzębie-Zdrój|ul. 11 Listopada 45 |44-335 Jastrzębie-Zdrój;1828;989;989;27;962;54.10;2.73
105130;246701;Szkoła Podstawowa Nr 9|Jastrzębie-Zdrój|ul. Wielkopolska 22 |44-335 Jastrzębie-Zdrój;1906;997;997;20;977;52.31;2.01
105131;246701;Szkoła Podstawowa nr 9|Jastrzębie-Zdrój|ul. Wielkopolska 22 |44-335 Jastrzębie-Zdrój;2056;1062;1062;13;1049;51.65;1.22
105132;246701;Szkoła Podstawowa nr 9|Jastrzębie-Zdrój|ul. Wielkopolska 22 |44-335 Jastrzębie-Zdrój;1867;1011;1011;24;987;54.15;2.37
105133;246701;Zespół Szkół nr 11|Jastrzębie-Zdrój|ul. Bronisława Czecha 20A |44-335 Jastrzębie-Zdrój;2135;1173;1173;17;1156;54.94;1.45
105134;246701;Zespół Szkół nr 11|Jastrzębie-Zdrój|ul. Bronisława Czecha 20A |44-335 Jastrzębie-Zdrój;1983;1140;1140;35;1105;57.49;3.07
105135;246701;Szkoła Podstawowa Nr 16|Jastrzębie-Zdrój|ul. Komuny Paryskiej 18C |44-335 Jastrzębie-Zdrój;1717;936;936;24;912;54.51;2.56
105136;246701;Szkoła Podstawowa Nr 16|Jastrzębie-Zdrój|ul. Komuny Paryskiej 18C |44-335 Jastrzębie-Zdrój;1560;810;810;19;791;51.92;2.35
105137;246701;Szkoła Podstawowa nr 17|Jastrzębie-Zdrój|ul. ks. Emanuela Płonki 23 |44-335 Jastrzębie-Zdrój;1381;745;745;17;728;53.95;2.28
105138;246701;Szkoła Podstawowa nr 17|Jastrzębie-Zdrój|ul. ks. Emanuela Płonki 23 |44-335 Jastrzębie-Zdrój;1656;923;923;19;904;55.74;2.06
105139;246701;Szkoła Podstawowa nr 6|Jastrzębie-Zdrój|ul. Śląska 6 |44-335 Jastrzębie-Zdrój;1807;894;894;22;872;49.47;2.46
105140;246701;Szkoła Podstawowa Nr 6|Jastrzębie-Zdrój|ul. Śląska 6 |44-335 Jastrzębie-Zdrój;1725;888;888;9;879;51.48;1.01
105141;246701;Szkoła Podstawowa nr 5|Jastrzębie-Zdrój|ul. Mazurska 6 |44-335 Jastrzębie-Zdrój;1460;736;736;14;722;50.41;1.90
105142;246701;Publiczne Przedszkole nr 5|Jastrzębie-Zdrój|ul. Kaszubska 4 |44-335 Jastrzębie-Zdrój;1678;862;862;24;838;51.37;2.78
105143;246701;Publiczne Przedszkole nr 5|Jastrzębie-Zdrój|ul. Kaszubska 4 |44-335 Jastrzębie-Zdrój;1770;919;919;12;907;51.92;1.31
105144;246701;Szkoła Podstawowa Nr 10|Jastrzębie-Zdrój|ul. Zielona 2A |44-335 Jastrzębie-Zdrój;1535;834;834;27;807;54.33;3.24
105145;246701;Szkoła Podstawowa Nr 10|Jastrzębie-Zdrój|ul. Zielona 2A |44-335 Jastrzębie-Zdrój;1850;1036;1036;16;1020;56.00;1.54
105146;246701;Szkoła Podstawowa Nr 10|Jastrzębie-Zdrój|ul. Zielona 2A |44-335 Jastrzębie-Zdrój;1374;788;788;19;769;57.35;2.41
105147;246701;Zespół Szkół Nr 1|Jastrzębie-Zdrój|ul. Graniczna 2 |44-335 Jastrzębie-Zdrój;1510;830;830;22;808;54.97;2.65
105148;246701;Zespół Szkół Nr 1|Jastrzębie-Zdrój|ul. Graniczna 2 |44-335 Jastrzębie-Zdrój;1551;852;852;13;839;54.93;1.53
105149;246701;Szkoła Podstawowa nr 12|Jastrzębie-Zdrój|ul. Szkolna 7 |44-335 Jastrzębie-Zdrój;2137;1153;1153;27;1126;53.95;2.34
105150;246701;Szkoła Podstawowa nr 12|Jastrzębie-Zdrój|ul. Szkolna 7 |44-335 Jastrzębie-Zdrój;2209;1260;1260;24;1236;57.04;1.90
105151;246701;Zakład Karny|Jastrzębie-Zdrój|Norwida 23 |44-268 Jastrzębie-Zdrój;767;243;243;38;205;31.68;15.64
105152;246701;Wojewódzki Szpital Specjalistyczny nr 2|Jastrzębie-Zdrój|Al. Jana Pawła II 7 |44-330 Jastrzębie-Zdrój;155;109;109;1;108;70.32;0.92
105153;246701;Wojewódzki Szpital Specjalistyczny nr 2|Jastrzębie-Zdrój|Krasickiego 21 |44-330 Jastrzębie-Zdrój;89;26;26;0;26;29.21;0.00
105154;246701;Dom Pomocy Społecznej|Jastrzębie-Zdrój|Kaszubska 6 |44-335 Jastrzębie-Zdrój;32;22;22;1;21;68.75;4.55
105155;246701;Leczniczo – Rehabilitacyjny NZOZ „Orthogon”|Jastrzębie-Zdrój|Wodeckiego 23 |44-335 Jastrzębie-Zdrój;24;24;24;4;20;100.00;16.67
105156;246801;Sala lustrzana w Hali Widowiskowo - Sportowej MCKiS /wejście od ul. Farnej/|Jaworzno|ul. Grunwaldzka 80 |43-600 Jaworzno;1576;928;928;17;911;58.88;1.83
105157;246801;Gimnazjum nr 1|Jaworzno|ul. Urzędnicza 11 |43-600 Jaworzno;1512;885;885;23;862;58.53;2.60
105158;246801;Gimnazjum nr 1|Jaworzno|ul. Urzędnicza 11 |43-600 Jaworzno;1670;659;659;5;654;39.46;0.76
105159;246801;Zespół Szkolno - Przedszkolny nr 1|Jaworzno|ul. Matejki 3 |43-600 Jaworzno;1728;909;909;21;888;52.60;2.31
105160;246801;Zespół Szkolno - Przedszkolny nr 1|Jaworzno|ul. Matejki 3 |43-600 Jaworzno;1874;764;764;18;746;40.77;2.36
105161;246801;Przedszkole Miejskie nr 1|Jaworzno|ul. Szymanowskiego 10 |43-600 Jaworzno;1546;601;601;17;584;38.87;2.83
105162;246801;Zespół Szkół Ponadgimnazjalnych nr 3|Jaworzno|ul. Północna 9a |43-600 Jaworzno;1487;785;785;22;763;52.79;2.80
105163;246801;I Liceum Ogólnokształcące|Jaworzno|ul. Licealna 3 |43-600 Jaworzno;1493;747;747;18;729;50.03;2.41
105164;246801;Szkoła Podstawowa nr 16|Jaworzno|ul. 3 Maja 18 |43-600 Jaworzno;1932;986;986;21;965;51.04;2.13
105165;246801;Szkoła Podstawowa nr 16|Jaworzno|ul. 3 Maja 18 |43-600 Jaworzno;1874;969;969;24;945;51.71;2.48
105166;246801;Gimnazjum nr 3|Jaworzno|ul. Lipowa 24 |43-600 Jaworzno;1894;870;870;20;850;45.93;2.30
105167;246801;Gimnazjum nr 3|Jaworzno|ul. Lipowa 24 |43-600 Jaworzno;1977;1012;1012;22;990;51.19;2.17
105168;246801;Gimnazjum nr 3|Jaworzno|ul. Lipowa 24 |43-600 Jaworzno;1806;879;879;17;862;48.67;1.93
105169;246801;Szkoła Podstawowa nr 3|Jaworzno|ul. Kasprzaka 6 |43-600 Jaworzno;657;329;329;12;317;50.08;3.65
105170;246801;Szkoła Podstawowa nr 7|Jaworzno|ul. Ławczana 12 |43-600 Jaworzno;1616;832;832;17;815;51.49;2.04
105171;246801;Szkoła Podstawowa Nr 7|Jaworzno|ul. Ławczana 12 |43-600 Jaworzno;1524;768;768;12;756;50.39;1.56
105172;246801;Zespół Szkół Ogólnokształcących|Jaworzno|ul. Towarowa 61 |43-600 Jaworzno;1819;998;998;19;979;54.87;1.90
105173;246801;Zespół Szkół Ogólnokształcących|Jaworzno|ul. Towarowa 61 |43-600 Jaworzno;2235;1175;1175;18;1157;52.57;1.53
105174;246801;Szkoła Podstawowa nr 15|Jaworzno|ul. Leśna 49 |43-600 Jaworzno;2081;1191;1191;23;1168;57.23;1.93
105175;246801;Gimnazjum nr 11|Jaworzno|ul. Sobieskiego 61 |43-600 Jaworzno;1315;627;627;15;612;47.68;2.39
105176;246801;Zespół Szkół nr 3|Jaworzno|ul. Koszarowa 20 |43-600 Jaworzno;1961;990;990;22;968;50.48;2.22
105177;246801;Przedszkole Miejskie nr 17|Jaworzno|ul. Kościuszki 6 |43-600 Jaworzno;1583;628;628;17;611;39.67;2.71
105178;246801;Szkoła Podstawowa nr 9|Jaworzno|ul. Batorego 48 |43-600 Jaworzno;1866;1005;1005;10;995;53.86;1.00
105179;246801;Zespół Szkolno Przedszkolny nr 2|Jaworzno|ul. Chropaczówka 101 |43-600 Jaworzno;1517;832;832;36;796;54.85;4.33
105180;246801;Szkoła Podstawowa Nr 3|Jaworzno|ul. Kasprzaka 6 |43-600 Jaworzno;1106;613;613;7;606;55.42;1.14
105181;246801;Szkoła Podstawowa nr 5|Jaworzno|ul. Puszkina 5 |43-600 Jaworzno;1503;657;657;17;640;43.71;2.59
105182;246801;II Liceum Ogólnokształcące|Jaworzno|ul. M. Curie-Skłodowskiej 6 |43-600 Jaworzno;1709;802;802;22;780;46.93;2.74
105183;246801;Zespół Szkół Ponadgimnazjalnych nr 4|Jaworzno|ul. Armii Krajowej 5 |43-600 Jaworzno;1662;750;750;24;726;45.13;3.20
105184;246801;Zespół Szkół Ponadgimnazjalnych nr 4|Jaworzno|ul. Armii Krajowej 5 |43-600 Jaworzno;1788;990;990;14;976;55.37;1.41
105185;246801;Gimnazjum Nr 5|Jaworzno|ul. Starowiejska 15 |43-600 Jaworzno;1944;1137;1137;13;1124;58.49;1.14
105186;246801;Zespół Szkół Ponadgimnazjalnych nr 2|Jaworzno|ul. Inwalidów Wojennych 16 |43-600 Jaworzno;499;166;166;7;159;33.27;4.22
105187;246801;Zespół Szkół nr 4|Jaworzno|ul. Spółdzielcza 9 |43-600 Jaworzno;2187;1266;1266;13;1253;57.89;1.03
105188;246801;Przedszkole Miejskie nr 24|Jaworzno|ul. Czwartaków 1 |43-600 Jaworzno;1849;991;991;26;965;53.60;2.62
105189;246801;Szkoła Podstawowa nr 18|Jaworzno|ul. ks. Andrzeja Mroczka 53c |43-600 Jaworzno;2181;1212;1212;29;1183;55.57;2.39
105190;246801;Szkoła Podstawowa nr 18|Jaworzno|ul. ks. Andrzeja Mroczka 53c |43-600 Jaworzno;2045;1034;1034;38;996;50.56;3.68
105191;246801;Szkoła Podstawowa nr 19|Jaworzno|ul. Kasztanowa 33 |43-600 Jaworzno;1699;910;910;17;893;53.56;1.87
105192;246801;Przedszkole Miejskie nr 18|Jaworzno|ul. Korczyńskiego 12 |43-600 Jaworzno;1619;960;962;15;945;59.30;1.56
105193;246801;Klub Środowiskowy "NIKO"|Jaworzno|ul. Korczyńskiego 10 |43-600 Jaworzno;2082;1156;1156;21;1135;55.52;1.82
105194;246801;Dom Kultury|Jaworzno|ul. Wiosny Ludów 1 |43-600 Jaworzno;2335;1353;1353;30;1323;57.94;2.22
105195;246801;Gimnazjum nr 8|Jaworzno|ul. Zwycięstwa 30 |43-600 Jaworzno;1665;872;872;22;850;52.37;2.52
105196;246801;Szkoła Podstawowa nr 14|Jaworzno|ul. Niemcewicza 7a |43-600 Jaworzno;2014;1131;1131;26;1105;56.16;2.30
105197;246801;Gimnazjum nr 2|Jaworzno|ul. Olszewskiego 76 |43-600 Jaworzno;961;556;556;9;547;57.86;1.62
105198;246801;Przedszkole Miejskie nr 15|Jaworzno|ul. Azot 16 |43-600 Jaworzno;1707;796;796;22;774;46.63;2.76
105199;246801;Szkoła Podstawowa nr 15|Jaworzno|ul. Leśna 49 |43-600 Jaworzno;1221;736;736;7;729;60.28;0.95
105200;246801;Dom Pomocy Społecznej|Jaworzno|Obrońców Poczty Gdańskiej 63 |43-600 Jaworzno;100;35;35;8;27;35.00;22.86
105201;246801;SP ZOZ Szpital Wielospecjalistyczny|Jaworzno|Chełmońskiego 28 |43-600 Jaworzno;167;74;74;3;71;44.31;4.05
105202;246901;Zakłady Metalowe "ZA-MET" Sp. z o.o.|Katowice|ul. Panewnicka 375 |40-773 Katowice;1998;1348;1348;11;1337;67.47;0.82
105203;246901;Szkoła Podstawowa nr 9|Katowice|ul. Panewnicka 172 |40-772 Katowice;1975;1350;1350;16;1334;68.35;1.19
105204;246901;Przedszkole nr 99|Katowice|ul. Płochy 6 |40-755 Katowice;1980;1255;1255;34;1221;63.38;2.71
105205;246901;Szkoła Podstawowa nr 67|Katowice|ul. Zielona 5 |40-756 Katowice;1724;998;998;10;988;57.89;1.00
105206;246901;Szkoła Podstawowa nr 67|Katowice|ul. Zielona 5 |40-756 Katowice;1312;920;920;10;910;70.12;1.09
105207;246901;Gimnazjum nr 23|Katowice|ul. Medyków 27 |40-751 Katowice;1967;1305;1305;13;1292;66.34;1.00
105208;246901;VII Liceum Ogólnokształcące|Katowice|ul. Panewnicka 13 |40-709 Katowice;2145;1120;1120;11;1109;52.21;0.98
105209;246901;VII Liceum Ogólnokształcące|Katowice|ul. Panewnicka 13 |40-709 Katowice;2120;1181;1181;17;1164;55.71;1.44
105210;246901;Szkoła Podstawowa nr 34|Katowice|ul. Zielonogórska 3 |40-710 Katowice;2023;1167;1167;57;1110;57.69;4.88
105211;246901;Gimnazjum nr 21|Katowice|ul. Zielonogórska 23 |40-710 Katowice;1752;886;886;9;877;50.57;1.02
105212;246901;Zespół Szkół Specjalnych nr 12|Katowice|ul. Kołobrzeska 8 |40-718 Katowice;982;611;611;10;601;62.22;1.64
105213;246901;Przedszkole nr 76|Katowice|ul. Kołobrzeska 20a |40-718 Katowice;1504;904;904;16;888;60.11;1.77
105214;246901;Przedszkole nr 89|Katowice|ul. Zadole 26a |40-719 Katowice;1455;912;912;10;902;62.68;1.10
105215;246901;Szkoła Podstawowa nr 11|Katowice|ul. Nasypowa 16 |40-551 Katowice;975;571;571;3;568;58.56;0.53
105216;246901;Dom Pomocy Społecznej "Zacisze"|Katowice|ul. Traktorzystów 42 |40-695 Katowice;1707;1090;1090;12;1078;63.85;1.10
105217;246901;Zespół Szkolno-Przedszkolny nr 2|Katowice|ul. Sobańskiego 86 |40-685 Katowice;1291;771;771;7;764;59.72;0.91
105218;246901;Zespół Szkolno-Przedszkolny nr 2|Katowice|ul. Sobańskiego 86 |40-685 Katowice;1978;1283;1283;15;1268;64.86;1.17
105219;246901;Zespół Szkół Poligraficzno-Mechanicznych|Katowice|ul. Armii Krajowej 84 |40-671 Katowice;1234;734;734;14;720;59.48;1.91
105220;246901;Gimnazjum nr 20|Katowice|ul. Gen. W. Jankego 160 |40-613 Katowice;1592;1048;1048;9;1039;65.83;0.86
105221;246901;Gimnazjum nr 20|Katowice|ul. Gen. W. Jankego 160 |40-613 Katowice;1912;1085;1085;7;1078;56.75;0.65
105222;246901;V Liceum Ogólnokształcące|Katowice|ul. Gen. W. Jankego 65 |40-615 Katowice;1882;1197;1197;25;1172;63.60;2.09
105223;246901;Gimnazjum nr 19|Katowice|ul. Spółdzieczości 21 |40-642 Katowice;2102;1315;1315;17;1298;62.56;1.29
105224;246901;Szkoła Podstawowa nr 27|Katowice|ul. Łętowskiego 18 |40-648 Katowice;1980;1209;1209;13;1196;61.06;1.08
105225;246901;Szkoła Podstawowa nr 27|Katowice|ul. Łętowskiego 18 |40-648 Katowice;2088;1318;1318;21;1297;63.12;1.59
105226;246901;Przedszkole nr 93|Katowice|ul. Łętowskiego 24 |40-648 Katowice;1907;1203;1203;21;1182;63.08;1.75
105227;246901;Miejski Dom Kultury "Południe" Filia w Zarzeczu|Katowice|ul. Stellera 4 |40-748 Katowice;1883;1280;1280;8;1272;67.98;0.62
105228;246901;Dom Katechetyczny|Katowice|ul. Boya Żeleńskiego 34 wejście od ul. Migdałowców |40-750 Katowice;1479;1003;1003;10;993;67.82;1.00
105229;246901;Dom Katechetyczny|Katowice|ul. Boya Żeleńskiego 34 wejście od ul. Migdałowców |40-750 Katowice;1597;1047;1047;20;1027;65.56;1.91
105230;246901;Dom Katechetyczny|Katowice|ul. Boya Żeleńskiego 34 wejście od ul. Migdałowców |40-750 Katowice;1681;1054;1054;17;1037;62.70;1.61
105231;246901;Miejski Dom Kultury "Południe"|Katowice|ul. Boya Żeleńskiego 83 |40-750 Katowice;968;497;497;19;478;51.34;3.82
105232;246901;Miejski Dom Kultury "Południe"|Katowice|ul. Boya Żeleńskiego 83 |40-750 Katowice;1450;758;758;26;732;52.28;3.43
105233;246901;Szkoła Podstawowa nr 21|Katowice|ul. Malczewskiego 1 |40-748 Katowice;2284;1488;1488;14;1474;65.15;0.94
105234;246901;Szkoła Podstawowa nr 21|Katowice|ul. Malczewskiego 1 |40-748 Katowice;799;537;537;4;533;67.21;0.74
105235;246901;Szkoła Podstawowa nr 21|Katowice|ul. Malczewskiego 1 |40-748 Katowice;1615;1023;1023;14;1009;63.34;1.37
105236;246901;Zespół Szkół nr 2|Katowice|ul. Goetla 2 |40-749 Katowice;1573;1016;1016;11;1005;64.59;1.08
105237;246901;Zespół Szkół nr 2|Katowice|ul. Goetla 2 |40-749 Katowice;1435;794;794;24;770;55.33;3.02
105238;246901;Miejski Dom Kultury "Południe" Filia Murcki|Katowice|ul. Kołodzieja 42 |40-749 Katowice;1318;680;680;16;664;51.59;2.35
105239;246901;Centrum Kształcenia Zawodowego i Ustawicznego Województwa Śląskiego w Katowicach|Katowice|ul. Wiertnicza 3 |40-304 Katowice;2209;1240;1240;23;1217;56.13;1.85
105240;246901;Zespół Szkolno-Przedszkolny nr 3|Katowice|ul. Grzegorzka 4 |40-309 Katowice;1053;481;481;20;461;45.68;4.16
105241;246901;Zespół Szkolno-Przedszkolny nr 3|Katowice|ul. Grzegorzka 4 |40-309 Katowice;935;513;513;13;500;54.87;2.53
105242;246901;Zespół Szkół Handlowych|Katowice|ul. Gen. J. Hallera 60 |40-320 Katowice;1432;640;640;11;629;44.69;1.72
105243;246901;Gimnazjum nr 11|Katowice|ul. Deszczowa 14 |40-318 Katowice;1450;792;792;20;772;54.62;2.53
105244;246901;Szkoła Podstawowa nr 45|Katowice|ul. Korczaka 11 |40-321 Katowice;1084;462;462;9;453;42.62;1.95
105245;246901;Szkoła Podstawowa nr 44|Katowice|ul. Morawa 86 |40-353 Katowice;1592;757;757;24;733;47.55;3.17
105246;246901;Szkoła Podstawowa nr 42|Katowice|ul. Wiosny Ludów 22 |40-374 Katowice;1984;818;818;34;784;41.23;4.16
105247;246901;Szkoła Podstawowa nr 42|Katowice|ul. Wiosny Ludów 22 |40-374 Katowice;1353;481;481;25;456;35.55;5.20
105248;246901;Zespół Szkół Przemysłu Spożywczego|Katowice|ul. Bednorza 15 |40-358 Katowice;1197;410;410;11;399;34.25;2.68
105249;246901;Zespół Szkół Przemysłu Spożywczego|Katowice|ul. Bednorza 15 |40-384 Katowice;1645;593;593;5;588;36.05;0.84
105250;246901;Gimnazjum nr 14|Katowice|ul. Oswobodzenia 47 |40-404 Katowice;1984;801;801;14;787;40.37;1.75
105251;246901;Przedszkole nr 63|Katowice|ul. Zamkowa 10 |40-413 Katowice;1642;802;802;25;777;48.84;3.12
105252;246901;Szkoła Podstawowa nr 53|Katowice|Pl. Wyzwolenia 18 |40-423 Katowice;1453;727;727;11;716;50.03;1.51
105253;246901;Szkoła Podstawowa nr 53|Katowice|Pl. Wyzwolenia 18 |40-423 Katowice;1360;598;598;8;590;43.97;1.34
105254;246901;Budynek Szkoły Podstawowej nr 53|Katowice|ul. Szopienicka 58a |40-431 Katowice;1880;993;993;16;977;52.82;1.61
105255;246901;Gimnazjum nr 15|Katowice|ul. Karliczka 15 |40-488 Katowice;1908;1050;1050;4;1046;55.03;0.38
105256;246901;Gimnazjum nr 15|Katowice|ul. Karliczka 15 |40-488 Katowice;1813;1018;1018;20;998;56.15;1.96
105257;246901;Szkoła Podstawowa nr 51|Katowice|ul. Przyjazna 7a |40-466 Katowice;1782;1051;1051;9;1042;58.98;0.86
105258;246901;Szkoła Podstawowa nr 51|Katowice|ul. Przyjazna 7a |40-466 Katowice;1965;1018;1018;14;1004;51.81;1.38
105259;246901;Przedszkole nr 91|Katowice|ul. Adama 33 |40-467 Katowice;1922;1097;1097;14;1083;57.08;1.28
105260;246901;Gimnazjum nr 16|Katowice|ul. Wojciecha 9 |40-474 Katowice;1280;766;766;5;761;59.84;0.65
105261;246901;Gimnazjum nr 16|Katowice|ul. Wojciecha 9 |40-474 Katowice;1420;814;814;15;799;57.32;1.84
105262;246901;Gimnazjum nr 16|Katowice|ul. Wojciecha 9 |40-474 Katowice;1820;975;975;15;960;53.57;1.54
105263;246901;Katowicka Spółdzielnia Mieszkaniowa Osiedle Zgrzebnioka|Katowice|ul. Łabędzia 19 |40-521 Katowice;1839;1378;1378;8;1370;74.93;0.58
105264;246901;Zespół Szkół Technicznych i Ogólnokształcących nr 2|Katowice|ul. Mikołowska 131 |40-592 Katowice;488;303;303;5;298;62.09;1.65
105265;246901;Szkoła Podstawowa nr 65|Katowice|ul. Kukułek 2a |40-533 Katowice;1545;1148;1148;2;1146;74.30;0.17
105266;246901;Dom Dziecka "Zakątek"|Katowice|ul. Brynowska 70a |40-584 Katowice;1620;1067;1067;5;1062;65.86;0.47
105267;246901;III Liceum Ogólnokształcące|Katowice|ul. Mickiewicza 11 |40-092 Katowice;1060;517;517;8;509;48.77;1.55
105268;246901;Gimnazjum nr 3|Katowice|ul. Sokolska 23 |40-086 Katowice;1213;790;790;12;778;65.13;1.52
105269;246901;III Liceum Ogólnokształcące|Katowice|ul. Mickiewicza 11 |40-092 Katowice;603;287;287;7;280;47.60;2.44
105270;246901;Dział Nadzoru Systemu Parkowania przy MZUiM|Katowice|ul. Warszawska 19 |40-009 Katowice;778;339;339;4;335;43.57;1.18
105271;246901;VIII Liceum Ogólnokształcące|Katowice|ul. 3 Maja 42 |40-097 Katowice;1097;499;499;12;487;45.49;2.40
105272;246901;Gimnazjum nr 2|Katowice|ul. Głowackiego 4 |40-052 Katowice;1174;539;539;9;530;45.91;1.67
105273;246901;Gimnazjum nr 2|Katowice|ul. Głowackiego 4 |40-052 Katowice;1474;868;868;3;865;58.89;0.35
105274;246901;Świetlica Śląskiego Oddziału Okręgowego PCK|Katowice|ul. PCK 8 |40-057 Katowice;1547;821;821;24;797;53.07;2.92
105275;246901;Komunikacyjny Związek Komunalny Górnośląskiego Okręgu Przemysłowego|Katowice|ul. Barbary 21a |40-053 Katowice;1604;935;935;9;926;58.29;0.96
105276;246901;Dom Pomocy Społecznej "Przystań"|Katowice|ul. Adamskiego 22 |40-069 Katowice;1931;1176;1176;23;1153;60.90;1.96
105277;246901;Zespół Szkół Ekonomicznych|Katowice|ul. Raciborska 3 |40-074 Katowice;1518;640;640;24;616;42.16;3.75
105278;246901;Biurowiec|Katowice|ul. Wita Stwosza 31 |40-042 Katowice;1121;761;761;10;751;67.89;1.31
105279;246901;Zespół Szkół Ogólnokształcących nr 1|Katowice|ul. Sienkiewicza 74 |40-039 Katowice;1710;1130;1130;10;1120;66.08;0.88
105280;246901;Szkoła Podstawowa nr 1|Katowice|ul. Jagiellońska 18 |40-035 Katowice;1599;817;817;6;811;51.09;0.73
105281;246901;Szkoła Podstawowa nr 1|Katowice|ul. Jagiellońska 18 |40-035 Katowice;1250;661;661;13;648;52.88;1.97
105282;246901;Dom Technika|Katowice|ul. Podgórna 4 |40-026 Katowice;1598;852;852;6;846;53.32;0.70
105283;246901;Przedszkole nr 6|Katowice|ul. Uniwersytecka 15 |40-007 Katowice;1230;718;718;14;704;58.37;1.95
105284;246901;Terenowy Punkt Pomocy Społecznej nr 2 MOPS Katowice|Katowice|ul. Warszawska 42 |40-009 Katowice;1113;460;460;4;456;41.33;0.87
105285;246901;Gimnazjum nr 5|Katowice|ul. Graniczna 27 |40-017 Katowice;1722;1022;1022;14;1008;59.35;1.37
105286;246901;Gimnazjum nr 5|Katowice|ul. Graniczna 27 |40-017 Katowice;1670;1155;1155;13;1142;69.16;1.13
105287;246901;Szkoła Podstawowa nr 12|Katowice|ul. Paderewskiego 46 |40-282 Katowice;1937;1290;1290;14;1276;66.60;1.09
105288;246901;Gimnazjum nr 4|Katowice|ul. Graniczna 46 |40-018 Katowice;1821;1177;1177;24;1153;64.63;2.04
105289;246901;Gimnazjum nr 4|Katowice|ul. Graniczna 46 |40-024 Katowice;1906;1121;1121;7;1114;58.81;0.62
105290;246901;Przedszkole nr 57|Katowice|ul. Piastów 13 |40-866 Katowice;1583;1002;1002;13;989;63.30;1.30
105291;246901;Szkoła Podstawowa nr 66|Katowice|Al. Krzywoustego 7 |40-870 Katowice;1878;1170;1170;11;1159;62.30;0.94
105292;246901;Młodzieżowy Dom Kultury|Katowice|ul. Tysiąclecia 5 |40-873 Katowice;1704;1093;1093;14;1079;64.14;1.28
105293;246901;Młodzieżowy Dom Kultury|Katowice|ul. Tysiąclecia 5 |40-873 Katowice;1564;847;847;14;833;54.16;1.65
105294;246901;Zespół Szkół Integracyjnych nr 1|Katowice|Al. Krzywoustego 11 |40-870 Katowice;1226;747;747;9;738;60.93;1.20
105295;246901;Spółdzielczy Ośrodek Kultury przy Spółdzielni Mieszkaniowej "Piast"|Katowice|ul. Zawiszy Czarnego 8 |40-872 Katowice;1706;1091;1091;11;1080;63.95;1.01
105296;246901;Przedszkole nr 90|Katowice|ul. Chrobrego 39 |40-881 Katowice;1427;933;933;17;916;65.38;1.82
105297;246901;Zespół Szkół Ogólnokształcących nr 3|Katowice|ul. Chrobrego 4 |40-881 Katowice;2035;1316;1316;21;1295;64.67;1.60
105298;246901;Przedszkole nr 34|Katowice|ul. Tysiąclecia 84a |40-871 Katowice;1586;1014;1014;20;994;63.93;1.97
105299;246901;Szkoła Podstawowa nr 59|Katowice|ul. Chrobrego 5 |40-881 Katowice;1673;1034;1034;11;1023;61.81;1.06
105300;246901;Szkoła Podstawowa nr 59|Katowice|ul. Chrobrego 5 |40-881 Katowice;1811;1156;1156;16;1140;63.83;1.38
105301;246901;Zespół Szkół Specjalnych nr 11|Katowice|ul. Gliwicka 148a |40-859 Katowice;1652;656;656;19;637;39.71;2.90
105302;246901;Młodzieżowy Dom Kultury|Katowice|ul. Gliwicka 214 |40-860 Katowice;1949;919;919;17;902;47.15;1.85
105303;246901;Szkoła Podstawowa nr 20|Katowice|ul. Zarębskiego 2 |40-854 Katowice;1544;707;707;13;694;45.79;1.84
105304;246901;Szkoła Podstawowa nr 20|Katowice|ul. Zarębskiego 2 |40-854 Katowice;1503;556;556;17;539;36.99;3.06
105305;246901;Szkoła Podstawowa nr 20|Katowice|ul. Zarębskiego 2 |40-854 Katowice;1312;679;679;20;659;51.75;2.95
105306;246901;Szkoła Podstawowa nr 19|Katowice|ul. Agnieszki 2 |40-110 Katowice;1904;936;936;20;916;49.16;2.14
105307;246901;Przedszkole nr 27|Katowice|ul. Ściegiennego 27 |40-114 Katowice;1687;1015;1015;21;994;60.17;2.07
105308;246901;Zespół Szkolno-Przedszkolny nr 1|Katowice|ul. Sportowa 29 |40-106 Katowice;1026;551;551;14;537;53.70;2.54
105309;246901;Zespół Szkolno-Przedszkolny nr 1|Katowice|ul. Sportowa 29 |40-106 Katowice;1472;804;804;25;779;54.62;3.11
105310;246901;Śląski Oddział Wojewódzki Narodowego Funduszu Zdrowia w Katowicach|Katowice|ul. Kossutha 13 |40-833 Katowice;1645;997;997;30;967;60.61;3.01
105311;246901;XV Liceum Ogólnokształcące|Katowice|ul. Obroki 87 |40-833 Katowice;1522;851;851;11;840;55.91;1.29
105312;246901;Przedszkole nr 13|Katowice|ul. Witosa 16a |40-832 Katowice;1724;1036;1036;10;1026;60.09;0.97
105313;246901;Zespół Szkół Ogólnokształcących nr 7|Katowice|ul. Witosa 23 |40-832 Katowice;1858;1084;1084;17;1067;58.34;1.57
105314;246901;Zespół Szkół Ogólnokształcących nr 7|Katowice|ul. Witosa 23 |40-832 Katowice;1791;1166;1166;18;1148;65.10;1.54
105315;246901;Zespół Szkół Ogólnikształcących nr 7|Katowice|ul. Witosa 23 |40-832 Katowice;1800;1042;1042;8;1034;57.89;0.77
105316;246901;Gimnazjum nr 22|Katowice|ul. Hetmańska 8 |40-560 Katowice;1825;1096;1096;12;1084;60.05;1.09
105317;246901;Gimnazjum nr 22|Katowice|ul. Hetmańska 8 |40-560 Katowice;1144;730;730;3;727;63.81;0.41
105318;246901;Zespół Szkół Zawodowych Specjalnych nr 6|Katowice|ul. Rolna 22 |40-555 Katowice;2042;1388;1388;12;1376;67.97;0.86
105319;246901;Szkoła Podstawowa nr 11|Katowice|ul. Nasypowa 16 |40-551 Katowice;1921;1277;1277;11;1266;66.48;0.86
105320;246901;Zakładowy Dom Kultury KWK "Wujek"|Katowice|ul. W. Pola 73 |40-595 Katowice;2154;1161;1161;16;1145;53.90;1.38
105321;246901;Szkoła Podstawowa nr 5|Katowice|ul. Gallusa 5 |40-594 Katowice;1709;929;929;15;914;54.36;1.61
105322;246901;Zespół Szkół Technicznych i Ogólnokształcących nr 2|Katowice|ul. Mikołowska 131 |40-592 Katowice;1656;980;980;16;964;59.18;1.63
105323;246901;Szkoła Podstawowa nr 17|Katowice|ul. Dekerta 1 |40-143 Katowice;2116;1134;1134;23;1111;53.59;2.03
105324;246901;Szkoła Podstawowa nr 17|Katowice|ul. Dekerta 1 |40-143 Katowice;1796;1031;1031;13;1018;57.41;1.26
105325;246901;Gimnazjum nr 9|Katowice|ul. Krzyżowa 12 |40-111 Katowice;1726;1080;1080;10;1070;62.57;0.93
105326;246901;Gimnazjum nr 9|Katowice|ul. Krzyżowa 12 |40-111 Katowice;1552;910;910;10;900;58.63;1.10
105327;246901;XIV Liceum Ogólnokształcące|Katowice|ul. Józefowska 32 |40-144 Katowice;1813;806;806;18;788;44.46;2.23
105328;246901;Gimnazjum nr 9|Katowice|ul. Krzyżowa 12 |40-111 Katowice;1551;903;903;18;885;58.22;1.99
105329;246901;Przedszkole nr 73|Katowice|ul. Słoneczna 77a |40-136 Katowice;1553;978;978;11;967;62.97;1.12
105330;246901;Szkoła Podstawowa nr 36|Katowice|ul. Iłłakowiczówny 13 |40-134 Katowice;1703;956;956;18;938;56.14;1.88
105331;246901;Szkoła Podstawowa nr 36|Katowice|ul. Iłłakowiczówny 13 |40-134 Katowice;1171;671;671;5;666;57.30;0.75
105332;246901;Komunalny Zakład Gospodarki Mieszkaniowej Świetlica|Katowice|ul. Grażyńskiego 5 |40-126 Katowice;1281;806;806;12;794;62.92;1.49
105333;246901;Miejska Biblioteka Publiczna, Filia nr 11|Katowice|ul. Grażyńskiego 47 |40-126 Katowice;2032;1162;1164;7;1155;57.19;0.60
105334;246901;Główny Instytut Górnictwa|Katowice|Pl. Gwarków 1 |40-166 Katowice;1835;971;971;16;955;52.92;1.65
105335;246901;IV Liceum Ogólnokształcące|Katowice|ul. Katowicka 54 |40-165 Katowice;1375;986;986;7;979;71.71;0.71
105336;246901;IV Liceum Ogólnokształcące|Katowice|ul. Katowicka 54 |40-165 Katowice;1341;633;633;9;624;47.20;1.42
105337;246901;IV Liceum Ogólnokształcące|Katowice|ul. Katowicka 54 |40-165 Katowice;1302;818;818;5;813;62.83;0.61
105338;246901;Miejska Biblioteka Publiczna Filia nr 16|Katowice|ul. Wajdy 21 |40-175 Katowice;2082;1278;1278;18;1260;61.38;1.41
105339;246901;Zespół Szkół Specjalnych nr 9|Katowice|ul. Ścigały 17 |40-208 Katowice;2004;1055;1055;21;1034;52.64;1.99
105340;246901;Miejski Dom Kultury "Bogucice-Zawodzie"|Katowice|ul. Markiefki 44a |40-213 Katowice;1502;675;675;17;658;44.94;2.52
105341;246901;Gimnazjum nr 10|Katowice|ul. Słowiańska 1 |40-216 Katowice;1740;1009;1009;17;992;57.99;1.68
105342;246901;Gimnazjum nr 10|Katowice|ul. Słowiańska 1 |40-216 Katowice;1951;1298;1298;11;1287;66.53;0.85
105343;246901;Szkoła Podstawowa nr 2|Katowice|Al. Roździeńskiego 82 |40-203 Katowice;1345;896;896;10;886;66.62;1.12
105344;246901;Szkoła Podstawowa nr 2|Katowice|Al. Roździeńskiego 82 |40-203 Katowice;1095;708;708;11;697;64.66;1.55
105345;246901;X Liceum Ogólnokształcące|Katowice|ul. Miarki 6 |40-224 Katowice;1409;517;517;15;502;36.69;2.90
105346;246901;Zespół Szkół nr 1|Katowice|ul. Staszica 2 |40-230 Katowice;2301;1348;1348;17;1331;58.58;1.26
105347;246901;Zespół Szkół nr 1|Katowice|ul. Staszica 2 |40-230 Katowice;1503;629;629;22;607;41.85;3.50
105348;246901;Miejski Dom Kultury "Bogucice-Zawodzie"|Katowice|ul. Marcinkowskiego 13 |40-233 Katowice;1208;697;697;15;682;57.70;2.15
105349;246901;Miejski Dom Kultury "Bogucice-Zawodzie"|Katowice|ul. Marcinkowskiego 13 |40-233 Katowice;1247;785;785;12;773;62.95;1.53
105350;246901;Dom Pomocy Spolecznej "Przystań"|Katowice|ul. Adamskiego 22 |40-069 ;83;47;47;8;39;56.63;17.02
105351;246901;Dom Pomocy Społecznej "Zacisze"|Katowice|ul. Traktorzystów 42 |40-695 ;97;31;31;2;29;31.96;6.45
105352;246901;"Senior Residence" Dom Pomocy Społecznej|Katowice|ul. Pijarska 4 |40-750 ;77;35;35;1;34;45.45;2.86
105353;246901;"Senior Residence" Placówka Świadcząca Całodobową Opiekę|Katowice|ul. Zabłockiego 26 |40-750 ;72;23;23;2;21;31.94;8.70
105354;246901;Społeczne Towarzystwo Hospicjum Cordis|Katowice|ul. Ociepki 2 |40-413 ;27;17;17;0;17;62.96;0.00
105355;246901;Zakład Opiekuńczo-Leczniczy|Katowice|ul. Czempiela 1 |40-044 ;55;28;28;0;28;50.91;0.00
105356;246901;Zakład Opieki Zdrowotnej|Katowice|ul. Głowackiego 10 |40-052 ;42;33;33;0;33;78.57;0.00
105357;246901;Szpital|Katowice|ul. Reymonta 8 |40-029 ;295;145;145;7;138;49.15;4.83
105358;246901;Szpital|Katowice|ul. Sokołowskiego 2 |40-749 ;120;49;49;4;45;40.83;8.16
105359;246901;Szpital|Katowice|ul. Ziołowa 45/47 |40-635 ;473;153;153;1;152;32.35;0.65
105360;246901;Szpital|Katowice|ul. Medyków 14 |40-752 ;503;156;156;6;150;31.01;3.85
105361;246901;Szpital|Katowice|ul. Markiefki 87 |40-211 ;178;46;46;1;45;25.84;2.17
105362;246901;Szpital|Katowice|ul. Korczaka 27 |40-340 ;212;75;75;3;72;35.38;4.00
105363;246901;Szpital|Katowice|ul. Raciborska 27 |40-074 ;101;65;65;1;64;64.36;1.54
105364;246901;Szpital|Katowice|ul. Strzelecka 9 |40-073 ;103;38;38;1;37;36.89;2.63
105365;246901;Szpital|Katowice|ul. Józefowska 119 |40-145 ;39;12;12;1;11;30.77;8.33
105366;246901;Szpital|Katowice|ul. Warszawska 52 |40-008 ;30;15;15;0;15;50.00;0.00
105367;246901;Szpital|Katowice|ul. Panewnicka 54 |40-760 ;50;24;24;2;22;48.00;8.33
105368;246901;Szpital|Katowice|ul. Ceglana 35 |40-514 ;32;25;25;2;23;78.12;8.00
105369;246901;Szpital|Katowice|ul. Morawa 31 |40-353 ;52;21;21;0;21;40.38;0.00
105370;246901;Areszt Śledczy|Katowice|ul. Mikołowska 10a |40-067 ;311;192;192;23;169;61.74;11.98
105371;247001;Zespół Szkół Sportowych|Mysłowice, Szabelnia|ul. Gwarków 1 |41-400 Mysłowice;1457;590;590;27;563;40.49;4.58
105372;247001;Przedszkole Nr 8|Mysłowice, Szabelnia|ul. Gwarków 22 |41-400 Mysłowice;1344;586;586;28;558;43.60;4.78
105373;247001;Szkoła Podstawowa Nr 2|Mysłowice, Szabelnia|ul. Piastowska 7 |41-400 Mysłowice;1627;623;623;15;608;38.29;2.41
105374;247001;Mysłowicki Ośrodek Kultury|Mysłowice, Szabelnia|ul. Grunwaldzka 7 |41-400 Mysłowice;1314;600;600;11;589;45.66;1.83
105375;247001;Szkoła Podstawowa Nr 9|Mysłowice, Szabelnia|ul. Armii Krajowej 30 |41-400 Mysłowice;1420;714;714;24;690;50.28;3.36
105376;247001;II Liceum Ogólnokształcące|Mysłowice, Szabelnia|ul. Mikołowska 3 |41-400 Mysłowice;1926;925;925;28;897;48.03;3.03
105377;247001;Zespół Szkół Ogólnokształcących|Mysłowice, Szabelnia|ul. Adama Mickiewicza 6-8 |41-400 Mysłowice;1819;942;942;12;930;51.79;1.27
105378;247001;Gimnazjum Nr 2|Mysłowice, Szabelnia|ul. Górnicza 4 |41-400 Mysłowice;1497;569;571;19;550;38.01;3.34
105379;247001;Gimnazjum Nr 2|Mysłowice, Szabelnia|ul. Górnicza 4 |41-400 Mysłowice;993;415;415;9;406;41.79;2.17
105380;247001;Przedszkole Nr 9|Mysłowice, Janów Miejski|ul. Różyckiego 10J |41-406 Mysłowice;1779;999;999;67;932;56.16;6.71
105381;247001;Zespół Szkół Ponadgimnazjalnych Nr 1|Mysłowice, Ćmok|ul. Mikołowska 44 |41-406 Mysłowice;1464;907;907;13;894;61.95;1.43
105382;247001;Zespół Szkół Ponadgimnazjalnych Nr 1|Mysłowice, Ćmok|ul. Mikołowska 44 |41-406 Mysłowice;1867;1147;1147;11;1136;61.44;0.96
105383;247001;Szkoła Podstawowa Nr 3|Mysłowice, Janów Miejski|ul. 1000-lecia Państwa Polskiego 6 |41-406 Mysłowice;2221;1254;1254;22;1232;56.46;1.75
105384;247001;Gimnazjum Nr 1|Mysłowice, Janów Miejski|ul. Wielka Skotnica 84a |41-400 Mysłowice;1913;1005;1005;18;987;52.54;1.79
105385;247001;Gimnazjum Nr 1|Mysłowice, Janów Miejski|ul. Wielka Skotnica 84a |41-400 Mysłowice;1877;1073;1073;24;1049;57.17;2.24
105386;247001;Przedszkole Nr 20|Mysłowice, Janów Miejski|ul. Gabrieli Zapolskiej 1 |41-400 Mysłowice;961;667;667;9;658;69.41;1.35
105387;247001;Szkoła Podstawowa Nr 1|Mysłowice, Szabelnia|ul. Wielka Skotnica 2 |41-406 Mysłowice;1398;773;773;9;764;55.29;1.16
105388;247001;Szkoła Podstawowa Nr 1|Mysłowice, Szabelnia|ul. Wielka Skotnica 2 |41-406 Mysłowice;1692;966;966;21;945;57.09;2.17
105389;247001;Przedszkole Nr 13|Mysłowice, Szabelnia|ul. Armii Krajowej 19 |41-406 Mysłowice;1857;779;779;17;762;41.95;2.18
105390;247001;Szkoła Podstawowa Nr 7|Mysłowice, Słupna|ul. Stadionowa 2 |41-400 Mysłowice;529;268;268;3;265;50.66;1.12
105391;247001;Zespół Szkolno-Przedszkolny Nr 1|Mysłowice, Brzęczkowice|ul. Gen. Jerzego Ziętka 116 |41-412 Mysłowice;960;594;594;6;588;61.88;1.01
105392;247001;Gimnazjum Nr 3 z Oddziałami Integracyjnymi i Dwujęzycznymi|Mysłowice, Brzęczkowice|ul. Ks. Kardynała Augusta Hlonda 14 |41-412 Mysłowice;1654;951;951;15;936;57.50;1.58
105393;247001;Gimnazjum Nr 3 z Oddziałami Integracyjnymi i Dwujęzycznymi|Mysłowice, Brzęczkowice|ul. Ks. Kardynała Augusta Hlonda 14 |41-412 Mysłowice;1574;951;951;14;937;60.42;1.47
105394;247001;Zespół Szkół Specjalnych|Mysłowice, Brzęczkowice|ul. Bernarda Wały 4 |41-412 Mysłowice;1425;769;769;10;759;53.96;1.30
105395;247001;Przedszkole Nr 16|Mysłowice, Brzęczkowice|ul. Franciszka Kawy 4 |41-412 Mysłowice;1783;1082;1082;14;1068;60.68;1.29
105396;247001;Szkoła Podstawowa Nr 10|Mysłowice, Brzezinka|ul. Mikołaja Reja 28 |41-404 Mysłowice;2246;1220;1220;20;1200;54.32;1.64
105397;247001;Mysłowicki Ośrodek Kultury|Mysłowice, Brzezinka|ul. Laryska 5 |41-404 Mysłowice;1677;827;827;26;801;49.31;3.14
105398;247001;Szkoła Podstawowa Nr 17|Mysłowice, Krasowy|ul. PCK 209 b |41-409 Mysłowice;2062;1238;1238;25;1213;60.04;2.02
105399;247001;Szkoła Podstawowa Nr 16|Mysłowice, Kosztowy|ul. Kosztowska 46 |41-409 Mysłowice;1462;914;914;15;899;62.52;1.64
105400;247001;Gimnazjum Nr 6|Mysłowice, Kosztowy|ul. Jerzego Chromika 3 |41-409 Mysłowice;1437;927;927;11;916;64.51;1.19
105401;247001;Szkoła Podstawowa Nr 5|Mysłowice, Dziećkowice|ul. Długa 92 |41-409 Mysłowice;1149;586;590;9;577;51.00;1.54
105402;247001;Zespół Szkolno-Przedszkolny Nr 3|Mysłowice, Brzezinka|ul. Laryska 101 |41-404 Mysłowice;1073;633;633;14;619;58.99;2.21
105403;247001;Zespół Szkolno-Przedszkolny Nr 2|Mysłowice, Morgi|ul. Józefa Wybickiego 79 |41-404 Mysłowice;1917;1259;1259;14;1245;65.68;1.11
105404;247001;Gimnazjum Nr 5|Mysłowice, Wesoła|ul. Jana Dierżonia 26 |41-408 Mysłowice;2284;1149;1149;42;1107;50.31;3.66
105405;247001;Dom Katechetyczny|Mysłowice, Ławki|ul. Murckowska 147 |41-408 Mysłowice;779;457;457;5;452;58.66;1.09
105406;247001;Zespół Szkół Ponadgimnazjalnych Nr 2|Mysłowice, Wesoła|ul. Pocztowa 20 |41-408 Mysłowice;972;452;452;6;446;46.50;1.33
105407;247001;Zespół Szkół Ponadgimnazjalnych Nr 2|Mysłowice, Wesoła|ul. Pocztowa 20 |41-408 Mysłowice;996;496;496;21;475;49.80;4.23
105408;247001;Szkoła Podstawowa Nr 14|Mysłowice, Wesoła|ul. 3-go Maja 19 |41-408 Mysłowice;1450;939;939;16;923;64.76;1.70
105409;247001;Mysłowickie Centrum Zdrowia Sp. z o.o.|Mysłowice|Mikołowska 1 |41-400 Mysłowice;27;9;9;0;9;33.33;0.00
105410;247001;SP ZOZ Szpital nr 2 im. dr. T. Boczonia|Mysłowice|Bytomska 41 |41-400 Mysłowice;53;31;31;1;30;58.49;3.23
105411;247001;Areszt Śledczy|Mysłowice|K. Szymanowskiego 6 |41-400 Mysłowice;276;181;181;15;166;65.58;8.29
105412;247101;Filia Miejskiego Domu Kultury|Piekary Śląskie, Kozłowa Góra|ul. Tarnogórska 49 |41-945 Piekary Śląskie;1345;719;719;15;704;53.46;2.09
105413;247101;Zespół Szkolno-Przedszkolny Nr 1|Piekary Śląskie, Kozłowa Góra|ul. Tarnogóska 40 |41-945 Piekary Śląskie;1155;643;643;6;637;55.67;0.93
105414;247101;Miejski Ośrodek Sportu i Rekreacji|Piekary Śląskie|ul. Olimpijska 3 |41-943 Piekary Śląskie;1820;707;707;26;681;38.85;3.68
105415;247101;Miejska Szkoła Podstawowa Nr 9 z Oddziałami Integracyjnymi im. Gustawa Morcinka|Piekary Śląskie|ul. księdza Gerarda Waculika 10 |41-943 Piekary Śląskie;2222;1139;1139;26;1113;51.26;2.28
105416;247101;Miejska Szkoła Podstawowa Nr 9 z Oddziałami Integracyjnymi im. Gustawa Morcinka|Piekary Śląskie|ul. księdza Gerarda Waculika 10 |41-943 Piekary Śląskie;1957;904;904;13;891;46.19;1.44
105417;247101;Miejska Szkoła Podstawowa Nr 11|Piekary Śląskie|ul. Śląska 8 |41-943 Piekary Śląskie;1287;540;540;18;522;41.96;3.33
105418;247101;Miejska Szkoła Podstawowa Nr 11|Piekary Śląskie|ul. Śląska 8 |41-943 Piekary Śląskie;1257;609;609;12;597;48.45;1.97
105419;247101;Miejska Szkoła Podstawowa Nr 11|Piekary Śląskie|ul. Śląska 8 |41-943 Piekary Śląskie;1426;858;858;19;839;60.17;2.21
105420;247101;Miejskie Gimnazjum Nr 1|Piekary Śląskie|ul. Armii Krajowej 2 |41-943 Piekary Śląskie;1493;790;790;22;768;52.91;2.78
105421;247101;Miejskie Gimnazjum Nr 1|Piekary Śląskie|ul. Armii Krajowej 2 |41-943 Piekary Śląskie;1530;756;756;15;741;49.41;1.98
105422;247101;Miejskie Gimnazjum Nr 2|Piekary Śląskie|ul. Ks. Jerzego Popiełuszki 8 |41-940 Piekary Śląskie;1739;991;991;32;959;56.99;3.23
105423;247101;Miejskie Gimnazjum Nr 2|Piekary Śląskie|ul. Ks. Jerzego Popiełuszki 8 |41-940 Piekary Śląskie;1810;1028;1028;22;1006;56.80;2.14
105424;247101;Zasadnicza Szkoła Zawodowa im. Stanisława Ligonia|Piekary Śląskie|ul. Bytomska 207 |41-940 Piekary Śląskie;1912;1039;1039;32;1007;54.34;3.08
105425;247101;Zakład Opiekuńczo-Leczniczy|Piekary Śląskie|ul. ks. Jana Ficka 1 |41-940 Piekary Śląskie;76;30;30;0;30;39.47;0.00
105426;247101;Miejska Szkoła Podstawowa Nr 5 im. Wawrzyńca Hajdy|Piekary Śląskie|ul. Fryderyka Chopina 11 |41-940 Piekary Śląskie;1980;1190;1190;23;1167;60.10;1.93
105427;247101;Miejskie Gimnazjum Nr 3 im. Jana Pawła II|Piekary Śląskie|ul. Bytomska 81a |41-940 Piekary Śląskie;1902;1010;1010;23;987;53.10;2.28
105428;247101;Samodzielny Publiczny Wojewódzki Szpital Chirurgii Urazowej im. Dra J.Daaba|Piekary Śląskie|ul. Bytomska 62 |41-940 Piekary Śląskie;188;104;104;4;100;55.32;3.85
105429;247101;I Liceum Ogólnokształcące im. Króla Jana III Sobieskiego|Piekary Śląskie|ul. Gimnazjalna 24 |41-940 Piekary Śląskie;1565;735;735;16;719;46.96;2.18
105430;247101;Szpital Miejski w Piekarach Śląskich pw. Św. Łukasza|Piekary Śląskie|ul. Szpitalna 11 |41-940 Piekary Śląskie;83;43;43;0;43;51.81;0.00
105431;247101;Miejska Szkoła Podstawowa Nr 1|Piekary Śląskie|ul. Szpitalna 9 |41-940 Piekary Śląskie;1204;396;396;15;381;32.89;3.79
105432;247101;Miejska Szkoła Podstawowa Nr 1|Piekary Śląskie|ul. Szpitalna 9 |41-940 Piekary Śląskie;1409;696;696;14;682;49.40;2.01
105433;247101;Miejska Szkoła Podstawowa Nr 12 im. Jana Demarczyka|Piekary Śląskie, Brzozowice|ul. Związkowa 14 |41-949 Piekary Śląskie;1554;799;799;20;779;51.42;2.50
105434;247101;Ośrodek Kultury "Andaluzja"|Piekary Śląskie, Brzozowice-Kamień|ul. Oświęcimska 45 |41-949 Piekary Śląskie;1486;783;783;16;767;52.69;2.04
105435;247101;Zespół Szkół Nr 1|Piekary Śląskie, Brzozowice-Kamień|ul. Marii Curie-Skłodowskiej 49 |41-949 Piekary Śląskie;1186;719;719;12;707;60.62;1.67
105436;247101;Zespół Szkół Nr 1|Piekary Śląskie, Brzozowice-Kamień|ul. Marii Curie-Skłodowskiej 49 |41-949 Piekary Śląskie;1248;596;596;21;575;47.76;3.52
105437;247101;Miejskie Gimnazjum Nr 4|Piekary Śląskie, Brzozowice-Kamień|ul. Marii Curie-Skłodowskiej 108 |41-949 Piekary Śląskie;1504;769;769;16;753;51.13;2.08
105438;247101;Miejskie Gimnazjum Nr 4|Piekary Śląskie, Brzozowice-Kamień|ul. Marii Curie-Skłodowskiej 108 |41-949 Piekary Śląskie;1610;879;879;12;867;54.60;1.37
105439;247101;Miejska Szkoła Podstawowa Nr 14|Piekary Śląskie, Brzeziny Śląskie|ul. Biskupa Herberta Bednorza 29 |41-946 Piekary Śląskie;1893;766;766;33;733;40.46;4.31
105440;247101;Miejska Szkoła Podstawowa Nr 15 im. Powstańców Śląskich|Piekary Śląskie, Brzeziny Śląskie|ul. Franciszka Kotuchy 40 |41-946 Piekary Śląskie;1614;661;674;31;630;40.95;4.69
105441;247101;Dom Pomocy Społecznej|Piekary Śląskie, Brzeziny Śląskie|ul. Teodora Trautmana 4 |41-946 Piekary Śląskie;98;56;56;21;35;57.14;37.50
105442;247101;Zespół Szkolno-Przedszkolny Nr 2|Piekary Śląskie, Dąbrówka Wielka|ul. Rycerska 15a |41-948 Piekary Śląskie;1446;761;761;16;745;52.63;2.10
105443;247101;Zespół Szkolno-Przedszkolny Nr 2|Piekary Śląskie, Dąbrówka Wielka|ul. Rycerska 15a |41-948 Piekary Śląskie;1814;987;987;18;969;54.41;1.82
105444;247201;Gimnazjum Nr 2|Ruda Śląska|ul. Ryszarda Sprusa 4 |41-700 Ruda Śląska;1500;468;468;22;446;31.20;4.70
105445;247201;Gimnazjum Nr 2|Ruda Śląska|ul. Ryszarda Sprusa 4 |41-700 Ruda Śląska;1180;418;418;14;404;35.42;3.35
105446;247201;Szkoła Podstawowa Nr 41|Ruda Śląska|ul. Jana Gierałtowskiego 15 |41-700 Ruda Śląska;1310;614;614;14;600;46.87;2.28
105447;247201;Szkoła Podstawowa Nr 41|Ruda Śląska|ul. Jana Gierałtowskiego 15 |41-700 Ruda Śląska;1169;491;491;15;476;42.00;3.05
105448;247201;Zespół Szkół Ogólnokształcących Nr 1|Ruda Śląska|ul. Adama Mickiewicza 15 |41-700 Ruda Śląska;1085;507;507;12;495;46.73;2.37
105449;247201;Zespół Szkół Ogólnokształcących Nr 1|Ruda Śląska|ul. Adama Mickiewicza 15 |41-700 Ruda Śląska;1093;524;524;14;510;47.94;2.67
105450;247201;Zespół Szkół Ponadgimnazjalnych Nr 7 Specjalnych|Ruda Śląska|ul. Wiktora Bujoczka 2 |41-700 Ruda Śląska;1631;591;591;15;576;36.24;2.54
105451;247201;Szkoła Podstawowa Nr 3|Ruda Śląska|ul. Cypriana Norwida 10 |41-700 Ruda Śląska;623;328;328;6;322;52.65;1.83
105452;247201;Szkoła Podstawowa Nr 3|Ruda Śląska|ul. Cypriana Norwida 10 |41-700 Ruda Śląska;1568;904;904;11;893;57.65;1.22
105453;247201;Dyrekcja Rudzkiej Spółdzielni Mieszkaniowej|Ruda Śląska|ul. Magazynowa 12 |41-700 Ruda Śląska;728;415;415;5;410;57.01;1.20
105454;247201;Niepubliczny Zakład Opieki Zdrowotnej Przychodnia Lekarska s.c|Ruda Śląska|ul. Wawelska 7 |41-700 Ruda Śląska;1858;1033;1033;27;1006;55.60;2.61
105455;247201;Miejskie Przedszkole Nr 38|Ruda Śląska|ul. Astrów 5 |41-700 Ruda Śląska;1745;885;885;18;867;50.72;2.03
105456;247201;Szkoła Podstawowa Nr 30|Ruda Śląska|ul. Chryzantem 10 |41-700 Ruda Śląska;1077;674;674;18;656;62.58;2.67
105457;247201;Szkoła Podstawowa Nr 30|Ruda Śląska|ul. Chryzantem 10 |41-700 Ruda Śląska;1229;662;662;8;654;53.86;1.21
105458;247201;Dom Pomocy Społecznej "Senior"|Ruda Śląska|ul. Aleksandra Puszkina 7 |41-712 Ruda Śląska;1989;673;673;34;639;33.84;5.05
105459;247201;Szkoła Podstawowa Nr 6|Ruda Śląska|ul. Bytomska 8 |41-712 Ruda Śląska;1526;712;712;7;705;46.66;0.98
105460;247201;Szkoła Podstawowa Nr 6|Ruda Śląska|ul. Bytomska 8 |41-712 Ruda Śląska;1604;934;934;18;916;58.23;1.93
105461;247201;Gimnazjum Nr 5|Ruda Śląska|ul. Bytomska 1 |41-712 Ruda Śląska;1338;763;763;11;752;57.03;1.44
105462;247201;Gimnazjum Nr 5|Ruda Śląska|ul. Bytomska 1 |41-712 Ruda Śląska;1024;631;631;17;614;61.62;2.69
105463;247201;Przychodnia Rejonowa Samodzielny Publiczny Zakład Opieki Zdrowotnej|Ruda Śląska|ul. Wincentego Lipa 3 |41-712 Ruda Śląska;1603;766;766;12;754;47.79;1.57
105464;247201;Osiedlowy Dom Kultury RSM "Jowisz"|Ruda Śląska|ul. Joanny 12 |41-712 Ruda Śląska;1652;858;858;13;845;51.94;1.52
105465;247201;Szkoła Podstawowa Nr 40|Ruda Śląska|ul. Joanny 13 |41-712 Ruda Śląska;1806;994;994;28;966;55.04;2.82
105466;247201;Szkoła Podstawowa Nr 40|Ruda Śląska|ul. Joanny 13 |41-712 Ruda Śląska;1462;640;640;18;622;43.78;2.81
105467;247201;Szkoła Podstawowa Nr 40|Ruda Śląska|ul. Joanny 13 |41-712 Ruda Śląska;1287;630;630;12;618;48.95;1.90
105468;247201;Miejskie Przedszkole nr 14|Ruda Śląska|ul. Węglowa 8 |41-709 Ruda Śląska;765;301;301;4;297;39.35;1.33
105469;247201;Zespół Szkół Ponadgimnazjalnych Nr1|Ruda Śląska|ul. Gen. Hallera 6 |41-709 Ruda Śląska;1901;566;566;18;548;29.77;3.18
105470;247201;Urząd Miasta (budynek B)|Ruda Śląska|ul. Piotra Niedurnego 46 |41-709 Ruda Śląska;1256;625;625;16;609;49.76;2.56
105471;247201;Zespół Szkół Muzycznych I i II Stopnia|Ruda Śląska|ul. Piotra Niedurnego 36 |41-709 Ruda Śląska;1999;945;945;35;910;47.27;3.70
105472;247201;Przychodnia Rejonowa Samodzielny Publiczny Zakład Opieki Zdrowotnej|Ruda Śląska|ul. Pokoju 4 |41-709 Ruda Śląska;1724;712;712;42;670;41.30;5.90
105473;247201;Gimnazjum Nr 11|Ruda Śląska|ul. Ratowników 15 |41-709 Ruda Śląska;1011;587;587;8;579;58.06;1.36
105474;247201;Gimnazjum Nr 11|Ruda Śląska|ul. Ratowników 15 |41-709 Ruda Śląska;1071;585;585;14;571;54.62;2.39
105475;247201;Szkoła Podstawowa nr 4|Ruda Śląska|ul. Lwa Tołstoja 1 |41-710 Ruda Śląska;1851;925;925;21;904;49.97;2.27
105476;247201;Szkoła Podstawowa Nr 8|Ruda Śląska|ul. Główna 1 |41-710 Ruda Śląska;1228;611;611;19;592;49.76;3.11
105477;247201;Szkoła Podstawowa Nr 8|Ruda Śląska|ul. Główna 1 |41-710 Ruda Śląska;1380;586;586;17;569;42.46;2.90
105478;247201;Miejskie Przedszkole nr 37|Ruda Śląska|ul. Obrońców Westerplatte 7A |41-710 Ruda Śląska;560;295;295;10;285;52.68;3.39
105479;247201;Miejskie Przedszkole nr 37|Ruda Śląska|ul. Obrońców Westerplatte 7A |41-710 Ruda Śląska;1504;844;844;13;831;56.12;1.54
105480;247201;Zespół Szkół Ogólnokształcących Nr 2|Ruda Śląska|ul. Alojzego Jankowskiego 22 |41-710 Ruda Śląska;1543;762;762;15;747;49.38;1.97
105481;247201;Zespół Szkół Ogólnokształcących Nr 2|Ruda Śląska|ul. Alojzego Jankowskiego 22 |41-710 Ruda Śląska;1458;640;640;24;616;43.90;3.75
105482;247201;Zespół Szkół Ogólnokształcących Nr 2|Ruda Śląska|ul. Alojzego Jankowskiego 22 |41-710 Ruda Śląska;1602;969;969;10;959;60.49;1.03
105483;247201;Gimnazjum Nr 7|Ruda Śląska|ul. Obrońców Westerplatte 2A |41-710 Ruda Śląska;989;496;496;12;484;50.15;2.42
105484;247201;Gimnazjum Nr 7|Ruda Śląska|ul. Obrońców Westerplatte 2A |41-710 Ruda Śląska;1193;611;611;10;601;51.22;1.64
105485;247201;Zespół Szkół Ponadgimnazjalnych Nr 6 im. M. Kopernika|Ruda Śląska|ul. Wawrzyna Kałusa 3 |41-710 Ruda Śląska;850;222;222;11;211;26.12;4.95
105486;247201;Szkoła Podstawowa Nr 7|Ruda Śląska|ul. 1 Maja 173 |41-710 Ruda Śląska;1074;638;638;11;627;59.40;1.72
105487;247201;Szkoła Podstawowa Nr 14|Ruda Śląska|ul. Główna 40 |41-711 Ruda Śląska;1508;725;725;21;704;48.08;2.90
105488;247201;Dom Kultury w Rudzie Śląskiej|Ruda Śląska|ul. Edmunda Kokota 170 |41-711 Ruda Śląska;1891;1026;1026;28;998;54.26;2.73
105489;247201;Dom Kultury w Rudzie Śląskiej|Ruda Śląska|ul. Edmunda Kokota 170 |41-711 Ruda Śląska;1553;826;826;14;812;53.19;1.69
105490;247201;Szkoła Podstawowa Nr 13|Ruda Śląska|ul. Ks. Józefa Nidzieli 61 |41-711 Ruda Śląska;1586;790;790;17;773;49.81;2.15
105491;247201;Gimnazjum Nr 14|Ruda Śląska|ul. Szkolna 22 |41-711 Ruda Śląska;1441;706;706;15;691;48.99;2.12
105492;247201;Miejskie Przedszkole Nr 43|Ruda Śląska|ul. Drozdów 6 |41-717 Ruda Śląska;1458;840;840;20;820;57.61;2.38
105493;247201;Miejskie Przedszkole Nr 43|Ruda Śląska|ul. Drozdów 6 |41-717 Ruda Śląska;1312;808;808;6;802;61.59;0.74
105494;247201;Szkoła Podstawowa Nr 23|Ruda Śląska|ul. 11 Listopada 15 |41-705 Ruda Śląska;2124;1049;1049;27;1022;49.39;2.57
105495;247201;Miejskie Przedszkole Nr 45|Ruda Śląska|ul. Bolesława Chrobrego 6 |41-705 Ruda Śląska;1486;686;686;18;668;46.16;2.62
105496;247201;Miejskie Przedszkole Nr 45|Ruda Śląska|ul. Bolesława Chrobrego 6 |41-705 Ruda Śląska;1036;533;533;13;520;51.45;2.44
105497;247201;Szkoła Podstawowa Nr 2|Ruda Śląska|ul. Gwarecka 2 |41-717 Ruda Śląska;1566;884;884;24;860;56.45;2.71
105498;247201;Miejska Biblioteka Publiczna Filia Nr 21|Ruda Śląska|ul. Józefa Grzegorzka 8 |41-717 Ruda Śląska;1523;871;871;15;856;57.19;1.72
105499;247201;Gimnazjum Nr 6|Ruda Śląska|ul. Gwarecka 2 |41-717 Ruda Śląska;1531;859;859;15;844;56.11;1.75
105500;247201;Gimnazjum Nr 6|Ruda Śląska|ul. Gwarecka 2 |41-717 Ruda Śląska;1476;836;836;18;818;56.64;2.15
105501;247201;Szkoła Podstawowa Nr 21|Ruda Śląska|ul. Ks. Ludwika Tunkla 125 |41-707 Ruda Śląska;2029;996;996;16;980;49.09;1.61
105502;247201;"BUM-MED" Sp. z o.o|Ruda Śląska|ul. Radoszowska 163 |41-707 Ruda Śląska;1743;956;956;15;941;54.85;1.57
105503;247201;"MOZZINI - Cafe - F.u.sy"|Ruda Śląska|ul. Wyzwolenia 5 |41-707 Ruda Śląska;1592;941;941;16;925;59.11;1.70
105504;247201;Szkoła Podstawowa Nr 18|Ruda Śląska|ul. Ignacego Łukasiewicza 7 |41-707 Ruda Śląska;1353;752;752;21;731;55.58;2.79
105505;247201;Szkoła Podstawowa Nr 18|Ruda Śląska|ul. Ignacego Łukasiewicza 7 |41-707 Ruda Śląska;1445;810;810;12;798;56.06;1.48
105506;247201;Zespół Szkół Ogólnokształcących Nr 3|Ruda Śląska|ul. Oświęcimska 90 |41-707 Ruda Śląska;1915;981;981;22;959;51.23;2.24
105507;247201;Szkoła Podstawowa Nr 24|Ruda Śląska|ul. Ks. Pawła Lexa 3 |41-706 Ruda Śląska;2168;1304;1304;22;1282;60.15;1.69
105508;247201;Gimnazjum Nr 8|Ruda Śląska|ul. Ks. Pawła Lexa 14 |41-706 Ruda Śląska;2079;1168;1168;33;1135;56.18;2.83
105509;247201;Hala Widowiskowo-Sportowa|Ruda Śląska|ul. Kłodnicka 95 |41-706 Ruda Śląska;1637;877;878;23;854;53.57;2.62
105510;247201;Hala Widowiskowo-Sportowa|Ruda Śląska|ul. Kłodnicka 95 |41-706 Ruda Śląska;1930;1077;1077;20;1057;55.80;1.86
105511;247201;Zespół Szkolno-Przedszkolny nr 2|Ruda Śląska|ul. Ignacego Kaczmarka 9 |41-706 Ruda Śląska;1890;1213;1213;22;1191;64.18;1.81
105512;247201;Szkoła Podstawowa Sportowa nr 15 z Klasami Integracyjnymi|Ruda Śląska|ul. Energetyków 15 |41-706 Ruda Śląska;1892;1082;1082;24;1058;57.19;2.22
105513;247201;Szkoła Podstawowa Sportowa Nr 15 z Klasami Integracyjnymi|Ruda Śląska|ul. Energetyków 15 |41-706 Ruda Śląska;1785;955;955;21;934;53.50;2.20
105514;247201;Miejskie Przedszkole nr 35|Ruda Śląska|ul. Ludwika Zamenhofa 3 |41-706 Ruda Śląska;1812;885;885;25;860;48.84;2.82
105515;247201;Gimnazjum nr 9 z Oddziałami Integracyjnymi|Ruda Śląska|ul. Ludwika Zamenhofa 12 |41-706 Ruda Śląska;1940;1040;1040;31;1009;53.61;2.98
105516;247201;Gimnazjum Nr 9 z Oddziałami Integracyjnymi|Ruda Śląska|ul. Ludwika Zamenhofa 12 |41-706 Ruda Śląska;1412;802;802;13;789;56.80;1.62
105517;247201;Gimnazjum Nr 9 z Oddziałami Integracyjnymi|Ruda Śląska|ul. Ludwika Zamenhofa 12 |41-706 Ruda Śląska;1620;853;853;14;839;52.65;1.64
105518;247201;Ośrodek św. Elżbieta, Dom Pomocy Społecznej|Ruda Śląska|Wolności 30 |41-700 Ruda Śląska;80;39;39;8;31;48.75;20.51
105519;247201;Szpital Miejski w Rudzie Śląskiej Sp. z o. o.|Ruda Śląska|Wincentego Lipa 2 |41-712 Ruda Śląska;74;48;48;3;45;64.86;6.25
105520;247201;Szpital Miejski w Rudzie Śląskiej Sp. z o. o.|Ruda Śląska|Główna 11 |41-711 Ruda Śląska;42;27;27;1;26;64.29;3.70
105521;247201;Pensjonat Senior|Ruda Śląska|Juliusza Słowackiego 22 |41-710 Ruda Śląska;17;7;7;1;6;41.18;14.29
105522;247301;Powiatowa i Miejska Biblioteka Publiczna|Rybnik|ul. Ks.Józefa Szafranka 7 |44-200 Rybnik;1482;863;863;12;851;58.23;1.39
105523;247301;Powiatowy Urząd Pracy|Rybnik|ul. Jankowicka 1 |44-200 Rybnik;1373;723;723;14;709;52.66;1.94
105524;247301;Zespół Szkół Technicznych|Rybnik|ul. Tadeusza Kościuszki 5 |44-200 Rybnik;1627;920;920;9;911;56.55;0.98
105525;247301;Gimnazjum Sportowe Nr 1 z Oddziałami Integracyjnymi im. Adama Mickiewicza|Rybnik|ul. Cmentarna 1 |44-200 Rybnik;1788;998;998;16;982;55.82;1.60
105526;247301;Gimnazjum Sportowe Nr 1 z Oddziałami Integracyjnymi im. Adama Mickiewicza|Rybnik|ul. Cmentarna 1 |44-200 Rybnik;1619;901;901;11;890;55.65;1.22
105527;247301;Zespół Szkół Nr 2|Rybnik|ul. Mikołowska 19 |44-200 Rybnik;2053;1146;1146;10;1136;55.82;0.87
105528;247301;Zespół Szkolno - Przedszkolny Nr 5|Rybnik|ul. Dr.Mariana Różańskiego 14A |44-200 Rybnik;1442;899;899;6;893;62.34;0.67
105529;247301;Zespół Szkolno - Przedszkolny Nr 5|Rybnik|ul. Dr. Mariana Różańskiego 14A |44-200 Rybnik;1266;819;820;13;806;64.69;1.59
105530;247301;Szkoła Podstawowa Nr 28 im. Alojzego Szewczyka|Rybnik|ul. Alojzego Szewczyka 6 |44-200 Rybnik;1783;1002;1002;21;981;56.20;2.10
105531;247301;Szkoła Podstawowa Nr 28 im. Alojzego Szewczyka|Rybnik|ul. Alojzego Szewczyka 6 |44-200 Rybnik;1730;987;987;38;949;57.05;3.85
105532;247301;Zespół Szkolno - Przedszkolny z Oddziałami Integracyjnymi Nr 1|Rybnik|ul. Gliwicka 105 |44-200 Rybnik;1587;905;905;19;886;57.03;2.10
105533;247301;Zespół Szkolno - Przedszkolny Nr 7|Rybnik|ul. Borki 37D |44-200 Rybnik;1479;878;878;12;866;59.36;1.37
105534;247301;Zespół Szkolno - Przedszkolny Nr 7|Rybnik|ul. Borki 37D |44-200 Rybnik;1244;704;704;14;690;56.59;1.99
105535;247301;Gimnazjum Nr 4 im. Jana Kochanowskiego|Rybnik|ul. Rybacka 55 |44-200 Rybnik;1432;877;877;13;864;61.24;1.48
105536;247301;Zespół Szkolno-Przedszkolny Nr 13|Rybnik|ul. Św.Maksymiliana 26 |44-200 Rybnik;1540;865;865;14;851;56.17;1.62
105537;247301;Zespół Szkolno - Przedszkolny Nr 4|Rybnik|ul. Komisji Edukacji Narodowej 29 |44-200 Rybnik;1820;1162;1162;21;1141;63.85;1.81
105538;247301;Zespół Szkolno - Przedszkolny Nr 4|Rybnik|ul. Komisji Edukacji Narodowej 29 |44-200 Rybnik;584;326;326;7;319;55.82;2.15
105539;247301;Zespół Szkolno - Przedszkolny Nr 15|Rybnik|ul. Gzelska 7 |44-200 Rybnik;1458;778;778;19;759;53.36;2.44
105540;247301;Budynek Ochotniczej Straży Pożarnej|Rybnik|ul. Zwonowicka 5 |44-200 Rybnik;501;221;221;10;211;44.11;4.52
105541;247301;Zespół Szkolno - Przedszkolny Nr 3 im. Jana Pawła II|Rybnik|ul. Bernarda Kuglera 8A |44-200 Rybnik;1540;859;859;26;833;55.78;3.03
105542;247301;Szkoła Podstawowa Nr 3 im. Św. Stanisława Kostki|Rybnik|ul. Wolna 17 |44-200 Rybnik;1661;831;831;32;799;50.03;3.85
105543;247301;Przedszkole Nr 3|Rybnik|ul. Za Torem 3B |44-200 Rybnik;1850;898;898;19;879;48.54;2.12
105544;247301;Gimnazjum Nr 10 im. Jana Pawła II|Rybnik|ul. Karola Miarki 74 |44-200 Rybnik;1454;849;849;13;836;58.39;1.53
105545;247301;Gimnazjum Nr 10 im. Jana Pawła II|Rybnik|ul. Karola Miarki 74 |44-200 Rybnik;1623;960;960;21;939;59.15;2.19
105546;247301;Szkoła Podstawowa Nr 20 im. Harcerzy Buchalików|Rybnik|ul. Ziołowa 3 |44-200 Rybnik;1435;877;877;22;855;61.11;2.51
105547;247301;Szkoła Podstawowa Nr 20 im. Harcerzy Buchalików|Rybnik|ul. Ziołowa 3 |44-200 Rybnik;1362;777;777;19;758;57.05;2.45
105548;247301;Zespół Szkolno - Przedszkolny nr 6|Rybnik|ul. Stanisława Małachowskiego 44 |44-200 Rybnik;2069;1327;1328;26;1301;64.14;1.96
105549;247301;Zespół Szkolno - Przedszkolny Nr 6|Rybnik|ul.Stanisława Małachowskiego 44 |44-200 Rybnik;1793;1036;1036;14;1022;57.78;1.35
105550;247301;Gimnazjum z Oddziałami Integracyjnymi Nr 7 im. Czesława Miłosza|Rybnik|ul. Sztolniowa 29B |44-200 Rybnik;2164;1129;1129;18;1111;52.17;1.59
105551;247301;Gimnazjum Nr 5 im. Władysława Webera|Rybnik|ul. Żurawia 8 |44-200 Rybnik;1507;615;615;11;604;40.81;1.79
105552;247301;Przedszkole z Oddziałami Integracyjnymi Nr 39|Rybnik|ul. Południe 20 |44-200 Rybnik;1834;1003;1003;26;977;54.69;2.59
105553;247301;Przedszkole z Oddziałami Integracyjnymi Nr 39|Rybnik|ul.Południe 20 |44-200 Rybnik;1571;569;569;17;552;36.22;2.99
105554;247301;Zespół Szkolno - Przedszkolny Nr 8|Rybnik|ul. Józefa Lompy 6 |44-200 Rybnik;1733;578;578;38;540;33.35;6.57
105555;247301;Zespół Szkolno - Przedszkolny Nr 8|Rybnik|ul.Józefa Lompy 6 |44-200 Rybnik;1922;752;752;24;728;39.13;3.19
105556;247301;Szkoła Podstawowa Nr 19|Rybnik|ul. Włościańska 39E |44-200 Rybnik;2020;995;995;35;960;49.26;3.52
105557;247301;Zespół Szkół Budowlanych|Rybnik|ul. Świerklańska 42 |44-200 Rybnik;1078;629;629;14;615;58.35;2.23
105558;247301;Zespół Szkół Budowlanych|Rybnik|ul. Świerklańska 42 |44-200 Rybnik;1062;602;602;8;594;56.69;1.33
105559;247301;Gimnazjum Nr 3 im. Józefa Pukowca|Rybnik|ul. Śląska 18A |44-200 Rybnik;2123;1061;1061;22;1039;49.98;2.07
105560;247301;IV Liceum Ogólnokształcące im. Mikołaja Kopernika|Rybnik|ul. 1 Maja 91 A |44-200 Rybnik;2040;1002;1002;23;979;49.12;2.30
105561;247301;Szkoła Podstawowa Nr 13 - im. Bohaterskich Harcerzy Rybnika -Chwałowic|Rybnik|ul. 1 Maja 51 |44-253 Rybnik;2007;1020;1020;35;985;50.82;3.43
105562;247301;Gimnazjum Nr 13 im. Jana III Sobieskiego|Rybnik|ul. Kręta 20 |44-200 Rybnik;1508;802;802;15;787;53.18;1.87
105563;247301;Zespół Szkolno - Przedszkolny Nr 14|Rybnik|ul. Leopolda Staffa 42A |44-200 Rybnik;1229;709;709;18;691;57.69;2.54
105564;247301;Zespół Szkolno - Przedszkolny Nr 14|Rybnik|ul. Leopolda Staffa 42A |44-200 Rybnik;1424;766;766;15;751;53.79;1.96
105565;247301;Szkoła Podstawowa Nr 22 im. Juliusza Słowackiego|Rybnik|ul. Boczna 17 |44-200 Rybnik;1675;812;812;17;795;48.48;2.09
105566;247301;Szkoła Podstawowa Nr 22 im. Juliusza Słowackiego|Rybnik|ul. Boczna 17 |44-200 Rybnik;1557;730;730;7;723;46.89;0.96
105567;247301;Zespół Szkół Nr 5 im. Józefa Rymera|Rybnik|ul. Józefa Rymera 24A |44-200 Rybnik;1413;666;666;21;645;47.13;3.15
105568;247301;Zespół Szkół Nr 5 im. Józefa Rymera|Rybnik|ul. Józefa Rymera 24A |44-200 Rybnik;1465;738;738;11;727;50.38;1.49
105569;247301;Szkoła Podstawowa Nr 21 im. Karola Miarki|Rybnik|ul. Niedobczycka 191 |44-200 Rybnik;1863;1046;1046;24;1022;56.15;2.29
105570;247301;Szkoła Podstawowa Nr 21 im. Karola Miarki|Rybnik|ul. Niedobczycka 191 |44-200 Rybnik;1795;935;935;35;900;52.09;3.74
105571;247301;Zespół Szkolno - Przedszkolny Nr 2 im. Janusza Korczaka|Rybnik|ul. Gustawa Morcinka 18 |44-200 Rybnik;1814;855;855;33;822;47.13;3.86
105572;247301;Gimnazjum Nr 12 im. Górniczego Stanu|Rybnik|ul. Sportowa 52 |44-200 Rybnik;2038;1005;1006;21;984;49.31;2.09
105573;247301;Zespół Szkół Nr 3|Rybnik|ul. Orzepowicka 15A |44-200 Rybnik;2173;1080;1080;25;1055;49.70;2.31
105574;247301;Zespół Szkół Nr 3|Rybnik|ul. Orzepowicka 15A |44-200 Rybnik;1977;1104;1104;15;1089;55.84;1.36
105575;247301;Zespół Szkół Nr 3|Rybnik|ul. Orzepowicka 15A |44-200 Rybnik;1465;808;808;8;800;55.15;0.99
105576;247301;Zespół Szkół Nr 3|Rybnik|ul. Orzepowicka 15A |44-200 Rybnik;2239;1281;1281;14;1267;57.21;1.09
105577;247301;Gimnazjum Mistrzostwa Sportowego Nr 2 im. Świętej Jadwigi Królowej Polski|Rybnik|ul. Grunwaldzka 18 |44-200 Rybnik;1647;859;859;9;850;52.16;1.05
105578;247301;Gimnazjum Mistrzostwa Sportowego Nr 2 im. Świętej Jadwigi Królowej Polski|Rybnik|ul. Grunwaldzka 18 |44-200 Rybnik;2108;1120;1120;19;1101;53.13;1.70
105579;247301;Zespół Szkolno - Przedszkolny Nr 11|Rybnik|ul. Władysława Hibnera 25 |44-200 Rybnik;2143;979;979;21;958;45.68;2.15
105580;247301;Zespół Szkół Ekonomiczno -Usługowych|Rybnik|ul. Św.Józefa 30 |44-200 Rybnik;1648;985;985;12;973;59.77;1.22
105581;247301;Szkoła Podstawowa z Oddziałami Integracyjnymi Nr 34 im. Ireny Sendlerowej|Rybnik|ul. Władysława Stanisława Reymonta 69 |44-200 Rybnik;1838;1032;1032;28;1004;56.15;2.71
105582;247301;Szkoła Podstawowa z Oddziałami Integracyjnymi Nr 34 im. Ireny Sendlerowej|Rybnik|ul.Władysława Stanisława Reymonta 69 |44-200 Rybnik;1889;1122;1122;18;1104;59.40;1.60
105583;247301;Zespół Szkolno - Przedszkolny Nr 10|Rybnik|ul. Wodzisławska 46 |44-200 Rybnik;1922;1096;1096;4;1092;57.02;0.36
105584;247301;Zespół Szkolno-Przedszkolny Nr 9|Rybnik|ul. Wodzisławska 123 |44-200 Rybnik;1284;787;787;6;781;61.29;0.76
105585;247301;Zespół Szkolno-Przedszkolny Nr 9|Rybnik|ul. Wodzisławska 123 |44-200 Rybnik;1401;913;913;11;902;65.17;1.20
105586;247301;Zespół Szkolno-Przedszkolny Nr 12|Rybnik|ul.Maksymiliana Buhla 3 |44-200 Rybnik;1366;790;790;13;777;57.83;1.65
105587;247301;Zespół Szkolno -Przedszkolny Nr 12|Rybnik|ul.Maksymiliana Buhla 3 |44-200 Rybnik;1136;613;613;7;606;53.96;1.14
105588;247301;Państwowy Szpital dla Nerwowo i Psychicznie Chorych w Rybniku|Rybnik|Gliwicka 33 |44-200 ;575;192;192;24;168;33.39;12.50
105589;247301;Miejski Dom Pomocy Społecznej w Rybniku|Rybnik|Żużlowa 25 |44-200 ;134;56;56;4;52;41.79;7.14
105590;247301;Wojewódzki Szpital Specjalistyczny Nr 3 w Rybniku|Rybnik|Energetyków 46 |44-200 Rybnik;386;141;141;2;139;36.53;1.42
105591;247301;Śląskie Centrum Medyczne - Dom Opieki "Senior" w Rybniku|Rybnik|Wrębowa 21 |44-200 Rybnik;21;14;14;0;14;66.67;0.00
105592;247401;Zespół Szkół Ponadgimnazjalnych "Cogito"|Siemianowice Śląskie|ul. Matejki 5 |41-100 Siemianowice Śląskie;990;217;217;13;204;21.92;5.99
105593;247401;Szkoła Podstawowa Nr 11|Siemianowice Śląskie, Sadzawki|ul. Słowackiego 5 |41-100 Siemianowice Śląskie;1078;488;488;9;479;45.27;1.84
105594;247401;Świetlica Wojskowych Zakładów Mechanocznych|Siemianowice Śląskie|ul. Powstańców 5 |41-100 Siemianowice Śląskie;1370;563;563;15;548;41.09;2.66
105595;247401;Zespół Szkół Specjalnych|Siemianowice Śląskie|ul. Myśliwiecka 6 |41-100 Siemianowice Śląskie;1554;551;551;26;525;35.46;4.72
105596;247401;Szkoła Podstawowa Nr 6|Siemianowice Śląskie|ul. 1 Maja 16 |41-100 Siemianowice Śląskie;1368;526;526;15;511;38.45;2.85
105597;247401;Liceum Ogólnokształcące Nr 1|Siemianowice Śląskie|ul. Wyspiańskiego 5 |41-100 Siemianowice Śląskie;1224;491;491;10;481;40.11;2.04
105598;247401;Samodzielny Publiczny Zakład Pielęgnacyjno-Opiekuńczy|Siemianowice Śląskie|Szpitalna 4 |41-100 Siemianowice Śląskie;42;3;3;0;3;7.14;0.00
105599;247401;Szpital Miejski Sp. z o.o.|Siemianowice Śląskie|1 Maja 9 |41-100 Siemianowice Śląskie;79;50;50;2;48;63.29;4.00
105600;247401;Samodzielny Publiczny Zespół Lecznictwa Psychiatrycznego|Siemianowice Śląskie|ul. Szkolna 2 |41-100 Siemianowice Śląskie;1959;724;724;39;685;36.96;5.39
105601;247401;Szkoła Podastawowa Nr 3|Siemianowice Śląskie|ul. Szkolna 15 |41-100 Siemianowice Śląskie;1953;721;721;22;699;36.92;3.05
105602;247401;Zespół Szkół Integracyjnych|Siemianowice Śląskie|ul. Lipowa 3 |41-100 Siemianowice Śląskie;1664;742;742;25;717;44.59;3.37
105603;247401;Przedszkole Nr 9|Siemianowice Śląskie|ul. Okrężna 17 |41-100 Siemianowice Śląskie;1144;705;705;16;689;61.63;2.27
105604;247401;Liceum Ogólnokształcące Nr 2|Siemianowice Śląskie|ul. Leśna 1 |41-100 Siemianowice Śląskie;1456;675;675;16;659;46.36;2.37
105605;247401;Szkoła Podstawowa Nr 1|Siemianowice Śląskie, Bytków|ul. Niepodległości 47 |41-106 Siemianowice Śląskie;1486;876;876;13;863;58.95;1.48
105606;247401;Dom Kultury "Chemik"|Siemianowice Śląskie|ul. Niepodległości 51 |41-100 Siemianowice Śląskie;2259;1333;1333;27;1306;59.01;2.03
105607;247401;Przedszkole Nr 15|Siemianowice Śląskie, Bytków|ul. Grunwaldzka 10 |41-106 Siemianowice Śląskie;1742;1147;1147;14;1133;65.84;1.22
105608;247401;Siemianowice Centrum Kultury|Siemianowice Śląskie, Bytków|ul. Niepodległości 45 |41-106 Siemianowice Śląskie;1442;844;844;10;834;58.53;1.18
105609;247401;Przedszkole Nr 15|Siemianowice Śląskie, Bytków|ul. Grunwaldzka 10 |41-106 Siemianowice Śląskie;1818;1063;1063;17;1046;58.47;1.60
105610;247401;Gimnazjum Nr 3|Siemianowice Śląskie|ul. Korfantego 18 |41-100 Siemianowice Śląskie;1376;831;831;17;814;60.39;2.05
105611;247401;Przedszkole Nr 20|Siemianowice Śląskie|ul. Wróbla 11 |41-100 Siemianowice Śląskie;1155;713;713;17;696;61.73;2.38
105612;247401;Przedszkole Nr 2|Siemianowice Śląskie, Bytków|ul. ZHP 8 |41-106 Siemianowice Śląskie;1335;758;758;11;747;56.78;1.45
105613;247401;Zespół Szkół Sportowych|Siemianowice Śląskie, Bytków|ul. Mikołaja 3 |41-106 Siemianowice Śląskie;1511;900;900;9;891;59.56;1.00
105614;247401;Szkoła Podstawowa Nr 8|Siemianowice Śląskie, Bytków|pl. Skrzeka i Wójcika 4 |41-106 Siemianowice Śląskie;1080;653;653;15;638;60.46;2.30
105615;247401;Dom Harcerza|Siemianowice Śląskie, Bytków|ul. Wróblewskiego 10 |41-106 Siemianowice Śląskie;1248;745;745;12;733;59.70;1.61
105616;247401;Młodzieżowy Dom Kultury|Siemianowice Śląskie|ul. Chopina 2 |41-100 Siemianowice Śląskie;1298;875;875;9;866;67.41;1.03
105617;247401;Gimnazjum Nr 4|Siemianowice Śląskie|ul. Chopina 4a |41-100 Siemianowice Śląskie;1273;552;552;20;532;43.36;3.62
105618;247401;Liceum Ogólnokształcące Nr 1|Siemianowice Śląskie|ul. Wyspiańskiego 5 |41-100 Siemianowice Śląskie;1630;711;711;17;694;43.62;2.39
105619;247401;Szkoła Podstawowa Nr 5|Siemianowice Śląskie|ul. Michałkowicka 15 |41-100 Siemianowice Śląskie;1563;683;683;22;661;43.70;3.22
105620;247401;Prywatne Liceum ARKONA|Siemianowice Śląskie, Bańgów|ul. Okrzei 2 |41-103 Siemianowice Śląskie;407;206;206;4;202;50.61;1.94
105621;247401;Zespół Szkół Nr 1|Siemianowice Śląskie, Bańgów|ul. Szymanowskiego 11 |41-103 Siemianowice Śląskie;1330;795;795;12;783;59.77;1.51
105622;247401;Zespół Szkół Nr 1|Siemianowice Śląskie, Bańgów|ul. Szymanowskiego 11 |41-103 Siemianowice Śląskie;911;495;495;10;485;54.34;2.02
105623;247401;Ośrodek Rehabilitacyjny "Wichrowe Wzgórza"|Siemianowice Śląskie, Przełajka|ul. Wiejska 2 |41-103 Siemianowice Śląskie;1006;613;613;10;603;60.93;1.63
105624;247401;Zespół Szkół Nr 4|Siemianowice Śląskie, Michałkowice|ul. Dąbrowskiej 10 |41-103 Siemianowice Śląskie;1565;895;895;25;870;57.19;2.79
105625;247401;Przedszkole Nr 12|Siemianowice Śląskie, Michałkowice|ul. Oświęcimska 3 |41-103 Siemianowice Śląskie;1710;932;932;22;910;54.50;2.36
105626;247401;Gimnazjum Nr 2|Siemianowice Śląskie, Michałkowice|ul. Przyjaźni 28 |41-103 Siemianowice Śląskie;1789;988;988;23;965;55.23;2.33
105627;247401;Przedszkole Nr 16|Siemianowice Śląskie, Michałkowice|ul. Stawowa 22 |41-103 Siemianowice Śląskie;1837;989;989;23;966;53.84;2.33
105628;247401;Przedszkole Nr 6|Siemianowice Śląskie, Michałkowice|ul. Kościelna 39 |41-103 Siemianowice Śląskie;1318;604;604;9;595;45.83;1.49
105629;247401;Zespół Szkół Ogólnokształcących i Zawodowych|Siemianowice Śląskie, Michałkowice|ul. Budryka 2 |41-103 Siemianowice Śląskie;658;283;283;4;279;43.01;1.41
105630;247401;Świetlica Katowickich Zakładów Wyrobów Metalowych|Siemianowice Śląskie, Michałkowice|ul. Żeromskiego 21 |41-103 Siemianowice Śląskie;1222;534;534;23;511;43.70;4.31
105631;247401;Szkoła Podstawowa Nr 13|Siemianowice Śląskie, Michałkowice|ul. Barlickiwgo 2 |41-103 Siemianowice Śląskie;2001;1209;1209;13;1196;60.42;1.08
105632;247501;Przedszkole Miejskie Nr 11|Sosnowiec, Milowice|ul. Krzysztofa Kamila Baczyńskiego 16 |41-203 Sosnowiec;1102;638;638;10;628;57.89;1.57
105633;247501;Zespół Szkół Ogólnokształcących Nr 13|Sosnowiec, Milowice|ul. Krzysztofa Kamila Baczyńskiego 14 |41-203 Sosnowiec;1693;927;927;12;915;54.75;1.29
105634;247501;Regionalne Centrum Kształcenia Ustawicznego|Sosnowiec, Kalety|ul. Stalowa 9a |41-214 Sosnowiec;1314;796;796;7;789;60.58;0.88
105635;247501;Regionalne Centrum Kształcenia Ustawicznego|Sosnowiec, Kalety|ul. Stalowa 9a |41-214 Sosnowiec;852;329;329;8;321;38.62;2.43
105636;247501;Zespół Szkół Specjalnych Nr 2|Sosnowiec, Pogoń|ul. Sucha 21 |41-205 Sosnowiec;1062;664;664;10;654;62.52;1.51
105637;247501;Uniwersytet Śląski, Wydział Informatyki i Nauki o Materiałach, Instytut Informatyki|Sosnowiec, Pogoń|ul. Będzińska 39 |41-205 Sosnowiec;1784;911;911;15;896;51.07;1.65
105638;247501;Zespół Szkół Ogólnokształcących Nr 8|Sosnowiec, Pogoń|ul. Hutnicza 6 |41-205 Sosnowiec;845;401;401;5;396;47.46;1.25
105639;247501;Miejski Klub im. Jana Kiepury|Sosnowiec, Pogoń|ul. Będzińska 6 |41-205 Sosnowiec;1247;735;735;21;714;58.94;2.86
105640;247501;Zespół Szkół Ogólnokształcących Nr 8|Sosnowiec, Pogoń|ul. Hutnicza 6 |41-205 Sosnowiec;774;241;241;5;236;31.14;2.07
105641;247501;Zespół Szkół Ogólnokształcących Nr 1|Sosnowiec|ul. Stanisława Staszica 62 |41-200 Sosnowiec;1166;336;336;13;323;28.82;3.87
105642;247501;Centrum Kształcenia Zawodowego i Ustawicznego w Sosnowcu Technikum Nr 1 Ekonomiczne (dawny Zespół Szkół Ekonomicznych)|Sosnowiec|ul. gen. Stefana Grota-Roweckiego 66 |41-214 Sosnowiec;1391;825;825;5;820;59.31;0.61
105643;247501;Centrum Kształcenia Zawodowego i Ustawicznego w Sosnowcu (dawny Zespół Szkół Projektowania i Stylizacji Ubioru)|Sosnowiec|ul. gen. Stefana Grota-Roweckiego 64 |41-214 Sosnowiec;1437;783;783;8;775;54.49;1.02
105644;247501;Centrum Kształcenia Zawodowego i Ustawicznego w Sosnowcu Technikum Nr 1 Ekonomiczne (dawny Zespół Szkół Ekonomicznych)|Sosnowiec|ul. gen. Stefana Grota-Roweckiego 66 |41-214 Sosnowiec;1244;681;681;7;674;54.74;1.03
105645;247501;Gimnazjum Nr 13|Sosnowiec, Pogoń|ul. Ludwika Zamenhofa 15 |41-214 Sosnowiec;2069;1068;1068;20;1048;51.62;1.87
105646;247501;Przedszkole Miejskie Nr 3|Sosnowiec, Pogoń|ul. Dąbrowszczaków 1 |41-214 Sosnowiec;1537;749;749;24;725;48.73;3.20
105647;247501;Szkoła Podstawowa Nr 27|Sosnowiec, Stary Sosnowiec|ul. Grabowa 2 |41-209 Sosnowiec;2063;1321;1321;20;1301;64.03;1.51
105648;247501;Zespół Szkół Ogólnokształcących Nr 3|Sosnowiec, Stary Sosnowiec|ul. Piłsudskiego 114 |41-209 Sosnowiec;1834;1093;1093;20;1073;59.60;1.83
105649;247501;Szkoła Podstawowa Nr 27|Sosnowiec, Stary Sosnowiec|ul. Grabowa 2 |41-209 Sosnowiec;1621;913;913;40;873;56.32;4.38
105650;247501;Centrum Kształcenia Zawodowego i Ustawicznego w Sosnowcu Technikum Nr 4 Transportowe (dawny Zespół Szkół Technicznych i Licealnych)|Sosnowiec|ul. Jana Kilińskiego 31 |41-209 Sosnowiec;2234;1309;1309;13;1296;58.59;0.99
105651;247501;Szkoła Podstawowa Nr 19|Sosnowiec, Stary Sosnowiec|ul. Składowa 5 |41-209 Sosnowiec;1758;1008;1008;20;988;57.34;1.98
105652;247501;Szkoła Podstawowa Nr 19|Sosnowiec, Stary Sosnowiec|ul. Składowa 5 |41-209 Sosnowiec;1954;1052;1052;13;1039;53.84;1.24
105653;247501;Zespół Szkół Ogólnokształcących Nr 2|Sosnowiec, Pogoń|ul. Czeladzka 58 |41-214 Sosnowiec;2142;1161;1161;15;1146;54.20;1.29
105654;247501;Uniwersytet Śląski, Wydział Filologiczny|Sosnowiec|ul. Żytnia 10 |41-205 Sosnowiec;853;421;421;7;414;49.36;1.66
105655;247501;Szkoła Podstawowa Nr 10|Sosnowiec, Pogoń|ul. Władysława Reymonta 36 |41-205 Sosnowiec;1740;885;885;9;876;50.86;1.02
105656;247501;Uniwersytet Śląski, Wydział Informatyki i Nauki o Materiałach|Sosnowiec, Pogoń|ul. Żytnia 12 |41-205 Sosnowiec;1154;529;529;7;522;45.84;1.32
105657;247501;Zespół Szkół Ogólnokształcących Nr 15|Sosnowiec|plac Waldemara Zillingera 1 |41-205 Sosnowiec;1813;769;769;22;747;42.42;2.86
105658;247501;Szkoła Podstawowa Nr 1|Sosnowiec|ul. Niepodległości 7 |41-205 Sosnowiec;1827;828;828;17;811;45.32;2.05
105659;247501;Miejski Ośrodek Sportu i Rekreacji w Sosnowcu|Sosnowiec|ul. 3 Maja 41 |41-200 Sosnowiec;1541;771;771;9;762;50.03;1.17
105660;247501;Zespół Szkół Nr 1|Sosnowiec|ul. Zamkowa 7 |41-200 Sosnowiec;2015;1196;1196;14;1182;59.35;1.17
105661;247501;Szkoła Podstawowa Nr 6|Sosnowiec|ul. Wawel 13 |41-200 Sosnowiec;1577;890;890;17;873;56.44;1.91
105662;247501;Gimnazjum Nr 16|Sosnowiec|ul. Legionów 21 |41-200 Sosnowiec;1433;817;817;8;809;57.01;0.98
105663;247501;Centrum Kształcenia Zawodowego i Ustawicznego w Sosnowcu , Technikum Nr 6 Grafiki, Logistyki i Środowiska (dawny Zespół Szkół Technicznych)|Sosnowiec|ul. Legionów 9 |41-200 Sosnowiec;1553;880;880;16;864;56.66;1.82
105664;247501;Centrum Kształcenia Zawodowego i Ustawicznego w Sosnowcu , Technikum Nr 6 Grafiki, Logistyki i Środowiska (dawny Zespół Szkół Technicznych)|Sosnowiec|ul. Legionów 9 |41-200 Sosnowiec;1641;975;975;8;967;59.41;0.82
105665;247501;Przedszkole Miejskie Nr 12|Sosnowiec|ul. Ignacego Mościckiego 26a |41-200 Sosnowiec;1337;710;710;10;700;53.10;1.41
105666;247501;Szkoła Podstawowa Nr 22|Sosnowiec|ul. Anieli Urbanowicz 14 |41-200 Sosnowiec;1387;743;743;13;730;53.57;1.75
105667;247501;Szkoła Podstawowa Nr 22|Sosnowiec|ul. Anieli Urbanowicz 14 |41-200 Sosnowiec;1055;536;536;13;523;50.81;2.43
105668;247501;Urząd Miejski w Sosnowcu|Sosnowiec|ul. Stanisława Małachowskiego 3 |41-200 Sosnowiec;1163;543;543;9;534;46.69;1.66
105669;247501;Dawny Zespół Szkół Specjalnych nr 1|Sosnowiec|ul. Teatralna 3 |41-200 Sosnowiec;1386;660;660;16;644;47.62;2.42
105670;247501;Szkoła Podstawowa Nr 4|Sosnowiec|ul. Kościelna 9 |41-200 Sosnowiec;1002;270;270;12;258;26.95;4.44
105671;247501;Przedszkole Miejskie nr 28|Sosnowiec|ul. Leona Kruczkowskiego 9 |41-200 Sosnowiec;1823;934;934;9;925;51.23;0.96
105672;247501;Szkoła Podstawowa Nr 8|Sosnowiec|ul. Teatralna 8 |41-200 Sosnowiec;1102;421;421;10;411;38.20;2.38
105673;247501;Przedszkole Miejskie Nr 55|Sosnowiec|ul. Akacjowa 81 |41-200 Sosnowiec;1284;789;789;5;784;61.45;0.63
105674;247501;Przedzkole Miejskie Nr 55 (wejście od parkingu przedszkola)|Sosnowiec|Akacjowa 81 |41-200 Sosnowiec;1980;1094;1094;9;1085;55.25;0.82
105675;247501;Szkoła Podstawowa Nr 4|Sosnowiec|ul. Kościelna 4 |41-200 Sosnowiec;1201;673;673;7;666;56.04;1.04
105676;247501;Przedszkole Miejskie Nr 56|Sosnowiec|ul. Jagiellońska 13E |41-200 Sosnowiec;1801;993;993;12;981;55.14;1.21
105677;247501;Zespół Szkół Elektronicznych i Informatycznych|Sosnowiec|ul. Jagiellońska 13 |41-200 Sosnowiec;1561;891;891;10;881;57.08;1.12
105678;247501;Zespół Szkół Specjalnych Nr 4|Sosnowiec|ul. Franciszkańska 5a |41-200 Sosnowiec;1906;962;962;15;947;50.47;1.56
105679;247501;Szkoła Podstawowa Nr 42|Sosnowiec, Środula|ul. Bolesawa Prusa 253a |41-219 Sosnowiec;1907;1132;1132;23;1109;59.36;2.03
105680;247501;Przedszkole Miejskie Nr 52|Sosnowiec, Środula|ul. Stanisława Witkiewicza 1 |41-219 Sosnowiec;1622;888;888;12;876;54.75;1.35
105681;247501;Szkoła Podstawowa Nr 16|Sosnowiec, Środula|ul. Okrzei 56 |41-219 Sosnowiec;1428;792;792;6;786;55.46;0.76
105682;247501;Szkoła Podstawowa Nr 42|Sosnowiec, Środula|ul. Bolesława Prusa 253a |41-219 Sosnowiec;1849;1101;1101;12;1089;59.55;1.09
105683;247501;Przedszkole Miejskie Nr 51|Sosnowiec, Środula|ul. Bolesława Prusa 253a |41-219 Sosnowiec;1248;682;682;9;673;54.65;1.32
105684;247501;Powiatowy Urząd Pracy|Sosnowiec, Sielec|ul. Rzeźnicza 12 |41-200 Sosnowiec;2432;1390;1390;9;1381;57.15;0.65
105685;247501;Szkoła Podstawowa Nr 20|Sosnowiec|ul. gen. Władysława Andersa 66 |41-200 Sosnowiec;1340;842;842;5;837;62.84;0.59
105686;247501;Przedszkole Miejskie Nr 50|Sosnowiec|ul. Franciszkańska 19 |41-200 Sosnowiec;458;133;133;3;130;29.04;2.26
105687;247501;Przedszkole Miejskie Nr 14|Sosnowiec|ul. Mariana Maliny 25 |41-200 Sosnowiec;941;451;451;13;438;47.93;2.88
105688;247501;Zespół Szkół Ogólnokształcących Nr 9|Sosnowiec, Dańdówka|ul. Jedności 7 |41-208 Sosnowiec;1102;555;555;11;544;50.36;1.98
105689;247501;Warsztaty Terapii Zajęciowej przy TPD|Sosnowiec, Dańdówka|ul. Jodłowa 1 |41-208 Sosnowiec;2039;1002;1002;39;963;49.14;3.89
105690;247501;Przedszkole Miejskie Nr 54|Sosnowiec, Dańdówka|ul. Kalinowa 115 |41-208 Sosnowiec;1976;1031;1031;19;1012;52.18;1.84
105691;247501;Szkoła Podstawowa Nr 29|Sosnowiec, Dańdówka|ul. Zagłębiowska 25 |41-208 Sosnowiec;2043;946;946;20;926;46.30;2.11
105692;247501;Szkoła Podstawowa Nr 11 "Modrzejów"|Sosnowiec, Modrzejów|ul. Orląt Lwowskich 2 |41-208 Sosnowiec;755;379;379;10;369;50.20;2.64
105693;247501;Szkoła Podstawowa Nr 15|Sosnowiec, Niwka|ul. Wojska Polskiego 84 |41-208 Sosnowiec;2208;1099;1099;21;1078;49.77;1.91
105694;247501;Gimnazjum Nr 1|Sosnowiec, Niwka|ul. Wojska Polskiego 86 |41-208 Sosnowiec;2041;992;992;13;979;48.60;1.31
105695;247501;Przedszkole Miejskie Nr 20|Sosnowiec, Modrzejów|ul. Adama Śliwki 38 |41-208 Sosnowiec;1957;934;934;26;908;47.73;2.78
105696;247501;Dawny Budynek ADM 2 Spółdzielni Mieszkaniowej "LOKUM"|Sosnowiec, Bór|Biała Przemsza 35 |41-208 Sosnowiec;1803;910;910;19;891;50.47;2.09
105697;247501;Szkoła Podstawowa Nr 21|Sosnowiec, Jęzor|ul. Zawodzie 34 |41-208 Sosnowiec;1061;592;592;14;578;55.80;2.36
105698;247501;Szkoła Podstawowa Nr 20|Sosnowiec|ul. gen. Władysława Andersa 66 |41-200 Sosnowiec;1587;742;743;17;725;46.75;2.29
105699;247501;Hala Widowiskowo - Sportowa|Sosnowiec, Zagórze|ul. Braci Mieroszewskich 91 |41-219 Sosnowiec;1021;474;474;9;465;46.43;1.90
105700;247501;Przedszkole Miejskie Nr 38|Sosnowiec, Zagórze|ul. Bolesława Krzywoustego 6 |41-219 Sosnowiec;1517;826;826;13;813;54.45;1.57
105701;247501;Szkoła Podstawowa Nr 23|Sosnowiec, Zagórze|ul. Tomasza Zapały 3 |41-219 Sosnowiec;1729;808;808;12;796;46.73;1.49
105702;247501;Szkoła Podstawowa Nr 9|Sosnowiec, Zagórze|ul. Braci Mieroszewskich 54 |41-219 Sosnowiec;1734;892;892;18;874;51.44;2.02
105703;247501;Przedszkole Miejskie Nr 59|Sosnowiec, Zagórze|ul. Jana Długosza 11a |41-219 Sosnowiec;2099;1134;1134;22;1112;54.03;1.94
105704;247501;Przedszkole Miejskie Nr 39|Sosnowiec, Zagórze|ul. Romana Dmowskiego 18a |41-219 Sosnowiec;1953;981;981;27;954;50.23;2.75
105705;247501;Gimnazjum Nr 9|Sosnowiec, Zagórze|ul. Ignacego Kalagi 9a |41-219 Sosnowiec;2236;1133;1133;19;1114;50.67;1.68
105706;247501;Zespół Szkół Ogólnokształcących Nr 5|Sosnowiec, Zagórze|Bohaterów Monte Cassino 46 |41-219 Sosnowiec;2123;799;799;19;780;37.64;2.38
105707;247501;Zespół Szkół Ogólnokształcących Nr 5|Sosnowiec, Zagórze|ul. Bohaterów Monte Cassino 46 |41-219 Sosnowiec;1630;790;790;12;778;48.47;1.52
105708;247501;Przedszkole Miejskie Nr 43|Sosnowiec, Zagórze|ul. Bohaterów Monte Cassino 46 |41-219 Sosnowiec;1198;630;630;14;616;52.59;2.22
105709;247501;Zespół Szkół Ogólnokształcących Nr 14|Sosnowiec, Zagórze|ul. Stefana Kisielewskiego 4b |41-219 Sosnowiec;1749;936;936;12;924;53.52;1.28
105710;247501;Przedszkole Miejskie Nr 45|Sosnowiec, Zagórze|ul. Stefana Kisielewskiego 4a |41-219 Sosnowiec;1718;999;999;17;982;58.15;1.70
105711;247501;Szkoła Podstawowa Nr 39|Sosnowiec, Zagórze|ul. Lubelska 51 |41-219 Sosnowiec;1782;1055;1055;10;1045;59.20;0.95
105712;247501;Przedszkole Miejskie Nr 46|Sosnowiec, Zagórze|ul. Koszalińska 55 |41-219 Sosnowiec;1420;774;774;19;755;54.51;2.45
105713;247501;Przedszkole Miejskie Nr 44|Sosnowiec, Zagórze|ul. Lubelska 49 |41-219 Sosnowiec;1786;1073;1073;19;1054;60.08;1.77
105714;247501;Klub "Bakcyl" Spółdzielni Mieszkaniowej Hutnik|Sosnowiec, Zagórze|ul. Koszalińska 15 |41-219 Sosnowiec;1071;535;535;3;532;49.95;0.56
105715;247501;Szkoła Podstawowa Nr 39|Sosnowiec, Zagórze|ul. Lubelska 51 |41-219 Sosnowiec;1349;751;751;12;739;55.67;1.60
105716;247501;Poradnia Psychologiczno - Pedagogiczna Nr 2|Sosnowiec, Zagórze|ul. Białostocka 17 |41-219 Sosnowiec;1603;931;931;10;921;58.08;1.07
105717;247501;Klub "Bios" Spółdzielni Mieszkaniowej Zagórze|Sosnowiec, Zagórze|ul. Teofila Lenartowicza 106 |41-219 Sosnowiec;1808;1086;1086;16;1070;60.07;1.47
105718;247501;Zespół Szkół Ogólnokształcących Nr 7|Sosnowiec, Klimontów|ul. Gwiezdna 2 |41-218 Sosnowiec;2142;1238;1238;23;1215;57.80;1.86
105719;247501;Szkoła Podstawowa Nr 25|Sosnowiec, Klimontów|ul. Janka Krasickiego 1 |41-218 Sosnowiec;2342;1303;1303;32;1271;55.64;2.46
105720;247501;Przedszkole Miejskie nr 40|Sosnowiec, Klimontów|ul. Gwiezdna 16D |41-218 Sosnowiec;1546;852;852;11;841;55.11;1.29
105721;247501;Prywatna Szkoła Języka Angielskiego Eurolingua s.c.|Sosnowiec, Klimontów|ul. mjr. Henryka Hubala-Dobrzańskiego 124 |41-218 Sosnowiec;897;463;463;7;456;51.62;1.51
105722;247501;Przedszkole Miejskie Nr 53|Sosnowiec, Klimontów|Kornela Makuszyńskiego 4b |41-218 Sosnowiec;1734;822;822;13;809;47.40;1.58
105723;247501;Miejski Klub Maczki - Filia Klimontów|Sosnowiec, Klimontów|ul. Mjr Hubala-Dobrzańskiego 99a |41-218 Sosnowiec;1746;817;817;10;807;46.79;1.22
105724;247501;Zespół Szkół Ogólnokształcących Nr 12|Sosnowiec, Kazimierz|ul. Brunona Jasieńskiego 2a |41-215 Sosnowiec;2385;1146;1146;15;1131;48.05;1.31
105725;247501;Przedszkole Miejskie Nr 35|Sosnowiec, Porąbka|ul. Zagórska 3 |41-216 Sosnowiec;971;467;467;4;463;48.09;0.86
105726;247501;Szkoła Podstawowa Nr 35|Sosnowiec, Porąbka|ul. Stanisława Ligonia 3a |41-216 Sosnowiec;774;344;344;10;334;44.44;2.91
105727;247501;Zespół Szkół Ogólnokształcących Nr 10|Sosnowiec, Juliusz|ul. Czołgistów 12 |41-216 Sosnowiec;2101;887;887;22;865;42.22;2.48
105728;247501;Przedszkole Miejskie Nr 34|Sosnowiec, Juliusz|ul. Hanki Sawickiej 1 |41-216 Sosnowiec;1869;760;760;15;745;40.66;1.97
105729;247501;Zespół Szkół Ogólnokształcących Nr 12|Sosnowiec, Kazimierz|ul. Brunona Jasieńskiego 2a |41-215 Sosnowiec;1930;941;942;12;929;48.76;1.28
105730;247501;Przedszkole Miejskie Nr 33|Sosnowiec, Kazimierz|ul. Ogrodowa 6 |41-215 Sosnowiec;1835;918;918;27;891;50.03;2.94
105731;247501;Zespół Szkół Ogólnokształcących Nr 6|Sosnowiec, Ostrowy Górnicze|ul. Stefana Starzyńskiego 41 |41-215 Sosnowiec;1261;585;585;8;577;46.39;1.37
105732;247501;Zespół Szkół Ogólnokształcących Nr 6|Sosnowiec, Ostrowy Górnicze|ul. Stefana Starzyńskiego 41 |41-215 Sosnowiec;1235;634;634;10;624;51.34;1.58
105733;247501;Zespół Szkół Ogólnokształcących Nr 11|Sosnowiec, Maczki|ul. Skwerowa 21 |41-217 Sosnowiec;1406;725;725;10;715;51.56;1.38
105734;247501;Przedszkole Miejskie Nr 57|Sosnowiec, Pogoń|ul. Gospodarcza 63 |41-214 Sosnowiec;1392;809;809;15;794;58.12;1.85
105735;247501;Szkoła Podstawowa Nr 6|Sosnowiec, Sielec|ul. Wawel 13 |41-200 Sosnowiec;1281;758;758;9;749;59.17;1.19
105736;247501;Szkoła Podstawowa Nr 15|Sosnowiec, Niwka|ul. Wojska Polskiego 84 |41-208 Sosnowiec;824;446;446;5;441;54.13;1.12
105737;247501;Szkoła Podstawowa Nr 16|Sosnowiec, Środula|ul. Okrzei 56 |41-219 Sosnowiec;1606;772;772;9;763;48.07;1.17
105738;247501;Szkoła Podstawowa Nr 42|Sosnowiec, Środula|ul. Bolesława Prusa 253a |41-219 Sosnowiec;1475;808;808;11;797;54.78;1.36
105739;247501;Zespół Szkół Elektronicznych i Informatycznych|Sosnowiec|ul. Jagiellońska 13 |41-200 Sosnowiec;1332;776;776;7;769;58.26;0.90
105740;247501;Zespół Szkół Ogólnokształcących Nr 5|Sosnowiec, Zagórze|ul. Bohaterów Monte Cassino 46 |41-219 Sosnowiec;1230;650;650;9;641;52.85;1.38
105741;247501;Dom Pomocy Społecznej Nr 1|Sosnowiec|Gen. Władysława Andersa 81B |41-200 ;71;34;34;3;31;47.89;8.82
105742;247501;Sosnowiecki Szpital Miejski Sp. z o.o.|Sosnowiec|ul. Emila Zegadłowicza 3 |41-200 ;214;64;64;9;55;29.91;14.06
105743;247501;Dom Pomocy Społecznej Nr 2|Sosnowiec|ul. Jagiellońska 2 |41-200 ;80;53;53;1;52;66.25;1.89
105744;247501;Sosnowiecki Szpital Miejski Sp. z o.o.|Sosnowiec|Szpitalna 1 |41-200 ;229;66;66;0;66;28.82;0.00
105745;247501;Wojewódzki Szpital Specjalistyczny Nr 5 im. św. Barbary w Sosnowcu|Sosnowiec|Plac Medyków 1 |41-200 ;331;90;90;3;87;27.19;3.33
105746;247501;Centrum Profilaktyki Leczenia i i Opieki MEDICO NZOZ Sp. z o.o.|Sosnowiec|Odrodzenia 9 |41-200 ;65;4;4;0;4;6.15;0.00
105747;247501;Areszt Śledczy w Sosnowcu|Sosnowiec|Radocha 25 |41-200 ;299;151;151;7;144;50.50;4.64
105748;247501;Ośrodek Opiekuńczy dla Bezdomnych|Sosnowiec|Piotrkowska 19 |41-200 ;62;22;22;5;17;35.48;22.73
105749;247601;Przedszkole Miejskie Nr 9|Świętochłowice, Chropaczów|ul. Sportowa 6 |41-608 Świętochłowice;1936;962;962;10;952;49.69;1.04
105750;247601;Szkoła Podstawowa Nr 17|Świętochłowice, Chropaczów|ul. Armii Ludowej 14 |41-608 Świętochłowice;1875;485;485;23;462;25.87;4.74
105751;247601;Miejskie Przedsiębiorstwo Gospodarki Komunalnej Sp. z o.o.|Świętochłowice, Chropaczów|ul. Łagiewnicka 76 |41-608 Świętochłowice;1758;899;899;19;880;51.14;2.11
105752;247601;Szkoła Podstawowa Specjalna Nr 10|Świętochłowice, Chropaczów|ul. Łagiewnicka 65 |41-608 Świętochłowice;1858;1018;1018;19;999;54.79;1.87
105753;247601;Zespół Szkół Ogólnokształcących Nr 2|Świętochłowice, Chropaczów|ul. Sudecka 5 |41-608 Świętochłowice;1515;862;862;11;851;56.90;1.28
105754;247601;Zespół Szkół Ogólnokształcących Nr 2|Świętochłowice, Chropaczów|ul. Sudecka 5 |41-608 Świętochłowice;1203;685;685;9;676;56.94;1.31
105755;247601;Zespół Szkół Gimnazjalnych i Pracy Pozaszkolnej|Świętochłowice, Lipiny|ul. Doktora Bukowego 23 |41-605 Świętochłowice;1239;228;228;13;215;18.40;5.70
105756;247601;Zespół Szkół Gimnazjalnych i Pracy Pozaszkolnej|Świętochłowice, Lipiny|ul. Doktora Bukowego 23 |41-605 Świętochłowice;1442;399;399;21;378;27.67;5.26
105757;247601;Centrum Kultury Śląskiej -Lipiny|Świętochłowice, Lipiny|ul. Chorzowska 73 |41-605 Świętochłowice;1853;663;663;25;638;35.78;3.77
105758;247601;Miejska Biblioteka Publiczna|Świętochłowice, Piaśniki|ul. Chorzowska 37 |41-605 Świętochłowice;1935;1030;1030;26;1004;53.23;2.52
105759;247601;Świetlica Spółdzielni Mieszkaniowej|Świętochłowice, Piaśniki|ul. Korfantego 1 |41-605 Świętochłowice;1777;945;945;18;927;53.18;1.90
105760;247601;Szkoła Podstawowa Nr 1|Świętochłowice, Piaśniki|ul. Zubrzyckiego 38 |41-605 Świętochłowice;1962;1180;1180;18;1162;60.14;1.53
105761;247601;Sala Gimnastyczna OSIR Skałka|Świętochłowice|ul. Szkolna 10 |41-600 Świętochłowice;1677;496;496;30;466;29.58;6.05
105762;247601;Szkoła Podstawowa nr 4|Świętochłowice|ul. Szkolna 17 |41-600 Świętochłowice;1886;1076;1076;20;1056;57.05;1.86
105763;247601;Zespół Szkół Specjalnych|Świętochłowice|ul. Szkolna 13 |41-600 Świętochłowice;1882;857;857;18;839;45.54;2.10
105764;247601;Zespół Szkół Ogólnokształcących nr 1|Świętochłowice|ul. Licealna 1 |41-600 Świętochłowice;1461;811;811;16;795;55.51;1.97
105765;247601;Szkoła Podstawowa nr 2|Świętochłowice|ul. Wyzwolenia 50 |41-600 Świętochłowice;1938;882;882;15;867;45.51;1.70
105766;247601;Miejska Biblioteka Publiczna|Świętochłowice|ul. Świerczewskiego 1D |41-600 Świętochłowice;2016;713;713;17;696;35.37;2.38
105767;247601;Zespół Szkół Ekonomiczno-Usługowych|Świętochłowice|ul. Sikorskiego 9 |41-600 Świętochłowice;1751;565;565;9;556;32.27;1.59
105768;247601;Szkoła Podstawowa Nr 3|Świętochłowice|ul. Chopina 1 |41-600 Świętochłowice;1345;691;691;21;670;51.38;3.04
105769;247601;Centrum Kultury Śląskiej - Zgoda|Świętochłowice|ul. Krauzego 1 |41-600 Świętochłowice;1889;869;869;14;855;46.00;1.61
105770;247601;Szkoła Podstawowa Nr 8|Świętochłowice|ul. Komandra 9 |41-600 Świętochłowice;2224;1219;1219;19;1200;54.81;1.56
105771;247601;Powiatowy Urząd Pracy|Świętochłowice, Zgoda|ul. Plebiscytowa 3 |41-600 Świętochłowice;1082;488;488;7;481;45.10;1.43
105772;247601;Miejski Dom Pomocy Społecznej "Złota Jesień"|Świętochłowice, Lipiny|Imieli 12 |41-605 Świętochłowice;61;37;37;0;37;60.66;0.00
105773;247601;Szpital Powiatowy Zespołu Opieki Zdrowotnej w Świętochłowicach|Świętochłowice, Piaśniki|Chorzowska 36 |41-605 Świętochłowice;143;49;49;3;46;34.27;6.12
105774;247601;Zakład Opiekuńczo-Leczniczy Zespołu Opieki Zdrowotnej w Świętochłowicach|Świętochłowice|Szpitalna 2 |41-600 Świętochłowice;67;2;2;0;2;2.99;0.00
105775;247701;II Liceum Ogólnokształcące|Tychy|ul. Cypriana Norwida 40 |43-100 Tychy;1711;1130;1130;18;1112;66.04;1.59
105776;247701;Szkoła Podstawowa Nr 1|Tychy|Plac Wolności 4 |43-100 Tychy;1684;1140;1140;17;1123;67.70;1.49
105777;247701;Szkoła Podstawowa Nr 1|Tychy|Plac Wolności 4 |43-100 Tychy;1689;1003;1003;11;992;59.38;1.10
105778;247701;Szkoła Podstawowa Nr 6|Tychy|ul. Katowicka 102 |43-100 Tychy;1991;1336;1336;12;1324;67.10;0.90
105779;247701;Szkoła Podstawowa Nr 6|Tychy|ul. Katowicka 102 |43-100 Tychy;1818;1022;1022;19;1003;56.22;1.86
105780;247701;Szkoła Podstawowa Nr 3|Tychy|ul. Wojska Polskiego 10 |43-100 Tychy;1759;770;770;34;736;43.77;4.42
105781;247701;Szkoła Podstawowa Nr 3|Tychy|ul. Wojska Polskiego 10 |43-100 Tychy;1257;610;610;23;587;48.53;3.77
105782;247701;Gimnazjum Nr 1|Tychy|ul. Brzozowa 24 |43-100 Tychy;1311;697;697;11;686;53.17;1.58
105783;247701;Miejskie Centrum Kultury|Tychy|ul. Bohaterów Warszawy 26 |43-100 Tychy;1736;827;827;17;810;47.64;2.06
105784;247701;Przedszkole Nr 11|Tychy|ul. Bukowa 29 |43-100 Tychy;2046;1005;1005;24;981;49.12;2.39
105785;247701;Szkoła Podstawowa Nr 17|Tychy|ul. Begonii 5 |43-100 Tychy;1321;624;624;13;611;47.24;2.08
105786;247701;Szkoła Podstawowa Nr 17|Tychy|ul. Begonii 5 |43-100 Tychy;1373;892;892;12;880;64.97;1.35
105787;247701;Zespół Szkolno-Przedszkolny nr 3|Tychy|ul. Cmentarna 54 |43-100 Tychy;996;654;654;14;640;65.66;2.14
105788;247701;Szkoła Podstawowa Nr 4|Tychy|ul. Oświęcimska 256 |43-100 Tychy;1581;915;915;8;907;57.87;0.87
105789;247701;Szkoła Podstawowa Nr 4|Tychy|ul. Oświęcimska 256 |43-100 Tychy;1341;787;787;21;766;58.69;2.67
105790;247701;Zespół Szkół Nr 5|Tychy|ul. Edukacji 11 |43-100 Tychy;1633;817;817;12;805;50.03;1.47
105791;247701;I Liceum Ogólnokształcące|Tychy|ul. Janusza Korczaka 6 |43-100 Tychy;1910;1040;1040;41;999;54.45;3.94
105792;247701;Zespół Szkół Nr 1|Tychy|ul. Filaretów 27 |43-100 Tychy;1920;1178;1178;16;1162;61.35;1.36
105793;247701;Zespół Szkół Nr 2|Tychy|ul. Elfów 9 |43-100 Tychy;1863;825;825;13;812;44.28;1.58
105794;247701;Gimnazjum Nr 11|Tychy|al. Niepodległości 108 |43-100 Tychy;1679;810;810;13;797;48.24;1.60
105795;247701;Gimnazjum Nr 11|Tychy|al. Niepodległości 108 |43-100 Tychy;1164;556;556;5;551;47.77;0.90
105796;247701;Przedszkole Nr 22|Tychy|ul. Henryka Dąbrowskiego 85 |43-100 Tychy;1921;1039;1039;6;1033;54.09;0.58
105797;247701;Przedszkole Nr 19|Tychy|al. Niepodległości 154 |43-100 Tychy;1604;874;874;22;852;54.49;2.52
105798;247701;Zespół Szkół Specjalnych Nr 8|Tychy|ul. Edukacji 21 |43-100 Tychy;1335;670;670;13;657;50.19;1.94
105799;247701;Zespół Szkół Sportowych|Tychy|al. Niepodległości 190 |43-100 Tychy;1081;642;642;9;633;59.39;1.40
105800;247701;Szkoła Podstawowa Nr 36|Tychy|ul. Generała Ch. De Gaulle'a 18 |43-100 Tychy;847;450;450;9;441;53.13;2.00
105801;247701;Przedszkole Nr 5|Tychy|ul. Elizy Orzeszkowej 56 |43-100 Tychy;1327;779;779;8;771;58.70;1.03
105802;247701;Przedszkole Nr 3|Tychy|ul. Paprocańska 156 |43-100 Tychy;1349;809;809;17;792;59.97;2.10
105803;247701;Przedszkole Nr 3|Tychy|ul. Paprocańska 156 |43-100 Tychy;1929;1149;1149;12;1137;59.56;1.04
105804;247701;Przedszkole Nr 3|Tychy|ul. Paprocańska 156 |43-100 Tychy;1429;1049;1049;17;1032;73.41;1.62
105805;247701;Szkoła Podstawowa Nr 7|Tychy|ul. Lwa Tołstoja 1 |43-100 Tychy;1579;978;978;8;970;61.94;0.82
105806;247701;Szkoła Podstawowa Nr 7|Tychy|ul. Lwa Tołstoja 1 |43-100 Tychy;1508;892;892;11;881;59.15;1.23
105807;247701;Szkoła Podstawowa Nr 7|Tychy|ul. Lwa Tołstoja 1 |43-100 Tychy;1604;921;921;17;904;57.42;1.85
105808;247701;Przedszkole Nr 17|Tychy|ul. Lwa Tołstoja 5 |43-100 Tychy;1466;835;835;12;823;56.96;1.44
105809;247701;Przedszkole Nr 17|Tychy|ul. Lwa Tołstoja 5 |43-100 Tychy;1454;911;911;15;896;62.65;1.65
105810;247701;Szkoła Podstawowa Nr 40|Tychy|ul. Alfonsa Zgrzebnioka 45 |43-100 Tychy;1686;1064;1064;8;1056;63.11;0.75
105811;247701;Szkoła Podstawowa Nr 40|Tychy|ul. Alfonsa Zgrzebnioka 45 |43-100 Tychy;1225;783;783;11;772;63.92;1.40
105812;247701;Szkoła Podstawowa Nr 40|Tychy|ul. Alfonsa Zgrzebnioka 45 |43-100 Tychy;1442;903;903;14;889;62.62;1.55
105813;247701;Zespół Szkolno - Przedszkolny Nr 2|Tychy|ul. Jedności 51 |43-100 Tychy;1162;655;655;9;646;56.37;1.37
105814;247701;Zespół Szkół|Tychy|ul. Stefana Czarnieckiego 22 |43-100 Tychy;2047;913;913;36;877;44.60;3.94
105815;247701;Szkoła Podstawowa Nr 11|Tychy|ul. M. Curie-Skłodowskiej 4 |43-100 Tychy;1563;759;759;13;746;48.56;1.71
105816;247701;Szkoła Podstawowa Nr 11|Tychy|ul. M. Curie-Skłodowskiej 4 |43-100 Tychy;1664;855;855;17;838;51.38;1.99
105817;247701;Przedszkole Nr 29|Tychy|ul. Majora Hubala 7 |43-100 Tychy;2060;1094;1094;21;1073;53.11;1.92
105818;247701;Przedszkole Nr 26|Tychy|ul. Młodziezowa 5 |43-100 Tychy;1769;1039;1039;14;1025;58.73;1.35
105819;247701;Szkoła Podstawowa Nr 35|Tychy|al. Marszałka Piłsudskiego 21 |43-100 Tychy;1728;1011;1011;7;1004;58.51;0.69
105820;247701;Szkoła Podstawowa Nr 35|Tychy|al. Marszałka Piłsudskiego 21 |43-100 Tychy;1554;934;934;9;925;60.10;0.96
105821;247701;Przedszkole Niepubliczne|Tychy|ul. Zofii Nałkowskiej 6 |43-100 Tychy;1669;995;995;14;981;59.62;1.41
105822;247701;Zespół Szkół Nr 6|Tychy|al. Marszałka Piłsudskiego 10 |43-100 Tychy;1765;1079;1079;15;1064;61.13;1.39
105823;247701;Zespół Szkół Nr 6|Tychy|al. Marszałka Piłsudskiego 10 |43-100 Tychy;1453;822;822;12;810;56.57;1.46
105824;247701;Szkoła Podstawowa Nr 37|Tychy|ul. Feliksa Konecznego 1 |43-100 Tychy;1593;942;942;0;942;59.13;0.00
105825;247701;Szkoła Podstawowa Nr 37|Tychy|ul. Feliksa Konecznego 1 |43-100 Tychy;1321;781;781;7;774;59.12;0.90
105826;247701;Przedszkole Nr 1|Tychy|ul. Myśliwska 102 |43-100 Tychy;1830;1105;1105;16;1089;60.38;1.45
105827;247701;Gimnazjum Nr 3|Tychy|ul. Borowa 123 |43-100 Tychy;1600;1009;1009;12;997;63.06;1.19
105828;247701;Gimnazjum Nr 3|Tychy|ul. Borowa 123 |43-100 Tychy;1458;893;893;16;877;61.25;1.79
105829;247701;Gimnazjum Nr 3|Tychy|ul. Borowa 123 |43-100 Tychy;1632;1045;1045;26;1019;64.03;2.49
105830;247701;Gimnazjum Nr 3|Tychy|ul. Borowa 123 |43-100 Tychy;1730;1191;1191;11;1180;68.84;0.92
105831;247701;Szkoła Podstawowa Nr 22|Tychy|ul. Harcerska 25 |43-100 Tychy;1885;1025;1025;20;1005;54.38;1.95
105832;247701;Szkoła Podstawowa Nr 22|Tychy|ul. Harcerska 25 |43-100 Tychy;1757;1082;1082;11;1071;61.58;1.02
105833;247701;Szkoła Podstawowa Nr 22|Tychy|ul. Harcerska 25 |43-100 Tychy;1989;1227;1227;27;1200;61.69;2.20
105834;247701;Szkoła Podstawowa Nr 22|Tychy|ul. Harcerska 25 |43-100 Tychy;1787;972;972;19;953;54.39;1.95
105835;247701;Zespół Szkół Nr 4|Tychy|al. Bielska 100 |43-100 Tychy;1751;1063;1063;19;1044;60.71;1.79
105836;247701;Zespół Szkół Nr 4|Tychy|al. Bielska 100 |43-100 Tychy;1651;936;936;19;917;56.69;2.03
105837;247701;Zespół Szkolno - Przedszkolny Nr 1|Tychy|ul. Leśna 66 |43-100 Tychy;1524;766;766;13;753;50.26;1.70
105838;247701;Obwód odrębny w Szpitalu Miejskim Sp. z o.o. W Tychach|Tychy|Cicha 27 |43-100 ;42;19;19;1;18;45.24;5.26
105839;247701;Obwód odrębny w Megrez Sp. z o.o. w Tychach - Wojewódzki Szpital Specjalistyczny w Tychach|Tychy|Edukacji 102 |43-100 ;203;116;116;4;112;57.14;3.45
105840;247701;Obwód odrębny w Domu Pomocy Społecznej Św. Anna w Tychach|Tychy|ul. Mikołaja Kopernika 8 |43-100 Tychy;53;28;28;1;27;52.83;3.57
105841;247701;X Oddział Kardiologii Inwazyjnej, Elektrofizjologii i Elektrostymulacji Polsko-Amerykańska Klinika Serca w Tychach|Tychy|Edukacji 102 |43-100 Tychy;14;8;8;1;7;57.14;12.50
105842;247801;Szkoła Podstawowa Nr 30|Zabrze|ul. Ludwiki Wawrzyńskiej 11 |41-813 Zabrze;1484;578;578;13;565;38.95;2.25
105843;247801;Szkoła Podstawowa Nr 30|Zabrze|ul. Ludwiki Wawrzyńskiej 11 |41-813 Zabrze;1774;678;678;15;663;38.22;2.21
105844;247801;Salezjański Zespół Szkół Publicznych|Zabrze|ul. Leona Kruczkowskiego 31 |41-813 Zabrze;1280;526;526;15;511;41.09;2.85
105845;247801;Gimnazjum Nr 24|Zabrze|ul. Ludwika Zamenhofa 56 |41-813 Zabrze;1632;765;765;18;747;46.88;2.35
105846;247801;Gimnazjum Nr 24|Zabrze|ul. Ludwika Zamenhofa 56 |41-813 Zabrze;1716;798;798;9;789;46.50;1.13
105847;247801;Szkoła Podstawowa Nr 31|Zabrze|ul. Dr. Henryka Jordana 7 |41-813 Zabrze;1659;656;656;12;644;39.54;1.83
105848;247801;Zespół Szkół Ogólnokształcących Nr 12|Zabrze|ul. Gen. Władysława Andersa 64 |41-808 Zabrze;1785;622;622;11;611;34.85;1.77
105849;247801;Zespół Szkół Ogólnokształcących Nr 12|Zabrze|ul. Gen. Władysława Andersa 64 |41-808 Zabrze;2212;1004;1004;19;985;45.39;1.89
105850;247801;Gimnazjum Nr 29|Zabrze|ul. Budowlana 26 |41-808 Zabrze;1687;614;614;13;601;36.40;2.12
105851;247801;Gimnazjum Nr 29|Zabrze|ul. Budowlana 26 |41-808 Zabrze;2077;887;887;13;874;42.71;1.47
105852;247801;Szkoła Podstawowa Nr 28|Zabrze|ul. Ireny Kosmowskiej 43 |41-808 Zabrze;2223;809;809;23;786;36.39;2.84
105853;247801;Zespół Szkolno-Przedszkolny Nr 8|Zabrze|ul. Ks. Jerzego Badestinusa 30 |41-814 Zabrze;1767;854;854;14;840;48.33;1.64
105854;247801;Szkoła Podstawowa Nr 24|Zabrze|ul. Tarnopolska 85 |41-807 Zabrze;2243;1003;1003;13;990;44.72;1.30
105855;247801;Zespół Szkół Nr 10|Zabrze|ul. Fryderyka Chopina 26 |41-807 Zabrze;1983;596;596;11;585;30.06;1.85
105856;247801;Zespół Szkół Nr 10|Zabrze|ul. Fryderyka Chopina 26 |41-807 Zabrze;1923;718;718;12;706;37.34;1.67
105857;247801;Zespół Szkół Nr 10|Zabrze|ul. Fryderyka Chopina 26 |41-807 Zabrze;1306;415;415;13;402;31.78;3.13
105858;247801;Szkoła Podstawowa Nr 26|Zabrze|ul. Stanisława Ogórka 9 |41-807 Zabrze;2025;706;706;15;691;34.86;2.12
105859;247801;Zespół Szkół Katolickich|Zabrze|ul. Tarnopolska 3 |41-807 Zabrze;1558;755;755;11;744;48.46;1.46
105860;247801;Rada Dzielnicy Os. Młodego Górnika|Zabrze|ul. Młodego Górnika 2C |41-808 Zabrze;994;486;486;9;477;48.89;1.85
105861;247801;Zespół Szkół Nr 20|Zabrze|ul. Jurija Gagarina 2 |41-818 Zabrze;2058;1201;1201;30;1171;58.36;2.50
105862;247801;Zespół Szkół Nr 20|Zabrze|ul. Jurija Gagarina 2 |41-818 Zabrze;1909;1011;1011;27;984;52.96;2.67
105863;247801;Szkoła Podstawowa Nr 23|Zabrze|ul. Johanna Pestalozziego 16 |41-819 Zabrze;923;457;457;8;449;49.51;1.75
105864;247801;Przedszkole Nr 14|Zabrze|ul. Ks. Piotra Ściegiennego 1 |41-800 Zabrze;1866;888;888;18;870;47.59;2.03
105865;247801;Szkoła Podstawowa Nr 7|Zabrze|ul. Pokoju 41 |41-800 Zabrze;1985;1045;1045;13;1032;52.64;1.24
105866;247801;Szkoła Podstawowa Nr 7|Zabrze|ul. Pokoju 41 |41-800 Zabrze;2065;1003;1003;29;974;48.57;2.89
105867;247801;Szkoła Podstawowa Nr 7|Zabrze|ul. Pokoju 41 |41-800 Zabrze;1959;922;922;24;898;47.06;2.60
105868;247801;Przedszkole Nr 7|Zabrze|ul. Wolności 215A |41-800 Zabrze;1821;731;731;27;704;40.14;3.69
105869;247801;Szkoła Podstawowa Nr 25|Zabrze|ul. Prof. Tadeusza Kotarbińskiego 18 |41-819 Zabrze;2186;1184;1184;20;1164;54.16;1.69
105870;247801;Szkoła Podstawowa Nr 25|Zabrze|ul. Prof. Tadeusza Kotarbińskiego 18 |41-819 Zabrze;1270;777;777;8;769;61.18;1.03
105871;247801;Zespół Szkół Spożywczych|Zabrze|ul. Franciszkańska 13 |41-819 Zabrze;2150;1043;1043;21;1022;48.51;2.01
105872;247801;Szkoła Podstawowa Nr 14|Zabrze|ul. Gdańska 10 |41-800 Zabrze;2028;1022;1022;16;1006;50.39;1.57
105873;247801;Przedszkole Nr 25|Zabrze|ul. Cieszyńska 33 |41-800 Zabrze;2024;1147;1147;16;1131;56.67;1.39
105874;247801;Szkoła Podstawowa Nr 14|Zabrze|ul. Gdańska 10 |41-800 Zabrze;1233;586;586;12;574;47.53;2.05
105875;247801;Przedszkole Nr 25|Zabrze|ul. Cieszyńska 33 |41-800 Zabrze;1412;479;479;14;465;33.92;2.92
105876;247801;Szkoła Podstawowa Nr 8|Zabrze|ul. Ks. Józefa Londzina 2 |41-800 Zabrze;1604;478;478;16;462;29.80;3.35
105877;247801;Zespół Szkół Ekonomiczno-Usługowych|Zabrze|ul. Plac Romualda Traugutta 1 |41-800 Zabrze;1550;655;655;14;641;42.26;2.14
105878;247801;Zespół Szkół Ogólnokształcących Nr 13|Zabrze|ul. Ks. Józefa Wajdy 7 |41-800 Zabrze;2048;991;991;25;966;48.39;2.52
105879;247801;Gimnazjum Nr 20|Zabrze|ul. Jana Kasprowicza 7 |41-803 Zabrze;1468;392;392;11;381;26.70;2.81
105880;247801;Zespół Szkół Specjalnych Nr 40|Zabrze|ul. Bytomska 24 |41-803 Zabrze;1521;521;521;17;504;34.25;3.26
105881;247801;Szkoła Podstawowa Nr 21|Zabrze|ul. Bytomska 26 |41-803 Zabrze;1935;773;773;19;754;39.95;2.46
105882;247801;Szkoła Podstawowa Nr 22|Zabrze|ul. Bytomska 94 |41-803 Zabrze;1555;532;532;19;513;34.21;3.57
105883;247801;Szkoła Podstawowa Nr 22|Zabrze|ul. Bytomska 94 |41-803 Zabrze;1671;411;411;22;389;24.60;5.35
105884;247801;Szkoła Podstawowa Nr 18|Zabrze|ul. Wacława Karczewskiego 10 |41-806 Zabrze;2138;1030;1030;21;1009;48.18;2.04
105885;247801;Szkoła Podstawowa Nr 18|Zabrze|ul. Wacława Karczewskiego 10 |41-806 Zabrze;1648;740;740;16;724;44.90;2.16
105886;247801;Gimnazjum Nr 9|Zabrze|ul. Olchowa 2 |41-806 Zabrze;1935;922;922;25;897;47.65;2.71
105887;247801;Gimnazjum Nr 9|Zabrze|ul. Olchowa 2 |41-806 Zabrze;2062;949;949;19;930;46.02;2.00
105888;247801;Szkoła Podstawowa Nr 17|Zabrze|ul. Ks.Doktora Antoniego Korczoka 98 |41-806 Zabrze;1863;976;976;21;955;52.39;2.15
105889;247801;Szkoła Podstawowa Nr 17|Zabrze|ul. Ks. Doktora Antoniego Korczoka 98 |41-806 Zabrze;1777;963;963;20;943;54.19;2.08
105890;247801;Szkoła Podstawowa Nr 17|Zabrze|ul. Ks. Doktora Antoniego Korczoka 98 |41-806 Zabrze;1641;945;945;15;930;57.59;1.59
105891;247801;Zespół Szkół Sportowych|Zabrze|ul. Filipiny Płaskowickiej 2 |41-806 Zabrze;285;116;116;8;108;40.70;6.90
105892;247801;Zespół Szkół Sportowych|Zabrze|ul. Filipiny Płaskowickiej 2 |41-806 Zabrze;1900;664;664;29;635;34.95;4.37
105893;247801;Szkoła Podstawowa Nr 16|Zabrze|ul. Józefa Lompy 78 |41-806 Zabrze;1459;503;503;23;480;34.48;4.57
105894;247801;Zespół Szkół Nr 3|Zabrze|ul. 3 Maja 118 |41-800 Zabrze;1991;958;958;22;936;48.12;2.30
105895;247801;Szkoła Podstawowa Nr 1|Zabrze|ul. Sportowa 5 |41-800 Zabrze;1563;712;712;9;703;45.55;1.26
105896;247801;Szkoła Podstawowa Nr 1|Zabrze|ul. Sportowa 5 |41-800 Zabrze;1451;691;691;17;674;47.62;2.46
105897;247801;Szkoła Podstawowa Nr 1|Zabrze|ul. Sportowa 5 |41-800 Zabrze;1595;834;834;25;809;52.29;3.00
105898;247801;Zespół Szkolno-Przedszkolny Nr 6|Zabrze|ul. Gen. Władysława Sikorskiego 74 |41-809 Zabrze;1763;955;955;16;939;54.17;1.68
105899;247801;Przedszkole Nr 29|Zabrze|ul. Ignacego Paderewskiego 53 |41-810 Zabrze;885;469;469;13;456;52.99;2.77
105900;247801;Zespół Szkół Nr 18|Zabrze|ul. Konrada Sitki 55 |41-810 Zabrze;926;480;480;10;470;51.84;2.08
105901;247801;Zespół Szkolno-Przedszkolny Nr 7|Zabrze|ul. Daleka 2 |41-811 Zabrze;1740;847;847;22;825;48.68;2.60
105902;247801;Zabrzańskie Centrum Kształcenia Ogólnego i Zawodowego|Zabrze|ul. Marszałka Józefa Piłsudskiego 58 |41-800 Zabrze;2073;1015;1015;20;995;48.96;1.97
105903;247801;Zespół Szkół Specjalnych Nr 38|Zabrze|ul. Ks. Konstantego Damrota 33 |41-800 Zabrze;1961;847;847;22;825;43.19;2.60
105904;247801;Zespół Szkół Specjalnych Nr 38|Zabrze|ul. Ks. Konstantego Damrota 33 |41-800 Zabrze;1951;641;641;21;620;32.85;3.28
105905;247801;Szkoła Podstawowa Nr 5|Zabrze|ul. Królewska 4 |41-800 Zabrze;2033;906;906;29;877;44.56;3.20
105906;247801;Szkoła Podstawowa Nr 5|Zabrze|ul. Królewska 4 |41-800 Zabrze;1264;676;676;12;664;53.48;1.78
105907;247801;Centrum Edukacji|Zabrze|ul. 1 Maja 12 |41-800 Zabrze;1962;1036;1036;16;1020;52.80;1.54
105908;247801;Szkoła Podstawowa Nr 36|Zabrze|Plac Warszawski 6 |41-800 Zabrze;1695;758;758;12;746;44.72;1.58
105909;247801;Szkoła Podstawowa Nr 43|Zabrze|ul. Buchenwaldczyków 25 |41-800 Zabrze;1833;735;735;18;717;40.10;2.45
105910;247801;Zespół Szkół Ogólnokształcących|Zabrze|ul. Wolności 323 |41-800 Zabrze;1828;942;942;16;926;51.53;1.70
105911;247801;Gimnazjum Nr 16|Zabrze|ul. Lucjana Szenwalda 2 |41-800 Zabrze;1523;516;516;13;503;33.88;2.52
105912;247801;Gimnajzum Nr 16|Zabrze|ul. Lucjana Szenwalda 2 |41-800 Zabrze;1598;689;689;15;674;43.12;2.18
105913;247801;Dom Harcerza|Zabrze|ul. Wolności 350A |41-800 Zabrze;1451;500;500;18;482;34.46;3.60
105914;247801;Centrum Kształcenia Zawodowego i Ustawicznego Województwa Śląskiego w Zabrzu|Zabrze|ul. 3 Maja 63 |41-800 Zabrze;1973;889;889;27;862;45.06;3.04
105915;247801;Szkoła Podstawowa Nr 6|Zabrze|ul. Klonowa 23 |41-800 Zabrze;1878;1047;1047;17;1030;55.75;1.62
105916;247801;Szkoła Podstawowa Nr 6|Zabrze|ul. Klonowa 23 |41-800 Zabrze;2246;1128;1128;34;1094;50.22;3.01
105917;247801;Gimnazjum Nr 12|Zabrze|ul. Juliana Ursyna Niemcewicza 1 |41-800 Zabrze;1873;878;878;23;855;46.88;2.62
105918;247801;Szkoła Podstawowa Nr 15|Zabrze|ul. Czołgistów 1 |41-800 Zabrze;2085;1072;1072;24;1048;51.41;2.24
105919;247801;Zespól Szkolno-Przedszkolny Nr 16|Zabrze|ul. Cmentarna 7 |41-800 Zabrze;1835;563;563;14;549;30.68;2.49
105920;247801;Dom Pomocy Społecznej Nr 1|Zabrze|ul. Jana Matejki 62 |41-800 Zabrze;94;50;50;10;40;53.19;20.00
105921;247801;Dom Pomocy Społecznej Nr 2|Zabrze|ul. Jaskółcza 11 |41-800 Zabrze;68;38;38;2;36;55.88;5.26
105922;247801;Dom Pomocy Społecznej Nr 3|Zabrze|ul. Wiktora Brysza 3 |41-800 Zabrze;55;25;25;4;21;45.45;16.00
105923;247801;Dom Pomocy Społecznej prowadzony przez Zakon Ojców Kamilianów|Zabrze|ul. Cisowa 6 |41-800 Zabrze;77;30;30;3;27;38.96;10.00
105924;247801;Kamiliańskie Centrum Opiekuńczo-Lecznicze|Zabrze|ul. Pawła Dubiela 10 |41-800 Zabrze;65;19;19;1;18;29.23;5.26
105925;247801;Zakład Karny|Zabrze|ul. Ks. Pawła Janika 12 |41-806 Zabrze;572;222;222;17;205;38.81;7.66
105926;247801;Areszt Śledczy|Zabrze|ul. Sądowa 1 |41-800 Zabrze;213;143;143;25;118;67.14;17.48
105927;247801;Szpital Miejski w Zabrzu Sp. z o.o.|Zabrze|ul. Zamkowa 4 |41-803 Zabrze;159;86;86;6;80;54.09;6.98
105928;247801;Samodzielny Publiczny Szpital Kliniczny Nr 1 Śląskiego Uniwersytetu Medycznego|Zabrze|ul. Ks. Karola Koziołka 1 |41-803 Zabrze;60;52;52;1;51;86.67;1.92
105929;247801;Śląskie Centrum Chorób Serca|Zabrze|ul. Marii Curie-Skłodowskiej 9 |41-800 Zabrze;257;117;117;3;114;45.53;2.56
105930;247801;Szpital Specjalistyczny|Zabrze|ul. Marii Curie-Skłodowskiej 10 |41-800 Zabrze;91;57;57;5;52;62.64;8.77
105931;247801;Samodzielny Publiczny Szpital Kliniczny Nr 1|Zabrze|ul. 3 Maja 13-15 |41-800 Zabrze;77;37;37;2;35;48.05;5.41
105932;247801;Szpital Miejski w Zabrzu Sp. z o.o., Zakład Opiekuńczo-Leczniczy "Pomocna Dłoń"|Zabrze|ul. Ks. Pawła Janika 18 |41-803 Zabrze;41;15;15;0;15;36.59;0.00
105933;247901;Gimnazjum Nr 2 z Oddziałami Sportowymi im. Wojciecha Korfantego w Żorach|Żory|ul. Klimka 7 |44-240 Żory;1110;577;577;10;567;51.98;1.73
105934;247901;Gimnazjum Nr 2 z Oddziałami Sportowymi im. Wojciecha Korfantego w Żorach|Żory|ul. Klimka 7 |44-240 Żory;935;559;559;6;553;59.79;1.07
105935;247901;Szkoła Podstawowa Nr 3 im. Żorskich Twórców Kultury w Żorach|Żory|Osiedle 700-lecia Żor 16 |44-240 Żory;1732;927;927;26;901;53.52;2.80
105936;247901;Szkoła Podstawowa Nr 3 im. Żorskich Twórców Kultury w Żorach|Żory|Osiedle 700-lecia Żor 16 |44-240 Żory;846;397;397;11;386;46.93;2.77
105937;247901;Zespół Szkół Budowlano-Informatycznych im. Mikołaja Kopernika w Żorach|Żory|ul. Rybnicka 5 |44-240 Żory;1695;1091;1091;16;1075;64.37;1.47
105938;247901;Zespół Szkół Budowlano-Informatycznych im. Mikołaja Kopernika w Żorach|Żory|ul. Rybnicka 5 |44-240 Żory;1261;788;788;12;776;62.49;1.52
105939;247901;Zespół Szkolno-Przedszkolny Nr 9 w Żorach|Żory|ul. Rybnicka 226 |44-240 Żory;1959;1159;1159;31;1128;59.16;2.67
105940;247901;Szkoła Podstawowa Nr 1 im. Janusza Korczaka w Żorach|Żory|ul. Słoneczna 2 |44-240 Żory;1276;673;673;17;656;52.74;2.53
105941;247901;Szkoła Podstawowa Nr 1 im. Janusza Korczaka w Żorach|Żory|ul. Słoneczna 2 |44-240 Żory;1594;1024;1024;20;1004;64.24;1.95
105942;247901;Zespół Szkół Nr 8 w Żorach|Żory|ul. Osińska 50 |44-240 Żory;1903;1056;1056;22;1034;55.49;2.08
105943;247901;Zespół Szkół Nr 8 w Żorach|Żory|ul. Osińska 50 |44-240 Żory;1773;910;910;20;890;51.33;2.20
105944;247901;Gimnazjum Nr 4 w Żorach|Żory|Osiedle Księcia Władysława |44-240 Żory;1904;982;982;27;955;51.58;2.75
105945;247901;Gimnazjum Nr 4 w Żorach|Żory|Osiedle Księcia Władysława |44-240 Żory;1839;1048;1048;19;1029;56.99;1.81
105946;247901;Gimnazjum Nr 4 w Żorach|Żory|Osiedle Księcia Władysława |44-240 Żory;1686;903;903;24;879;53.56;2.66
105947;247901;Szkoła Podstawowa Nr 17 im. Stanisława Ligonia w Żorach|Żory|Osiedle Powstańców Śląskich |44-240 Żory;1443;791;791;24;767;54.82;3.03
105948;247901;Szkoła Podstawowa Nr 17 im. Stanisława Ligonia w Żorach|Żory|Osiedle Powstańców Śląskich |44-240 Żory;1492;823;823;17;806;55.16;2.07
105949;247901;Szkoła Podstawowa Nr 17 im. Stanisława Ligonia w Żorach|Żory|Osiedle Powstańców Śląskich |44-240 Żory;1457;771;771;13;758;52.92;1.69
105950;247901;Zespół Szkół Nr 6 w Żorach|Żory|Osiedle Pawlikowskiego 40 |44-240 Żory;1617;756;756;27;729;46.75;3.57
105951;247901;Zespół Szkół Nr 6 w Żorach|Żory|Osiedle Pawlikowskiego 40 |44-240 Żory;1516;722;722;29;693;47.63;4.02
105952;247901;Zespół Szkół Nr 6 w Żorach|Żory|Osiedle Pawlikowskiego 40 |44-240 Żory;1583;824;824;23;801;52.05;2.79
105953;247901;Zespół Szkolno-Przedszkolny Nr 8 w Żorach|Żory|ul. Wysoka 13 |44-240 Żory;1780;1061;1061;29;1032;59.61;2.73
105954;247901;Zespół Szkół Nr 5 w Żorach|Żory|ul. Wodzisławska 201 |44-240 Żory;1352;777;777;32;745;57.47;4.12
105955;247901;Zespół Szkół Nr 5 w Żorach|Żory|ul. Wodzisławska 201 |44-240 Żory;1002;593;593;32;561;59.18;5.40
105956;247901;Miejski Ośrodek Kultury w Żorach Świetlica w Dzielnicy Rój|Żory|ul. Gwarków 22 |44-240 Żory;979;333;333;14;319;34.01;4.20
105957;247901;Zespół Szkół Nr 3 w Żorach|Żory|Osiedle Sikorskiego 52 |44-240 Żory;1880;932;932;20;912;49.57;2.15
105958;247901;Szkoła Podstawowa Nr 15 w Żorach|Żory|ul. Bankowa 1 |44-240 Żory;1923;985;985;21;964;51.22;2.13
105959;247901;Zespół Szkół Nr 3 w Żorach|Żory|Osiedle Sikorskiego 52 |44-240 Żory;1859;930;930;30;900;50.03;3.23
105960;247901;Szkoła Podstawowa Nr 15 w Żorach|Żory|ul. Bankowa 1 |44-240 Żory;1686;853;853;37;816;50.59;4.34
105961;247901;Zespół Szkolno-Przedszkolny Nr 7 w Żorach|Żory|ul. Szkolna 8 |44-240 Żory;973;586;586;21;565;60.23;3.58
105962;247901;Zespół Szkolno-Przedszkolny Nr 5 w Żorach|Żory|ul. Strażacka 6 |44-240 Żory;1445;835;835;24;811;57.79;2.87
105963;247901;Zespół Szkolno-Przedszkolny Nr 6 w Żorach|Żory|ul. Pszczyńska 81 |44-240 Żory;1466;877;877;36;841;59.82;4.10
105964;247901;Szpital Miejski|Żory|ul. Dąbrowskiego 20 |44-240 Żory;80;27;27;1;26;33.75;3.70
105965;247901;Miejski Dom Pomocy Społecznej|Żory|os. Powstańców Śląskich 20 |44-240 Żory;21;12;12;2;10;57.14;16.67
105966;260101;Miejsko-Gminny Ośrodek Pomocy Społecznej w Busku-Zdroju|Busko-Zdrój|os. Kościuszki 2A |28-100 Busko-Zdrój;1337;671;671;11;660;50.19;1.64
105967;260101;Publiczne Przedszkole Nr 2 w Busku-Zdroju|Busko-Zdrój|os. Kościuszki 14 |28-100 Busko-Zdrój;1308;648;648;15;633;49.54;2.31
105968;260101;Miejsko-Gminna Biblioteka Publiczna w Busku-Zdroju|Busko-Zdrój|os. Świerczewskiego 17 |28-100 Busko-Zdrój;1101;563;563;15;548;51.14;2.66
105969;260101;Publiczne Przedszkole Nr 3 w Busku-Zdroju|Busko-Zdrój|os. Sikorskiego 12 |28-100 Busko-Zdrój;1084;582;582;1;581;53.69;0.17
105970;260101;Przychodnia Rejonowa Nr 2 w Busku-Zdroju|Busko-Zdrój|os. Sikorskiego 10 |28-100 Busko-Zdrój;1043;531;531;22;509;50.91;4.14
105971;260101;Buskie Samorządowe Centrum Kultury w Busku-Zdroju|Busko-Zdrój|ul. Mickiewicza 22 |28-100 Busko-Zdrój;1782;1263;1263;10;1253;70.88;0.79
105972;260101;Hala Sportowa w Busku-Zdroju|Busko-Zdrój|ul. Kusocińskiego 3 |28-100 Busko-Zdrój;1159;632;632;14;618;54.53;2.22
105973;260101;Zespół Szkół Technicznych i Ogólnokształcących w Busku-Zdroju|Busko-Zdrój|ul. Boh. Warszawy 106 |28-100 Busko-Zdrój;1265;720;720;11;709;56.92;1.53
105974;260101;Szkoła Podstawowa Nr 2 w Busku-Zdroju|Busko-Zdrój|ul. Korczaka 13 |28-100 Busko-Zdrój;1215;658;658;6;652;54.16;0.91
105975;260101;Zakład Doskonalenia Zawodowego w Busku-Zdroju|Busko-Zdrój|ul. Wojska Polskiego 31 |28-100 Busko-Zdrój;1381;696;696;14;682;50.40;2.01
105976;260101;Zakład Ubezpieczeń Społecznych Inspektorat w Busku-Zdroju|Busko-Zdrój|ul. Partyzantów 33 |28-100 Busko-Zdrój;1409;762;762;14;748;54.08;1.84
105977;260101;Niepubliczne Przedszkole Bajkowe Wzgórze w Mikułowicach|Mikułowice| 123 |28-100 Busko-Zdrój;1406;652;652;17;635;46.37;2.61
105978;260101;Świetlica OSP w Młynach|Młyny| 98 |28-100 Busko-Zdrój;1180;488;488;15;473;41.36;3.07
105979;260101;Szkoła Podstawowa w Kołaczkowicach|Kołaczkowice| 122 |28-100 Busko-Zdrój;1389;445;445;9;436;32.04;2.02
105980;260101;Świetlica Wiejska w Widuchowej|Widuchowa| 76 |28-100 Busko-Zdrój;1510;584;584;14;570;38.68;2.40
105981;260101;Szkoła Podstawowa w Szczaworyżu|Szczaworyż| 49 |28-100 Busko-Zdrój;1261;482;482;12;470;38.22;2.49
105982;260101;Szkoła Podstawowa w Dobrowodzie|Dobrowoda| 26 |28-100 Busko-Zdrój;1207;456;456;11;445;37.78;2.41
105983;260101;Zespół Placówek Oświatowych w Zbludowicach|Zbludowice|ul. Świętokrzyska 9 |28-100 Busko-Zdrój;1315;697;697;9;688;53.00;1.29
105984;260101;Szkoła Podstawowa w Siesławicach|Siesławice| 140 |28-100 Busko-Zdrój;1160;449;449;19;430;38.71;4.23
105985;260101;Świetlica Wiejska w Wełczu|Wełecz| 118 |28-100 Busko-Zdrój;1308;474;474;18;456;36.24;3.80
105986;260101;Zespół Placówek Oświatowych w Szańcu|Szaniec| 240 |28-100 Busko-Zdrój;1398;561;561;31;530;40.13;5.53
105987;260101;Zespół Opieki Zdrowotnej w Busku-Zdroju|Busko-Zdrój|ul. Bohaterów Warszawy 67 |28-100 Busko-Zdrój;128;15;15;1;14;11.72;6.67
105988;260101;Uzdrowiskowy Szpital Kompleksowej Rehabilitacji "Krystyna" w Busku-Zdroju|Busko-Zdrój|ul. Gen.Feliksa Rzewuskiego 3 |28-100 Busko-Zdrój;323;204;204;7;197;63.16;3.43
105989;260101;Specjalistyczny Szpital Ortopedyczno-Rehabilitacyjny "Górka" w Busku-Zdroju|Busko-Zdrój|ul. Dr. Starkiewicza 1 |28-100 Busko-Zdrój;81;68;68;2;66;83.95;2.94
105990;260101;21 Wojskowy Szpital Uzdrowiskowo-Rehabilitacyjny w Busku-Zdroju SP ZOZ|Busko-Zdrój|ul. Gen. Feliksa Rzewuskiego 8 |28-100 Busko-Zdrój;128;97;97;5;92;75.78;5.15
105991;260102;Szkoła Podstawowa w Balicach|Balice| 59 |28-114 Gnojno;844;299;299;20;279;35.43;6.69
105992;260102;Strażnica OSP w Gnojnie|Gnojno| 144 |28-114 Gnojno;1332;513;513;19;494;38.51;3.70
105993;260102;Szkoła Podstawowa w Jarząbkach|Jarząbki| 90 |28-114 Gnojno;574;203;203;2;201;35.37;0.99
105994;260102;Szkoła Podstawowa w Raczycach|Raczyce| 64 |28-114 Gnojno;899;298;298;16;282;33.15;5.37
105995;260102;Dom Pomocy Społecznej w Gnojnie|Gnojno| 118 |28-114 Gnojno;64;12;12;1;11;18.75;8.33
105996;260103;Dom Strażaka w Nowym Korczynie|Nowy Korczyn|ul. Józefa Piłsudskiego 7 |28-136 Nowy Korczyn;1537;699;699;26;673;45.48;3.72
105997;260103;Dom Strażaka w Ostrowcach|Ostrowce| 30 |28-136 Nowy Korczyn;678;298;298;23;275;43.95;7.72
105998;260103;Publiczna Szkoła Podstawowa w Starym Korczynie|Stary Korczyn| 85 |28-136 Nowy Korczyn;700;305;305;14;291;43.57;4.59
105999;260103;Dom Strażaka w Strożyskach|Strożyska| 72 |28-136 Nowy Korczyn;1283;551;551;19;532;42.95;3.45
106000;260103;Szkoła Podstawowa w Brzostkowie|Brzostków| 1 |28-136 Nowy Korczyn;945;394;394;17;377;41.69;4.31
106001;260104;Szkoła Podstawowa w Pacanowie|Pacanów|ul. Karska 3 |28-133 Pacanów;1642;700;700;11;689;42.63;1.57
106002;260104;Remiza OSP w Zborówku|Zborówek| 51 |28-133 Pacanów;992;360;360;36;324;36.29;10.00
106003;260104;Szkoła Podstawowa w Ratajach Słupskich|Rataje Słupskie| 39a |28-133 Pacanów;1278;456;456;10;446;35.68;2.19
106004;260104;Szkoła Podstawowa w Oblekoniu|Oblekoń| 73 |28-133 Pacanów;762;256;256;9;247;33.60;3.52
106005;260104;Świetlica wiejska w Biechowie|Biechów| 40a |28-133 Pacanów;1089;425;425;24;401;39.03;5.65
106006;260104;Remiza OSP w Sroczkowie|Sroczków| 27 |28-133 Pacanów;513;165;165;1;164;32.16;0.61
106007;260104;Dom Pomocy Społecznej w Słupi|Słupia| 91 |28-133 Pacanów;67;55;55;3;52;82.09;5.45
106008;260104;Dom Pomocy Społecznej w Ratajach Słupskich|Rataje Słupskie| 39b |28-133 Pacanów;29;12;12;2;10;41.38;16.67
106009;260105;Szkoła Podstawowa w Kikowie|Kików| 67 |28-131 Solec-Zdrój;579;241;241;11;230;41.62;4.56
106010;260105;Szkoła Podstawowa w Zborowie|Zborów| 121 |28-131 Solec-Zdrój;729;326;326;19;307;44.72;5.83
106011;260105;Zespół Szkół w Solcu-Zdroju|Solec-Zdrój|ul.1 Maja 18 |28-131 Solec-Zdrój;1183;679;679;19;660;57.40;2.80
106012;260105;Remiza OSP w Świniarach|Świniary| 44 |28-131 Solec-Zdrój;604;196;196;6;190;32.45;3.06
106013;260105;Remiza OSP w Piestrzcu|Piestrzec| 7 |28-131 Solec-Zdroj;507;179;179;8;171;35.31;4.47
106014;260105;Świetlica wiejska w Piasku Małym|Piasek Mały| 83 |28-131 Solec-Zdrój;553;218;218;5;213;39.42;2.29
106015;260105;Dom Pomocy Społecznej w Świniarach|Świniary| 25 |28-131 Solec-Zdrój;41;37;37;7;30;90.24;18.92
106016;260105;Dom Pomocy Społecznej w Zborowie|Zborów| 112 |28-131 Solec-Zdrój;42;20;20;1;19;47.62;5.00
106017;260106;OSP w Stopnicy|Stopnica|ul. Adama Mickiewicza 5a |28-130 Stopnica;1882;895;895;26;869;47.56;2.91
106018;260106;Urząd Miasta i Gminy Stopnica|Stopnica|ul. Tadeusza Kościuszki 2 |28-130 Stopnica;1900;717;717;24;693;37.74;3.35
106019;260106;Gminne Centrum Kultury w Stopnicy|Stopnica|ul. Kazimierza Wielkiego 15 |28-130 Stopnica;1911;861;861;30;831;45.05;3.48
106020;260106;Świetlica wiejska|Strzałków| 51 |28-130 Stopnica;720;252;252;7;245;35.00;2.78
106021;260107;Szkoła Podstawowa w Kargowie|Kargów| 65A |28-142 Tuczępy;432;148;148;10;138;34.26;6.76
106022;260107;Szkoła Podstawowa w Tuczępach|Tuczępy| 33 |28-142 Tuczępy;1556;662;662;41;621;42.54;6.19
106023;260107;Szkoła Podstawowa w Nizinach|Niziny| 120A |28-142 Tuczępy;1086;416;416;22;394;38.31;5.29
106024;260108;Gimnazjum w Wiślicy|Wiślica|ul. Okopowa 27 |28-160 Wiślica;1196;585;585;17;568;48.91;2.91
106025;260108;Szkoła Podstawowa w Wiślicy|Wiślica|ul. Podwale 1 |28-160 Wiślica;1055;329;329;13;316;31.18;3.95
106026;260108;Świetlica Wiejska w Chotlu Czerwonym|Chotel Czerwony| 63a |28-160 Wiślica;1030;361;361;18;343;35.05;4.99
106027;260108;Dom Strażaka w Szczerbakowie|Szczerbaków| 104 |28-160 Wiślica;686;272;272;18;254;39.65;6.62
106028;260108;Szkoła Podstawowa w Skotnikach Dolnych|Skotniki Dolne| 41 |28-160 Wiślica;755;285;285;6;279;37.75;2.11
106029;260201;Urząd Gminy w Imielnie|Imielno|ul. Cmentarna 7 |28-313 Imielno;1600;694;694;22;672;43.38;3.17
106030;260201;Zespół Szkół w Motkowicach|Motkowice|ul. Szkolna 2 |28-313 Imielno;1050;412;412;21;391;39.24;5.10
106031;260201;Zespół Szkół w Mierzwinie|Mierzwin| 11 |28-313 Imielno;557;171;171;9;162;30.70;5.26
106032;260201;Strażnica OSP w Opatkowicach Murowanych|Opatkowice Murowane| 32 |28-313 Imielno;445;125;125;8;117;28.09;6.40
106033;260202;Przedszkole Nr 3 w Jędrzejowie|Jędrzejów|ul. Kościelna 16 |28-300 Jędrzejów;1147;547;547;19;528;47.69;3.47
106034;260202;Specjalny Ośrodek Szkolno-Wychowawczy w Jędrzejowie|Jędrzejów|ul. Feliksa Przypkowskiego 5 |28-300 Jędrzejów;910;505;505;10;495;55.49;1.98
106035;260202;Szkoła Podstawowa Nr 2 w Jędrzejowie|Jędrzejów|ul. Feliksa Przypkowskiego 12 |28-300 Jędrzejów;1382;754;754;18;736;54.56;2.39
106036;260202;I Liceum Ogólnokształcące w Jędrzejowie|Jędrzejów|ul. 11 Listopada 37 |28-300 Jędrzejów;848;362;362;10;352;42.69;2.76
106037;260202;Przedszkole Nr 1 w Jędrzejowie|Jędrzejów|ul. Mieszka I 9 |28-300 Jędrzejów;1385;701;701;15;686;50.61;2.14
106038;260202;Zespół Szkół w Jędrzejowie|Jędrzejów|ul. Feliksa Przypkowskiego 43 |28-300 Jędrzejów;1079;539;539;6;533;49.95;1.11
106039;260202;Zespół Szkół Ponadgimnazjalnych Nr 1 w Jędrzejowie|Jędrzejów|ul. Feliksa Przypkowskiego 49 |28-300 Jędrzejów;923;477;477;12;465;51.68;2.52
106040;260202;Spółdzielnia Mieszkaniowa ,,Przyszłość" w Jędrzejowie|Jędrzejów|ul. Dojazd 56 |28-300 Jędrzejów;912;496;496;1;495;54.39;0.20
106041;260202;Specjalny Ośrodek Szkolno-Wychowawczy Internat w Jędrzejowie|Jędrzejów|ul. Bolesława Krzywoustego 4 |28-300 Jędrzejów;824;342;342;12;330;41.50;3.51
106042;260202;Zespół Szkół Ponadgimnazjalnych Nr 2 w Jędrzejowie|Jędrzejów|ul. Okrzei 63 |28-300 Jędrzejów;1444;716;716;23;693;49.58;3.21
106043;260202;Szkoła Podstawowa Nr 3 w Jędrzejowie|Jędrzejów|ul. Władysława Stanisława Reymonta 1 |28-300 Jędrzejów;1096;593;593;9;584;54.11;1.52
106044;260202;Przedszkole Nr 2 w Jędrzejowie|Jędrzejów|ul. 11 Listopada 113a |28-300 Jędrzejów;856;491;491;13;478;57.36;2.65
106045;260202;Zespół Placówek Oświatowych w Prząsławiu|Prząsław| 55 |28-300 Jędrzejów;1487;671;671;21;650;45.12;3.13
106046;260202;Szkoła Podstawowa w Potoku Wielkim|Potok Wielki| 9 |28-300 Jędrzejów;811;330;330;8;322;40.69;2.42
106047;260202;Zespół Placówek Oświatowych w Skroniowie|Skroniów| 75 |28-300 Jędrzejów;1556;737;737;17;720;47.37;2.31
106048;260202;Szkoła Podstawowa w Piaskach|Piaski| 83 |28-300 Jędrzejów;973;507;507;10;497;52.11;1.97
106049;260202;Szkoła Podstawowa w Rakowie|Raków| 45 |28-300 Jędrzejów;911;342;342;13;329;37.54;3.80
106050;260202;Szkoła Podstawowa w Jasionnie|Jasionna| 8 |28-300 Jędrzejów;677;252;252;11;241;37.22;4.37
106051;260202;Szkoła Podstawowa w Mnichowie|Mnichów| 72 |28-300 Jędrzejów;1110;465;465;17;448;41.89;3.66
106052;260202;Szkoła Podstawowa w Podchojnach|Podchojny| 106 |28-300 Jędrzejów;1476;640;640;21;619;43.36;3.28
106053;260202;Szkoła Podstawowa w Łysakowie|Łysaków Drugi| 44b |28-300 Jędrzejów;1248;457;457;17;440;36.62;3.72
106054;260202;ARTMEDIK Sp. z o.o. Szpital Specjalistyczny im. Władysława Biegańskiego w Jędrzejowie|Jędrzejów|ul. Małogoska 25 |28-300 Jędrzejów;84;17;17;0;17;20.24;0.00
106055;260202;Dom Pomocy Społecznej w Mnichowie|Mnichów| 135 |28-300 Jędrzejów;52;6;6;1;5;11.54;16.67
106056;260203;Sala konferencyjna Urzędu Miasta i Gminy|Małogoszcz|ul. Jaszowskiego 3a |28-366 Małogoszcz;1439;758;758;27;731;52.68;3.56
106057;260203;Dom Kultury|Małogoszcz|ul. 11 Listopada 17 |28-366 Małogoszcz;1624;803;803;20;783;49.45;2.49
106058;260203;Szkoła Podstawowa|Kozłów| 182 |28-366 Małogoszcz;1338;532;532;17;515;39.76;3.20
106059;260203;Zespół Placówek Oświatowych|Żarczyce Duże| 29 |28-366 Małogoszcz;718;327;327;11;316;45.54;3.36
106060;260203;Szkoła Podstawowa|Rembieszyce| 10 |28-366 Małogoszcz;1174;523;523;28;495;44.55;5.35
106061;260203;Zespół Placówek Oświatowych|Złotniki| 66A |28-366 Małogoszcz;1234;545;545;45;500;44.17;8.26
106062;260203;Zespół Szkół Ogólnokształcących|Małogoszcz|ul. 11 Listopada 14B |28-366 Małogoszcz;1811;757;757;16;741;41.80;2.11
106063;260204;Gminny Ośrodek Kultury|Nagłowice|ul. Mikołaja Reja 17 |28-362 Nagłowice;1035;372;372;15;357;35.94;4.03
106064;260204;Remiza OSP w Jaronowicach|Jaronowice| 122 |28-362 Nagłowice;266;83;83;4;79;31.20;4.82
106065;260204;Zespół Placówek Oświatowych w Warzynie Pierwszym|Warzyn Pierwszy| 95 |28-362 Nagłowice;677;257;257;8;249;37.96;3.11
106066;260204;Punkt Przedszkolny|Trzciniec| 59 |28-362 Nagłowice;480;169;169;5;164;35.21;2.96
106067;260204;Remiza OSP w Ciernie-Żabieńcu|Cierno-Żabieniec| 34 |28-362 Nagłowice;796;242;242;18;224;30.40;7.44
106068;260204;Świetlica Środowiskowa|Deszno| 39 |28-362 Nagłowice;416;171;171;7;164;41.11;4.09
106069;260204;Budynek po Szkole Podstawowej w Rakoszynie|Rakoszyn| 19 |28-362 Nagłowice;469;144;144;5;139;30.70;3.47
106070;260205;Zespół Placówek Oświatowych w Oksie|Oksa|Pl. M. Reja 19 |28-363 Oksa;1384;561;561;17;544;40.53;3.03
106071;260205;Remiza Strażacka Ochotniczej Straży Pożarnej|Lipno| 11 |28-363 Oksa;391;156;156;9;147;39.90;5.77
106072;260205;Szkoła Podstawowa w Węgleszynie|Węgleszyn| 51A |28-363 Oksa;1437;598;598;19;579;41.61;3.18
106073;260205;Remiza Strażacka Ochotniczej Straży Pożarnej Tyniec-Kolonia|Tyniec-Kolonia| 5 |28-363 Oksa;334;129;129;8;121;38.62;6.20
106074;260205;Budynek po Szkole Podstawowej w Nowych Kanicach|Nowe Kanice| 15A |28-363 Oksa;314;116;116;3;113;36.94;2.59
106075;260206;Szkoła Podstawowa w Krzcięcicach|Krzcięcice| 34 |28-340 Sędziszów;750;351;351;11;340;46.80;3.13
106076;260206;Remiza OSP w Borszowicach|Borszowice| 11a |28-340 Sędziszów;830;394;394;19;375;47.47;4.82
106077;260206;Szkoła Podstawowa w Pawłowicach|Pawłowice| 94 |28-340 Sędziszów;454;169;169;9;160;37.22;5.33
106078;260206;Szkoła Podstawowa w Tarnawie|Tarnawa| 119 |28-340 Sędziszów;968;443;443;14;429;45.76;3.16
106079;260206;Szkoła Podstawowa w Mstyczowie|Mstyczów| 37 |28-340 Sędziszów;707;274;274;12;262;38.76;4.38
106080;260206;Remiza OSP w Klimontowie|Klimontów| 42 |28-340 Sędziszów;676;281;281;12;269;41.57;4.27
106081;260206;Świetlica Wiejska w Gniewięcinie|Gniewięcin| 150 |28-340 Sędziszów;541;245;245;4;241;45.29;1.63
106082;260206;Remiza OSP w Sędziszowie|Sędziszów|ul. Jędrzejowska 10 |28-340 Sędziszów;1431;620;620;15;605;43.33;2.42
106083;260206;Przedszkole Samorządowe w Sędziszowie|Sędziszów|Osiedle Na Skarpie 8 |28-340 Sędziszów;1592;722;722;18;704;45.35;2.49
106084;260206;Przedszkole Samorządowe w Sędziszowie|Sędziszów|Osiedle Na Skarpie 8 |28-340 Sędziszów;790;342;342;10;332;43.29;2.92
106085;260206;Samorządowe Centrum Kultury w Sędziszowie|Sędziszów|ul. Dworcowa 26 |28-340 Sędziszów;1844;868;868;21;847;47.07;2.42
106086;260207;Remiza Strażacka|Rożnica| 209 |28-350 Słupia;797;270;270;13;257;33.88;4.81
106087;260207;Świetlica Wiejska|Słupia| 95 |28-350 Słupia;1375;648;648;25;623;47.13;3.86
106088;260207;Remiza Strażacka|Raszków| 51 |28-350 Słupia;540;181;181;8;173;33.52;4.42
106089;260207;Szkoła Podstawowa|Obiechów| 47 |28-350 Słupia;910;306;306;5;301;33.63;1.63
106090;260208;Zespół Placówek Oświatowych w Mokrsku Dolnym|Mokrsko Dolne| 50a |28-305 Sobków;803;324;324;4;320;40.35;1.23
106091;260208;Szkoła Podstawowa w Chomentowie|Chomentów| 72 |28-305 Sobków;1182;422;422;20;402;35.70;4.74
106092;260208;Budynek Remizy w Brzegach|Brzegi| 116 |28-305 Sobków;1120;587;587;26;561;52.41;4.43
106093;260208;Świetlica Wiejska w Miąsowej|Miąsowa| 13a |28-305 Sobków;1396;686;686;35;651;49.14;5.10
106094;260208;Szkoła Podstawowa w Sobkowie|Sobków|ul. Źródłowa 4 |28-305 Sobków;1719;843;843;17;826;49.04;2.02
106095;260208;Zespół Placówek Oświatowych w Korytnicy|Korytnica| 206 |28-305 Sobków;636;288;288;15;273;45.28;5.21
106096;260209;Samorządowa Szkoła Podstawowa w Brześciu|Brzeście| |28-330 Wodzisław;1238;503;503;18;485;40.63;3.58
106097;260209;Środowiskowy Dom Kultury w Nawarzycach|Nawarzyce| |28-330 Wodzisław;452;198;198;18;180;43.81;9.09
106098;260209;Szkoła Podstawowa w Niegosławicach|Niegosławice| |28-330 Wodzisław;781;262;262;13;249;33.55;4.96
106099;260209;Zespół Szkół w Wodzisławiu|Wodzisław|ul. Szkolna 4 |28-330 Wodzisław;1207;561;561;10;551;46.48;1.78
106100;260209;Szkoła Podstawowa w Mierzawie|Mierzawa| |28-330 Wodzisław;434;184;184;14;170;42.40;7.61
106101;260209;Szkoła Podstawowa w Piotrkowicach|Piotrkowice| |28-330 Wodzisław;795;311;311;16;295;39.12;5.14
106102;260209;Samorzadowa Szkoła Podstawowa w Lubczy|Lubcza| |28-330 Wodzisław;828;247;247;12;235;29.83;4.86
106103;260209;Remiza OSP w Klemencicach|Klemencice| |28-330 Wodzisław;319;130;130;4;126;40.75;3.08
106104;260301;Samorządowa Szkoła Podstawowa im. gen. Franciszka Kamińskiego w Bejscach|Bejsce| 233 |28-512 Bejsce;2202;806;806;25;781;36.60;3.10
106105;260301;Samorządowa Szkoła Podstawowa im. Edwarda Haruzy w Dobiesławicach|Dobiesławice| 38A |28-512 Bejsce;1200;362;362;4;358;30.17;1.10
106106;260301;Dom Pomocy Społecznej w Bejscach|Bejsce| 230 |28-512 Bejsce;52;21;21;2;19;40.38;9.52
106107;260302;Szkoła Podstawowa w Czarnocinie|Czarnocin| 2 |28-506 Czarnocin;1121;463;463;12;451;41.30;2.59
106108;260302;Szkoła Podstawowa w Stradowie|Stradów| 16 |28-506 Czarnocin;883;304;304;10;294;34.43;3.29
106109;260302;Szkoła Podstawowa w Sokolinie|Sokolina| 19 |28-506 Czarnocin;1347;426;426;4;422;31.63;0.94
106110;260303;Samorządowa Szkoła Podstawowa nr 1 im. Hugona Kołłątaja|Kazimierza Wielka|ul. 1 Maja 1 |28-500 Kazimierza Wielka;1105;473;473;10;463;42.81;2.11
106111;260303;Samorządowa Szkoła Podstawowa nr 1 im. Hugona Kołłątaja|Kazimierza Wielka|ul. 1 Maja 1 |28-500 Kazimierza Wielka;978;449;449;14;435;45.91;3.12
106112;260303;Samorządowa Szkoła Podstawowa Nr 3 im. Jana Pawła II|Kazimierza Wielka|ul. Szkolna 14 |28-500 Kazimierza Wielka;808;372;372;7;365;46.04;1.88
106113;260303;Samorządowa Szkoła Podstawowa Nr 3 im. Jana Pawła II|Kazimierza Wielka|ul. Szkolna 14 |28-500 Kazimierza Wielka;964;406;406;18;388;42.12;4.43
106114;260303;Samorządowa Szkoła Podstawowa Nr 3 im. Jana Pawła II|Kazimierza Wielka|ul. Szkolna 14 |28-500 Kazimierza Wielka;810;364;364;8;356;44.94;2.20
106115;260303;Samorządowa Szkoła Podstawowa nr 1 im. Hugona Kołłątaja|Kazimierza Wielka|ul. 1 Maja 1 |28-500 Kazimierza Wielka;820;333;333;12;321;40.61;3.60
106116;260303;Samorządowa Szkoła Podstawowa nr 1 im. Hugona Kołłątaja|Kazimierza Wielka|ul. 1 Maja 1 |28-500 Kazimierza Wielka;1139;413;413;13;400;36.26;3.15
106117;260303;Zespół Szkół Rolniczych|Cudzynowice| 176 |28-500 Kazimierza Wielka;1032;364;364;16;348;35.27;4.40
106118;260303;Remiza OSP|Gabułtów| 101 |28-500 Kazimierza Wielka;854;332;332;17;315;38.88;5.12
106119;260303;Świetlica wiejska|Stradlice| 84 |28-500 Kazimierza Wielka;623;209;209;4;205;33.55;1.91
106120;260303;Samorządowa Szkoła Podstawowa im. mjr. H. Dobrzańskiego "Hubala"|Gorzków| 80 |28-500 Kazimierza Wielka;873;289;289;14;275;33.10;4.84
106121;260303;Samorządowa Szkoła Podstawowa im. mjr. H. Dobrzańskiego "Hubala"|Gorzków| 80 |28-500 Kazimierza Wielka;818;293;293;12;281;35.82;4.10
106122;260303;Zespół Szkół Samorządowych|Wielgus| 59 |28-500 Kazimierza Wielka;997;305;305;16;289;30.59;5.25
106123;260303;Budynek byłej Samorządowej Szkoły Podstawowej|Sieradzice| 83 |28-500 Kazimierza Wielka;854;286;286;8;278;33.49;2.80
106124;260303;Samorządowa Szkoła Podstawowa im. Ks. Władysława Latosa|Kamieńczyce| 24 |28-500 Kazimierza Wielka;902;344;344;16;328;38.14;4.65
106125;260303;Samodzielny Publiczny Zespół Opieki Zdrowotnej w Kazimierzy Wielkiej|Kazimierza Wielka|ul. Partyzantów 12 |28-500 Kazimierza Wielka;58;19;19;1;18;32.76;5.26
106126;260304;Szkoła Podstawowa w Krzczonowie|Krzczonów| 41a |28-520 Opatowiec;1377;387;387;9;378;28.10;2.33
106127;260304;Dom Kultury w Opatowcu|Opatowiec|ul. Rynek 16 |28-520 Opatowiec;1016;450;450;8;442;44.29;1.78
106128;260304;Świetlica OSP w Rogowie|Rogów| 54 |28-520 Opatowiec;643;236;236;6;230;36.70;2.54
106129;260305;Zespół Szkół Zawodowych w Skalbmierzu|Skalbmierz|ul. Kanonijska 7 |28-530 Skalbmierz;1096;471;471;14;457;42.97;2.97
106130;260305;Zespół Placówek Oświatowych w Skalbmierzu|Skalbmierz|ul. Ppor. Sokoła 55 |28-530 Skalbmierz;737;245;245;9;236;33.24;3.67
106131;260305;Zespół Placówek Oświatowych w Skalbmierzu|Skalbmierz|ul. Ppor. Sokoła 55 |28-530 Skalbmierz;1026;364;364;15;349;35.48;4.12
106132;260305;Remiza OSP w Boszczynku|Boszczynek| 57 |28-530 Skalbmierz;761;207;207;3;204;27.20;1.45
106133;260305;Świetlica Wiejska w Tempoczowie-Kolonii|Tempoczów-Kolonia| 4 |28-530 Skalbmierz;622;175;175;6;169;28.14;3.43
106134;260305;Zespół Szkół w Topoli|Topola| 259 |28-530 Skalbmierz;1226;374;374;16;358;30.51;4.28
106135;260401;Szkoła Podstawowa w Porąbkach|Porąbki| 1 |26-004 Bieliny;843;458;458;12;446;54.33;2.62
106136;260401;Zespół Szkół Samarządowych w Bielinach|Bieliny|ul. Partyzantów 17 |26-004 Bieliny;1687;792;792;17;775;46.95;2.15
106137;260401;Szkoła Podstawowa w Hucie Nowej|Huta Nowa| 48 |26-004 Bieliny;1016;400;400;13;387;39.37;3.25
106138;260401;Szkoła Podstawowa w Makoszynie|Makoszyn| 100A |26-004 Bieliny;608;205;205;8;197;33.72;3.90
106139;260401;Szkoła Podstawowa w Lechowie|Lechów| 66 |26-004 Bieliny;989;407;407;19;388;41.15;4.67
106140;260401;Szkoła Podstawowa w Belnie|Belno| 25 |26-004 Bieliny;868;353;353;22;331;40.67;6.23
106141;260401;Szkoła Podstawowa w Hucie Podłysicy|Huta Podłysica| 58a |26-004 Bieliny;502;209;209;3;206;41.63;1.44
106142;260401;Szkoła Podstawowa w Hucie Starej|Huta Stara| 25 |26-004 Bieliny;470;197;197;7;190;41.91;3.55
106143;260401;Urząd Gminy w Bielinach|Bieliny|ul. Partyzantów 17 |26-004 Bieliny;965;447;447;15;432;46.32;3.36
106144;260402;Szkoła Podstawowa w Bodzentynie|Bodzentyn|ul. Rynek Górny 11 |26-010 Bodzentyn;1852;1005;1005;24;981;54.27;2.39
106145;260402;Szkoła Podstawowa w Bodzentynie|Bodzentyn|ul. Rynek Górny 11 |26-010 Bodzentyn;980;379;379;23;356;38.67;6.07
106146;260402;Remiza OSP w Sieradowicach|Sieradowice-Parcele| 1 |26-010 Bodzentyn;444;152;152;7;145;34.23;4.61
106147;260402;Szkoła Podstawowa w Śniadce|Śniadka Druga| 19a |26-010 Bodzentyn;372;164;166;8;156;44.09;4.88
106148;260402;Szkoła Podstawowa w Leśnej - Starej Wsi|Leśna-Stara Wieś| 1 |26-010 Bodzentyn;586;243;243;11;232;41.47;4.53
106149;260402;Świetlica Wiejska Siekierno-Stara Wieś|Siekierno-Stara Wieś| 5 |26-010 Bodzentyn;281;106;106;5;101;37.72;4.72
106150;260402;Szkoła Podstawowa w Psarach-Starej Wsi|Psary-Stara Wieś| 59a |26-010 Bodzentyn;945;324;324;29;295;34.29;8.95
106151;260402;Szkoła Podstawowa we Wzdole Rządowym|Stara Wieś| 28 |26-010 Bodzentyn;2207;870;870;47;823;39.42;5.40
106152;260402;Szkoła Podstawowa w Świętej Katarzynie|Święta Katarzyna|ul. Kielecka 45 |26-010 Bodzentyn;577;308;308;10;298;53.38;3.25
106153;260402;Świetlica Wiejska w Wilkowie|Wilków|ul. Łysogórska 155 |26-010 Bodzentyn;697;338;338;9;329;48.49;2.66
106154;260402;Szkoła Podstawowa w Woli Szczygiełkowej|Wola Szczygiełkowa| 63 |26-006 Nowa Słupia;484;176;176;8;168;36.36;4.55
106155;260403;Centrum Kultury i Sportu|Chęciny|ul. Armii Krajowej 18A |26-060 Chęciny;1876;1058;1058;26;1032;56.40;2.46
106156;260403;Przedszkole Samorządowe w Chęcinach|Chęciny|Os. Sosnówka 12 |26-060 Chęciny;630;318;318;15;303;50.48;4.72
106157;260403;Centrum Kultury i Sportu|Chęciny|ul. Armii Krajowej 18A |26-060 Chęciny;1083;564;564;8;556;52.08;1.42
106158;260403;Szkoła Podstawowa w Korzecku|Korzecko| 82 |26-060 Chęciny;650;305;305;8;297;46.92;2.62
106159;260403;Remiza OSP w Bolminie|Bolmin| 59A |26-060 Chęciny;908;371;371;16;355;40.86;4.31
106160;260403;Szkoła Podstawowa w Polichnie|Polichno| 52 |26-060 Chęciny;1531;670;670;35;635;43.76;5.22
106161;260403;Szkoła Podstawowa w Radkowicach|Radkowice| 85 |26-060 Chęciny;534;280;280;11;269;52.43;3.93
106162;260403;Szkoła Podstawowa w Starochęcinach|Starochęciny| 61 |26-060 Chęciny;1009;529;529;16;513;52.43;3.02
106163;260403;Szkoła Podstawowa w Tokarni|Tokarnia| 186a |26-060 Chęciny;1081;541;541;23;518;50.05;4.25
106164;260403;Gimnazjum Nr 2 w Wolicy|Wolica|ul. Szkolna 37 |26-060 Chęciny;923;413;413;12;401;44.75;2.91
106165;260403;Świetlica Wiejska w Siedlcach|Siedlce| 79b |26-060 Chęciny;617;286;286;13;273;46.35;4.55
106166;260403;Świetlica Wiejska w Ostrowie|Ostrów| 65a |26-060 Chęciny;604;214;214;9;205;35.43;4.21
106167;260403;Świetlica Wiejska w Łukowej|Łukowa| 100a |26-060 Chęciny;668;301;301;8;293;45.06;2.66
106168;260403;Wojewódzki Szpital Specjalistyczny im Św. Rafała w Czerwonej Górze|Chęciny|ul. Czerwona Góra 10 |26-060 Chęciny;252;82;82;4;78;32.54;4.88
106169;260404;Gimnazjum im. Generała Kazimierza Tańskiego w Chmielniku|Chmielnik|ul. Szkolna 7 |26-020 Chmielnik;1545;828;828;18;810;53.59;2.17
106170;260404;Biblioteka Publiczna w Chmielniku|Chmielnik|ul. Wspólna 13 |26-020 Chmielnik;1625;875;875;20;855;53.85;2.29
106171;260404;Szkoła Podstawowa im. Stefana Żeromskiego w Chmielniku|Chmielnik|ul. Szkolna 7 |26-020 Chmielnik;1593;639;639;16;623;40.11;2.50
106172;260404;Świetlica w Kotlicach|Kotlice| 24 |26-020 Chmielnik;504;227;227;12;215;45.04;5.29
106173;260404;Szkoła Podstawowa im. Stefana Żeromskiego w Chmielniku filia w Lubani|Lubania| 12 |26-020 Chmielnik;586;193;193;8;185;32.94;4.15
106174;260404;Szkoła Podstawowa im. Stefana Żeromskiego w Chmielniku filia w Suchowoli|Suchowola| 102 |26-020 Chmielnik;607;270;270;23;247;44.48;8.52
106175;260404;Szkoła Podstawowa im. Stefana Żeromskiego w Chmielniku filia w Zreczu Dużym|Zrecze Duże| 22 |26-020 Chmielnik;561;186;186;11;175;33.16;5.91
106176;260404;Świetlica w Sędziejowicach|Sędziejowice| 36 |26-020 Chmielnik;796;304;304;8;296;38.19;2.63
106177;260404;Filia Biblioteczna w Piotrkowicach|Piotrkowice|Rynek 7 |26-020 Chmielnik;1306;683;683;18;665;52.30;2.64
106178;260404;Szpital Powiatowy w Chmielniku|Chmielnik|ul. Kielecka 1-3 |26-020 Chmielnik;44;7;7;0;7;15.91;0.00
106179;260404;Dom Pomocy Społecznej w Łagiewnikach|Łagiewniki| 73 |26-020 Chmielnik;127;33;33;2;31;25.98;6.06
106180;260405;Zespół Szkolno-Przedszkolny w Daleszycach|Daleszyce|ul. Sienkiewicza 11 |26-021 Daleszyce;1597;785;785;28;757;49.15;3.57
106181;260405;Zespół Szkolno-Przedszkolny w Daleszycach|Daleszyce|ul. Sienkiewicza 11 |26-021 Daleszyce;1239;592;592;13;579;47.78;2.20
106182;260405;Zespół Szkół Ogólnokształcących w Sukowie|Suków| 215 |26-021 Daleszyce;1710;851;851;13;838;49.77;1.53
106183;260405;Szkoła Podstawowa w Borkowie|Borków| 36b |26-021 Daleszyce;490;244;244;11;233;49.80;4.51
106184;260405;Szkoła Podstawowa w Brzechowie|Brzechów| 41 |26-021 Daleszyce;764;333;333;13;320;43.59;3.90
106185;260405;Remiza OSP w Cisowie|Cisów| 44A |26-021 Daleszyce;651;239;239;9;230;36.71;3.77
106186;260405;Publiczna Szkoła Podstawowa w Sierakowie|Sieraków| 32 |26-021 Daleszyce;506;179;179;7;172;35.38;3.91
106187;260405;Dom Ludowy w Daleszycach|Daleszyce|ul. Kościelna 5 |26-021 Daleszyce;1146;501;501;12;489;43.72;2.40
106188;260405;Świetlica wiejska w Trzemosnej|Trzemosna| 27 |26-021 Daleszyce;194;78;78;2;76;40.21;2.56
106189;260405;Publiczna Szkoła Podstawowa w Szczecnie|Szczecno| 172 |26-015 Pierzchnica;907;351;351;20;331;38.70;5.70
106190;260405;Publiczna Szkoła Podstawowa w Marzyszu|Marzysz| 12 |26-021 Daleszyce;659;301;301;1;300;45.68;0.33
106191;260405;Szkoła Podstawowa im. gen. Tadeusza Buka w Mójczy|Mójcza| 9 |26-021 Daleszyce;1093;485;485;9;476;44.37;1.86
106192;260405;Szkoła Podstawowa im. Kornela Makuszyńskiego w Niestachowie|Niestachów| 271 |26-021 Daleszyce;886;502;502;18;484;56.66;3.59
106193;260405;Publiczna Szkoła Podstawowa w Słopcu|Słopiec| 86 |26-021 Daleszyce;537;216;216;10;206;40.22;4.63
106194;260406;Zespół Szkół w Bęczkowie|Bęczków| 195 |26-008 Górno;1369;793;793;25;768;57.93;3.15
106195;260406;Zespół Szkolno-Przedszkolny w Cedzynie|Cedzyna| 79 |25-900 Kielce;1007;588;588;23;565;58.39;3.91
106196;260406;Zespół Szkół w Górnie|Górno| 82"a" |26-008 Górno;2038;1073;1073;37;1036;52.65;3.45
106197;260406;Zespół Szkół w Krajnie|Krajno Pierwsze| 153"a" |26-008 Górno;1951;1003;1003;40;963;51.41;3.99
106198;260406;Szkoła Podstawowa w Leszczynach|Leszczyny| 33 |26-008 Górno;999;564;564;11;553;56.46;1.95
106199;260406;Zespół Szkolno-Przedszkolny w Radlinie|Radlin| 86 |26-008 Górno;1318;660;660;14;646;50.08;2.12
106200;260406;Szkoła Podstawowa w Skorzeszycach|Skorzeszyce| 165"b" |26-008 Górno;1135;540;540;20;520;47.58;3.70
106201;260406;Zespół Szkół w Woli Jachowej|Wola Jachowa| 136 |26-008 Górno;1113;553;553;28;525;49.69;5.06
106202;260407;Gminny Zespół Szkół w Łagowie|Łagów|ul. Zapłotnia 1 |26-025 Łagów;1335;619;619;18;601;46.37;2.91
106203;260407;Gminny Zespół Szkół w Łagowie|Łagów|ul. Zapłotnia 1 |26-025 Łagów;1882;650;650;37;613;34.54;5.69
106204;260407;Szkoła Podstawowa w Starej Zbelutce|Stara Zbelutka| 14 |26-025 Łagów;1018;404;404;16;388;39.69;3.96
106205;260407;Szkoła Podstawowa w Rudzie|Melonek, Ruda| 11 |26-025 Łagów;431;144;144;4;140;33.41;2.78
106206;260407;Szkoła Podstawowa w Czyżowie|Czyżów| 92 |26-025 Łagów;278;80;80;2;78;28.78;2.50
106207;260407;Szkoła Podstawowa w Piotrowie|Piotrów| 1 |26-025 Łagów;697;298;298;16;282;42.75;5.37
106208;260408;Świetlica Wiejska w Lasocinie|Lasocin| 59 |26-070 Łopuszno;489;223;223;10;213;45.60;4.48
106209;260408;Świetlica Wiejska w Piotrowcu|Piotrowiec| 178 |26-070 Łopuszno;482;227;227;11;216;47.10;4.85
106210;260408;Szkoła Podstawowa w Dobrzeszowie Filia w Sarbicach|Sarbice Drugie| 1 |26-070 Łopuszno;592;279;279;6;273;47.13;2.15
106211;260408;Zespół Szkół im. Jana Pawła II w Łopusznie|Łopuszno|ul. Strażacka 5 |26-070 Łopuszno;858;464;464;23;441;54.08;4.96
106212;260408;Remiza Ochotniczej Straży Pożarnej w Łopusznie|Łopuszno|ul. Strażacka 4 |26-070 Łopuszno;1455;836;836;35;801;57.46;4.19
106213;260408;Zespół Szkół im. Jana Pawła II w Łopusznie Filia w Grabownicy|Grabownica| 14 |26-070 Łopuszno;1144;558;558;18;540;48.78;3.23
106214;260408;Warsztaty Terapii Zajęciowej w Fanisławicach|Fanisławice| 22 |26-070 Łopuszno;389;195;195;9;186;50.13;4.62
106215;260408;Szkoła Podstawowa w Dobrzeszowie|Dobrzeszów| 70 |26-070 Łopuszno;410;243;243;3;240;59.27;1.23
106216;260408;Świetlica Wiejska w Snochowicach|Snochowice|ul. Łopuszańska 52 |26-070 Łopuszno;407;239;239;8;231;58.72;3.35
106217;260408;Zespół Szkół w Gnieździskach|Gnieździska| 85 |26-070 Łopuszno;1029;544;544;28;516;52.87;5.15
106218;260409;Szkoła Podstawowa w Brzezinkach|Brzezinki| 43 |26-001 Masłów;691;287;287;20;267;41.53;6.97
106219;260409;Szklany Dom w Ciekotach|Ciekoty| 76 |26-001 Masłów;772;362;362;12;350;46.89;3.31
106220;260409;Szkoła Podstawowa nr 4 w Kielcach-Dąbrowie|Kielce|ul. Warszawska 340 |25-414 Kielce;897;500;500;18;482;55.74;3.60
106221;260409;Budynek prywatny w Domaszowicach|Domaszowice| 112 |25-900 Kielce;913;562;562;3;559;61.56;0.53
106222;260409;Była Szkoła Podstawowa w Masłowie Drugim|Masłów Drugi|ul. Krajobrazowa 55 |26-001 Masłów;1131;559;559;18;541;49.43;3.22
106223;260409;Hala Sportowa w Masłowie Pierwszym|Masłów Pierwszy|ul. Jana Pawła II nr 1 |26-001 Masłów;1407;788;788;16;772;56.01;2.03
106224;260409;Zespół Szkół w Mąchocicach Kapitulnych|Mąchocice Kapitulne| 167 |26-001 Masłów;1066;574;574;20;554;53.85;3.48
106225;260409;Świetlica Samorządowa w Wiśniówce|Wiśniówka| 17 |26-050 Zagnańsk;445;206;206;3;203;46.29;1.46
106226;260409;Dom Ludowy w Woli Kopcowej|Wola Kopcowa|ul. Świętokrzyska 86 |26-001 Masłów;1076;647;648;7;640;60.13;1.08
106227;260410;Remiza OSP w Miedzianej Górze|Miedziana Góra|ul. Urzędnicza 10 |26-085 Miedziana Góra;1377;796;796;20;776;57.81;2.51
106228;260410;Centrum Kulturalno Sportowe w Kostomłotach Pierwszych|Kostomłoty Pierwsze|ul. Podmiejska 142 |26-085 Miedziana Góra;1390;789;789;35;754;56.76;4.44
106229;260410;Zespół Szkół w Kostomłotach Drugich|Kostomłoty Drugie|ul. Kielecka 9 |26-085 Miedziana Góra;1316;677;677;27;650;51.44;3.99
106230;260410;Gimnazjum w Ćmińsku|Ćmińsk|ul. Świętokrzyska 61 |26-085 Miedziana Góra;1247;585;585;26;559;46.91;4.44
106231;260410;Szkoła Podstawowa w Ćmińsku|Ćmińsk|ul. Świętokrzyska 61 |26-085 Miedziana Góra;1533;777;777;29;748;50.68;3.73
106232;260410;Świetlica Wiejska w Tumlinie-Wykień|Tumlin-Wykień| 40 |26-085 Miedziana Góra;1024;583;583;12;571;56.93;2.06
106233;260410;Świetlica w Remizie OSP w Miedzianej Górze|Miedziana Góra|ul. Urzędnicza 10 |26-085 Miedziana Góra;1015;517;517;15;502;50.94;2.90
106234;260411;Szkoła Podstawowa w Cierchach|Cierchy| 1 |26-080 Mniów;681;340;340;16;324;49.93;4.71
106235;260411;Powiatowy Zarząd Dróg w Kielcach|Stachura| 1 |26-080 Mniów;402;180;180;11;169;44.78;6.11
106236;260411;Zespół Szkół w Grzymałkowie|Grzymałków|ul. Świętokrzyska 22 |26-080 Mniów;1852;819;819;57;762;44.22;6.96
106237;260411;Zespół Szkół w Mniowie|Mniów|ul. Centralna 11 |26-080 Mniów;2284;1183;1183;44;1139;51.80;3.72
106238;260411;Szkoła Podstawowa w Rogowicach|Rogowice| 123 |26-080 Mniów;603;249;249;14;235;41.29;5.62
106239;260411;Szkoła Podstawowa w Zaborowicach|Zaborowice| 160 |26-080 Mniów;1137;623;623;26;597;54.79;4.17
106240;260411;Świetlica Wiejska w Wólce Kłuckiej|Wólka Kłucka| 157 |26-080 Mniów;465;191;191;14;177;41.08;7.33
106241;260412;Samorządowe Centrum Kultury|Morawica|ul. Spacerowa 7 |26-026 Morawica;1750;957;957;18;939;54.69;1.88
106242;260412;Szkoła Podstawowa w Bilczy|Bilcza|ul. Szkolna 2 |26-026 Morawica;1955;1266;1266;22;1244;64.76;1.74
106243;260412;Remiza OSP w Radomicach I|Radomice| 45A |26-026 Morawica;477;228;228;9;219;47.80;3.95
106244;260412;Szkoła Podstawowa w Obicach|Obice|ul. Szkolna 18 |26-026 Morawica;854;353;353;16;337;41.33;4.53
106245;260412;Szkoła Podstawowa w Dębskiej Woli|Dębska Wola| 146 |26-026 Morawica;1416;547;547;18;529;38.63;3.29
106246;260412;Szkoła Podstawowa w Brzezinach|Brzeziny|ul. Szkolna 1 |26-026 Morawica;2284;1177;1177;22;1155;51.53;1.87
106247;260412;Szkoła Podstawowa w Lisowie|Lisów|ul. Szkolna 8 |26-026 Morawica;942;466;466;14;452;49.47;3.00
106248;260412;Hala Sportowa "BILCZA"|Bilcza|ul. Szkolna 1 |26-026 Morawica;1456;886;886;20;866;60.85;2.26
106249;260412;Szkoła Podstawowa w Woli Morawickiej|Wola Morawicka|ul. Podemłynie 1 |26-026 Morawica;781;366;366;15;351;46.86;4.10
106250;260412;Świętokrzyskie Centrum Psychiatrii w Morawicy|Morawica|ul. Spacerowa 5 |26-026 Morawica;629;133;133;12;121;21.14;9.02
106251;260412;Świętokrzyskie Centrum Psychiatrii w Morawicy|Kielce|ul. Kusocińskiego 59 |25-045 Kielce;100;39;39;6;33;39.00;15.38
106252;260412;Zakład Opiekuńczo-Leczniczy i Rehabilitacyjny w Bilczy|Bilcza|ul. Osikowa 4 |26-026 Morawica;73;13;13;1;12;17.81;7.69
106253;260413;Zespół Szkół w Nowej Słupi|Nowa Słupia|ul. Szkolna 10 |26-006 Nowa Słupia;1532;673;673;26;647;43.93;3.86
106254;260413;Publiczna Szkoła Podstawowa w Mirocicach|Mirocice| 45A |26-006 Nowa Słupia;430;139;139;6;133;32.33;4.32
106255;260413;Świetokrzyskie Centrum Doskonalenia Nauczycieli Centrum Edukacyjne w Milanowskiej Wólce|Milanowska Wólka| 18A |26-006 Nowa Słupia;885;316;316;5;311;35.71;1.58
106256;260413;Publiczna Szkoła Podstawowa w Jeziorku im. Św. Eugeniusza de Mazenoda|Jeziorko| 123A |26-006 Nowa Słupia;1030;370;370;14;356;35.92;3.78
106257;260413;Zespół Szkół w Rudkach|Rudki|ul. Szkolna 2 |26-006 Nowa Słupia;1940;831;831;30;801;42.84;3.61
106258;260413;Publiczna Szkoła Podstawowa w Pokrzywiance|Pokrzywianka| 33 |26-006 Nowa Słupia;985;358;358;14;344;36.35;3.91
106259;260413;Publiczna Szkoła Podstawowa w Starej Słupi|Stara Słupia| 78 |26-006 Nowa Słupia;763;330;330;8;322;43.25;2.42
106260;260413;Publiczna Szkoła Podstawowa w Jeleniowie|Jeleniów| 85 |26-006 Nowa Słupia;545;245;245;6;239;44.95;2.45
106261;260414;Centrum Kultury|Piekoszów|ul. Częstochowska 85A |26-065 Piekoszów;1069;628;628;23;605;58.75;3.66
106262;260414;Biblioteka Centrum Kultury|Piekoszów|ul. Częstochowska 66 |26-065 Piekoszów;827;418;418;9;409;50.54;2.15
106263;260414;Centrum Kultury|Piekoszów|ul. Kolejowa 2 |26-065 Piekoszów;865;430;430;11;419;49.71;2.56
106264;260414;Gimnazjum w Jaworzni|Jaworznia| 93 |26-065 Piekoszów;704;329;329;8;321;46.73;2.43
106265;260414;Szkoła Podstawowa w Jaworzni|Jaworznia| 93 |26-065 Piekoszów;790;331;331;11;320;41.90;3.32
106266;260414;Szkoła Podstawowa w Brynicy|Brynica| 144a |26-065 Piekoszów;815;402;402;8;394;49.33;1.99
106267;260414;Zespół Placówek Oświatowych w Łosieniu|Łosień| 1 |26-065 Piekoszów;905;460;460;14;446;50.83;3.04
106268;260414;Zespół Placówek Oświatowych w Zajączkowie|Zajączków| 86 |26-065 Piekoszów;938;442;442;15;427;47.12;3.39
106269;260414;Szkoła Podstawowa w Rykoszynie|Rykoszyn| 124 |26-065 Piekoszów;1184;566;566;23;543;47.80;4.06
106270;260414;Świetlica Wiejska w Szczukowicach|Szczukowice| 176A |26-065 Piekoszów;1038;448;448;21;427;43.16;4.69
106271;260414;Szkoła Podstawowa w Micigoździe|Micigózd|ul. Częstochowska 21 |26-065 Piekoszów;902;433;433;20;413;48.00;4.62
106272;260414;Świetlica Wiejska w Wincentowie|Wincentów| 66B |26-065 Piekoszów;754;366;366;8;358;48.54;2.19
106273;260414;Żłobek Gminny w Piekoszowie|Piekoszów|ul. Czarnowska 54 |26-065 Piekoszów;539;260;260;7;253;48.24;2.69
106274;260414;Budynek Klubu Sportowego|Skałka|Osiedle 3a |26-065 Piekoszów;1024;495;495;13;482;48.34;2.63
106275;260414;Przedszkole w Jaworzni|Jaworznia| 93 |26-065 Piekoszów;450;166;166;7;159;36.89;4.22
106276;260414;Dom Dla Niepełnosprawnych w Piekoszowie|Piekoszów|ul. Czarnowska 2a |26-065 Piekoszów;48;43;43;2;41;89.58;4.65
106277;260415;Urząd Gminy Pierzchnica|Pierzchnica|ul.13 Stycznia 6 |26-015 Pierzchnica;1218;521;521;21;500;42.78;4.03
106278;260415;Społeczna Szkoła Podstawowa w Drugni|Drugnia| 28 |26-015 Pierzchnica;715;275;275;14;261;38.46;5.09
106279;260415;Budynek byłej szkoły podstawowej w Skrzelczycach|Skrzelczyce| 104 |26-015 Pierzchnica;777;362;362;22;340;46.59;6.08
106280;260415;Zespół Szkół w Pierzchnicy|Pierzchnica|ul. Kardynała Stefana Wyszyńskiego 5 |26-015 Pierzchnica;1120;546;546;15;531;48.75;2.75
106281;260415;Dom Seniora im. Sue Ryder|Pierzchnica|ul. Szkolna 36 |26-015 Pierzchnica;55;27;27;4;23;49.09;14.81
106282;260415;Dom Pomocy Społecznej w Osinach|Osiny| 54B |26-015 Pierzchnica;71;35;35;0;35;49.30;0.00
106283;260416;Szkoła Podstawowa|Bardo| 86a |26-035 Raków;409;142;142;4;138;34.72;2.82
106284;260416;Świetlica Wiejska|Celiny| 27a |26-035 Raków;366;143;143;4;139;39.07;2.80
106285;260416;Szkoła Podstawowa|Ociesęki| 63 |26-035 Raków;531;160;160;3;157;30.13;1.88
106286;260416;Zespół Szkolno Przedszkolny|Raków|ul. Sienieńskiego 20 |26-035 Raków;672;320;320;8;312;47.62;2.50
106287;260416;Szkoła Podstawowa|Szumsko| 42b |26-035 Raków;662;283;283;18;265;42.75;6.36
106288;260416;Świetlica Wiejska|Nowa Huta| 68 |26-035 Raków;350;144;144;6;138;41.14;4.17
106289;260416;Remiza OSP|Chańcza| 59a |26-035 Raków;343;169;169;2;167;49.27;1.18
106290;260416;Świetlica Wiejska|Życiny| 91 |26-035 Raków;263;85;85;11;74;32.32;12.94
106291;260416;Zespół Szkolno-Przedszkolny|Raków|ul. Sienieńskiego 20 |26-035 Raków;653;308;308;24;284;47.17;7.79
106292;260416;Dom Wiejski|Szumsko| 37 |26-035 Raków;566;213;213;9;204;37.63;4.23
106293;260417;Świetlica w Szewcach|Szewce|ul. Dewońska 91 |26-052 Nowiny;631;345;345;20;325;54.68;5.80
106294;260417;Gminna Biblioteka Publiczna w Nowinach|Nowiny|ul. Białe Zagłębie 25 |26-052 Nowiny;573;354;354;10;344;61.78;2.82
106295;260417;Zespół Szkół Ponadpodstawowych w Nowinach|Nowiny|ul. Gimnazjalna 1 |26-052 Nowiny;871;492;492;18;474;56.49;3.66
106296;260417;Samorządowe Przedszkole w Nowinach|Nowiny|ul. Parkowa 11 |26-052 Nowiny;910;484;484;6;478;53.19;1.24
106297;260417;Szkoła Podstawowa w Nowinach|Nowiny|ul. Białe Zagłębie 21 |26-052 Nowiny;1058;556;556;21;535;52.55;3.78
106298;260417;Szkoła Podstawowa w Bolechowicach|Bolechowice| 10 |26-052 Nowiny;791;401;401;14;387;50.70;3.49
106299;260417;Szkoła Podstawowa w Kowali|Kowala| 51B |26-052 Nowiny;949;448;448;21;427;47.21;4.69
106300;260418;Zespół Placówek Oświatowych w Oblęgorku|Oblęgorek|ul. Gimnazjalna 15 |26-067 Strawczyn;1528;780;780;21;759;51.05;2.69
106301;260418;Samorządowe Centrum Kultury i Sportu w Strawczynie|Strawczyn|ul. Żeromskiego 16 |26-067 Strawczyn;1688;926;926;31;895;54.86;3.35
106302;260418;Szkoła Podstawowa w Rudzie Strawczyńskiej|Ruda Strawczyńska| 4 |26-067 Strawczyn;1177;589;589;27;562;50.04;4.58
106303;260418;Szkoła Podstawowa w Korczynie|Korczyn| 101 |26-067 Strawczyn;714;355;355;18;337;49.72;5.07
106304;260418;Szkoła Podstawowa w Chełmcach|Chełmce|ul. Kościelna 51 |26-067 Strawczyn;1145;611;611;25;586;53.36;4.09
106305;260418;Zespół Placówek Oświatowych w Promniku|Promnik|ul. Szkolna 10 |26-067 Strawczyn;1109;565;565;10;555;50.95;1.77
106306;260418;Świetlica środowiskowa w Strawczynku|Strawczynek|ul. Wojewódzka 39 |26-067 Strawczyn;846;429;429;25;404;50.71;5.83
106307;260419;Urząd Gminy Zagnańsk|Zagnańsk|ul. Spacerowa 8 |26-050 Zagnańsk;492;269;269;7;262;54.67;2.60
106308;260419;Zespół Szkoły Podstawowej Nr 2, Przedszkola i Gimnazjum w Zagnańsku|Zagnańsk|ul. Turystyczna 59 |26-050 Zagnańsk;1452;902;902;19;883;62.12;2.11
106309;260419;Świetlica w Jaworzach|Jaworze|ul. Bursztynowa 9 |26-050 Zagnańsk;743;426;426;9;417;57.34;2.11
106310;260419;Zespół Szkoły Podstawowej i Gimnazjum w Kajetanowie|Zabłocie| 1 |26-050 Zagnańsk;1656;985;985;17;968;59.48;1.73
106311;260419;Zespół Szkoły Podstawowej, Przedszkola i Gimnazjum w Samsonowie|Samsonów| 24 |26-050 Zagnańsk;1566;856;856;25;831;54.66;2.92
106312;260419;Zespół Szkoły Podstawowej, Przedszkola i Gimnazjum w Tumlinie|Tumlin-Węgle|ul. Grodowa 2 |26-050 Zagnańsk;1177;633;633;14;619;53.78;2.21
106313;260419;Budynek Gminny w Szałasie|Szałas| 1A |26-050 Zagnańsk;495;220;220;9;211;44.44;4.09
106314;260419;Budynek Gminny w Umrze|Umer| 76 |26-050 Zagnańsk;723;366;366;9;357;50.62;2.46
106315;260419;Budynek Gminny w Zachełmiu|Zachełmie| 1 |26-050 Zagnańsk;687;368;368;13;355;53.57;3.53
106316;260419;Zespół Szkół Leśnych w Zagnańsku|Zagnańsk|ul. Spacerowa 4 |26-050 Zagnańsk;1053;555;555;14;541;52.71;2.52
106317;260419;Budynek Gminny w Belnie|Belno| 143 |26-050 Zagnańsk;493;225;225;10;215;45.64;4.44
106318;260501;Publiczna Szkoła Podstawowa|Czermno|ul. Kościelna 86 |26-260 Fałków;1361;503;503;21;482;36.96;4.17
106319;260501;Strażnica OSP w Fałkowie|Fałków|ul. Plac Kościelny 11 |26-260 Fałków;1837;739;739;36;703;40.23;4.87
106320;260501;Strażnica OSP w Turowicach|Turowice| 67 |26-260 Fałków;689;248;248;23;225;35.99;9.27
106321;260502;Remiza Ochotniczej Strazy Pożarnej Gowarczów|Gowarczów|ul. Warszawska 17 |26-225 Gowarczów;1148;521;521;19;502;45.38;3.65
106322;260502;Szkoła Podstawowa Gowarczów|Gowarczów|ul. Stanisława Żuka 3 |26-225 Gowarczów;519;194;194;13;181;37.38;6.70
106323;260502;Publiczne Gimnazjum Gowarczów|Gowarczów|ul. Szkolna 52 |26-225 Gowarczów;929;351;351;21;330;37.78;5.98
106324;260502;Remiza Ochotniczej Straży Pożarnej Giełzów|Giełzów| 72a |26-225 Gowarczów;593;240;240;15;225;40.47;6.25
106325;260502;Szkoła Podstawowa w Gowarczowie Filia w Kamiennej Woli|Kamienna Wola| 46B |26-225 Gowarczów;691;240;240;12;228;34.73;5.00
106326;260503;Miejsko-Gminny Ośrodek Pomocy Społecznej w Końskich|Końskie|ul. Armii Krajowej 22 |26-200 Końskie;1416;723;723;23;700;51.06;3.18
106327;260503;Gimnazjum Nr 1 w Końskich|Końskie|ul. Armii Krajowej 2 |26-200 Końskie;1438;740;740;18;722;51.46;2.43
106328;260503;Szkoła Podstawowa Nr 1 w Końskich|Końskie|ul.Armii Krajowej 2 |26-200 Końskie;1144;525;525;10;515;45.89;1.90
106329;260503;I Liceum Ogólnokształcące w Końskich|Końskie|ul. Kapitana Stoińskiego 4 |26-200 Końskie;951;518;518;11;507;54.47;2.12
106330;260503;Hala Sportowa w Końskich|Końskie|ul. Kapitana Stoińskiego 3 |26-200 Końskie;1584;871;871;6;865;54.99;0.69
106331;260503;Zespół Szkół Ponadgimnazjalnych Nr 3 w Końskich|Końskie|ul. Marszałka Piłsudskiego 68 |26-200 Końskie;1388;688;688;16;672;49.57;2.33
106332;260503;Przedszkole Samorządowe Nr 5 w Końskich|Końskie|ul.Księdza Granata 6 |26-200 Końskie;1316;674;674;14;660;51.22;2.08
106333;260503;Miejsko-Gminny Dom Kultury w Końskich|Końskie|ul. Partyzantów 1 |26-200 Końskie;1488;776;776;33;743;52.15;4.25
106334;260503;Szkoła Podstawowa Nr 2 w Końskich|Końskie|ul. Polna 6 |26-200 Końskie;1791;936;936;23;913;52.26;2.46
106335;260503;Gimnazjum Nr 2 w Końskich|Końskie|ul. Partyzantów 9 |26-200 Końskie;1442;698;698;17;681;48.40;2.44
106336;260503;Niepubliczny Zakład Opieki Zdrowotnej "POŁUDNIOWA" w Końskich|Końskie|ul. Południowa 1 |26-200 Końskie;1378;820;820;13;807;59.51;1.59
106337;260503;Zespół Skół w Stadnickiej Woli|Stadnicka Wola| 55 |26-200 Końskie;1114;640;640;15;625;57.45;2.34
106338;260503;Budynek OSP w Bedlnie|Bedlno| 33A |26-200 Końskie;1205;472;472;20;452;39.17;4.24
106339;260503;Budynek OSP w Proćwinie|Proćwin|ul. Zastawna 12 |26-200 Końskie;1693;721;721;20;701;42.59;2.77
106340;260503;Zespół Placówek Oświatowych w Nieświniu|Nieświń|ul. Szkolna 5 |26-200 Końskie;1388;504;504;26;478;36.31;5.16
106341;260503;Szkoła Podstawowa w Modliszewicach|Modliszewice|ul. Gasińskiego 2 |26-200 Końskie;1431;614;614;30;584;42.91;4.89
106342;260503;Zespół Szkół w Rogowie|Rogów|ul. Kozubskiego 18B |26-200 Końskie;1487;625;625;19;606;42.03;3.04
106343;260503;Zespół Placówek Oświatowych w Kazanowie|Nowy Kazanów| 1A |26-200 Końskie;1880;914;914;36;878;48.62;3.94
106344;260503;Zespół Placówek Oświatowych w Pomykowie|Pomyków| 25A |26-200 Końskie;1327;594;594;16;578;44.76;2.69
106345;260503;Szkoła Podstawowa w Dziebałtowie|Nowy Dziebałtów| 85 |26-200 Końskie;1731;794;794;33;761;45.87;4.16
106346;260503;Zespół Szkół w Stadnickiej Woli|Stadnicka Wola| 55 |26-200 Końskie;617;346;346;6;340;56.08;1.73
106347;260503;Budynek OSP w Wąsoszu|Wąsosz| 57A |26-220 Stąporków;421;207;207;10;197;49.17;4.83
106348;260503;Dom Pomocy Społecznej "Cichy Zakątek" w Końskich|Końskie|ul. Warszawska 25 |26-200 Końskie;109;60;60;12;48;55.05;20.00
106349;260503;Szpital im. Św. Łukasza w Końskich|Końskie|ul. Gimnazjalna 41B |26-200 Końskie;289;73;73;6;67;25.26;8.22
106350;260504;Szkoła Podstawowa w Radoszycach|Radoszyce|ul. Szkolna 1 |26-230 Radoszyce;1529;632;632;26;606;41.33;4.11
106351;260504;Gimnazjum Nr 1 w Radoszycach|Radoszyce|ul. Ogrodowa 21 |26-230 Radoszyce;1183;480;480;14;466;40.57;2.92
106352;260504;Hala Sportowa|Radoszyce|ul. Ogrodowa 21 |26-230 Radoszyce;919;404;404;14;390;43.96;3.47
106353;260504;Szkoła Podstawowa w Grodzisku|Grodzisko| 48C |26-230 Radoszyce;879;402;402;21;381;45.73;5.22
106354;260504;Szkoła Podstawowa w Górnikach|Górniki| 18 |26-230 Radoszyce;469;188;188;3;185;40.09;1.60
106355;260504;Szkoła Podstawowa w Kapałowie|Kapałów| 46 |26-230 Radoszyce;516;211;211;19;192;40.89;9.00
106356;260504;Szkoła Podstawowa w Wilczkowicach|Wilczkowice| 34 |26-230 Radoszyce;932;426;426;15;411;45.71;3.52
106357;260504;Świetlica OSP w Węgrzynie|Węgrzyn| 45 |26-230 Radoszyce;465;211;211;10;201;45.38;4.74
106358;260504;Szkoła Podstawowa w Kłucku 39|Kłucko| 39 |26-212 Smyków;492;138;138;16;122;28.05;11.59
106359;260505;Strażnica Ochotniczej Straży Pożarnej w Dębie|Dęba| 79 |26-242 Ruda Maleniecka;349;192;192;6;186;55.01;3.12
106360;260505;Zespół Publicznych Placówek Oświatowych w Rudzie Malenieckiej|Ruda Maleniecka| 105a |26-242 Ruda Maleniecka;979;494;494;23;471;50.46;4.66
106361;260505;Strażnica Ochotniczej Straży Pożarnej w Kołońcu|Kołoniec| 34 |26-242 Ruda Maleniecka;246;105;105;5;100;42.68;4.76
106362;260505;Szkoła Filialna w Lipie|Lipa| 70a |26-242 Ruda Maleniecka;926;475;475;18;457;51.30;3.79
106363;260505;Strażnica Ochotniczej Straży Pożarnej w Koliszowach|Koliszowy| 140 |26-242 Ruda Maleniecka;243;126;126;9;117;51.85;7.14
106364;260506;Szkoła Podstawowa w Pilczycy|Pilczyca| 70 |26-234 Słupia;874;340;340;8;332;38.90;2.35
106365;260506;Niepubliczna Szkoła Podstawowa w Radwanowie|Radwanów| 43 |26-234 Słupia;316;143;143;11;132;45.25;7.69
106366;260506;I Publiczne Gimnazjum w Słupi|Słupia| 36 |26-234 Słupia;666;341;341;9;332;51.20;2.64
106367;260506;Niepubliczna Szkoła Podstawowa w Mninie|Mnin|ul. Kościelna 38 |26-234 Słupia;459;201;201;16;185;43.79;7.96
106368;260506;Szkoła Podstawowa w Wólce|Wólka - Konradów| 4 |26-234 Słupia;423;192;192;1;191;45.39;0.52
106369;260506;Dom Pomocy Społecznej "Etola" w Rudzie Pilczyckiej|Ruda Pilczycka| 57 |26-234 Słupia;59;23;23;1;22;38.98;4.35
106370;260507;Świetlica w Smykowie|Smyków| 108 |26-212 Smyków;527;231;231;6;225;43.83;2.60
106371;260507;Szkoła Podstawowa w Królewcu|Królewiec| 14 |26-212 Smyków;772;330;330;12;318;42.75;3.64
106372;260507;Remiza OSP w Kozowie|Kozów| 52A |26-212 Smyków;487;226;226;10;216;46.41;4.42
106373;260507;Remiza OSP w Miedzierzy|Miedzierza| 23 |26-212 Smyków;837;370;370;14;356;44.21;3.78
106374;260507;Remiza OSP w Przyłogach|Przyłogi| 50 |26-212 Smykow;420;196;196;9;187;46.67;4.59
106375;260508;Publiczne Gimnazjum w Stąporkowie|Stąporków|ul. J. Piłsudskiego 114 |26-220 Stąporków;847;315;315;12;303;37.19;3.81
106376;260508;Publiczne Przedszkole w Stąporkowie|Stąporków|ul. J. Słowackiego 1 |26-220 Stąporków;896;336;336;17;319;37.50;5.06
106377;260508;Miejsko Gminny Ośrodek Kultury w Stąporkowie|Stąporków|ul. J. Piłsudskiego 103 |26-220 Stąporków;1213;554;554;6;548;45.67;1.08
106378;260508;Szkoła Podstawowa Nr 1 w Stąporkowie|Stąporków|ul. 1-go Maja 18 |26-220 Stąporków;1109;499;499;16;483;45.00;3.21
106379;260508;Szkoła Podstawowa Nr 2 w Stąporkowie|Stąporków|ul. Piłsudskiego 114 |26-220 Stąporków;811;334;334;10;324;41.18;2.99
106380;260508;Szkoła Podstawowa w Niekłaniu Wielkim|Niekłań Wielki|ul. Szkolna 1 |26-220 Stąporków;780;302;302;17;285;38.72;5.63
106381;260508;Szkoła Podstawowa w Niekłaniu Wielkim|Niekłań Wielki|ul. Szkolna 1 |26-220 Stąporków;1065;391;391;20;371;36.71;5.12
106382;260508;Świetlica wiejska w Koziej Woli|Kozia Wola| 156 |26-220 Stąporków;1116;406;406;17;389;36.38;4.19
106383;260508;Świetlica wiejska w Czarnej|Czarna| 72 |26-220 Stąporków;939;388;388;7;381;41.32;1.80
106384;260508;Świetlica Wiejska w Adamku|Adamek| 18b |26-220 Stąporków;820;383;383;7;376;46.71;1.83
106385;260508;Szkoła Podstawowa w Krasnej|Krasna| 53 |26-220 Stąporków;826;345;345;16;329;41.77;4.64
106386;260508;Remiza OSP w Mokrej|Mokra| 57a |26-220 Stąporków;513;196;196;10;186;38.21;5.10
106387;260508;Budynek po szkole podstawowej w Hucisku|Hucisko|ul. Górna 2 |26-220 Stąporków;573;243;243;8;235;42.41;3.29
106388;260508;Niepubliczna Szkoła Podstawowa w Gosaniu|Gosań| 150 |26-220 Stąporków;649;250;250;10;240;38.52;4.00
106389;260508;Świetlica wiejska w Świerczowie|Świerczów| 51a |26-220 Stąporków;589;219;219;9;210;37.18;4.11
106390;260508;Remiza OSP w Odrowążu|Odrowąż|ul. Kielecka 5 |26-220 Stąporków;1015;410;410;19;391;40.39;4.63
106391;260508;Świetlica wiejska w Wielkiej Wsi|Wielka Wieś|ul. Szkolna 24 |26-220 Stąporków;1083;333;333;20;313;30.75;6.01
106392;260601;Urząd Gminy w Baćkowicach|Baćkowice| 84 |27-552 Baćkowice;1900;877;877;25;852;46.16;2.85
106393;260601;Szkoła Podstawowa w Modliborzycach|Modliborzyce| 93 |27-552 Baćkowice;949;447;447;24;423;47.10;5.37
106394;260601;Szkoła Podstawowa w Piórkowie|Piórków| 9 |27-552 Baćkowice;699;234;234;13;221;33.48;5.56
106395;260601;Szkoła Podstawowa we Wszachowie|Wszachów| 49a |27-552 Baćkowice;558;221;221;11;210;39.61;4.98
106396;260602;Urząd Gminy|Iwaniska|Rynek 3 |27-570 Iwaniska;2299;1135;1135;45;1090;49.37;3.96
106397;260602;Zespół Publicznych Szkół w Iwaniskach Publiczna Szkoła Podstawowa w Iwaniskach Fila w Ujeździe|Ujazd| 9 |27-570 Iwaniska;1002;371;371;21;350;37.03;5.66
106398;260602;Budynek po byłej szkole|Przepiórów| 33 |27-570 Iwaniska;499;181;181;12;169;36.27;6.63
106399;260602;Zespół Publicznych Szkół w Iwaniskach Publiczna Szkoła Podstawowa w Iwaniskach Fila w Wygiełzowie|Wygiełzów| 6 |27-570 Iwaniska;563;216;216;3;213;38.37;1.39
106400;260602;Zespół Publicznych Szkół w Iwaniskach Publiczna Szkoła Podstawowa w Iwaniskach Fila w Jastrzębskiej Woli|Jastrzębska Wola| 5 |27-570 Iwaniska;546;218;218;9;209;39.93;4.13
106401;260602;Zespół Publicznych Szkół w Iwaniskach Publiczna Szkoła Podstawowa w Iwaniskach Fila w Mydłowie|Mydłów| 1 |27-570 Iwaniska;701;253;253;9;244;36.09;3.56
106402;260603;Zespół Szkół w Lipniku|Lipnik| 23 |27-540 Lipnik;1691;624;624;13;611;36.90;2.08
106403;260603;Zespół Szkół we Włostowie|Włostów| 1 |27-545 Włostów;1735;640;640;34;606;36.89;5.31
106404;260603;Świetlica Wiejska w Malicach Kościelnych|Malice Kościelne| 60 |27-540 Lipnik;739;248;248;8;240;33.56;3.23
106405;260603;Budynek po byłej Filialnej Szkole Podstawowej w Słoptowie|Słoptów| 23 |27-545 Włostów;412;135;135;7;128;32.77;5.19
106406;260604;Samorządowy Zespół Szkół Nr 1 w Opatowie|Opatów|ul. Ćmielowska 2 |27-500 Opatów;1296;698;698;20;678;53.86;2.87
106407;260604;Zespół Szkół Nr 2 w Opatowie Liceum Ogólnokształcące|Opatów|ul. Stefanii Sempołowskiej 1 |27-500 Opatów;1314;630;630;25;605;47.95;3.97
106408;260604;Opatowski Ośrodek Kultury w Opatowie|Opatów|ul. Partyzantów 13b |27-500 Opatów;1325;682;682;18;664;51.47;2.64
106409;260604;Samorządowy Zespół Szkół Nr 2 w Opatowie|Opatów|ul. Mikołaja Kopernika 30 |27-500 Opatów;1550;861;861;47;814;55.55;5.46
106410;260604;Samorządowy Zespół Szkół Nr 2 w Opatowie - Hala Sportowa|Opatów|ul. Mikołaja Kopernika 30 |27-500 Opatów;754;299;299;22;277;39.66;7.36
106411;260604;Świetlica wiejska w Nikisiałce Dużej|Nikisiałka Duża| 43 |27-500 Opatów;577;241;241;6;235;41.77;2.49
106412;260604;Szkoła Podstawowa w Kobylanach|Kobylany| 6 |27-500 Opatów;663;327;327;18;309;49.32;5.50
106413;260604;Specjalny Ośrodek Szkolno-Wychowawczy w Jałowęsach|Jałowęsy| 124 |27-500 Opatów;588;318;318;15;303;54.08;4.72
106414;260604;Remiza Ochotniczej Straży Pożarnej w Strzyżowicach|Strzyżowice| 36 |27-500 Opatów;600;330;330;26;304;55.00;7.88
106415;260604;Samorządowy Zespół Szkół Nr 1 w Opatowie|Opatów|ul. Ćmielowska 2 |27-500 Opatów;1146;487;487;21;466;42.50;4.31
106416;260604;Dom Pomocy Społecznej w Zochcinku|Zochcinek| 42 |27-500 Opatów;127;107;107;36;71;84.25;33.64
106417;260604;CENTRUM DIALIZA Sp. z o.o. Sosnowiec - Szpital Opatów|Opatów|ul. Szpitalna 4 |27-500 Opatów;68;27;27;2;25;39.71;7.41
106418;260605;Zespół Szkół Ogólnokształcących w Ożarowie im E. Szylki|Ożarów|Osiedle Wzgórze 54 |27-530 Ożarów;1305;605;605;27;578;46.36;4.46
106419;260605;Zespół Szkół w Ożarowie im. M. Skłodowskiej-Curie|Ożarów|Osiedle Wzgórze 56 |27-530 Ożarów;1190;584;584;23;561;49.08;3.94
106420;260605;Miejsko-Gminny Ośrodek Kultury w Ożarowie|Ożarów|ul. Stodolna 3 |27-530 Ożarów;1313;564;564;17;547;42.96;3.01
106421;260605;Specjalny Ośrodek Szkolno-Wychowawczy w Dębnie|Dębno| 69 |27-530 Ożarów;560;283;283;12;271;50.54;4.24
106422;260605;Publiczny Zespół Szkoły i Przedszkola w Lasocinie|Lasocin|ul. Rynek 17 |27-530 Ożarów;482;238;238;16;222;49.38;6.72
106423;260605;Zespół Szkół Ogólnokształcących w Ożarowie im E. Szylki|Ożarów|Osiedle Wzgórze 54 |27-530 Ożarów;1104;438;438;34;404;39.67;7.76
106424;260605;Zespół Szkół Ogólnokształcących w Ożarowie im. E. Szylki|Ożarów|Osiedle Wzgórze 54 |27-530 Ożarów;621;228;228;20;208;36.71;8.77
106425;260605;Remiza OSP w Janikowie|Janików| 5A |27-530 Ożarów;591;255;255;8;247;43.15;3.14
106426;260605;Remiza OSP w Jakubowicach|Jakubowice| 48A |27-530 Ożarów;474;185;185;9;176;39.03;4.86
106427;260605;Remiza OSP Przybysławicach|Przybysławice| 46 |27-530 Ożarów;644;256;256;15;241;39.75;5.86
106428;260605;Remiza OSP w Sobótce|Sobótka| 146 |27-530 Ożarów;642;245;245;17;228;38.16;6.94
106429;260605;Dom Pomocy Społecznej w Sobowie|Sobów| 117 |27-530 Ożarów;40;37;37;6;31;92.50;16.22
106430;260605;Dom Pomocy Społecznej w Czachowie|Czachów| 54 |27-530 Ożarów;29;19;19;4;15;65.52;21.05
106431;260606;Gminny Ośrodek Kultury i Sportu w Sadowiu|Sadowie| 90A |27-580 Sadowie;957;409;409;17;392;42.74;4.16
106432;260606;Zespół Szkół w Sadowiu|Sadowie| 94 |27-580 Sadowie;925;423;423;19;404;45.73;4.49
106433;260606;Strażnica Ochotniczej Straży Pożarnej w Wszechświęte|Wszechświęte| 19A |27-580 Sadowie;798;310;310;5;305;38.85;1.61
106434;260606;Szkoła Podstawowa w Biskupicach|Biskupice| 33 |27-580 Sadowie;726;362;362;13;349;49.86;3.59
106435;260607;Gminny Ośrodek Kultury w Tarłowie|Tarłów|ul. Kleparz 1 |27-515 Tarłów;1280;570;570;26;544;44.53;4.56
106436;260607;Szkoła Podstawowa w Czekarzewicach Drugich|Czekarzewice Drugie| 125 |27-515 Tarłów;639;227;227;10;217;35.52;4.41
106437;260607;Szkoła Podstawowa w Ciszycy Górnej|Ciszyca Górna| 53 |27-515 Tarłów;829;315;315;11;304;38.00;3.49
106438;260607;Specjalny Ośrodek Szkolno-Wychowawczy w Sulejowie|Sulejów| 69 |27-515 Tarłów;268;101;101;4;97;37.69;3.96
106439;260607;Remiza Ochotniczej Straży Pożarnej w Cegielni|Cegielnia| 25A |27-515 Tarłów;918;370;370;15;355;40.31;4.05
106440;260607;Szkoła Podstawowa w Duranowie|Duranów| 67 |27-515 Tarłów;712;264;264;23;241;37.08;8.71
106441;260608;Publiczna Szkoła Podstawowa w Wojciechowicach|Wojciechowice| 40 |27-532 Wojciechowice;960;423;423;26;397;44.06;6.15
106442;260608;Zespół Szkół Publicznych Nr 1 w Bidzinach|Bidziny| 121 |27-532 Wojciechowice;1140;513;513;28;485;45.00;5.46
106443;260608;Publiczna Szkoła Podstawowa w Gierczycach|Gierczyce| 123 |27-532 Wojciechowice;709;373;373;20;353;52.61;5.36
106444;260608;Publiczna Szkoła Podstawowa w Stodołach-Kolonie|Stodoły-Kolonie| 54a |27-532 Wojciechowice;640;278;278;17;261;43.44;6.12
106445;260701;Przedszkole Publiczne Nr 5|Ostrowiec Świętokrzyski|ul. Jasna 4 |27-400 Ostrowiec Świętokrzyski;1476;661;661;21;640;44.78;3.18
106446;260701;Publiczna Szkoła podstawowa Nr 3|Ostrowiec Świętokrzyski|ul. Niska 9 |27-400 Ostrowiec Świętokrzyski;1338;646;646;25;621;48.28;3.87
106447;260701;Miejski Ośrodek Sportu i Rekreacji Hala Sportowo-Widowiskowa|Ostrowiec Świętokrzyski|ul. Świętokrzyska 11 |27-400 Ostrowiec Świętokrzyski;1718;716;716;22;694;41.68;3.07
106448;260701;Budynek szkolny|Ostrowiec Świętokrzyski|ul. Górna 3 |27-400 Ostrowiec Świętokrzyski;1682;611;611;18;593;36.33;2.95
106449;260701;Publiczne Gimnazjum Nr 1 (SALA A)|Ostrowiec Świętokrzyski|ul. Henryka Sienkiewicza 69 |27-400 Ostrowiec Świętokrzyski;1636;736;736;27;709;44.99;3.67
106450;260701;Centrum Kształcenia Zawodowego i Ustawicznego w Ostrowcu Świętokrzyskim|Ostrowiec Świętokrzyski|ul. Adama Mickiewicza 1 |27-400 Ostrowiec Świętokrzyski;1107;453;453;14;439;40.92;3.09
106451;260701;Środowiskowy Dom Samopomocy "Przystań"|Ostrowiec Świętokrzyski|ul. Iłżecka 31 |27-400 Ostrowiec Świętokrzyski;1605;571;571;20;551;35.58;3.50
106452;260701;Budynek szkolny|Ostrowiec Świętokrzyski|ul. Ferdynanda Focha 3 |27-400 Ostrowiec Świętokrzyski;1431;548;548;14;534;38.29;2.55
106453;260701;Przedszkole Publiczne Nr 19|Ostrowiec Świętokrzyski|Os. Ogrody 20 |27-400 Ostrowiec Świętokrzyski;1293;620;620;13;607;47.95;2.10
106454;260701;Publiczne Gimnazjum Nr 3|Ostrowiec Świętokrzyski|Os. Słoneczne 37 |27-400 Ostrowiec Świętokrzyski;1518;635;635;13;622;41.83;2.05
106455;260701;Publiczne Gimnazjum Nr 1 (SALA B)|Ostrowiec Świętokrzyski|ul. Henryka Sienkiewicza 69 |27-400 Ostrowiec Świętokrzyski;2324;1052;1052;32;1020;45.27;3.04
106456;260701;Publiczna Szkoła Podstawowa nr 4|Ostrowiec Świętokrzyski|ul. Polna 56 |27-400 Ostrowiec Świętokrzyski;1701;734;734;20;714;43.15;2.72
106457;260701;Przedszkole Publiczne Nr 11|Ostrowiec Świętokrzyski|ul. Wspólna 20 |27-400 Ostrowiec Świętokrzyski;1466;663;663;18;645;45.23;2.71
106458;260701;Przedszkole Publiczne nr 12|Ostrowiec Świętokrzyski|Os. Słoneczne 5 |27-400 Ostrowiec Świętokrzyski;1990;942;942;25;917;47.34;2.65
106459;260701;Zespół Szkół Nr 1|Ostrowiec Świętokrzyski|Os. Słoneczne 33 |27-400 Ostrowiec Świętokrzyski;2161;984;984;30;954;45.53;3.05
106460;260701;Zespół Szkół i Placówek Publicznych Nr 3 (SALA A)|Ostrowiec Świętokrzyski|Os. Ogrody 20 |27-400 Ostrowiec Świętokrzyski;2201;951;951;34;917;43.21;3.58
106461;260701;Zespół Szkół i Placówek Publicznych Nr 3 (SALA B)|Ostrowiec Świętokrzyski|Os. Ogrody 20 |27-400 Ostrowiec Świętokrzyski;2242;1031;1031;20;1011;45.99;1.94
106462;260701;Dom Kultury "MALWA" sala teatralna|Ostrowiec Świętokrzyski|Os. Stawki 45 |27-400 Ostrowiec Świętokrzyski;1427;659;659;21;638;46.18;3.19
106463;260701;Dom Kultury "MALWA" Sala Wykładowa|Ostrowiec Świętokrzyski|Os. Stawki 45 |27-400 Ostrowiec Świętokrzyski;1481;616;616;11;605;41.59;1.79
106464;260701;Dom Kultury "MALWA" Klub "BONGO"|Ostrowiec Świętokrzyski|Os. Stawki 45 |27-400 Ostrowiec Świętokrzyski;1532;679;679;14;665;44.32;2.06
106465;260701;Przedszkole Publiczne Nr 21|Ostrowiec Świętokrzyski|Os. Stawki 43 |27-400 Ostrowiec Świętokrzyski;1328;563;563;21;542;42.39;3.73
106466;260701;Zespół Szkół Publicznych Nr 2 (SALA A)|Ostrowiec Świętokrzyski|Os. Stawki 35 |27-400 Ostrowiec Świętokrzyski;2368;1050;1050;21;1029;44.34;2.00
106467;260701;Zespół Szkół Publicznych Nr 2 (SALA B)|Ostrowiec Świętokrzyski|Os. Stawki 35 |27-400 Ostrowiec Świętokrzyski;1230;571;571;13;558;46.42;2.28
106468;260701;Zespół Szkół Publicznych Nr 2 (SALA C)|Ostrowiec Świętokrzyski|Os. Stawki 35 |27-400 Ostrowiec Świętokrzyski;1211;562;562;15;547;46.41;2.67
106469;260701;Publiczna Szkoła Podstawowa Nr 7|Ostrowiec Świętokrzyski|ul. Akademicka 20 |27-400 Ostrowiec Świętokrzyski;1234;559;559;27;532;45.30;4.83
106470;260701;Wyższa Szkoła Biznesu i Przedsiębiorczości|Ostrowiec Świętokrzyski|ul. Akademicka 12 |27-400 Ostrowiec Świętokrzyski;1176;529;529;18;511;44.98;3.40
106471;260701;Dzienny Dom Pomocy Społecznej|Ostrowiec Świętokrzyski|Os. Pułanki 10 |27-400 Ostrowiec Świętokrzyski;1227;567;567;13;554;46.21;2.29
106472;260701;Przedszkole Publiczne Nr 16|Ostrowiec Świętokrzyski|Os. Pułanki 6 |27-400 Ostrowiec Świętokrzyski;1169;582;582;14;568;49.79;2.41
106473;260701;Publiczna Szkoła Podstawowa Nr 1 (SALA A)|Ostrowiec Świętokrzyski|ul. Trzeciaków 35 |27-400 Ostrowiec Świętokrzyski;2113;1195;1195;13;1182;56.55;1.09
106474;260701;Publiczna Szkoła Podstawowa Nr 1 (SALA B)|Ostrowiec Świętokrzyski|ul. Trzeciaków 35 |27-400 Ostrowiec Świętokrzyski;2029;981;981;10;971;48.35;1.02
106475;260701;Miejskie Wodociągi i Kanalizacja|Ostrowiec Świętokrzyski|ul. Henryka Sienkiewicza 91 |27-400 Ostrowiec Świętokrzyski;1931;942;942;16;926;48.78;1.70
106476;260701;Miejskie Wodociągi i Kanalizacja Wydział Eksploatacyjny|Ostrowiec Świętokrzyski|ul. Długa 14 |27-400 Ostrowiec Świętokrzyski;1572;845;845;15;830;53.75;1.78
106477;260701;Publiczna Szkoła Podstawowa Nr 10|Ostrowiec Świętokrzyski|ul. Rzeczki 18 |27-400 Ostrowiec Świętokrzyski;2274;950;950;28;922;41.78;2.95
106478;260701;Budynek szkolny|Ostrowiec Świętokrzyski|ul. Bałtowska 336a |27-400 Ostrowiec Świętokrzyski;1465;618;618;13;605;42.18;2.10
106479;260701;Publiczna Szkoła Podstawowa Nr 9|Ostrowiec Świętokrzyski|ul. Niewiadoma 19 |27-400 Ostrowiec Świętokrzyski;1866;806;806;34;772;43.19;4.22
106480;260701;Dom Pomocy Społecznej|Ostrowiec Świętokrzyski|ul. Grabowiecka 7 |27-400 Ostrowiec Świętokrzyski;171;90;90;5;85;52.63;5.56
106481;260701;Dom Pomocy Społecznej|Ostrowiec Świętokrzyski|os. Słoneczne 49 |27-400 Ostrowiec Świętokrzyski;102;38;38;10;28;37.25;26.32
106482;260701;Szpital (Zespół Opieki Zdrowotnej)|Ostrowiec Świętokrzyski|ul. K. Szymanowskiego 11 |27-400 Ostrowiec Świętokrzyski;293;68;68;3;65;23.21;4.41
106483;260702;Zespół Szkół Publicznych w Bałtowie|Bałtów| 43 |27-423 Bałtów;1117;536;536;26;510;47.99;4.85
106484;260702;Publiczna Szkoła Podstawowa im. Legionów Polskich w Okole|Okół| 82 |27-423 Bałtów;659;231;231;26;205;35.05;11.26
106485;260702;Budynek byłej Szkoły Podstawowej w Pętkowicach|Pętkowice| 49 |27-423 Bałtów;685;288;288;37;251;42.04;12.85
106486;260702;Filia Szkoły Podstawowej w Bałtowie w m. Wólka Bałtowska|Wólka Bałtowska| 30 |27-423 Bałtów;538;189;189;11;178;35.13;5.82
106487;260702;Świetlica Wiejska w Michałowie|Michałów| 11 |27-423 Bałtów;91;38;38;0;38;41.76;0.00
106488;260703;Zespół Szkół Publicznych Publiczne Gimnazjum im. Jana Pawła II w Bodzechowie|Bodzechów|ul. Szkolna 12 |27-420 Bodzechów;1367;556;556;12;544;40.67;2.16
106489;260703;Publiczna Szkoła Podstawowa w Miłkowie|Miłków|ul.Szkolna 13 |27-400 Ostrowiec Świętokrzyski;712;329;329;10;319;46.21;3.04
106490;260703;Publiczna Szkoła Podstawowa w Szwarszowicach|Szwarszowice| 20A |27-400 Ostrowiec Świętokrzyski;1312;493;493;14;479;37.58;2.84
106491;260703;Publiczne Gimnazjum w Szewnie|Szewna|ul. Langiewicza 3 |27-400 Ostrowiec Świętokrzyski;1866;951;951;20;931;50.96;2.10
106492;260703;Świetlica Wiejska w Jędrzejowicach|Jędrzejowice| 17A |27-400 Ostrowiec Świętokrzyski;1053;430;430;25;405;40.84;5.81
106493;260703;Publiczna Szkoła Podstawowa im. Jana Brzechwy w Chmielowie|Chmielów|ul. Spacerowa 2 |27-400 Ostrowiec Świętokrzyski;770;313;313;15;298;40.65;4.79
106494;260703;Zespół Szkół Publicznych w Sarnówku|Sarnówek Duży| 11 |27-400 Ostrowiec Świętokrzyski;879;346;346;9;337;39.36;2.60
106495;260703;Ośrodek Szkoleniowo-Wypoczynkowy "Leśne Kąty" w Sudole|Sudół| 3 |27-400 Ostrowiec Świętokrzyski;912;296;296;15;281;32.46;5.07
106496;260703;Świetlica Wiejska w Goździelinie|Goździelin| 72B |27-400 Ostrowiec Świętokrzyski;564;236;236;8;228;41.84;3.39
106497;260703;Leśniczówka "Sowia Góra" w Przyborowiu|Przyborów| 1 |27-420 Bodzechów;603;279;279;9;270;46.27;3.23
106498;260703;Ośrodek Wsparcia Rodziny im. ks. Marcina Popiela w Jędrzejowie|Jędrzejów| 23 |27-400 Ostrowiec Świętokrzyski;729;331;331;10;321;45.40;3.02
106499;260703;Strażnica OSP w Gromadzicach|Gromadzice|ul. Szewieńska 37 |27-400 Ostrowiec Świętokrzyski;377;152;152;6;146;40.32;3.95
106500;260704;Dom Kultury im. W Gombrowicza w Ćmielowie|Ćmielów|ul. Rynek 50 |27-440 Ćmielów;1414;575;575;34;541;40.66;5.91
106501;260704;Szkoła Podstawowa nr 1 im. Jana Nalazka w Ćmielowie|Ćmielów|ul. Długa 164 |27-440 Ćmielów;1785;681;681;20;661;38.15;2.94
106502;260704;Publiczna Szkoła Podstawowa w Brzóstowej|Brzóstowa| 200A |27-440 Ćmielów;1921;729;729;15;714;37.95;2.06
106503;260704;Świetlica Wiejska w Stokach Małych|Stoki Małe| 12 |27-440 Ćmielów;364;121;121;9;112;33.24;7.44
106504;260704;Szkoła Podstawowa w Podgórzu|Podgórze| 55 |27-440 Ćmielów;370;160;160;9;151;43.24;5.62
106505;260704;Remiza Ochotniczej Straży Pożarnej w Buszkowicach|Buszkowice| 6 |27-440 Ćmielów;382;148;148;8;140;38.74;5.41
106506;260705;Budynek po Szkole Podstawowej w Bukowiu|Bukowie| 23 |27-415 Kunów;455;173;173;8;165;38.02;4.62
106507;260705;Budynek po Szkole Podstawowej w Chocimowie|Chocimów| 75b |27-415 Kunów;598;205;205;5;200;34.28;2.44
106508;260705;Publiczna Szkoła Podstawowa w Dołach Biskupich|Doły Biskupie| 42 |27-415 Kunów;359;135;135;10;125;37.60;7.41
106509;260705;Publiczna Szkoła Podstawowa w Janiku|Janik|ul. Szkolna 21 |27-415 Kunów;1177;453;453;26;427;38.49;5.74
106510;260705;Publiczna Szkoła Podstawowa w Kunowie|Kunów|ul. Szkolna 1 |27-415 Kunów;1140;539;539;26;513;47.28;4.82
106511;260705;Gimnazjum w Kunowie|Kunów|Fabryczna 1 |27-415 Kunów;1751;739;739;47;692;42.20;6.36
106512;260705;Lokal Prywatny Restauracja Gościna|Boksycka| 114 |27-415 Kunów;571;212;212;5;207;37.13;2.36
106513;260705;Publiczna Szkoła Podstawowa w Wymysłowie|Wymysłów|ul. Wesoła 43 |27-415 Kunów;464;175;175;13;162;37.72;7.43
106514;260705;Szkoła Podstawowa w Nietulisku Dużym|Nietulisko Duże| 30 |27-415 Kunów;662;277;277;11;266;41.84;3.97
106515;260705;Remiza OSP w Nietulisku Małym|Nietulisko Małe| 83 a |27-415 Kunów;626;220;220;9;211;35.14;4.09
106516;260705;Publiczna Szkoła Podstawowa w Miłkowskiej Karczmie|Miłkowska Karczma| 64 |27-415 Kunów;407;127;127;11;116;31.20;8.66
106517;260706;Publiczna Szkoła Podstawowa w Waśniowie|Waśniów|ul. Kunowska 2 |27-425 Waśniów;1146;434;434;26;408;37.87;5.99
106518;260706;Publiczna Szkoła Podstawowa w Waśniowie|Waśniów|ul. Kunowska 2 |27-425 Waśniów;721;221;221;16;205;30.65;7.24
106519;260706;Publiczna Szkoła Podstawowa w Boleszynie|Boleszyn| 74 |27-425 Waśniów;603;229;229;13;216;37.98;5.68
106520;260706;Budynek po zlikwidowanej Gminnej Bibliotece w Sarniej Zwoli|Sarnia Zwola| 30b |27-425 Waśniów;1526;543;543;34;509;35.58;6.26
106521;260706;Zespół Szkół w Mominie|Momina| 20 |27-425 Waśniów;774;287;287;15;272;37.08;5.23
106522;260706;Budynek po zlikwidowanej Szkole Podstawowej w Janowicach|Janowice| 31 |27-425 Waśniów;854;266;266;11;255;31.15;4.14
106523;260801;Hala Sportowa Zespół Szkół w Działoszycach|Działoszyce|ul. Szkolna 5 |28-440 Działoszyce;849;290;290;8;282;34.16;2.76
106524;260801;Urząd Miasta i Gminy w Działoszycach|Działoszyce|ul. Skalbmierska 5 |28-440 Działoszyce;933;327;327;16;311;35.05;4.89
106525;260801;Szkoła Podstawowa w Dzierążni|Dzierążnia| 171 |28-440 Działoszyce;901;318;318;6;312;35.29;1.89
106526;260801;Remiza OSP w Sancygniowie|Sancygniów| 37 |28-440 Działoszyce;522;176;176;5;171;33.72;2.84
106527;260801;Szkoła Podstawowa w Stępocicach|Stępocice| 4 |28-440 Działoszyce;624;248;248;10;238;39.74;4.03
106528;260801;Budynek Parafialny w Wolicy|Wolica| 7a |28-440 Działoszyce;563;183;183;4;179;32.50;2.19
106529;260802;Świetlica Wiejska w Czechowie|Czechów| 25 |28-404 Kije;564;247;247;11;236;43.79;4.45
106530;260802;Szkoła Podstawowa w Kijach|Kije| 14 |28-404 Kije;1570;653;653;20;633;41.59;3.06
106531;260802;Świetlica Wiejska w Stawianach|Stawiany| 15 |28-404 Kije;762;309;309;11;298;40.55;3.56
106532;260802;Szkoła Filialna we Włoszczowicach|Włoszczowice| 15 |28-404 Kije;836;415;415;11;404;49.64;2.65
106533;260803;Zespół Placówek Oświatowych w Górach|Góry| 116 |28-411 Michałów;651;279;279;7;272;42.86;2.51
106534;260803;Świetlica wiejska Tomaszów|Tomaszów| 21 |28-411 Michałów;731;236;236;7;229;32.28;2.97
106535;260803;Świetlica wiejska Michałów|Michałów| 107 |28-411 Michałów;1248;507;507;17;490;40.62;3.35
106536;260803;Remiza Ochotniczej Straży Pożarnej|Tur Dolny| 75 |28-411 Michałów;461;135;135;6;129;29.28;4.44
106537;260803;Remiza Ochotniczej Straży Pożarnej|Wrocieryż| 75 |28-411 Michałów;777;271;271;12;259;34.88;4.43
106538;260804;Pińczowskie Samorządowe Centrum Kultury|Pińczów|ul. Piłsudskiego 2a |28-400 Pińczów;1863;766;766;28;738;41.12;3.66
106539;260804;Zespół Szkół Zawodowych|Pińczów|ul. Spółdzielcza 6 |28-400 Pińczów;1351;607;607;5;602;44.93;0.82
106540;260804;Gimnazjum Nr 2|Pińczów|ul. 1 Maja 5 |28-400 Pińczów;1808;904;904;14;890;50.00;1.55
106541;260804;Przedszkole w Szarbkowie|Szarbków| 62 |28-400 Pińczów;917;387;387;12;375;42.20;3.10
106542;260804;Miejska i Gminna Biblioteka Publiczna|Pińczów|ul. Nowy Świat 3 |28-400 Pińczów;1592;722;722;10;712;45.35;1.39
106543;260804;Szkoła Podstawowa w Młodzawach Dużych|Młodzawy Duże| 14a |28-400 Pińczów;846;273;273;11;262;32.27;4.03
106544;260804;Szkoła Podstawowa w Kozubowie|Kozubów| 54a |28-400 Pińczów;951;287;287;11;276;30.18;3.83
106545;260804;Szkoła Podstawowa w Bogucicach Pierwszych|Bogucice Pierwsze|ul. Stara Wieś 34 |28-400 Pińczów;898;429;429;10;419;47.77;2.33
106546;260804;Szkoła Podstawowa w Gackach Osiedlu|Gacki-Osiedle| 25 |28-400 Pińczów;1424;542;542;8;534;38.06;1.48
106547;260804;Szkoła Podstawowa w Starej Zagości|Stara Zagość| 12 |28-400 Pińczów;600;223;223;10;213;37.17;4.48
106548;260804;Przedszkole Nr 3|Pińczów|ul. Kołłątaja 8 |28-400 Pińczów;1503;793;793;7;786;52.76;0.88
106549;260804;Zespół Szkół - Gimnazjum Nr 1|Pińczów|ul.7 Źródeł 7 |28-400 Pińczów;1856;879;879;10;869;47.36;1.14
106550;260804;Szkoła Podstawowa w Brześciu|Brzeście| 75a |28-400 Pińczów;951;383;383;5;378;40.27;1.31
106551;260804;Zespół Szkół - Szkoła Podstawowa|Pińczów|ul. 7 Źródeł 7 |28-400 Pińczów;813;363;363;8;355;44.65;2.20
106552;260804;Szpital Powiatowy w Pińczowie|Pińczów|ul. Armii Krajowej 22 |28-400 Pińczów;212;20;20;1;19;9.43;5.00
106553;260804;Dom Pomocy Społecznej w Pińczowie|Pińczów|ul. Wesoła 5 |28-400 Pińczów;70;37;37;5;32;52.86;13.51
106554;260804;Zakład Karny w Pińczowie|Pińczów|ul. 3 Maja 34 |28-400 Pińczów;607;257;257;31;226;42.34;12.06
106555;260805;Zespół Placówek Oświatowych w Złotej|Złota|ul. Parkowa 4 |28-425 Złota;1238;408;408;10;398;32.96;2.45
106556;260805;Szkoła Podstawowa w Chrobrzu|Chroberz|ul. Chrobrego 22 |28-425 Złota;1423;500;500;18;482;35.14;3.60
106557;260805;Świetlica Wiejska w Pełczyskach|Pełczyska| 75 |28-425 Złota;1266;444;444;11;433;35.07;2.48
106558;260901;Centrum Kultury i Rekreacji|Sandomierz|ul.Portowa 24 |27-600 Sandomierz;1701;791;791;33;758;46.50;4.17
106559;260901;Szkoła Podstawowa nr 3|Sandomierz|ul.Flisaków 26 |27-600 Sandomierz;1911;917;917;26;891;47.99;2.84
106560;260901;Urząd Miejski|Sandomierz|Plac Poniatowskiego 1 |27-600 Sandomierz;1747;973;973;18;955;55.70;1.85
106561;260901;Szkoła Podstawowa nr 2|Sandomierz|ul.Mickiewicza 9 |27-600 Sandomierz;1055;525;525;11;514;49.76;2.10
106562;260901;Miejski Stadion Sportowy|Sandomierz|Koseły 3a |27-600 Sandomierz;1032;462;462;17;445;44.77;3.68
106563;260901;Zespół Szkół Technicznych i Ogólnokształcących|Sandomierz|ul.Słowackiego 37 |27-600 Sandomierz;1009;466;466;10;456;46.18;2.15
106564;260901;Gimnazjum nr 1|Sandomierz|ul.Cieśli 2 |27-600 Sandomierz;1989;1019;1019;16;1003;51.23;1.57
106565;260901;Ośrodek Promocji Aktywności Kulturalnej|Sandomierz|ul.Armii Krajowej 1 |27-600 Sandomierz;1883;996;996;12;984;52.89;1.20
106566;260901;Szkoła Podstawowa nr 4|Sandomierz|ul.Mickiewicza 39 |27-600 Sandomierz;898;458;458;8;450;51.00;1.75
106567;260901;Ponadgimnazjalny Zespół Szkół Ekonomicznych|Sandomierz|ul.Żeromskiego 8 |27-600 Sandomierz;1766;710;710;24;686;40.20;3.38
106568;260901;Komenda Powiatowa Państwowej Straży Pożarnej|Sandomierz|ul.Mickiewicza 61 |27-600 Sandomierz;2111;1101;1101;10;1091;52.16;0.91
106569;260901;Bursa Szkolna|Sandomierz|ul.Wojska Polskiego 22 |27-600 Sandomierz;826;453;453;6;447;54.84;1.32
106570;260901;Państwowa Wyższa Szkoła Zawodowa|Sandomierz|ul.Schinzla 13 |27-600 Sandomierz;1866;875;875;24;851;46.89;2.74
106571;260901;Szpital Specjalistyczny Ducha Świętego|Sandomierz|ul. Schinzla 13 |27-600 Sandomierz;466;106;106;6;100;22.75;5.66
106572;260901;Dom Pomocy Społecznej|Sandomierz|ul. Czyżewskiego 1 |27-600 Sandomierz;85;64;64;5;59;75.29;7.81
106573;260902;Urząd Gminy w Dwikozach|Dwikozy|ul. Spółdzielcza 15 |27-620 Dwikozy;1557;622;622;24;598;39.95;3.86
106574;260902;Szkoła Podstawowa w Dwikozach|Dwikozy|ul. Sandomierska 55 |27-620 Dwikozy;654;218;218;15;203;33.33;6.88
106575;260902;Szkoła Podstawowa w Starym Garbowie|Stary Garbów| 82 |27-620 Dwikozy;723;255;255;3;252;35.27;1.18
106576;260902;Szkoła Podstawowa w Gierlachowie|Gierlachów| 96 |27-600 Sandomierz;628;276;276;9;267;43.95;3.26
106577;260902;Szkoła Podstawowa w Górach Wysokich|Góry Wysokie| 61 |27-620 Dwikozy;1040;368;368;15;353;35.38;4.08
106578;260902;Szkoła Podstawowa w Winiarach|Winiary| 2 |27-620 Dwikozy;559;175;175;10;165;31.31;5.71
106579;260902;Szkoła Podstawowa w Słupczy|Słupcza| 74 |27-620 Dwikozy;1003;339;339;11;328;33.80;3.24
106580;260902;Szkoła Podstawowa w Mściowie|Mściów| 100 |27-600 Sandomierz;1199;411;411;14;397;34.28;3.41
106581;260903;Gimnazjum im. Papieża Jana Pawła II w Klimontowie|Klimontów|ul. Zysmana 9 |27-640 Klimontów;1584;669;669;18;651;42.23;2.69
106582;260903;Publiczna Szkoła Podstawowa im. Jerzego Ossolińskiego w Klimontowie|Klimontów|ul. Szkolna 1 |27-640 Klimontów;1115;339;339;13;326;30.40;3.83
106583;260903;Publiczna Szkoła Podstawowa im. Jerzego Ossolińskiego w Klimontowie|Klimontów|ul. Szkolna 1 |27-640 Klimontów;1076;362;362;17;345;33.64;4.70
106584;260903;Świetlica w Olbierzowicach|Olbierzowice| |27-640 Klimontów;476;174;174;6;168;36.55;3.45
106585;260903;Świetlica w Nawodzicach|Nawodzice| |27-640 Klimontów;590;206;206;22;184;34.92;10.68
106586;260903;Szkoła Podstawowa w Konarach|Konary| 88 |27-640 Klimontów;638;213;213;10;203;33.39;4.69
106587;260903;Remiza OSP w Nasławicach|Nasławice| |27-640 Klimontów;416;143;143;9;134;34.38;6.29
106588;260903;Szkoła Podstawowa w Goźlicach|Goźlice| 28 |27-640 Klimontów;911;301;301;25;276;33.04;8.31
106589;260904;Urząd Miasta i Gminy /I piętro/|Koprzywnica|ul.11 listopada 88 |27-660 Koprzywnica;2088;995;995;28;967;47.65;2.81
106590;260904;Urząd Miasta i Gminy w Koprzywnicy /parter/|Koprzywnica|ul.11 Listopada 88 |27-660 Koprzywnica;723;352;352;13;339;48.69;3.69
106591;260904;Szkoła Podstawowa w Gnieszowicach|Gnieszowice| |27-660 Koprzywnica;426;219;219;12;207;51.41;5.48
106592;260904;Szkoła Podstawowa w Niedźwicach|Niedźwice| 63 |27-660 Koprzywnica;681;280;280;8;272;41.12;2.86
106593;260904;Remiza OSP w Zbigniewicach|Zbigniewice| |27-660 Koprzywnica;707;267;267;9;258;37.77;3.37
106594;260904;Budynek byłej Szkoły Podstawowej w Krzcinie|Krzcin| |27-660 Koprzywnica;424;171;171;7;164;40.33;4.09
106595;260904;Remiza OSP w Ciszycy|Ciszyca| 112 |27-660 Koprzywnica;607;259;259;9;250;42.67;3.47
106596;260905;Gminny Ośrodek Kultury w Łoniowie|Łoniów| 56 |27-670 Łoniów;2309;1010;1010;24;986;43.74;2.38
106597;260905;Gminny Ośrodek Kultury, Filia w Chodkowie Starym|Chodków Stary| 44 |27-670 Łoniów;834;346;346;9;337;41.49;2.60
106598;260905;Publiczna Szkoła Podstawowa w Świniarach Starych|Świniary Stare| 131 |27-670 Łoniów;1354;582;582;25;557;42.98;4.30
106599;260905;Centrum Spotkań Wiejskich w Sulisławicach|Sulisławice| 11 |27-670 Łoniów;1657;729;729;32;697;44.00;4.39
106600;260906;Remiza Ochotniczej Straży Pożarnej w Obrazowie|Obrazów| 120 |27-641 Obrazów;1678;611;611;21;590;36.41;3.44
106601;260906;Szkoła Podstawowa w Głazowie|Głazów| 80 |27-641 Obrazów;840;355;355;4;351;42.26;1.13
106602;260906;Szkoła Podstawowa w Kleczanowie|Kleczanów| 145 |27-641 Obrazów;1072;417;417;8;409;38.90;1.92
106603;260906;Szkoła Podstawowa w Bilczy|Bilcza| 75 |27-641 Obrazów;1097;380;380;22;358;34.64;5.79
106604;260906;Budynek Świetlicy|Chwałki| 149A |27-600 Sandomierz;769;354;354;7;347;46.03;1.98
106605;260907;Zespół Publicznych Placówek Oświatowych|Samborzec| 79 |27-650 Samborzec;1536;687;687;27;660;44.73;3.93
106606;260907;Szkoła Podstawowa|Skotniki| 64 |27-650 Samborzec;893;411;411;15;396;46.02;3.65
106607;260907;Liceum Ogólnokształcące|Chobrzany| 111A |27-650 Samborzec;882;355;355;14;341;40.25;3.94
106608;260907;Liceum Ogólnokształcące|Chobrzany| 111A |27-650 Samborzec;1030;434;434;9;425;42.14;2.07
106609;260907;Szkoła Podstawowa|Zawierzbie| 67 |27-650 Samborzec;916;375;375;13;362;40.94;3.47
106610;260907;Szkoła Podstawowa|Złota| 121 |27-650 Samborzec;969;423;423;7;416;43.65;1.65
106611;260907;Szkoła Podstawowa|Złota| 121 |27-650 Samborzec;913;359;359;18;341;39.32;5.01
106612;260908;Zespół Szkół w Wilczycach im. Stanisława Młodożeńca|Wilczyce| 177 |27-612 Wilczyce;920;306;306;12;294;33.26;3.92
106613;260908;Szkoła Podstawowa i Gimnazjum w Darominie|Daromin| 128 |27-612 Wilczyce;680;235;235;17;218;34.56;7.23
106614;260908;Zespół Szkół w Radoszkach|Radoszki| 16 |27-612 Wilczyce;536;232;232;7;225;43.28;3.02
106615;260908;Zespół Szkół w Łukawie|Łukawa| 83 |27-612 Wilczyce;650;233;233;11;222;35.85;4.72
106616;260908;Remiza OSP w Pielaszowie|Pielaszów| 69 |27-612 Wilczyce;406;136;136;7;129;33.50;5.15
106617;260909;Miejsko - Gminny Ośrodek Kultury|Zawichost|ul. Żeromskiego 33 |27-630 Zawichost;1514;669;669;27;642;44.19;4.04
106618;260909;Zespół Szkoły i Przedszkola w Czyżowie Szlacheckim|Czyżów Szlachecki| |27-630 Zawichost;1433;453;453;27;426;31.61;5.96
106619;260909;Samorządowe Przedszkole w Linowie|Linów| 97A |27-630 Zawichost;779;278;278;6;272;35.69;2.16
106620;261001;Powiatowy Urząd Pracy|Skarżysko-Kamienna|ul. 1-go Maja 105 |26-110 Skarżysko-Kamienna;1133;489;489;15;474;43.16;3.07
106621;261001;Specjalny Ośrodek Szkolno - Wychowawczy Nr 2|Skarżysko-Kamienna|ul. Spacerowa 31 |26-110 Skarżysko-Kamienna;1234;681;681;14;667;55.19;2.06
106622;261001;Szkoła Podstawowa Nr 8|Skarżysko-Kamienna|ul. Podjazdowa 21 |26-110 Skarżysko-Kamienna;1366;620;620;4;616;45.39;0.65
106623;261001;Powiatowa i Miejska Biblioteka Publiczna|Skarżysko-Kamienna|ul. Towarowa 20 |26-110 Skarżysko-Kamienna;788;313;313;3;310;39.72;0.96
106624;261001;Zespół Placówek Oświatowych Nr 3|Skarżysko-Kamienna|ul. Sportowa 30 |26-110 Skarżysko-Kamienna;1349;533;533;18;515;39.51;3.38
106625;261001;Zespół Placówek Edukacyjno-Wychowawczych|Skarżysko-Kamienna|ul. Szkolna 15 |26-110 Skarżysko-Kamienna;806;351;351;9;342;43.55;2.56
106626;261001;Muzeum im. Orła Białego|Skarżysko-Kamienna|ul. Słoneczna 90 |26-110 Skarżysko-Kamienna;1511;561;561;29;532;37.13;5.17
106627;261001;Zespół Placówek Oświatowych|Skarżysko-Kamienna|ul. Zwycięzców 13 |26-110 Skarżysko-Kamienna;1228;732;732;18;714;59.61;2.46
106628;261001;Samodzielny Publiczny Zakład Opieki Zdrowotnej "Przychodnie Miejskie" Przychodnia Rejonowa Nr 2|Skarżysko-Kamienna|ul. Legionów Nr 104 |26-110 Skarżysko-Kamienna;1176;559;559;6;553;47.53;1.07
106629;261001;Gimnazjum Nr 3|Skarżysko-Kamienna|ul. Akacjowa 1 |26-110 Skarżysko-Kamienna;1129;601;601;3;598;53.23;0.50
106630;261001;Szkoła Podstawowa Nr 9|Skarżysko-Kamienna|ul. Warszawska 54 |26-110 Skarżysko-Kamienna;898;413;413;8;405;45.99;1.94
106631;261001;Miejskie Centrum Sportu i Rekreacji|Skarżysko-Kamienna|ul. Sienkiewicza 34 |26-110 Skarżysko-Kamienna;960;548;548;7;541;57.08;1.28
106632;261001;Zespół Placówek Oświatowych Nr 4|Skarżysko-Kamienna|ul. Norwida 3 |26-110 Skarżysko-Kamienna;1828;861;861;13;848;47.10;1.51
106633;261001;Urząd Miasta|Skarżysko-Kamienna|ul. Sikorskiego 18 |26-110 Skarżysko-Kamienna;2072;985;985;21;964;47.54;2.13
106634;261001;Zespół Placówek Oświatowych nr 4|Skarżysko-Kamienna|ul. Sikorskiego 17 |26-110 Skarżysko-Kamienna;2195;1016;1016;27;989;46.29;2.66
106635;261001;Miejskie Centrum Kultury|Skarżysko-Kamienna|ul. Słowackiego 25 |26-110 Skarżysko-Kamienna;1457;769;769;28;741;52.78;3.64
106636;261001;Gimnazjum Nr 2|Skarżysko-Kamienna|ul. Słowackiego 29 |26-110 Skarżysko-Kamienna;1229;600;600;14;586;48.82;2.33
106637;261001;Zespół Szkół Technicznych|Skarżysko-Kamienna|al. Tysiąclecia 22 |26-110 Skarżysko-Kamienna;1959;953;953;18;935;48.65;1.89
106638;261001;II Liceum Ogólnokształcące|Skarżysko-Kamienna|al. Marszałka Józefa Piłsudskiego 50 |26-110 Skarżysko-Kamienna;1651;785;785;13;772;47.55;1.66
106639;261001;Zespół Szkół Ekonomicznych|Skarżysko-Kamienna|ul. Powstańców Warszawy 11 |26-110 Skarżysko-Kamienna;1801;999;999;13;986;55.47;1.30
106640;261001;Starostwo Powiatowe|Skarżysko-Kamienna|ul. Konarskiego 20 |26-110 Skarżysko-Kamienna;1450;712;712;14;698;49.10;1.97
106641;261001;Zespół Szkół Publicznych Nr 1|Skarżysko-Kamienna|ul. Sezamkowa 23 |26-110 Skarżysko-Kamienna;1865;968;968;21;947;51.90;2.17
106642;261001;Zespół Szkół Samochodowo-Usługowych|Skarżysko-Kamienna|ul. Oseta Wasilewskiego 5 |26-110 Skarżysko-Kamienna;2053;1061;1061;21;1040;51.68;1.98
106643;261001;Zespół Placówek Oświatowych Nr 5|Skarżysko-Kamienna|ul. Zielna 27 |26-110 Skarżysko-Kamienna;2085;1015;1015;22;993;48.68;2.17
106644;261001;Zespół Placówek Oświatowych Nr 5|Skarżysko-Kamienna|ul. Zielna 29 |26-110 Skarżysko-Kamienna;2151;969;969;16;953;45.05;1.65
106645;261001;Zespół Szkół Publicznych Nr 4|Skarżysko-Kamienna|ul. Książeca 149 |26-110 Skarżysko-Kamienna;1539;672;672;18;654;43.66;2.68
106646;261001;Zespół Opieki Zdrowotnej - Szpital Powiatowy|Skarżysko-Kamienna|ul. Szpitalna 1 |26-110 Skarżysko-Kamienna;117;48;48;1;47;41.03;2.08
106647;261001;Zespół Opieki Zdrowotnej - II budynek szpitalny|Skarżysko-Kamienna|ul. Ekonomii 4 |26-110 Skarżysko-Kamienna;55;22;22;0;22;40.00;0.00
106648;261001;Dom Pomocy Społecznej|Skarżysko-Kamienna|ul. Sporna 6 |26-110 Skarżysko-Kamienna;43;17;17;0;17;39.53;0.00
106649;261002;Gminny Ośrodek Kultury w Bliżynie|Bliżyn|ul. Staszica 16D |26-120 Bliżyn;1458;747;747;16;731;51.23;2.14
106650;261002;Szkoła Podstawowa w Bliżynie|Bliżyn|ul. Piaskowa 26 |26-120 Bliżyn;2144;879;879;25;854;41.00;2.84
106651;261002;Szkoła Podstawowa w Mroczkowie|Mroczków| 25 |26-120 Bliżyn;1708;696;696;30;666;40.75;4.31
106652;261002;Szkoła Podstawowa w Odrowążku|Odrowążek| 1 |26-120 Bliżyn;972;374;374;25;349;38.48;6.68
106653;261002;Szkoła Podstawowa w Sorbinie|Sorbin| 89 |26-120 Bliżyn;681;326;326;6;320;47.87;1.84
106654;261003;Szkoła Podstawowa w Goździe|Gózd| 125 |26-140 Łączna;841;422;422;12;410;50.18;2.84
106655;261003;Budynek po Szkole Podstawowej w Klonowie|Klonów| 62 |26-140 Łączna;231;98;98;1;97;42.42;1.02
106656;261003;Gminna Biblioteka Publiczna w Łącznej|Czerwona Górka| 1"b" |26-140 Łączna;1017;416;416;10;406;40.90;2.40
106657;261003;Budynek po Gimnazjum w Zaleziance|Zalezianka| 49a |26-140 Łączna;631;291;291;8;283;46.12;2.75
106658;261003;Budynek po Szkole Filialnej w Zagórzu|Zagórze| 40"B" |26-140 Łączna;528;191;191;11;180;36.17;5.76
106659;261003;Szkoła Podstawowa w Łącznej|Kamionki| 63 |26-140 Łączna;1003;436;436;8;428;43.47;1.83
106660;261004;Szkoła Podstawowa w Grzybowej Górze|Grzybowa Góra|ul. Świętokrzyska 102 |26-115 Skarżysko Kościelne;801;363;363;19;344;45.32;5.23
106661;261004;Szkoła Podstawowa w Lipowym Polu Skarbowym|Lipowe Pole Skarbowe|ul. Wesoła 2 |26-115 Skarżysko Kościelne;598;301;301;10;291;50.33;3.32
106662;261004;Urząd Gminy w Skarżysku Kościelnym|Skarżysko Kościelne|ul. Kościelna 2A |26-115 Skarżysko Kościelne;2155;1038;1038;46;992;48.17;4.43
106663;261004;Szkoła Podstawowa w Majkowie|Majków|ul. Stefana Żeromskiego 106 |26-110 Skarżysko-Kamienna;983;391;391;14;377;39.78;3.58
106664;261004;Publiczna Szkoła Podstawowa w Kierzu Niedźwiedzim|Kierz Niedźwiedzi|ul. Boczna 7 |26-115 Skarżysko Kościelne;588;274;274;24;250;46.60;8.76
106665;261005;Gimnazjum w Suchedniowie|Suchedniów|ul. Szarych Szeregów 6 |26-130 Suchedniów;693;340;340;9;331;49.06;2.65
106666;261005;Gimnazjum w Suchedniowie|Suchedniów|ul. Szarych Szeregów 6 |26-130 Suchedniów;1120;576;576;15;561;51.43;2.60
106667;261005;Samorządowa Szkoła Podstawowa nr 3 w Suchedniowie|Suchedniów|ul. Kościelna 3 |26-130 Suchedniów;675;355;355;6;349;52.59;1.69
106668;261005;Samorządowa Szkoła Podstawowa nr 3 w Suchedniowie|Suchedniów|ul. Kościelna 3 |26-130 Suchedniów;790;408;408;7;401;51.65;1.72
106669;261005;Urząd Miasta i Gminy w Suchedniowie|Suchedniów|ul. Fabryczna 5 |26-130 Suchedniów;646;317;317;7;310;49.07;2.21
106670;261005;Samorządowa Szkoła Podstawowa w Ostojowie|Ostojów| 16 |26-130 Suchedniów;568;234;234;7;227;41.20;2.99
106671;261005;Świetlica OSP w Suchedniowie|Suchedniów|ul. Kielecka 11 |26-130 Suchedniów;577;266;266;3;263;46.10;1.13
106672;261005;Samorządowe Przedszkole w Suchedniowie|Suchedniów|ul. Emilii Peck 15a |26-130 Suchedniów;1125;590;590;11;579;52.44;1.86
106673;261005;Urząd Stanu Cywilnego w Suchedniów|Suchedniów|ul. Sportowa 1 |26-130 Suchedniów;1008;444;444;14;430;44.05;3.15
106674;261005;Samorządowa Szkoła Podstawowa w Ostojowie|Ostojów| 16 |26-130 Suchedniów;800;360;360;7;353;45.00;1.94
106675;261005;Centrum Kształceniowo Integracyjne w Michniowie|Michniów| 20b |26-130 Suchedniów;353;173;173;9;164;49.01;5.20
106676;261005;Wiejski Dom Kultury w Mostkach|Mostki| 1 |26-130 Suchedniów;396;193;193;13;180;48.74;6.74
106677;261101;Szkoła Podstawowa nr 1 w Starachowicach|Starachowice|ul. 1 Maja 11 |27-200 Starachowice;2097;1041;1041;12;1029;49.64;1.15
106678;261101;Starachowickie Centrum Kultury w Starachowicach|Starachowice|ul. Radomska 21 |27-200 Starachowice;1545;627;628;15;612;40.58;2.39
106679;261101;Zespół Szkół Zawodowych nr 3 w Starachowicach|Starachowice|ul. Szkolna 10 |27-200 Starachowice;1833;846;846;20;826;46.15;2.36
106680;261101;Szkoła Podstawowa Nr 9 w Starachowicach|Starachowice|ul. Jana Mrozowskiego 5 |27-200 Starachowice;1381;686;686;15;671;49.67;2.19
106681;261101;Gimnazjum Nr 3 w Starachowicach|Starachowice|ul. Leśna 2 |27-200 Starachowice;2300;1219;1219;16;1203;53.00;1.31
106682;261101;Szkoła Podstawowa Nr 9 w Starachowicach|Starachowice|ul. Jana Mrozowskiego 5 |27-200 Starachowice;1880;734;734;23;711;39.04;3.13
106683;261101;Szkoła Podstawowa nr 11 w Starachowicach|Starachowice|ul. Leśna 2 |27-200 Starachowice;1684;876;876;15;861;52.02;1.71
106684;261101;Przedszkole Miejskie nr 14 w Starachowicach|Starachowice|ul. Graniczna 10 |27-200 Starachowice;1692;880;880;9;871;52.01;1.02
106685;261101;Przedszkole Miejskie nr 13 w Starachowicach|Starachowice|ul. Leśna 40 |27-200 Starachowice;1348;687;687;7;680;50.96;1.02
106686;261101;Przedszkole Miejskie Nr 15 w Starachowicach|Starachowice|ul. Na Szlakowisku 7b |27-200 Starachowice;2016;1039;1039;8;1031;51.54;0.77
106687;261101;Starachowicka Spółdzielnia Mieszkaniowa w Starachowicach|Starachowice|ul. Wojska Polskiego 9 |27-200 Starachowice;2006;1089;1089;19;1070;54.29;1.74
106688;261101;Szkoła Podstawowa Nr 12 w Starachowicach|Starachowice|ul. Słoneczna 1A |27-200 Starachowice;1826;937;937;17;920;51.31;1.81
106689;261101;Międzyszkolny Ośrodek Gimnastyki Korekcyjnej i Kompensacyjnej w Starachowicach|Starachowice|ul. Stefana Żeromskiego 1A |27-200 Starachowice;2327;1020;1020;17;1003;43.83;1.67
106690;261101;Przedszkole Miejskie Nr 11 w Starachowicach|Starachowice|ul. Górna 13 |27-200 Starachowice;1855;918;918;21;897;49.49;2.29
106691;261101;Szkoła Podstawowa Nr 10 w Starachowicach|Starachowice|Aleja Armii Krajowej 1 |27-200 Starachowice;1689;766;766;11;755;45.35;1.44
106692;261101;Gimnazjum Nr 2 w Starachowicach|Starachowice|ul. Iłżecka 39 |27-200 Starachowice;1680;701;701;20;681;41.73;2.85
106693;261101;Gimnazjum nr 1 w Starachowicach|Starachowice|ul. Kielecka 3 |27-200 Starachowice;1815;853;853;18;835;47.00;2.11
106694;261101;Szkoła Podstawowa nr 6 w Starachowicach|Starachowice|ul. Stanisława Moniuszki 117 |27-200 Starachowice;1857;863;863;26;837;46.47;3.01
106695;261101;Szkoła Podstawowa nr 13 w Starachowicach|Starachowice|ul. Ignacego Prądzyńskiego 2 |27-200 Starachowice;2204;1004;1004;19;985;45.55;1.89
106696;261101;Gimnazjum Nr 4 w Starachowicach|Starachowice|ul. Jana Pawła II 18 |27-200 Starachowice;1584;795;795;7;788;50.19;0.88
106697;261101;Gimnazjum Nr 4 w Starachowicach|Starachowice|ul. Jana Pawła II 18 |27-200 Starachowice;1941;953;953;8;945;49.10;0.84
106698;261101;Centrum Kształcenia Praktycznego w Starachowicach|Starachowice|ul. Władysława Rogowskiego 14 |27-200 Starachowice;1747;879;879;18;861;50.31;2.05
106699;261101;Szkoła Podstawowa nr 2 w Starachowicach|Starachowice|ul. Ostrowiecka 134 |27-200 Starachowice;1291;530;530;9;521;41.05;1.70
106700;261101;Powiatowy Zakład Opieki Zdrowotnej|Starachowice|ul. Radomska 70 |27-200 Starachowice;269;61;61;2;59;22.68;3.28
106701;261101;Polsko - Amerykańskie Kliniki Serca Centrum Kardiologiczno - Angiologiczne|Starachowice|ul. Radomska 70 d |27-200 Starachowice;36;13;13;0;13;36.11;0.00
106702;261101;Dom Pomocy Społecznej|Starachowice|ul. Gen. Józefa Bema 26 |27-200 Starachowice;110;49;49;13;36;44.55;26.53
106703;261102;Szkoła Podstawowa w Adamowie|Adamów|ul. Kościelna 2 |27-230 Brody;759;355;355;9;346;46.77;2.54
106704;261102;Urząd Gminy w Brodach|Brody|ul. Stanisława Staszica 3 |27-230 Brody;696;352;352;6;346;50.57;1.70
106705;261102;Szkoła Podstawowa w Brodach|Brody|ul. Szkolna 77 |27-230 Brody;738;277;277;18;259;37.53;6.50
106706;261102;Szkoła Podstawowa w Dziurowie|Dziurów|ul. Słoneczna 1 |27-230 Brody;705;337;337;9;328;47.80;2.67
106707;261102;Klub Rolnika w Kuczowie|Kuczów|ul. Wysoka 118 |27-230 Brody;785;334;334;24;310;42.55;7.19
106708;261102;Szkoła Podstawowa w Lipiu|Lipie|ul. Starachowicka 84 |27-230 Brody;401;157;157;12;145;39.15;7.64
106709;261102;Szkoła Podstawowa w Lubieni|Lubienia|ul. Iłżecka 20 |27-230 Brody;883;334;334;8;326;37.83;2.40
106710;261102;Szkoła Podstawowa w Lubieni|Lubienia|ul. Iłżecka 20 |27-230 Brody;865;384;384;9;375;44.39;2.34
106711;261102;Szkoła Podstawowa w Rudzie|Ruda|ul. Widok 1 |27-230 Brody;504;274;274;12;262;54.37;4.38
106712;261102;Szkoła Podstawowa w Stawie Kunowskim|Staw Kunowski|ul. Szkolna 6 |27-230 Brody;687;209;209;14;195;30.42;6.70
106713;261102;Szkoła Podstawowa w Stykowie|Styków|ul. Świętokrzyska 22 |27-230 Brody;897;332;332;18;314;37.01;5.42
106714;261102;Remiza Strażacka w Krynkach|Krynki|ul. Długa 1 |27-230 Brody;990;418;418;20;398;42.22;4.78
106715;261103;Zespół Szkół - Szkoła Podstawowa w Mircu|Mirzec Stary| 10 |27-220 Mirzec;1017;464;465;21;443;45.62;4.53
106716;261103;Szkoła Podstawowa w Trębowcu|Trębowiec Duży| 54 |27-220 Mirzec;455;210;210;13;197;46.15;6.19
106717;261103;Szkoła Podstawowa w Osinach|Osiny| 101 |27-220 Mirzec;709;354;354;12;342;49.93;3.39
106718;261103;Szkoła Podstawowa w Gadce|Gadka| 100 |27-220 Mirzec;996;486;486;16;470;48.80;3.29
106719;261103;Szkoła Podstawowa w Tychowie Starym|Tychów Stary| 69 |27-220 Mirzec;1029;535;535;24;511;51.99;4.49
106720;261103;Szkoła Podstawowa w Małyszynie|Małyszyn Górny| 71 |27-220 Mirzec;800;333;333;6;327;41.62;1.80
106721;261103;Szkoła Podstawowa w Tychowie Nowym|Tychów Nowy| 87 |27-220 Mirzec;657;288;288;6;282;43.84;2.08
106722;261103;Szkoła Podstawowa w Jagodnem|Jagodne| 138 |27-220 Mirzec;471;242;242;15;227;51.38;6.20
106723;261103;Zespół Szkół - Gimnazjum Publiczne w Mircu|Mirzec Stary| 10 |27-220 Mirzec;711;363;363;14;349;51.05;3.86
106724;261104;Szkoła Podstawowa w Grabkowie|Grabków| 24 |27-225 Pawłów;501;190;190;11;179;37.92;5.79
106725;261104;Szkoła Podstawowa w Łomnie|Łomno| 20 |27-225 Pawłów;557;188;188;16;172;33.75;8.51
106726;261104;Szkoła Podstawowa w Chybicach|Chybice| 50 |27-225 Pawłów;1533;691;691;23;668;45.08;3.33
106727;261104;Ośrodek Zdrowia w Kałkowie|Kałków| 37A |27-225 Pawłów;846;347;347;20;327;41.02;5.76
106728;261104;Gminny Ośrodek Kultury, Sportu i Rekreacji w Pawłowie|Pawłów| 45 |27-225 Pawłów;1568;751;751;49;702;47.90;6.52
106729;261104;Szkoła Podstawowa w Jadownikach|Jadowniki| 49 |27-225 Pawłów;759;335;335;10;325;44.14;2.99
106730;261104;Szkoła Podstawowa w Pokrzywnicy|Pokrzywnica| 38 |27-225 Pawłów;439;149;149;6;143;33.94;4.03
106731;261104;Szkoła Podstawowa w Radkowicach|Radkowice| 5 |27-225 Pawłów;1267;471;471;19;452;37.17;4.03
106732;261104;Szkoła Podstawowa w Rzepinie|Rzepin Drugi| 154 |27-225 Pawłów;1605;633;633;24;609;39.44;3.79
106733;261104;Szkoła Podstawowa w Szerzawach|Szerzawy| 104 |27-225 Pawłów;1382;469;469;22;447;33.94;4.69
106734;261104;Szkoła Podstawowa w Bostowie|Stary Bostów| 8A |27-225 Pawłów;536;242;242;7;235;45.15;2.89
106735;261104;Biblioteka Publiczna w Tarczku|Tarczek| 98 |27-225 Pawłów;457;197;197;1;196;43.11;0.51
106736;261104;Szkoła Podstawowa w Dąbrowie|Dąbrowa| 58 |27-225 Pawłów;613;257;257;4;253;41.92;1.56
106737;261104;Dom Pomocy Społecznej im. Sue Ryder w Kałkowie-Godowie|Godów| 88 |27-225 Pawłów;85;37;37;5;32;43.53;13.51
106738;261105;Miejsko-Gminny Ośrodek Kultury w Wąchocku|Wąchock|ul. Kościelna 7 |27-215 Wąchock;1160;532;532;17;515;45.86;3.20
106739;261105;Gimnazjum Publiczne w Wąchocku|Wąchock|ul. Kościelna 10 |27-215 Wąchock;1192;584;584;44;540;48.99;7.53
106740;261105;Szkoła Podstawowa w Wielkiej Wsi|Wielka Wieś| 354 |27-215 Wąchock;1305;616;616;31;585;47.20;5.03
106741;261105;Szkoła Podstawowa w Parszowie|Parszów|ul. Szkolna 28 |27-215 Wąchock;1259;597;597;14;583;47.42;2.35
106742;261105;Wiejski Dom Kultury w Marcinkowie|Marcinków| 39a |27-215 Wąchock;519;213;213;14;199;41.04;6.57
106743;261105;Wiejski Dom Kultury w Ratajach|Rataje| 109 |27-215 Wąchock;382;169;169;6;163;44.24;3.55
106744;261201;Szkoła Podstawowa w Bogorii|Bogoria|ul. Staszowska 10 |28-210 Bogoria;1979;828;828;25;803;41.84;3.02
106745;261201;Szkoła Podstawowa w Jurkowicach|Jurkowice| 78 |28-210 Bogoria;1140;522;522;30;492;45.79;5.75
106746;261201;Dom Pomocy Społecznej w Pęcławicach Górnych|Pęcławice Górne| 23 |28-210 Bogoria;466;219;219;8;211;47.00;3.65
106747;261201;Szkoła Podstawowa w Niedźwiedziu|Niedźwiedź| 24 |28-210 Bogoria;418;121;121;4;117;28.95;3.31
106748;261201;Wiejski Dom Kultury w Przyborowicach|Przyborowice| 31 |28-210 Bogoria;1414;525;525;22;503;37.13;4.19
106749;261201;Szkoła Podstawowa w Szczeglicach|Szczeglice| 48 |28-210 Bogoria;961;378;378;13;365;39.33;3.44
106750;261202;Centrum Kultury|Łubnice| 74 |28-232 Łubnice;1289;547;547;21;526;42.44;3.84
106751;261202;Publiczna Szkoła Podstawowa|Budziska| 149 |28-232 Łubnice;706;339;339;16;323;48.02;4.72
106752;261202;Publiczna Szkoła Podstawowa|Gace Słupieckie| 85 |28-232 Łubnice;970;391;391;18;373;40.31;4.60
106753;261202;Publiczna Szkoła Podstawowa|Wilkowa| 47 |28-232 Łubnice;560;249;249;13;236;44.46;5.22
106754;261203;OSP Borzymów|Borzymów| 89 |28-220 Oleśnica;473;184;184;5;179;38.90;2.72
106755;261203;Przedszkole Gminne w Oleśnicy|Oleśnica|ul. Nadstawie 29 |28-220 Oleśnica;1088;496;496;14;482;45.59;2.82
106756;261203;Publiczne Gimnazjum w Oleśnicy|Oleśnica|ul. Szkolna 9 |28-220 Oleśnica;1088;409;409;24;385;37.59;5.87
106757;261203;Szkoła Podstawowa w Pieczonogach|Pieczonogi| 32a |28-220 Oleśnica;592;191;191;3;188;32.26;1.57
106758;261204;Hala sportowa, Osiek|Osiek|ul. Wolności 24A |28-221 Osiek;1639;789;789;21;768;48.14;2.66
106759;261204;Ochotnicza Straż Pożarna w Bukowej|Bukowa| 52 |28-221 Osiek;262;95;95;4;91;36.26;4.21
106760;261204;Publiczna Szkoła Podstawowa im. Heleny i Józefa Świątyńskich w Ossali|Ossala| 26 A |28-221 Osiek;863;378;378;24;354;43.80;6.35
106761;261204;Publiczna Szkoła Podstawowa w Pliskowoli|Pliskowola| 135B |28-221 Osiek;801;327;327;18;309;40.82;5.50
106762;261204;Publiczna Szkoła Podstawowa im. Marii Konopnickiej w Suchowoli|Suchowola| 31 |28-221 Osiek;845;339;339;12;327;40.12;3.54
106763;261204;Klub Wiejski|Matiaszów| 41A |28-221 Osiek;381;124;124;8;116;32.55;6.45
106764;261204;Ochotnicza Straż Pożarna w Tursku Wielkim|Tursko Wielkie| 54 |28-221 Osiek;523;279;279;9;270;53.35;3.23
106765;261204;Publiczna Szkoła Podstawowa im. Świętego Jana Pawła II w Szwagrowie|Szwagrów| 126A |28-221 Osiek;598;281;281;11;270;46.99;3.91
106766;261204;Ochotnicza Straż Pożarna w Długołęce|Długołęka| 61B |28-221 Osiek;422;213;213;4;209;50.47;1.88
106767;261205;Przedszkole Publiczne|Połaniec|ul. Madalińskiego 1 |28-230 Połaniec;2172;1200;1200;32;1168;55.25;2.67
106768;261205;Gimnazjum Publiczne nr 1|Połaniec|ul. Żapniowska 1 |28-230 Połaniec;1199;625;625;23;602;52.13;3.68
106769;261205;Urząd Stanu Cywilnego|Połaniec|ul. Ruszczańska 27 |28-230 Połaniec;1425;717;717;18;699;50.32;2.51
106770;261205;Punkt Informacji Turystycznej|Połaniec|Plac Uniwersału Połanieckiego 1 |28-230 Połaniec;2050;1123;1123;33;1090;54.78;2.94
106771;261205;Remiza OSP w Tursku Małym|Tursko Małe| 49A |28-230 Połaniec;590;274;274;10;264;46.44;3.65
106772;261205;Remiza OSP w Rudnikach|Rudniki| 45A |28-230 Połaniec;594;246;246;12;234;41.41;4.88
106773;261205;Remiza OSP w Zrębinie|Zrębin| 37 |28-230 Połaniec;655;243;243;9;234;37.10;3.70
106774;261205;Remiza OSP w Ruszczy|Ruszcza|ul.Knothego 6 |28-230 Połaniec;1038;481;481;12;469;46.34;2.49
106775;261206;Zespół Szkół Ogólnokształcących im. Jana Pawła II w Rytwianach|Rytwiany|ul. Szkolna 9/ 1|28-236 Rytwiany;1519;659;659;23;636;43.38;3.49
106776;261206;Remiza Ochotniczej Straży Pożarnej w Niedziałkach|Niedziałki| 66 |28-230 Połaniec;749;298;298;4;294;39.79;1.34
106777;261206;Zespół Placówek Oświatowych im. Marii Firlejczyk w Sichowie Dużym|Sichów Duży| 88 |28-236 Rytwiany;1423;505;505;12;493;35.49;2.38
106778;261206;Remiza Ochotniczej Straży Pożarnej w Strzegomiu|Strzegom|ul. Strażacka 6 |28-221 Osiek;664;267;267;12;255;40.21;4.49
106779;261206;Remiza Ochotniczej Straży Pożarnej w Kłodzie|Kłoda|ul. Długa 7 |28-236 Rytwiany;474;209;209;6;203;44.09;2.87
106780;261206;Remiza Ochotniczej Straży Pożarnej w Tuklęczy|Tuklęcz| 19 |28-236 Rytwiany;338;132;132;4;128;39.05;3.03
106781;261207;Liceum Ogólnokształcące im. ks. kard. Stefana Wyszyńskiego w Staszowie|Staszów|ul. 11 Listopada 3 |28-200 Staszów;840;442;442;8;434;52.62;1.81
106782;261207;Liceum Ogólnokształcące im. ks. kard. Stefana Wyszyńskiego w Staszowie|Staszów|ul. 11 Listopada 3 |28-200 Staszów;808;441;441;10;431;54.58;2.27
106783;261207;Placówka Wsparcia Dziennego w Staszowie-Świetlica "Jutrzenka", filia w Staszowie|Staszów|ul. Jana Pawła II 10 |28-200 Staszów;836;425;425;18;407;50.84;4.24
106784;261207;Przedszkole nr 3 im. Jana Pawła II w Staszowie z Oddziałem w Dobrej|Staszów|ul. Jana Pawła II 17a |28-200 Staszów;1032;489;489;14;475;47.38;2.86
106785;261207;Zespół Szkół-Publiczna Szkoła Podstawowa nr 2 im. Ignacego Jana Paderewskiego i Publiczne Gimnazjum nr 2 w Staszowie|Staszów|ul. Niepodległości 4 |28-200 Staszów;1026;566;566;14;552;55.17;2.47
106786;261207;Zespół Szkół Ekonomicznych im. Jana Pawła II w Staszowie|Staszów|ul. Szkolna 11 |28-200 Staszów;1049;468;468;9;459;44.61;1.92
106787;261207;Zespół Szkół Ekonomicznych im. Jana Pawła II w Staszowie|Staszów|ul. Szkolna 11 |28-200 Staszów;1096;438;438;14;424;39.96;3.20
106788;261207;Zespół Szkół im. Stanisława Staszica w Staszowie|Staszów|ul. Koszarowa 7 |28-200 Staszów;887;436;436;14;422;49.15;3.21
106789;261207;Zespół Placówek Oświatowych - Publiczne Gimnazjum Nr 1 im. T. Kościuszki, Publiczna Szkoła Podstawowa Nr 1 im. Tadeusza Kościuszki i Przedszkole nr 4 im. T. Kościuszki w Staszowie|Staszów|ul. Wysoka 39 |28-200 Staszów;762;354;354;8;346;46.46;2.26
106790;261207;Przedszkole Nr 8 im. Jana Christiana Andersena z Oddziałami Integracyjnymi w Staszowie|Staszów|ul. Jana Kilińskiego 20 |28-200 Staszów;1048;539;539;9;530;51.43;1.67
106791;261207;Przedszkole Nr 8 im. Jana Christiana Andersena z Oddziałami Integracyjnymi w Staszowie|Staszów|ul. Jana Kilińskiego 20 |28-200 Staszów;1028;459;459;7;452;44.65;1.53
106792;261207;Publiczna Szkoła Podstawowa Nr 3 im. Hieronima Łaskiego w Staszowie|Staszów|ul. Mickiewicza 40 |28-200 Staszów;1052;522;522;6;516;49.62;1.15
106793;261207;Publiczna Szkoła Podstawowa Nr 3 im. Hieronima Łaskiego w Staszowie|Staszów|ul. Mickiewicza 40 |28-200 Staszów;1039;467;467;7;460;44.95;1.50
106794;261207;Zespół Placówek Oświatowych Publiczna Szkoła Podstawowa i Przedszkole w Wiązownicy Dużej|Wiązownica Duża| 135 |28-200 Staszów;1117;334;334;22;312;29.90;6.59
106795;261207;Publiczna Szkoła Podstawowa im. Oddziału Partyzanckiego AK "Jędrusie" i Przedszkole w Smerdynie|Smerdyna| 100 |28-200 Staszów;1312;401;401;29;372;30.56;7.23
106796;261207;Publiczna Szkoła Podstawowa i Przedszkole w Wiśniowej|Wiśniowa| 111 |28-200 Staszów;1250;466;466;17;449;37.28;3.65
106797;261207;Zespół Placówek Oświatowych - Publiczna Szkoła Podstawowa i Przedszkole w Mostkach|Mostki| 56 |28-200 Staszów;1080;391;391;15;376;36.20;3.84
106798;261207;Zespół Placówek Oświatowych - Publiczna Szkoła Podstawowa i Przedszkole w Kurozwękach|Kurozwęki|ul. Szydłowska 9 |28-200 Staszów;913;422;422;16;406;46.22;3.79
106799;261207;Placówka Wsparcia Dziennego w Staszowie-Świetlica "Jutrzenka", filia w Sielcu|Sielec| 37 |28-200 Staszów;1090;427;427;26;401;39.17;6.09
106800;261207;Zespół Placówek Oświatowych - Publiczna Szkoła Podstawowa i Przedszkole w Koniemłotach|Koniemłoty|ul. Staszowska 7 |28-200 Staszów;1085;449;449;22;427;41.38;4.90
106801;261207;Placówka Wsparcia Dziennego w Staszowie-Świetlica "Jutrzenka", filia w Woli Osowej|Wola Osowa| 22 |28-200 Staszów;634;226;226;10;216;35.65;4.42
106802;261207;Przedszkole nr 3 im. Jana Pawła II w Staszowie z Oddziałem w Dobrej|Dobra| 52 |28-200 Staszów;415;147;147;6;141;35.42;4.08
106803;261207;Samodzielny Publiczny Zespół Zakładów Opieki Zdrowotnej w Staszowie|Staszów|ul. 11 Listopada 78 |28-200 Staszów;96;36;36;3;33;37.50;8.33
106804;261207;Dom Pomocy Społecznej Zgromadzenia SS.Miłosierdzia św. Wincentego a'Paulo w Kurozwękach|Kurozwęki|ul. Kościelna 4 |28-200 Staszów;101;50;50;0;50;49.50;0.00
106805;261207;Staszowskie Centrum Medyczne Sp. z o. o. w Koniemłotach|Koniemłoty|pl. Ks. Romana Kotlarza 9 |28-200 Staszów;24;20;20;0;20;83.33;0.00
106806;261208;Remiza OSP w Kotuszowie|Kotuszów| 83a |28-225 Szydłów;584;289;289;11;278;49.49;3.81
106807;261208;Świetlica Wiejska w Potoku|Potok| 99 |28-225 Szydłów;609;223;223;14;209;36.62;6.28
106808;261208;Szkoła Podstawowa w Szydłowie|Szydłów|ul.Szkolna 10 |28-225 Szydłów;766;261;261;10;251;34.07;3.83
106809;261208;Urząd Gminy w Szydłowie|Szydłów|ul.Rynek 2 |28-225 Szydłow;896;497;497;11;486;55.47;2.21
106810;261208;Remiza OSP w Gackach|Gacki| 29 |28-225 Szydłów;490;196;196;5;191;40.00;2.55
106811;261208;Szkoła Podstawowa w Solcu|Solec| 22 |28-225 Szydłów;605;263;263;17;246;43.47;6.46
106812;261208;Dom Pomocy Społecznej w Rudkach|Rudki| 89 |28-225 Szydłów;18;9;9;0;9;50.00;0.00
106813;261301;Zespół Przedszkolno-Szkolny w Kluczewsku|Kluczewsko|ul. Leśna 1 |29-120 Kluczewsko;1789;872;872;26;846;48.74;2.98
106814;261301;Zespół Przedszkolno-Szkolny w Komornikach|Komorniki| 7 |29-120 Kluczewsko;665;297;297;8;289;44.66;2.69
106815;261301;Świetlica Wiejska w Stanowiskach|Stanowiska| 22 |29-120 Kluczewsko;931;412;412;24;388;44.25;5.83
106816;261301;Zespół Przedszkolno-Szkolny w Dobromierzu|Dobromierz|ul. Włoszczowska 5 |29-120 Kluczewsko;889;374;374;20;354;42.07;5.35
106817;261302;Zespół Placówek Oświatowych w Olesznie|Oleszno|ul. Szkolna 34 |29-105 Krasocin;1898;866;866;43;823;45.63;4.97
106818;261302;Szkoła Filialna w Brygidowie|Brygidów| 1 |29-105 Krasocin;696;313;313;16;297;44.97;5.11
106819;261302;Szkoła Podstawowa w Mieczynie|Mieczyn| 8 |29-105 Krasocin;781;311;311;15;296;39.82;4.82
106820;261302;Zespół Placówek Oświatowych w Bukowie|Bukowa|ul. Szkolna 8 |29-105 Krasocin;2047;1012;1012;34;978;49.44;3.36
106821;261302;Szkoła Podstawowa w Cieślach|Cieśle| 63 |29-105 Krasocin;691;305;305;17;288;44.14;5.57
106822;261302;Szkoła Podstawowa w Czostkowie|Czostków| 83 |29-105 Krasocin;829;341;341;12;329;41.13;3.52
106823;261302;Urząd Gminy w Krasocinie|Krasocin|ul. Macierzy Szkolnej 1 |29-105 Krasocin;1666;753;753;38;715;45.20;5.05
106824;261303;Dom Kultury Chlewice|Chlewice|ul. 16 stycznia 32 |29-130 Moskorzew;972;389;389;18;371;40.02;4.63
106825;261303;Wiejskie Centrum Kulturalno-Turystyczne|Moskorzew| 97 |29-130 Moskorzew;950;430;430;23;407;45.26;5.35
106826;261303;Remiza OSP Mękarzów|Mękarzów| 35 |29-130 Moskorzew;230;98;98;2;96;42.61;2.04
106827;261303;Remiza OSP Tarnawa-Góra|Tarnawa-Góra| 26 |29-130 Moskorzew;232;115;115;8;107;49.57;6.96
106828;261304;Ośrodek Zdrowia w Bieganowie|Bieganów| 43 |29-135 Radków;579;181;181;7;174;31.26;3.87
106829;261304;Warsztaty Terapii Zajęciowej w Kossowie|Kossów| 68 |29-135 Radków;683;214;214;17;197;31.33;7.94
106830;261304;Szkoła Podstawowa w Radkowie|Radków| 88 |29-135 Radków;848;347;347;7;340;40.92;2.02
106831;261305;Zespół Szkół w Seceminie|Secemin|ul. Koniecpolska 1 |29-145 Secemin;1063;449;449;14;435;42.24;3.12
106832;261305;Gminna Biblioteka Publiczna w Seceminie|Secemin|ul. Ogrodowa 1 |29-145 Secemin;584;180;180;10;170;30.82;5.56
106833;261305;Szkoła Podstawowa w Psarach-Kolonii|Psary-Kolonia| 57 |29-145 Secemin;532;173;173;6;167;32.52;3.47
106834;261305;Szkoła Podstawowa w Kuczkowie|Kuczków| 38 |29-145 Secemin;389;162;162;11;151;41.65;6.79
106835;261305;Remiza OSP w Woli Czaryskiej|Wola Czaryska| 20 |29-145 Secemin;337;125;125;2;123;37.09;1.60
106836;261305;Zespół Szkolno-Przedszkolny w Żelisławicach|Żelisławice| 13 |29-145 Secemin;683;314;314;22;292;45.97;7.01
106837;261305;Remiza OSP w Wałkonowach Dolnych|Wałkonowy Dolne| 36 |29-145 Secemin;498;135;135;4;131;27.11;2.96
106838;261305;Dom Pomocy Społecznej w Woli Czaryskiej|Wola Czaryska| 92 |29-145 Secemin;37;28;28;3;25;75.68;10.71
106839;261306;PKP Sekcja Eksploatacji Włoszczowa "Północ"|Włoszczowa|ul. Śląska 4 |29-100 Włoszczowa;923;549;549;9;540;59.48;1.64
106840;261306;Urząd Gminy Włoszczowa|Włoszczowa|ul. Partyzantów 14 |29-100 Włoszczowa;1726;962;962;18;944;55.74;1.87
106841;261306;Hala Sportowa - OSiR Włoszczowa|Włoszczowa|ul. Wiśniowa 2 |29-100 Włoszczowa;2217;1217;1217;29;1188;54.89;2.38
106842;261306;Internat Zespołu Szkół Ponadgimnazjalnych Nr 3 im. Stanisława Staszica we Włoszczowie|Włoszczowa|ul. Wiśniowa 23 |29-100 Włoszczowa;1526;788;788;21;767;51.64;2.66
106843;261306;Zespół Placówek Oświatowych Nr 2 we Włoszczowie|Włoszczowa|ul. Różana 16 |29-100 Włoszczowa;2035;1094;1094;42;1052;53.76;3.84
106844;261306;Zespół Placówek Oświatowych w Koniecznie|Konieczno| 80 |29-100 Włoszczowa;1736;734;734;38;696;42.28;5.18
106845;261306;Szkoła Podstawowa im. Wincentego Przybyszewskiego w Bebelnie|Bebelno Wieś| 85 |29-100 Włoszczowa;984;410;410;16;394;41.67;3.90
106846;261306;Budynek byłej szkoły w Rząbcu|Rząbiec| 22 |29-100 Włoszczowa;608;247;247;4;243;40.62;1.62
106847;261306;Niepubliczne Przedszkole "Kubuś Puchatek" w Woli Wiśniowej|Wola Wiśniowa| 95 |29-100 Włoszczowa;823;376;376;14;362;45.69;3.72
106848;261306;Szkoła Podstawowa w Czarncy im. Stefana Czarnieckiego|Czarnca|ul. Szkolna 16A |29-100 Włoszczowa;806;384;384;17;367;47.64;4.43
106849;261306;Zespół Placówek Oświatowych Nr 1 we Włoszczowie filia w Łachowie|Łachów| 71a |29-100 Włoszczowa;689;295;295;14;281;42.82;4.75
106850;261306;Strażnica OSP w Międzylesiu|Międzylesie| 12 |29-100 Włoszczowa;672;290;290;11;279;43.15;3.79
106851;261306;Dom Kultury w Kurzelowie|Kurzelów|ul. Kielecka 11 |29-100 Włoszczowa;1451;621;621;22;599;42.80;3.54
106852;261306;Zespół Opieki Zdrowotnej Szpital im. Jana Pawła II we Włoszczowie|Włoszczowa|ul. Żeromskiego 28 |29-100 Włoszczowa;128;57;57;4;53;44.53;7.02
106853;261306;Dom Pomocy Społecznej Włoszczowa|Włoszczowa|ul. Koniecpolska 20 |29-100 Włoszczowa;84;49;49;5;44;58.33;10.20
106854;266101;Gimnazjum nr 3|Kielce|ul. Stanisława Toporowskiego 40 |25-546 Kielce;2206;1204;1204;11;1193;54.58;0.91
106855;266101;Przedszkole Samorządowe nr 6|Kielce|ul. Bukowa 8 |25-542 Kielce;2256;1154;1154;31;1123;51.15;2.69
106856;266101;Przedszkole Samorządowe nr 1|Kielce|ul. Cypriana Kamila Norwida 5 |25-410 Kielce;1866;1153;1153;14;1139;61.79;1.21
106857;266101;Przedszkole Samorządowe nr 32|Kielce|ul. Jana Kasprowicza 5 |25-411 Kielce;1097;684;684;3;681;62.35;0.44
106858;266101;Szkoła Podstawowa nr 1|Kielce|ul. Leopolda Staffa 7 |25-410 Kielce;1714;1077;1077;11;1066;62.84;1.02
106859;266101;Gimnazjum nr 7|Kielce|ul. Marii Krzyżanowskiej 8 |25-435 Kielce;1205;753;753;6;747;62.49;0.80
106860;266101;Zespół Szkół Ogólnokształcących nr 4 Integracyjnych|Kielce|ul. Jasna 20/22 |25-523 ;996;562;562;8;554;56.43;1.42
106861;266101;Integracyjne Przedszkole Samorządowe nr 27|Kielce|ul. Stanisława Toporowskiego 11A |25-533 Kielce;2203;1317;1317;13;1304;59.78;0.99
106862;266101;Szkoła Podstawowa nr 19|Kielce|ul. Targowa 3 |25-520 Kielce;2080;1253;1253;11;1242;60.24;0.88
106863;266101;Przedszkole Samorządowe nr 16|Kielce|ul. Nowy Świat 34 |25-522 Kielce;2272;1306;1306;16;1290;57.48;1.23
106864;266101;Zespół Szkół Elektrycznych|Kielce|ul.Prezydenta Ryszarda Kaczorowskiego 8 |25-317 Kielce;1719;1047;1047;6;1041;60.91;0.57
106865;266101;Zespół Szkół Ogólnokształcących nr 5|Kielce|ul.Wspólna 17 |25-003 Kielce;1940;1118;1118;15;1103;57.63;1.34
106866;266101;Środowiskowy Dom Samopomocy dla Osób Niepełnosprawnych Intelektualnie|Kielce|ul. Stefana Okrzei 8 |25-525 Kielce;1748;881;881;9;872;50.40;1.02
106867;266101;Szkoła Podstawowa nr 2|Kielce|ul. Generała Tadeusza Kościuszki 5 |25-310 Kielce;1661;830;830;7;823;49.97;0.84
106868;266101;Zespół Szkół Przemysłu Spożywczego|Kielce|ul. Zagórska 14 |25-355 Kielce;1812;1018;1018;6;1012;56.18;0.59
106869;266101;Dom Kultury "Zameczek"|Kielce|ul. Juliusza Słowackiego 23 |25-365 Kielce;1834;1088;1088;16;1072;59.32;1.47
106870;266101;Zespół Szkół Ogólnokształcących nr 27|Kielce|ul. Prosta 27A |25-371 Kielce;1777;1087;1087;6;1081;61.17;0.55
106871;266101;Ochotnicza Straż Pożarna|Kielce|ul. Podporucznika Zbigniewa Kruszelnickiego "Wilka" 49 |25-669 Kielce;1897;1004;1004;11;993;52.93;1.10
106872;266101;Targi Kielce S.A.|Kielce|ul. Zakładowa 1 |25-672 Kielce;1904;903;903;13;890;47.43;1.44
106873;266101;Przedszkole Samorządowe nr 2|Kielce|ul. Górnicza 64 |25-651 Kielce;2096;1209;1209;13;1196;57.68;1.08
106874;266101;Urząd Miasta|Kielce|ul. Strycharska 6 |25-361 Kielce;2190;1325;1325;18;1307;60.50;1.36
106875;266101;Przedszkole Samorządowe nr 18|Kielce|ul. Malików 3 |25-639 Kielce;1677;816;816;30;786;48.66;3.68
106876;266101;Szkoła Podstawowa nr 25|Kielce|Jurajska 7 |25-640 ;1035;729;729;2;727;70.43;0.27
106877;266101;Szkoła Podstawowa nr 25|Kielce|Jurajska 7 |25-640 ;1147;797;797;4;793;69.49;0.50
106878;266101;Szkoła Podstawowa nr 25|Kielce|Jurajska 7 |25-640 Kielce;1127;742;742;6;736;65.84;0.81
106879;266101;Szkoła Podstawowa nr 25|Kielce|Jurajska 7 |25-640 Kielce;1116;724;724;2;722;64.87;0.28
106880;266101;Klub „Domatorek”|Kielce|Edmunda Massalskiego 4 |25-636 Kielce;2076;1314;1314;8;1306;63.29;0.61
106881;266101;Szkoła Podstawowa Nr 34|Kielce|Biskupa Adama Naruszewicza 25 |25-628 Kielce;2303;1393;1393;15;1378;60.49;1.08
106882;266101;Przedszkole Samorządowe Nr 34|Kielce|Aleja Jerzego Szajnowicza-Iwanowa 15 |25-636 Kielce;2322;1427;1427;14;1413;61.46;0.98
106883;266101;Gimnazjum nr 9|Kielce|Biskupa Adama Naruszewicza 16 |25-628 Kielce;2198;1385;1385;5;1380;63.01;0.36
106884;266101;III LO z Oddziałami Integracyjnymi im. Cypriana Kamila Norwida|Kielce|ul. Jagiellońska 4 |25-613 Kielce;2149;1112;1112;20;1092;51.74;1.80
106885;266101;Przedszkole Samorządowe nr 29|Kielce|ul. Tytusa Chałubińskiego 32 |25-619 Kielce;2122;1029;1029;21;1008;48.49;2.04
106886;266101;Szkoła Podstawowa nr 18|Kielce|ul. Króla Bolesława Chrobrego 105 |25-623 Kielce;2237;1166;1166;8;1158;52.12;0.69
106887;266101;Przedszkole Samorzadowe nr 26|Kielce|ul. Piekoszowska 42 |25-735 Kielce;2251;1138;1138;19;1119;50.56;1.67
106888;266101;ENERIS Surowce S.A.|Kielce|ul. Zagnańska 232A |25-563 Kielce;1106;622;622;5;617;56.24;0.80
106889;266101;Przedszkole Samorządowe nr 35|Kielce|ul. Władysława Orkana 13 |25-548 Kielce;2379;1566;1566;11;1555;65.83;0.70
106890;266101;Szkoła Podstawowa nr 4|Kielce|ul. Warszawska 340 |25-414 Kielce;2105;1389;1389;11;1378;65.99;0.79
106891;266101;Szkoła Podstawowa nr 27|Kielce|ul. Stanisława Toporowskiego 96 |25-549 Kielce;2122;1328;1328;17;1311;62.58;1.28
106892;266101;Szkoła Podstawowa nr 27|Kielce|ul. Stanisława Toporowskiego 96 |25-549 Kielce;2161;1260;1260;6;1254;58.31;0.48
106893;266101;V LO im. Ks. Piotra Ściegiennego|Kielce|ul. Stanisława Toporowskiego 96 |25-549 Kielce;2069;1243;1243;10;1233;60.08;0.80
106894;266101;Gimnazjum nr 7|Kielce|ul. Marii Krzyżanowskiej 8 |25-435 Kielce;1328;831;831;4;827;62.58;0.48
106895;266101;Przedszkole Samorządowe nr 42|Kielce|ul. Elizy Orzeszkowej 26 |25-435 Kielce;1734;1054;1054;13;1041;60.78;1.23
106896;266101;Przedszkole Samorządowe nr 40|Kielce|ul. Marszałka Józefa Piłsudskiego 30 |25-431 Kielce;2311;1397;1397;11;1386;60.45;0.79
106897;266101;Szkoła Podstawowa nr 33|Kielce|ul. Marszała Józefa Piłsudskiego 42 |25-431 Kielce;2297;1381;1381;34;1347;60.12;2.46
106898;266101;Szkoła Podstawowa nr 33|Kielce|ul. Marszałka Józefa Piłsudskiego 42 |25-431 Kielce;2377;1371;1371;11;1360;57.68;0.80
106899;266101;Przedszkole Samorządowe nr 19|Kielce|Osiedle Na Stoku 98 |25-437 Kielce;2249;1359;1359;10;1349;60.43;0.74
106900;266101;Zespół Szkół Ogólnokształcacych nr 14|Kielce|ul. Jana Nowaka-Jeziorańskiego 53 |25-432 Kielce;2195;1353;1353;7;1346;61.64;0.52
106901;266101;Zespól Szkół Ogólnokształcących nr 14|Kielce|ul. Jana Nowaka-Jeziorańskiego 53 |25-432 Kielce;2356;1370;1370;17;1353;58.15;1.24
106902;266101;Przedszkole Samorządowe nr 5|Kielce|ul. Jana Nowaka-Jeziorańskiego 67 |25-432 Kielce;2275;1301;1301;12;1289;57.19;0.92
106903;266101;Zespół Szkół Ogólnokształcących nr 6|Kielce|ul.Leszczyńska 8 |25-321 Kielce;1797;1101;1101;12;1089;61.27;1.09
106904;266101;Przedszkole Samorządowe nr 33|Kielce|ul. Romualda 6 |25-322 Kielce;1622;992;992;18;974;61.16;1.81
106905;266101;Przedszkole Samorządowe nr 30|Kielce|ul.Wielkopolska 15 |25-327 Kielce;1759;1091;1091;9;1082;62.02;0.82
106906;266101;Klub Seniora|Kielce|ul. Świętego Stanisława Kostki 4A |25-341 Kielce;2182;1340;1340;16;1324;61.41;1.19
106907;266101;Zespół Szkół Ogólnokształcących nr 12|Kielce|ul.Kujawska 18 |25-344 Kielce;2046;1252;1252;19;1233;61.19;1.52
106908;266101;Przedszkole Samorządowe nr 4|Kielce|ul. Kujawska 21 |25-344 Kielce;1916;1120;1120;6;1114;58.46;0.54
106909;266101;Przedszkole Samorządowe nr 24|Kielce|ul. Fryderyka Chopina 3 |25-356 Kielce;1846;1071;1071;7;1064;58.02;0.65
106910;266101;Szkoła Podstawowa nr 28|Kielce|ul. Karola Szymanowskiego 5 |25-361 Kielce;1956;1206;1206;17;1189;61.66;1.41
106911;266101;Dom Działkowca|Kielce|ul. Głogowa 6 |25-346 Kielce;2235;1430;1430;15;1415;63.98;1.05
106912;266101;Dzienny Ośrodek Socjoterapii|Kielce|ul. Wikaryjska 2 |25-255 Kielce;1376;803;803;16;787;58.36;1.99
106913;266101;Miejski Zarząd Dróg|Kielce|ul. Jadwigi Prendowskiej 7 |25-395 Kielce;2150;1299;1299;10;1289;60.42;0.77
106914;266101;Przedszkole Samorządowe nr 3|Kielce|ul. Barwinek 33 |25-150 Kielce;2179;1315;1315;13;1302;60.35;0.99
106915;266101;Zespół Szkół Ogólnokształcących nr 16|Kielce|ul. Barwinek 31 |25-150 Kielce;2035;1230;1230;12;1218;60.44;0.98
106916;266101;Przedszkole Samorządowe nr 39|Kielce|ul. Barwinek 31 |25-150 Kielce;2194;1362;1362;23;1339;62.08;1.69
106917;266101;Szkoła Podstawowa nr 8|Kielce|ul. Jana Karskiego 26 |25-214 Kielce;2023;1284;1284;12;1272;63.47;0.93
106918;266101;Zespół Szkół Informatycznych|Kielce|ul.Generała Józefa Hauke-Bosaka 1 |25-217 Kielce;2067;1244;1244;14;1230;60.18;1.13
106919;266101;Młodzieżowy Ośrodek Wychowawczy|Kielce|ul. Dobromyśl 44 |25-825 Kielce;544;294;294;8;286;54.04;2.72
106920;266101;Zespół Szkół Ogólnokształcących nr 15|Kielce|ul. Krzemionkowa 1 |25-750 Kielce;1732;1106;1106;15;1091;63.86;1.36
106921;266101;Zespół Szkół Ogólnokształcących nr 29|Kielce|ul. Zimna 16 |25-732 Kielce;1981;1232;1232;8;1224;62.19;0.65
106922;266101;Zespół Szkół Ogólnokształcących nr 15|Kielce|ul. Krzemionkowa 1 |25-750 Kielce;1969;1266;1266;14;1252;64.30;1.11
106923;266101;Zespół Szkół Ponadgimnazjalnych nr 1|Kielce|ul.Jagiellońska 90 |25-734 Kielce;1258;694;694;6;688;55.17;0.86
106924;266101;Wojewódzki Szpital Zespolony,Świętokrzyskie Centrum Neurologii,Wejście Główne Nr 1|Kielce|ul. Grunwaldzka 45 |25-736 Kielce;2317;1002;1002;19;983;43.25;1.90
106925;266101;Miejski Zespół Poradni Psychologiczno-Pedagogicznych|Kielce|ul. Urzędnicza 16 |25-729 Kielce;1824;980;980;9;971;53.73;0.92
106926;266101;Zespół Szkół Ogólnokształcących nr 17 Specjalnych|Kielce|ul. Szkolna 29 |25-604 Kielce;2268;1322;1322;16;1306;58.29;1.21
106927;266101;Klub "Mrówka"|Kielce|ul. Karczówkowska 10 |25-019 Kielce;2003;1196;1196;13;1183;59.71;1.09
106928;266101;Przedszkole Samorządowe nr 13|Kielce|ul.Karczówkowska 8 |25-019 Kielce;1725;1011;1011;5;1006;58.61;0.49
106929;266101;Klub Sportowy "Stella"|Kielce|ul.Krakowska 374 |25-801 Kielce;1466;735;735;4;731;50.14;0.54
106930;266101;Ośrodek Kultury "Białogon", Filia Domu Kultury "Zameczek"|Kielce|ul.Pańska 1A |25-820 Kielce;2288;1282;1282;5;1277;56.03;0.39
106931;266101;Zespół Szkoł Ogólnokształcących nr 8|Kielce|Aleja Górników Staszicowskich 22A |25-804 Kielce;903;498;498;10;488;55.15;2.01
106932;266101;Miejski Ośrodek Sportu i Rekreacji, Hotel Maraton|Kielce|ul.Leszka Drogosza 1 |25-093 Kielce;1348;750;750;8;742;55.64;1.07
106933;266101;I LO im. Stefana Żeromskiego|Kielce|ul. Księdza Piotra Ściegiennego 15 |25-033 Kielce;2230;1304;1304;13;1291;58.48;1.00
106934;266101;Przedszkole Samorządowe nr 8 z Oddziałami Integracyjnymi|Kielce|ul. Hetmana Stanisława Żółkiewskiego 12 |25-130 Kielce;1852;1197;1197;10;1187;64.63;0.84
106935;266101;Zespół Szkół Ogólnokształcących nr 26|Kielce|ul. Adolfa Dygasińskiego 6 |25-120 Kielce;1895;1138;1138;9;1129;60.05;0.79
106936;266101;Miejski Ośrodek Pomocy Rodzinie|Kielce|ul.Posłowicka 98 |25-145 Kielce;792;451;451;13;438;56.94;2.88
106937;266101;Zespół Szkół Ogólnokształcących nr 11|Kielce|ul. Łanowa 68 |25-147 Kielce;1405;770;770;10;760;54.80;1.30
106938;266101;Świętokrzyskie Centrum Matki i Noworodka Szpital Specjalistyczny|Kielce|ul. Prosta 30 |25-371 Kielce;86;22;22;0;22;25.58;0.00
106939;266101;Dom Pomocy Społecznej im. Florentyny Malskiej|Kielce|ul. Tarnowska 10 |25-394 Kielce;93;57;57;2;55;61.29;3.51
106940;266101;Dom Pomocy Społecznej im. Św. Brata Alberta|Kielce|ul. Stefana Żeromskiego 4/6 |25-369 Kielce;58;20;20;3;17;34.48;15.00
106941;266101;Samodzielny Publiczny Zakład Opieki Zdrowotnej MSW|Kielce|ul. Ogrodowa 11 |25-024 Kielce;23;8;8;0;8;34.78;0.00
106942;266101;Areszt Śledczy|Kielce|ul. Zagnańska 155 |25-563 Kielce;931;364;364;67;297;39.10;18.41
106943;266101;Szpital Kielecki św. Aleksandra Sp. z o. o.|Kielce|ul. Generała Tadeusza Kościuszki 25 |25-316 Kielce;61;27;27;1;26;44.26;3.70
106944;266101;Dom Pomocy Społecznej im. Jana i Marysieńki Sobieskich|Kielce|ul. Króla Jana III Sobieskiego 30 |25-124 Kielce;62;20;20;5;15;32.26;25.00
106945;266101;Wojewódzki Szpital Zespolony|Kielce|ul. Grunwaldzka 45 |25-736 Kielce;647;175;175;7;168;27.05;4.00
106946;266101;Świętokrzyskie Centrum Onkologii|Kielce|ul. Prezydenta Stefana Artwińskiego 3 |25-734 Kielce;186;98;98;8;90;52.69;8.16
106947;266101;Dom Pomocy Społecznej im. Jana Pawła II|Kielce|ul. Jagiellońska 76 |25-734 Kielce;187;84;85;14;70;44.92;16.67
106948;266101;Dom Pomocy Społecznej im. prof. Antoniego Kępińskiego|Kielce|ul. Jagiellońska 76 |25-734 Kielce;49;22;22;5;17;44.90;22.73
106949;280101;Bartoszycki Dom Kultury|Bartoszyce|ul.Boh. Warszawy 11 |11-200 Bartoszyce;1733;741;741;15;726;42.76;2.02
106950;280101;Zespół Szkolno-Przedszkolny Nr 1|Bartoszyce|ul.Nowowiejskiego 31 |11-200 Bartoszyce;2011;994;994;21;973;49.43;2.11
106951;280101;Sala Gimnastyczna Zespołu Szkół Nr 1|Bartoszyce|ul.Mierosławskiego 1 |11-200 Bartoszyce;1884;886;886;34;852;47.03;3.84
106952;280101;Filia Miejskiej Biblioteki Publicznej|Bartoszyce|ul.Ogrodowa 1a |11-200 Bartoszyce;1957;1055;1055;24;1031;53.91;2.27
106953;280101;Zespół Szkół Nr 1|Bartoszyce|ul.Traugutta 23 |11-200 Bartoszyce;1914;755;755;19;736;39.45;2.52
106954;280101;Zespół Szkół Ponadgimnazjalnych Nr 2|Bartoszyce|ul.Słowackiego 1 |11-200 Bartoszyce;2097;918;918;16;902;43.78;1.74
106955;280101;Szkoła Podstawowa Nr 3|Bartoszyce|ul.Marksa 18 |11-200 Bartoszyce;1982;1014;1014;17;997;51.16;1.68
106956;280101;Przedszkole Integracyjne Nr 4|Bartoszyce|ul.Generała Bema 49 |11-200 Bartoszyce;1745;820;820;21;799;46.99;2.56
106957;280101;Szkoła Podstawowa Nr 7|Bartoszyce|ul.Generała Bema 35 wejście od ul.Gdańskiej|11-200 Bartoszyce;1570;700;700;16;684;44.59;2.29
106958;280101;Gimnazjum Nr 2|Bartoszyce|ul.Generała Bema 35 |11-200 Bartoszyce;1762;842;842;9;833;47.79;1.07
106959;280101;Zespół Szkół z UJN|Bartoszyce|ul. Leśna 1 |11-200 Bartoszyce;895;480;480;3;477;53.63;0.62
106960;280101;Szpital Powiatowy w Bartoszycach|Bartoszyce|ul. Kardynała Wyszyńskiego 11 |11-200 Bartoszyce;104;27;27;1;26;25.96;3.70
106961;280101;Areszt Śledczy w Bartoszycach|Bartoszyce|ul. Warszawska 5 |11-200 Bartoszyce;128;48;48;4;44;37.50;8.33
106962;280101;Dom Pomocy Społecznej|Bartoszyce|ul. Boh. Monte Cassino 4 |11-200 Bartoszyce;69;32;32;2;30;46.38;6.25
106963;280102;Ośrodek Kultury|Górowo Iławeckie|Kościuszki 26 |11-220 Górowo Iławeckie;1656;771;771;33;738;46.56;4.28
106964;280102;Gimnazjum nr 1|Górowo Iławeckie|Generała Sikorskiego 22 |11-220 Górowo Iławeckie;1765;736;736;26;710;41.70;3.53
106965;280103;Młodzieżowy Dom Kultury w Bartoszycach|Bartoszyce|ul.Boh.Warszawy 6 |11-200 Bartoszyce;1650;605;605;26;579;36.67;4.30
106966;280103;Dom Kultury w Bezledach|Bezledy| 47 |11-200 Bartoszyce;1243;488;488;34;454;39.26;6.97
106967;280103;Świetlica Wiejska w Galinach|Galiny| 36 |11-214 Bartoszyce;1553;583;583;23;560;37.54;3.95
106968;280103;Gimnazjum w Kinkajmach|Kinkajmy| 18a |11-200 Bartoszyce;645;224;224;15;209;34.73;6.70
106969;280103;Dom Kultury w Łabędniku|Łabędnik| 11 |11-200 Bartoszyce;1079;351;351;19;332;32.53;5.41
106970;280103;Dom Kultury w Rodnowie|Rodnowo| 10 |11-200 Bartoszyce;662;203;203;15;188;30.66;7.39
106971;280103;Gminny Ośrodek Kultury w Tolko|Tolko| 1 |11-200 Bartoszyce;638;242;242;15;227;37.93;6.20
106972;280103;Dom Kultury w Wojciechach|Wojciechy| 68 |11-200 Bartoszyce;785;261;261;13;248;33.25;4.98
106973;280103;Szkoła Podstawowa w Żydowie|Żydowo| 2 |11-200 Bartoszyce;531;210;210;8;202;39.55;3.81
106974;280104;Ośrodek Kultury i Aktywności Lokalnej w Bisztynku|Bisztynek|ul. Ogrodowa 2 |11-230 Bisztynek;1977;707;707;22;685;35.76;3.11
106975;280104;Gimnazjum Publiczne w Bisztynku|Bisztynek|ul. Kolejowa 5 |11-230 Bisztynek;1534;404;404;9;395;26.34;2.23
106976;280104;Szkoła Podstawowa w Grzędzie|Grzęda| 31A |11-230 Bisztynek;355;84;84;6;78;23.66;7.14
106977;280104;Szkoła Podstawowa w Sątopach|Sątopy| 1 |11-230 Bisztynek;1455;399;399;26;373;27.42;6.52
106978;280105;Zespół Szkół z Ukraińskim Językiem Nauczania w Górowie Iławeckim|Górowo Iławeckie|ul. Szkolna 6 |11-220 Górowo Iławeckie;1281;422;422;23;399;32.94;5.45
106979;280105;Klub Seniora|Kamińsk|ul. XXX-lecia PRL 8 |11-220 Górowo Iławeckie;1114;396;396;11;385;35.55;2.78
106980;280105;Zespół Szkół w Kandytach|Kandyty| 77 |11-220 Górowo Iławeckie;1197;396;396;23;373;33.08;5.81
106981;280105;Szkoła Filialna w Pieszkowie|Pieszkowo| 38 |11-220 Górowo Iławeckie;858;287;287;20;267;33.45;6.97
106982;280105;Świetlica|Gałajny| 9 1|11-220 Górowo Iławeckie;773;231;231;25;206;29.88;10.82
106983;280105;Świetlica|Bukowiec| 41 |11-220 Górowo Iławeckie;439;167;167;6;161;38.04;3.59
106984;280105;Zakład Karny|Kamińsk|ul. XXX-lecia PRL 1 |11-220 Górowo Iławeckie;1068;309;309;21;288;28.93;6.80
106985;280105;Dom Pomocy Społecznej|Kamińsk|ul. XXX-lecia PRL 10 |11-220 Górowo Iławeckie;18;10;10;1;9;55.56;10.00
106986;280106;Zespół Szkolno-Przedszkolny w Sępopolu|Sępopol|al.Wojska Polskiego 8 |11-210 Sępopol;1677;630;630;27;603;37.57;4.29
106987;280106;Miejsko Gminny Ośrodek Kultury w Sępopolu|Sępopol|ul. Mostowa 3 |11-210 Sępopol;754;220;220;16;204;29.18;7.27
106988;280106;Świetlica Wiejska w Wodukajmach|Wodukajmy| 20 |11-210 Sępopol;780;171;171;12;159;21.92;7.02
106989;280106;Szkoła Podstawowa w Dzietrzychowie|Dzietrzychowo| 10 |11-210 Sępopol;779;203;203;15;188;26.06;7.39
106990;280106;Szkoła Podstawowa w Wiatrowcu|Wiatrowiec| 2 |11-210 Sępopol;578;168;168;9;159;29.07;5.36
106991;280106;Świetlica Wiejska w Smolance|Smolanka| 20 |11-210 Sępopol;691;217;217;12;205;31.40;5.53
106992;280201;Miejski Ośrodek Pomocy Społecznej|Braniewo|Rzemieślnicza 1 |14-500 Braniewo;1626;769;769;28;741;47.29;3.64
106993;280201;Szkoła Podstawowa Nr 6|Braniewo|Konarskiego 13 |14-500 Braniewo;1566;774;774;22;752;49.43;2.84
106994;280201;Zespół Szkół Budowlanych|Braniewo|Wiejska 2 |14-500 Braniewo;1604;722;722;32;690;45.01;4.43
106995;280201;Braniewskie Centrum Kultury|Braniewo|Katedralna 9 |14-500 Braniewo;1682;821;821;24;797;48.81;2.92
106996;280201;Szkoła Podstawowa Nr 5|Braniewo|Moniuszki 22a |14-500 Braniewo;1734;848;848;29;819;48.90;3.42
106997;280201;Liceum Ogólnokształcące|Braniewo|Sikorskiego 15 |14-500 Braniewo;1768;896;896;28;868;50.68;3.12
106998;280201;Szkoła Podstawowa Nr 3|Braniewo|PCK 4 |14-500 Braniewo;1603;781;781;19;762;48.72;2.43
106999;280201;Przedszkole Miejskie Nr 2|Braniewo|Różana 14 |14-500 Braniewo;1868;900;900;24;876;48.18;2.67
107000;280201;Powiatowe Centrum Medyczne Spółka z o.o. w Braniewie|Braniewo|Moniuszki 13 |14-500 Braniewo;47;4;4;0;4;8.51;0.00
107001;280201;Zakład Karny w Braniewie|Braniewo|Plac Grunwaldu 2A |14-500 Braniewo;145;96;96;4;92;66.21;4.17
107002;280202;Urząd Gminy w Braniewie|Braniewo|ul. Moniuszki 5 |14-500 Braniewo;1620;589;589;30;559;36.36;5.09
107003;280202;Szkoła Filialna w Szylenach|Szyleny| 13 |14-500 Braniewo;780;253;253;9;244;32.44;3.56
107004;280202;Budynek świetlicy wiejskiej w Lipowinie|Lipowina| 31A |14-500 Braniewo;1198;401;401;17;384;33.47;4.24
107005;280202;Budynek świetlicy wiejskiej w Żelaznej Górze|Żelazna Góra| 24 |14-500 Braniewo;680;242;242;13;229;35.59;5.37
107006;280202;Budynek świetlicy wiejskiej w Gronowie|Gronowo| 15 |14-500 Braniewo;697;206;206;6;200;29.56;2.91
107007;280203;Urząd Miasta i Gminy we Fromborku|Frombork|Młynarska 5a |14-530 Frombork;1016;225;225;22;203;22.15;9.78
107008;280203;Zespół Szkół we Fromborku|Frombork|Katedralna 9 |14-530 Frombork;1206;545;545;22;523;45.19;4.04
107009;280203;Miejsko-Gminny Ośrodek Kultury we Fromborku|Frombork|Osiedle Słoneczne 16 |14-530 Frombork;832;409;409;11;398;49.16;2.69
107010;280203;Samodzielny Publiczny Specjalistyczny Psychiatryczny Zakład Opieki Zdrowotnej|Frombork|Sanatoryjna 1 |14-530 Frombork;225;72;72;5;67;32.00;6.94
107011;280204;Gminne Centrum Kultury|Lelkowo| 17 |14-521 Lelkowo;984;377;377;18;359;38.31;4.77
107012;280204;Szkoła Podstawowa|Zagaje| 6 |14-521 Lelkowo;698;155;155;14;141;22.21;9.03
107013;280204;Świetlica|Głębock| 63 |14-521 Lelkowo;330;108;108;7;101;32.73;6.48
107014;280204;Świetlica|Wyszkowo| 20 |14-521 Lelkowo;480;108;108;7;101;22.50;6.48
107015;280205;Środowiskowy Dom Samopomocy - "Bajka"|Pieniężno|ul.Sienkiewicza 2 |14-520 Pieniężno;1392;590;590;20;570;42.39;3.39
107016;280205;Zespół Szkolno-Przedszkolny|Pieniężno|ul.Ornecka 8 |14-520 Pieniężno;1014;427;427;10;417;42.11;2.34
107017;280205;Miejski Dom Kultury|Pieniężno|ul.Sienkiewicza 4 |14-520 Pieniężno;1099;313;313;10;303;28.48;3.19
107018;280205;Szkoła Podstawowa|Lechowo| 72 |14-520 Pieniężno;455;126;126;3;123;27.69;2.38
107019;280205;Świetlica Sołecka|Pluty| 13 |14-520 Pieniężno;413;104;104;6;98;25.18;5.77
107020;280205;Szkoła Podstawowa|Pakosze| 22 |14-520 Pieniężno;373;112;112;8;104;30.03;7.14
107021;280205;Szkoła Podstawowa|Piotrowiec| 10 |14-520 Pieniężno;644;151;151;3;148;23.45;1.99
107022;280206;Zespół Szkół w Płoskini|Płoskinia| 43 |14-526 Płoskinia;1041;399;399;12;387;38.33;3.01
107023;280206;Szkoła Podstawowa w Chruścielu|Chruściel| 27 |14-526 Płoskinia;539;172;172;11;161;31.91;6.40
107024;280206;Świetlica Wiejska w Długoborze|Długobór| 11 |14-526 Płoskinia;487;164;164;10;154;33.68;6.10
107025;280207;Gimnazjum Publiczne|Wilczęta| 43 |14-405 Wilczęta;1153;419;419;20;399;36.34;4.77
107026;280207;Szkoła Podstawowa|Nowica| 17 |14-405 Wilczęta;531;171;171;8;163;32.20;4.68
107027;280207;Szkoła Podstawowa|Słobity| 3 |14-405 Wilczęta;754;226;226;17;209;29.97;7.52
107028;280301;Zespół Szkół Nr 2 w Działdowie|Działdowo|Polna 11 |13-200 Działdowo;1694;816;816;10;806;48.17;1.23
107029;280301;Zespół Szkół Nr 1 w Działdowie (Sala Sportowa)|Działdowo|Grunwaldzka 4 |13-200 Działdowo;1515;650;650;24;626;42.90;3.69
107030;280301;Przedsiębiorstwo Budowlano-Usługowe PRIMBUD Spółka z o.o. w Działdowie|Działdowo|Osiedleńcza 1 |13-200 Działdowo;1515;719;719;28;691;47.46;3.89
107031;280301;Gimnazjum Nr 1 w Działdowie (Sala Sportowa)|Działdowo|Wł. Jagiełły 33 |13-200 Działdowo;728;297;297;9;288;40.80;3.03
107032;280301;Urząd Miasta Działdowo {Sala Ślubów - Ratusz Miejski}|Działdowo|Pl.Mickiewicza 43 |13-200 Działdowo;772;309;309;18;291;40.03;5.83
107033;280301;Zespół Szkół Zawodowych Nr 1 w Działdowie (Sala Sportowa)|Działdowo|Pocztowa 6 |13-200 Działdowo;782;307;307;14;293;39.26;4.56
107034;280301;Gimnazjum Nr 2 w Działdowie|Działdowo|Sportowa 1 |13-200 Działdowo;1714;735;735;28;707;42.88;3.81
107035;280301;Szkoła Podstawowa Nr 3 w Działdowie|Działdowo|Lenartowicza 1 |13-200 Działdowo;1674;746;746;25;721;44.56;3.35
107036;280301;Spółdzielnia Mieszkaniowa Lokatorsko - Własnościowa w Działdowie|Działdowo|Nidzicka 17 |13-200 Działdowo;1632;614;614;16;598;37.62;2.61
107037;280301;Hala Sportowa przy Gimnazjum Nr 2 w Działdowie|Działdowo|Sportowa 1 |13-200 Działdowo;1673;703;703;19;684;42.02;2.70
107038;280301;Przedsiębiorstwo Ciepłownicze Spółka z oo. w Działdowie|Działdowo|Marii Zientary - Malewskiej 1b |13-200 Działdowo;1717;826;826;12;814;48.11;1.45
107039;280301;Miejski Ośrodek Sportu i Rekreacji w Działdowie|Działdowo|Robotnicza 10 |13-200 Działdowo;1675;783;783;26;757;46.75;3.32
107040;280301;Samodzielny Publiczny Zakład Opieki Zdrowotnej w Działdowie|Działdowo|Leśna 1 |13-200 Działdowo;114;54;54;11;43;47.37;20.37
107041;280301;Areszt Śledczy w Działdowie|Działdowo|Wł.Jagiełly 31A |13-200 Działdowo;74;44;44;10;34;59.46;22.73
107042;280302;Szkoła Podstawowa w Klęczkowie|Klęczkowo| 13 |13-200 Działdowo;571;143;143;6;137;25.04;4.20
107043;280302;Świetlica Wiejska w Kurkach|Kurki| 59 |13-200 Działdowo;340;93;93;10;83;27.35;10.75
107044;280302;Szkoła Podstawowa w Petrykozach|Petrykozy| 59 |13-200 Działdowo;751;217;217;20;197;28.89;9.22
107045;280302;Świetlica Wiejska w Księżym Dworze|Księży Dwór| 55 |13-200 Działdowo;646;252;252;14;238;39.01;5.56
107046;280302;Szkoła Podstawowa w Uzdowie|Uzdowo| 75 |13-200 Działdowo;871;298;298;12;286;34.21;4.03
107047;280302;Szkoła Podstawowa w Ruszkowie|Ruszkowo| 64 |13-200 Działdowo;1356;344;344;23;321;25.37;6.69
107048;280302;Szkoła Podstawowa w Wysokiej|Wysoka| 62 |13-200 Działdowo;609;185;185;3;182;30.38;1.62
107049;280302;Gimnazjum w Burkacie|Burkat| 46 |13-200 Działdowo;705;301;301;17;284;42.70;5.65
107050;280302;Szkoła Podstawowa w Turzy Wielkiej|Turza Wielka| 57A |13-200 Działdowo;533;189;189;10;179;35.46;5.29
107051;280302;Świetlica Wiejska w Kisinach|Kisiny| 38 |13-200 Działdowo;539;209;209;4;205;38.78;1.91
107052;280302;Świetlica Wiejska w Grzybinach|Grzybiny| 31 |13-200 Działdowo;480;95;95;13;82;19.79;13.68
107053;280302;Dom Pomocy Społecznej w Uzdowie|Uzdowo| 18/19 |13-200 Działdowo;65;22;22;5;17;33.85;22.73
107054;280303;Gminny Ośrodek Kultury i Sportu w Iłowie-Osadzie|Iłowo-Osada|ul.Staszica 1 |13-240 Iłowo-Osada;793;375;375;16;359;47.29;4.27
107055;280303;Zespół Szkół Zawodowych w Iłowie-Osadzie|Iłowo-Osada|ul.Leśna 10A |13-240 Iłowo-Osada;1664;682;682;45;637;40.99;6.60
107056;280303;Remiza Ochotniczej Straży Pożarnej w Iłowie-Wsi|Iłowo-Wieś|ul.Wiejska 4A |13-240 Iłowo-Osada;616;213;213;12;201;34.58;5.63
107057;280303;Szkoła Podstawowa w Białutach|Białuty| 1 |13-240 Iłowo-Osada;748;215;215;18;197;28.74;8.37
107058;280303;Zespół Szkół nr 2 w Narzymiu|Narzym|ul.Kościelna 14 |13-240 Iłowo-Osada;1904;577;577;47;530;30.30;8.15
107059;280304;Gimnazjum|Lidzbark|Nowa 10 |13-230 Lidzbark;1534;640;640;13;627;41.72;2.03
107060;280304;Przedszkole Miejskie|Lidzbark|Akacjowa 19 |13-230 Lidzbark;1662;647;647;15;632;38.93;2.32
107061;280304;Miejski Ośrodek Pomocy Społecznej|Lidzbark|Jeleńska 26 |13-230 Lidzbark;1476;619;619;36;583;41.94;5.82
107062;280304;Miejsko-Gminny Ośrodek Kultury|Lidzbark|Sądowa 23 |13-230 Lidzbark;1634;556;556;31;525;34.03;5.58
107063;280304;Dom Strażaka|Lidzbark|Nowy Rynek 15 |13-230 Lidzbark;1525;537;538;28;509;35.21;5.21
107064;280304;Szkoła Podstawowa|Słup| 41 |13-230 Lidzbark;825;254;254;15;239;30.79;5.91
107065;280304;Niepubliczna Szkoła Podstawowa im. Wincentego Witosa|Wąpiersk| 31 |13-230 Lidzbark;741;232;232;14;218;31.31;6.03
107066;280304;Szkoła Podstawowa|Bryńsk| 71 |13-230 Lidzbark;720;216;216;15;201;30.00;6.94
107067;280304;Świetlica Wiejska|Nowy Dwór| 16 |13-230 Lidzbark;413;155;155;11;144;37.53;7.10
107068;280304;Szkoła Podstawowa|Stare Dłutowo|Długa 61 |13-203 Stare Dłutowo;998;351;351;19;332;35.17;5.41
107069;280305;Szkoła Podstawowa|Płośnica|Lipowa 5 |13-206 Płośnica;1403;508;508;23;485;36.21;4.53
107070;280305;Gimnazjum|Gródki| 29 |13-206 Płośnica;920;319;319;10;309;34.67;3.13
107071;280305;Remiza OSP|Rutkowice| 33 |13-206 Płośnica;572;151;151;12;139;26.40;7.95
107072;280305;Szkoła Podstawowa|Niechłonin| 92 |13-206 Płośnica;1169;428;428;34;394;36.61;7.94
107073;280305;Dom Strażaka|Wielki Łęck| 39 |13-230 Lidzbark;608;191;191;9;182;31.41;4.71
107074;280306;Szkoła Podstawowa w Rumianie|Rumian| 12 |13-220 Rybno;408;200;200;10;190;49.02;5.00
107075;280306;Szkoła Podstawowa w Hartowcu|Hartowiec| 40 |13-220 Rybno;507;227;228;11;216;44.77;4.85
107076;280306;Szkoła Podstawowa w Żabinach|Żabiny| 26 |13-220 Rybno;732;280;281;12;268;38.25;4.29
107077;280306;Szkoła Podstawowa w Koszelewach|Koszelewy| 78 |13-206 Płośnica;449;124;124;8;116;27.62;6.45
107078;280306;Sala Konferencyjna w Urzędzie Gminy Rybno|Rybno|ul.Lubawska 15 |13-220 Rybno;1145;593;593;26;567;51.79;4.38
107079;280306;Świetlica Wiejska w Tuczkach|Tuczki| 38 |13-220 Rybno;578;214;214;14;200;37.02;6.54
107080;280306;Remiza OSP w Dębieniu|Dębień| 9 |13-220 Rybno;474;215;215;6;209;45.36;2.79
107081;280306;Sala OSP w Rybnie|Rybno|Lubawska 15 |13-220 Rybno;1116;498;498;21;477;44.62;4.22
107082;280306;Szkoła Podstawowa w Jeglii|Jeglia| 11 |13-220 Rybno;315;135;135;11;124;42.86;8.15
107083;280401;Zespół Szkół w Nowakowie|Nowakowo| 47 |82-300 Elbląg;1162;368;368;12;356;31.67;3.26
107084;280401;Dom Pomocy Społecznej we Władysławowie|Władysławowo| 4 |82-300 Elbląg;1047;340;340;17;323;32.47;5.00
107085;280401;Zespół Szkół w Gronowie Górnym|Gronowo Górne|Szmaragdowa 5 |82-300 Elbląg;2042;897;897;21;876;43.93;2.34
107086;280401;Gminna Biblioteka Publiczna w Komorowie Żuławskim|Komorowo Żuławskie| 6 |82-300 Elbląg;962;360;360;24;336;37.42;6.67
107087;280401;Szkoła Podstawowa w Węzinie|Węzina| 16 |82-300 Elbląg;558;153;153;11;142;27.42;7.19
107088;280402;Szkoła Podstawowa|Bielica| 11 |14-407 Godkowo;845;239;239;11;228;28.28;4.60
107089;280402;Urząd Gminy|Godkowo| 14 |14-407 Godkowo;1068;344;344;20;324;32.21;5.81
107090;280402;Gimnazjum|Dobry| 29 |14-407 Godkowo;730;191;191;10;181;26.16;5.24
107091;280403;Gimnazjum|Gronowo Elbląskie|Osiedlowa 6a |82-335 Gronowo Elbląskie;2147;779;779;32;747;36.28;4.11
107092;280403;Szkoła Podstawowa|Jegłownik|Malborska 43 |82-335 Gronowo Elbląskie;1829;624;624;34;590;34.12;5.45
107093;280404;Świetlica Wiejska w Markusach|Markusy| 81 |82-325 Markusy;1147;323;323;15;308;28.16;4.64
107094;280404;Szkoła Podstawowa w Żurawcu|Żurawiec|Elbląska 15 |82-325 Markusy;859;277;277;16;261;32.25;5.78
107095;280404;Szkoła Podstawowa w Zwierznie|Zwierzno| 28 |82-325 Markusy;1191;370;370;14;356;31.07;3.78
107096;280405;Gimnazjum|Milejewo|Szkolna 4 |82-316 Milejewo;1585;649;649;23;626;40.95;3.54
107097;280405;Szkoła Podstawowa|Pomorska Wieś| 40 |82-316 Milejewo;1085;412;412;20;392;37.97;4.85
107098;280406;Ośrodek Kultury w Młynarach|Młynary|ul.Dworcowa 10 |14-420 Młynary;1625;678;678;30;648;41.72;4.42
107099;280406;Zespół Szkół w Młynarach|Młynary|ul. Warszawska 1 |14-420 Młynary;1360;487;487;23;464;35.81;4.72
107100;280406;Szkoła Podstawowa Błudowo|Błudowo| 48 |14-420 Młynary;720;225;225;12;213;31.25;5.33
107101;280407;Ośrodek Szkolenia i Wychowania OHP w Pasłęku|Pasłęk|ul. Bohaterów Westerplatte 20 |14-400 Pasłęk;1135;555;555;5;550;48.90;0.90
107102;280407;Zespół Szkół Powszechnych w Pasłęku|Pasłęk|ul. 3 Maja 21 |14-400 Pasłęk;1017;462;462;13;449;45.43;2.81
107103;280407;Przedszkole Samorządowe nr 2 w Pasłęku|Pasłęk|ul. Gdańska 17 |14-400 Pasłęk;1064;512;512;21;491;48.12;4.10
107104;280407;Zespół Szkół w Pasłęku|Pasłęk|ul. Zwycięstwa 28 |14-400 Pasłęk;1148;458;458;11;447;39.90;2.40
107105;280407;Przedszkole Samorządowe nr 1 w Pasłęku|Pasłęk|ul. 11 Listopada 8 |14-400 Pasłęk;1097;515;515;19;496;46.95;3.69
107106;280407;Filia Zespołu Szkół Powszechnych w Pasłęku|Pasłęk|ul. Spółdzielcza 7 |14-400 Pasłęk;1106;533;533;8;525;48.19;1.50
107107;280407;Pasłęcki Ośrodek Kultury w Pasłęku|Pasłęk|Plac Świętego Wojciecha 5 |14-400 Pasłęk;1115;407;407;17;390;36.50;4.18
107108;280407;Zespół Szkół Ekonomicznych i Technicznych w Pasłęku|Pasłęk|ul. Wojska Polskiego 36 |14-400 Pasłęk;1156;539;539;11;528;46.63;2.04
107109;280407;Szkoła Podstawowa nr 2 w Pasłęku|Pasłęk|ul. Sprzymierzonych 9 |14-400 Pasłęk;1143;500;500;17;483;43.74;3.40
107110;280407;Miejski Ośrodek Sportu i Rekreacji|Pasłęk|ul. Kraszewskiego 2a |14-400 Pasłęk;935;289;289;7;282;30.91;2.42
107111;280407;Środowiskowy Dom Samopomocy w Rzecznej|Rzeczna| 19 |14-400 Pasłęk;1010;276;276;9;267;27.33;3.26
107112;280407;Gimnazjum nr 1 w Pasłęku|Pasłęk|ul. Władysława Jagiełły 30 |14-400 Pasłęk;1397;389;389;26;363;27.85;6.68
107113;280407;Szkoła Podstawowa z Oddziałami Integracyjnymi w Zielonce Pasłęckiej|Zielonka Pasłęcka| 17 |14-400 Pasłęk;1346;395;395;25;370;29.35;6.33
107114;280407;Szkoła Podstawowa w Rogajnach|Rogajny| 27 |14-400 Pasłęk;935;252;252;18;234;26.95;7.14
107115;280407;Szpital Powiatowy Spółka z o. o. w Pasłęku|Pasłęk|Kopernika 24A |14-400 Pasłęk;36;9;9;0;9;25.00;0.00
107116;280408;Świetlica Wiejska w Jelonkach|Jelonki| 108 |14-411 Rychliki;973;327;327;17;310;33.61;5.20
107117;280408;Świetlica Wiejska w Kwietniewie|Kwietniewo| 7 |14-411 Rychliki;854;209;209;10;199;24.47;4.78
107118;280408;Zespół Szkół w Rychlikach|Rychliki| 34 |14-411 Rychliki;1348;379;379;15;364;28.12;3.96
107119;280409;Szkoła Podstawowa|Łęcze| 29 |82-340 Tolkmicko;640;224;224;13;211;35.00;5.80
107120;280409;Świetlica Wiejska|Suchacz|ul. Królowej Marii 18 |82-340 Tolkmicko;1021;379;379;9;370;37.12;2.37
107121;280409;Świetlica Wiejska|Pogrodzie| 41C |82-340 Tolkmicko;822;268;268;10;258;32.60;3.73
107122;280409;Miejsko-Gminny Ośrodek Kultury|Tolkmicko|Świętojańska 1 |82-340 Tolkmicko;2094;828;828;34;794;39.54;4.11
107123;280409;Dom Pomocy Społecznej|Rangóry| 106 |82-340 Tolkmicko;31;10;10;0;10;32.26;0.00
107124;280409;Dom Pomocy Społecznej|Tolkmicko|ul. Szpitalna 2 |82-340 Tolkmicko;89;26;26;6;20;29.21;23.08
107125;280409;Świetlica Wiejska|Kadyny| 13C |82-340 Tolkmicko;582;210;210;10;200;36.08;4.76
107126;280501;Specjalny Ośrodek Szkolno-Wychowawczy w Ełku|Ełk|ul. Grajewska 16A |19-300 Ełk;1997;907;907;20;887;45.42;2.21
107127;280501;Szkoła Podstawowa Nr 5 w Ełku|Ełk|ul. Księdza Jerzego Popiełuszki 6 |19-300 Ełk;2055;941;941;32;909;45.79;3.40
107128;280501;Szkoła Podstawowa Nr 5 w Ełku|Ełk|ul. Księdza Jerzego Popiełuszki 6 |19-300 Ełk;1880;864;864;19;845;45.96;2.20
107129;280501;Szkoła Podstawowa Nr 5 w Ełku|Ełk|ul. Św. Maksymiliana Marii Kolbe 11 |19-300 Ełk;1805;896;896;10;886;49.64;1.12
107130;280501;Gimnazjum Nr 2 w Ełku|Ełk|ul. Koszykowa 1 |19-300 Ełk;2005;844;844;19;825;42.09;2.25
107131;280501;Szkoła Podstawowa Nr 7 w Ełku|Ełk|ul. J. Kilińskiego 48 |19-300 Ełk;1961;864;864;17;847;44.06;1.97
107132;280501;Centrum Edukacji Ekologicznej w Ełku|Ełk|ul. Parkowa 12 |19-300 Ełk;1909;800;800;8;792;41.91;1.00
107133;280501;Szkoła Podstawowa Nr 7 w Ełku|Ełk|ul. J. Kilińskiego 48 |19-300 Ełk;1961;831;831;22;809;42.38;2.65
107134;280501;Powiatowy Urząd Pracy w Ełku|Ełk|ul. Suwalska 38 |19-300 Ełk;1999;881;881;21;860;44.07;2.38
107135;280501;Gimnazjum Nr 3 w Ełku|Ełk|ul. Majora Jana Piwnika Ponurego 1 |19-300 Ełk;2083;987;987;14;973;47.38;1.42
107136;280501;Szkoła Podstawowa Nr 9 w Ełku|Ełk|ul. Majora Jana Piwnika Ponurego 1 |19-300 Ełk;2051;875;875;15;860;42.66;1.71
107137;280501;Szkoła Policealna w Ełku|Ełk|ul. K. A. Bahrkego 2B |19-300 Ełk;1810;724;724;15;709;40.00;2.07
107138;280501;Szkoła Podstawowa nr 3 w Ełku|Ełk|ul. Grodzieńska 1 |19-300 Ełk;2095;998;998;23;975;47.64;2.30
107139;280501;Zespół Szkół Nr 6 w Ełku|Ełk|ul. M. Kajki 4 |19-300 Ełk;1166;563;563;18;545;48.28;3.20
107140;280501;Zespół Szkół Nr 6 w Ełku|Ełk|ul. M. Kajki 4 |19-300 Ełk;1818;839;839;15;824;46.15;1.79
107141;280501;Ełckie Centrum Kultury w Ełku|Ełk|ul. Wojska Polskiego 47 |19-300 Ełk;1881;806;806;22;784;42.85;2.73
107142;280501;Ełckie Centrum Kultury w Ełku|Ełk|ul. Wojska Polskiego 47 |19-300 Ełk;1975;792;792;21;771;40.10;2.65
107143;280501;Szkoła Podstawowa nr 4 w Ełku|Ełk|ul. Prof. Władysława Szafera 2 |19-300 Ełk;2120;1064;1064;28;1036;50.19;2.63
107144;280501;I Liceum Ogólnokształcące w Ełku|Ełk|ul. Marszałka Józefa Piłsudskiego 3 |19-300 Ełk;1925;864;864;36;828;44.88;4.17
107145;280501;I Liceum Ogólnokształcące w Ełku|Ełk|ul. Marszałka Józefa Piłsudskiego 3 |19-300 Ełk;1830;689;689;12;677;37.65;1.74
107146;280501;Gimnazjum nr 1 w Ełku|Ełk|ul. J. i H. Małeckich 1 |19-300 Ełk;1790;582;582;17;565;32.51;2.92
107147;280501;Szkoła Podstawowa Nr 2 w Ełku|Ełk|ul. J. i H. Małeckich 1 |19-300 Ełk;2011;860;860;31;829;42.76;3.60
107148;280501;Szkoła Podstawowa Nr 2 w Ełku|Ełk|ul. J. i H. Małeckich 1 |19-300 Ełk;1990;742;742;29;713;37.29;3.91
107149;280501;Zespół Szkół Nr 6 w Ełku|Ełk|ul. M. Kajki 4 |19-300 Ełk;1171;641;641;9;632;54.74;1.40
107150;280501;"PRO MEDICA" w Ełku sp. z o.o.|Ełk|ul. Baranki 24 |19-300 Ełk;113;41;41;1;40;36.28;2.44
107151;280501;108 Szpital Wojskowy z Przychodnią SP ZOZ w Ełku|Ełk|ul. Kościuszki 30 |19-300 Ełk;83;16;16;0;16;19.28;0.00
107152;280502;Zespół Szkół Samorządowych w Chełchach|Chełchy| 26 |19-300 Ełk;952;283;283;17;266;29.73;6.01
107153;280502;Szkoła Podstawowa w Mrozach Wielkich|Mrozy Wielkie| 12 |19-300 Ełk;587;246;246;8;238;41.91;3.25
107154;280502;Świetlica Wiejska w Reglu|Regiel| 12 |19-300 Ełk;389;159;159;4;155;40.87;2.52
107155;280502;Szkoła Podstawowa w Nowej Wsi Ełckiej|Nowa Wieś Ełcka|ul. Ełcka 18 |19-300 Ełk;1054;342;342;12;330;32.45;3.51
107156;280502;Świetlica Wiejska w Mostołtach|Mostołty| 11 11|19-300 Ełk;742;185;185;9;176;24.93;4.86
107157;280502;Świetlica Wiejska w Baranach|Barany|ul. Wrzosowa 2 |19-300 Ełk;862;351;351;7;344;40.72;1.99
107158;280502;Szkoła Podstawowa w Rękusach|Rękusy| 17 |19-300 Ełk;645;182;182;10;172;28.22;5.49
107159;280502;Świetlica Wiejska w Rożyńsku|Rożyńsk| 17 |12-250 Orzysz;442;130;130;6;124;29.41;4.62
107160;280502;Zespół Szkół Samorządowych w Woszczelach|Woszczele|ul. Szkolna 4 |19-300 Ełk;515;206;206;9;197;40.00;4.37
107161;280502;Centrum Edukacji Ekologicznej Gminy Ełk w Siedliskach|Siedliska| 25A |19-300 Ełk;467;206;206;6;200;44.11;2.91
107162;280502;Centrum Kultury Gminy Ełk w Stradunach|Straduny|ul. Kajki 10 |19-300 Ełk;1807;620;620;20;600;34.31;3.23
107163;280502;Dom Pomocy Społecznej w Nowej Wsi Ełckiej|Nowa Wieś Ełcka|Lipowa 1 |19-300 Ełk;197;34;34;8;26;17.26;23.53
107164;280503;Gminny Ośrodek Kultury w Kalinowie|Kalinowo|ul. Mazurska 8 |19-314 Kalinowo;1708;540;540;18;522;31.62;3.33
107165;280503;Strażnica OSP|Milewo| 15a |19-314 Kalinowo;724;178;178;12;166;24.59;6.74
107166;280503;Budynek po Szkole Podstawowej|Wysokie| 12 |19-314 Kalinowo;700;155;155;6;149;22.14;3.87
107167;280503;Wiejski Dom Kultury|Pisanica| 64 |19-314 Kalinowo;784;237;237;10;227;30.23;4.22
107168;280503;Szkoła Podstawowa|Sypitki| 3 |19-314 Kalinowo;654;183;183;8;175;27.98;4.37
107169;280503;Szkoła Podstawowa|Borzymy| 22 |19-314 Kalinowo;801;221;221;18;203;27.59;8.14
107170;280503;Dom Pomocy Społecznej "LILI"|Golubie| 7A |19-314 Kalinowo;70;41;41;1;40;58.57;2.44
107171;280504;Remiza Strażacka|Prostki|ul. 1 Maja 25A |19-335 Prostki;933;298;298;13;285;31.94;4.36
107172;280504;Publiczne Gimnazjum w Prostkach|Prostki|ul. Szkolna 9 |19-335 Prostki;1021;264;264;8;256;25.86;3.03
107173;280504;Szkoła Podstawowa w Prostkach|Prostki|ul. 1 Maja 19 |19-335 Prostki;744;231;231;10;221;31.05;4.33
107174;280504;Urząd Gminy Prostki|Prostki|ul. 1 Maja 44B |19-335 Prostki;777;185;185;4;181;23.81;2.16
107175;280504;Szkoła Podstawowa w Bobrach|Bobry| 12 |19-335 Prostki;410;96;96;5;91;23.41;5.21
107176;280504;Szkoła Podstawowa w Rożyńsku Wielkim|Rożyńsk Wielki| 31 |19-335 Prostki;773;179;179;15;164;23.16;8.38
107177;280504;Zespół Szkół w Wiśniowie Ełckim|Wiśniowo Ełckie| 40 |19-335 Prostki;1203;296;296;19;277;24.61;6.42
107178;280505;Zespół Szkół Samorządowych w Starych Juchach|Stare Juchy|ul. Mazurska 11 |19-330 Stare Juchy;1093;374;374;12;362;34.22;3.21
107179;280505;Świetlica wiejska w Grabniku|Grabnik| 28A |19-330 Stare Juchy;314;99;99;6;93;31.53;6.06
107180;280505;Świetlica wiejska w strażnicy OSP w Skomacku Wielkim|Skomack Wielki| 25 |19-330 Stare Juchy;438;104;104;4;100;23.74;3.85
107181;280505;Biblioteka - Centrum Informacji i Kultury Gminy Stare Juchy|Stare Juchy|ul. Ełcka 8 |19-330 Stare Juchy;1271;448;448;8;440;35.25;1.79
107182;280601;Zespół Szkół Nr 1 im. Mikołaja Kopernika w Giżycku|Giżycko|ul. Wiejska 50 |11-500 Giżycko;2255;1043;1043;24;1019;46.25;2.30
107183;280601;"Żegluga Mazurska" Spółka. z o.o.|Giżycko|al. Wojska Polskiego 8 |11-500 Giżycko;2094;1075;1075;13;1062;51.34;1.21
107184;280601;Gimnazjum Nr 1 im. Jana Pawła II w Giżycku|Giżycko|ul. Gimnazjalna 1 |11-500 Giżycko;2177;914;914;37;877;41.98;4.05
107185;280601;Sala Sportowa MOSiR|Giżycko|ul. 3 Maja 21A |11-500 Giżycko;1304;551;551;8;543;42.25;1.45
107186;280601;Zespół Szkół Elektronicznych i Informatycznych im. Komisji Edukacji Narodowej|Giżycko|ul. Mickiewicza 27 |11-500 Giżycko;2309;1045;1045;21;1024;45.26;2.01
107187;280601;Zespół Szkół Zawodowych|Giżycko|ul. I Dywizji im. T. Kościuszki 16 |11-500 Giżycko;1144;457;457;10;447;39.95;2.19
107188;280601;Przedszkole Miejskie Nr 4 w Giżycku|Giżycko|ul. Jagiełły 3 |11-500 Giżycko;2293;1070;1070;27;1043;46.66;2.52
107189;280601;Szkoła Podstawowa Nr 6 w Giżycku|Giżycko|ul. Pionierska 13 |11-500 Giżycko;2235;997;997;18;979;44.61;1.81
107190;280601;Szkoła Podstawowa Nr 7 im. Janusza Korczaka w Giżycku|Giżycko|ul. Wodociągowa 8 |11-500 Giżycko;2187;1046;1046;13;1033;47.83;1.24
107191;280601;Miejski Ośrodek Pomocy Społecznej w Giżycku|Giżycko|ul. Wodociągowa 15 |11-500 Giżycko;1132;530;530;18;512;46.82;3.40
107192;280601;Spółdzielnia Mieszkaniowa "Mamry" w Giżycku|Giżycko|ul. Jagiełły 1 |11-500 Giżycko;2047;1032;1032;18;1014;50.42;1.74
107193;280601;Gimnazjum Nr 2 im. Chwały Oręża Polskiego w Giżycku|Giżycko|ul. Warszawska 39 |11-500 Giżycko;2173;984;984;27;957;45.28;2.74
107194;280601;Areszt Śledczy|Giżycko|ul. Warszawska 28A |11-500 Giżycko;105;51;51;8;43;48.57;15.69
107195;280601;Szpital Giżycki Spółka z o.o.|Giżycko|ul. Warszawska 41 |11-500 Giżycko;153;63;63;3;60;41.18;4.76
107196;280601;Dom Pomocy Społecznej|Giżycko|ul. Warszawska 31 |11-500 Giżycko;123;44;44;5;39;35.77;11.36
107197;280604;Świetlica Wiejska w Kamionkach|Kamionki| 11 |11-500 Giżycko;455;119;119;8;111;26.15;6.72
107198;280604;Świetlica Wiejska w Sterławkach Małych|Sterławki Małe| 2B |11-500 Giżycko;517;178;178;5;173;34.43;2.81
107199;280604;Świetlica Wiejska w Szczybałach Giżyckich|Szczybały Giżyckie| 10A |11-500 Giżycko;650;220;220;12;208;33.85;5.45
107200;280604;Gminny Ośrodek Kultury i Rekreacji w Wilkasach|Wilkasy|ul. Olsztyńska 54 |11-500 Giżycko;1326;618;618;18;600;46.61;2.91
107201;280604;Świetlica Wiejska w Antonowie|Antonowo|ul. Sympatyczna 38 |11-500 Giżycko;367;190;190;5;185;51.77;2.63
107202;280604;Świetlica Wiejska w Spytkowie|Spytkowo| 21A |11-500 Giżycko;403;145;145;12;133;35.98;8.28
107203;280604;Świetlica Wiejska w Pieczonkach|Pieczonki| 7 |11-500 Giżycko;389;101;101;9;92;25.96;8.91
107204;280604;Urząd Gminy Giżycko|Giżycko|ul. Mickiewicza 33 |11-500 Giżycko;574;323;323;5;318;56.27;1.55
107205;280604;Świetlica Wiejska w Sulimach|Sulimy| 3A |11-500 Giżycko;516;200;200;5;195;38.76;2.50
107206;280604;Świetlica Wiejska w Upałtach Małych|Upałty Małe| 5 |11-500 Giżycko;421;130;130;12;118;30.88;9.23
107207;280604;Szkoła Podstawowa w Bystrym|Bystry| 9A |11-500 Giżycko;625;275;275;17;258;44.00;6.18
107208;280604;Świetlica Wiejska w Upałtach|Upałty| 10 |11-500 Giżycko;382;140;140;2;138;36.65;1.43
107209;280605;Gminny Ośrodek Kultury w Kruklankach|Kruklanki|ul. 22 Lipca 19 |11-612 Kruklanki;564;225;225;5;220;39.89;2.22
107210;280605;Gminny Ośrodek Kultury w Kruklankach|Kruklanki|ul. 22 Lipca 19 |11-612 Kruklanki;657;258;258;6;252;39.27;2.33
107211;280605;Świetlica Ochotniczej Straży Pożarnej w Jeziorowskich|Jeziorowskie| 17A |11-612 Kruklanki;308;108;108;6;102;35.06;5.56
107212;280605;Szkoła Podstawowa w Boćwince|Boćwinka| 12 |11-612 Kruklanki;535;112;112;3;109;20.93;2.68
107213;280605;Była Szkoła Podstawowa w Jurkowie|Jurkowo| 17 |11-612 Kruklanki;475;126;126;12;114;26.53;9.52
107214;280606;Ośrodek Kultury w Miłkach|Miłki|ul. Szkolna 1 |11-513 Miłki;1315;441;441;21;420;33.54;4.76
107215;280606;Świetlica Wiejska|Konopki Nowe| 9 |11-513 Miłki;594;200;200;8;192;33.67;4.00
107216;280606;Szkoła Podstawowa w Rydzewie|Rydzewo|ul. Mazurska 94 |11-513 Miłki;1185;404;404;23;381;34.09;5.69
107217;280608;Urząd Miasta i Gminy Ryn|Ryn|ul. Świerczewskiego 2 |11-520 Ryn;882;299;299;21;278;33.90;7.02
107218;280608;Zespół Szkolno-Przedszkolny w Rynie|Ryn|ul. Hanki Sawickiej 8A |11-520 Ryn;601;248;248;9;239;41.26;3.63
107219;280608;Urząd Miasta i Gminy Ryn|Ryn|ul. Świerczewskiego 2 |11-520 Ryn;960;306;306;18;288;31.87;5.88
107220;280608;Wiejski Dom Kultury w Sterławkach Wielkich|Sterławki Wielkie| 54 |11-520 Ryn;436;169;169;13;156;38.76;7.69
107221;280608;Ryńskie Centrum Kultury w Rynie|Ryn|ul. Hanki Sawickiej 1 |11-520 Ryn;1199;321;321;18;303;26.77;5.61
107222;280608;Świetlica Wiejska w Skopie|Skop| 9 |11-520 Ryn;356;114;114;13;101;32.02;11.40
107223;280608;Świetlica Wiejska w Szymonce|Szymonka| 25 |11-520 Ryn;331;137;137;6;131;41.39;4.38
107224;280610;Zespół Szkół w Gawlikach Wielkich|Gawliki Wielkie| 32 |11-510 Wydminy;680;237;237;15;222;34.85;6.33
107225;280610;Świetlica Środowiskowa w Orłowie|Orłowo| 37A |11-510 Wydminy;341;97;97;7;90;28.45;7.22
107226;280610;Szkoła Podstawowa im. Feliksa Nowowiejskiego w Wydminach Szkoła Filialna w Talkach|Talki| 2 |11-510 Wydminy;342;98;98;8;90;28.65;8.16
107227;280610;Gminny Ośrodek Kultury w Wydminach|Wydminy|pl. Rynek 1 3|11-510 Wydminy;1260;413;413;19;394;32.78;4.60
107228;280610;Zespół Szkół Ogólnokształcących w Wydminach|Wydminy|ul. Grunwaldzka 94 |11-510 Wydminy;1894;874;874;23;851;46.15;2.63
107229;280610;Szkoła Podstawowa im. Feliksa Nowowiejskiego w Wydminach Szkoła Filialna w Zelkach|Zelki| 1 |11-510 Wydminy;386;128;128;5;123;33.16;3.91
107230;280610;Świetlica Wiejska w Siedliskach|Siedliska| 32 |11-510 Wydminy;301;104;104;8;96;34.55;7.69
107231;280610;Dom Pomocy Społecznej w Wydminach|Wydminy|Źródlana 2 |11-510 Wydminy;29;27;27;1;26;93.10;3.70
107232;280701;Iławskie Przedsiębiorstwo Budowlane|Iława|ul. Lubawska 3 |14-200 Iława;1277;577;577;9;568;45.18;1.56
107233;280701;Przedszkole Miejskie Nr 3|Iława|ul. Kościuszki 22A |14-200 Iława;1244;507;507;7;500;40.76;1.38
107234;280701;Przedszkole Miejskie Nr 3|Iława|ul. Kościuszki 22A |14-200 Iława;1469;737;737;7;730;50.17;0.95
107235;280701;Przedszkole Miejskie Nr 4|Iława|ul. Dąbrowskiego 17B |14-200 Iława;1401;754;754;11;743;53.82;1.46
107236;280701;Przedszkole Miejskie Nr 4|Iława|ul. Dąbrowskiego 17B |14-200 Iława;1190;642;642;16;626;53.95;2.49
107237;280701;Miejski Ośrodek Pomocy Społecznej|Iława|ul. Obrońców Westerplatte 5 |14-200 Iława;1101;541;541;5;536;49.14;0.92
107238;280701;Samorządowa Szkoła Podstawowa Nr 3|Iława|ul. Niepodległości 11A |14-200 Iława;1327;713;713;15;698;53.73;2.10
107239;280701;Miejski Ośrodek Pomocy Społecznej|Iława|ul. Obrońców Westerplatte 5 |14-200 Iława;1230;530;530;17;513;43.09;3.21
107240;280701;Ośrodek Psychoedukacji, Profilaktyki Uzależnień i Pomocy Rodzinie|Iława|ul. Chełmińska 1 |14-200 Iława;1379;731;731;23;708;53.01;3.15
107241;280701;Ośrodek Psychoedukacji, Profilaktyki Uzależnień i Pomocy Rodzinie|Iława|ul. Chełmińska 1 |14-200 Iława;1227;509;509;12;497;41.48;2.36
107242;280701;Zespół Placówek Szkolno-Wychowawczych|Iława|ul. Kościuszki 23A |14-200 Iława;1274;614;614;18;596;48.19;2.93
107243;280701;Miejski Ośrodek Pomocy Społecznej|Iława|ul. Grunwaldzka 6A |14-200 Iława;1339;587;587;18;569;43.84;3.07
107244;280701;Zespół Szkół im. Bohaterów Września 1939 r.|Iława|ul. Kopernika 8A |14-200 Iława;1260;667;667;18;649;52.94;2.70
107245;280701;Gimnazjum Samorządowe Nr 2|Iława|ul. Wiejska 11 |14-200 Iława;1291;678;678;14;664;52.52;2.06
107246;280701;Przedszkole Miejskie Nr 6|Iława|ul. Wiejska 3 |14-200 Iława;1289;640;640;12;628;49.65;1.88
107247;280701;Samorządowa Szkoła Podstawowa Nr 4|Iława|ul. Skłodowskiej 31 |14-200 Iława;1083;599;599;14;585;55.31;2.34
107248;280701;Samorządowa Szkoła Podstawowa Nr 4|Iława|ul. Skłodowskiej 31 |14-200 Iława;1035;497;497;9;488;48.02;1.81
107249;280701;Samorządowa Szkoła Podstawowa Nr 2|Iława|ul. Andersa 7 |14-200 Iława;1212;581;581;12;569;47.94;2.07
107250;280701;Zespół Szkół im. Bohaterów Września 1939 r.|Iława|ul. Kopernika 8A |14-200 Iława;1241;523;523;13;510;42.14;2.49
107251;280701;Przedszkole Miejskie Nr 5|Iława|ul. Andersa 8A |14-200 Iława;1117;504;504;10;494;45.12;1.98
107252;280701;Osiedlowy Dom Kultury|Iława|ul. Skłodowskiej 26A |14-200 Iława;1194;574;574;14;560;48.07;2.44
107253;280701;Powiatowy Szpital im. Władysława Biegańskiego|Iława|ul. Andersa 3 |14-200 Iława;86;40;40;4;36;46.51;10.00
107254;280701;Zakład Karny|Iława|ul. 1 Maja 14 |14-200 Iława;951;372;372;65;307;39.12;17.47
107255;280701;Dom Pomocy Społecznej|Iława|Dąbrowskiego 15B |14-200 Iława;50;21;21;0;21;42.00;0.00
107256;280702;Szkoła Podstawowa|Lubawa|Rzepnikowskiego 7 |14-260 Lubawa;2262;1133;1133;49;1084;50.09;4.32
107257;280702;Kino "POKÓJ"|Lubawa|Kupnera 27 |14-260 Lubawa;1647;814;814;20;794;49.42;2.46
107258;280702;Zespół Szkół|Lubawa|Gdańska 25 |14-260 Lubawa;1695;807;807;30;777;47.61;3.72
107259;280702;Gimnazjum|Lubawa|Świętej Barbary 45 |14-260 lubawa;1924;985;985;29;956;51.20;2.94
107260;280703;Gminny Ośrodek Kultury w Lasecznie|Laseczno| 39A |14-202 Iława;682;222;222;11;211;32.55;4.95
107261;280703;Świetlica Wiejska w Wikielcu|Wikielec| 17B |14-200 Iława;1445;581;581;21;560;40.21;3.61
107262;280703;Szkoła Podstawowa w Ząbrowie|Ząbrowo| 43 |14-241 Ząbrowo;1320;441;441;29;412;33.41;6.58
107263;280703;Szkoła Podstawowa w Gałdowie|Gałdowo| 24 |14-241 Ząbrowo;598;203;203;11;192;33.95;5.42
107264;280703;Świetlica Wiejska w Siemianach|Siemiany| 29D |14-216 Siemiany;538;213;213;7;206;39.59;3.29
107265;280703;Szkoła Podstawowa w Rudzienicach|Rudzienice|ul. Szkolna 2 |14-204 Rudzienice;667;264;264;20;244;39.58;7.58
107266;280703;Świetlica Wiejska we Frednowach|Frednowy| 48 |14-200 Iława;714;286;286;12;274;40.06;4.20
107267;280703;Gimnazjum Samorządowe we Franciszkowie|Franciszkowo| 18 |14-200 Iława;535;205;205;17;188;38.32;8.29
107268;280703;Świetlica Wiejska w Woli Kamieńskiej|Wola Kamieńska| 27 |14-200 Iława;846;370;370;8;362;43.74;2.16
107269;280703;Świetlica Wiejska w Nowej Wsi|Nowa Wieś|ul. Olsztyńska 13 |14-200 Iława;735;374;374;6;368;50.88;1.60
107270;280703;Niepubliczna Szkoła Podstawowa w Ławicach|Ławice| 8 |14-200 Iława;978;378;378;22;356;38.65;5.82
107271;280703;Szkoła Podstawowa w Gromotach|Gromoty| 20 |14-204 Rudzienice;668;197;197;10;187;29.49;5.08
107272;280704;Zespół Szkół w Kisielicach|Kisielice|Aleja Wojska Polskiego 2 |14-220 Kisielice;1017;376;376;20;356;36.97;5.32
107273;280704;Zespół Szkół w Kisielicach|Kisielice|Aleja Wojska Polskiego 2 |14-220 Kisielice;963;320;320;21;299;33.23;6.56
107274;280704;Sala Wiejska w Łodygowie|Łodygowo| 3B |14-220 Kisielice;633;192;192;7;185;30.33;3.65
107275;280704;Remiza OSP w Jędrychowie|Jędrychowo| 56 |14-220 Kisielice;709;245;245;6;239;34.56;2.45
107276;280704;Szkoła Podstawowa w Goryniu|Goryń| 88 |14-220 Kisielice;733;198;198;18;180;27.01;9.09
107277;280704;Sala Wiejska w Klimach|Klimy| 42 |14-220 Kisielice;272;74;74;3;71;27.21;4.05
107278;280704;Szkoła Podstawowa w Łęgowie|Łęgowo| 75 |14-220 Kisielice;555;132;132;11;121;23.78;8.33
107279;280705;Urząd Gminy Lubawa w Fijewie|Fijewo| 73 |14-260 Lubawa;1188;518;518;16;502;43.60;3.09
107280;280705;Zespół Szkół w Prątnicy|Prątnica| 9 |14-260 Lubawa;1465;593;593;38;555;40.48;6.41
107281;280705;Szkoła Podstawowa w Rumienicy|Rumienica| 29 |14-260 Lubawa;417;180;180;13;167;43.17;7.22
107282;280705;Szkoła Podstawowa w Złotowie|Złotowo| 66 |14-260 Lubawa;625;290;290;8;282;46.40;2.76
107283;280705;Zespół Szkół w Grabowie-Wałdykach|Grabowo| 116 |14-229 Rożental;797;307;307;13;294;38.52;4.23
107284;280705;Szkoła Podstawowa w Rożentalu|Rożental| 140 A |14-229 Rożental;1213;527;527;25;502;43.45;4.74
107285;280705;Zespół Szkół w Kazanicach|Kazanice| 83 A |14-229 Rożental;1032;449;449;23;426;43.51;5.12
107286;280705;Zespół Szkół w Sampławie|Sampława| 4 |14-260 Lubawa;1449;606;606;32;574;41.82;5.28
107287;280706;Środowiskowy Dom Samopomocy|Susz|ul. Kościelna 1 |14-240 Susz;1005;368;368;26;342;36.62;7.07
107288;280706;Centrum Zarządzania Kryzysowego|Susz|ul. Polna 1a |14-240 Susz;1309;531;531;19;512;40.57;3.58
107289;280706;Publiczne Gimnazjum|Susz|ul. Piastowska 5 |14-240 Susz;1625;699;699;29;670;43.02;4.15
107290;280706;Świetlica|Susz|ul. Koszarowa 15A |14-240 Susz;1041;305;305;11;294;29.30;3.61
107291;280706;Szkoła Podstawowa|Lubnowy Małe| 28 |14-240 Susz;553;97;97;7;90;17.54;7.22
107292;280706;Świetlica|Bałoszyce| 63 |14-240 Susz;843;175;175;11;164;20.76;6.29
107293;280706;Świetlica|Różnowo| 42 |14-240 Susz;554;160;160;10;150;28.88;6.25
107294;280706;Szkoła Podstawowa|Kamieniec| 20 |14-240 Susz;782;191;191;15;176;24.42;7.85
107295;280706;Szkoła Podstawowa|Piotrkowo| 45 |14-240 Susz;579;153;153;12;141;26.42;7.84
107296;280706;Szkoła Podstawowa|Babięty Wielkie| 31 |14-240 Susz;878;231;231;9;222;26.31;3.90
107297;280706;Świetlica|Ulnowo| 1 |14-240 Susz;794;234;234;8;226;29.47;3.42
107298;280707;Urząd Miejski w Zalewie|Zalewo|Częstochowska 8 |14-230 Zalewo;1826;703;703;29;674;38.50;4.13
107299;280707;Urząd Miejski w Zalewie|Zalewo|Częstochowska 8 |14-230 Zalewo;1539;365;365;13;352;23.72;3.56
107300;280707;Zespół Szkół w Borecznie|Boreczno| 22 |14-230 Zalewo;1353;347;347;24;323;25.65;6.92
107301;280707;Szkoła Podstawowa w Dobrzykach|Dobrzyki| 25 |14-230 Zalewo;918;239;239;10;229;26.03;4.18
107302;280801;Miejskie Przedszkole Integracyjne "Malinka"|Kętrzyn|ul. Obrońców Westerplatte 16 |11-400 Kętrzyn;2157;962;962;31;931;44.60;3.22
107303;280801;Przedszkole Niepubliczne "Słoneczko"|Kętrzyn|ul. Obrońców Westerplatte 18 |11-400 Kętrzyn;1081;495;495;8;487;45.79;1.62
107304;280801;Przedszkole Niepubliczne "Puchatek"|Kętrzyn|ul. Gen.Władysława Sikorskiego 46 |11-400 Kętrzyn;1159;488;488;13;475;42.11;2.66
107305;280801;Zespół Szkół Nr 1 z Oddziałami Integracyjnymi|Kętrzyn|ul. Kazimierza Wielkiego 12 |11-400 Kętrzyn;1089;525;525;16;509;48.21;3.05
107306;280801;Zespół Szkół Nr 1 z Oddziałami Integracyjnymi|Kętrzyn|ul. Kazimierza Wielkiego 12 |11-400 Kętrzyn;1930;870;870;15;855;45.08;1.72
107307;280801;Miejski Ośrodek Sportu i Rekreacji|Kętrzyn|ul. Kazimierza Wielkiego 12a |11-400 Kętrzyn;2247;954;954;18;936;42.46;1.89
107308;280801;Powiatowe Centrum Edukacyjne|Kętrzyn|ul. Poznańska 21 |11-400 Kętrzyn;2002;1008;1008;14;994;50.35;1.39
107309;280801;Gimnazjum Nr 2|Kętrzyn|ul. Wojska Polskiego 9 |11-400 Kętrzyn;987;370;370;6;364;37.49;1.62
107310;280801;Młodzieżowy Dom Kultury|Kętrzyn|ul. Pocztowa 13 |11-400 Kętrzyn;1106;464;464;11;453;41.95;2.37
107311;280801;PGK "Komunalnik" Sp. z o. o.|Kętrzyn|pl. Słowiański 2 |11-400 Kętrzyn;1083;459;459;10;449;42.38;2.18
107312;280801;Przedszkole Niepubliczne "Miś Uszatek"|Kętrzyn|ul. Stanisława Moniuszki 3 |11-400 Kętrzyn;1186;570;570;13;557;48.06;2.28
107313;280801;Szkoła Podstawowa Nr 4|Kętrzyn|ul. Stanisława Moniuszki 1 |11-400 Kętrzyn;2203;958;958;19;939;43.49;1.98
107314;280801;Zespół Szkół Ogólnokształcących|Kętrzyn|ul. Powstańców Warszawy 2 |11-400 Kętrzyn;2313;943;943;23;920;40.77;2.44
107315;280801;Szkoła Podstawowa Nr 3|Kętrzyn|ul. Bydgoska 1 |11-400 Kętrzyn;1812;722;722;23;699;39.85;3.19
107316;280801;Dom Pomocy Społecznej|Kętrzyn|Wileńska 16 |11-400 Kętrzyn;79;16;16;2;14;20.25;12.50
107317;280801;Szpital Powiatowy|Kętrzyn|Marii Curie-Skłodowskiej 2 |11-400 Kętrzyn;53;14;14;0;14;26.42;0.00
107318;280802;Zespół Szkół w Barcianach|Barciany|ul. Nowa 1A |11-410 Barciany;946;345;345;15;330;36.47;4.35
107319;280802;Zespół Szkół w Barcianach|Barciany|ul. Nowa 1A |11-410 Barciany;801;197;197;12;185;24.59;6.09
107320;280802;Zespół Szkół w Drogoszach|Drogosze| 40 |11-410 Barciany;879;220;220;23;197;25.03;10.45
107321;280802;Zespół Szkół w Windzie|Winda| 6 |11-410 Barciany;701;199;199;13;186;28.39;6.53
107322;280802;Zespół Szkół w Mołtajnach|Mołtajny| 1 |11-410 Barciany;441;89;89;9;80;20.18;10.11
107323;280802;Zespół Szkół w Mołtajnach|Mołtajny| 1 |11-410 Barciany;656;146;146;8;138;22.26;5.48
107324;280802;Budynek po byłej Szkole Podstawowej w Skandawie|Skandawa| 34 |11-410 Barciany;816;174;174;8;166;21.32;4.60
107325;280803;Świetlica Wiejska w budynku po Szkole Podstawowej w Linkowie|Linkowo| 19 5|11-400 Kętrzyn;303;57;57;0;57;18.81;0.00
107326;280803;Świetlica Wiejska w Gałwunach|Gałwuny| 1B |11-400 Kętrzyn;511;144;144;2;142;28.18;1.39
107327;280803;Szkoła Podstawowa w Biedaszkach|Biedaszki| 11 |11-400 Kętrzyn;851;299;299;11;288;35.14;3.68
107328;280803;Urząd Gminy Kętrzyn|Kętrzyn|ul. T. Kościuszki 2 |11-400 Kętrzyn;518;148;148;8;140;28.57;5.41
107329;280803;Zespół Szkół w Wilkowie|Wilkowo| 23 |11-440 Reszel;523;167;167;8;159;31.93;4.79
107330;280803;Świetlica Wiejska w Nowej Wsi Kętrzyńskiej|Nowa Wieś Kętrzyńska| 8A 4|11-400 Kętrzyn;441;188;188;11;177;42.63;5.85
107331;280803;Szkoła Podstawowa w Nakomiadach|Nakomiady| 1 |11-400 Kętrzyn;943;240;240;14;226;25.45;5.83
107332;280803;Gimnazjum Gminne w Karolewie|Karolewo| 9 |11-400 Kętrzyn;732;317;317;7;310;43.31;2.21
107333;280803;Gimnazjum Gminne w Karolewie|Karolewo| 9 |11-400 Kętrzyn;516;197;197;4;193;38.18;2.03
107334;280803;Świetlica Wiejska "Kuźnia" w Wopławkach|Wopławki| 10 |11-400 Kętrzyn;498;152;152;11;141;30.52;7.24
107335;280803;Świetlica Wiejska w Mażanach|Mażany| 17 |11-400 Kętrzyn;354;58;58;6;52;16.38;10.34
107336;280803;Świetlica Wiejska w Nowej Różance|Nowa Różanka| 30A |11-400 Kętrzyn;386;139;139;10;129;36.01;7.19
107337;280804;Budynek administracyjny na stadionie miejskim|Korsze|ul. Wojska Polskiego 39 |11-430 Korsze;1369;426;426;15;411;31.12;3.52
107338;280804;Miejsko-Gminna Biblioteka Publiczna|Korsze|ul. Wolności 16 |11-430 Korsze;912;352;352;9;343;38.60;2.56
107339;280804;Miejski Ośrodek Pomocy Społecznej|Korsze|ul. Mickiewicza 13 |11-430 Korsze;1385;540;540;12;528;38.99;2.22
107340;280804;Zespół Szkół w Korszach|Korsze|ul. Kościuszki 12 |11-430 Korsze;734;154;154;8;146;20.98;5.19
107341;280804;Świetlica Wiejska w Garbnie|Garbno| 36A |11-430 Korsze;1201;344;344;22;322;28.64;6.40
107342;280804;Świetlica Wiejska w Warnikajmach|Warnikajmy| 8 |11-430 Korsze;438;106;106;7;99;24.20;6.60
107343;280804;Zespół Szkół w Łankiejmach|Łankiejmy| 10 |11-430 Korsze;739;136;136;9;127;18.40;6.62
107344;280804;Świetlica Wiejska w Wandajnach|Wandajny| 10 |11-430 Korsze;452;77;77;2;75;17.04;2.60
107345;280804;Zespół Szkół w Sątocznie|Sątoczno| 8 |11-430 Korsze;927;206;206;10;196;22.22;4.85
107346;280804;Zakład Karny w Dublinach|Dubliny| 16 |11-430 Korsze;279;107;107;24;83;38.35;22.43
107347;280805;Hala sportowa im. Orłów Górskiego przy Gimnazjum Nr 1|Reszel|ul. B. Chrobrego 1 |11-440 Reszel;1201;493;493;20;473;41.05;4.06
107348;280805;Hala sportowa im. Orłów Górskiego przy Gimnazjum Nr 1|Reszel|ul. B. Chrobrego 1 |11-440 Reszel;853;318;318;16;302;37.28;5.03
107349;280805;Szkoła Podstawowa Nr 3|Reszel|ul. Marii Konopnickiej 3 |11-440 Reszel;836;343;343;8;335;41.03;2.33
107350;280805;Szkoła Podstawowa Nr 3|Reszel|ul. Marii Konopnickiej 3 |11-440 Reszel;1045;440;440;12;428;42.11;2.73
107351;280805;Miejski Ośrodek Kultury|Reszel|ul. A. Mickiewicza 4 |11-440 Reszel;857;274;274;13;261;31.97;4.74
107352;280805;Filia Miejskiej Biblioteki Publicznej|Święta Lipka| 26 |11-440 Reszel;876;322;322;11;311;36.76;3.42
107353;280805;Niepubliczna Szkoła Podstawowa w Leginach|Leginy| 61 |11-440 Reszel;346;101;101;2;99;29.19;1.98
107354;280805;Świetlica Stacji Dydaktyczno-Badawczej UW-M w Łężanach|Łężany| 16 |11-440 Reszel;391;127;127;7;120;32.48;5.51
107355;280805;Świetlica ZOZ w Reszlu|Reszel|Słowackiego 17 |11-440 Reszel;56;8;8;0;8;14.29;0.00
107356;280805;Świetlica ZOZ w Reszlu|Reszel|Słowackiego 17 |11-440 Reszel;43;10;10;0;10;23.26;0.00
107357;280806;Świetlica Wiejska w Bajorach Małych|Bajory Małe| 6 1|11-420 Srokowo;244;44;44;2;42;18.03;4.55
107358;280806;Świetlica Wiejska w Jegławkach|Jegławki| 18 |11-420 Srokowo;628;162;162;13;149;25.80;8.02
107359;280806;Gminny Ośrodek Kultury w Srokowie|Srokowo|ul. Plac Rynkowy 14 |11-420 Srokowo;891;398;398;13;385;44.67;3.27
107360;280806;Gminny Ośrodek Kultury w Srokowie|Srokowo|ul. Plac Rynkowy 14 |11-420 Srokowo;782;251;251;11;240;32.10;4.38
107361;280806;Filia w Solance Szkoły Podstawowej w Srokowie|Solanka| 3 |11-420 Srokowo;728;155;155;13;142;21.29;8.39
107362;280901;Zespół Szkolno-Przedszkolny|Lidzbark Warmiński|ul.Polna Nr 36 |11-100 Lidzbark Warmiński;1665;857;857;26;831;51.47;3.03
107363;280901;Gimnazjum Nr 2|Lidzbark Warmiński|ul.Polna Nr 36 |11-100 Lidzbark Warmiński;822;412;412;14;398;50.12;3.40
107364;280901;Przedszkole Niepubliczne "Kubuś"|Lidzbark Warmiński|ul.Ogrodowa Nr 1 |11-100 Lidzbark Warmiński;861;356;356;10;346;41.35;2.81
107365;280901;Spółdzielnia Mieszkaniowa "Warmia"|Lidzbark Warmiński|ul.Poniatowskiego Nr 18 |11-100 Lidzbark Warmiński;1637;832;832;27;805;50.82;3.25
107366;280901;Lokal po byłej Filiii Miejskiej Biblioteki Publicznej|Lidzbark Warmiński|ul.Ornecka Nr 6A |11-100 Lidzbark Warmiński;746;340;340;14;326;45.58;4.12
107367;280901;Młodzieżowy Dom Kultury|Lidzbark Warmiński|ul.Poniatowskiego Nr 3 |11-100 Lidzbark Warmiński;866;458;458;20;438;52.89;4.37
107368;280901;Zespół Szkół i Placówek Oświatowych|Lidzbark Warmiński|ul.Wierzbickiego Nr 3B |11-100 Lidzbark Warmiński;1875;893;893;22;871;47.63;2.46
107369;280901;Szkoła Podstawowa Nr 1|Lidzbark Warmiński|ul.Szkolna Nr 2 |11-100 Lidzbark Warmiński;843;508;508;10;498;60.26;1.97
107370;280901;Lidzbarski Dom Kultury|Lidzbark Warmiński|ul.Słowackiego Nr 4 |11-100 Lidzbark Warmiński;1763;843;843;21;822;47.82;2.49
107371;280901;Szkoła Podstawowa Nr 3|Lidzbark Warmiński|ul.Lipowa Nr 17A |11-100 Lidzbark Warmiński;1739;756;756;24;732;43.47;3.17
107372;280901;Szpital Powiatowy|Lidzbark Warmiński|Bartoszycka 3 |11-100 Lidzbark Warmiński;51;20;20;0;20;39.22;0.00
107373;280902;Świetlica Wiejska w Kiwitach|Kiwity| 2 |11-106 Kiwity;728;312;312;17;295;42.86;5.45
107374;280902;Filia Szkoły Podstawowej w Kiwitach z siedzibą w Żegotach|Żegoty| 91 |11-106 Kiwity;871;260;260;12;248;29.85;4.62
107375;280902;Niepubliczna Szkoła Podstawowa w Krekolach|Krekole| 34 |11-106 Kiwity;597;217;217;7;210;36.35;3.23
107376;280902;Świetlica Wiejska w Stoczku|Stoczek| 31 |11-106 Kiwity;587;244;244;7;237;41.57;2.87
107377;280903;Urząd Gminy|Lidzbark Warmiński|ul. Krasickiego 1 |11-100 Lidzbark Warmiński;1163;376;376;13;363;32.33;3.46
107378;280903;Publiczna Szkoła Podstawowa|Kraszewo| 2 |11-100 Lidzbark Warmiński;833;283;283;21;262;33.97;7.42
107379;280903;Publiczna Szkoła Podstawowa|Kłębowo| 7 |11-100 Lidzbark Warmiński;745;247;247;8;239;33.15;3.24
107380;280903;Zespół Szkół w Rogóżu|Rogóż| 92 |11-100 Lidzbark Warmiński;928;315;315;11;304;33.94;3.49
107381;280903;Publiczna Szkoła Podstawowa|Runowo| 55 |11-100 Lidzbark Warmiński;657;180;180;6;174;27.40;3.33
107382;280903;Świetlica wiejska|Babiak| 12 |11-100 Lidzbark Warmiński;343;86;86;2;84;25.07;2.33
107383;280903;Świetlica wiejska|Kochanówka| 17 |11-100 Lidzbark Warmiński;297;107;107;6;101;36.03;5.61
107384;280903;Świetlica wiejska|Łaniewo| 79 |11-100 Lidzbark Warmiński;473;146;146;7;139;30.87;4.79
107385;280904;Urząd Gminy Lubomino|Lubomino|Kopernika 7 |11-135 Lubomino;1815;574;574;26;548;31.63;4.53
107386;280904;Środowiskowy Dom Samopomocy|Wolnica| 50 |11-135 Lubomino;398;113;113;10;103;28.39;8.85
107387;280904;Szkoła Podstawowa|Wilczkowo| 73 |11-135 Lubomino;699;185;185;15;170;26.47;8.11
107388;280905;Zespół Szkół Ogólnokształcących|Orneta|1 Maja 28 |11-130 Orneta;2023;766;766;33;733;37.86;4.31
107389;280905;Miejski Dom Kultury|Orneta|1 Maja 45 |11-130 Orneta;1919;848;848;25;823;44.19;2.95
107390;280905;Szkoła Podstawowa Nr 1|Orneta|Zamkowa 26 |11-130 Orneta;1101;359;359;14;345;32.61;3.90
107391;280905;Gimnazjum Nr 2|Orneta|Warmińska 11 |11-130 Orneta;1392;521;521;31;490;37.43;5.95
107392;280905;Szkoła Podstawowa Nr 4|Orneta|Kopernika 13 |11-130 Orneta;1514;531;531;17;514;35.07;3.20
107393;280905;Szkoła Podstawowa|Bażyny| 17 |11-130 Orneta;728;225;225;6;219;30.91;2.67
107394;280905;Świetlica wiejska|Henrykowo| 47 |11-130 Orneta;540;215;215;5;210;39.81;2.33
107395;280905;Szkoła Podstawowa|Mingajny| 48 |11-130 Orneta;683;169;169;7;162;24.74;4.14
107396;281001;Urząd Miejski w Mrągowie|Mrągowo|ul. Królewiecka 60A |11-700 Mrągowo;1550;734;734;19;715;47.35;2.59
107397;281001;Powiatowa Stacja Sanitarno-Epidemiologiczna w Mrągowie|Mrągowo|ul. Królewiecka 60B |11-700 Mrągowo;1630;801;801;15;786;49.14;1.87
107398;281001;Zespół Szkół Zawodowych w Mrągowie|Mrągowo|ul. Mrongowiusza 65 |11-700 Mrągowo;808;370;370;7;363;45.79;1.89
107399;281001;Zespół Szkół Nr 4 im. Generała Stefana "Grota" Roweckiego w Mrągowie|Mrągowo|osiedle Mazurskie 12 |11-700 Mrągowo;899;439;439;8;431;48.83;1.82
107400;281001;Zespół Szkół nr 4 im. Generała Stefana "Grota" Roweckiego w Mrągowie|Mrągowo|osiedle Mazurskie 12 |11-700 Mrągowo;1709;864;865;18;846;50.56;2.08
107401;281001;Centrum Kultury i Turystyki w Mrągowie|Mrągowo|ul. Warszawska 26 |11-700 Mrągowo;1665;693;693;18;675;41.62;2.60
107402;281001;Przedszkole Publiczne Nr 1 "Stokrotka" w Mrągowie|Mrągowo|ul. Brzozowa 7 |11-700 Mrągowo;1697;799;799;29;770;47.08;3.63
107403;281001;I Liceum Ogólnokształcące im. Obrońców Westerplatte w Mrągowie|Mrągowo|ul. Piotra Sobczyńskiego 1A |11-700 Mrągowo;1449;736;736;20;716;50.79;2.72
107404;281001;Zespół Szkół Nr 1 w Mrągowie|Mrągowo|ul. Kopernika 2 |11-700 Mrągowo;1828;856;856;17;839;46.83;1.99
107405;281001;Świetlica Socjoterapeutyczna|Mrągowo|ul. Henryka Sienkiewicza 16 |11-700 Mrągowo;1575;773;773;34;739;49.08;4.40
107406;281001;Gimnazjum Nr 2 im. M. Kopernika w Zespole Szkół Nr 1 w Mrągowie|Mrągowo|ul. Kopernika 2C |11-700 Mragowo;914;433;433;9;424;47.37;2.08
107407;281001;Gimnazjum Nr 2 im. M. Kopernika w Zespole Szkół Nr 1 w Mrągowie|Mrągowo|ul. Kopernika 2C |11-700 Mrągowo;1682;786;786;16;770;46.73;2.04
107408;281001;Szpital Mrągowski im.Michała Kajki Sp. z o.o. w Mrągowie|Mrągowo|Wolności 3 |11-700 Mrągowo;44;18;18;0;18;40.91;0.00
107409;281002;Hala Sportowa w Mikołajkach|Mikołajki|ul. Papieża Jana Pawła II 7 |11-730 Mikołajki;1380;635;635;20;615;46.01;3.15
107410;281002;Urząd Miasta i Gminy w Mikołajkach|Mikołajki|ul. Kolejowa 7 |11-730 Mikołajki;1654;720;720;28;692;43.53;3.89
107411;281002;Zespół Oświatowy w Mikołajkach|Mikołajki|ul. Papieża Jana Pawła II 7 |11-730 Mikołajki;997;345;345;20;325;34.60;5.80
107412;281002;Szkoła Podstawowa w Olszewie|Olszewo| 20 |11-730 Mikołajki;621;160;160;12;148;25.76;7.50
107413;281002;Szkoła Podstawowa w Woźnicach|Woźnice| 11a |11-730 Mikołajki;752;235;235;11;224;31.25;4.68
107414;281002;Zespół Szkół w Baranowie|Baranowo| 29 |11-730 Mikołajki;1199;415;415;16;399;34.61;3.86
107415;281002;Ewangelicki Dom Opieki "ARKA" w Mikołajkach|Mikołajki|Plac Kościelny 5A |11-730 Mikołajki;94;35;35;10;25;37.23;28.57
107416;281003;Świetlica Wiejska w Grabowie|Grabowo| 28 |11-700 Mrągowo;871;288;288;10;278;33.07;3.47
107417;281003;Zespół Szkół Nr 1 w Mrągowie|Mrągowo|ul. Kopernika 2A |11-700 Mrągowo;1007;432;432;13;419;42.90;3.01
107418;281003;Świetlica Wiejska w Zalcu|Zalec| 17 |11-700 Mrągowo;892;247;247;6;241;27.69;2.43
107419;281003;Szkoła Podstawowa w Bożem|Boże| 18 |11-700 Mrągowo;1033;265;265;11;254;25.65;4.15
107420;281003;Zespół Szkół w Szestnie|Szestno| 18 |11-700 Mrągowo;894;281;281;23;258;31.43;8.19
107421;281003;Urząd Gminy Mrągowo|Mrągowo|ul. Królewiecka 60A |11-700 Mrągowo;453;170;170;10;160;37.53;5.88
107422;281003;Zespół Szkół w Marcinkowie|Marcinkowo| 27 |11-700 Mrągowo;1084;503;503;11;492;46.40;2.19
107423;281004;Szkoła Podstawowa w Nawiadach|Nawiady| 31 |11-710 Piecki;644;162;164;5;157;25.16;3.09
107424;281004;Szkoła Podstawowa w Nawiadach|Nawiady| 31 |11-710 Piecki;574;205;205;9;196;35.71;4.39
107425;281004;Szkoła Podstawowa w Krutyni|Krutyń| 23 |11-710 Piecki;427;153;153;5;148;35.83;3.27
107426;281004;Szkoła Podstawowa w Dłużcu|Dłużec| 17 1|11-710 Piecki;384;148;148;9;139;38.54;6.08
107427;281004;Szkoła Podstawowa w Starych Kiełbonkach|Stare Kiełbonki| 14 |11-710 Piecki;428;124;124;4;120;28.97;3.23
107428;281004;Lokal Świetlicy Wiejskiej w Lipowie|Lipowo| 18 2|11-710 Piecki;419;145;145;8;137;34.61;5.52
107429;281004;Szkoła Podstawowa im. Karola Wojtyły w Pieckach|Piecki|ul. Zwycięstwa 23 |11-710 Piecki;799;233;233;18;215;29.16;7.73
107430;281004;Gminny Ośrodek Kultury, Sportu i Rekreacji "Pegaz" w Pieckach|Piecki|ul. Zwycięstwa 6 |11-710 Piecki;1669;686;686;30;656;41.10;4.37
107431;281004;Samorządowe Przedszkole w Pieckach|Piecki|os. 35-lecia PRL 18 |11-710 Piecki;890;372;372;14;358;41.80;3.76
107432;281005;Publiczne Gimnazjum w Sorkwitach|Sorkwity|ul. Szkolna 17b |11-731 Sorkwity;733;278;278;13;265;37.93;4.68
107433;281005;Publiczne Gimnazjum w Sorkwitach|Sorkwity|ul. Szkolna 17b |11-731 Sorkwity;716;240;240;16;224;33.52;6.67
107434;281005;Świetlica Wiejska w Warpunach|Warpuny|ul. Wolności 12A |11-731 Sorkwity;1198;426;426;16;410;35.56;3.76
107435;281005;Biblioteka w Rybnie|Rybno|ul. Długa 20 |11-731 Sorkwity;723;269;269;21;248;37.21;7.81
107436;281005;Świetlica Wiejska w Choszczewie|Choszczewo| 49a |11-731 Sorkwity;330;99;99;5;94;30.00;5.05
107437;281101;Gimnazjum w Janowcu Kościelnym|Janowiec Kościelny| 61 |13-111 Janowiec Kościelny;619;263;263;8;255;42.49;3.04
107438;281101;Gimnazjum w Janowcu Kościelnym|Janowiec Kościelny| 61 |13-111 Janowiec Kościelny;564;201;201;5;196;35.64;2.49
107439;281101;Gimnazjum w Janowcu Kościelnym|Janowiec Kościelny| 61 |13-111 Janowiec Kościelny;520;155;155;10;145;29.81;6.45
107440;281101;Świetlica Wiejska w Nowej Wsi Wielkiej|Nowa Wieś Wielka| 44 |13-111 Janowiec Kościelny;515;177;177;6;171;34.37;3.39
107441;281101;Świetlica Wiejska w Safronce|Safronka| 23 |13-111 Janowiec Kościelny;424;103;103;6;97;24.29;5.83
107442;281102;Zespół Szkół|Janowo|ul. Chorzelska 21 |13-113 Janowo;519;214;214;17;197;41.23;7.94
107443;281102;Zespół Szkół|Janowo|ul. Chorzelska 21 |13-113 Janowo;581;210;210;2;208;36.14;0.95
107444;281102;Szkoła Podstawowa|Muszaki| 39 |13-113 Janowo;735;293;293;14;279;39.86;4.78
107445;281102;Budynek byłej szkoły podstawowej|Róg| 44 |13-113 Janowo;330;91;91;6;85;27.58;6.59
107446;281103;Zespół Szkolno - Przedszkolny|Kozłowo|ul. Szkolna 6 |13-124 Kozłowo;637;193;193;10;183;30.30;5.18
107447;281103;Zespół Szkolno - Przedszkolny|Kozłowo|ul. Szkolna 6 |13-124 Kozłowo;1003;391;391;18;373;38.98;4.60
107448;281103;Szkoła Podstawowa|Zaborowo| 2 |13-124 Kozłowo;712;156;156;10;146;21.91;6.41
107449;281103;Świetlica Wiejska|Krokowo| 30A |13-124 Kozłowo;386;107;107;9;98;27.72;8.41
107450;281103;Zespół Szkół|Szkotowo| 51 |13-124 Kozłowo;1159;245;245;29;216;21.14;11.84
107451;281103;Zespół Szkół|Rogóż| 4 |13-124 Kozłowo;895;260;260;16;244;29.05;6.15
107452;281104;Zespół Szkół Nr 2 w Nidzicy|Nidzica|ul. Barke 3 |13-100 Nidzica;2192;1018;1018;25;993;46.44;2.46
107453;281104;Przedszkole Nr 4 w Nidzicy|Nidzica|ul. Krzywa 7 |13-100 Nidzica;861;343;343;22;321;39.84;6.41
107454;281104;Zespół Szkół Nr 1 w Nidzicy|Nidzica|ul. Kopernika 1 |13-100 Nidzica;1612;762;762;21;741;47.27;2.76
107455;281104;Zespół Szkół Ogólnokształcących w Nidzicy|Nidzica|ul. Władysława Jagiełły 1 |13-100 Nidzica;1696;827;827;42;785;48.76;5.08
107456;281104;Zespół Szkół Zawodowych i Ogólnokształcących w Nidzicy|Nidzica|ul. Władysława Jagiełły 3 |13-100 Nidzica;1571;708;708;29;679;45.07;4.10
107457;281104;Centrum Rehabilitacyjno-Edukacyjne w Nidzicy|Nidzica|ul. Krzywa 8 |13-100 Nidzica;934;441;441;11;430;47.22;2.49
107458;281104;Przedszkole Nr 2 w Nidzicy|Nidzica|ul. 1 Maja 36 |13-100 Nidzica;715;359;359;17;342;50.21;4.74
107459;281104;Zespół Szkół Nr 3 w Nidzicy|Nidzica|ul. 1 Maja 42 |13-100 Nidzica;1784;859;859;20;839;48.15;2.33
107460;281104;Świetlica wiejska w Wietrzychowie|Wietrzychowo| 19 |13-100 Nidzica;896;226;226;14;212;25.22;6.19
107461;281104;Świetlica wiejska w Orłowie|Orłowo| 6 |13-100 Nidzica;1034;308;308;16;292;29.79;5.19
107462;281104;Szkoła Podstawowa w Napiwodzie|Napiwoda| 25A |13-100 Nidzica;766;263;263;16;247;34.33;6.08
107463;281104;Świetlica wiejska w Rozdrożu|Rozdroże| 29A |13-100 Nidzica;644;226;226;17;209;35.09;7.52
107464;281104;Miejski Ośrodek Pomocy Społecznej w Nidzicy|Nidzica|ul. Kolejowa 5 |13-100 Nidzica;692;230;230;6;224;33.24;2.61
107465;281104;Świetlica wiejska w Piotrowicach|Piotrowice| 17 |13-100 Nidzica;675;211;211;19;192;31.26;9.00
107466;281104;Świetlica wiejska w Kanigowie|Kanigowo| 18 |13-100 Nidzica;871;343;343;18;325;39.38;5.25
107467;281104;Zespół Opieki Zdrowotnej w Nidzicy|Nidzica|ul. Mickiewicza 25 |13-100 Nidzica;72;12;12;1;11;16.67;8.33
107468;281201;Gimnazjum im. Filomatów Nowomiejskich|Nowe Miasto Lubawskie|ul. Działyńskich 14 |13-300 Nowe Miasto Lubawskie;1124;450;450;22;428;40.04;4.89
107469;281201;Miejski Ośrodek Pomocy Społecznej|Nowe Miasto Lubawskie|Janusza Korczaka 4 |13-300 Nowe Miasto Lubawskie;1584;796;796;17;779;50.25;2.14
107470;281201;Szkoła Podstawowa Nr 1 im. Jana Pawła II|Nowe Miasto Lubawskie|ul.Jagiellońska 3 |13-300 Nowe Miasto Lubawskie;1882;959;959;28;931;50.96;2.92
107471;281201;Cech Rzemiosł Różnych i Przedsiębiorczości|Nowe Miasto Lubawskie|Grunwaldzka 7 |13-300 Nowe Miasto Lubawskie;1775;852;852;7;845;48.00;0.82
107472;281201;Szkoła Podstawowa Nr 2 im. Janusza Korczaka|Nowe Miasto Lubawskie|Tysiąclecia 33 |13-300 Nowe Miasto Lubawskie;1088;559;559;19;540;51.38;3.40
107473;281201;Zespół Szkół im. Cypriana Kamila Norwida|Nowe Miasto Lubawskie|3 Maja 24 |13-300 Nowe Miasto Lubawskie;1172;563;563;18;545;48.04;3.20
107474;281201;Szpital Powiatowy w Nowym Mieście Lubawskim sp. z o.o.|Nowe Miasto Lubawskie|Mickiewicza 10 |13-300 ;40;7;7;0;7;17.50;0.00
107475;281202;Gminny Ośrodek Kultury w Biskupcu|Biskupiec|Rynek 4 |13-340 Biskupiec;2118;858;858;66;792;40.51;7.69
107476;281202;Szkoła Podstawowa w Krotoszynach|Krotoszyny| 4a |13-330 Krotoszyny;1398;584;584;28;556;41.77;4.79
107477;281202;Szkoła Podstawowa w Lipinkach|Lipinki| 7 |13-334 Łąkorz;1052;400;400;20;380;38.02;5.00
107478;281202;Szkoła Podstawowa w Łąkorzu|Łąkorz| 99 |13-334 Łąkorz;800;343;343;16;327;42.88;4.66
107479;281202;Szkoła Podstawowa w Ostrowitem|Ostrowite| 34 |13-334 Łąkorz;784;272;272;14;258;34.69;5.15
107480;281202;Sala Wiejska w Podlasku|Podlasek| 10a |13-340 Biskupiec;743;245;245;23;222;32.97;9.39
107481;281202;Szkoła Podstawowa w Szwarcenowie|Szwarcenowo| 36 |13-340 Biskupiec;706;349;349;16;333;49.43;4.58
107482;281203;Zespół Szkół w Nowym Grodzicznie|Nowe Grodziczno| 83 |13-324 Grodziczno;1628;783;783;37;746;48.10;4.73
107483;281203;Szkoła Podstawowa w Zajączkowie|Zajączkowo| 21A |13-324 Grodziczno;462;174;174;10;164;37.66;5.75
107484;281203;Szkoła Podstawowa w Zwiniarzu|Zwiniarz| 4A |13-324 Grodziczno;413;177;177;11;166;42.86;6.21
107485;281203;Szkoła Podstawowa w Ostaszewie|Ostaszewo| 16A |13-324 Grodziczno;738;257;257;18;239;34.82;7.00
107486;281203;Szkoła Podstawowa w Boleszynie|Boleszyn| 12B |13-324 Grodziczno;433;175;175;14;161;40.42;8.00
107487;281203;Zespół Szkół w Mrocznie|Mroczno| 22A |13-324 Grodziczno;1276;530;530;35;495;41.54;6.60
107488;281204;Szkoła Podstawowa im. Orła Białego w Brzoziu Lubawskim|Brzozie Lubawskie| 43a |13-306 Kurzętnik;1205;535;535;15;520;44.40;2.80
107489;281204;Urząd Gminy w Kurzętniku|Kurzętnik|ul. Grunwaldzka 39 |13-306 Kurzętnik;1451;618;618;30;588;42.59;4.85
107490;281204;Szkoła Podstawowa im. Przyjaciół Ziemii|Marzęcice|ul. Szkolna 21 |13-306 Kurzętnik;1490;650;650;22;628;43.62;3.38
107491;281204;Szkoła Podstawowa w Tereszewie|Tereszewo| 9a |13-306 Kurzętnik;1356;478;478;29;449;35.25;6.07
107492;281204;Szkoła Podstawowa w Kurzętniku|Kurzętnik|Grunwaldzka 37 |13-306 Kurzętnik;1505;705;705;36;669;46.84;5.11
107493;281205;Świetlica Wiejska w Pacółtowie|Pacółtowo| 19 |13-300 Nowe Miasto Lubawskie;885;371;371;23;348;41.92;6.20
107494;281205;Zespół Szkół im. Rodu Działyńskich w Bratianie|Bratian|ul. Szkolna 2 |13-300 Nowe Miasto Lubawskie;1217;505;505;28;477;41.50;5.54
107495;281205;Zespół Szkół im. Jana Pawła II w Jamielniku|Jamielnik|Szkolna 10 |13-332 Jamielnik;1136;465;465;18;447;40.93;3.87
107496;281205;Szkoła Podstawowa w Skarlinie|Skarlin| 72 |13-300 Nowe Miasto Lubawskie;684;289;289;8;281;42.25;2.77
107497;281205;Szkoła Podstawowa w Radomnie|Radomno| 18 |13-304 Radomno;982;403;403;25;378;41.04;6.20
107498;281205;Gminne Centrum Kultury w Mszanowie|Mszanowo|Podleśna 1 |13-300 Nowe Miasto Lubawskie;753;342;342;15;327;45.42;4.39
107499;281205;Szkoła Podstawowa im. ks. Kazimierza Wróblewskiego w Gwiździnach|Gwiździny| 58 |13-300 Nowe Miasto Lubawskie;598;244;244;17;227;40.80;6.97
107500;281303;Świetlica Wiejska w Lakielach|Lakiele| 16 |19-420 Kowale Oleckie;516;79;79;1;78;15.31;1.27
107501;281303;Publiczne Gimnazjum w Kowalach Oleckich|Kowale Oleckie|ul. Witosa 6 |19-420 Kowale Oleckie;1146;321;321;15;306;28.01;4.67
107502;281303;Szkoła Podstawowa im. Jana Pawła II w Kowalach Oleckich|Kowale Oleckie|ul. Kościuszki 88 |19-420 Kowale Oleckie;739;222;222;13;209;30.04;5.86
107503;281303;Szkoła Podstawowa w Stożnem|Stożne| 6 |19-420 Kowale Oleckie;772;264;264;8;256;34.20;3.03
107504;281303;Szkoła Podstawowa im. Marii Konopnickiej w Sokółkach|Sokółki| 47 |19-420 Kowale Oleckie;963;247;247;17;230;25.65;6.88
107505;281303;Dom Pomocy Społecznej w Kowalach Oleckich|Kowale Oleckie|Witosa 8 |19-420 Kowale Oleckie;35;25;25;3;22;71.43;12.00
107506;281304;Zespół Szkół Licealnych i Zawodowych|Olecko|ul. Gołdapska 29 |19-400 Olecko;878;390;390;14;376;44.42;3.59
107507;281304;Gimnazjum Nr 2 im. Mikołaja Kopernika|Olecko|ul. Słowiańska 1 |19-400 Olecko;730;333;333;4;329;45.62;1.20
107508;281304;Gimnazjum Nr 2 im. Mikołaja Kopernika|Olecko|ul. Słowiańska 1 |19-400 Olecko;842;406;406;2;404;48.22;0.49
107509;281304;Przedszkole z Oddziałami Integracyjnymi|Olecko|ul. Zielona 1 |19-400 Olecko;858;370;370;3;367;43.12;0.81
107510;281304;Plac Wolności 2|Olecko|ul. Plac Wolności 2 |19-400 Olecko;727;302;302;4;298;41.54;1.32
107511;281304;Szkoła Podstawowa Nr 3 im. Jana Pawła II|Olecko|ul. Kolejowa 33 |19-400 Olecko;842;385;385;4;381;45.72;1.04
107512;281304;Niepubliczny Zakład Opieki Zdrowotnej Poradnia Terapii Uzależnienia od Alkoholu, Narkotyków i Współuzależnienia|Olecko|ul. Nocznickiego 15 |19-400 Olecko;750;371;371;12;359;49.47;3.23
107513;281304;Regionalny Ośrodek Kultury w Olecku - "Mazury Garbate"|Olecko|ul. Plac Wolności 22 |19-400 Olecko;769;302;302;6;296;39.27;1.99
107514;281304;Szkoła Podstawowa Nr 3 im. Jana Pawła II|Olecko|ul. Kolejowa 33 |19-400 Olecko;783;365;365;11;354;46.62;3.01
107515;281304;I Liceum Ogólnokształcące im. Jana Kochanowskiego|Olecko|ul. Kościuszki 29 |19-400 Olecko;881;436;436;6;430;49.49;1.38
107516;281304;I Liceum Ogólnokształcące im. Jana Kochanowskiego|Olecko|ul. Kościuszki 29 |19-400 Olecko;763;360;360;5;355;47.18;1.39
107517;281304;Szkoła Podstawowa Nr 1 im. Henryka Sienkiewicza|Olecko|ul. Kościuszki 20 |19-400 Olecko;799;394;394;6;388;49.31;1.52
107518;281304;Szkoła Podstawowa Nr 1 im. Henryka Sienkiewicza|Olecko|ul. Kościuszki 20 |19-400 Olecko;811;346;346;7;339;42.66;2.02
107519;281304;Nadleśnictwo Olecko|Olecko|ul. Kościuszki 32 |19-400 Olecko;598;178;178;8;170;29.77;4.49
107520;281304;Zespół Szkół|Olecko|Osiedle Siejnik I 14 |19-400 Olecko;869;358;358;9;349;41.20;2.51
107521;281304;Zespół Szkół|Olecko|Osiedle Siejnik I 14 |19-400 Olecko;822;357;357;4;353;43.43;1.12
107522;281304;Zespół Szkół w Judzikach|Judziki| 5 |19-400 Olecko;849;270;270;9;261;31.80;3.33
107523;281304;Świetlica OSP w Szczecinkach|Szczecinki| 9 |19-400 Olecko;700;184;184;7;177;26.29;3.80
107524;281304;Świetlica w Olszewie|Olszewo| 9 |19-400 Olecko;852;241;241;7;234;28.29;2.90
107525;281304;Świetlica w Kukowie|Kukowo| 21A |19-400 Olecko;848;215;215;4;211;25.35;1.86
107526;281304;Szkoła Podstawowa im. Marszałka Józefa Piłsudskiego w Gąskach|Gąski| 14 |19-400 Olecko;851;263;263;4;259;30.90;1.52
107527;281304;"OLMEDICA" w Olecku Sp. z o.o.|Olecko|Gołdapska 1 |19-400 Olecko;72;13;13;0;13;18.06;0.00
107528;281304;Samodzielny Publiczny Zespół Zakładów Opieki Długoterminowej w Olecku-Kolonii|Olecko-Kolonia| 4 |19-400 Olecko;60;6;6;0;6;10.00;0.00
107529;281305;Urząd Gminy|Świętajno| 104 |19-411 Świętajno;1177;379;379;20;359;32.20;5.28
107530;281305;Środowiskowy Dom Samopomocy|Wronki| 36 |19-411 Świętajno;622;175;175;2;173;28.14;1.14
107531;281305;Szkoła Podstawowa|Mazury| 6 |19-411 Świętajno;486;151;151;1;150;31.07;0.66
107532;281305;Szkoła Podstawowa|Cichy| 3 |19-411 Świętajno;521;162;162;9;153;31.09;5.56
107533;281305;Wiejskie Centrum Inicjatyw|Giże| 7 |19-411 Świętajno;448;117;117;5;112;26.12;4.27
107534;281306;Szkoła Podstawowa|Wieliczki|ul. Lipowa 10 |19-404 Wieliczki;565;246;246;5;241;43.54;2.03
107535;281306;Szkoła Podstawowa|Wieliczki|ul. Lipowa 10 |19-404 Wieliczki;571;180;180;9;171;31.52;5.00
107536;281306;Budynek byłej szkoły|Krupin| 44 |19-404 Wieliczki;415;137;137;4;133;33.01;2.92
107537;281306;Szkoła Podstawowa|Cimochy|ul. Szkolna 15 |19-404 Wieliczki;649;248;248;11;237;38.21;4.44
107538;281306;Świetlica Wiejska|Kleszczewo| 10 |19-404 Wieliczki;520;130;130;7;123;25.00;5.38
107539;281401;Lokal Szkoły Podstawowej|Barczewo|ul. Wojska Polskiego 36 |11-010 Barczewo;800;330;330;11;319;41.25;3.33
107540;281401;Lokal Urzędu Stanu Cywilnego|Barczewo|ul. Kopernika 10 |11-010 Barczewo;1016;482;482;17;465;47.44;3.53
107541;281401;Lokal Przedszkola Miejskiego|Barczewo|ul. Słowackiego 7 |11-010 Barczewo;1000;517;517;7;510;51.70;1.35
107542;281401;Lokal Centrum Kulturalno-Bibliotecznego w Barczewie|Barczewo|ul. Słowackiego 5 |11-010 Barczewo;810;450;450;6;444;55.56;1.33
107543;281401;Lokal Centrum Kulturalno-Bibliotecznego w Barczewie|Barczewo|ul. Słowackiego 5 |11-010 Barczewo;808;359;359;8;351;44.43;2.23
107544;281401;Lokal Zespołu Szkół w Barczewie|Barczewo|ul. Północna 14 |11-010 Barczewo;1130;479;479;21;458;42.39;4.38
107545;281401;Lokal Zespołu Szkolno-Przedszkolnego w Łęgajnach|Łęgajny|ul. Ogrodowa 7 |11-010 Barczewo;1042;445;445;28;417;42.71;6.29
107546;281401;Lokal Szkoły Podstawowej w Barczewku|Barczewko| 35 |11-010 Barczewo;682;230;230;12;218;33.72;5.22
107547;281401;Lokal Niepublicznego Zespołu Szkół i Placówek w Wipsowie|Wipsowo| 63 |11-010 Barczewo;742;233;233;9;224;31.40;3.86
107548;281401;Lokal Niepublicznego Zespołu Szkół i Placówek w Ramsowie|Ramsowo| 87 |11-010 Barczewo;735;219;219;9;210;29.80;4.11
107549;281401;Lokal Szkoły Podstawowej w Bartołtach Wielkich|Bartołty Wielkie| 5 |11-010 Barczewo;413;132;132;3;129;31.96;2.27
107550;281401;Lokal świetlicy wiejskiej w Jedzbarku|Jedzbark| 64 |11-010 Barczewo;557;173;173;7;166;31.06;4.05
107551;281401;Lokal Stacji Doświadczalnej Oceny Odmian w Wrócikowie|Wrócikowo| 16 |11-010 Barczewo;535;269;269;11;258;50.28;4.09
107552;281401;Lokal Niepublicznego Zespołu Szkół i Placówek w Kronowie|Kronowo| 6 |11-010 Barczewo;355;98;98;10;88;27.61;10.20
107553;281401;Lokal w Domu Parafialnym w Wójtowie|Wójtowo|ul. Kwiatowa 19 |11-010 Barczewo;937;579;579;19;560;61.79;3.28
107554;281401;Lokal świetlicy wiejskiej w Ruszajnach|Ruszajny| 34 |11-010 Barczewo;634;254;254;13;241;40.06;5.12
107555;281401;Lokal świetlicy wiejskiej w Nikielkowie|Nikielkowo|ul. Jana Grzymały 8 |10-376 Olsztyn;425;266;266;3;263;62.59;1.13
107556;281401;Lokal Niepublicznego Zespołu Szkół i Placówek w Lamkowie|Lamkowo| 29 |11-010 Barczewo;487;148;148;13;135;30.39;8.78
107557;281401;Lokal świetlicy wiejskiej w Skajbotach|Skajboty| 32 |11-010 Barczewo;288;105;105;4;101;36.46;3.81
107558;281401;Lokal Domu Pomocy Społecznej|Barczewo|ul.Kraszewskiego 17 |11-010 Barczewo;126;20;20;3;17;15.87;15.00
107559;281401;Lokal Świetlicy Zakładu Karnego|Barczewo|ul.Klasztorna 7 |11-010 Barczewo;575;301;301;38;263;52.35;12.62
107560;281401;Lokal Szpitala Pomocy Maltańskiej Oddział w Barczewie|Barczewo|ul.Niepodległości 9 |11-010 Barczewo;56;1;1;0;1;1.79;0.00
107561;281402;Biskupiecki Dom Kultury|Biskupiec|ul. Jana Matejki 5 |11-300 Biskupiec;968;457;457;11;446;47.21;2.41
107562;281402;Biskupiecki Dom Kultury|Biskupiec|ul. Jana Matejki 5 |11-300 Biskupiec;1068;468;468;12;456;43.82;2.56
107563;281402;Szkoła Podstawowa Nr 3|Biskupiec|ul. Bolesława Chrobrego 15 |11-300 Biskupiec;1126;479;479;19;460;42.54;3.97
107564;281402;Szkoła Podstawowa Nr 2|Biskupiec|ul. Adama Mickiewicza 8 |11-300 Biskupiec;865;407;407;14;393;47.05;3.44
107565;281402;Szkoła Podstawowa Nr 2|Biskupiec|ul. Adama Mickiewicza 8 |11-300 Biskupiec;1141;509;509;9;500;44.61;1.77
107566;281402;Szkoła Podstawowa Nr 2|Biskupiec|ul. Adama Mickiewicza 8 |11-300 Biskupiec;821;376;376;7;369;45.80;1.86
107567;281402;Gimnazjum Nr 1|Biskupiec|ul. Ludowa 5 |11-300 Biskupiec;1247;591;591;17;574;47.39;2.88
107568;281402;Gimnazjum Nr 1|Biskupiec|ul. Ludowa 5 |11-300 Biskupiec;1190;610;610;10;600;51.26;1.64
107569;281402;Szkoła Podstawowa Nr 3|Biskupiec|ul. Bolesława Chrobrego 15 |11-300 Biskupiec;923;285;285;10;275;30.88;3.51
107570;281402;Zespół Szkół w Czerwonce|Czerwonka| 15 |11-300 Biskupiec;1167;370;370;12;358;31.71;3.24
107571;281402;Świetlica Wiejska|Biesowo| 26 |11-300 Biskupiec;325;142;142;5;137;43.69;3.52
107572;281402;Świetlica Wiejska|Stryjewo| 28A |11-300 Biskupiec;621;206;206;9;197;33.17;4.37
107573;281402;Społeczna Szkoła Podstawowa|Bredynki| 24 |11-300 Biskupiec;657;211;211;6;205;32.12;2.84
107574;281402;Szkoła Podstawowa Nr 3|Biskupiec|ul. Bolesława Chrobrego 15 |11-300 Biskupiec;306;90;90;3;87;29.41;3.33
107575;281402;Świetlica Wiejska|Borki Wielkie| 37 |11-300 Biskupiec;495;158;158;12;146;31.92;7.59
107576;281402;Zespół Szkół|Kobułty| 80 |11-300 Biskupiec;631;178;178;8;170;28.21;4.49
107577;281402;Szkoła Podstawowa Nr 3|Biskupiec|ul. Bolesława Chrobrego 15 |11-300 Biskupiec;343;63;63;3;60;18.37;4.76
107578;281402;Świetlica Wiejska|Dymer| 8 |11-300 Biskupiec;498;155;155;17;138;31.12;10.97
107579;281402;Świetlica Wiejska|Rzeck| 79 |11-300 Biskupiec;879;191;191;6;185;21.73;3.14
107580;281402;Szpital Powiatowy im. Jana Mikulicza w Biskupcu|Biskupiec|Armii Krajowej 8 |11-300 Biskupiec;62;37;37;3;34;59.68;8.11
107581;281403;Remiza Ochotniczej Straży Pożarnej w Dobrym Mieście|Dobre Miasto|ul. Gen. T. Kościuszki 2D |11-040 Dobre Miasto;856;431;431;5;426;50.35;1.16
107582;281403;Gimnazjum Publiczne w Dobrym Mieście|Dobre Miasto|ul. Garnizonowa 20 |11-040 Dobre Miasto;1281;654;654;16;638;51.05;2.45
107583;281403;Centrum Kulturalno-Biblioteczne w Dobrym Mieście|Dobre Miasto|ul. Górna 1a |11-040 Dobre Miasto;1549;635;635;21;614;40.99;3.31
107584;281403;Zespół Szkół w Dobrym Mieście|Dobre Miasto|ul. Fabryczna 6 |11-040 Dobre Miasto;931;426;426;12;414;45.76;2.82
107585;281403;Szkoła Podstawowa Nr 2 w Dobrym Mieście|Dobre Miasto|ul. Gdańska 13 |11-040 Dobre Miasto;1768;792;792;20;772;44.80;2.53
107586;281403;Przedszkole Samorządowe Nr 1 w Dobrym Mieście|Dobre Miasto|ul. Grudziądzka 9A |11-040 Dobre Miasto;1926;992;992;34;958;51.51;3.43
107587;281403;Szkoła Podstawowa w Barcikowie|Barcikowo| 12a |11-040 Dobre Miasto;500;164;164;17;147;32.80;10.37
107588;281403;Świetlica Wiejska|Cerkiewnik| 16 |11-040 Dobre Miasto;462;184;184;4;180;39.83;2.17
107589;281403;Świetlica Wiejska|Głotowo| 44b |11-040 Dobre Miasto;376;170;170;9;161;45.21;5.29
107590;281403;Świetlica Wiejska|Knopin| 39 |11-040 Dobre Miasto;345;133;133;11;122;38.55;8.27
107591;281403;Świetlica Wiejska|Łęgno| 18 |11-040 Dobre Miasto;520;208;208;12;196;40.00;5.77
107592;281403;Świetlica Wiejska|Praslity| 20 |11-040 Dobre Miasto;328;86;86;3;83;26.22;3.49
107593;281403;Środowiskowy Dom Samopomocy w Piotraszewie|Piotraszewo| 7 |11-040 Dobre Miasto;346;73;73;4;69;21.10;5.48
107594;281403;Świetlica Wiejska|Smolajny| 4 |11-040 Dobre Miasto;531;232;232;10;222;43.69;4.31
107595;281403;Szkoła Filialna w Orzechowie|Orzechowo| 26 |11-040 Dobre Miasto;416;124;124;5;119;29.81;4.03
107596;281403;Szkoła Filialna w Jesionowie|Jesionowo| 10 |11-040 Dobre Miasto;585;164;164;4;160;28.03;2.44
107597;281403;Zespół Zakładów Opieki Zdrowotnej w Dobrym Mieście|Dobre Miasto|Grunwaldzka 10 B |11-040 Dobre Miasto;75;0;0;0;0;0.00;-99
107598;281403;Dom Pomocy Społecznej w Dobrym Mieście|Dobre Miasto|Łużycka 73 |11-040 Dobre Miasto;16;6;6;0;6;37.50;0.00
107599;281404;Urząd Gminy Dywity segment C|Dywity|ul. Olsztyńska 32 |11-001 Dywity;1278;753;755;13;740;58.92;1.73
107600;281404;Urząd Gminy Dywity segment C|Dywity|ul. Olsztyńska 32 |11-001 Dywity;1183;701;701;11;690;59.26;1.57
107601;281404;Świetlica Wiejska w Spręcowie|Spręcowo| 106 |11-001 Dywity;960;396;396;13;383;41.25;3.28
107602;281404;Szkoła Podstawowa w Tuławkach|Tuławki| 31 |11-001 Dywity;718;315;315;3;312;43.87;0.95
107603;281404;Świetlica Wiejska w Gradkach|Gradki| 32b |11-001 Dywity;577;170;170;11;159;29.46;6.47
107604;281404;Świetlica Wiejska w Barkwedzie|Barkweda| 14 |11-001 Dywity;773;324;324;15;309;41.91;4.63
107605;281404;Świetlica Wiejska w Słupach|Słupy| 44 |10-381 Olsztyn;670;387;387;10;377;57.76;2.58
107606;281404;Świetlica Wiejska w Kieźlinach|Kieźliny|ul. Ks. Jakuba Jagałły 3a |10-371 Olsztyn;1485;895;895;13;882;60.27;1.45
107607;281404;Świetlica Wiejska w Różnowie|Różnowo| 17 |11-001 Dywity;976;545;545;8;537;55.84;1.47
107608;281404;Dom Opieki Społecznej "Dom Nad Doliną" w Różnowie|Różnowo| 70A |11-001 Dywity;42;29;29;0;29;69.05;0.00
107609;281405;Świetlica Wiejska "Pod Lipą" w Gronitach|Gronity|ul. Olsztyńska 21 |11-036 Gietrzwałd;951;542;542;7;535;56.99;1.29
107610;281405;Szkoła Podstawowa w Sząbruku|Sząbruk|ul. Samulowskiego 1 |11-036 Gietrzwałd;763;385;385;5;380;50.46;1.30
107611;281405;Świetlica Wiejska w Unieszewie|Unieszewo|ul. Lipowa 2 |11-036 Gietrzwałd;677;273;273;6;267;40.32;2.20
107612;281405;Gietrzwałdzki Ośrodek Kultury w Gietrzwałdzie|Gietrzwałd|ul. Kościelna 1 |11-036 Gietrzwałd;1377;666;666;14;652;48.37;2.10
107613;281405;Szkoła Podstawowa w Biesalu|Biesal| 59 |11-036 Gietrzwałd;1149;387;387;18;369;33.68;4.65
107614;281405;Dom Pomocy Społecznej w Grazymach|Grazymy|- 1 -|11-036 Gietrzwałd;49;25;25;0;25;51.02;0.00
107615;281406;Ośrodek Sportu i Rekreacji|Jeziorany|ul. Konopnickiej 13E |11-320 Jeziorany;1340;548;548;22;526;40.90;4.01
107616;281406;Zespół Szkół Ponadgimnazjalnych|Jeziorany|ul. Mickiewicza 11 |11-320 Jeziorany;1182;368;368;25;343;31.13;6.79
107617;281406;Świetlica Wiejska|Wójtówko| 17 2|11-320 Jeziorany;415;121;121;16;105;29.16;13.22
107618;281406;Miejski Ośrodek Kultury|Jeziorany|ul. Konopnickiej 4 |11-320 Jeziorany;1644;506;506;26;480;30.78;5.14
107619;281406;Szkoła Podstawowa|Radostowo| 58 |11-320 Jeziorany;884;279;279;16;263;31.56;5.73
107620;281406;Świetlica Wiejska|Franknowo| 14A |11-320 Jeziorany;717;190;190;12;178;26.50;6.32
107621;281406;Dom Pomocy Społecznej|Jeziorany|ul. Kajki 49 |11-320 Jeziorany;92;41;41;11;30;44.57;26.83
107622;281406;Oddział Zewnętrzny w Kikitach Zakładu Karnego w Barczewie|Kikity| 33S |11-311 Kolno;119;78;78;20;58;65.55;25.64
107623;281407;Szkoła Podstawowa w Jonkowie|Jonkowo|ul. Ks. Jana Hanowskiego 29 |11-042 Jonkowo;1583;850;850;21;829;53.70;2.47
107624;281407;Szkoła Podstawowa we Wrzesinie|Wrzesina| 43 |11-042 Jonkowo;1215;507;507;16;491;41.73;3.16
107625;281407;Szkoła Podstawowa w Nowym Kawkowie|Nowe Kawkowo| 25 |11-042 Jonkowo;684;270;270;9;261;39.47;3.33
107626;281407;Szkoła Podstawowa w Jonkowie|Jonkowo|ul. Ks. Jana Hanowskiego 29 |11-042 Jonkowo;1142;490;490;12;478;42.91;2.45
107627;281407;Szkoła Podstawowa w Jonkowie|Jonkowo|ul. Ks. Jana Hanowskiego 29 |11-042 Jonkowo;836;395;395;14;381;47.25;3.54
107628;281407;Dom Pomocy Społecznej|Jonkowo|Lipowa 9 |11-042 Jonkowo;42;20;20;2;18;47.62;10.00
107629;281408;Gminny Ośrodek Kultury w Kolnie|Kolno| 25b |11-311 Kolno;1021;286;286;19;267;28.01;6.64
107630;281408;Biblioteka Publiczna Gminy Kolno z siedzibą w Lutrach|Lutry| 12 |11-311 Kolno;871;327;327;25;302;37.54;7.65
107631;281408;Gminny Ośrodek Kultury w Kolnie filia w Bęsi pn. "Centrum Kultury w Bęsi"|Bęsia| 24 |11-311 Kolno;851;288;288;15;273;33.84;5.21
107632;281409;Zespół Szkół w Olsztynku|Olsztynek|ul. Zamkowa 6 |11-015 Olsztynek;538;270;270;8;262;50.19;2.96
107633;281409;Zespół Szkół w Olsztynku|Olsztynek|ul. Zamkowa 6 |11-015 Olsztynek;659;246;246;4;242;37.33;1.63
107634;281409;Przedszkole Miejskie w Olsztynku|Olsztynek|ul. Szkolna 9 |11-015 Olsztynek;831;381;381;10;371;45.85;2.62
107635;281409;Przedszkole Miejskie w Olsztynku|Olsztynek|ul. Szkolna 9 |11-015 Olsztynek;723;329;329;9;320;45.50;2.74
107636;281409;I Liceum Ogólnokształcące im. Jacka Kaczmarskiego w Olsztynku|Olsztynek|ul. Klikowicza 4 |11-015 Olsztynek;894;332;332;13;319;37.14;3.92
107637;281409;Gimnazjum im. Noblistów Polskich w Olsztynku|Olsztynek|ul Górna 5 |11-015 Olsztynek;894;344;344;9;335;38.48;2.62
107638;281409;Miejski Ośrodek Pomocy Społecznej w Olsztynku|Olsztynek|ul. Świerczewskiego 19 |11-015 Olsztynek;751;336;336;9;327;44.74;2.68
107639;281409;I Liceum Ogólnokształcące im. Jacka Kaczmarskiego w Olsztynku|Olsztynek|ul. Klikowicza 4 |11-015 Olsztynek;577;273;273;5;268;47.31;1.83
107640;281409;Szkoła Podstawowa w Elgnówku|Elgnówko| 27 |11-015 Olsztynek;284;62;62;3;59;21.83;4.84
107641;281409;Świetlica w Mańkach|Mańki| 5a |11-015 Olsztynek;314;104;104;4;100;33.12;3.85
107642;281409;Świetlica w Mierkach|Mierki| 33a |11-015 Olsztynek;523;193;193;3;190;36.90;1.55
107643;281409;Zakład Rybacki Szwaderki|Swaderki| 13a |11-015 Olsztynek;535;181;181;7;174;33.83;3.87
107644;281409;Świetlica w Kunkach|Kunki| 29 |11-015 Olsztynek;762;246;246;12;234;32.28;4.88
107645;281409;Zespół Szkolno-Przedszkolny w Waplewie|Waplewo| 15 |11-015 Olsztynek;831;295;295;20;275;35.50;6.78
107646;281409;Świetlica w Królikowie|Królikowo| 13a |11-015 Olsztynek;579;214;214;1;213;36.96;0.47
107647;281409;Świetlica w Pawłowie|Pawłowo| 8a |11-015 Olsztynek;298;114;114;3;111;38.26;2.63
107648;281409;Świetlica w Platynach|Platyny| 8a |11-015 Olsztynek;447;92;92;6;86;20.58;6.52
107649;281409;Szkoła Podstawowa w Olsztynku|Olsztynek|ul. Ostródzka 2 |11-015 Olsztynek;297;96;96;2;94;32.32;2.08
107650;281409;Dom Pomocy Społecznej "Zacisze" w Olsztynku|Olsztynek|Park 5 |11-015 Olsztynek;128;37;37;4;33;28.91;10.81
107651;281410;Remiza Ochotniczej Straży Pożarnej w Purdzie|Purda| 12B |11-030 Purda;1675;552;552;18;534;32.96;3.26
107652;281410;Świetlica wiejska w Giławach|Giławy| 2C |11-030 Purda;272;97;97;6;91;35.66;6.19
107653;281410;Szkoła Podstawowa w Butrynach|Butryny| 1A |10-687 Olsztyn;798;292;292;19;273;36.59;6.51
107654;281410;Szkoła Podstawowa w Klebarku Wielkim|Klebark Wielki| 9 |10-687 Olsztyn;1185;536;536;17;519;45.23;3.17
107655;281410;Świetlica Wiejska w Klewkach|Klewki| 15 |10-687 Olsztyn;2181;991;992;33;958;45.44;3.33
107656;281410;Remiza Ochotniczej Straży Pożarnej w Nowej Wsi|Nowa Wieś| 9A |11-030 Purda;623;241;241;9;232;38.68;3.73
107657;281411;Zespół Szkolno-Przedszkolny w Stawigudzie|Stawiguda|ul. Warszawska 5 |11-034 Stawiguda;1470;895;895;24;871;60.88;2.68
107658;281411;Publiczne Gimnazjum w Stawigudzie|Stawiguda|ul. Leśna 2 |11-034 Stawiguda;637;296;296;9;287;46.47;3.04
107659;281411;Świetlica w Gryźlinach|Gryźliny|ul. Spacerowa 8 |11-034 Stawiguda;474;193;193;10;183;40.72;5.18
107660;281411;Klub w Dorotowie|Dorotowo| 34 |11-034 Stawiguda;1070;636;636;16;620;59.44;2.52
107661;281411;Przedszkole w Bartągu|Bartąg|ul. Nad Łyną 57 |10-687 Olsztyn;2136;1174;1174;30;1144;54.96;2.56
107662;281411;Świetlica "Nad Łyną" w Rusi|Ruś| 6 |10-687 Olsztyn;590;284;284;11;273;48.14;3.87
107663;281412;Szkoła Podstawowa|Świątki| 95 |11-008 Świątki;708;299;299;11;288;42.23;3.68
107664;281412;Gminna Biblioteka Publiczna|Świątki| 93 |11-008 Świątki;819;246;246;16;230;30.04;6.50
107665;281412;Świetlica Wiejska|Kwiecewo| 25 |11-008 Świątki;591;179;179;8;171;30.29;4.47
107666;281412;Świetlica Wiejska|Brzydowo| 52 |11-008 Świątki;379;69;69;2;67;18.21;2.90
107667;281412;Świetlica Wiejska|Skolity| 3a |11-008 Świątki;467;168;168;10;158;35.97;5.95
107668;281412;Świetlica Wiejska|Włodowo| 46 |11-008 Świątki;289;71;71;7;64;24.57;9.86
107669;281501;BUDYNEK ORATORIUM|Ostróda|Parkowa 30 |14-100 Ostróda;1153;624;624;10;614;54.12;1.60
107670;281501;Budynek Stadionu|Ostróda|3 Maja 19A |14-100 Ostróda;1279;658;658;12;646;51.45;1.82
107671;281501;Zespół Szkolno Przedszkolny|Ostróda|Plebiscytowa 50 |14-100 Ostróda;1644;808;808;32;776;49.15;3.96
107672;281501;Szkoła Podstawowa Nr 2|Ostróda|Olsztyńska 7 |14-100 Ostróda;1098;315;315;19;296;28.69;6.03
107673;281501;Szkoła Podstawowa Nr 2|Ostróda|Olsztyńska 7 |14-100 Ostróda;1456;603;603;23;580;41.41;3.81
107674;281501;Szkoła Podstawowa Nr 6|Ostróda|Osiedle Młodych 8 |14-100 Ostróda;1213;561;561;16;545;46.25;2.85
107675;281501;Szkoła Podstawowa Nr 6|Ostróda|Osiedle Młodych 8 |14-100 Ostróda;1163;583;583;14;569;50.13;2.40
107676;281501;Gimnazjum Nr 2|Ostróda|Tadeusza Kościuszki 22 |14-100 Ostróda;1311;621;621;11;610;47.37;1.77
107677;281501;Szkoła Podstawowa Nr 1|Ostróda|Seweryna Pieniężnego 30A |14-100 Ostróda;1481;824;824;23;801;55.64;2.79
107678;281501;Szkoła Podstawowa Nr 1|Ostróda|Seweryna Pieniężnego 30A |14-100 Ostróda;1199;599;599;14;585;49.96;2.34
107679;281501;Gimnazjum Nr 2|Ostróda|Tadeusza Kościuszki 22 |14-100 Ostróda;1336;544;544;12;532;40.72;2.21
107680;281501;Szkoła Podstawowa Nr 4|Ostróda|Tadeusza Kościuszki 14 |14-100 Ostróda;1382;682;682;20;662;49.35;2.93
107681;281501;Przedszkole Niepubliczne "Promyczek"|Ostróda|Przedszkolna 1 |14-100 Ostróda;1183;539;539;19;520;45.56;3.53
107682;281501;Szkoła Podstawowa Nr 1|Ostróda|Seweryna Pieniężnego 30A |14-100 Ostróda;1149;541;541;17;524;47.08;3.14
107683;281501;Szkoła Podstawowa Nr 3|Ostróda|Rycerska 5 |14-100 Ostróda;1090;601;601;11;590;55.14;1.83
107684;281501;Przedszkole Niepubliczne "Radość"|Ostróda|Armii Krajowej 5 |14-100 Ostróda;1293;593;593;15;578;45.86;2.53
107685;281501;Gimnazjum Nr 1|Ostróda|Marszałka Piłsudskiego 4 |14-100 Ostróda;1379;659;659;12;647;47.79;1.82
107686;281501;Przedszkole Nr 1|Ostróda|Bolesława Chrobrego 3 |14-100 Ostróda;1257;605;605;20;585;48.13;3.31
107687;281501;Szkoła Podstawowa Nr 3|Ostróda|Rycerska 5 |14-100 Ostróda;1244;693;693;10;683;55.71;1.44
107688;281501;Szkoła Podstawowa Nr 3|Ostróda|Rycerska 5 |14-100 Ostróda;1081;582;582;10;572;53.84;1.72
107689;281501;Budynek Polskiego Stowarzyszenia Na Rzecz Osób z Upośledzeniem Umysłowym|Ostroda|Grunwaldzka 19A |14-100 Ostróda;1328;576;576;14;562;43.37;2.43
107690;281501;PZOZ w Ostródzie S.A.|Ostróda|Władysława Jagiełły 1 |14-100 Ostróda;151;19;19;0;19;12.58;0.00
107691;281501;Areszt Śledczy|Ostróda|Olsztyńska 3 |14-100 ;56;45;45;14;31;80.36;31.11
107692;281502;GMINNE CENTRUM KULTURALNO-BIBLIOTECZNE|DĄBRÓWNO|KOŚCIUSZKI 11C |14-120 DĄBRÓWNO;1508;608;608;29;579;40.32;4.77
107693;281502;ŚWIETLICA WIEJSKA|GARDYNY| 27 |14-120 DĄBRÓWNO;306;66;66;2;64;21.57;3.03
107694;281502;PUBLICZNA SZKOŁA PODSTAWOWA|MARWAŁD| 32 |14-120 DĄBRÓWNO;1025;244;244;27;217;23.80;11.07
107695;281502;ŚWIETLICA WIEJSKA|SAMIN| 13 |14-120 DĄBRÓWNO;572;193;193;6;187;33.74;3.11
107696;281503;Gminny Ośrodek Kultury w Gierzwałdzie|Gierzwałd| |14-107 Gierzwałd;1540;364;364;16;348;23.64;4.40
107697;281503;Publiczne Gimnazjum w Stębarku|Stębark| 57 |14-107 Gierzwałd;1364;430;430;20;410;31.52;4.65
107698;281503;Szkoła Podstawowa w Szczepankowie|Szczepankowo| 31 |00-000 Gierzwałd;872;251;251;26;225;28.78;10.36
107699;281503;Szkoła Podstawowa we Frygnowie|Frygnowo| 17 |14-107 Gierzwałd;656;209;209;8;201;31.86;3.83
107700;281504;Gminny Ośrodek Kultury w Łukcie|Łukta|Kościelna 2B |14-105 Łukta;2255;802;802;38;764;35.57;4.74
107701;281504;Punkt Filialny Szkoły Podstawowej w Łukcie z siedzibą w Mostkowie|Mostkowo| 25 |14-105 Łukta;883;226;226;11;215;25.59;4.87
107702;281504;Świetlica wiejska we Florczakach|Florczaki| 36 |14-105 Łukta;388;142;142;5;137;36.60;3.52
107703;281505;Przedszkole Samorządowe w Dobrocinie|Dobrocin| 49 A |14-330 Małdyty;830;323;323;9;314;38.92;2.79
107704;281505;Szkoła Podstawowa w Małdytach|Małdyty|ul. Szkolna 9 |14-330 Małdyty;2164;617;617;28;589;28.51;4.54
107705;281505;Zespół Szkół w Szymonowie|Szymonowo| 15 |14-330 Małdyty;929;263;263;7;256;28.31;2.66
107706;281505;Niepubliczna Szkoła Podstawowa w Wielkim Dworze|Wielki Dwór| 9 |14-330 Małdyty;1177;246;246;19;227;20.90;7.72
107707;281506;Miłakowski Dom Kultury w Miłakowie|Miłakowo|O.Władysława Włodyki 20 |14-310 Miłakowo;2137;870;870;19;851;40.71;2.18
107708;281506;Zespół Szkolno-Przedszkolny w Miłakowie im. Jana Pawła II|Miłakowo|Olsztyńska 9A |14-310 Miłakowo;1163;251;251;16;235;21.58;6.37
107709;281506;Filia Zespołu Szkolno-Przedszkolnego im. Jana Pawła II w Miłakowie, Szkoła Podstawowa w Boguchwałach|Boguchwały| 47A |14-310 Miłakowo;588;133;133;8;125;22.62;6.02
107710;281506;Dwór w Bieniaszach|Bieniasze| 8 |14-310 Miłakowo;351;76;76;3;73;21.65;3.95
107711;281506;Świetlica wiejska w Książniku|Książnik| 42 |14-310 Miłakowo;226;72;72;5;67;31.86;6.94
107712;281507;Szkoła Podstawowa w Miłomłynie|Miłomłyn|Pasłęcka 15 |14-140 Miłomłyn;2020;780;780;41;739;38.61;5.26
107713;281507;Szkoła Podstawowa w Liwie|Liwa|Długa 30 |14-140 Miłomłyn;930;268;268;12;256;28.82;4.48
107714;281507;Świetlica Wiejska w Liksajnach|Liksajny| 15A |14-140 Miłomłyn;278;106;106;7;99;38.13;6.60
107715;281507;Szkoła Podstawowa w Bynowie|Bynowo| 7 |14-140 Miłomłyn;534;141;141;11;130;26.40;7.80
107716;281507;Świetlica Wiejska w Majdanach Wielkich|Majdany Wielkie| 28B |14-140 Miłomłyn;297;96;96;4;92;32.32;4.17
107717;281508;Szkoła Podstawowa Nr 2 w Morągu|Morąg,|Żeromskiego 26 |14-300 Morąg;1201;459;459;27;432;38.22;5.88
107718;281508;Miejskie Przedsiębiorstwo Zarządzania Nieruchomościami Sp. z o. o. w Morągu|Morąg|Wenecka 1 |14-300 Morąg;728;349;349;6;343;47.94;1.72
107719;281508;Szkoła Podstawowa Nr 4 w Morągu|Morąg|Kajki 2 |14-300 Morąg;923;409;409;13;396;44.31;3.18
107720;281508;Szkoła Podstawowa Nr 4 w Morągu|Morąg|Kajki 2 |14-300 Morąg;1019;417;417;17;400;40.92;4.08
107721;281508;Gimnazjum Nr 1 w Morągu|Morąg|Mickiewicza 25 |14-300 Morąg;727;307;307;4;303;42.23;1.30
107722;281508;Zespół Szkól Licealnych|Morąg|11 Listopada 7A |14-300 Morąg;809;334;334;5;329;41.29;1.50
107723;281508;Ratusz w Morągu|Morąg|Plac Jana Pawła II 1 |14-300 Morąg;879;327;327;13;314;37.20;3.98
107724;281508;Szkoła Podstawowa Nr 4 w Morągu|Morąg|Krzywa 2 |14-300 Morąg;1087;475;475;9;466;43.70;1.89
107725;281508;Przedszkole Nr 2 w Moragu|Morąg|Armii Krajowej 15 |14-300 Morąg;743;367;367;6;361;49.39;1.63
107726;281508;Świetlica Spółdzielni Mieszkaniowej "Narie" w Morągu|Morąg|Leśna 22 |14-300 Morąg;855;457;457;8;449;53.45;1.75
107727;281508;Przedszkole Nr 6 w Morągu|Morąg|Pomorska 23 |14-300 Morąg;999;500;500;9;491;50.05;1.80
107728;281508;Szkoła Podstawowa Nr 3 w Morągu|Morąg|Zygmunta Wróblewskiego 17 |14-300 Morąg;1244;600;600;19;581;48.23;3.17
107729;281508;Szkoła Podstawowa w Żabim Rogu|Żabi Róg| 115A |14-300 Morąg;1015;368;368;11;357;36.26;2.99
107730;281508;Świetlica w Zawrotach|Zawroty| 17A |14-300 Morąg;747;206;206;5;201;27.58;2.43
107731;281508;Świetlica w Bramce|Bramka| 66 |14-300 Morąg;808;270;270;16;254;33.42;5.93
107732;281508;Świetlica w Słoneczniku|Słonecznik| 30 |14-300 Morąg;984;274;274;14;260;27.85;5.11
107733;281508;Przedsiębiorstwo Oczyszczania Sp. z o.o.|Morąg|Wenecka 1 |14-300 Morąg;961;260;260;7;253;27.06;2.69
107734;281508;Świetlica w Królewie|Królewo| 42 |14-300 Morąg;1028;257;257;16;241;25.00;6.23
107735;281508;Szkoła Podstawowa w Łącznie|Łączno| 48B |14-300 Morąg;887;206;206;9;197;23.22;4.37
107736;281508;Świetlica w Jurkach|Jurki| 55A |14-300 Morąg;965;231;231;9;222;23.94;3.90
107737;281508;Świetlica w Bogaczewie|Bogaczewo| 39A |14-300 Morąg;891;317;317;12;305;35.58;3.79
107738;281508;Szpital Miejski w Morągu Sp. z o.o. (odrębny obwód głosowania)|Morąg|Generała Jana Henryka Dąbrowskiego 16 |14-300 Morąg;116;36;36;3;33;31.03;8.33
107739;281509;Szkoła Podstawowa w Brzydowie|Brzydowo| 27 |14-100 Ostróda;954;281;281;5;276;29.45;1.78
107740;281509;Gimnazjum w Durągu|Durąg| 14 |14-106 Szyldak;1085;353;353;18;335;32.53;5.10
107741;281509;Zespół Przedszkolno-Szkolny w Tyrowie|Tyrowo| 41 |14-100 Ostróda;876;274;274;22;252;31.28;8.03
107742;281509;Zespół Szkół Rolniczych w Ostródzie|Ostróda|ul.Stefana Czarnieckiego 69 |14-100 Ostróda;1136;569;569;11;558;50.09;1.93
107743;281509;Niepubliczny Zespół Szkolno -Przedszkolny w Idzbarku|Idzbark| 30 |14-100 Ostróda;630;237;237;15;222;37.62;6.33
107744;281509;Szkoła Podstawowa w Zwierzewie|Zwierzewo| 36 |14-100 Ostróda;1057;398;398;12;386;37.65;3.02
107745;281509;Szkoła Podstawowa w Starych Jabłonkach|Stare Jabłonki|ul.Olsztyńska 20 |14-133 Stare Jabłonki;749;346;346;15;331;46.19;4.34
107746;281509;Szkoła Podstawowa w Szyldaku|Szyldak|ul.Szkolna 12 |14-106 Szyldak;918;303;303;12;291;33.01;3.96
107747;281509;Gminne Centrum Kulturalno-Biblioteczne w Samborowie|Ostróda|ul.Ostródzka 17 |14-100 Ostróda;1206;543;543;39;504;45.02;7.18
107748;281509;Świetlica Wiejska w Turznicy|Turznica| 23 |14-100 Ostróda;512;163;163;9;154;31.84;5.52
107749;281509;Świetlica Wiejska w Reszkach|Reszki| 36 |14-100 Ostróda;580;179;179;15;164;30.86;8.38
107750;281509;Zespół Szkół w Lipowie|Lipowo| 16 |14-100 Ostróda;522;190;190;12;178;36.40;6.32
107751;281509;Świetlica Wiejska w Pietrzwałdzie|Pietrzwałd| 20b |14-100 Ostróda;800;265;265;12;253;33.12;4.53
107752;281509;Środowiskowy Dom Samopomocy w Wygodzie|Wygoda| 10 |14-120 Dąbrówno;426;110;110;14;96;25.82;12.73
107753;281509;Budynek Oratorium w Ostródzie|Ostróda|ul.Parkowa 30 |14-100 Ostróda;909;363;363;11;352;39.93;3.03
107754;281601;Urząd Miejski w Białej Piskiej|Biała Piska|ul. Sikorskiego 21A |12-230 Biała Piska;1402;530;530;22;508;37.80;4.15
107755;281601;Publiczne Gimnazjum|Biała Piska|ul. Moniuszki 7 |12-230 Biała Piska;1914;864;864;42;822;45.14;4.86
107756;281601;Świetlica w Pogorzeli Wielkiej|Pogorzel Wielka| |12-230 Biała Piska;488;93;93;10;83;19.06;10.75
107757;281601;Sołeckie Centrum Kultury|Drygały|ul. Kościuszki 4 |12-230 Biała Piska;1782;581;581;40;541;32.60;6.88
107758;281601;Szkoła Podstawowa w Skarżynie|Skarżyn| |12-230 Biała Piska;507;163;163;6;157;32.15;3.68
107759;281601;Świetlica Wiejska w Świdrach Kościelnych|Świdry Kościelne| |12-230 Biała Piska;540;175;175;20;155;32.41;11.43
107760;281601;Szkoła Podstawowa w Kumielsku|Kumielsk| |12-230 Biała Piska;802;256;256;15;241;31.92;5.86
107761;281601;Zespół Szkół Nr 1|Biała Piska|ul. Sienkiewicza 16 |12-230 Biała Piska;1158;324;324;23;301;27.98;7.10
107762;281601;Szkoła Podstawowa w Bemowie Piskim|Bemowo Piskie| |12-230 Biała Piska;883;308;308;18;290;34.88;5.84
107763;281602;Szkoła Podstawowa w Orzyszu|Orzysz|ul. Wojska Polskiego 12 |12-250 Orzysz;1563;616;616;48;568;39.41;7.79
107764;281602;Centrum Informacji Turystycznej w Orzyszu|Orzysz|ul. Rynek 5 |12-250 Orzysz;1530;588;588;25;563;38.43;4.25
107765;281602;Gimnazjum w Orzyszu|Orzysz|ul. Osiedle Robotnicze 11 |12-250 Orzysz;1523;732;732;29;703;48.06;3.96
107766;281602;Świetlica wiejska w Wierzbinach|Wierzbiny| |12-250 Orzysz;580;220;220;13;207;37.93;5.91
107767;281602;Sala widowiskowo-sportowa w Orzyszu|Orzysz|ul. Osiedle Robotnicze 11A |12-250 Orzysz;970;268;268;11;257;27.63;4.10
107768;281602;Szkoła Podstawowa w Okartowie|Okartowo| 22 |12-250 Orzysz;471;163;163;16;147;34.61;9.82
107769;281602;Szkoła Filialna w Drozdowie|Drozdowo| 15 |12-250 Orzysz;449;127;127;9;118;28.29;7.09
107770;281602;Zespół Szkół w Dąbrówce|Dąbrówka| 40 |12-250 Orzysz;452;130;130;7;123;28.76;5.38
107771;281603;Świetlica Wiejska|Szczechy Wielkie| 13 |12-200 Pisz;654;238;238;9;229;36.39;3.78
107772;281603;Świetlica Wiejska|Rostki| 18a |12-200 Pisz;572;166;166;13;153;29.02;7.83
107773;281603;Świetlica Wiejska|Wiartel| 6b |12-200 Pisz;967;366;366;7;359;37.85;1.91
107774;281603;Świetlica Wiejska|Turośl| 5 |12-220 Ruciane-Nida;672;242;242;14;228;36.01;5.79
107775;281603;Świetlica Wiejska|Stare Guty| 13a |12-200 Pisz;1286;456;456;15;441;35.46;3.29
107776;281603;Szkoła Podstawowa|Jeże| 14 |12-200 Pisz;498;175;175;7;168;35.14;4.00
107777;281603;Szkoła Podstawowa im. Ks. Jerzego Popiełuszki|Liski| 22 |12-200 Pisz;755;195;195;7;188;25.83;3.59
107778;281603;Szkoła Podstawowa Nr 2 im. Henryka Sienkiewicza|Pisz|ul. Gustawa Gizewiusza 8 |12-200 Pisz;1072;415;415;15;400;38.71;3.61
107779;281603;Gimnazjum Nr 1 im. Konstantego Ildefonsa Gałczyńskiego|Pisz|ul. Lipowa 15 |12-200 Pisz;1882;879;879;40;839;46.71;4.55
107780;281603;Szkoła Podstawowa Nr 1 im. Mikołaja Kopernika|Pisz|ul. dr Władysława Klementowskiego 2 |12-200 Pisz;1999;787;787;39;748;39.37;4.96
107781;281603;Szkoła Podstawowa Nr 1 im. Mikołaja Kopernika|Pisz|ul. dr Władyslawa Klementowskiego 2 |12-200 Pisz;1043;440;440;9;431;42.19;2.05
107782;281603;Urząd Miejski|Pisz|ul. Gustawa Gizewiusza 5 |12-200 Pisz;2126;881;881;28;853;41.44;3.18
107783;281603;Zespół Szkół Ogólnokształcących|Pisz|ul. Władysława Sikorskiego 15 |12-200 Pisz;2031;825;825;28;797;40.62;3.39
107784;281603;Zespół Szkół Nr 1|Pisz|ul. Młodzieżowa 26 |12-200 Pisz;962;364;364;13;351;37.84;3.57
107785;281603;Zespół Szkół Nr 1|Pisz|ul. Młodzieżowa 26 |12-200 Pisz;1995;814;814;18;796;40.80;2.21
107786;281603;Gminny Zespół Szkół|Pisz|ul. Michała Wołodyjowskiego 2a |12-200 Pisz;2104;990;990;35;955;47.05;3.54
107787;281603;Gminny Zespół Szkół|Pisz|ul. Michała Wołodyjowskiego 2a |12-200 Pisz;1054;506;506;14;492;48.01;2.77
107788;281603;Samodzielny Publiczny Zakład Opieki Zdrowotnej Szpital Powiatowy w Piszu|Pisz|Henryka Sienkiewicza 2 |12-200 Pisz;78;30;30;3;27;38.46;10.00
107789;281604;Świetlica Osiedlowa|Ruciane-Nida|ul. Mazurska 13 |12-220 Ruciane-Nida;837;335;335;15;320;40.02;4.48
107790;281604;Zespół Szkół Leśnych im. Unii Europejskiej|Ruciane-Nida|ul. Polna 2 |12-220 Ruciane-Nida;985;465;465;18;447;47.21;3.87
107791;281604;Szkoła Podstawowa Nr 1|Ruciane-Nida|ul. Gałczyńskiego 2 |12-220 Ruciane-Nida;1122;494;494;27;467;44.03;5.47
107792;281604;Zespół Szkół Samorządowych im. Agnieszki Osieckiej|Ruciane-Nida|ul. Gałczyńskiego 2A |12-220 Ruciane-Nida;853;356;356;16;340;41.74;4.49
107793;281604;Świetlica Wiejska|Wejsuny| 29 |12-220 Ruciane-Nida;829;332;332;22;310;40.05;6.63
107794;281604;Szkoła Podstawowa|Ukta| 70 |12-220 Ruciane-Nida;946;380;380;14;366;40.17;3.68
107795;281604;Świetlica Wiejska|Wojnowo| 21 |12-220 Ruciane-Nida;894;344;344;25;319;38.48;7.27
107796;281604;Świetlica Wiejska|Karwica| 12A |12-220 Ruciane-Nida;344;141;141;5;136;40.99;3.55
107797;281604;Świetlica Domu Pomocy Społecznej Ewangelickiego Domu Opieki BETEZDA w Ukcie Parafii Ewangelicko-Augsburskiej w Mikołajkach|Ukta| 31 |12-220 Ruciane-Nida;36;17;17;1;16;47.22;5.88
107798;281701;Warsztaty Szkolne przy Zespole Szkół Nr 1|Szczytno|ul. Śląska 14 |12-100 Szczytno;1177;625;625;6;619;53.10;0.96
107799;281701;Szkoła Podstawowa z Oddziałami Integracyjnymi Nr 2 im. Wojciecha Kętrzyńskiego|Szczytno|ul. Wojciecha Kętrzyńskiego 6 |12-100 Szczytno;856;483;483;6;477;56.43;1.24
107800;281701;Szkoła Podstawowa Nr 6 im. Orła Białego|Szczytno|ul. Bohaterów Września 1939 r. 2 |12-100 Szczytno;1050;527;527;15;512;50.19;2.85
107801;281701;Miejski Dom Kultury|Szczytno|ul. Polska 12 |12-100 Szczytno;732;286;286;7;279;39.07;2.45
107802;281701;Zespół Szkół Nr 1 im. Stanisława Staszica|Szczytno|ul. Adama Mickiewicza 10 |12-100 Szczytno;903;381;381;14;367;42.19;3.67
107803;281701;Gimnazjum Nr 1 im. Henryka Sienkiewicza|Szczytno|ul. Jana Kasprowicza 1 |12-100 Szczytno;1060;514;514;14;500;48.49;2.72
107804;281701;Gminna Spółdzielnia "Samopomoc Chłopska"|Szczytno|ul. Łomżyńska 18 |12-100 Szczytno;892;429;429;16;413;48.09;3.73
107805;281701;Miejskie Przedszkole Nr 2 "Fantazja"|Szczytno|ul. Polska 42 |12-100 Szczytno;789;378;378;10;368;47.91;2.65
107806;281701;Szkoła Podstawowa Nr 3 im. Marii Curie-Skłodowskiej|Szczytno|ul. Marii Curie-Skłodowskiej 2 |12-100 Szczytno;845;391;391;3;388;46.27;0.77
107807;281701;Przedszkole Niepubliczne Nr 1 "Pod Topolą"|Szczytno|ul. Pasymska 7 |12-100 Szczytno;1083;542;543;20;522;50.05;3.69
107808;281701;Miejskie Przedszkole Nr 1 "Bajka"|Szczytno|ul. Pasymska 21 |12-100 Szczytno;680;318;318;5;313;46.76;1.57
107809;281701;Gimnazjum Nr 1 im. Henryka Sienkiewicza|Szczytno|ul. Jana Kasprowicza 1 |12-100 Szczytno;888;441;441;12;429;49.66;2.72
107810;281701;Dom Studencki Wyższej Szkoły Policji|Szczytno|ul. Bolesława Chrobrego 12 |12-100 Szczytno;721;348;348;6;342;48.27;1.72
107811;281701;Hala Widowiskowo-Sportowa im. Huberta Wagnera|Szczytno|ul. Jerzego Lanca 1 |12-100 Szczytno;995;509;509;11;498;51.16;2.16
107812;281701;Hala Widowiskowo-Sportowa im. Huberta Wagnera|Szczytno|ul. Jerzego Lanca 1 |12-100 Szczytno;1035;552;552;8;544;53.33;1.45
107813;281701;Zespół Szkół Nr 3 im. Jana III Sobieskiego|Szczytno|ul. Jerzego Lanca 10 |12-100 Szczytno;1260;682;682;17;665;54.13;2.49
107814;281701;Cech Rzemiosł Różnych|Szczytno|ul. Marii Curie-Skłodowskiej 15 |12-100 Szczytno;773;361;361;10;351;46.70;2.77
107815;281701;Powiatowy Urząd Pracy|Szczytno|ul. Wincentego Pola 4 |12-100 Szczytno;581;263;263;9;254;45.27;3.42
107816;281701;Centrum Rehabilitacyjno-Edukacyjne Dla Dzieci i Młodzieży Niepełnosprawnej|Szczytno|ul. Pasymska 21 A |12-100 Szczytno;954;454;454;7;447;47.59;1.54
107817;281701;Zespół Szkół Nr 2 im. Jędrzeja Śniadeckiego|Szczytno|ul. Polska 18 |12-100 Szczytno;811;374;374;10;364;46.12;2.67
107818;281701;Gimnazjum Nr 2 z Oddziałami Integracyjnymi|Szczytno|ul. Jerzego Lanca 1 |12-100 Szczytno;1185;539;539;11;528;45.49;2.04
107819;281701;Dom Pomocy Społecznej|Szczytno|ul. Wielbarska 2 |12-100 Szczytno;105;36;36;4;32;34.29;11.11
107820;281701;Szpital Powiatowy|Szczytno|ul. Marii Curie-Skłodowskiej 12 |12-100 Szczytno;76;31;31;2;29;40.79;6.45
107821;281701;Areszt Śledczy|Szczytno|ul. Henryka Sienkiewicza 10 |12-100 Szczytno;116;72;72;19;53;62.07;26.39
107822;281702;Szkoła Podstawowa w Rumach|Rumy| 19 |12-120 Dźwierzuty;284;85;85;0;85;29.93;0.00
107823;281702;Gminny Ośrodek Kultury, Sportu i Rekreacji w Dźwierzutach|Dźwierzuty|ul. Pasymska 2 |12-120 Dźwierzuty;1385;407;407;41;366;29.39;10.07
107824;281702;Urząd Gminy w Dźwierzutach|Dźwierzuty|ul. Niepodległości 6 |12-120 Dźwierzuty;1331;540;540;23;517;40.57;4.26
107825;281702;Szkoła Podstawowa w Kałęczynie|Kałęczyn| 17 |12-120 Dźwierzuty;573;217;217;11;206;37.87;5.07
107826;281702;Świetlica Wiejska Jabłonka|Jabłonka| 42 |12-120 Dźwierzuty;679;185;185;8;177;27.25;4.32
107827;281702;Zespół Szkolno-Przedszkolny w Orzynach|Orzyny| 34 |12-120 Dźwierzuty;1150;313;313;24;289;27.22;7.67
107828;281703;Budynek Zespołu Szkół|Jedwabno|ul. Polna 1 |12-122 Jedwabno;1042;438;438;27;411;42.03;6.16
107829;281703;Gminny Ośrodek Kultury|Jedwabno|ul. 1 Maja 63 |12-122 Jedwabno;875;301;301;17;284;34.40;5.65
107830;281703;Świetlica Wiejska|Burdąg| 46 |12-122 Jedwabno;577;165;165;10;155;28.60;6.06
107831;281703;Świetlica Wiejska|Nowy Dwór| 37 |12-122 Jedwabno;512;141;141;12;129;27.54;8.51
107832;281704;Zespół Szkół-Publiczne Gimnazjum|Pasym|ul. Jana Pawła II 1 |12-130 Pasym;470;158;158;13;145;33.62;8.23
107833;281704;Miejski Ośrodek Kultury|Pasym|ul. Rynek 10A |12-130 Pasym;346;105;105;5;100;30.35;4.76
107834;281704;Szkoła Podstawowa|Grom| 67 |12-130 Pasym;423;141;141;7;134;33.33;4.96
107835;281704;Szkoła Podstawowa|Tylkowo| 1 |12-130 Pasym;648;280;280;15;265;43.21;5.36
107836;281704;Świetlica Wiejska|Grzegrzółki| 11 |12-130 Pasym;337;85;85;6;79;25.22;7.06
107837;281704;Remiza Strażacka|Pasym|ul. Pocztowa 14 |12-130 Pasym;524;201;201;18;183;38.36;8.96
107838;281704;Zespół Szkolno-Przedszkolny|Pasym|ul. Ogrodowa 1 |12-130 Pasym;868;299;299;18;281;34.45;6.02
107839;281704;Zespół Szkolno-Przedszkolny|Pasym|ul. Ogrodowa 1 |12-130 Pasym;663;298;298;11;287;44.95;3.69
107840;281705;Sala sportowa przy Zespole Szkolno-Przedszkolnym w Dąbrowach|Dąbrowy| 238 |12-114 Rozogi;1015;369;369;20;349;36.35;5.42
107841;281705;Gminny Ośrodek Kultury w Rozogach|Rozogi|ul. Plac Jana Pawła II 1 |12-114 Rozogi;1195;495;495;26;469;41.42;5.25
107842;281705;Sala sportowa przy Zespole Szkół w Rozogach|Rozogi|ul. 24 Stycznia 13 |12-114 Rozogi;499;154;154;12;142;30.86;7.79
107843;281705;Szkoła Podstawowa w Klonie|Klon| 96 |12-114 Rozogi;699;195;195;20;175;27.90;10.26
107844;281705;Świetlica Wiejska w Księżym Lasku|Księży Lasek| 26 |12-114 Rozogi;309;118;118;2;116;38.19;1.69
107845;281705;Świetlica Wiejska w Farynach|Faryny| 51 |12-114 Rozogi;402;144;144;22;122;35.82;15.28
107846;281705;Budynek byłej Szkoły Podstawowej w Spalinach Wielkich|Spaliny Wielkie| 25a |12-114 Rozogi;429;115;115;11;104;26.81;9.57
107847;281706;Urząd Gminy Szczytno|Szczytno|ul. Łomżyńska 3 |12-100 Szczytno;1113;397;397;15;382;35.67;3.78
107848;281706;Świetlica Wiejska w Płozach|Płozy| 37A |12-100 Szczytno;641;252;252;12;240;39.31;4.76
107849;281706;Świetlica Wiejska w Leśnym Dworze|Leśny Dwór| 54 |12-100 Szczytno;994;545;545;7;538;54.83;1.28
107850;281706;Agencja Nieruchomości Rolnych, Oddział w Olsztynie, Sekcja Zamiejscowa Gospodarowania Zasobem w Kamionku|Kamionek| 25 |12-100 Szczytno;548;211;211;8;203;38.50;3.79
107851;281706;Urząd Gminy Szczytno|Szczytno|ul. Łomżyńska 3 |12-100 Szczytno;857;336;336;17;319;39.21;5.06
107852;281706;Zespół Szkół w Lipowcu|Lipowiec| 48 |12-100 Szczytno;1146;369;369;25;344;32.20;6.78
107853;281706;Zespół Szkół w Szymanach|Szymany| 21 |12-100 Szczytno;692;270;270;14;256;39.02;5.19
107854;281706;Zespół Szkół w Olszynach|Olszyny| 30 |12-100 Szczytno;711;257;257;10;247;36.15;3.89
107855;281706;Zakład Gospodarki Komunalnej i Mieszkaniowej w Kamionku|Kamionek| 25 |12-100 Szczytno;846;381;381;17;364;45.04;4.46
107856;281706;Szkoła Podstawowa w Rudce|Rudka| 10 |12-100 Szczytno;1265;500;500;24;476;39.53;4.80
107857;281706;Niepubliczny Zespół Szkolno-Przedszkolny w Romanach|Romany| 20B |12-100 Szczytno;786;226;226;29;197;28.75;12.83
107858;281707;Gminny Ośrodek Kultury w Świętajnie|Świętajno|ul. Młodzieżowa 2 |12-140 Świętajno;1172;476;476;22;454;40.61;4.62
107859;281707;Gminna Biblioteka Publiczna w Świętajnie|Świętajno|ul. Młodzieżowa 2 |12-140 Świętajno;589;177;177;10;167;30.05;5.65
107860;281707;Zespół Szkół w Spychowie|Spychowo|ul. Mazurska 5 |12-150 Spychowo;1184;506;506;21;485;42.74;4.15
107861;281707;Szkoła Podstawowa w Jerutach|Jeruty| 41 |12-140 Świętajno;687;209;209;14;195;30.42;6.70
107862;281707;Szkoła Podstawowa w Kolonii|Kolonia| 71 |12-140 Świętajno;809;250;250;13;237;30.90;5.20
107863;281707;Środowiskowy Dom Samopomocy w Piasutnie|Piasutno| 63 |12-140 Świętajno;401;164;164;12;152;40.90;7.32
107864;281707;Dom Pomocy Społecznej|Spychowo|Sienkiewicza 3 |12-150 Spychowo;15;11;11;4;7;73.33;36.36
107865;281708;Szkoła Podstawowa w Wielbarku|Wielbark|ul. Mikołaja Kopernika 10 |12-160 Wielbark;1071;360;360;24;336;33.61;6.67
107866;281708;Szkoła Podstawowa w Wielbarku|Wielbark|ul. Mikołaja Kopernika 10 |12-160 Wielbark;728;260;260;8;252;35.71;3.08
107867;281708;Urząd Gminy Wielbark|Wielbark|ul. Grunwaldzka 2 |12-160 Wielbark;977;282;282;11;271;28.86;3.90
107868;281708;Gminny Ośrodek Kultury w Wielbarku|Wielbark|ul. Wojciecha Kętrzyńskiego 13 |12-160 Wielbark;1058;320;320;13;307;30.25;4.06
107869;281708;Szkoła Podstawowa w Zabielach|Zabiele| 4 |12-160 Wielbark;443;139;139;15;124;31.38;10.79
107870;281708;Świetlica Wiejska w Lesinach Wielkich|Lesiny Wielkie| 18c |12-160 Wielbark;892;204;204;5;199;22.87;2.45
107871;281801;Zespół Placówek Oświatowych w Baniach Mazurskich|Banie Mazurskie|ul. Konopnickiej 12 |19-520 Banie Mazurskie;1147;397;397;11;386;34.61;2.77
107872;281801;Zespół Placówek Oświatowych w Baniach Mazurskich|Banie Mazurskie|ul. Konopnickiej 12 |19-520 Banie Mazurskie;711;199;199;7;192;27.99;3.52
107873;281801;Szkoła Podstawowa w Lisach|Lisy| 23A |19-520 Banie Mazurskie;541;123;123;10;113;22.74;8.13
107874;281801;Była Szkoła Podstawowa w Żabinie|Żabin| 8A |19-520 Banie Mazurskie;825;207;207;12;195;25.09;5.80
107875;281802;Szkoła Podstawowa w Dubeninkach|Dubeninki|ul. Szkolna 1 |19-504 Dubeninki;1020;328;328;23;305;32.16;7.01
107876;281802;Gminne Centrum Kultury w Dubeninkach|Dubeninki|ul. Henryka Mereckiego 6 |19-504 Dubeninki;446;141;141;5;136;31.61;3.55
107877;281802;Świetlica Wiejska w Żytkiejmach|Żytkiejmy|ul. 1-go Maja 2 |19-504 Dubeninki;979;270;270;10;260;27.58;3.70
107878;281803;Szkoła Podstawowa w Boćwince|Boćwinka| 13 |19-500 Gołdap;771;193;193;11;182;25.03;5.70
107879;281803;Zespół Szkół w Grabowie|Grabowo| 54 |19-500 Gołdap;818;211;211;11;200;25.79;5.21
107880;281803;Szkoła Podstawowa w Jabłońskich|Jabłońskie| 12 |19-500 Gołdap;638;216;216;9;207;33.86;4.17
107881;281803;Świetlica Wiejska w Górnem|Górne| 22 |19-500 Gołdap;756;189;189;8;181;25.00;4.23
107882;281803;Świetlica Wiejska w Kozakach|Kozaki| 19A |19-500 Gołdap;851;236;236;16;220;27.73;6.78
107883;281803;Świetlica Wiejska w Galwieciach|Galwiecie| 30a |19-500 Gołdap;390;122;122;7;115;31.28;5.74
107884;281803;Szkoła Podstawowa Nr 1 w Gołdapi|Gołdap|ul. Szkolna 5 |19-500 Gołdap;1575;604;604;10;594;38.35;1.66
107885;281803;Urząd Miejski w Gołdapi|Gołdap|pl. Zwycięstwa 14 |19-500 Gołdap;1589;705;705;18;687;44.37;2.55
107886;281803;Starostwo Powiatowe w Gołdapi|Gołdap|ul. Krótka 1 |19-500 Gołdap;1684;570;570;12;558;33.85;2.11
107887;281803;Szkoła Podstawowa Nr 3 w Gołdapi|Gołdap|ul. Tadeusza Kościuszki 25 |19-500 Gołdap;1393;621;621;8;613;44.58;1.29
107888;281803;Gimnazjum Nr 1 w Gołdapi|Gołdap|ul. Tadeusza Kościuszki 30 |19-500 Gołdap;780;331;331;3;328;42.44;0.91
107889;281803;Zespół Szkół Zawodowych w Gołdapi|Gołdap|ul. Jaćwieska 14 |19-500 Gołdap;1538;654;654;12;642;42.52;1.83
107890;281803;Liceum Ogólnokształcące w Gołdapi|Gołdap|ul. Księdza Popiełuszki 2 |19-500 Gołdap;1431;564;564;9;555;39.41;1.60
107891;281803;Szkoła Podstawowa Nr 2 w Gołdapi|Gołdap|ul. 1 Maja 25 |19-500 Gołdap;1506;666;666;15;651;44.22;2.25
107892;281803;Goldmedica Sp.z o.o.|Gołdap|Słoneczna 7 |19-500 Gołdap;43;28;28;0;28;65.12;0.00
107893;281803;Sanatorium WITAL|Gołdap|Wczasowa 7 |19-500 Gołdap;411;339;339;15;324;82.48;4.42
107894;281901;Szkoła Podstawowa w Budrach|Budry|ul. M. Kajki 4 |11-606 Budry;775;270;270;6;264;34.84;2.22
107895;281901;Szkoła Podstawowa w Budrach|Budry|ul. M. Kajki 4 |11-606 Budry;742;185;185;9;176;24.93;4.86
107896;281901;Świetlica w Ołowniku|Ołownik| 43 |11-606 Budry;522;179;179;12;167;34.29;6.70
107897;281901;Warsztaty Terapii Zajęciowej w Olszewie Węgorzewskim|Olszewo Węgorzewskie| 41 |11-606 Budry;400;116;116;4;112;29.00;3.45
107898;281902;Pomieszczenie przy Ochotniczej Straży Pożarnej w Kutach|Kuty| 28 |11-610 Pozezdrze;918;238;238;9;229;25.93;3.78
107899;281902;Zespół Szkół w Pozezdrzu|Pozezdrze|ul. 1 Maja 1B |11-610 Pozezdrze;836;271;271;8;263;32.42;2.95
107900;281902;Zespół Szkół w Pozezdrzu|Pozezdrze|ul. 1 Maja 1B |11-610 Pozezdrze;977;362;362;12;350;37.05;3.31
107901;281903;Urząd Miejski w Węgorzewie|Węgorzewo|ul. Zamkowa 3 |11-600 Węgorzewo;929;432;432;12;420;46.50;2.78
107902;281903;Szkoła Podstawowa Nr 2 w Węgorzewie|Węgorzewo|ul. Zamkowa 6 |11-600 Węgorzewo;927;391;391;9;382;42.18;2.30
107903;281903;Ciepłownie Miejskie Sp. z o.o. Węgorzewo|Węgorzewo|ul. Bolesłwa Chrobrego 4 |11-600 Węgorzewo;815;373;373;7;366;45.77;1.88
107904;281903;Węgorzewskie Centrum Kultury w Węgorzewie|Węgorzewo|ul. Generała Józefa Bema 14 |11-600 Węgorzewo;929;440;440;6;434;47.36;1.36
107905;281903;Szkoła Podstawowa Nr 1 w Węgorzewie|Węgorzewo|ul. Generała Józefa Bema 12 |11-600 Węgorzewo;786;346;346;10;336;44.02;2.89
107906;281903;Specjalny Ośrodek Szkolno-Wychowawczy w Węgorzewie|Węgorzewo|ul. Zamkowa 34 |11-600 Węgorzewo;1015;376;376;7;369;37.04;1.86
107907;281903;Gimnazjum w Węgorzewie|Węgorzewo|ul. Pionierów 6 |11-600 Węgorzewo;996;421;421;11;410;42.27;2.61
107908;281903;Liceum Ogólnokształcące w Węgorzewie|Węgorzewo|ul. Bolesława Prusa 10 |11-600 Węgorzewo;780;322;322;8;314;41.28;2.48
107909;281903;Gimnazjum w Węgorzewie|Węgorzewo|ul. Pionierów 6 |11-600 Węgorzewo;968;409;409;7;402;42.25;1.71
107910;281903;Szkoła Podstawowa Nr 2 w Węgorzewie|Węgorzewo|ul. Zamkowa 6 |11-600 Węgorzewo;963;447;447;13;434;46.42;2.91
107911;281903;Szkoła Podstawowa w Perłach|Perły| 33 |11-600 Węgorzewo;811;225;225;14;211;27.74;6.22
107912;281903;Ekomarina w Węgorzewie|Węgorzewo|ul. Bulwar Loir et Cher 4 |11-600 Węgorzewo;902;243;243;7;236;26.94;2.88
107913;281903;Szkoła Podstawowa Nr 1 w Węgorzewie|Węgorzewo|ul. Generała Józefa Bema 12 |11-600 Węgorzewo;973;314;314;7;307;32.27;2.23
107914;281903;Świetlica wiejska w Węgielsztynie|Węgielsztyn| 45 |11-600 Węgorzewo;783;237;237;5;232;30.27;2.11
107915;281903;Zespół Szkół w Radziejach|Radzieje|ul. Węgorzewska 16 |11-600 Węgorzewo;927;251;251;9;242;27.08;3.59
107916;281903;Szpital Psychiatryczny Samodzielny Publiczny Zakład Opieki Zdrowotnej|Węgorzewo|Gen.J.Bema 24 |11-600 Węgorzewo;168;30;30;2;28;17.86;6.67
107917;281903;Mazurskie Centrum Zdrowia Szpital Powiatowy|Węgorzewo|3-go Maja 17 |11-600 Węgorzewo;82;42;42;1;41;51.22;2.38
107918;281903;Dom Pomocy Społecznej|Węgorzewo|11 Listopada 12 |11-600 Węgorzewo;196;18;18;3;15;9.18;16.67
107919;286101;Ośrodek Rehabilitacyjno-Edukacyjno-Wychowawczy Koło PSOUU w Elblągu|Elbląg|ul. Szarych Szeregów 32 |82-300 Elbląg;1946;989;989;12;977;50.82;1.21
107920;286101;Zespół Szkół Nr 3|Elbląg|ul. Rodziny Nalazków 20 |82-300 Elbląg;1845;991;991;20;971;53.71;2.02
107921;286101;Przedszkole Niepubliczne "Akademia Krasnoludków"|Elbląg|ul. Macieja Kalenkiewicza 24 |82-300 Elbląg;1376;731;731;13;718;53.12;1.78
107922;286101;Przedszkole Nr 21|Elbląg|ul. Wiejska 6 |82-300 Elbląg;1969;929;929;23;906;47.18;2.48
107923;286101;Spółdzielnia Mieszkaniowa "Zakrzewo"|Elbląg|ul. Robotnicza 246 |82-300 Elbląg;1804;969;969;15;954;53.71;1.55
107924;286101;Szkoła Podstawowa Nr 18|Elbląg|ul. Węgrowska 1 |82-300 Elbląg;1417;663;663;14;649;46.79;2.11
107925;286101;Zespół Szkół Inżynierii Środowiska i Usług|Elbląg|ul. Obrońców Pokoju 44 |82-300 Elbląg;843;257;257;2;255;30.49;0.78
107926;286101;Szkoła Podstawowa Nr 18|Elbląg|ul. Węgrowska 1 |82-300 Elbląg;1649;778;778;13;765;47.18;1.67
107927;286101;Świetlica w Próchniku|Elbląg|ul. Strumykowa 35 |82-300 Elbląg;572;296;296;7;289;51.75;2.36
107928;286101;Zespół Szkół Nr 1|Elbląg|ul. Janusza Korczaka 34 |82-300 Elbląg;1444;760;760;8;752;52.63;1.05
107929;286101;Zespół Szkół nr 1|Elbląg|ul. Janusza Korczaka 34 |82-300 Elbląg;1727;873;873;9;864;50.55;1.03
107930;286101;Przedszkole Nr 24|Elbląg|ul. Jana Brzechwy 5 |82-300 Elbląg;2078;1070;1070;12;1058;51.49;1.12
107931;286101;Przedszkole Nr 24|Elbląg|ul. Jana Brzechwy 5 |82-300 Elbląg;2311;1239;1239;15;1224;53.61;1.21
107932;286101;Szkoła Podstawowa Nr 15|Elbląg|ul. Modlińska 39 |82-300 Elbląg;2075;1123;1123;29;1094;54.12;2.58
107933;286101;Szkoła Podstawowa Nr 15|Elbląg|ul. Modlińska 39 |82-300 Elbląg;1989;945;945;19;926;47.51;2.01
107934;286101;Przedszkole Niepubliczne "Wiki"|Elbląg|ul. Częstochowska 5 |82-300 Elbląg;1978;1063;1063;15;1048;53.74;1.41
107935;286101;NZOZ Młodzieżowy Ośrodek Terapeutyczny KARAN|Elbląg|ul. Królewiecka 197 |82-300 Elbląg;1401;749;749;16;733;53.46;2.14
107936;286101;Przedszkole Niepubliczne "Bajka"|Elbląg|ul. Rypińska 3 |82-300 Elbląg;1893;875;875;32;843;46.22;3.66
107937;286101;Gimnazjum Nr 2|Elbląg|ul. Robotnicza 173 |82-300 Elbląg;1772;920;920;16;904;51.92;1.74
107938;286101;Gimnazjum Nr 2|Elbląg|ul. Robotnicza 173 |82-300 Elbląg;1793;874;874;22;852;48.75;2.52
107939;286101;Szkoła Podstawowa Nr 1|Elbląg|ul. Ignacego Daszyńskiego 1 |82-300 Elbląg;1898;914;914;25;889;48.16;2.74
107940;286101;Szkoła Podstawowa Nr 1|Elbląg|ul. Ignacego Daszyńskiego 1 |82-300 Elbląg;2182;988;988;19;969;45.28;1.92
107941;286101;Przedszkole Nr 23|Elbląg|ul. Pułkownika Stanisława Dąbka 49 |82-300 Elbląg;1633;829;829;15;814;50.77;1.81
107942;286101;Świetlica ESM "Sielanka"|Elbląg|ul. Gwiezdna 26 27|82-300 Elbląg;1962;995;995;22;973;50.71;2.21
107943;286101;Gimnazjum Nr 9|Elbląg|ul. Browarna 1 |82-300 Elbląg;1890;789;789;14;775;41.75;1.77
107944;286101;Szkoła Podstawowa Nr 6|Elbląg|Aleja Józefa Piłsudskiego 4 |82-300 Elbląg;1699;868;868;25;843;51.09;2.88
107945;286101;Zespół Szkół Gospodarczych|Elbląg|ul. Królewiecka 128 |82-300 Elbląg;1837;917;917;29;888;49.92;3.16
107946;286101;Szkoła Podstawowa Nr 19|Elbląg|ul. Urocza 4 |82-300 Elbląg;1551;850;850;12;838;54.80;1.41
107947;286101;Specjalny Ośrodek Szkolno-Wychowawczy Nr 1|Elbląg|ul. Mikołaja Kopernika 27 |82-300 Elbląg;1378;634;634;17;617;46.01;2.68
107948;286101;Dom Pomocy Społecznej "Niezapominajka"|Elbląg|ul. Toruńska 17 |82-300 Elbląg;105;37;37;5;32;35.24;13.51
107949;286101;Szkoła Podstawowa nr 12|Elbląg|ul. Wojciecha Zajchowskiego 12 |82-300 Elbląg;1591;736;736;14;722;46.26;1.90
107950;286101;IV Liceum Ogólnokształcące|Elbląg|ul. Henryka Sienkiewicza 4 |82-300 Elbląg;1478;816;816;17;799;55.21;2.08
107951;286101;IV Liceum Ogólnokształcące|Elbląg|ul. Henryka Sienkiewicza 4 |82-300 Elbląg;1738;852;852;36;816;49.02;4.23
107952;286101;Młodzieżowy Dom Kultury|Elbląg|ul. Generała Józefa Bema 37 |82-300 Elbląg;1410;702;702;19;683;49.79;2.71
107953;286101;Zespół Szkół Nr 2|Elbląg|ul. Wyżynna 3 |82-300 Elbląg;2199;1114;1114;15;1099;50.66;1.35
107954;286101;Przedszkole Nr 17|Elbląg|ul. Karowa 30 |82-300 Elbląg;1335;604;604;17;587;45.24;2.81
107955;286101;Zespół Szkół Ogólnokształcących Nr 2|Elbląg|ul. Królewiecka 42 |82-300 Elbląg;1708;813;813;29;784;47.60;3.57
107956;286101;Szkoła Podstawowa Nr 12|Elbląg|ul. Wojciecha Zajchowskiego 12 |82-300 Elbląg;2006;956;956;28;928;47.66;2.93
107957;286101;Szkoła Podstawowa Nr 23|Elbląg|ul. Słoneczna 14 |82-300 Elbląg;1977;962;962;37;925;48.66;3.85
107958;286101;Zespół Państwowych Szkół Muzycznych|Elbląg|ul. Romualda Traugutta 91 |82-300 Elbląg;1476;656;679;12;644;44.44;1.83
107959;286101;Zespół Szkół Ogólnokształcących|Elbląg|ul. Pocztowa 2 |82-300 Elbląg;1372;741;741;8;733;54.01;1.08
107960;286101;Szkoła Podstawowa Nr 21|Elbląg|ul. Zbyszka Godlewskiego 1 |82-300 Elbląg;1955;1076;1076;22;1054;55.04;2.04
107961;286101;Szkoła Podstawowa Nr 8|Elbląg|ul. Szańcowa 2 |82-300 Elbląg;1775;695;695;32;663;39.15;4.60
107962;286101;Zespół Szkół Techniczno-Informatycznych|Elbląg|ul. Rycerska 2 |82-300 Elbląg;1248;615;615;11;604;49.28;1.79
107963;286101;Przedszkole Nr 14|Elbląg|ul. Michała Bałuckiego 17 |82-300 Elbląg;1690;827;827;16;811;48.93;1.93
107964;286101;Państwowa Wyższa Szkoła Zawodowa|Elbląg|ul. Czerniakowska 22 |82-300 Elbląg;1798;568;568;28;540;31.59;4.93
107965;286101;Przedszkole Nr 18|Elbląg|ul. Romualda Mielczarskiego 47 |82-300 Elbląg;1024;381;381;6;375;37.21;1.57
107966;286101;Szkoła Podstawowa Nr 14|Elbląg|ul. Romualda Mielczarskiego 45 |82-300 Elbląg;1967;844;844;19;825;42.91;2.25
107967;286101;Gimnazjum Nr 7|Elbląg|ul. Lotnicza 12 |82-300 Elbląg;1908;898;898;22;876;47.06;2.45
107968;286101;Specjalny Ośrodek Szkolno-Wychowawczy Nr 2|Elbląg|ul. Polna 8A |82-300 Elbląg;1425;521;521;14;507;36.56;2.69
107969;286101;Szkoła Podstawowa Nr 4|Elbląg|ul. Adama Mickiewicza 41 |82-300 Elbląg;1828;866;866;23;843;47.37;2.66
107970;286101;Zespół Szkół Mechanicznych|Elbląg|ul. Jana Amosa Komeńskiego 39 |82-300 Elbląg;1464;643;643;14;629;43.92;2.18
107971;286101;Szkoła Podstawowa Nr 16|Elbląg|ul. Sadowa 2 |82-300 Elbląg;1465;618;618;13;605;42.18;2.10
107972;286101;Państwowa Wyższa Szkoła Zawodowa|Elbląg|Aleja Grunwaldzka 137 |82-300 Elbląg;2125;1048;1048;19;1029;49.32;1.81
107973;286101;Zespół Szkół Technicznych|Elbląg|ul. Artura Grottgera 71 |82-300 Elbląg;1508;718;718;15;703;47.61;2.09
107974;286101;Gimnazjum Nr 6|Elbląg|ul. Rawska 3 |82-300 Elbląg;1834;839;839;17;822;45.75;2.03
107975;286101;Przedszkole Niepubliczne "Wiki"|Elbląg|ul. Częstochowska 5 |82-300 Elbląg;1369;735;735;14;721;53.69;1.90
107976;286101;Wojewódzki Szpital Zespolony oraz Centrum Radioterapii i Usprawniania Nu-Med Grupa S.A.|Elbląg|ul. Królewiecka 146 |82-300 Elbląg;304;139;139;5;134;45.72;3.60
107977;286101;Samodzielny Publiczny Specjalistyczny Z.O.Z. Szpital Miejski im. Jana Pawła II|Elbląg|ul. Stefana Żeromskiego 22 |82-300 Elbląg;65;27;27;1;26;41.54;3.70
107978;286101;Elbląski Szpital Specjalistyczny z Przychodnią Samodzielny Publiczny Z.O.Z.|Elbląg|ul. Jana Amosa Komeńskiego 35 |82-300 Elbląg;129;56;56;5;51;43.41;8.93
107979;286101;B.BRAUN AVITUM POLAND Sp. z o.o. Przedsiębiorstwo Podmiotu Leczniczego "EL-VITA"|Elbląg|ul. Związku Jaszczurczego 22 |82-300 Elbląg;25;7;7;1;6;28.00;14.29
107980;286101;Areszt Śledczy|Elbląg|ul. 12 Lutego 4A |82-300 Elbląg;265;158;158;29;129;59.62;18.35
107981;286201;Zespół Szkół Ogólnokształcących Nr 1 II Liceum Ogólnokształcące im. K. I. Gałczyńskiego|Olsztyn|ul. Roberta i Karola Małłków 3 |10-113 Olsztyn;1031;432;432;4;428;41.90;0.93
107982;286201;I Liceum Ogólnokształcące im. A. Mickiewicza|Olsztyn|ul. Adama Mickiewicza 6 |10-551 Olsztyn;648;310;310;6;304;47.84;1.94
107983;286201;I Liceum Ogólnokształcące im. A. Mickiewicza|Olsztyn|ul. Adama Mickiewicza 6 |10-551 Olsztyn;1102;544;544;13;531;49.36;2.39
107984;286201;Specjalny Ośrodek Szkolno-Wychowawczy|Olsztyn|al. Marszałka Józefa Piłsudskiego 42 |10-450 Olsztyn;984;569;569;4;565;57.83;0.70
107985;286201;Szkoła Podstawowa Nr 2 im. J. Dąbrowskiego|Olsztyn|ul. Tadeusza Kościuszki 70 |10-553 Olsztyn;1230;652;652;17;635;53.01;2.61
107986;286201;Wojewódzka Biblioteka Publiczna, Wypożyczalnia Główna i Międzybiblioteczna|Olsztyn|ul. Stare Miasto 33 |10-026 Olsztyn;810;460;460;11;449;56.79;2.39
107987;286201;Uniwersytet Warmińsko-Mazurski w Olsztynie Studium Języków Obcych|Olsztyn|al. Obrońców Tobruku 3 |10-718 Olsztyn;1609;722;722;8;714;44.87;1.11
107988;286201;Uniwersytet Warmińsko-Mazurski w Olsztynie, Wydział Nauk Społecznych|Olsztyn|ul. Żołnierska 14 |10-561 Olsztyn;824;493;493;10;483;59.83;2.03
107989;286201;Szkoła Podstawowa Nr 29 im. J. Liszewskiego|Olsztyn|ul. Jarosława Iwaszkiewicza 44 |10-089 Olsztyn;1525;927;927;18;909;60.79;1.94
107990;286201;Szkoła Podstawowa Nr 29 im. J. Liszewskiego|Olsztyn|ul. Jarosława Iwaszkiewicza 44 |10-089 Olsztyn;1395;915;915;11;904;65.59;1.20
107991;286201;Generalna Dyrekcja Dróg Krajowych i Autostrad Oddział w Olsztynie|Olsztyn|al. Warszawska 89 |10-083 Olsztyn;2186;1248;1248;13;1235;57.09;1.04
107992;286201;Szkoła Podstawowa Nr 10 im. W. Broniewskiego|Olsztyn|ul. Walentego Barczewskiego 11 A |10-061 Olsztyn;1478;833;833;8;825;56.36;0.96
107993;286201;Szkoła Podstawowa Nr 10 im. W. Broniewskiego|Olsztyn|ul. Niepodległości 18 |10-045 Olsztyn;1712;872;872;15;857;50.93;1.72
107994;286201;Gimnazjum Nr 5|Olsztyn|ul. Marii Konopnickiej 11 |10-168 Olsztyn;1455;774;774;8;766;53.20;1.03
107995;286201;Gimnazjum Nr 5|Olsztyn|ul. Marii Konopnickiej 11 |10-168 Olsztyn;1318;671;671;12;659;50.91;1.79
107996;286201;Zespół Szkół Ogólnokształcących Nr 5 Mistrzostwa Sportowego im. Mariana Grzegorza Bublewicza|Olsztyn|ul. Kazimierza Jagiellończyka 32 |10-062 Olsztyn;1837;1105;1105;13;1092;60.15;1.18
107997;286201;Szkoła Podstawowa Nr 7 im. L. Kruczkowskiego|Olsztyn|al. Przyjaciół 42 |10-148 Olsztyn;1289;842;842;4;838;65.32;0.48
107998;286201;Stowarzyszenie Wyjątkowe Serce Warsztat Terapii Zajęciowej|Olsztyn|ul. Bałtycka 45 |10-175 Olsztyn;1807;1161;1161;15;1146;64.25;1.29
107999;286201;Szkoła Podstawowa Nr 19 im. Mikołaja Kopernika|Olsztyn|ul. Bałtycka 151 |11-041 Olsztyn;1497;799;799;7;792;53.37;0.88
108000;286201;Szkoła Podstawowa Nr 19 im. Mikołaja Kopernika|Olsztyn|ul. Bałtycka 151 |11-041 Olsztyn;1203;779;780;4;775;64.75;0.51
108001;286201;Przedszkole Kraina Bajek|Olsztyn|ul. Stokrotki 1 |11-041 Olsztyn;1610;1180;1180;9;1171;73.29;0.76
108002;286201;Przedszkole Miejskie Nr 14|Olsztyn|ul. Kłosowa 23A |10-818 Olsztyn;1362;826;826;11;815;60.65;1.33
108003;286201;Szkoła Podstawowa Nr 18 im. Orła Białego|Olsztyn|ul. Żytnia 71 |10-822 Olsztyn;1594;984;984;16;968;61.73;1.63
108004;286201;Gimnazjum Nr 14 im. Marszałka Józefa Piłsudskiego|Olsztyn|ul. Żytnia 71 |10-822 Olsztyn;1787;1137;1137;9;1128;63.63;0.79
108005;286201;Uniwersytet Warmińsko-Mazurski w Olsztynie Wydział Nauk Ekonomicznych|Olsztyn|ul. Michała Oczapowskiego 4 |10-719 Olsztyn;1048;725;725;5;720;69.18;0.69
108006;286201;Instytut Rozrodu Zwierząt i Badań Żywności Polskiej Akademii Nauk|Olsztyn|ul. Juliana Tuwima 10 |10-748 Olsztyn;920;618;618;9;609;67.17;1.46
108007;286201;Dom Studenta Nr 119|Olsztyn|ul. Benedykta Dybowskiego 9 |10-723 Olsztyn;697;511;511;9;502;73.31;1.76
108008;286201;Izba Celna|Olsztyn|ul. Dworcowa 1 |10-413 Olsztyn;948;422;422;4;418;44.51;0.95
108009;286201;Państwowe Liceum Plastyczne|Olsztyn|ul. Partyzantów 85 |10-527 Olsztyn;1158;466;466;5;461;40.24;1.07
108010;286201;Regionalna Dyrekcja Lasów Państwowych|Olsztyn|ul. Tadeusza Kościuszki 46/48 |10-959 Olsztyn;1305;679;679;13;666;52.03;1.91
108011;286201;Szkoła Podstawowa Nr 15 im. W. Kętrzyńskiego|Olsztyn|ul. Wojciecha Kętrzyńskiego 10 |10-507 Olsztyn;1433;729;729;13;716;50.87;1.78
108012;286201;Gimnazjum Nr 3|Olsztyn|ul. Kołobrzeska 9 |10-444 Olsztyn;1401;793;793;9;784;56.60;1.13
108013;286201;Gimnazjum Nr 3|Olsztyn|ul. Kołobrzeska 9 |10-444 Olsztyn;1624;883;883;12;871;54.37;1.36
108014;286201;Szkoła Podstawowa Nr 3|Olsztyn|ul. Kołobrzeska 13M |10-445 Olsztyn;1118;607;607;10;597;54.29;1.65
108015;286201;Zespół Szkół Chemicznych i Ogólnokształcących im. J. Śniadeckiego|Olsztyn|ul. Kołobrzeska 29 |10-431 Olsztyn;1194;546;546;14;532;45.73;2.56
108016;286201;Przedszkole Artystyczno-Teatralne "Dorotka"|Olsztyn|ul. Świtezianki 2 |10-465 Olsztyn;1220;713;713;10;703;58.44;1.40
108017;286201;Przedszkole Miejskie Nr 37|Olsztyn|ul. Pana Tadeusza 12A |10-461 Olsztyn;1312;784;784;10;774;59.76;1.28
108018;286201;Zespół Szkół Mechaniczno-Energetycznych im. T. Kościuszki|Olsztyn|al. Marszałka Józefa Piłsudskiego 61 |10-499 Olsztyn;1542;898;898;13;885;58.24;1.45
108019;286201;Izba Skarbowa|Olsztyn|al. Marszałka Józefa Piłsudskiego 59 A |10-950 Olsztyn;1070;654;654;15;639;61.12;2.29
108020;286201;Zespół Szkół Ogólnokształcących Nr 2 IV Liceum Ogólnokształcące im. M. Skłodowskiej-Curie|Olsztyn|al. Marszałka Józefa Piłsudskiego 56 |10-450 Olsztyn;1584;877;877;25;852;55.37;2.85
108021;286201;Gimnazjum Nr 7 im. I. Krasickiego|Olsztyn|ul. Żołnierska 39 |10-560 Olsztyn;1583;880;880;16;864;55.59;1.82
108022;286201;Gimnazjum Nr 7 im. I. Krasickiego|Olsztyn|ul. Żołnierska 39 |10-560 Olsztyn;1574;800;800;8;792;50.83;1.00
108023;286201;Przedszkole Miejskie Nr 38|Olsztyn|ul. Żołnierska 24 |10-561 Olsztyn;1606;878;878;13;865;54.67;1.48
108024;286201;Zespół Szkół Gastronomiczno-Spożywczych|Olsztyn|ul. Żołnierska 49 |10-560 Olsztyn;1208;667;667;13;654;55.22;1.95
108025;286201;Szkoła Podstawowa Nr 22 im. M. Dąbrowskiej|Olsztyn|ul. Żołnierska 26 |10-561 Olsztyn;1403;794;794;23;771;56.59;2.90
108026;286201;Przedszkole Miejskie Nr 17|Olsztyn|ul. Wincentego Pstrowskiego 17a |10-601 Olsztyn;2162;1205;1205;7;1198;55.74;0.58
108027;286201;Szkoła Podstawowa Nr 6 im. K. I. Gałczyńskiego|Olsztyn|ul. Gdyńska 17 |10-608 Olsztyn;1886;1170;1170;13;1157;62.04;1.11
108028;286201;Przedszkole Miejskie Nr 3|Olsztyn|ul. Opolska 28 |10-626 Olsztyn;2180;1344;1344;19;1325;61.65;1.41
108029;286201;Zespół Szkół Ogólnokształcących Nr 4|Olsztyn|ul. Edwarda Turowskiego 3 |10-685 Olsztyn;1728;959;959;17;942;55.50;1.77
108030;286201;Przedszkole Miejskie Nr 31|Olsztyn|ul. Melchiora Wańkowicza 4 |10-684 Olsztyn;2265;1319;1319;22;1297;58.23;1.67
108031;286201;Przedszkole Miejskie Nr 32|Olsztyn|ul. Stanisława Murzynowskiego 24 |10-684 Olsztyn;1698;931;931;14;917;54.83;1.50
108032;286201;Spółdzielnia Mieszkaniowa "Jaroty"|Olsztyn|ul. Melchiora Wańkowicza 9 |10-684 Olsztyn;2054;1135;1135;23;1112;55.26;2.03
108033;286201;Zespół Szkół Ogólnokształcących Nr 3|Olsztyn|ul. Melchiora Wańkowicza 1 |10-684 Olsztyn;1345;802;802;18;784;59.63;2.24
108034;286201;Społeczna Szkoła Podstawowa Nr 101|Olsztyn|ul. Edwarda Mroza 25 |10-692 Olsztyn;2077;1240;1240;16;1224;59.70;1.29
108035;286201;Społeczne Gimnazjum 101|Olsztyn|ul. Edwarda Mroza 25 |10-692 Olsztyn;1854;1147;1147;9;1138;61.87;0.78
108036;286201;Miejska Biblioteka Publiczna Filia Nr 6|Olsztyn|ul. Jarocka 65 |10-699 Olsztyn;1403;816;816;10;806;58.16;1.23
108037;286201;Miejska Biblioteka Publiczna Filia Nr 6|Olsztyn|ul. Jarocka 65 |10-699 Olsztyn;1450;879;879;11;868;60.62;1.25
108038;286201;Spółdzielnia Mieszkaniowa "Kormoran"|Olsztyn|ul. Gen. Zygmunta Berlinga 2 |10-693 Olsztyn;1313;814;814;5;809;62.00;0.61
108039;286201;Przedszkole Miejskie Nr 5|Olsztyn|ul. Gen. Stanisława Maczka 11 |10-693 Olsztyn;1535;964;964;11;953;62.80;1.14
108040;286201;Przedszkole Miejskie Nr 5|Olsztyn|ul. Gen. Stanisława Maczka 11 |10-693 Olsztyn;1824;1202;1202;14;1188;65.90;1.16
108041;286201;Rada Osiedla "Generałów"|Olsztyn|ul. Gen. Tadeusza Kutrzeby 9 S|10-693 Olsztyn;1457;797;797;14;783;54.70;1.76
108042;286201;Szkoła Podstawowa Nr 30 im. M. Zientary-Malewskiej|Olsztyn|ul. Pieczewska 10 |10-699 Olsztyn;848;525;525;9;516;61.91;1.71
108043;286201;Przedszkole Miejskie Nr 29|Olsztyn|ul. Juliusza Malewskiego 2A |10-686 Olsztyn;1490;910;910;9;901;61.07;0.99
108044;286201;Spółdzielnia Mieszkaniowa "Jaroty" Administracja Osiedla Jaroty|Olsztyn|ul. Kazimierza Jaroszyka 14 |10-687 Olsztyn;2129;1274;1274;22;1252;59.84;1.73
108045;286201;Spółdzielnia Mieszkaniowa "Jaroty" Administracja Osiedla Pieczewo|Olsztyn|ul. Bolesława Jeziołowicza 11 |10-690 Olsztyn;1758;1027;1027;14;1013;58.42;1.36
108046;286201;Przedszkole Miejskie Nr 15 im. Wandy Chotomskiej|Olsztyn|ul. Jana Boenigka 5 |10-686 Olsztyn;1777;1022;1022;16;1006;57.51;1.57
108047;286201;Przedszkole Miejskie Nr 15 im. Wandy Chotomskiej|Olsztyn|ul. Jana Boenigka 5 |10-686 Olsztyn;1685;1000;1000;20;980;59.35;2.00
108048;286201;Gimnazjum Nr 13 im. H. Wagnera|Olsztyn|ul. Bolesława Jeziołowicza 2 |10-690 Olsztyn;1546;903;903;20;883;58.41;2.21
108049;286201;Gimnazjum Nr 13 im. H. Wagnera|Olsztyn|ul. Bolesława Jeziołowicza 2 |10-690 Olsztyn;1386;826;826;12;814;59.60;1.45
108050;286201;Szkoła Podstawowa Nr 32 im. Jana Brzechwy|Olsztyn|ul. Ernesta Wiecherta 14 |10-691 Olsztyn;1865;1094;1094;12;1082;58.66;1.10
108051;286201;AAI-Polska AIKIDO|Olsztyn|ul. Immanuela Kanta 15A |10-691 Olsztyn;2255;1407;1407;7;1400;62.39;0.50
108052;286201;Osiedlowy Dom Kultury S. M. "Jaroty" Klub "Akant"|Olsztyn|ul. Immanuela Kanta 11 |10-691 Olsztyn;2154;1293;1293;12;1281;60.03;0.93
108053;286201;Poradnia Lekarza Rodzinnego Bogusława Solnica Podmiot Leczniczy Bogusława Solnica|Olsztyn|ul. Balbiny Świtycz - Widackiej 3 |10-691 Olsztyn;1982;1238;1238;25;1213;62.46;2.02
108054;286201;Szkoła Podstawowa Nr 34|Olsztyn|ul. Johanna Gottfrieda Herdera 3 |10-691 Olsztyn;2016;1175;1175;25;1150;58.28;2.13
108055;286201;Szkoła Podstawowa Nr 1 im. R. Knosały|Olsztyn|ul. Stanisława Moniuszki 10 |10-275 Olsztyn;1433;678;678;12;666;47.31;1.77
108056;286201;Szkoła Podstawowa Nr 13 im. Komisji Edukacji Narodowej|Olsztyn|ul. Aleksandra Puszkina 11 |10-295 Olsztyn;2135;1160;1160;11;1149;54.33;0.95
108057;286201;Zespół Szkół Samochodowych im. A. M. Bocheńskiego|Olsztyn|al. Wojska Polskiego 17 |10-224 Olsztyn;1501;659;659;14;645;43.90;2.12
108058;286201;Zespół Szkół Samochodowych im. A. M. Bocheńskiego|Olsztyn|al. Wojska Polskiego 17 |10-224 Olsztyn;2006;1088;1088;14;1074;54.24;1.29
108059;286201;Gimnazjum Nr 11|Olsztyn|ul. Jagiellońska 8 |10-271 Olsztyn;2042;939;939;30;909;45.98;3.19
108060;286201;Centrum Edukacji i Inicjatyw Kulturalnych|Olsztyn|ul. Parkowa 1 |10-233 Olsztyn;1045;550;550;11;539;52.63;2.00
108061;286201;Centrum Edukacji "Oskar" Przedszkole "Patryk"|Olsztyn|ul. Wiśniowa 11 |10-321 Olsztyn;917;498;498;11;487;54.31;2.21
108062;286201;Szkoła Podstawowa Nr 1 im. R. Knosały|Olsztyn|ul. Stanisława Moniuszki 10 |10-275 Olsztyn;1978;975;975;23;952;49.29;2.36
108063;286201;Szkoła Podstawowa Nr 9|Olsztyn|ul. Ludwika Zamenhofa 14 |10-130 Olsztyn;2152;1064;1064;23;1041;49.44;2.16
108064;286201;Szkoła Podstawowa Nr 9|Olsztyn|ul. Ludwika Zamenhofa 14 |10-130 Olsztyn;2177;1266;1266;17;1249;58.15;1.34
108065;286201;Gimnazjum Nr 12|Olsztyn|al. Sybiraków 3A |10-256 Olsztyn;1331;635;635;26;609;47.71;4.09
108066;286201;III Liceum Ogólnokształcące im. M. Kopernika|Olsztyn|al. Sybiraków 3 |10-256 Olsztyn;1081;573;573;8;565;53.01;1.40
108067;286201;Zespół Szkół Elektronicznych i Telekomunikacyjnych|Olsztyn|ul. Bałtycka 37A |10-144 Olsztyn;1185;694;694;7;687;58.57;1.01
108068;286201;Miejski Szpital Zespolony|Olsztyn|ul. Niepodleglości 44 |10-045 Olsztyn;137;31;31;0;31;22.63;0.00
108069;286201;Miejski Szpital Zespolony|Olsztyn|al. Wojska Polskiego 30 |10-226 Olsztyn;35;19;19;2;17;54.29;10.53
108070;286201;Wojewódzki Szpital Specjalistyczny|Olsztyn|ul. Żołnierska 18 |10-561 Olsztyn;238;100;100;4;96;42.02;4.00
108071;286201;Wojewódzki Zespół Lecznictwa Psychiatrycznego|Olsztyn|al. Wojska Polskiego 35 |10-228 Olsztyn;267;40;40;4;36;14.98;10.00
108072;286201;Samodzielny Publiczny Zakład Opieki Zdrowotnej Ministerstwa Spraw Wewnętrznych z Warmińsko-Mazurskim Centrum Onkologii|Olsztyn|al. Wojska Polskiego 37 |10-228 Olsztyn;158;72;72;3;69;45.57;4.17
108073;286201;Samodzielny Publiczny Zespół Gruźlicy i Chorób Płuc|Olsztyn|ul. Jagiellońska 78 |10-357 Olsztyn;125;59;59;4;55;47.20;6.78
108074;286201;Uniwersytecki Szpital Kliniczny|Olsztyn|Al. Warszawska 30 |10-082 Olsztyn;95;33;33;0;33;34.74;0.00
108075;286201;Niepubliczny Zakład Opieki Zdrowotnej Ośrodek Mieszkalno-Rehabilitacyjny Polski Związek Niewidomych|Olsztyn|ul. Paukszty 57 |10-685 Olsztyn;185;85;85;2;83;45.95;2.35
108076;286201;Dom Pomocy Społecznej „Kombatant”|Olsztyn|ul. Juliana Fałata 23K |10-211 Olsztyn;127;41;41;2;39;32.28;4.88
108077;286201;Dom Pomocy Społecznej i Dom Opieki „Laurentius”|Olsztyn|ul. Hozjusza 19 |11-041 Olsztyn;91;28;28;2;26;30.77;7.14
108078;286201;Dom Pomocy Społecznej|Olsztyn|ul. Bałtycka 37a |10-144 Olsztyn;38;22;22;3;19;57.89;13.64
108079;286201;Dom Pomocy Społecznej „BARKA”|Olsztyn|ul. Jacka Kuronia 5 |10-165 Olsztyn;44;10;10;0;10;22.73;0.00
108080;286201;Areszt Śledczy|Olsztyn|al. Marszałka Józefa Piłsudskiego 3 |10-575 Olsztyn;116;63;63;8;55;54.31;12.70
108081;286201;Oddział Zewnętrzny Aresztu Śledczego|Olsztyn|ul. Opolska 42 |10-626 Olsztyn;253;85;85;13;72;33.60;15.29
108082;300101;Niepubliczne Przedszkole nr 3 " Wesoły Smyk"|Chodzież|ul. Bolesława Prusa 14 |64-800 Chodzież;2209;1139;1139;20;1119;51.56;1.76
108083;300101;Miejskie Gimnazjum im. Ignacego Jana Paderewskiego|Chodzież|ul. Ignacego Jana Paderewskiego 13 |64-800 Chodzież;2077;1155;1155;35;1120;55.61;3.03
108084;300101;Miejskie Przedszkole nr 5|Chodzież|ul. Władysława Reymonta 25 |64-800 Chodzież;2022;1145;1145;23;1122;56.63;2.01
108085;300101;Zespół Szkół Ponadgimnazjalnych im. Hipolita Cegielskiego|Chodzież|ul. Prymasa Stefana Wyszyńskiego 2 |64-800 Chodzież;1963;928;928;20;908;47.27;2.16
108086;300101;I Liceum Ogólnokształcące im. św. Barbary|Chodzież|ul. Stefana Żeromskiego 11 |64-800 Chodzież;1895;854;854;24;830;45.07;2.81
108087;300101;Szkoła Podstawowa nr 1 im. Stanislawa Staszica|Chodzież|ul. Stanisława Staszica 19 |64-800 Chodzież;1913;867;867;28;839;45.32;3.23
108088;300101;Chodzieski Dom Kultury im. Stanisława Moniuszki|Chodzież|ul. Strzelecka 15 |64-800 Chodzież;1149;610;610;11;599;53.09;1.80
108089;300101;Szkoła Podstawowa Nr 3 im. Powstańców Wielkopolskich|Chodzież|ul. Jana Kochanowskiego 1 |64-800 Chodzież;2044;1070;1070;43;1027;52.35;4.02
108090;300101;Budynek Domu Pomocy Społecznej|Chodzież|Ujska 47 |64-800 Chodzież;108;39;39;9;30;36.11;23.08
108091;300101;Budynek Szpitala Powiatowego|Chodzież|Stefana Żeromskiego 29 |64-800 Chodzież;41;23;23;0;23;56.10;0.00
108092;300101;Budynek Szpitala w Chodzieży|Chodzież|Strzelecka 32 |64-800 Chodzież;179;86;86;9;77;48.04;10.47
108093;300102;Szkoła Podstawowa im. Tadeusza Kotarbińskiego w Budzyniu|Budzyń|os. Wierzbowe 7 |64-840 Budzyń;1473;750;750;43;707;50.92;5.73
108094;300102;Gimnazjum im. Powstańców Wielkopolskich w Budzyniu|Budzyń|ul. Rogozińska 52 |64-840 Budzyń;1967;986;986;19;967;50.13;1.93
108095;300102;Gminny Ośrodek Kultury w Budzyniu|Budzyń|ul. Władysława Łokietka 31 |64-840 Budzyń;1267;410;410;11;399;32.36;2.68
108096;300102;Budynek byłej Szkoły Podstawowej w Sokołowie Budzyńskim|Sokołowo Budzyńskie| 28 |64-841 Sokołowo Budzyńskie;737;236;236;14;222;32.02;5.93
108097;300102;Wiejski Dom Kultury w Wyszynach|Wyszyny| 23 |64-834 Wyszyny;1156;469;469;38;431;40.57;8.10
108098;300103;Świetlica Wiejska|Rataje|Osiedle Wichrowe Wzgórze 1 |64-800 Chodzież;835;503;503;7;496;60.24;1.39
108099;300103;Świetlica Wiejska|Strzelce| 24 |64-800 Chodzież;680;266;266;22;244;39.12;8.27
108100;300103;Szkoła Podstawowa w Strzelcach Filia w Zacharzynie|Zacharzyn| 142 |64-813 Zacharzyn;963;395;395;17;378;41.02;4.30
108101;300103;Świetlica Wiejska|Podanin| 28 |64-800 Chodzież;394;177;177;9;168;44.92;5.08
108102;300103;Wiejski Klub Kultury|Stróżewo| 55A |64-800 Chodzież;452;208;208;13;195;46.02;6.25
108103;300103;Szkoła Podstawowa|Oleśnica| 5 |64-800 Chodzież;314;152;152;4;148;48.41;2.63
108104;300103;Świetlica Wiejska|Nietuszkowo| 42 |64-800 Chodzież;255;135;135;10;125;52.94;7.41
108105;300103;Wiejski Klub Kultury|Milcz| 73A |64-800 Chodzież;582;246;246;13;233;42.27;5.28
108106;300104;Miejsko-Gminny Ośrodek Kultury|Margonin|ul. Powstańców Wielkopolskich 15 |64-830 Margonin;1747;901;901;28;873;51.57;3.11
108107;300104;Urząd Stanu Cywilnego - Pałac Ślubów|Margonin|ul. Poznańska 8 |64-830 Margonin;1235;542;542;31;511;43.89;5.72
108108;300104;Ośrodek Wypoczynkowy|Zbyszewice| 1A |64-830 Margonin;686;275;275;24;251;40.09;8.73
108109;300104;Spółdzielnia "Adorol"|Adolfowo| 22A |64-830 Margonin;397;183;183;9;174;46.10;4.92
108110;300104;Szkoła Podstawowa|Lipiny| 40 |64-830 Margonin;388;169;169;6;163;43.56;3.55
108111;300104;Miejsko-Gminna Biblioteka Publiczna w Margoninie, Filia w Radwankach|Radwanki|Radwanki 30b |64-830 Margonin;478;196;196;12;184;41.00;6.12
108112;300105;Biblioteka Publiczna w Szamocinie|Szamocin|ul. Rynek 1 |64-820 Szamocin;1544;725;725;29;696;46.96;4.00
108113;300105;Zespół Szkół w Szamocinie|Szamocin|ul. 19 Stycznia 29 |64-820 Szamocin;1706;771;771;49;722;45.19;6.36
108114;300105;Dom Kultury|Lipia Góra| 88a |64-820 Szamocin;1245;365;365;15;350;29.32;4.11
108115;300105;Budynek Gminny|Józefowice| 38 |64-820 Szamocin;493;157;157;14;143;31.85;8.92
108116;300105;Ośrodek Szkolenia i Wychowania OHP|Szamocin|ul. Szkolna 11 |64-820 Szamocin;820;348;348;9;339;42.44;2.59
108117;300201;Przedszkole Miejskie Nr 2|Czarnków|os.Parkowe 10 |64-700 Czarnków;1786;987;987;31;956;55.26;3.14
108118;300201;Gimnazjum Publiczne|Czarnków|ul.Wroniecka 136 |64-700 Czarnków;1801;990;990;35;955;54.97;3.54
108119;300201;Miejskie Centrum Kultury|Czarnków|ul.Kościuszki 60 |64-700 Czarnków;1665;725;725;22;703;43.54;3.03
108120;300201;Przedszkole Miejskie Nr 1|Czarnków|ul.Rolna 2 |64-700 Czarnków;1833;1080;1080;50;1030;58.92;4.63
108121;300201;Miejska Biblioteka Publiczna (Muzeum)|Czarnków|ul.Wroniecka 32 |64-700 Czarnków;1723;882;882;26;856;51.19;2.95
108122;300201;Szpital Powiatowy w Czarnkowie|Czarnków|Kościuszki 94 |64-700 Czarnków;43;23;23;1;22;53.49;4.35
108123;300202;Zespół Szkół|Romanowo Dolne| 123 |64-704 Romanowo Dolne;632;315;315;20;295;49.84;6.35
108124;300202;Szkoła Podstawowa|Sarbia| 1 |64-705 Sarbia;688;313;313;6;307;45.49;1.92
108125;300202;Zespół Szkół|Gębice|ul. Szkolna 2 |64-707 Gębice;837;340;340;18;322;40.62;5.29
108126;300202;Szkoła Podstawowa|Huta|ul. Radomska 22 |64-708 Huta;746;345;345;11;334;46.25;3.19
108127;300202;Szkoła Podstawowa|Śmieszkowo|ul. Szkolna 38 |64-700 Czarnków;845;388;388;11;377;45.92;2.84
108128;300202;Sala Wiejska|Ciszkowo|Lipowa 7 |64-700 Czarnków;894;410;410;20;390;45.86;4.88
108129;300202;Zespół Szkół|Jędrzejewo| 25 |64-713 Jędrzejewo;870;327;327;7;320;37.59;2.14
108130;300202;Sala Wiejska|Gajewo| 51 |64-713 Jędrzejewo;878;306;306;12;294;34.85;3.92
108131;300202;Zespół Szkół|Kuźnica Czarnkowska|ul. Szkolna 10 |64-700 Czarnków;1072;397;397;25;372;37.03;6.30
108132;300202;Zespół Szkół|Romanowo Górne| 72 |64-704 Romanowo Dolne;635;257;257;8;249;40.47;3.11
108133;300202;Budynek byłej Szkoły Podstawowej|Brzeźno|ul.Czarnkowska 17 |64-700 Czarnków;621;248;248;12;236;39.94;4.84
108134;300203;Sala Posiedzeń Urzędu Gminy Drawsko|Drawsko|ul. Powstańców Wielkopolskich 121 |64-733 Drawsko;1318;568;568;25;543;43.10;4.40
108135;300203;Szkoła Podstawowa im.św.Urszuli Ledóchowskiej|Drawski Młyn|ul. Szosa Dworcowa 2 |64-731 Drawsko;827;344;344;12;332;41.60;3.49
108136;300203;Szkoła Podstawowa im. Jana Pawła II|Piłka| 24 |64-733 Drawsko;610;243;243;17;226;39.84;7.00
108137;300203;Szkoła Podstawowa im. Józefa Noji|Pęckowo|ul. Powstańców Wielkopolskich 1 |64-733 Drawsko;801;324;324;24;300;40.45;7.41
108138;300203;Gimnazjum im.Ziemi Nadnoteckiej|Chełst| 64 |64-733 Drawsko;1191;423;423;17;406;35.52;4.02
108139;300204;Szkoła Podstawowa|Krzyż Wielkopolski|ul. Wojska Polskiego 31 |64-761 Krzyż Wielkopolski;2175;891;891;40;851;40.97;4.49
108140;300204;Miejsko Gminny Ośrodek Kultury|Krzyż Wielkopolski|Wojska Polskiego 11 |64-761 krzyż wielkopolski;1801;710;710;29;681;39.42;4.08
108141;300204;Zespół Szkół Ogólnokształcących|Krzyż Wielkopolski|ul. Sienkiewicza 1 |64-761 Krzyż Wielkopolski;1941;820;820;24;796;42.25;2.93
108142;300204;Szkoła Podstawowa|Kuźnica Żelichowska| 8 |64-761 Krzyż Wielkopolski;504;189;189;9;180;37.50;4.76
108143;300204;Sala wiejska|Huta Szklana| 42 |64-761 Krzyż Wielkopolski;591;211;211;11;200;35.70;5.21
108144;300205;Publiczna Szkoła Podstawowa w Lubaszu|Lubasz|ul.Szkolna 6 |64-720 Lubasz;1248;589;589;23;566;47.20;3.90
108145;300205;Publiczna Szkoła Podstawowa w Lubaszu|Lubasz|ul.Szkolna 6 |64-720 Lubasz;1148;635;635;33;602;55.31;5.20
108146;300205;Pałac Spółdzielni Produkcji Rolnej w Sławnie|Sławno| 1 |64-720 Lubasz;883;292;292;11;281;33.07;3.77
108147;300205;Publiczna Szkoła Podstawowa w Miłkowie|Miłkowo| 11 |64-720 Lubasz;675;290;290;11;279;42.96;3.79
108148;300205;Publiczna Szkoła Podstawowa w Kruczu|Krucz| 62 |64-720 Lubasz;657;267;267;13;254;40.64;4.87
108149;300205;Gimnazjum w Lubaszu|Lubasz|ul.Podgórna 8A |64-720 Lubasz;1204;466;466;17;449;38.70;3.65
108150;300206;Szkoła Podstawowa im. Arkadego Fiedlera|Połajewo|ul. Leśna 1 |64-710 Połajewo;1954;861;861;72;789;44.06;8.36
108151;300206;Gminny Ośrodek Kultury|Połajewo|ul. Obornicka 1 |64-710 Połajewo;718;269;269;9;260;37.47;3.35
108152;300206;Szkoła Podstawowa im. Kornela Makuszyńskiego|Boruszyn| 25 |64-710 Połajewo;1490;583;583;50;533;39.13;8.58
108153;300206;Gimnazjum im. Jana Pawła II|Młynkowo| 109 |64-710 Połajewo;652;305;305;14;291;46.78;4.59
108154;300207;Nadleśnictwo Trzcianka|Trzcianka|ul. Ogrodowa 2 |64-980 Trzcianka;938;472;472;24;448;50.32;5.08
108155;300207;Szkoła Podstawowa Nr 2 w Trzciance|Trzcianka|ul. Fryderyka Chopina 36 |64-980 Trzcianka;972;481;481;11;470;49.49;2.29
108156;300207;Gimnazjum Nr 2 w Trzciance|Trzcianka|ul. Fryderyka Chopina 36 |64-980 Trzcianka;861;449;449;11;438;52.15;2.45
108157;300207;Szkoła Podstawowa Nr 2 w Trzciance|Trzcianka|ul. Fryderyka Chopina 36 |64-980 Trzcianka;843;329;329;10;319;39.03;3.04
108158;300207;Zespół Szkół Technicznych w Trzciance|Trzcianka|ul. 27 Stycznia 100 |64-980 Trzcianka;941;394;394;37;357;41.87;9.39
108159;300207;Liceum Ogólnokształcące w Trzciance|Trzcianka|ul. Stefana Żeromskiego 28 |64-980 Trzcianka;894;355;355;18;337;39.71;5.07
108160;300207;Gimnazjum Nr 1 w Trzciance|Trzcianka|ul. Stanisława Staszica 6 |64-980 Trzcianka;654;374;374;8;366;57.19;2.14
108161;300207;Gimnazjum Nr 1 w Trzciance|Trzcianka|ul. Stanisława Staszica 6 |64-980 Trzcianka;1103;563;563;8;555;51.04;1.42
108162;300207;Szkoła Podstawowa Nr 3 w Trzciance|Trzcianka|ul. Broniewskiego 2 |64-980 Trzcianka;832;392;392;8;384;47.12;2.04
108163;300207;Gimnazjum Nr 1 w Trzciance|Trzcianka|ul. Stanisława Staszica 6 |64-980 Trzcianka;963;507;507;9;498;52.65;1.78
108164;300207;Młodzieżowy Dom Kultury w Trzciance|Trzcianka|ul. Gen. Władysława Sikorskiego 26 |64-980 Trzcianka;817;402;402;15;387;49.20;3.73
108165;300207;Miejsko-Gminny Ośrodek Pomocy Społecznej w Trzciance|Trzcianka|os. Juliusza Słowackiego 24 |64-980 Trzcianka;853;452;452;13;439;52.99;2.88
108166;300207;Młodzieżowy Dom Kultury w Trzciance|Trzcianka|ul. Gen. Władysława Sikorskiego 26 |64-980 Trzcianka;980;436;436;7;429;44.49;1.61
108167;300207;Gminne Przedszkole Nr 3 w Trzciance|Trzcianka|os. Juliusza Słowackiego 24A |64-980 Trzcianka;858;412;412;5;407;48.02;1.21
108168;300207;Szkoła Podstawowa Nr 3 w Trzciance|Trzcianka|ul. Władysława Broniewskiego 2 |64-980 Trzcianka;841;381;381;7;374;45.30;1.84
108169;300207;Zespół Szkół w Siedlisku|Siedlisko| 160 |64-980 Trzcianka;727;273;273;14;259;37.55;5.13
108170;300207;Gminne Przedszkole w Siedlisku, Oddział w Nowej Wsi|Nowa Wieś| 37 |64-980 Trzcianka;998;360;360;13;347;36.07;3.61
108171;300207;Zespół Szkół w Siedlisku|Siedlisko| 160 |64-980 Trzcianka;1122;371;371;9;362;33.07;2.43
108172;300207;Szkoła Podstawowa w Łomnicy|Łomnica| 7 |64-980 Trzcianka;908;258;258;4;254;28.41;1.55
108173;300207;Szkoła Podstawowa w Białej|Biała|ul. Radolińska 9 |64-980 Trzcianka;892;337;337;11;326;37.78;3.26
108174;300207;Szkoła Podstawowa w Łomnicy, Oddział Przedszkolny w Stobnie|Stobno| 60 |64-980 Trzcianka;759;305;305;10;295;40.18;3.28
108175;300207;Szpital Powiatowy im. Jana Pawła II w Trzciance|Trzcianka|gen. Władysława Sikorskiego 9 |64-980 Trzcianka;64;39;39;1;38;60.94;2.56
108176;300208;Świetlica przy Szkole Podstawowej|Wieleń|ul.Nowe Miasto 18 |64-730 Wieleń;1666;665;665;36;629;39.92;5.41
108177;300208;Zespół Domów Pomocy Społecznej|Wieleń|ul. Staszica 2 |64-730 Wieleń;206;141;141;13;128;68.45;9.22
108178;300208;Wieleń, Ośrodek Kultury "Strzelnica"|Wieleń|ul. Dworcowa 1 |64-730 Wieleń;2030;1064;1064;37;1027;52.41;3.48
108179;300208;Wieleń, Gimnazjum|Wieleń|ul. Jana Pawła II 3 |64-730 Wieleń;1317;493;493;29;464;37.43;5.88
108180;300208;Rosko, Gimnazjum|Rosko|ul. Powstańców Wlkp. 15 |64-730 Wieleń;1019;403;403;29;374;39.55;7.20
108181;300208;Szkoła Podstawowa|Dzierżążno Wielkie| 24 |64-730 Wieleń;913;254;254;17;237;27.82;6.69
108182;300208;Przedszkole|Folsztyn| 18 |64-730 Wieleń;843;251;251;19;232;29.77;7.57
108183;300208;Szkoła Podstawowa|Gulcz|ul. Czarnkowska 10 |64-730 Wieleń;547;218;218;16;202;39.85;7.34
108184;300208;Szkoła Podstawowa|Miały|ul. Powstańców Wlkp. 13 |64-730 Wieleń;950;383;383;37;346;40.32;9.66
108185;300208;Zamiejscowy Oddział Przedszkolny Szkoły Podstawowej w Rosku z siedzibą we Wrzeszczynie|Wrzeszczyna|ul. 4 Lutego 13 |64-730 Wieleń;435;178;178;13;165;40.92;7.30
108186;300301;Szkoła Podstawowa Nr 5|Gniezno|ul. B. Chrobrego 12 |62-200 Gniezno;788;323;323;16;307;40.99;4.95
108187;300301;Zespół Szkół Ponadgimnazjalnych Nr 3|Gniezno|ul. Sienkiewicza 6 |62-200 Gniezno;1508;715;715;26;689;47.41;3.64
108188;300301;II Liceum Ogólnokształcące im. Dąbrówki|Gniezno|ul. Ks. Prymasa M. Łubieńskiego 3/5 |62-200 Gniezno;1376;664;664;15;649;48.26;2.26
108189;300301;Szkoła Podstawowa nr 2|Gniezno|ul. Ks. Prymasa M. Łubieńskiego 7 |62-200 Gniezno;846;359;359;7;352;42.43;1.95
108190;300301;Medyczne Studium Zawodowe|Gniezno|ul. Mieszka I 27 |62-200 Gniezno;1212;597;597;18;579;49.26;3.02
108191;300301;Przedszkole nr 12|Gniezno|ul. T. Kościuszki 21 |62-200 Gniezno;1197;486;486;15;471;40.60;3.09
108192;300301;LOK Ośrodek Szkolenia Kierowców|Gniezno|ul. Jeziorna 9 |62-200 Gniezno;2206;857;857;43;814;38.85;5.02
108193;300301;Gimnazjum Nr 1|Gniezno|ul. św. Jana 2a |62-200 Gniezno;2268;994;994;41;953;43.83;4.12
108194;300301;Szkoła Podstawowa Nr 3|Gniezno|ul. Czarnieckiego 7 |62-200 Gniezno;2356;1366;1366;44;1322;57.98;3.22
108195;300301;I Liceum Ogólnokształcące im. B. Chrobrego|Gniezno|ul. Kostrzewskiego 3 |62-200 Gniezno;1194;665;665;16;649;55.70;2.41
108196;300301;Budynek administracyjny Wojewódzkiego Szpitala dla Nerwowo i Psychicznie Chorych|Gniezno|ul. Poznańska 15 |62-200 Gniezno;1393;830;830;14;816;59.58;1.69
108197;300301;I Liceum Ogólnokształcące im. B. Chrobrego|Gniezno|Kostrzewskiego 3 |62-200 Gniezno;2020;1228;1228;24;1204;60.79;1.95
108198;300301;Przedszkole Nr 2 (budynek byłych koszar jednostki wojskowej)|Gniezno|ul. Wrzesińska 49A |62-200 Gniezno;1268;685;685;21;664;54.02;3.07
108199;300301;Przedszkole Nr 2 (budynek byłych koszar jednostki wojskowej)|Gniezno|ul. Wrzesińska 49A |62-200 Gniezno;1256;719;719;23;696;57.25;3.20
108200;300301;Miejskie Przedsiębiorstwo Komunikacyjne Sp. z o.o.|Gniezno|ul. Wesoła 7 |62-200 Gniezno;1064;501;501;13;488;47.09;2.59
108201;300301;Szkoła Podstawowa Nr 8|Gniezno|ul. P. Cymsa 14 |62-200 Gniezno;1383;685;685;29;656;49.53;4.23
108202;300301;Przedszkole nr 6|Gniezno|ul. Wiosenna 7 |62-200 Gniezno;1110;511;511;20;491;46.04;3.91
108203;300301;Szkoła Podstawowa nr 8|Gniezno|ul. Cymsa 14 |62-200 Gniezno;1359;801;801;13;788;58.94;1.62
108204;300301;Szkoła Podstawowa nr 8|Gniezno|ul. Cymsa 14 |62-200 Gniezno;1289;693;693;23;670;53.76;3.32
108205;300301;Szkoła Podstawowa Nr 8|Gniezno|ul. Cymsa 14 |62-200 Gniezno;1243;742;743;10;732;59.69;1.35
108206;300301;Szkoła Podstawowa Nr 6|Gniezno|ul. Żwirki i Wigury 22 |62-200 Gniezno;2338;1313;1313;22;1291;56.16;1.68
108207;300301;Przedszkole nr 8|Gniezno|Budowlanych 22 |62-200 Gniezno;2412;1349;1349;49;1300;55.93;3.63
108208;300301;Gimnazjum nr 3|Gniezno|ul. Paczkowskiego 13 |62-200 Gniezno;1318;755;755;19;736;57.28;2.52
108209;300301;Gnieźnieńska Spółdzielnia Mieszkaniowa|Gniezno|ul. Budowlanych 2 |62-200 Gniezno;1323;683;683;19;664;51.63;2.78
108210;300301;Szkoła Podstawowa Nr 9|Gniezno|ul. Staszica 5 |62-200 Gniezno;1347;745;745;18;727;55.31;2.42
108211;300301;Szkoła Podstawowa nr 9|Gniezno|ul. Staszica 5 |62-200 Gniezno;1266;719;719;13;706;56.79;1.81
108212;300301;Zespół Szkół Ponadgimnazjalnych|Gniezno|Cieszkowskiego 17 |62-200 Gniezno;2380;1359;1359;18;1341;57.10;1.32
108213;300301;Siedziba Rady Osiedla Nr IV "Arkuszewo" (kawiarnia Parafii p.w. Bł. Jolenty)|Gniezno|Wierzbiczany 4-10 |62-200 Gniezno;1890;1096;1096;35;1061;57.99;3.19
108214;300301;Warsztaty Sp. z o. o. "Urbis"|Gniezno|Fabryczna 7 |62-200 Gniezno;709;429;429;11;418;60.51;2.56
108215;300301;Przedszkole Nr 14|Gniezno|Os. Jagiellońskie 33 |62-200 Gniezno;2343;1365;1365;44;1321;58.26;3.22
108216;300301;Przedszkole Nr 17|Gniezno|Os. Piastowskie 18 |62-200 Gniezno;1962;1181;1181;48;1133;60.19;4.06
108217;300301;Gimnazjum Nr 4|Gniezno|Os. Orła Białego 18 |62-200 Gniezno;2003;1175;1175;44;1131;58.66;3.74
108218;300301;Przedszkole Nr 1|Gniezno|Os. Władysława Łokietka 21 |62-200 Gniezno;1907;1115;1115;37;1078;58.47;3.32
108219;300301;Szkoła Podstawowa Nr 12|Gniezno|Os. Kazimierza Wielkiego 33 |62-200 Gniezno;1313;724;724;27;697;55.14;3.73
108220;300301;Szkoła Podstawowa Nr 12|Gniezno|Os. Kazimierza Wielkiego 33 |62-200 Gniezno;1255;722;722;13;709;57.53;1.80
108221;300301;Wojewódzki Szpital dla Nerwowo i Psychicznie Chorych|Gniezno|Poznańska 15 |62-200 Gniezno;706;147;147;12;135;20.82;8.16
108222;300301;Szpital Zespołu Opieki Zdrowotnej|Gniezno|św. Jana 9 |62-200 Gniezno;81;29;29;2;27;35.80;6.90
108223;300301;Szpital Zespołu Opieki Zdrowotnej|Gniezno|3 Maja 37/39 |62-200 Gniezno;47;22;22;1;21;46.81;4.55
108224;300301;Dom Pomocy Społecznej|Gniezno|Wrzesińska 21 |62-200 Gniezno;66;29;29;2;27;43.94;6.90
108225;300302;Sala Gimnastyczna Zespołu Szkół Publicznych|Czerniejewo|Plac 21 Stycznia 4 |62-250 Czerniejewo;2097;1064;1064;42;1022;50.74;3.95
108226;300302;Blok Żywieniowo-Świetlicowy Zespołu Szkół Publicznych|Czerniejewo|ul. Szkolna 3 |62-250 Czerniejewo;783;315;315;24;291;40.23;7.62
108227;300302;Zespół Szkół Publicznych|Żydowo|ul. Tadeusza Kościuszki 24 |62-241 Żydowo;1596;767;767;34;733;48.06;4.43
108228;300302;Sala Gimnastyczna Zespołu Szkół Publicznych|Żydowo|ul. Tadeusza Kościuszki 34 |62-241 Żydowo;1194;471;471;30;441;39.45;6.37
108229;300302;Sala widzeń Zakładu Karnego w Gębarzewie|Gębarzewo| |62-241 Żydowo;515;186;186;24;162;36.12;12.90
108230;300303;Szkoła Podstawowa im. A. Fiedlera|Jankowo Dolne| 9 |62-200 Gniezno;1801;922;922;33;889;51.19;3.58
108231;300303;Zespół Szkolno-Gimnazjalny im. Jana Twardowskiego|Szczytniki Duchowne| 27 |62-200 Gniezno;1818;967;967;24;943;53.19;2.48
108232;300303;Świetlica Wiejska|Piekary|ul. Poziomkowa 32C |62-200 Gniezno;1539;883;883;20;863;57.37;2.27
108233;300303;Szkoła Podstawowa im. Obrońców Gniezna i Ziemi Gnieźnieńskiej|Goślinowo| 14 |62-200 Gniezno;1535;623;623;25;598;40.59;4.01
108234;300303;Zespół Szkolno-Gimnazjalny|Zdziechowa| 51 |62-200 Gniezno;1664;713;713;28;685;42.85;3.93
108235;300304;Urząd Gminy|Kiszkowo|Szkolna 2 |62-280 Kiszkowo;1067;548;548;23;525;51.36;4.20
108236;300304;Budynek po Szkole Podstawowej|Rybno Wielkie|ul. Główna 14 |62-280 Kiszkowo;1066;391;391;20;371;36.68;5.12
108237;300304;Szkoła Podstawowa|Sławno|ul. Gnieźnieńska 37 |62-265 Kiszkowo;1183;514;514;26;488;43.45;5.06
108238;300304;Hala Widowiskowo-Sportowa|Kiszkowo|ul. Polna 33 |62-280 Kiszkowo;964;397;397;13;384;41.18;3.27
108239;300305;Miejsko Gminny Ośrodek Kultury|Kłecko|ul. Gnieźnieńska 8 |62-270 Kłecko;1258;612;612;19;593;48.65;3.10
108240;300305;Gimnazjum|Kłecko|ul. Gnieźnieńska 7A |62-270 Kłecko;835;417;419;18;399;49.94;4.32
108241;300305;Świetlica- stadion sportowy|Kłecko|Ignacego Paderewskiego 26 |62-270 Kłecko;925;415;415;29;386;44.86;6.99
108242;300305;Świetlica wiejska|Charbowo| 17 |62-270 Kłecko;833;308;308;27;281;36.97;8.77
108243;300305;Szkoła Podstawowa|Dębnica| 3 |62-271 Działyń;1125;473;473;19;454;42.04;4.02
108244;300305;Przedszkole|Działyń| 21A |62-271 Działyń;978;391;391;36;355;39.98;9.21
108245;300306;Szkoła Podstawowa w Lednogórze|Lednogóra| 40A |62-261 Lednogóra;1394;680;680;24;656;48.78;3.53
108246;300306;Szkoła Podstawowa w Fałkowie|Fałkowo| 1A |62-262 Fałkowo;1396;613;613;23;590;43.91;3.75
108247;300306;Remiza Strażacka w Łubowie|Łubowo| 90A |62-260 Łubowo;1118;596;596;21;575;53.31;3.52
108248;300306;Szkoła Podstawowa w Owieczkach|Owieczki| 11A |62-260 Łubowo;891;413;413;16;397;46.35;3.87
108249;300307;Świetlica Wiejska|Mieleszyn| 24a |62-212 Mieleszyn;844;361;361;16;345;42.77;4.43
108250;300307;Świetlica Wiejska|Mielno| 33 |62-212 Mieleszyn;802;240;240;12;228;29.93;5.00
108251;300307;Szkoła Podstawowa|Łopienno| 117 |62-213 Łopienno;607;248;248;12;236;40.86;4.84
108252;300307;Szkoła Podstawowa|Karniszewo| 11a |62-212 Mieleszyn;836;343;343;11;332;41.03;3.21
108253;300308;Gminny Ośrodek Kultury|Niechanowo|ul. Gnieźnieńska 2 |62-220 Niechanowo;1574;832;832;37;795;52.86;4.45
108254;300308;Wiejski Dom Kultury|Jarząbkowo| 7 B |62-220 Niechanowo;1161;422;422;26;396;36.35;6.16
108255;300308;Gimnazjum nr 1|Niechanowo|ul. Różana 33 |62-220 Niechanowo;1679;803;803;34;769;47.83;4.23
108256;300309;Przedszkole Nr 2 im "Misia Uszatka"|Trzemeszno|ul. Bolesława Chrobrego 8 |62-240 Trzemeszno;1654;712;712;34;678;43.05;4.78
108257;300309;Ośrodek Sportu i Rekreacji|Trzemeszno|ul. Piastowska 11 |62-240 Trzemeszno;1303;629;629;41;588;48.27;6.52
108258;300309;Szkoła Podstawowa Nr 1 im. J.Kilińskiego|Trzemeszno|ul. J.J. Śniadeckich 18 |62-240 Trzemeszno;1550;663;663;19;644;42.77;2.87
108259;300309;Szkoła Podstawowa Nr 2 im. Polskich Olimpijczyków|Trzemeszno|1 Maja 11 |62-240 Trzemeszno;1568;662;662;40;622;42.22;6.04
108260;300309;Zespół Szkół Szkoła Podstawowa i Gimnazjum|Kruchowo| 1 |62-240 Kruchowo;1292;493;493;25;468;38.16;5.07
108261;300309;Świetlica Wiejska|Wydartowo| 48 |62-240 Wydartowo;828;279;279;16;263;33.70;5.73
108262;300309;Dom Kultury|Trzemeszno|ul. św. Jana 11 |62-240 Trzemeszno;731;232;232;11;221;31.74;4.74
108263;300309;Środowiskowy Dom Samopomocy|Trzemeszno|ul. A. Mickiewicza 28 |62-240 Trzemeszno;776;228;228;11;217;29.38;4.82
108264;300309;Zespół Szkół- Szkoła Podstawowa i Gimnazjum im. Bohaterów Września 1939|Trzemżal| 56 |62-240 Trzemżal;1175;468;468;14;454;39.83;2.99
108265;300309;Świetlica Wiejska|Lubiń| 10 |62-240 Lubiń;298;125;125;7;118;41.95;5.60
108266;300309;Zakład Poprawczy|Trzemeszno|A. Mickiewicza 35 |62-240 Trzemeszno;13;9;9;6;3;69.23;66.67
108267;300310;Szkoła Podstawowa w Witkowie|Witkowo|ul. Czerniejewska 14 |62-230 Witkowo;1543;814;814;24;790;52.75;2.95
108268;300310;Szkoła Podstawowa w Witkowie|Witkowo|ul. Czerniejewska 12 |62-230 Witkowo;1269;693;693;11;682;54.61;1.59
108269;300310;Urząd Gminy i Miasta|Witkowo|ul. Gnieźnieńska 1 |62-230 Witkowo;1431;649;649;29;620;45.35;4.47
108270;300310;Świetlica Wiejska|Sokołowo| |62-230 Witkowo;680;315;315;21;294;46.32;6.67
108271;300310;Świetlica Wiejska|Ruchocinek| |62-230 Witkowo;812;314;314;25;289;38.67;7.96
108272;300310;Niepubliczna Szkoła Podstawowa w Gorzykowie|Gorzykowo| 3/4 |62-230 Witkowo;723;234;234;11;223;32.37;4.70
108273;300310;Zespół Szkolno-Przedszkolny|Mielżyn|ul.Strzałkowska 1 |62-230 Witkowo;797;386;386;23;363;48.43;5.96
108274;300310;Gimnazjum|Witkowo|ul. Poznańska 47 |62-230 Witkowo;1639;851;851;41;810;51.92;4.82
108275;300310;Zespół Szkół Ponadgimnazjalnych|Witkowo|ul. Warszawska 29 |62-230 Witkowo;1183;601;601;7;594;50.80;1.16
108276;300310;Przedszkole Miejskie w Witkowie|Witkowo, Witkowo-Osiedle|ul. Jasna 38 |62-230 Witkowo;729;381;381;10;371;52.26;2.62
108277;300401;Szkoła Podstawowa im. Władysława Jagiełły w Borku Wielkopolskim|Borek Wielkopolski|ul. Szkolna 1 |63-810 Borek Wielkopolski;1260;551;551;10;541;43.73;1.81
108278;300401;Szkoła Podstawowa im. Władysława Jagiełły w Borku Wielkopolskim|Borek Wielkopolski|ul. Szkolna 1 |63-810 Borek Wielkopolski;1353;559;559;27;532;41.32;4.83
108279;300401;Urząd Miejski w Borku Wielkopolskim|Borek Wielkopolski|ul. Rynek 1 |63-810 Borek Wielkopolski;1265;419;419;18;401;33.12;4.30
108280;300401;Świetlica Wiejska|Koszkowo| 7 |63-810 Borek Wielkopolski;860;247;247;26;221;28.72;10.53
108281;300401;Zespół Szkół im. Jana Pawła II, Szkoła Podstawowa i Gimnazjum Zimnowoda|Zimnowoda| |63-810 Borek Wielkopolski;1290;406;406;21;385;31.47;5.17
108282;300402;Gimnazjum Nr 1|Gostyń|ul. Kościelna 4 |63-800 Gostyń;1014;541;541;26;515;53.35;4.81
108283;300402;Przedszkole Miejskie Nr 5|Gostyń|ul. Mostowa 9 |63-800 Gostyń;937;420;420;26;394;44.82;6.19
108284;300402;Zespół Szkół Ogólnokształcących|Gostyń|ul. Wrocławska 10 |63-800 Gostyń;1065;532;532;20;512;49.95;3.76
108285;300402;Biblioteka Publiczna M i G|Gostyń|ul. Wrocławska 257 |63-800 Gostyń;1062;486;486;15;471;45.76;3.09
108286;300402;Świetlica osiedlowa|Gostyń|ul. Górna 30 b |63-800 Gostyń;1025;574;574;17;557;56.00;2.96
108287;300402;Szkoła Podstawowa Nr 2|Gostyń|wejście od ul. Sądowej |63-800 Gostyń;1065;515;515;20;495;48.36;3.88
108288;300402;Gimnazjum Nr 1|Gostyń|wejście od ul. Lipowej |63-800 Gostyń;1096;568;568;15;553;51.82;2.64
108289;300402;Dom Dziennego Pobytu|Gostyń|ul. Polna 72 |63-800 Gostyń;1065;556;556;14;542;52.21;2.52
108290;300402;Gostyński Ośrodek Kultury "Hutnik"|Gostyń|ul. Hutnika 4 |63-800 Gostyń;1203;628;628;32;596;52.20;5.10
108291;300402;Gimnazjum Nr 2|Gostyń|wejście od ul. Leszczyńskiej |63-800 Gostyń;1119;526;526;22;504;47.01;4.18
108292;300402;Gimnazjum Nr 2|Gostyń|ul. Hutnika 3 |63-800 Gostyń;1227;534;534;16;518;43.52;3.00
108293;300402;Szkoła Podstawowa Nr 5|Gostyń|ul. Graniczna 1 |63-800 Gostyń;1084;518;518;20;498;47.79;3.86
108294;300402;Zespół Szkół Zawodowych|Gostyń|ul. Juliana Tuwima 44 |63-800 Gostyń;1152;695;695;24;671;60.33;3.45
108295;300402;Zespół Szkół Zawodowych|Gostyń|ul. Juliana Tuwima 44 |63-800 Gostyń;1244;634;634;31;603;50.96;4.89
108296;300402;Szkoła Podstawowa Nr 2|Gostyń|ul. Wrocławska 264 |63-800 Gostyń;953;481;481;19;462;50.47;3.95
108297;300402;Świetlica wiejska|Stary Gostyń| |63-800 Gostyń;1004;383;383;19;364;38.15;4.96
108298;300402;Szkoła Podstawowa|Siemowo| |63-800 Gostyń;861;289;289;16;273;33.57;5.54
108299;300402;Szkoła Podstawowa|Kunowo| |63-800 Gostyń;1019;365;365;21;344;35.82;5.75
108300;300402;Państwowa Szkoła Muzyczna I Stopnia|Gostyń|ul. Strzelecka 28 |63-800 Gostyń;1035;439;440;15;424;42.42;3.42
108301;300402;Szkoła Podstawowa|Gola| |63-800 Gostyń;1148;405;405;36;369;35.28;8.89
108302;300402;Wydział Komunikacji Starostwa Powiatowego w Gostyniu|Gostyń|ul. Wrocławska 154 |63-800 Gostyń;951;362;362;20;342;38.07;5.52
108303;300402;Samodzielny Publiczny Zespół Opieki Zdrowotnej Szpital w Gostyniu|Gostyń|pl. K. Marcinkowskiego 8 9|63-800 Gostyń;42;13;13;0;13;30.95;0.00
108304;300403;Pałac Ślubów|Krobia|Pl. Tadeusza Kościuszki 3 |63-840 Krobia;1375;657;657;29;628;47.78;4.41
108305;300403;Kino Szarotka|Krobia|ul. Powstańców Wielkopolskich 27 |63-840 Krobia;2015;978;978;24;954;48.54;2.45
108306;300403;Zespół Szkoły Podstawowej im prof. Józefa Zwierzyckiego i Gimnazjum w Krobi|Krobia|ul. prof. Józefa Zwierzyckiego 1 |63-840 Krobia;1825;749;749;16;733;41.04;2.14
108307;300403;Zespół Szkoły Podstawowej im. gen. Franciszka Dzierżykraja-Morawskiego i Gimnazjum im. Stanisława Fenrycha|Pudliszki|ul. Szkolna 20 |63-842 Pudliszki;2011;828;828;46;782;41.17;5.56
108308;300403;Stara Szkoła|Chwałkowo| 43 |63-840 Krobia;653;195;195;21;174;29.86;10.77
108309;300403;Zespół Szkoły Podstawowej i Gimnazjum im. Ziemi Biskupiańskiej|Stara Krobia| 71 |63-840 Krobia;770;318;318;7;311;41.30;2.20
108310;300403;Szkoła Podstawowa|Niepart| 45 |63-840 Krobia;800;248;248;19;229;31.00;7.66
108311;300403;Szkoła Podstawowa Filialna|Ciołkowo| 20 |63-840 Krobia;740;241;241;26;215;32.57;10.79
108312;300403;Dom Pomocy Społecznej w Chumiętkach|Chumiętki| 22 |63-840 Krobia;89;31;31;6;25;34.83;19.35
108313;300404;Zespół Szkół w Pępowie, Szkoła Podstawowa|Pępowo|ul.Powstańców Wielkopolskich 44 |63-830 Pępowo;1470;732;732;25;707;49.80;3.42
108314;300404;Zespół Szkół w Pępowie, Gimnazjum|Pępowo|ul.Powstańców Wielkopolskich 44 |63-830 Pępowo;1130;524;524;31;493;46.37;5.92
108315;300404;Samorządowa Szkoła Podstawowa|Skoraszewice| 15a |63-830 Pępowo;1055;504;504;30;474;47.77;5.95
108316;300404;Dom Strażaka|Siedlec| 9 |63-830 Pępowo;1085;497;497;32;465;45.81;6.44
108317;300405;Gminny Ośrodek Kultury w Piaskach|Piaski|ul.Strzelecka 4 |63-820 Piaski;1526;762;762;24;738;49.93;3.15
108318;300405;Gminny Ośrodek Kultury w Piaskach (mała salka)|Piaski|ul. Strzelecka 4 |63-820 Piaski;1022;453;453;17;436;44.32;3.75
108319;300405;Zespół Szkół w Piaskach|Piaski|ul. Drzęczewska 9 |63-820 Piaski;1348;530;530;37;493;39.32;6.98
108320;300405;Świetlica wiejska w Grabonogu|Grabonóg| 4 |63-820 Piaski;848;338;338;20;318;39.86;5.92
108321;300405;Szkoła Podstawowa w Bodzewie|Bodzewo| 35 |63-820 Piaski;866;346;346;17;329;39.95;4.91
108322;300405;Szkoła Podstawowa w Szelejewie Pierwszym|Szelejewo Pierwsze| 87A |63-820 Piaski;1175;491;491;22;469;41.79;4.48
108323;300405;Bonifraterskie Centrum Zdrowia Sp. z o.o.|Piaski|Osiedle Marysin 1 |63-820 Piaski;78;22;22;1;21;28.21;4.55
108324;300406;Przedszkole Samorządowe|Pogorzela|ul. Rynek 19 |63-860 Pogorzela;1684;734;734;33;701;43.59;4.50
108325;300406;Świetlica Wiejska|Bułaków| 34a |63-860 Pogorzela;776;327;327;19;308;42.14;5.81
108326;300406;Wiejski Dom Kultury|Kromolice| 42b |63-860 Pogorzela;588;211;211;5;206;35.88;2.37
108327;300406;Szkoła Podstawowa|Pogorzela|ul. Parkowa 7 |63-860 Pogorzela;1009;321;321;16;305;31.81;4.98
108328;300407;Szkoła Podstawowa w Poniecu|Poniec|ul. Szkolna 8 |64-125 Poniec;2327;1036;1036;72;964;44.52;6.95
108329;300407;Gminne Centrum Kultury Sportu Turystyki i Rekreacji w Poniecu|Poniec|ul. Szkolna 3 |64-125 Poniec;1668;509;509;36;473;30.52;7.07
108330;300407;Dom Kultury w Żytowiecku|Żytowiecko| 58 |63-805 Łęka Mała;1171;383;383;29;354;32.71;7.57
108331;300407;Dom Strażaka w Szurkowie|Szurkowo| 13 |64-125 Poniec;457;145;145;8;137;31.73;5.52
108332;300407;Wiejski Dom Kultury w Łęce Wielkiej|Łęka Wielka| 59 |63-805 Łęka Mała;667;180;180;16;164;26.99;8.89
108333;300501;Zespół Szkolno - Przedszkolny|Granowo|ul. Konstytucji 3 Maja 1 |62-066 Granowo;1197;562;562;36;526;46.95;6.41
108334;300501;Zespół Szkolno - Przedszkolny|Granowo|ul. Konstytucji 3 Maja 1 |62-066 Granowo;870;466;466;18;448;53.56;3.86
108335;300501;Szkoła Podstawowa|Bielawy| |62-066 Granowo;457;167;167;11;156;36.54;6.59
108336;300501;Zespół Szkolno - Przedszkolny|Granowo|ul. Szkolna 4 |62-066 Granowo;1390;493;493;36;457;35.47;7.30
108337;300502;Szkoła Podstawowa Nr1|Grodzisk Wielkopolski|ul. Chopina 26 |62-065 Grodzisk Wielkopolski;2154;1153;1153;34;1119;53.53;2.95
108338;300502;Centrum Kultury "RONDO"|Grodzisk Wielkopolski|ul. Kolejowa 12 |62-065 Grodzisk Wielkopolski;1995;985;985;20;965;49.37;2.03
108339;300502;Gimnazjum|Grodzisk Wielkopolski|ul. 3 Maja 5 |62-065 Grodzisk Wielkopolski;1038;441;441;27;414;42.49;6.12
108340;300502;Świetlica Spółdzielni Mieszkaniowej|Grodzisk Wielkopolski|ul. Osiedle Wojska Polskiego 25 |62-065 Grodzisk Wielkopolski;2039;1138;1138;37;1101;55.81;3.25
108341;300502;Świetlica Zespołu Szkół Ponadgimnazjalnych|Grodzisk Wielkopolski|ul. Żwirki i Wigury 2 |62-065 Grodzisk Wielkopolski;2088;1094;1094;43;1051;52.39;3.93
108342;300502;Zespól Szkół|Ptaszkowo| 31A |62-065 Grodzisk Wielkopolski;1027;388;388;10;378;37.78;2.58
108343;300502;Szkoła Podstawowa Nr1|Grodzisk Wielkopolski|ul. Chopina 26 |62-065 Grodzisk Wielkopolski;2075;713;713;31;682;34.36;4.35
108344;300502;Liceum Ogólnokształcące|Grodzisk Wielkopolski|ul. 3 Maja 7 |62-065 Grodzisk Wielkopolski;1963;919;919;60;859;46.82;6.53
108345;300502;Szkoła Podstawowa|Kąkolewo| 64 |62-065 Grodzisk Wielkopolski;860;323;323;18;305;37.56;5.57
108346;300502;Samodzielny Publiczny Zakład Opieki Zdrowotnej|Grodzisk Wielkopolski|ul. Mossego 3 |62-065 Grodzisk Wielkopolski;54;24;24;3;21;44.44;12.50
108347;300503;Publiczne Gimnazjum|Kamieniec|ul. Słoneczna 2 |64-061 Kamieniec;970;535;535;19;516;55.15;3.55
108348;300503;Szkoła Podstawowa|Kamieniec|ul. Stawowa 28 |64-061 Kamieniec;1023;382;382;21;361;37.34;5.50
108349;300503;Szkoła Podstawowa|Konojad|ul. Szkolna 15 |64-060 Wolkowo;1184;448;448;18;430;37.84;4.02
108350;300503;Świetlica wiejska|Łęki Wielkie| 55 |64-060 Wolkowo;977;390;390;10;380;39.92;2.56
108351;300503;Szkoła Podstawowa|Parzęczewo| 25 |64-061 Kamieniec;1037;457;457;34;423;44.07;7.44
108352;300504;Dom Kultury|Rakoniewice|ul. Krystyny 30 |62-067 Rakoniewice;1917;942;942;47;895;49.14;4.99
108353;300504;Zespół Szkolno-Gimnazjalny|Rakoniewice|ul. Nowotomyska 1 |62-067 Rakoniewice;2129;912;912;42;870;42.84;4.61
108354;300504;Zespół Przedszkolno-Szkolno-Gimnazjalny|Rostarzewo|ul. Rakoniewicka 23 |62-068 Rakoniewice;1887;841;841;51;790;44.57;6.06
108355;300504;Zespół Szkolno-Przedszkolny|Jabłonna|ul. Nowotomyska 9 |64-308 Rakoniewice;2093;674;674;38;636;32.20;5.64
108356;300504;Zespół Przedszkolno-Szkolno-Gimnazjalny|Ruchocice|ul. Poznańska 23 |62-073 Rakoniewice;1310;479;479;20;459;36.56;4.18
108357;300504;Zespół Przedszkolno-Szkolny|Łąkie| 81 |62-068 Rakoniewice;624;221;221;8;213;35.42;3.62
108358;300505;Zespół Szkół im.Polskich Noblistów w Wielichowie|Wielichowo|ul. Kościelna 7a |64-050 Wielichowo;1395;777;777;39;738;55.70;5.02
108359;300505;Szkoła Podstawowa im. Polskich Poetów w Łubnicy|Łubnica|ul. Szkolna 4 |64-050 Wielichowo;838;369;369;23;346;44.03;6.23
108360;300505;Szkoła Podstawowa im. Kompanii Wilkowskiej Powstańców Wielkopolskich w Wilkowie Polskim|Wilkowo Polskie|ul. Kościańska 2 |64-050 Wielichowo;1365;542;542;30;512;39.71;5.54
108361;300505;Zespół Szkół im. Polskich Noblistów w Wielichowie|Wielichowo|ul. Kościelna 7a |64-050 Wielichowo;1272;522;522;31;491;41.04;5.94
108362;300505;Szkoła Podstawowa w Gradowicach|Gradowice|ul. Szkolna 20 |64-050 Wielichowo;530;213;213;12;201;40.19;5.63
108363;300601;Świetlica Wiejska|Cerekwica Stara| 48 |63-233 Jaraczewo;589;238;238;6;232;40.41;2.52
108364;300601;Szkoła Podstawowa|Góra|ul.Jarocińska 6 |63-233 Jaraczewo;1914;912;912;46;866;47.65;5.04
108365;300601;Urząd Gminy|Jaraczewo|ul.Jarocińska 1 |63-233 Jaraczewo;1591;690;690;65;625;43.37;9.42
108366;300601;Szkoła Podstawowa|Nosków|ul.Szkolna 28 |63-233 Jaraczewo;756;328;328;13;315;43.39;3.96
108367;300601;Zespół Szkół|Rusko|ul.Szkolna 29 |63-233 Jaraczewo;1127;465;465;29;436;41.26;6.24
108368;300601;Świetlica Wiejska|Wojciechowo| 11a |63-233 Jaraczewo;537;238;238;15;223;44.32;6.30
108369;300602;Zespół Szkół|Cielcza|ul. Szkolna 16 |63-200 Jarocin;1834;767;767;24;743;41.82;3.13
108370;300602;Szkoła Podstawowa|Golina|ul. Jarocińska 32 |63-200 Jarocin;1713;798;798;45;753;46.58;5.64
108371;300602;Publiczne Przedszkole|Mieszków|ul. Dworcowa 10c |63-200 Jarocin;1608;730;730;26;704;45.40;3.56
108372;300602;Niepubliczna Szkoła Podstawowa|Prusy| 52 |63-230 Witaszyce;1383;561;561;39;522;40.56;6.95
108373;300602;Niepubliczna Szkoła Podstawowa|Siedlemin|ul. Główna 36 |63-200 Jarocin;1810;732;732;35;697;40.44;4.78
108374;300602;Niepubliczna Szkoła Podstawowa|Wilkowyja|ul. Powstańców Wielkopolskich 41 |63-200 Jarocin;1830;775;775;27;748;42.35;3.48
108375;300602;Szkoła Podstawowa|Witaszyce|ul. Szkolna 1a |63-230 Witaszyce;1592;785;785;21;764;49.31;2.68
108376;300602;Gimnazjum|Witaszyce|ul. Szkolna 1a |63-230 Witaszyce;1595;758;758;26;732;47.52;3.43
108377;300602;Niepubliczna Szkoła Podstawowa|Wilkowyja|ul. Powstańców Wielkopolskich 41 |63-200 Jarocin;1757;664;664;22;642;37.79;3.31
108378;300602;Ratusz|Jarocin|ul. Rynek |63-200 Jarocin;2039;1047;1047;28;1019;51.35;2.67
108379;300602;Zespół Szkół Nr 5|Jarocin|ul. Ludwika Waryńskiego 11 |63-200 Jarocin;2222;1142;1142;32;1110;51.40;2.80
108380;300602;Zespół Szkół Nr 5|Jarocin|ul. Ludwika Waryńskiego 11 |63-200 Jarocin;1621;778;778;32;746;48.00;4.11
108381;300602;Niepubliczne Przedszkole "Stokrotka"|Jarocin|ul. Generała Józefa Hallera 8a |63-200 Jarocin;1762;869;869;22;847;49.32;2.53
108382;300602;Zespół Szkół Nr 3|Jarocin|ul. Wrocławska 168 |63-200 Jarocin;1589;682;682;27;655;42.92;3.96
108383;300602;Zespół Szkół Nr 3|Jarocin|ul. Wrocławska 168 |63-200 Jarocin;1110;479;479;19;460;43.15;3.97
108384;300602;Centrum Socjalne|Jarocin|ul. Wrocławska 39 |63-200 Jarocin;1963;1004;1004;29;975;51.15;2.89
108385;300602;Pałac Radolińskich|Jarocin|ul. Park 3 |63-200 Jarocin;1474;817;817;26;791;55.43;3.18
108386;300602;Zespół Szkół Ponadgimnazjalnych Nr 2|Jarocin|ul. Franciszkańska 2 |63-200 Jarocin;1727;926;926;25;901;53.62;2.70
108387;300602;Publiczne Przedszkole Nr 2|Jarocin|ul. Marii Curie-Skłodowskiej 2a |63-200 Jarocin;2084;1126;1126;36;1090;54.03;3.20
108388;300602;Szkoła Podstawowa Nr 4|Jarocin|ul. Marii Curie-Skłodowskiej 4 |63-200 Jarocin;2156;1145;1145;28;1117;53.11;2.45
108389;300602;Szkoła Podstawowa Nr 4|Jarocin|ul. Marii Curie-Skłodowskiej 4 |63-200 Jarocin;1269;708;708;12;696;55.79;1.69
108390;300602;Szpital Powiatowy w Jarocinie Sp. z o.o.|Jarocin|ul. Szpitalna 1 |63-200 Jarocin;44;11;11;0;11;25.00;0.00
108391;300603;Urząd Gminy|Kotlin|ul. Powstańców Wlkp. 3 |63-220 Kotlin;1266;528;528;21;507;41.71;3.98
108392;300603;Szkoła Podstawowa|Kotlin|ul. M. Konopnickiej 22 |63-220 Kotlin;1325;694;694;25;669;52.38;3.60
108393;300603;Szkoła Podstawowa|Magnuszewice| 17 |63-220 Kotlin;1013;415;415;25;390;40.97;6.02
108394;300603;Szkoła Podstawowa Sławoszew z siedzibą w Parzewie|Parzew| 6a |63-220 Kotlin;889;320;320;23;297;36.00;7.19
108395;300603;Szkoła Podstawowa|Wola Książęca| 103 |63-220 Kotlin;1184;415;415;21;394;35.05;5.06
108396;300604;Środowiskowa Hala Sportowa|Żerków|ul.Cmentarna 10 |63-210 Żerków;1724;913;913;39;874;52.96;4.27
108397;300604;Szkoła Podstawowa|Chrzan|ul. Żerkowska 3 |63-210 Żerków;795;342;342;15;327;43.02;4.39
108398;300604;Szkoła Podstawowa|Dobieszczyzna| 32a |63-210 Żerków;1266;529;529;37;492;41.79;6.99
108399;300604;Szkoła Podstawowa|Komorze Przybysławskie| 18 |63-210 Żerków;719;256;256;10;246;35.61;3.91
108400;300604;Świetlica Wiejska|Brzóstków| 46 |63-210 Żerków;625;205;205;8;197;32.80;3.90
108401;300604;Szkoła Podstawowa|Żerków|ul.Cmentarna 10 |63-210 Żerków;1947;748;748;25;723;38.42;3.34
108402;300604;Świetlica Wiejska|Żerniki| 29 |63-210 Żerków;685;280;280;16;264;40.88;5.71
108403;300604;Szkoła Podstawowa w Chrzanie, Budynek Szkoły|Stęgosz| 106 |63-210 Żerków;544;232;232;12;220;42.65;5.17
108404;300701;Szkoła Podstawowa|Blizanów Drugi| 56 |62-814 Blizanów;988;393;393;17;376;39.78;4.33
108405;300701;Stowarzyszenie "Mała Szkoła" na Rzecz Ekorozwoju|Lipe| 20 |62-814 Blizanów;951;306;306;11;295;32.18;3.59
108406;300701;Rychnowskie Stowarzyszenie na Rzecz Dzieci i Młodzieży|Rychnów| 16 |62-814 Blizanów;902;384;384;23;361;42.57;5.99
108407;300701;Szkoła Filialna|Jastrzębniki| 51 |62-812 Jastrzębniki;479;202;202;7;195;42.17;3.47
108408;300701;Szkoła Podstawowa|Piotrów| 65 |62-812 Jastrzębniki;1978;1004;1004;25;979;50.76;2.49
108409;300701;Budynek poszkolny|Pruszków| 12 |62-800 Kalisz;973;503;503;10;493;51.70;1.99
108410;300701;Szkoła Podstawowa|Janków Pierwszy| 78 |62-814 Blizanów;1083;425;425;9;416;39.24;2.12
108411;300701;Szkoła Filialna|Brudzew| 11 |62-814 Blizanów;488;203;203;11;192;41.60;5.42
108412;300702;Zespół Szkół w Brzezinach|Brzeziny|ul. Wrocławska 17 |62-874 Brzeziny;946;459;459;8;451;48.52;1.74
108413;300702;Gimnazjum w Brzezinach|Brzeziny|Gimnazjalna 1 |62-874 Brzeziny;671;291;291;7;284;43.37;2.41
108414;300702;Budynek Ochotniczej Straży Pożarnej w Ostrowie Kaliskim|Ostrów Kaliski| 41 |62-874 Brzeziny;593;228;228;6;222;38.45;2.63
108415;300702;Szkoła Podstawowa w Dzięciołach|Dzięcioły| 14 |62-874 Brzeziny;695;226;226;6;220;32.52;2.65
108416;300702;Szkoła Podstawowa w Sobiesękach|Sobiesęki| 11 |62-874 Brzeziny;598;181;181;10;171;30.27;5.52
108417;300702;Szkoła Podstawowa w Aleksandrii|Aleksandria| 120 |62-874 Brzeziny;691;341;341;10;331;49.35;2.93
108418;300702;Budynek po Szkole Podstawowej w Przystajni|Przystajnia| 18 |62-874 Brzeziny;444;163;163;2;161;36.71;1.23
108419;300703;Zespół Szkół w Cekowie-Kolonii|Ceków-Kolonia| 2 |62-834 Ceków;1729;676;676;31;645;39.10;4.59
108420;300703;Szkoła Podstawowa|Morawin| 27 |62-834 Ceków;829;339;339;21;318;40.89;6.19
108421;300703;Zespół Szkół|Kamień| 34A |62-834 Ceków;937;424;424;22;402;45.25;5.19
108422;300703;Szkoła Podstawowa w Cekowie-Kolonii z Filią w Przespolewie Pańskim|Przespolew Pański| 35 |62-834 Ceków;325;131;131;8;123;40.31;6.11
108423;300704;Świetlica "Stara Gmina"|Godziesze Wielkie|ul. Rynek 7 |62-872 Godziesze Małe;1046;424;424;13;411;40.54;3.07
108424;300704;Gimnazjum|Godziesze Wielkie|ul. Ks. Augustyna Kordeckiego 10 |62-872 Godziesze Małe;1076;479;479;8;471;44.52;1.67
108425;300704;Szkoła Podstawowa|Wola Droszewska| 45 |62-872 Godziesze Małe;1020;408;408;18;390;40.00;4.41
108426;300704;Dom Ludowy|Wolica| 36 |62-872 Godziesze Małe;1015;597;597;6;591;58.82;1.01
108427;300704;Szkoła Podstawowa|Stara Kakawa| 57 |62-872 Godziesze Małe;786;269;269;6;263;34.22;2.23
108428;300704;Szkoła Podstawowa|Żydów|ul. Szkolna 72 |62-872 Godziesze Małe;419;221;221;4;217;52.74;1.81
108429;300704;Szkoła Podstawowa|Saczyn| 103 |62-872 Godziesze Małe;448;196;196;11;185;43.75;5.61
108430;300704;Szkoła Podstawowa|Stobno Siódme| 26 |62-872 Godziesze Małe;959;427;427;11;416;44.53;2.58
108431;300704;Sala OSP|Borek|ul. Kaliska 18 |62-872 Godziesze Małe;563;303;303;4;299;53.82;1.32
108432;300704;Wojewódzki Specjalistyczny Zespół ZOZ Chorób Płuc i Gruźlicy|Wolica| 113 |62-872 Godziesze Małe;68;29;29;2;27;42.65;6.90
108433;300705;Szkoła Podstawowa|Koźminek|ul.Szkolna 1 |62-840 Koźminek;1630;778;778;34;744;47.73;4.37
108434;300705;Gimnazjum|Koźminek|ul.Szkolna 1 |62-840 Koźminek;1267;441;441;12;429;34.81;2.72
108435;300705;Gminna Biblioteka Publiczna|Koźminek|ul.Kościuszki 13 |62-840 Koźminek;1016;353;353;17;336;34.74;4.82
108436;300705;Szkoła Podstawowa|Nowy Nakwasin| 48 |62-840 Koźminek;964;418;418;11;407;43.36;2.63
108437;300705;Szkoła Podstawowa|Moskurnia| 9a |62-840 Koźminek;674;259;259;11;248;38.43;4.25
108438;300705;Świetlica|Oszczeklin| 21 |62-840 Koźminek;508;208;208;6;202;40.94;2.88
108439;300706;Szkoła Podstawowa w Zakrzynie|Zakrzyn-Baranek| 1 |62-850 Lisków;909;355;355;22;333;39.05;6.20
108440;300706;Szkoła Podstawowa w Strzałkowie|Strzałków| 65 |62-850 Lisków;1068;430;430;26;404;40.26;6.05
108441;300706;Szkoła Podstawowa im. Józefa Wybickiego|Lisków|ul. Ks. Wacława Blizińskiego 27 |62-850 Lisków;1668;787;787;27;760;47.18;3.43
108442;300706;Szkoła Podstawowa w Ciepielewie|Ciepielew Pierwszy| 10 |62-850 Lisków;595;248;248;14;234;41.68;5.65
108443;300706;Dom Pomocy Społecznej|Lisków|ul. ks. Wacława Blizińskiego 96 |62-850 Lisków;37;28;28;2;26;75.68;7.14
108444;300707;Zespół Szkolno-Przedszkolny|Kościelec| 9 |62-831 Korzeniew;1434;524;524;36;488;36.54;6.87
108445;300707;Zespół Szkolno-Przedszkolny|Dzierzbin-Kolonia| 31-32 |62-831 Korzeniew;1253;475;475;18;457;37.91;3.79
108446;300707;Gimnazjum|Korzeniew| 51 |62-831 Korzeniew;1296;464;464;42;422;35.80;9.05
108447;300708;Szkoła Podstawowa im. Janusza Kusocińskiego|Opatówek|ul. Szkolna 3 |62-860 Opatówek;1741;978;978;14;964;56.17;1.43
108448;300708;Gminny Ośrodek Kultury|Opatówek|ul. Kościelna 2 |62-860 Opatówek;1314;666;666;28;638;50.68;4.20
108449;300708;Zespół Szkół im. Jana Pawła II|Chełmce| 3 |62-860 Opatówek;1368;826;826;15;811;60.38;1.82
108450;300708;Zespół Szkół|Rajsko| 4A |62-860 Opatówek;790;329;329;6;323;41.65;1.82
108451;300708;Zespół Szkół|Tłokinia Wielka| 86A |62-860 Opatówek;1937;916;916;22;894;47.29;2.40
108452;300708;Gimnazjum im. Agatona i Stefana Gillerów|Opatówek|ul. Szkolna 7 |62-860 Opatówek;1460;704;704;16;688;48.22;2.27
108453;300709;Zespół Szkół w Stawiszynie|Stawiszyn|ul. Szkolna 8 |62-820 Stawiszyn;1238;561;561;19;542;45.32;3.39
108454;300709;Zespół Szkół w Stawiszynie|Stawiszyn|ul. Szkolna 8 |62-820 Stawiszyn;2213;861;861;28;833;38.91;3.25
108455;300709;Miejsko Gminny Ośrodek Kultury w Zbiersku|Zbiersk-Cukrownia| 237 |62-830 Zbiersk;2350;1044;1044;35;1009;44.43;3.35
108456;300710;Zespół Szkół w Szczytnikach|Popów| 54 |62-865 Szczytniki;1451;607;607;16;591;41.83;2.64
108457;300710;Zespół Szkół w Stawie|Staw|ul. Karola Świerczewskiego 3 |62-865 Szczytniki;1258;554;554;18;536;44.04;3.25
108458;300710;Zespół Szkół w Radliczycach|Radliczyce| 72 |62-865 Szczytniki;1470;618;618;20;598;42.04;3.24
108459;300710;Zespół Szkół w Iwanowicach|Iwanowice|ul. ks. Augustyna Kordeckiego 11 |62-862 Iwanowice;2091;819;819;24;795;39.17;2.93
108460;300711;Zespół Szkół w Żelazkowie|Żelazków| 108 |62-817 Żelazków;1265;535;535;37;498;42.29;6.92
108461;300711;Zespół Szkół im. Marii Dąbrowskiej w Russowie|Russów| 6 |62-817 Żelazków;1120;494;494;23;471;44.11;4.66
108462;300711;Szkoła Filialna Szkoły Podstawowej w Russowie z siedzibą w Kokaninie|Kokanin| 67 |62-817 Żelazków;1223;656;656;21;635;53.64;3.20
108463;300711;Niepubliczna Szkoła Podstawowa w Biernatkach|Biernatki| 18 |62-817 Żelazków;511;220;220;4;216;43.05;1.82
108464;300711;Szkoła Podstawowa w Goliszewie|Goliszew| 17 |62-817 Żelazków;990;421;421;12;409;42.53;2.85
108465;300711;Sala OSP Pólko|Pólko| 71 |62-817 Żelazków;1096;589;589;13;576;53.74;2.21
108466;300711;Szkoła Podstawowa im. Armii Krajowej w Skarszewie|Skarszew| 50 |62-817 Żelazków;770;332;332;14;318;43.12;4.22
108467;300711;Szkoła Podstawowa w Dębem|Dębe| 34A |62-817 Żelazków;509;197;197;8;189;38.70;4.06
108468;300801;Zespół Szkół im. Powstańców Wielkopolskich w Baranowie, Publiczne Przedszkole Samorządowe w Baranowie|Baranów|Rynek 20 |63-604 Baranów;1586;924;924;19;905;58.26;2.06
108469;300801;Zespół Szkół w Donaborowie, Szkoła Podstawowa w Donaborowie|Donaborów| 91 |63-604 Baranów;819;384;384;23;361;46.89;5.99
108470;300801;Szkoła Podstawowa w Grębaninie|Grębanin| 87 |63-604 Baranów;665;309;309;18;291;46.47;5.83
108471;300801;Gimnazjum im. Jana Pawła II w Mroczeniu|Mroczeń| 140 |63-604 Baranów;1247;654;654;16;638;52.45;2.45
108472;300801;Zespół Szkół w Słupi pod Kępnem|Słupia pod Kępnem|ul. Szkolna 5 |63-604 Baranów;1120;503;503;27;476;44.91;5.37
108473;300801;Zespół Szkół w Łęce Mroczeńskiej, Szkoła Podstawowa w Łęce Mroczeńskiej|Łęka Mroczeńska| 55a |63-604 Baranów;693;340;340;21;319;49.06;6.18
108474;300802;Przedszkole "Kwiaty Polskie"|Bralin|ul. Lipowa 30 |63-640 Bralin;1249;725;725;20;705;58.05;2.76
108475;300802;Szkoła Podstawowa im. Mikołaja Kopernika|Bralin|ul. Rynek 1 |63-640 Bralin;984;494;494;11;483;50.20;2.23
108476;300802;Zespół Szkół im. Ks. Michała Przywary i Rodziny Salomonów|Nowa Wieś Książęca| 32 |63-640 Bralin;539;258;258;13;245;47.87;5.04
108477;300802;Dom Ludowy|Chojęcin-Parcele| 5 |63-640 Bralin;658;317;317;16;301;48.18;5.05
108478;300802;Dom Ludowy|Tabor Wielki| 4a |63-640 Bralin;709;355;355;16;339;50.07;4.51
108479;300802;Dom Ludowy|Weronikopole| 11a |63-640 Bralin;321;139;139;4;135;43.30;2.88
108480;300802;Dom Ludowy|Mnichowice| 42 |63-640 Bralin;236;136;136;3;133;57.63;2.21
108481;300803;Świetlica Spółdzielni Mieszkaniowej|Kępno|ul. Sienkiewicza 48 |63-600 Kępno;2306;1326;1326;62;1264;57.50;4.68
108482;300803;Przedszkole Samorządowe Nr 5|Kępno|Osiedle 700-Lecia 9 |63-600 Kępno;2402;1477;1477;33;1444;61.49;2.23
108483;300803;Szkoła Podstawowa Nr 1|Kępno|ul. Sienkiewicza 21 |63-600 Kępno;802;392;392;11;381;48.88;2.81
108484;300803;Urząd Miasta i Gminy|Kępno|ul. Ratuszowa 1 |63-600 Kępno;2003;999;999;23;976;49.88;2.30
108485;300803;Gimnazjum Nr 1|Kępno|ul. Tysiąclecia 1 |63-600 Kępno;1729;1054;1054;34;1020;60.96;3.23
108486;300803;Przedszkole Samorządowe Nr 4|Kępno|ul. Cicha 13 |63-600 Kępno;1589;777;778;25;752;48.90;3.22
108487;300803;Szkoła Podstawowa|Krążkowy| 29 |63-600 Kępno;1914;1052;1052;24;1028;54.96;2.28
108488;300803;Szkoła Podstawowa|Hanulin|ul. Powstańców Wlkp. 1a |63-600 Kępno;1135;606;606;13;593;53.39;2.15
108489;300803;Dom Strażaka|Rzetnia| 85 |63-600 Kępno;372;139;139;4;135;37.37;2.88
108490;300803;Dom Ludowy|Szklarka Mielęcka| 31 |63-600 Kępno;827;411;411;18;393;49.70;4.38
108491;300803;Szkoła Podstawowa|Olszowa| 124 |63-600 Kępno;858;432;432;17;415;50.35;3.94
108492;300803;Szkoła Podstawowa|Świba| 146 |63-600 Kępno;830;370;370;31;339;44.58;8.38
108493;300803;Szkoła Podstawowa|Kierzno| 21 |63-600 Kępno;625;246;246;6;240;39.36;2.44
108494;300803;Szkoła Podstawowa|Myjomice| 101 |63-600 Kępno;884;470;470;19;451;53.17;4.04
108495;300803;Szkoła Podstawowa|Mikorzyn| 75 |63-600 Kępno;1288;613;613;20;593;47.59;3.26
108496;300803;Szpital Samodzielnego Publicznego Zakładu Opieki Zdrowotnej w Kępnie|Kępno|ul. Szpitalna 7 |63-600 Kępno;74;19;19;3;16;25.68;15.79
108497;300803;Dom Pomocy Społecznej|Rzetnia| 87 |63-600 Kępno;44;20;20;5;15;45.45;25.00
108498;300804;Urząd Gminy|Łęka Opatowska|ul. Akacjowa 4 |63-645 Łęka Opatowska;1547;673;673;29;644;43.50;4.31
108499;300804;Szkoła Podstawowa|Siemianice|ul. Szkolna 2 |63-645 Łęka Opatowska;1007;455;455;12;443;45.18;2.64
108500;300804;Szkoła Podstawowa|Opatów|ul. Poznańska 7 |63-645 Łęka Opatowska;1600;762;762;22;740;47.62;2.89
108501;300805;Zespół Szkół w Perzowie|Perzów| 77A |63-642 Perzów;1372;709;709;27;682;51.68;3.81
108502;300805;Zespół Szkół w Trębaczowie|Trębaczów| 142 |63-642 Perzów;704;305;305;17;288;43.32;5.57
108503;300805;Zespół Szkół w Trębaczowie, Oddział Przedszkolny w Miechowie|Miechów| 56 |63-642 Perzów;995;370;370;19;351;37.19;5.14
108504;300806;Świetlica Środowiskowa|Rychtal|ul. Ogrodowa 12 |63-630 Rychtal;1370;650;650;36;614;47.45;5.54
108505;300806;Szkoła Podstawowa|Wielki Buczek| 6B |63-630 Rychtal;445;206;206;14;192;46.29;6.80
108506;300806;Dom Ludowy|Drożki| 18A |63-630 Rychtal;434;167;167;14;153;38.48;8.38
108507;300806;Dom Ludowy|Krzyżowniki| 39 |63-630 Rychtal;907;318;318;13;305;35.06;4.09
108508;300807;Dom Ludowy w Trzcinicy|Trzcinica|ul. Jana Pawła II 49 |63-620 Trzcinica;1657;869;869;26;843;52.44;2.99
108509;300807;Dom Ludowy w Laskach|Laski|ul. Kępińska 17 |63-620 Trzcinica;1605;825;825;49;776;51.40;5.94
108510;300807;Dom Ludowy w Wodzicznie|Wodziczna| 87 |63-620 Trzcinica;590;333;333;10;323;56.44;3.00
108511;300901;Zespół Szkół Nr 1|Koło|ul. Poniatowskiego 22 |62-600 Koło;1383;681;681;15;666;49.24;2.20
108512;300901;Specjalny Ośrodek Szkolno - Wychowawczy|Koło|ul. Mickiewicza 14 |62-600 Koło;1265;417;417;19;398;32.96;4.56
108513;300901;Szkoła Podstawowa Nr 3|Koło|ul. Toruńska 68 |62-600 Koło;1014;427;427;20;407;42.11;4.68
108514;300901;Szkoła Podstawowa Nr 3|Koło|ul. Toruńska 68 |62-600 Koło;1801;884;884;16;868;49.08;1.81
108515;300901;Szkoła Podstawowa Nr 3|Koło|ul. Toruńska 68 |62-600 Koło;1705;890;890;11;879;52.20;1.24
108516;300901;Zespół Szkół Nr 2|Koło|ul. Kolejowa 5 |62-600 Koło;1572;714;714;20;694;45.42;2.80
108517;300901;Zespół Szkół Nr 2|Koło|ul. Kolejowa 5 |62-600 Koło;1972;994;994;18;976;50.41;1.81
108518;300901;Państwowa Szkoła Muzyczna|Koło|ul. Sienkiewicza 11 |62-600 Koło;1030;513;513;13;500;49.81;2.53
108519;300901;Miejski Dom Kultury|Koło|ul. Słowackiego 5 |62-600 Koło;1512;871;871;14;857;57.61;1.61
108520;300901;Szkoła Podstawowa Nr 1|Koło|ul.Szkolna 2A |62-600 Koło;1007;558;558;9;549;55.41;1.61
108521;300901;Szkoła Podstawowa Nr 1|Koło|ul. Szkolna 2A |62-600 Koło;1858;966;966;23;943;51.99;2.38
108522;300901;Gimnazjum Nr 1|Koło|ul. Szkolna 2 |62-600 Koło;1906;960;960;22;938;50.37;2.29
108523;300901;Dom Pomocy Społecznej|Koło|ul. Poniatowskiego 21 |62-600 Koło;79;48;48;9;39;60.76;18.75
108524;300901;Dom Pomocy Społecznej dla Dorosłych|Koło|ul. Blizna 55 |62-600 Koło;54;42;42;0;42;77.78;0.00
108525;300901;Samodzielny Publiczny Zakład Opieki Zdrowotnej|Koło|ul. Poniatowskiego 25 |62-600 Koło;51;16;16;0;16;31.37;0.00
108526;300902;Gminny Ośrodek Kultury i Biblioteka Publiczna w Babiaku|Babiak|ul. Poznańska 2 |62-620 Babiak;1812;882;882;34;848;48.68;3.85
108527;300902;Szkoła Podstawowa w Babiaku|Babiak|ul. Poznańska 5 |62-620 Babiak;831;285;285;11;274;34.30;3.86
108528;300902;Zespół Szkół w Bogusławicach|Bogusławice| 85 |62-620 Babiak;1349;489;489;32;457;36.25;6.54
108529;300902;Zespół Szkół w Brdowie|Brdów|ul. Mickiewicza 8 |62-620 Babiak;1593;644;644;35;609;40.43;5.43
108530;300902;Środowiskowy Dom Samopomocy w Dębnie Królewskim|Dębno Królewskie| 53 |62-620 Babiak;880;293;293;15;278;33.30;5.12
108531;300903;Świetlica wiejska w Rdutowie|Rdutów| 44 |62-652 Chodów;423;161;161;5;156;38.06;3.11
108532;300903;Szkoła Podstawowa w Kaleni Małej|Kaleń Mała| 17 |62-652 Chodów;920;333;333;17;316;36.20;5.11
108533;300903;Świetlica wiejska w Czerwonce|Czerwonka| 2 |62-652 Chodów;709;253;253;12;241;35.68;4.74
108534;300903;Sala Narad Urzędu Gminy Chodów|Chodów| 18 |62-652 Chodów;669;245;245;13;232;36.62;5.31
108535;300904;Miejsko-Gminny Ośrodek Kultury|Dąbie|ul. 3 Maja 4 |62-660 Dąbie;1701;714;714;37;677;41.98;5.18
108536;300904;Szkoła Podstawowa w Karszewie|Kupinin| 1 |62-660 Dąbie;1066;346;346;14;332;32.46;4.05
108537;300904;Strażnica OSP w Tarnówce Wiesiołowskiej|Tarnówka Wiesiołowska| 14 |62-660 Dąbie;408;175;175;10;165;42.89;5.71
108538;300904;Szkoła Podstawowa w Chełmnie|Chełmno| 89B |62-660 Dąbie;1121;495;495;21;474;44.16;4.24
108539;300904;Strażnica OSP w Chruścinie|Chruścin| 29A |62-660 Dąbie;1048;466;466;24;442;44.47;5.15
108540;300905;Świetlica Gminna w Grzegorzewie|Grzegorzew|ul. Kolska 5 |62-640 Grzegorzew;1568;763;763;43;720;48.66;5.64
108541;300905;Szkoła Podstawowa|Barłogi|ul. Piaskowa 3 |62-640 Grzegorzew;1017;431;431;16;415;42.38;3.71
108542;300905;Niepubliczna Szkoła Podstawowa|Borysławice Kościelne| 37 |62-640 Grzegorzew;624;243;243;15;228;38.94;6.17
108543;300905;Szkoła Podstawowa|Bylice-Kolonia| 12 |62-640 Grzegorzew;606;237;237;17;220;39.11;7.17
108544;300905;Szkoła Podstawowa|Grzegorzew|Szkolna 23 |62-640 Grzegorzew;743;291;291;14;277;39.17;4.81
108545;300906;Przedszkole nr 1 im.Jana Brzechwy|Kłodawa|ul. Bohaterów Września 1939 r 4 |62-650 Kłodawa;2109;991;991;53;938;46.99;5.35
108546;300906;Szkoła Podstawowa Nr 2 im.Białych Górników w Kłodawie|Kłodawa|ul. 3 Maja 5 |62-650 Kłodawa;1397;669;669;31;638;47.89;4.63
108547;300906;Zespół Szkół Ponadgimnazjalnych w Kłodawie|Kłodawa|ul. Adama Mickiewicza 5 |62-650 Kłodawa;1486;651;651;24;627;43.81;3.69
108548;300906;Gimnazjum Nr 1 im.Świętego Jana Pawła II w Kłodawie|Kłodawa|ul. Kościelna 15 |62-650 Kłodawa;1298;587;587;23;564;45.22;3.92
108549;300906;Szkoła Podstawowa i Gimnazjum SPSK w Wólce Czepowej|Wólka Czepowa| 33 |62-650 Kłodawa;949;397;397;22;375;41.83;5.54
108550;300906;Budynek po Szkole Podstawowej|Dębina| 40 |62-650 Kłodawa;469;206;206;12;194;43.92;5.83
108551;300906;Zespół Szkół w Rysinach-Kolonii|Rysiny-Kolonia| 37 |62-650 Kłodawa;853;326;326;20;306;38.22;6.13
108552;300906;Szkoła Podstawowa w Bierzwiennej Długiej|Bierzwienna Długa| 76 |62-650 Kłodawa;657;249;249;13;236;37.90;5.22
108553;300906;Świetlica Wiejska w Leszczach|Leszcze| 20 |62-650 Kłodawa;567;194;194;12;182;34.22;6.19
108554;300906;Szkoła Podstawowa i Gimnazjum w Górkach|Górki| 18 |62-650 Kłodawa;486;180;180;12;168;37.04;6.67
108555;300906;Świetlica Wiejska w Krzykosach|Krzykosy| 83 |62-650 Kłodawa;332;120;120;6;114;36.14;5.00
108556;300907;Zespół Szkół w Powierciu|Powiercie| 3 |62-600 Koło;2135;1043;1043;35;1008;48.85;3.36
108557;300907;Szkoła Podstawowa we Wrzącej Wielkiej|Wrząca Wielka| 124 |62-600 Koło;1649;756;756;27;729;45.85;3.57
108558;300907;Szkoła Podstawowa w Kiełczewie Smużnym Pierwszym|Kiełczew Smużny Pierwszy| 42 |62-600 Koło;1016;421;421;16;405;41.44;3.80
108559;300907;Szkoła Podstawowa w Dzierawach|Dzierawy| 45 |62-600 Koło;1244;517;517;19;498;41.56;3.68
108560;300908;Szkoła Podstawowa|Trzęśniew| 24 |62-604 KOŚCIELEC;1218;415;415;35;380;34.07;8.43
108561;300908;Urząd Gminy|Kościelec|ul.Turecka 7, 3|62-604 KOŚCIELEC;1336;650;650;30;620;48.65;4.62
108562;300908;PUNKT PRZEDSZKOLNY KUBUŚ PUCHATEK|KOŚCIELEC|UL. KOŚCIELNA 1 |62-604 KOŚCIELEC;1385;566;566;30;536;40.87;5.30
108563;300908;SZKOŁA PODSTAWOWA|RUSZKÓW PIERWSZY|BRUDZEWSKA 3 |62-604 KOŚCIELEC;1428;624;624;14;610;43.70;2.24
108564;300909;Urząd Gminy w Olszówce|Olszówka| 15 |62-641 Olszówka;1700;598;598;22;576;35.18;3.68
108565;300909;Świetlica Wiejska w Adaminie|Adamin| 43 |62-641 Olszóka;1499;561;561;25;536;37.42;4.46
108566;300909;Świetlica Wiejska w Krzewacie|Krzewata| 95 |62-641 Olszówka;549;170;170;7;163;30.97;4.12
108567;300910;Zespół Szkół|Dęby Szlacheckie| 54 |62-613 Osiek Mały;1895;799;799;41;758;42.16;5.13
108568;300910;Szkoła Podstawowa|Drzewce| 41 |62-613 Osiek Mały;1087;392;392;15;377;36.06;3.83
108569;300910;Szkoła Podstawowa|Osiek Wielki| 61 |62-600 Koło;1747;743;743;20;723;42.53;2.69
108570;300911;Miejsko-Gminny Ośrodek Kultury|Przedecz|ul. Zamkowa 5 |62-635 Przedecz;1433;586;586;30;556;40.89;5.12
108571;300911;Zespół Szkół|Przedecz|ul. Szkolna 5 |62-635 Przedecz;1068;392;392;18;374;36.70;4.59
108572;300911;Świetlica Ochotniczej Straży Pożarnej|Dziwie| 57 |62-635 Przedecz;971;281;281;26;255;28.94;9.25
108573;301001;Szkoła Podstawowa w Golinie|Golina|ul. Wolności 20 |62-590 Golina;1824;794;794;31;763;43.53;3.90
108574;301001;Biblioteka Publiczna w Golinie|Golina|Plac Kazimierza Wielkiego 12 |62-590 Golina;1808;816;816;36;780;45.13;4.41
108575;301001;Ochotnicza Straż Pożarna w Węglewie|Węglew| 42 |62-590 Golina;1498;731;731;21;710;48.80;2.87
108576;301001;Szkoła Podstawowa w Kawnicach|Kawnice| 50 |62-590 Golina;1386;589;589;29;560;42.50;4.92
108577;301001;Szkoła Podstawowa w Przyjmie|Przyjma| |62-590 Golina;1307;478;478;23;455;36.57;4.81
108578;301001;Gimnazjum w Golinie|Golina|ul.Kopernika 12 |62-590 Golina;1168;425;425;18;407;36.39;4.24
108579;301001;Szkoła Podstawowa w Radolinie|Radolina| |62-590 Golina;615;256;256;6;250;41.63;2.34
108580;301002;Zespół Szkół|Grodziec|Plac Ks.Abpa Bronisława Dąbrowskiego 4 |62-580 Grodziec;1872;741;741;45;696;39.58;6.07
108581;301002;Społeczna Szkoła Podstawowa|Lipice| 13 |62-580 Grodziec;623;160;160;9;151;25.68;5.62
108582;301002;Szkoła Podstawowa|Królików| 82 |62-580 Grodziec;976;351;351;18;333;35.96;5.13
108583;301002;Społeczna Szkoła Podstawowa|Biskupice| 55 |62-580 Grodziec;680;236;236;16;220;34.71;6.78
108584;301003;Szkoła Podstawowa w Dobrosołowie|Dobrosołowo| 42 |62-530 Kazimierz Biskupi;998;382;382;11;371;38.28;2.88
108585;301003;Urząd Gminy w Kazimierzu Biskupim|Kazimierz Biskupi|pl. Wolności 1 |62-530 Kazimierz Biskupi;1777;710;710;39;671;39.95;5.49
108586;301003;Szkoła Podstawowa w Kazimierzu Biskupim|Kazimierz Biskupi|ul. Węglewska 12 |62-530 Kazimierz Biskupi;1685;810;810;46;764;48.07;5.68
108587;301003;Przedszkole w Kazimierzu Biskupim|Kazimierz Biskupi|ul. Ogrodowa 3 |62-530 Kazimierz Biskupi;1575;575;575;27;548;36.51;4.70
108588;301003;Szkoła Podstawowa w Sokółkach|Sokółki| 18 |62-530 Kazimierz Biskupi;1382;684;684;17;667;49.49;2.49
108589;301003;Pałac w Posadzie|Posada|ul. Tuwima 2 |62-530 Kazimierz Biskupi;1678;963;963;27;936;57.39;2.80
108590;301004;Gimnazjum im. Noblistów Polskich|Kleczew|ul. Warszawska 31 |62-540 Kleczew;1746;856;856;44;812;49.03;5.14
108591;301004;Zespół Szkolno-Przedszkolny|Kleczew|ul. Św. Kingi 7 |62-540 Kleczew;1687;752;752;45;707;44.58;5.98
108592;301004;Budynek wielofunkcyjny|Kleczew|ul. Strażacka 2 |62-540 Kleczew;1348;509;509;32;477;37.76;6.29
108593;301004;Szkoła Podstawowa im. Juliana Tuwima|Złotków| 48 |62-540 Kleczew;1052;451;451;38;413;42.87;8.43
108594;301004;Gimnazjum im. Przyrodników Polskich|Budzisław Kościelny|ul. Szkolna 17 |62-541 Budzisław Kościelny;1124;449;449;49;400;39.95;10.91
108595;301004;Zespół Szkolno-Przedszkolny|Budzisław Kościelny|ul. Szkolna 17 |62-541 Budzisław Kościelny;1083;485;485;36;449;44.78;7.42
108596;301005;Gimnazjum Publiczne|Kramsk|ul. Konińska 20 |62-511 Kramsk;1096;487;487;19;468;44.43;3.90
108597;301005;Centrum Pracy Twórczej|Kramsk|Rynek 4A |62-511 Kramsk;1107;492;492;24;468;44.44;4.88
108598;301005;Szkoła Podstawowa|Bilczew| 2 |62-511 Kramsk;953;362;362;15;347;37.99;4.14
108599;301005;Klub Rolnika w Borkach|Borki| 36 |62-511 Kramsk;607;276;276;13;263;45.47;4.71
108600;301005;Szkoła Podstawowa|Patrzyków| 2A |62-511 Kramsk;672;329;329;20;309;48.96;6.08
108601;301005;Remiza Ochotniczej Straży Pożarnej|Grąblin| 103 |62-563 Licheń Stary;537;243;243;9;234;45.25;3.70
108602;301005;Szkoła Podstawowa|Helenów Drugi| 15 |62-563 Licheń Stary;615;229;229;17;212;37.24;7.42
108603;301005;Remiza Ochotniczej Straży Pożarnej|Wola Podłężna|Centralna 61 |62-510 Konin;1740;789;789;19;770;45.34;2.41
108604;301005;Zespół Szkół|Wysokie| 15 |62-511 Kramsk;1344;541;542;15;526;40.25;2.77
108605;301006;Zespół Szkół w Krzymowie|Krzymów|ul. Główna 1 |62-513 Krzymów;2287;956;956;46;910;41.80;4.81
108606;301006;Niepubliczna Szkoła Podstawowa w Smólniku|Smólnik| 20A |62-513 Krzymów;743;286;286;8;278;38.49;2.80
108607;301006;Zespół Szkół w Brzeźnie|Brzeźno|ul. Kwiatowa 20A |62-513 Krzymów;1731;866;866;29;837;50.03;3.35
108608;301006;Niepubliczna Szkoła Podstawowa w Głodnie|Głodno| 20 |62-513 Krzymów;323;126;126;4;122;39.01;3.17
108609;301006;Szkoła Podstawowa w Szczepidle|Szczepidło| 52 |62-513 Krzymów;961;456;456;19;437;47.45;4.17
108610;301007;Szkoła Podstawowa|Kuchary Kościelne| 5 |62-573 Rychwał;924;411;411;26;385;44.48;6.33
108611;301007;Szkoła Podstawowa|Dąbroszyn| 47 |62-570 Rychwał;768;334;334;14;320;43.49;4.19
108612;301007;Zespół Szkół|Rychwał|ul. Konińska 46A |62-570 Rychwał;2168;1113;1113;45;1068;51.34;4.04
108613;301007;Szkoła Podstawowa|Jaroszewice Grodzieckie| 38 |62-570 Rychwał;816;301;301;14;287;36.89;4.65
108614;301007;Szkoła Podstawowa|Siąszyce| 4 |62-574 Rychwał;443;197;197;15;182;44.47;7.61
108615;301007;Szkoła Podstawowa|Biała Panieńska| 72 |62-574 Rychwał;551;178;178;13;165;32.30;7.30
108616;301007;Szkoła Podstawowa|Grochowy| 2 |62-574 Rychwał;997;402;402;21;381;40.32;5.22
108617;301008;Zespół Szkolno-Przedszkoly w Rzgowie|Rzgów|ul. Konińska 6 |62-586 Rzgów;1635;697;697;31;666;42.63;4.45
108618;301008;Zespół Szkół w Sławsku|Sławsk|ul. Okólna 3 |62-586 Rzgów;1795;816;816;10;806;45.46;1.23
108619;301008;Szkoła Podstawowa|Grabienice| |62-586 Rzgów;1050;390;390;21;369;37.14;5.38
108620;301008;Szkoła Podstawowa w Osieczy|Osiecza Pierwsza| |62-586 Rzgów;1181;501;501;22;479;42.42;4.39
108621;301009;Remiza OSP|Łuszczewo| |62-560 Skulsk;378;128;128;6;122;33.86;4.69
108622;301009;Gminny Ośrodek Kultury|Mielnica Duża| 32a |62-560 Skulsk;318;102;102;10;92;32.08;9.80
108623;301009;Remiza OSP|Skulsk|ul.Włocławska 12 |62-560 Skulsk;1397;600;600;20;580;42.95;3.33
108624;301009;Remiza OSP|Lisewo| |62-560 Skulsk;646;234;234;11;223;36.22;4.70
108625;301009;Świetlica|Celinowo| |62-560 Skulsk;340;120;120;7;113;35.29;5.83
108626;301009;Szkoła Podstawowa|Buszkowo| 51 |62-560 Skulsk;343;88;88;8;80;25.66;9.09
108627;301009;Świetlica|Rakowo| 37 |62-560 Skulsk;555;189;189;2;187;34.05;1.06
108628;301009;Budynek Gminny|Zygmuntowo| 35 |62-560 Skulsk;436;92;92;4;88;21.10;4.35
108629;301009;Szkoła Podstawowa|Wandowo| 3 |62-560 Skulsk;530;152;152;9;143;28.68;5.92
108630;301010;Miejsko-Gminna Biblioteka Publiczna|Sompolno|ul. Piotrkowska 8 |62-610 Sompolno;1827;778;778;36;742;42.58;4.63
108631;301010;Przedszkole Miejskie|Sompolno|ul. Kaliska 37 |62-610 Sompolno;1533;586;586;19;567;38.23;3.24
108632;301010;Zespół Szkolno-Przedszkolny nr 2|Lubstów|ul. Kościelna 1a |62-610 Sompolno;1088;407;407;24;383;37.41;5.90
108633;301010;Dom Ludowy|Lubstówek| 55 |62-610 Sompolno;714;301;301;4;297;42.16;1.33
108634;301010;Zespół Szkół nr 3|Mąkolno|ul. Szkolna 31 |62-610 Sompolno;1705;735;735;28;707;43.11;3.81
108635;301010;Szkoła Podstawowa|Ośno Górne| 2A |62-610 Sompolno;1039;372;372;21;351;35.80;5.65
108636;301010;Remiza OSP|Racięcice| 35 |62-610 Sompolno;483;186;186;8;178;38.51;4.30
108637;301011;Szkoła Podstawowa Stare Miasto|Stare Miasto|ul. Szkolna 11 |62-571 Stare Miasto;1125;612;612;26;586;54.40;4.25
108638;301011;Gimnazjum Stare Miasto|Stare Miasto|ul. Kasztanowa 1 |62-571 Stare Miasto;1171;643;643;20;623;54.91;3.11
108639;301011;Zespół Szkół Żychlin|Żychlin|ul. Parkowa 11 |62-571 Stare Miasto;1783;936;936;32;904;52.50;3.42
108640;301011;Klub Wiejski Krągola Pierwsza|Krągola Pierwsza| 12B |62-571 Stare Miasto;736;319;319;17;302;43.34;5.33
108641;301011;Zespół Szkół Lisiec Wielki|Lisiec Wielki|ul.Długa 1 |62-571 Stare Miasto;1922;849;849;50;799;44.17;5.89
108642;301011;Szkoła Podstawowa Modła Królewska|Modła Królewska| 35 |62-571 Stare Miasto;1067;493;493;10;483;46.20;2.03
108643;301011;Szkoła Podstawowa Barczygłów|Barczygłów| 43 |62-571 Stare Miasto;511;213;213;23;190;41.68;10.80
108644;301011;Przedszkole Samorządowe w Starym Mieście Oddział w Ruminie|Rumin| 45 |62-500 Konin;738;391;391;10;381;52.98;2.56
108645;301012;Zespół Szkolno-Przedszkolny w Ślesinie|Ślesin|ul.Żwirki i Wigury 55 |62-561 Ślesin;1523;744;744;22;722;48.85;2.96
108646;301012;Gimnazium w Ślesinie|Ślesin|ul.Młodzieżowa 1 |62-561 Ślesin;974;492;492;14;478;50.51;2.85
108647;301012;Szkoła Podstawowa w Ostrowążu|Ostrowąż| 21 |62-561 ślesin;668;258;258;10;248;38.62;3.88
108648;301012;Ośrodek Szkoleniowo-Wypoczynkowy WITYNG|Mikorzyn| 1A |62-561 ślesin;1606;718;718;32;686;44.71;4.46
108649;301012;Szkoła Podstawowa w Szyszyńskich Holendrach,|Szyszyńskie Holendry| 34 |62-561 Ślesin;1889;662;662;22;640;35.04;3.32
108650;301012;Budynek po Szkole Podstawowej w Ignacewie|Ignacewo| 19 |62-561 Ślesin;638;248;248;13;235;38.87;5.24
108651;301012;Szkoła Podstawowa w Piotrkowicach,|Piotrkowice| 27 |62-561 Ślesin;1663;617;617;22;595;37.10;3.57
108652;301012;Szkoła Podstawowa w Wąsoszach,|Wąsosze| 73 |62-561 Ślesin;745;327;327;12;315;43.89;3.67
108653;301012;Szkoła Podstawowa w Licheniu Starym,|Stary Licheń|ul.Konińska 48 |62-563 Licheń Stary;1543;717;717;26;691;46.47;3.63
108654;301012;Dom Pomocy Społecznej w Ślesinie|Ślesin|ul.Kościelna 46 |62-561 Ślesin;31;6;6;0;6;19.35;0.00
108655;301013;Szkoła Podstawowa|Zakrzewek| 7 |62-610 Sompolno;769;261;261;22;239;33.94;8.43
108656;301013;Zespół Gimnazjalno-Szkolny|Morzyczyn| 4 |62-619 Sadlno;675;238;238;8;230;35.26;3.36
108657;301013;Remiza OSP|Broniszewo| 30 |62-619 Sadlno;860;332;332;20;312;38.60;6.02
108658;301013;Szkoła Podstawowa|Sadlno| 5 |62-619 Sadlno;791;357;357;15;342;45.13;4.20
108659;301013;Szkoła Podstawowa|Tomisławice| 2 |62-619 Sadlno;1068;401;401;28;373;37.55;6.98
108660;301013;Urząd Gminy|Wierzbinek|Plac Powstańców Styczniowych 110 |62-619 Sadlno;844;334;334;17;317;39.57;5.09
108661;301013;Szkoła Podstawowa|Zaryń| 19 |62-618 Zaryń;848;272;272;23;249;32.08;8.46
108662;301014;świetlica Szkoły Podstawowej w Wilczynie|Wilczogóra| 8 |62-550 Wilczyn;1004;391;391;15;376;38.94;3.84
108663;301014;sala Gminnego Ośrodka Kultury w Wilczynie|Wilczyn|Rynek 14 |62-550 Wilczyn;1066;498;498;32;466;46.72;6.43
108664;301014;świetlica Gimnazjum w Wilczynie|Wilczogóra| 7 |62-550 Wilczyn;710;276;276;27;249;38.87;9.78
108665;301014;sala Ochotniczej Straży Pożarnej w Kopydłowie|Kopydłowo| 21 |62-550 Wilczyn;756;295;295;33;262;39.02;11.19
108666;301014;sala Ochotniczej Straży Pożarnej w Wiśniewie|Wiśniewa| 6 |62-550 Wilczyn;644;254;254;18;236;39.44;7.09
108667;301014;świetlica Szkoły Podstawowej w Bieli|Biela| 4 |62-550 Wilczyn;725;218;218;24;194;30.07;11.01
108668;301101;Zespół Szkół nr 4|Kościan|ul. 27 Stycznia 1 |64-000 Kościan;1647;953;953;31;922;57.86;3.25
108669;301101;Zespół Szkół nr 4|Kościan|ul. 27 Stycznia 1 |64-000 Kościan;1339;681;681;14;667;50.86;2.06
108670;301101;Wieża Ciśnień|Kościan|ul. Czempińska 1 |64-000 Kościan;1623;935;935;24;911;57.61;2.57
108671;301101;Urząd Miejski Kościana siedziba Urządu Stanu Cywilnego|Kościan|Rynek 1 |64-000 Kościan;989;587;587;17;570;59.35;2.90
108672;301101;I Liceum Ogolnokształcące|Kościan|Al. Kościuszki 3 |64-000 Kościan;1541;780;780;25;755;50.62;3.21
108673;301101;Zespół Szkół nr 1|Kościan|ul. Mickiewicza 12 |64-000 Kościan;1646;939;939;19;920;57.05;2.02
108674;301101;Kościański Ośrodek Kultury|Kościan|ul. Mickiewicza 11 |64-000 Kościan;1116;664;664;13;651;59.50;1.96
108675;301101;Zespól Szkół nr 3|Kościan|Wyzwolenia 24 |64-000 Kościan;2036;1195;1195;30;1165;58.69;2.51
108676;301101;Zespół Szkół Ponadgimnazjalnych|Kościan|ul. Wielichowska 43a |64-000 Kościan;2056;1148;1148;23;1125;55.84;2.00
108677;301101;Budynek przy ulicy Bernardyńskiej 2|Kościan|ul. Bernardyńska 2 |64-000 Kościan;2277;1106;1106;59;1047;48.57;5.33
108678;301101;Zespół Szkół nr 2|Kościan|Os. Piastowskie 47 |64-000 Kościan;940;456;456;24;432;48.51;5.26
108679;301101;Zespół Szkół nr 2|Kościan|Os. Piastowskie 47 |64-000 Kościan;1907;974;974;26;948;51.07;2.67
108680;301101;Wojewódzki Szpital Neuropsychiatryczny|Kościan|Pl. Paderewskiego 1a |64-000 Kościan;275;142;142;23;119;51.64;16.20
108681;301101;Samodzielny Publiczny Zespół Opieki Zdrowotnej|Kościan|Szpitalna 7 |64-000 Kościan;133;54;54;0;54;40.60;0.00
108682;301102;Szkoła Podstawowa im. Bohaterów Westerplatte|Czempiń|ul. Kolejowa 3 |64-020 Czempiń;2038;1095;1095;41;1054;53.73;3.74
108683;301102;Przedszkole Samorządowe|Czempiń|ul. Borówko Stare 1 |64-020 Czempiń;2147;1161;1161;42;1119;54.08;3.62
108684;301102;Szkoła Podstawowa im. Bohaterów Westerplatte|Czempiń|ul. Kolejowa 3 |64-020 Czempiń;1628;623;623;30;593;38.27;4.82
108685;301102;Świetlica|Gorzyczki| 12 |64-020 Czempiń;1681;599;599;32;567;35.63;5.34
108686;301102;Szkoła Podstawowa|Głuchowo|ul. Kościańska 28/30 |64-020 Czempiń;1506;570;570;42;528;37.85;7.37
108687;301102;Dom Pomocy Społecznej|Jarogniewice|ul. Poznańska 25 |64-020 Czempiń;55;41;41;5;36;74.55;12.20
108688;301103;Szkoła Podstawowa|Bonikowo|ul.Parkowa 3 |64-000 Kościan;864;358;358;23;335;41.44;6.42
108689;301103;"Dom Ogrodnika"|Widziszewo|ul. Podgórna 2 |64-000 Kościan;965;477;477;11;466;49.43;2.31
108690;301103;Gościniec Gryżyna|Gryżyna|ul.Zielona 6a |64-000 Kościan;772;309;309;18;291;40.03;5.83
108691;301103;Szkoła Podstawowa|Kiełczewo|ul. Kościańska 2 |64-000 Kościan;1223;655;655;23;632;53.56;3.51
108692;301103;Gimnazjum|Racot|ul. Kościańska 9e |64-000 Kościan;1604;772;772;23;749;48.13;2.98
108693;301103;Szkoła Podstawowa|Stary Lubosz|ul. Kościańska 7 |64-000 Kościan;1540;662;662;32;630;42.99;4.83
108694;301103;Szkoła Podstawowa|Turew|ul. Szkolna 21 |64-000 Kościan;830;365;365;21;344;43.98;5.75
108695;301103;Świetlica Wiejska|Choryń| 6a |64-000 Kościan;653;276;276;9;267;42.27;3.26
108696;301103;Świetlica Wiejska|Kurza Góra|ul. Leśna 31 |64-000 Kościan;677;324;324;12;312;47.86;3.70
108697;301103;Szkoła Podstawowa|Kokorzyn|ul. Szkolna 1 |64-000 Kościan;1554;633;633;23;610;40.73;3.63
108698;301103;Szkoła Podstawowa|Stare Oborzyska|ul. Szkolna 1 |64-000 Kościan;1796;816;816;51;765;45.43;6.25
108699;301104;Szkoła Podstawowa w Bieżyniu|Bieżyń| 111 |64-010 Krzywiń;1081;430;430;29;401;39.78;6.74
108700;301104;Zespół Szkół w Jerce|Jerka|ul. Szkolna 5 |64-010 Krzywiń;2046;917;917;77;840;44.82;8.40
108701;301104;Zespół Szkół Ponadgimnazjalnych w Krzywiniu|Krzywiń|ul. Generała Chłapowskiego 34 |64-010 Krzywiń;2335;1161;1161;59;1102;49.72;5.08
108702;301104;Zespół Szkół i Placówek Oświatowych w Lubiniu|Lubiń|ul. Powstańców 23 |64-010 Krzywiń;1525;634;634;47;587;41.57;7.41
108703;301104;Zespół Szkół w Jerce|Jerka|ul. Szkolna 5 |64-010 Krzywiń;913;365;365;14;351;39.98;3.84
108704;301105;Szkoła Podstawowa|Śmigiel|ul. Konopnickiej 5 |64-030 Śmigiel;1414;654;654;22;632;46.25;3.36
108705;301105;Szkoła Podstawowa|Śmigiel|ul. Konopnickiej 5 |64-030 Śmigiel;1081;506;506;14;492;46.81;2.77
108706;301105;Centrum Kultury|Śmigiel|ul. Kościuszki 20 |64-030 Śmigiel;1054;455;455;26;429;43.17;5.71
108707;301105;Przedszkole Samorządowe|Śmigiel|ul. Leszczyńska 13 |64-030 Śmigiel;1139;518;518;36;482;45.48;6.95
108708;301105;Zespół Szkół Ponadgimnazjalnych im. Jana Kasprowicza|Nietążkowo|ul. Dudycza 4 |64-030 Śmigiel;457;190;190;8;182;41.58;4.21
108709;301105;Przedszkole Samorządowe w Śmiglu|Śmigiel|al. Bohaterów 7 |64-030 Śmigiel;305;113;113;5;108;37.05;4.42
108710;301105;Zespół Szkół w Czaczu|Czacz|ul. Parkowa 2 |64-030 Śmigiel;1245;553;553;32;521;44.42;5.79
108711;301105;Świetlica Wiejska|Koszanowo|ul. Wierzbowa 40 |64-030 Śmigiel;534;250;250;16;234;46.82;6.40
108712;301105;Świetlica Wiejska|Bruszczewo|ul. Przysiecka 11 |64-030 Śmigiel;286;125;125;8;117;43.71;6.40
108713;301105;Świetlica Wiejska|Robaczyn| 45c |64-030 Śmigiel;238;112;112;1;111;47.06;0.89
108714;301105;Dom Wiejski|Stare Bojanowo|ul. Główna 34a |64-030 Śmigiel;1374;697;697;44;653;50.73;6.31
108715;301105;Zespół Szkół Samorządowe Gimnazjum i Szkoła Podstawowa|Stara Przysieka Druga| 34 |64-030 Śmigiel;855;328;328;30;298;38.36;9.15
108716;301105;Świetlica Wiejska|Spławie| 58 |64-030 Śmigiel;348;118;118;8;110;33.91;6.78
108717;301105;Świetlica Wiejska|Sierpowo| 12 |64-030 Śmigiel;543;213;213;7;206;39.23;3.29
108718;301105;Szkoła Podstawowa|Wonieść| 36 |64-030 Śmigiel;890;326;326;15;311;36.63;4.60
108719;301105;Świetlica Wiejska|Żegrówko|ul. Śmigielska 18 |64-030 Śmigiel;509;149;149;12;137;29.27;8.05
108720;301105;Zespół Szkół Samorządowe Gimnazjum i Szkoła Podstawowa|Bronikowo|ul. Morownicka 26 |64-030 Śmigiel;512;183;183;5;178;35.74;2.73
108721;301105;Świetlica Wiejska|Morownica|Leśna 1 |64-030 Śmigiel;447;165;165;10;155;36.91;6.06
108722;301105;Świetlica Wiejska|Brońsko| 22a |64-030 Śmigiel;360;152;152;12;140;42.22;7.89
108723;301105;Świetlica Wiejska|Karśnice| 90 |64-030 Śmigiel;309;127;127;7;120;41.10;5.51
108724;301201;Zespół Szkół Publicznych w Sulmierzycach|Sulmierzyce|ul. Szkolna 2 |63-750 Sulmierzyce;2208;986;986;66;920;44.66;6.69
108725;301202;Sala szkolna|Kobylin|Plac Andrzeja Glabera 1 |63-740 Kobylin;1304;592;592;18;574;45.40;3.04
108726;301202;Zespół Szkoła Podstawowa im. Juliana Tuwima i Przedszkole|Kobylin|ul. 3 Maja 9 |63-740 Kobylin;1251;538;538;24;514;43.01;4.46
108727;301202;Remiza Ochotniczej Straży Pożarnej|Kobylin|ul. Krobska 19 |63-740 Kobylin;501;176;176;19;157;35.13;10.80
108728;301202;Dom Strażaka|Smolice| 73a |63-740 Kobylin;1121;482;482;20;462;43.00;4.15
108729;301202;Szkoła Podstawowa|Kuklinów| 40 |63-740 Kobylin;593;228;228;14;214;38.45;6.14
108730;301202;Dom Strażaka|Zalesie Wielkie| 20 |63-740 Kobylin;634;266;266;13;253;41.96;4.89
108731;301202;Dom Strażaka|Wyganów| 38 |63-740 Kobylin;641;239;239;15;224;37.29;6.28
108732;301202;Świetlica Wiejska|Łagiewniki| 19A |63-740 Kobylin;388;141;141;6;135;36.34;4.26
108733;301203;Dom Parafialny|Koźmin Wielkopolski|Plac NS NMP 1 |63-720 Koźmin Wielkopolski;2226;1032;1032;41;991;46.36;3.97
108734;301203;Szkoła Podstawowa Nr 3|Koźmin Wielkopolski|ul. Klasztorna 29 |63-720 Koźmin Wielkopolski;2120;978;978;45;933;46.13;4.60
108735;301203;I Liceum Ogólnokształcące|Koźmin Wielkopolski|ul. Borecka 28 |63-720 Koźmin Wielkopolski;1011;457;457;26;431;45.20;5.69
108736;301203;Szkoła Podstawowa|Mokronos| 3 |63-720 Koźmin Wielkopolski;1109;469;469;32;437;42.29;6.82
108737;301203;Szkoła Podstawowa Nr 1|Koźmin Wielkopolski|ul. Glinki 11 |63-720 Koźmin Wielkopolski;1551;582;582;18;564;37.52;3.09
108738;301203;Specjalny Ośrodek Szkolno-Wychowawczy|Borzęciczki| 11 |63-720 Koźmin Wielkopolski;1020;414;414;12;402;40.59;2.90
108739;301203;Dom Strażaka|Wałków| 8 |63-720 Koźmin Wielkopolski;1670;652;652;26;626;39.04;3.99
108740;301203;Szpital Powiatowy|Koźmin Wielkopolski|ul. Czesława Stęszewskiego 9 |63-720 Koźmin Wielkopolski;37;23;23;2;21;62.16;8.70
108741;301204;Zespół Szkół Nr 1 z Oddziałami Integracyjnymi (świetlica)|Krotoszyn|ul. Władysława Jagiełły 4 |63-700 Krotoszyn;1819;950;950;23;927;52.23;2.42
108742;301204;Zespół Szkół Nr 1 z Oddziałami Integracyjnymi (sala nr 1)|Krotoszyn|ul. Władysława Jagiełły 4 |63-700 Krotoszyn;1590;828;828;22;806;52.08;2.66
108743;301204;Przedszkole Nr 7 z Oddziałami Integracyjnymi|Krotoszyn|Osiedle Korczaka |63-700 Krotoszyn;1269;625;625;13;612;49.25;2.08
108744;301204;Szkoła Podstawowa Nr 8|Krotoszyn|ul. 23 Stycznia 20 |63-700 Krotoszyn;1309;746;746;21;725;56.99;2.82
108745;301204;Gimnazjum Nr 4|Krotoszyn|ul. 23 Stycznia 20 |63-700 Krotoszyn;1372;728;728;17;711;53.06;2.34
108746;301204;Krotoszyńska Biblioteka Publiczna (sala prelekcyjna)|Krotoszyn|ul. Benicka 9 |63-700 Krotoszyn;1199;650;650;23;627;54.21;3.54
108747;301204;Zespół Szkół Ponadgimnazjalnych Nr 1 (klub)|Krotoszyn|ul. Mickiewicza 11 |63-700 Krotoszyn;1265;615;615;15;600;48.62;2.44
108748;301204;Zespół Szkół Ponadgimnazjalnych Nr 1 (stołówka)|Krotoszyn|ul. Mickiewicza 11 |63-700 Krotoszyn;1191;568;568;16;552;47.69;2.82
108749;301204;Muzeum Regionalne im. Hieronima Ławniczaka (budynek poklasztorny)|Krotoszyn|Mały Rynek 1 |63-700 Krotoszyn;1678;762;762;26;736;45.41;3.41
108750;301204;Krotoszyńska Biblioteka Publiczna (czytelnia)|Krotoszyn|ul. Benicka 9 |63-700 Krotoszyn;1129;565;565;15;550;50.04;2.65
108751;301204;Zespół Szkół Nr 3|Krotoszyn|Aleja Powstańców Wlkp. 13 |63-700 Krotoszyn;1965;842;842;50;792;42.85;5.94
108752;301204;Zespół Szkół Specjalnych (budynek byłego internatu)|Krotoszyn|ul. Ostrowska 49 |63-700 Krotoszyn;1683;806;806;26;780;47.89;3.23
108753;301204;Środowiskowy Dom Samopomocy (była Szkoła Rolnicza)|Krotoszyn|ul. Langiewicza 2 |63-700 Krotoszyn;1711;983;983;27;956;57.45;2.75
108754;301204;Liceum Ogólnokształcące|Krotoszyn|ul. Kołłątaja 1 |63-700 Krotoszyn;1929;1028;1028;21;1007;53.29;2.04
108755;301204;Zespół Szkół Specjalnych (budynek szkoły)|Krotoszyn|ul. Ostrowska 49 |63-700 Krotoszyn;1875;897;897;19;878;47.84;2.12
108756;301204;Zespół Szkół|Benice|ul. Armii Krajowej 9 |63-700 Krotoszyn;1104;409;409;25;384;37.05;6.11
108757;301204;Szkoła Podstawowa|Lutogniew|ul. Krotoszyńska 150 |63-700 Krotoszyn;1601;761;761;26;735;47.53;3.42
108758;301204;Szkoła Podstawowa|Kobierno|ul. Kobierska 3 |63-714 Kobierno;2110;885;885;36;849;41.94;4.07
108759;301204;Zespół Szkół|Orpiszew|ul. Szkolna 6 |63-714 Kobierno;1400;568;568;16;552;40.57;2.82
108760;301204;Szkoła Podstawowa|Biadki|ul. Szkolna 3 |63-714 Kobierno;1886;816;816;34;782;43.27;4.17
108761;301204;Zespół Szkół|Chwaliszew|ul. Ostrowska 39 |63-750 Sulmierzyce;770;334;334;19;315;43.38;5.69
108762;301204;Szpital Powiatowy im. Marcelego Nenckiego|Krotoszyn|ul. Mickiewicza 21 |63-700 Krotoszyn;61;9;9;0;9;14.75;0.00
108763;301204;Szpital Powiatowy|Krotoszyn|ul. Bolewskiego 4-8 |63-700 Krotoszyn;18;7;7;1;6;38.89;14.29
108764;301204;Zakład Opiekuńczo-Leczniczy w Krotoszynie|Krotoszyn|ul. Bolewskiego 14 |63-700 Krotoszyn;17;4;4;1;3;23.53;25.00
108765;301205;Sala Wiejska|Rozdrażew|ul. Rynek 3 |63-708 Rozdrażew;1336;650;650;38;612;48.65;5.85
108766;301205;Kółko Rolnicze|Rozdrażew|ul. Rynek 3 |63-708 Rozdrażew;1251;525;525;19;506;41.97;3.62
108767;301205;Zespół Szkół Publicznych|Nowa Wieś| 36 |63-708 Rozdrażew;1439;593;593;28;565;41.21;4.72
108768;301206;Biblioteka Publiczna Gminy i Miasta Zduny|Zduny|ul. Sienkiewicza 9 |63-760 Zduny;1847;866;866;45;821;46.89;5.20
108769;301206;Zespół Szkół|Zduny|ul. Łacnowa 26 |63-760 Zduny;2153;958;958;41;917;44.50;4.28
108770;301206;Szkoła Podstawowa|Baszków| 34 |63-760 Zduny;669;259;259;16;243;38.71;6.18
108771;301206;Dom Pomocy Społecznej|Baszków|Baszków 112A |63-760 Zduny;1003;372;372;11;361;37.09;2.96
108772;301206;Dom Pomocy Społecznej|Baszków| 112A |63-760 Zduny;132;68;68;10;58;51.52;14.71
108773;301301;Zespół Szkół Szkoła Podstawowa i Gimnazjum|Nowy Belęcin| 30 |64-120 Krzemieniewo;1037;416;416;23;393;40.12;5.53
108774;301301;Publiczne Przedszkole|Krzemieniewo|ul. Spółdzielcza 48 |64-120 Krzemieniewo;1883;820;820;20;800;43.55;2.44
108775;301301;Zespół Szkół Szkoła Podstawowa i Gimnazjum|Pawłowice|ul. Leszczyńska 6 |64-122 Pawłowice;1721;710;710;34;676;41.26;4.79
108776;301301;Zespół Szkół Gminy Krzemieniewo Przedszkole i Szkoła Podstawowa|Garzyn|ul. Leszczyńska 50 |64-120 Krzemieniewo;1213;510;510;21;489;42.04;4.12
108777;301301;Szkoła Podstawowa Filialna|Oporówko| 7a |64-120 Krzemieniewo;820;334;334;12;322;40.73;3.59
108778;301301;Samodzielny Publiczny Zakład Opieki Zdrowotnej Ministerstwa Spraw Wewnętrznych Centrum Rehabilitacji|Górzno| 63 |64-120 Krzemieniewo;105;61;61;8;53;58.10;13.11
108779;301302;Przedszkole|Górka Duchowna| 68 |64-111 Lipno;975;392;392;18;374;40.21;4.59
108780;301302;Szkoła Podstawowa|Lipno|ul. Powstańców Wielkopolskich 68 |64-111 Lipno;1595;853;853;56;797;53.48;6.57
108781;301302;Szkoła Podstawowa|Wilkowice|ul. Szkolna 28 |64-115 Święciechowa;1954;1003;1003;34;969;51.33;3.39
108782;301302;Szkoła Podstawowa|Goniembice| 30 |64-111 Lipno;1169;459;459;17;442;39.26;3.70
108783;301303;Miejsko-Gminny Ośrodek Kultury|Osieczna|ul. Plac 600-lecia 6 |64-113 Osieczna;1937;992;992;50;942;51.21;5.04
108784;301303;Zespół Szkół|Kąkolewo|ul. Krzywińska 14 |64-113 Osieczna;2021;894;894;57;837;44.24;6.38
108785;301303;Świetlica wiejska|Grodzisko| 1E |64-113 Osieczna;923;344;344;46;298;37.27;13.37
108786;301303;Schronisko Młodzieżowe|Osieczna|ul. Kopernika 4 |64-113 Osieczna;751;333;333;35;298;44.34;10.51
108787;301303;Zespół Przedszkole i Szkoła Podstawowa|Świerczyna| 43A |64-113 Osieczna;1477;524;524;22;502;35.48;4.20
108788;301304;Świetlica wiejska|Nowa Wieś| 28a |64-130 Rydzyna;324;150;150;13;137;46.30;8.67
108789;301304;Świetlica wiejska|Dąbcze| 31 |64-130 Rydzyna;1128;538;538;16;522;47.70;2.97
108790;301304;Hala sportowa Rydzyna|Rydzyna|ul.Jana Kazimierza 1 |64-130 Rydzyna;1384;800;800;22;778;57.80;2.75
108791;301304;Rydzyński Ośrodek Kultury Rydzyna|Rydzyna|ul.Rynek 7 |64-130 Rydzyna;895;487;487;30;457;54.41;6.16
108792;301304;Szkoła Podstawowa w Kaczkowie z siedzibą w Rojęczynie|Rojęczyn| 17 |64-130 Rydzyna;725;262;262;33;229;36.14;12.60
108793;301304;Przedszkole|Jabłonna| 36a |64-130 Rydzyna;296;92;92;22;70;31.08;23.91
108794;301304;Świetlica wiejska|Tarnowa Łąka| 75 |64-130 Rydzyna;262;84;84;7;77;32.06;8.33
108795;301304;Świetlica wiejska|Przybiń| 4 |64-130 Rydzyna;499;195;195;9;186;39.08;4.62
108796;301304;Świetlica wiejska|Kłoda| 52a |64-130 Rydzyna;921;403;403;12;391;43.76;2.98
108797;301304;Świetlica wiejska|Moraczewo| 59 |64-130 Rydzyna;437;211;211;11;200;48.28;5.21
108798;301304;NZOZ Zakład Pielęgnacyjno-Opiekuńczy "Niezapominajka"|Dąbcze| 25 |64-130 Rydzyna;39;15;15;1;14;38.46;6.67
108799;301305;Zespół Szkół|Święciechowa|ul. Szkolna 15 |64-115 Święciechowa;2209;1166;1166;55;1111;52.78;4.72
108800;301305;Samorządowy Ośrodek Kultury|Święciechowa|Śmigielska 1a |64-115 Święciechowa;1692;604;604;27;577;35.70;4.47
108801;301305;Zespół Szkół|Lasocice|ul. Szkolna 13 |64-100 Leszno;1050;460;460;15;445;43.81;3.26
108802;301305;Zespół Szkół|Długie Stare|ul. Leszczyńska 1 |64-100 Leszno;1036;424;424;17;407;40.93;4.01
108803;301306;Zespół Szkół im. Powstańców Wielkopolskich|Brenno|ul. Kościelna 1 |64-150 WIJEWO;1323;533;533;27;506;40.29;5.07
108804;301306;Szkoła Podstawowa|Wijewo|ul. Powstańców Wielkopolskich 12 |64-150 WIJEWO;1543;663;663;39;624;42.97;5.88
108805;301307;Sala masońska|Włoszakowice|ul. Kurpińskiego 29 |64-140 Włoszakowice;1455;734;734;36;698;50.45;4.90
108806;301307;Zespół Szkół|Dłużyna| 42 |64-140 Włoszakowice;1393;542;542;29;513;38.91;5.35
108807;301307;Zespół Szkół|Jezierzyce Kościelne| 90a |64-117 Krzycko Małe;681;258;258;11;247;37.89;4.26
108808;301307;Zespół Szkół|Bukówiec Górny|ul.Powstańców Wlkp. 114 |64-140 Włoszakowice;1247;615;615;34;581;49.32;5.53
108809;301307;Zespół Szkół|Krzycko Wielkie|ul.Szkolna 6 |64-117 Krzycko Małe;1206;524;524;20;504;43.45;3.82
108810;301307;Sala widowiskowa|Włoszakowice|ul. Kurpińskiego 29 |64-140 Włoszakowice;1189;631;631;16;615;53.07;2.54
108811;301401;Sala widowiskowa przy Gminnej Bibliotece Publicznej w Chrzypsku Wielkim|Chrzypsko Wielkie|ul. Główna 22 |64-412 Chrzypsko Wielkie;1323;592;592;27;565;44.75;4.56
108812;301401;Środowiskowy Dom Samopomocy w Chrzypsku Wielkim|Chrzypsko Wielkie|ul. Główna 16 |64-412 Chrzypsko Wielkie;1227;402;402;24;378;32.76;5.97
108813;301401;Dom Pomocy Społecznej w Łężeczkach|Łężeczki| 40 |64-412 Chrzypsko Wielkie;106;76;76;17;59;71.70;22.37
108814;301402;Sala Sportowa przy Zespole Szkół w Kwilczu (wejście A)|Kwilcz|ul. Kardynała Stefana Wyszyńskiego 20 |64-420 Kwilcz;2001;920;920;49;871;45.98;5.33
108815;301402;Sala Sportowa przy Zespole Szkół w Kwilczu (wejście B)|Kwilcz|ul. Kardynała Stefana Wyszyńskiego 20 |64-420 Kwilcz;1287;508;508;36;472;39.47;7.09
108816;301402;Sala Sportowa przy Szkole Podstawowej w Luboszu|Lubosz|ul. Powstańców Wielkopolskich 1 |64-423 Lubosz;1650;616;616;42;574;37.33;6.82
108817;301403;Hala Widowiskowo-Sportowa|Międzychód|ul. Dworcowa 22 |64-400 Międzychód;1859;842;842;27;815;45.29;3.21
108818;301403;Szkoła Podstawowa Nr 2|Międzychód|ul. Gorzycka 1 |64-400 Międzychód;1911;926;926;35;891;48.46;3.78
108819;301403;Urząd Miasta i Gminy|Międzychód|ul. Marszałka Piłsudskiego 2 |64-400 Międzychód;1932;991;991;42;949;51.29;4.24
108820;301403;Szkoła Podstawowa Nr 1|Międzychód|ul. 17 Stycznia 92 |64-400 Międzychód;1753;730;730;30;700;41.64;4.11
108821;301403;Zespół Szkół Nr 2|Międzychód|ul. Bolesława Chrobrego 13 |64-400 Międzychód;842;428;428;17;411;50.83;3.97
108822;301403;Zespół Szkół Nr 1|Międzychód|ul. Gwardii Ludowej 6 |64-400 Międzychód;1022;486;486;12;474;47.55;2.47
108823;301403;Filia Biblioteki Publicznej w Międzychodzie|Bielsko|ul. Armii Poznań 22a |64-400 Międzychód;1963;873;873;48;825;44.47;5.50
108824;301403;Dom Kultury Kamionna|Kamionna|Poznańska 15 |64-421 Kamionna;994;400;400;8;392;40.24;2.00
108825;301403;Zespół Szkół|Łowyń|ul. Szkolna 1 |64-426 Łowyń;1137;487;487;20;467;42.83;4.11
108826;301403;Świetlica wiejska|Radgoszcz| 90 |64-400 Międzychód;1116;458;458;9;449;41.04;1.97
108827;301403;Świetlica DPS Piłka-Zamyślin|Zamyślin| 2A |64-400 ;53;28;28;6;22;52.83;21.43
108828;301403;Świetlica SP ZOZ w Międzychodzie|Międzychód|Szpitalna 10 |64-400 międzychód;42;21;21;0;21;50.00;0.00
108829;301404;Sierakowski Ośrodek Kultury|Sieraków|ul. Poznańska 25 |64-410 Sieraków;1898;821;821;26;795;43.26;3.17
108830;301404;Szkoła Podstawowa|Sieraków|ul. Poznańska 25 |64-410 Sieraków;1968;861;861;39;822;43.75;4.53
108831;301404;kompleks sportowy "Orlik" - sala gimnastyczna|Sieraków|ul. Wroniecka 25 |64-410 Sieraków;2192;907;907;62;845;41.38;6.84
108832;301404;Centrum Kultury Sportu i Turystyki|Lutom| 77 |64-410 Sieraków;912;397;397;16;381;43.53;4.03
108833;301501;Gminny Ośrodek Kultury|Kuślin|ul. Leśna 13 |64-316 Kuślin;1678;748;748;37;711;44.58;4.95
108834;301501;Szkoła Podstawowa|Michorzewo|ul. Szkolna 2 |64-316 Kuślin;1652;584;584;29;555;35.35;4.97
108835;301501;Gimnazjum Publiczne|Wąsowo|Szkolna 2 |64-316 Kuślin;946;432;432;32;400;45.67;7.41
108836;301502;Szkoła Podstawowa im. E. Sczanieckiej w Lwówku ul. Szkolna 4, 64-310 Lwówek|Lwówek|Szkolna 4 |64-310 Lwówek;965;472;472;23;449;48.91;4.87
108837;301502;Szkoła Podstawowa im. E. Sczanieckiej w Lwówku ul. Szkolna 4, 64-310 Lwówek|Lwówek|ul. Szkolna 4 |64-310 Lwówek;1400;737;737;18;719;52.64;2.44
108838;301502;Miejsko-Gminny Ośrodek Kultury w Lwówku Al. E. Sczanieckiej 56, 64-310 Lwówek|Lwówek|Al. E. Sczanieckiej 56 56 |64-310 Lwówek;1188;410;410;17;393;34.51;4.15
108839;301502;Szkoła Podstawowa im. Powstańców Wlkp. w Posadowie, Posadowo 30, 64-310 Lwówek|Posadowo| 30 |64-310 Lwówek;826;252;252;6;246;30.51;2.38
108840;301502;Szkoła Podstawowa w ZSiP im. Jana Pawła II w Brodach, Brody 1, 64-310 Lwówek|Brody| 1 |64-310 Lwówek;1604;608;608;32;576;37.91;5.26
108841;301502;Szkoła Podstawowa w ZSPiP im. K. Makuszyńskiego w Zębowie ul. Długa 1, Zębowo, 64-310 Lwówek|Zębowo|ul. Długa 1 |64-310 Lwówek;1153;391;391;19;372;33.91;4.86
108842;301503;Sala wiejska w Bolewicach|Bolewice|ul. Świebodzińska 8 |64-305 Bolewice;1821;876;876;24;852;48.11;2.74
108843;301503;Szkoła Podstawowa w Miedzichowie|Miedzichowo|ul. Szkolna 6 |64-361 Miedzichowo;1162;456;456;13;443;39.24;2.85
108844;301504;Szkoła Podstawowa Nr 2|Nowy Tomyśl|ul. 3 Stycznia 12 |64-300 Nowy Tomyśl;0;0;0;0;0;-99;-99
108845;301504;Nowotomyski Ośrodek Kultury|Nowy Tomyśl|ul. Tysiąclecia 3 |64-300 Nowy Tomyśl;1148;566;566;35;531;49.30;6.18
108846;301504;Szkoła Podstawowa Nr 1|Nowy Tomyśl|ul. Wierzbowa 1 |64-300 Nowy Tomyśl;1871;1081;1081;31;1050;57.78;2.87
108847;301504;Przedszkole Nr 5|Nowy Tomyśl|ul. Nowa 23 |64-300 Nowy Tomyśl;2024;1080;1080;31;1049;53.36;2.87
108848;301504;Przedszkole Nr 2|Nowy Tomyśl|Osiedle Stefana Batorego 19 |64-300 Nowy Tomyśl;1163;659;659;10;649;56.66;1.52
108849;301504;Żłobek|Nowy Tomyśl|Osiedle Stefana Batorego 18 |64-300 Nowy Tomyśl;1176;692;692;24;668;58.84;3.47
108850;301504;Przedszkole Nr 4|Nowy Tomyśl|Osiedle Północ 8 |64-300 Nowy Tomyśl;1656;953;953;25;928;57.55;2.62
108851;301504;Gimnazjum|Nowy Tomyśl|Osiedle Północ 25 |64-300 Nowy Tomyśl;917;473;473;12;461;51.58;2.54
108852;301504;Wiejski Dom Kultury|Boruja Kościelna|ul. Wolsztyńska 1 |64-300 Nowy Tomyśl;1655;682;682;21;661;41.21;3.08
108853;301504;Wiejski Dom Kultury|Bukowiec|ul. Sątopska 3 |64-300 Nowy Tomyśl;813;428;428;17;411;52.64;3.97
108854;301504;Przedszkole Nr 3|Nowy Tomyśl|ul. 3 Stycznia 70 |64-300 Nowy Tomyśl;1273;625;625;21;604;49.10;3.36
108855;301504;Strażnica OSP|Jastrzębsko Stare|ul. Nowotomyska 25 |64-300 Nowy Tomyśl;920;414;414;19;395;45.00;4.59
108856;301504;Świetlica Wiejska|Paproć|Paproć 165 |64-300 Nowy Tomyśl;874;406;406;8;398;46.45;1.97
108857;301504;Przedszkole|Stary Tomyśl|ul. Powstańców Wielkopolskich 25 |64-300 Nowy Tomyśl;1165;607;607;10;597;52.10;1.65
108858;301504;Szkoła Podstawowa|Wytomyśl|ul. Szkolna 18 |64-300 Nowy Tomyśl;798;328;328;9;319;41.10;2.74
108859;301504;Szkoła Podstawowa|Sątopy|ul. Szkolna 3 |64-300 Nowy Tomyśl;827;320;320;11;309;38.69;3.44
108860;301504;Samodzielny Publiczny Zakład Opieki Zdrowotnej SZPITAL|Nowy Tomyśl|Henryka Sienkiewicza 3 |64-300 Nowy Tomyśl;94;27;27;0;27;28.72;0.00
108861;301505;Szkoła Podstawowa im. A. i W.Niegolewskich|Opalenica|ul. Poznańska 37 |64-330 Opalenica;1671;930;930;43;887;55.66;4.62
108862;301505;Miejsko-Gminny Ośrodek Kultury|Opalenica|Osiedle Centrum 11 |64-330 Opalenica;1616;890;890;32;858;55.07;3.60
108863;301505;Miejsko-Gminny Ośrodek Kultury|Opalenica|Osiedle Centrum 11 |64-330 Opalenica;817;482;482;23;459;59.00;4.77
108864;301505;Zespół Szkół|Opalenica|ul. Gimnazjalna 1 |64-330 Opalenica;1777;1021;1021;33;988;57.46;3.23
108865;301505;Gimnazjum im. gen. K. Sosnkowskiego|Opalenica|ul. Farna 5 |64-330 Opalenica;1669;842;842;34;808;50.45;4.04
108866;301505;Zespół Szkolno - Przedszkolny, Szkoła Podstawowa im. B. Chrzanowskiego|Wojnowice|ul. Poznańska 5 |64-330 Opalenica;848;346;346;18;328;40.80;5.20
108867;301505;Szkoła Podstawowa|Dakowy Mokre|ul. Szkolna 8 |64-330 Opalenica;922;342;342;13;329;37.09;3.80
108868;301505;Wielkopolski Ośrodek Doradztwa Rolniczego|Sielinko|ul. Parkowa 2 |64-330 Opalenica;1597;694;694;37;657;43.46;5.33
108869;301505;Świetlica Wiejska|Jastrzębniki| 36 |64-330 Opalenica;800;339;339;23;316;42.38;6.78
108870;301505;Wiejski Dom Kultury|Rudniki| 84 |64-330 Opalenica;998;417;417;24;393;41.78;5.76
108871;301506;Gimnazjum w Zbąszyniu|Zbąszyń|ul. Mostowa 10 |64-360 Zbąszyń;1819;1069;1069;24;1045;58.77;2.25
108872;301506;Zespół Szkolno - Przedszkolny w Zbąszyniu|Zbąszyń|ul. Mostowa 10 |64-360 Zbąszyń;1247;493;493;10;483;39.53;2.03
108873;301506;Zespół Szkół Nr 1 im. S. Garczyńskiego w Zbąszyniu|Zbąszyń|ul. Powstańców Wielkopolskich 43 |64-360 Zbąszyń;815;476;476;5;471;58.40;1.05
108874;301506;Muzeum Ziemi Zbąszyńskiej i Regionu Kozła|Zbąszyń|ul. Rynek 8 |64-360 Zbąszyń;1480;840;840;48;792;56.76;5.71
108875;301506;Biblioteka Publiczna Gminy i Miasta Zbąszyń|Zbąszyń|ul. 17 Stycznia 59a |64-360 Zbąszyń;1408;771;771;23;748;54.76;2.98
108876;301506;Zespół Szkolno - Przedszkolny w Chrośnicy|Chrośnica| 54 |64-360 Zbąszyń;762;319;319;12;307;41.86;3.76
108877;301506;Szkoła Podstawowa im. Powstańców Wlkp. w Łomnicy|Łomnica| 40 |64-360 Zbąszyń;623;291;291;24;267;46.71;8.25
108878;301506;Sala Wiejska w Stefanowie|Stefanowo| 56 |64-360 Zbąszyń;446;191;191;11;180;42.83;5.76
108879;301506;Zespół Szkolno - Przedszkolny w Przyprostyni|Przyprostynia|ul. Prandoty 76 |64-360 Zbąszyń;717;381;381;13;368;53.14;3.41
108880;301506;Szkoła Podstawowa w Perzynach|Perzyny| 19 |64-360 Zbąszyń;711;279;279;7;272;39.24;2.51
108881;301506;Zespół Szkolno - Przedszkolny w Nądni|Nądnia|ul. Główna 56 |64-360 Zbąszyń;630;325;325;11;314;51.59;3.38
108882;301601;Obornicki Ośrodek Kultury|Oborniki|ul. Armii Poznań 18 |64-600 Oborniki;1275;748;748;14;734;58.67;1.87
108883;301601;PGKiM w Obornikach|Oborniki|ul. Lipowa 19 |64-600 Oborniki;1133;561;561;13;548;49.51;2.32
108884;301601;Szkoła Podstawowa Nr 2 w Obornikach|Oborniki|ul. Szkolna 7 |64-600 Oborniki;1193;451;451;21;430;37.80;4.66
108885;301601;Biblioteka Publiczna Miasta i Gminy Oborniki|Oborniki|ul. Mikołaja Kopernika 10 |64-600 Oborniki;1297;715;715;26;689;55.13;3.64
108886;301601;Przedszkole Nr 2 w Obornikach|Oborniki|ul. Młyńska 2b |64-600 Oborniki;1255;631;631;19;612;50.28;3.01
108887;301601;Przedszkole Nr 4 w Obornikach|Oborniki|ul. Stanisława Staszica 23 |64-600 Oborniki;1186;600;600;14;586;50.59;2.33
108888;301601;Szkoła Podstawowa Nr 3 w Obornikach|Oborniki|ul. Czarnkowska 57 |64-600 Oborniki;1241;662;662;13;649;53.34;1.96
108889;301601;Szkoła Podstawowa Nr 3 w Obornikach|Oborniki|ul.Czarnkowska 57 |64-600 Oborniki;1290;682;682;13;669;52.87;1.91
108890;301601;Przedszkole Nr 1 w Obornikach|Oborniki|ul.Droga Leśna 29 |64-600 Oborniki;1248;651;651;9;642;52.16;1.38
108891;301601;Przedszkole Nr 1 w Obornikach|Oborniki|Droga Leśna 29 |64-600 Oborniki;1344;739;739;20;719;54.99;2.71
108892;301601;Zespół Szkół w Obornikach|Oborniki|Obrzycka 88 |64-600 Oborniki;1280;715;715;20;695;55.86;2.80
108893;301601;Zespół Szkół w Obornikach|Oborniki|ul. Obrzycka 88 |64-600 Oborniki;1322;669;669;18;651;50.61;2.69
108894;301601;Świetlica wiejska Uścikowo|Uścikowo| 10c |64-600 Oborniki;1235;584;584;10;574;47.29;1.71
108895;301601;Zespół Szkół w Kiszewie|Kiszewo| 51 |64-607 Kiszewo;1164;516;516;22;494;44.33;4.26
108896;301601;Świetlica wiejska w Popówku|Popówko| |64-606 Popówko;1081;384;384;7;377;35.52;1.82
108897;301601;Świetlica wiejska w Kowanówku|Kowanówko|ul. Tarninowa 23 |64-600 Oborniki;1163;647;647;23;624;55.63;3.55
108898;301601;Zespół Szkół w Rożnowie|Rożnowo|ul. Dworcowa 42 |64-600 Oborniki;1324;648;648;25;623;48.94;3.86
108899;301601;Świetlica wiejska w Łukowie|Łukowo| 38 |64-600 Oborniki;1137;389;389;8;381;34.21;2.06
108900;301601;Świetlica wiejska Bogdanowo|Bogdanowo| 29 |64-600 Oborniki;1229;685;685;23;662;55.74;3.36
108901;301601;Świetlica wiejska w Świerkówkach|Świerkówki| |64-605 Wargowo;1290;518;518;17;501;40.16;3.28
108902;301601;Szkoła Podstawowa w Objezierzu|Objezierze| 8 |64-600 Oborniki;1282;452;452;13;439;35.26;2.88
108903;301601;Szpital Rehabilitacyjno-Kardiologiczny w Kowanówku|Kowanówko|Sanatoryjna 34 |64-600 Oborniki;160;94;94;3;91;58.75;3.19
108904;301601;Samodzielny Publiczny Zakład Opieki Zdrowotnej w Obornikach|Oborniki|Szpitalna 2 |64-600 Oborniki;66;35;35;1;34;53.03;2.86
108905;301602;RODZINNY OGRÓD DZIAŁKOWY im.J.Słowackiego (świetlica - ul.Działkowa)|Rogoźno|ul. Działkowa 20 |64-610 Rogoźno;1433;712;712;32;680;49.69;4.49
108906;301602;GIMNAZJUM NR 1|Rogoźno|ul. Kościuszki 28 |64-610 Rogoźno;802;357;357;12;345;44.51;3.36
108907;301602;OŚRODEK KULTURY|Rogoźno|II Armii Wojska Polskiego 4 |64-610 Rogoźno;1024;599;599;15;584;58.50;2.50
108908;301602;SZKOŁA PODSTAWOWA NR 3|Rogoźno|ul. Seminarialna 16 |64-610 Rogoźno;1895;980;980;25;955;51.72;2.55
108909;301602;Sala gimnastyczna Zespół szkół|Rogoźno|ul. Kościuszki 41 |64-610 Rogoźno;852;395;395;6;389;46.36;1.52
108910;301602;SZKOŁA PODSTAWOWA NR 2|Rogoźno|ul. Wielka Poznańska 36 |64-610 Rogoźno;1975;930;930;49;881;47.09;5.27
108911;301602;DOM KATECHETYCZNY im. Św. JANA BOSKO|Rogoźno|ul. Kościelna 10 |64-610 Rogoźno;1352;506;506;38;468;37.43;7.51
108912;301602;SZKOŁA PODSTAWOWA|Pruśce| 30 |64-610 Rogoźno;638;242;242;13;229;37.93;5.37
108913;301602;ŚWIETLICA WIEJSKA|Studzieniec| 25 |64-608 Rogoźno;980;346;346;22;324;35.31;6.36
108914;301602;ZESPÓŁ SZKÓŁ|Parkowo| 6 |64-608 Parkowo;1111;479;479;16;463;43.11;3.34
108915;301602;ŚWIETLICA WIEJSKA|Grudna| 25 |64-610 Rogoźno;551;239;239;11;228;43.38;4.60
108916;301602;ZESPÓŁ SZKÓŁ|Tarnowo| 21 |64-610 Rogoźno;297;115;115;6;109;38.72;5.22
108917;301602;ZESPÓŁ SZKÓŁ|Gościejewo| 14 |64-610 Rogoźno;795;277;277;19;258;34.84;6.86
108918;301603;Gminny Ośrodek Kultury|Ryczywół|ul. Nowa 1 |64-630 Ryczywół;1930;957;957;30;927;49.59;3.13
108919;301603;Przedszkole Publiczne|Ryczywół|Os. Przyjaźni 5 |64-630 Ryczywół;1069;360;360;26;334;33.68;7.22
108920;301603;Zespół Szkół|Ludomy| |64-603 Ludomy;837;320;320;19;301;38.23;5.94
108921;301603;Świetlica wiejska|Radom| |64-630 Ryczywół;264;76;76;2;74;28.79;2.63
108922;301603;Świetlica wiejska|Gorzewo| |64-630 Ryczywół;516;178;178;10;168;34.50;5.62
108923;301603;Świetlica wiejska|Lipa| |64-603 Ludomy;724;214;214;13;201;29.56;6.07
108924;301603;Warsztaty Terapii Zajęciowej|Wiardunki| |64-630 Ryczywół;317;161;161;7;154;50.79;4.35
108925;301701;Świetlica Powiatowej Stacji Sanitarno-Epidemiologicznej|Ostrów Wielkopolski|Plac Stefana Rowińskiego 3 |63-400 Ostrów Wielkopolski;1403;656;656;18;638;46.76;2.74
108926;301701;II Liceum Ogólnokształcące|Ostrów Wielkopolski|ul. Wrocławska 48 |63-400 Ostrów Wielkopolski;1045;379;379;10;369;36.27;2.64
108927;301701;Szkoła Podstawowa Nr 4|Ostrów Wielkopolski|ul. Królowej Jadwigi 3 |63-400 Ostrów Wielkopolski;1387;806;806;23;783;58.11;2.85
108928;301701;Szkoła Podstawowa Nr 1|Ostrów Wielkopolski|ul. Partyzancka 15 |63-400 Ostrów Wielkopolski;1093;452;452;21;431;41.35;4.65
108929;301701;Powiatowy Urząd Pracy|Ostrów Wielkopolski|ul. Wolności 29A |63-400 Ostrów Wielkopolski;1306;577;577;13;564;44.18;2.25
108930;301701;Zespół Szkół Ogólnokształcących|Ostrów Wielkopolski|ul. Wojska Polskiego 17 |63-400 Ostrów Wielkopolski;1271;525;525;21;504;41.31;4.00
108931;301701;Zespół Szkół Sióstr Salezjanek|Ostrów Wielkopolski|Aleja Słowackiego 33a |63-400 Ostrów Wielkopolski;1454;836;836;13;823;57.50;1.56
108932;301701;Niepubliczne Przedszkole "NASZ DOMEK"|Ostrów Wielkopolski|ul. Melchiora Wańkowicza 42 |63-400 Ostrów Wielkopolski;980;454;454;15;439;46.33;3.30
108933;301701;Zespół Szkół Muzycznych im. Krzysztofa Komedy-Trzcińskiego|Ostrów Wielkopolski|Aleja Słowackiego 1C |63-400 Ostrów Wielkopolski;977;543;543;12;531;55.58;2.21
108934;301701;Gimnazjum Nr 3|Ostrów Wielkopolski|ul. Tuwima 12 |63-400 Ostrów Wielkopolski;1543;857;857;11;846;55.54;1.28
108935;301701;Przedszkole Nr 10|Ostrów Wielkopolski|ul. Andrzeja Frycza Modrzewskiego 4 |63-400 Ostrów Wielkopolski;1348;746;746;23;723;55.34;3.08
108936;301701;Ostrowski Zakład Ciepłowniczy S.A.|Ostrów Wielkopolski|ul. Grunwaldzka 74 |63-400 Ostrów Wielkopolski;1183;673;673;21;652;56.89;3.12
108937;301701;Szkoła Podstawowa Nr 5|Ostrów Wielkopolski|ul. Grabowska 1-3 |63-400 Ostrów Wielkopolski;1974;1177;1177;32;1145;59.63;2.72
108938;301701;Przedszkole Nr 1|Ostrów Wielkopolski|ul. profesora Kaliny 2 |63-400 Ostrów Wielkopolski;1696;875;875;14;861;51.59;1.60
108939;301701;Przedszkole Nr 3|Ostrów Wielkopolski|ul. dr Tadeusza Jankowskiego 10A |63-400 Ostrów Wielkopolski;1657;964;964;19;945;58.18;1.97
108940;301701;Urząd Dozoru Technicznego Oddział w Ostrowie Wielkopolskim|Ostrów Wielkopolski|ul. Matejki 31 |63-400 Ostrów Wielkopolski;1273;722;722;23;699;56.72;3.19
108941;301701;Przedszkole Nr 9|Ostrów Wielkopolski|ul. Jana Brzechwy 2 |63-400 Ostrów Wielkopolski;1541;823;823;23;800;53.41;2.79
108942;301701;Publiczne Gimnazjum im. Papieża Jana Pawła II|Ostrów Wielkopolski|ul. Ludwika Waryńskiego 29 |63-400 Ostrów Wielkopolski;1330;646;646;8;638;48.57;1.24
108943;301701;Szkoła Podstawowa Nr 9|Ostrów Wielkopolski|ul. Asnyka 26 |63-400 Ostrów Wielkopolski;1523;810;810;18;792;53.18;2.22
108944;301701;NZOZ ESKULAP S.C. Przychodnia|Ostrów Wielkopolski|ul. Jana Mertki 13 |63-400 Ostrów Wielkopolski;1516;830;830;20;810;54.75;2.41
108945;301701;Ostrowski Zakład Ciepłowniczy S.A.|Ostrów Wielkopolski|ul. Wysocka 57 |63-400 Ostrów Wielkopolski;894;492;492;21;471;55.03;4.27
108946;301701;Przedszkole Nr 15|Ostrów Wielkopolski|ul. Szkolna 26 |63-400 Ostrów Wielkopolski;1009;500;500;12;488;49.55;2.40
108947;301701;Szkoła Podstawowa Nr 13|Ostrów Wielkopolski|ul. Świetlicowa 9 |63-400 Ostrów Wielkopolski;1262;734;734;31;703;58.16;4.22
108948;301701;Szkoła Podstawowa Nr 13|Ostrów Wielkopolski|ul. Świetlicowa 9 |63-400 Ostrów Wielkopolski;1371;743;743;9;734;54.19;1.21
108949;301701;CAR-LIFT SERVICE Sp. z o.o.|Ostrów Wielkopolski|ul. Kamienna 10a |63-400 Ostrów Wielkopolski;2003;1024;1024;22;1002;51.12;2.15
108950;301701;Szkoła Podstawowa Nr 6|Ostrów Wielkopolski|ul. Staroprzygodzka 112 |63-400 Ostrów Wielkopolski;1948;995;995;23;972;51.08;2.31
108951;301701;Przedszkole Nr 2|Ostrów Wielkopolski|ul. Staroprzygodzka 112a |63-400 Ostrów Wielkopolski;1916;1102;1102;17;1085;57.52;1.54
108952;301701;Warsztat Terapii Zajęciowej|Ostrów Wielkopolski|ul. Odolanowska 19 |63-400 Ostrów Wielkopolski;2343;1290;1290;11;1279;55.06;0.85
108953;301701;Szkoła Podstawowa nr 7 (stołówka-wejście od strony boiska)|Ostrów Wielkopolski|ul. Bema 30 |63-400 Ostrów Wielkopolski;1530;828;828;20;808;54.12;2.42
108954;301701;Urząd Skarbowy|Ostrów Wielkopolski|ul. Chłapowskiego 45 |63-400 Ostrów Wielkopolski;995;571;571;15;556;57.39;2.63
108955;301701;Przedszkole Nr 13|Ostrów Wielkopolski|ul. Bema 30 |63-400 Ostrów Wielkopolski;1502;852;852;14;838;56.72;1.64
108956;301701;Hala Sportowa przy Szkole Podstawowej Nr 7|Ostrów Wielkopolski|ul. Bema 30 |63-400 Ostrów Wielkopolski;1240;713;713;19;694;57.50;2.66
108957;301701;Gimnazjum Nr 4|Ostrów Wielkopolski|ul. Krotoszyńska 171 |63-400 Ostrów Wielkopolski;1789;854;854;21;833;47.74;2.46
108958;301701;Przedszkole Nr 14|Ostrów Wielkopolski|ul. Piotra Bardowskiego 6 |63-400 Ostrów Wielkopolski;1567;881;881;21;860;56.22;2.38
108959;301701;Szkoła Podstawowa Nr 11|Ostrów Wielkopolski|ul. Batorego 2 |63-400 Ostrów Wielkopolski;1487;842;842;24;818;56.62;2.85
108960;301701;Przedszkole Nr 12|Ostrów Wielkopolski|ul. gen. Władysława Andersa 15 |63-400 Ostrów Wielkopolski;1631;902;902;19;883;55.30;2.11
108961;301701;Gimnazjum nr 1|Ostrów Wielkopolski|ul. Wrocławska 51 |63-400 Ostrów Wielkopolski;2126;1095;1095;32;1063;51.51;2.92
108962;301701;Zespół Szkół Transportowo-Elektrycznych|Ostrów Wielkopolski|ul. Kantaka 6 |63-400 Ostrów Wielkopolski;2109;1188;1188;22;1166;56.33;1.85
108963;301701;Przedszkole Nr 7|Ostrów Wielkopolski|ul. Piastowska 21 |63-400 Ostrów Wielkopolski;2272;1131;1131;20;1111;49.78;1.77
108964;301701;Zespół Zakładów Opieki Zdrowotnej|Ostrów Wielkopolski|ul. Bolesława Limanowskiego 20/22 |63-400 Ostrów Wielkopolski;136;49;49;1;48;36.03;2.04
108965;301701;Areszt Śledczy|Ostrów Wielkopolski|ul. kardynała M. Ledóchowskiego 1 |63-400 Ostrów Wielkopolski;290;145;145;22;123;50.00;15.17
108966;301701;Dom Pomocy Społecznej|Ostrów Wielkopolski|ul. Partyzancka 8 |63-400 Ostrów Wielkopolski;39;23;23;8;15;58.97;34.78
108967;301702;Gimnazjum|Nowe Skalmierzyce|ul. Kaliska 52 |63-460 Nowe Skalmierzyce;2156;1021;1021;44;977;47.36;4.31
108968;301702;Szkoła Podstawowa|Nowe Skalmierzyce|ul. Okólna 8 |63-460 Nowe Skalmierzyce;1768;802;802;30;772;45.36;3.74
108969;301702;Szkoła Podstawowa|Skalmierzyce|ul. Ostrowska 16 |63-460 Nowe Skalmierzyce;1729;913;913;37;876;52.81;4.05
108970;301702;Szkoła Podstawowa|Skalmierzyce|ul. Ostrowska 16 |63-460 Nowe Skalmierzyce;1366;528;528;40;488;38.65;7.58
108971;301702;Szkoła Podstawowa|Biskupice Ołoboczne|ul. Szkolna 7 |63-460 Nowe Skalmierzyce;960;393;393;12;381;40.94;3.05
108972;301702;Zespół Szkół w Ociążu|Fabianów|ul. Szkolna 56 |63-460 Nowe Skalmierzyce;1048;432;432;12;420;41.22;2.78
108973;301702;Szkoła Podstawowa|Kotowiecko|ul. Kaliska 4 |63-460 Nowe Skalmierzyce;532;173;173;13;160;32.52;7.51
108974;301702;Szkoła Podstawowa|Droszew| 21 |63-460 Nowe Skalmierzyce;1161;549;549;28;521;47.29;5.10
108975;301702;Szkoła Podstawowa|Gostyczyna| 48 |63-460 Nowe Skalmierzyce;1481;615;615;18;597;41.53;2.93
108976;301703;Dom Kultury|Odolanów|ul. Bartosza 7 |63-430 Odolanów;941;498;498;14;484;52.92;2.81
108977;301703;Przedszkole im. Kubusia Puchatka|Odolanów|Pl. Kościuszki 4 |63-430 Odolanów;515;277;277;14;263;53.79;5.05
108978;301703;Świetlica Osiedlowa|Odolanów|ul. Kaliska 58a |63-430 Odolanów;565;301;301;14;287;53.27;4.65
108979;301703;Liceum Ogólnokształcące|Odolanów|ul. Krotoszyńska 121 |63-430 Odolanów;784;462;462;16;446;58.93;3.46
108980;301703;Gminno-Miejskie Centrum Pomocy "Wiara-Nadzieja-Miłość"|Odolanów|ul. Raszkowska 36 |63-430 Odolanów;758;398;398;16;382;52.51;4.02
108981;301703;Gimnazjum im. Jana Pawła II|Odolanów|Al. Jana Pawła II 1 |63-430 Odolanów;540;293;293;13;280;54.26;4.44
108982;301703;Szkoła Podstawowa|Huta| 63A |63-430 Odolanów;612;287;287;13;274;46.90;4.53
108983;301703;Gimnazjum w Świecy|Świeca|ul. Szkolna 5 |63-430 Odolanów;769;352;352;11;341;45.77;3.12
108984;301703;Szkoła Podstawowa|Garki| 4 |63-430 Odolanów;1090;423;423;35;388;38.81;8.27
108985;301703;Szkoła Podstawowa|Tarchały Wielkie|ul. Szkolna 69 |63-430 Odolanów;1064;536;536;18;518;50.38;3.36
108986;301703;Gimnazjum w Raczycach|Raczyce|ul. Odolanowska 80 |63-430 Odolanów;1022;456;456;36;420;44.62;7.89
108987;301703;Szkoła Podstawowa|Uciechów|ul. Odolanowska 38 |63-430 Odolanów;820;282;282;7;275;34.39;2.48
108988;301703;Szkoła Filialna|Gorzyce Małe| 43 |63-430 Odolanów;431;211;211;16;195;48.96;7.58
108989;301703;Szkoła Podstawowa|Nabyszyce| 12 |63-430 Odolanów;518;250;250;22;228;48.26;8.80
108990;301703;Szkoła Filialna w Gliśnicy|Gliśnica|ul. Odolanowska 25 |63-430 Odolanów;413;210;210;12;198;50.85;5.71
108991;301703;Gimnazjum w Wierzbnie|Wierzbno|ul. Szkolna 4 |63-430 Odolanów;636;315;315;18;297;49.53;5.71
108992;301704;Szkoła Podstawowa w Daniszynie|Daniszyn| 37 |63-410 Ostrów Wielkopolski;1101;439;439;15;424;39.87;3.42
108993;301704;Zespół Szkół w Lamkach|Lamki| 131 |63-400 Ostrów Wielkopolski;1442;708;708;20;688;49.10;2.82
108994;301704;Zespół Szkół w Gorzycach Wielkich|Gorzyce Wielkie|ul. Szkolna 31a |63-410 Ostrów Wielkopolski;2023;1003;1003;21;982;49.58;2.09
108995;301704;Zespół Szkolno-Przedszkolny w Topoli Małej|Topola Mała|ul. Szkolna 115 |63-400 Ostrów Wielkopolski;910;474;474;9;465;52.09;1.90
108996;301704;Zespół Szkolno-Przedszkolny w Wysocku Wielkim|Wysocko Wielkie|ul. Sadowska 2 |63-400 Ostrów Wielkopolski;1094;568;568;28;540;51.92;4.93
108997;301704;Zespół Szkolno-Przedszkolny we Wtórku|Wtórek|ul. Szkolna 12 |63-400 Ostrów Wielkopolski;1356;685;685;31;654;50.52;4.53
108998;301704;Szkoła Podstawowa w Franklinowie|Franklinów| 43a |63-400 Ostrów Wielkopolski;593;259;259;8;251;43.68;3.09
108999;301704;Zespół Szkół w Lewkowie|Lewków|ul. Szkolna 6 |63-410 Ostrów Wielkopolski;1143;561;561;24;537;49.08;4.28
109000;301704;Szkoła Podstawowa w Szczurach|Szczury| 38 |63-450 Ostrów Wielkopolski;884;386;386;9;377;43.67;2.33
109001;301704;Przedszkole Publiczne w Biniewie|Biniew| 25 |63-450 Ostrów Wielkopolski;767;303;303;15;288;39.50;4.95
109002;301704;Zespół Szkół w Sobótce|Sobótka| 72 |63-450 Ostrów Wielkopolski;1256;497;497;42;455;39.57;8.45
109003;301704;Przedszkole Publiczne w Czekanowie|Czekanów|ul. Szkolna 6 |63-410 Ostrów Wielkopolski;1657;882;882;24;858;53.23;2.72
109004;301704;Szkoła Podstawowa w Łąkocinach|Łąkociny|ul. Szkolna 14 |63-410 Ostrów Wielkopolski;693;333;333;12;321;48.05;3.60
109005;301705;Zespół Szkół|Chynowa| 70A |63-421 Przygodzice;1412;547;547;28;519;38.74;5.12
109006;301705;Zespół Szkół|Czarnylas| 150 |63-421 Przygodzice;853;371;371;23;348;43.49;6.20
109007;301705;Dom Ludowy|Dębnica|ul. Ostrowska 9 |63-421 Przygodzice;1050;404;404;21;383;38.48;5.20
109008;301705;Zespół Szkół|Janków Przygodzki|ul. Szkolna 4 |63-421 Przygodzice;1767;1052;1052;36;1016;59.54;3.42
109009;301705;Zespół Szkół w Przygodzicach Szkoła Podstawowa w Przygodzicach|Przygodzice|ul. Wysocka 2 |63-421 Przygodzice;1880;1036;1036;23;1013;55.11;2.22
109010;301705;Zespół Szkół|Wysocko Małe|ul. Kościelna 22 |63-421 Przygodzice;1259;654;654;22;632;51.95;3.36
109011;301705;Nadleśnictwo Antonin|Antonin|ul. Pałacowa 2 |63-421 Przygodzice;551;255;255;8;247;46.28;3.14
109012;301705;Dom Ludowy|Topola-Osiedle|ul. Dworcowa 34 |63-421 Przygodzice;727;414;414;14;400;56.95;3.38
109013;301706;Świetlica Wiejska|Grudzielec Nowy| 31 |63-440 Raszków;643;239;239;15;224;37.17;6.28
109014;301706;Szkoła Podstawowa|Janków Zaleśny| 77 |63-440 Raszków;569;242;242;9;233;42.53;3.72
109015;301706;Świetlica Wiejska|Ligota|ul. Krotoszyńska 2 |63-440 Raszków;1575;546;546;45;501;34.67;8.24
109016;301706;Miejsko-Gminny Ośrodek Kultury|Raszków|ul. Koźmińska 8 |63-440 Raszków;2078;1016;1016;35;981;48.89;3.44
109017;301706;Świetlica Wiejska|Moszczanka| 68 |63-440 Raszków;1267;594;594;17;577;46.88;2.86
109018;301706;Sala Miejsko-Gminnego Ośrodka Pomocy Społecznej|Przybysławice| 42 |63-440 Raszków;1169;575;575;27;548;49.19;4.70
109019;301706;Szkoła Podstawowa|Radłów|ul. Wiejska 52 |63-440 Raszków;1919;996;996;35;961;51.90;3.51
109020;301707;Szkoła Podstawowa|Zamość| 14 |63-520 Grabów nad Prosną;492;202;202;9;193;41.06;4.46
109021;301707;Szkoła Podstawowa|Ołobok|ul. Kościelna 16 |63-405 Sieroszewice;585;224;224;8;216;38.29;3.57
109022;301707;Szkoła Podstawowa|Westrza| 4 |63-405 Sieroszewice;852;379;379;25;354;44.48;6.60
109023;301707;Zespół Szkół|Sieroszewice|ul. Szkolna 9 |63-405 Sieroszewice;1605;741;741;29;712;46.17;3.91
109024;301707;Szkoła Podstawowa|Strzyżew|ul. Anny Wiesiołowskiej 1 |63-405 Sieroszewice;835;265;265;11;254;31.74;4.15
109025;301707;Zespół Szkół|Wielowieś|ul. Grabowska 2 |63-405 Sieroszewice;1661;669;669;28;641;40.28;4.19
109026;301707;Szkoła Podstawowa|Rososzyca|ul. Kaliska 3 |63-405 Sieroszewice;1573;583;583;35;548;37.06;6.00
109027;301707;Dom Pomocy Społecznej|Psary|ul. Kaliska 3 |63-405 Sieroszewice;91;19;19;3;16;20.88;15.79
109028;301708;Zespół Szkół w Sośniach|Sośnie|ul. Wielkopolska 43 |63-435 Sośnie;2028;831;831;35;796;40.98;4.21
109029;301708;Szkoła Podstawowa|Bogdaj| 15 |63-435 Sośnie;496;200;200;13;187;40.32;6.50
109030;301708;Zespół Szkół w Cieszynie|Cieszyn|ul. Kościelna 17 |63-435 Sośnie;860;325;325;22;303;37.79;6.77
109031;301708;Zespół Szkół w Pawłowie|Pawłów| 3 |63-435 Sośnie;410;128;128;10;118;31.22;7.81
109032;301708;Zespół Szkół w Granowcu|Granowiec|ul. Odolanowska 19 |63-435 Sośnie;1034;500;500;23;477;48.36;4.60
109033;301708;Zespół Szkół w Pawłowie, Szkoła Podstawowa|Chojnik| 55 |63-435 Sośnie;406;140;140;6;134;34.48;4.29
109034;301801;Gimnazjum w Czajkowie|Czajków| 55/1 |63-524 Czajków;1305;528;528;28;500;40.46;5.30
109035;301801;Komunalny budynek po zlikwidowanej Szkole Filialnej w Mielcuchach|Mielcuchy| 61 |63-524 Czajków;765;310;310;12;298;40.52;3.87
109036;301802;Gminny Ośrodek Kultury w Doruchowie|Doruchów|ul. Sportowa 3 |63-505 Doruchów;1549;792;792;26;766;51.13;3.28
109037;301802;Szkoła Podstawowa w Doruchowie|Doruchów|ul. Kaliska 3 |63-505 Doruchów;730;287;287;18;269;39.32;6.27
109038;301802;Sala Domu Ludowego|Morawin| 8 |63-505 Doruchów;511;220;220;8;212;43.05;3.64
109039;301802;Sala Domu Ludowego|Godziętowy| 1a |63-505 Doruchów;829;313;313;15;298;37.76;4.79
109040;301802;Sala Domu Ludowego|Torzeniec| 54a |63-505 Doruchów;516;198;198;10;188;38.37;5.05
109041;301803;Gimnazjum|Grabów nad Prosną|ul.Przemysłowa 1a |63-520 Grabów nad Prosną;1579;875;875;16;859;55.41;1.83
109042;301803;Dom Pomocy Społecznej|Marszałki| 15 |63-520 Grabów nad Prosną;613;254;254;48;206;41.44;18.90
109043;301803;Szkoła Podstawowa|Bobrowniki| 25 |63-520 Grabów nad Prosną;507;218;218;4;214;43.00;1.83
109044;301803;Szkoła Podstawowa|Bukownica| 39 |63-520 Grabów nad Prosną;671;323;323;18;305;48.14;5.57
109045;301803;Ochotnicza Straż Pożarna|Dębicze| 35 |63-520 Grabów nad Prosną;303;111;111;3;108;36.63;2.70
109046;301803;Budynek komunalny|Giżyce| 40A |63-520 Grabów nad Prosną;315;123;123;5;118;39.05;4.07
109047;301803;Dom Strażaka|Chlewo| 21b |63-520 Grabów nad Prosną;296;134;134;9;125;45.27;6.72
109048;301803;Budynek komunalny|Skrzynki| 82 |63-520 Grabów nad Prosną;390;161;161;7;154;41.28;4.35
109049;301803;Szkoła Podstawowa|Grabów nad Prosną|ul.Szkolna 1 |63-520 Grabów nad Prosną;1572;631;631;24;607;40.14;3.80
109050;301804;budynek Szkoły Podstawowej|Kobyla Góra|Plac Wiosny Ludów 20 |63-507 Kobyla Góra;1462;795;795;27;768;54.38;3.40
109051;301804;budynek komunalny|Pisarzowice| 28 |63-507 Kobyla Góra;352;141;141;5;136;40.06;3.55
109052;301804;budynek komunalny|Mąkoszyce| 88 |63-507 Kobyla Góra;845;352;352;10;342;41.66;2.84
109053;301804;budynek komunalny|Rybin| 11 |63-507 Kobyla Góra;127;37;37;4;33;29.13;10.81
109054;301804;budynek komunalny|Kuźnica Myślniewska| 32 |63-507 Kobyla Góra;172;56;56;1;55;32.56;1.79
109055;301804;budynek komunalny|Myślniew| 43A |63-507 Kobyla Góra;254;140;140;1;139;55.12;0.71
109056;301804;budynek komunalny|Bierzów| 52 |63-507 Kobyla Góra;281;115;115;7;108;40.93;6.09
109057;301804;budynek komunalny|Ignaców| 29 |63-507 Kobyla Góra;292;98;98;7;91;33.56;7.14
109058;301804;budynek Szkoły Podstawowej|Parzynów| 6 |63-507 Kobyla Góra;462;193;193;8;185;41.77;4.15
109059;301804;budynek komunalny|Ligota| 3 |63-507 Kobyla Góra;268;111;111;6;105;41.42;5.41
109060;301804;budynek komunalny|Marcinki| 54 |63-507 Kobyla Góra;176;89;89;10;79;50.57;11.24
109061;301804;Dom Pomocy Społecznej w Kobylej Górze|Kobyla Góra|ul. Tomasza Sikorskiego 1 |63-507 Kobyla Góra;49;13;13;0;13;26.53;0.00
109062;301805;Ochotnicza Straż Pożarna|Renta| 18 |63-522 Kraszewice;458;171;171;7;164;37.34;4.09
109063;301805;Gimnazjum im. Polskich Olimpijczyków|Kraszewice|ul.Szkolna 1 |63-522 Kraszewice;1376;588;588;22;566;42.73;3.74
109064;301805;Szkoła Podstawowa im. Kardynała Karola Wojtyły|Kuźnica Grabowska| 106 |63-522 Kraszewice;1012;357;357;13;344;35.28;3.64
109065;301806;Publiczne Gimnazjum im. Jana Pawła II|Mikstat|ul. Grabowska 13 |63-510 Mikstat;1742;833;833;27;806;47.82;3.24
109066;301806;Świetlica Wiejska|Kotłów| 23 |63-510 Mikstat;480;135;135;9;126;28.12;6.67
109067;301806;Szkoła Podstawowa|Kaliszkowice Kaliskie| 38 |63-510 Mikstat;672;222;222;7;215;33.04;3.15
109068;301806;Wiejski Dom Kultury|Komorów| 44 |63-510 Mikstat;630;223;223;7;216;35.40;3.14
109069;301806;Szkoła Podstawowa|Kaliszkowice Ołobockie| 1 |63-510 Mikstat;618;210;210;9;201;33.98;4.29
109070;301806;Szkoła Podstawowa im. Ludwiki Wawrzyńskiej|Biskupice Zabaryczne| 48 |63-510 Mikstat;530;171;171;9;162;32.26;5.26
109071;301806;Wiejski Dom Kultury|Przedborów| 10 |63-510 Mikstat;290;135;135;8;127;46.55;5.93
109072;301807;Szkoła Podstawowa Nr 1|Ostrzeszów|ul. Łąkowa 1 |63-500 Ostrzeszów;1259;662;662;17;645;52.58;2.57
109073;301807;Zespół Szkół Nr 1|Ostrzeszów|ul. Gen. Władysława Sikorskiego 9 |63-500 Ostrzeszów;1845;877;877;34;843;47.53;3.88
109074;301807;I Liceum Ogólnokształcące|Ostrzeszów|ul. Zamkowa 21 |63-500 Ostrzeszów;1406;760;760;23;737;54.05;3.03
109075;301807;Sala sesyjna Starostwa Powiatowego|Ostrzeszów|ul. 21 Stycznia 2 |63-500 Ostrzeszów;1481;758;758;14;744;51.18;1.85
109076;301807;Gimnazjum Nr 2|Ostrzeszów|ul. Piastowska 3 |63-500 Ostrzeszów;1775;921;921;18;903;51.89;1.95
109077;301807;Przedszkole Publiczne Nr 6|Ostrzeszów|ul. Zielona 4 |63-500 Ostrzeszów;1734;911;911;25;886;52.54;2.74
109078;301807;Przedszkole Publiczne Nr 5|Ostrzeszów|ul. Łąkowa 5 |63-500 Ostrzeszów;2027;1057;1057;20;1037;52.15;1.89
109079;301807;Szkoła Podstawowa|Rojów|ul. Meszyny 1 |63-500 Ostrzeszów;760;278;278;7;271;36.58;2.52
109080;301807;Szkoła Podstawowa|Olszyna| 28 |63-500 Ostrzeszów;882;397;397;16;381;45.01;4.03
109081;301807;Sala OSP|Kochłowy| 46 |63-500 Ostrzeszów;317;133;133;3;130;41.96;2.26
109082;301807;Przedszkole Publiczne|Rogaszyce| 22 |63-500 Ostrzeszów;662;261;261;19;242;39.43;7.28
109083;301807;Szkoła Podstawowa|Rogaszyce| 106 |63-500 Ostrzeszów;840;372;372;16;356;44.29;4.30
109084;301807;Szkoła Podstawowa|Potaśnia| 4 |63-500 Ostrzeszów;719;324;324;6;318;45.06;1.85
109085;301807;Szkoła Podstawowa|Siedlików| 58d |63-500 Ostrzeszów;922;354;354;18;336;38.39;5.08
109086;301807;Szkoła Podstawowa|Niedźwiedź| 18 |63-500 Ostrzeszów;1099;470;470;26;444;42.77;5.53
109087;301807;Szkoła Podstawowa|Szklarka Przygodzicka| 53a |63-500 Ostrzeszów;1019;359;359;19;340;35.23;5.29
109088;301807;Szpital|Ostrzeszów|Aleja Wolności 4 |63-500 Ostrzeszów;49;17;17;3;14;34.69;17.65
109089;301807;Dom Pomocy Społecznej w Kochłowach|Kochłowy| 1 |63-500 Ostrzeszów;39;17;17;1;16;43.59;5.88
109090;301901;Szkoła Podstawowa Nr 5 im. Dzieci Polskich|Piła|Al. Niepodległości 18 |64-920 Piła;2184;978;978;32;946;44.78;3.27
109091;301901;Gimnazjum Nr 4 im. I.J. Paderewskiego|Piła|ul. Kujawska 18 |64-920 Piła;2157;1077;1077;24;1053;49.93;2.23
109092;301901;Wyższa Szkoła Biznesu|Piła|Sikorskiego 9 |64-920 Piła;2381;1194;1194;17;1177;50.15;1.42
109093;301901;I Liceum Ogólnokształcące im. Marii Skłodowskiej-Curie|Piła|ul. Wincentego Pola 11 |64-920 Piła;2109;1074;1074;21;1053;50.92;1.96
109094;301901;Regionalne Centrum Kultury - Fabryka Emocji|Piła|Pl. Staszica 1 |64-920 Piła;1259;614;614;11;603;48.77;1.79
109095;301901;Zespół Szkół Ponadgimnazjalnych im. Komisji Edukacji Narodowej|Piła|ul.Teatralna 1 |64-920 Piła;1115;495;495;11;484;44.39;2.22
109096;301901;Szkoła Podstawowa Nr 7 im. Adama Mickiewicza|Piła|Al. Wojska Polskiego 45 - Wejście A |64-920 Piła;1723;907;907;22;885;52.64;2.43
109097;301901;Publiczne Przedszkole Nr 13|Piła|ul. Kraszewskiego 2 |64-920 Piła;1723;863;863;20;843;50.09;2.32
109098;301901;Szkoła Podstawowa nr 7 im. Adama Mickiewicza|Piła|al.Wojska Polskiego 45 - Wejście B |64-920 Piła;1494;790;790;13;777;52.88;1.65
109099;301901;Publiczne Przedszkole nr 12|Piła|ul.Reja 11 |64-920 Piła;1939;1121;1121;21;1100;57.81;1.87
109100;301901;Zespół Szkół Nr 3 im. Lotników Polskich|Piła|ul. Żeromskiego 41 - Wejście A |64-920 Piła;1573;932;932;10;922;59.25;1.07
109101;301901;Zespół Szkół Nr 3 im. Lotników Polskich|Piła|ul. Żeromskiego 41 - Wejście B |64-920 Piła;1324;744;744;6;738;56.19;0.81
109102;301901;MOSiR - Mała Hala Treningowa|Piła|ul. Żeromskiego 90 |64-920 Piła;512;302;302;3;299;58.98;0.99
109103;301901;Publiczne Przedszkole Nr 18 im. Kubusia Puchatka|Piła|ul. Trentowskiego 3 |64-920 Piła;1088;616;616;8;608;56.62;1.30
109104;301901;Miejska Energetyka Cieplna sp. z o.o.|Piła|ul.Kaczorska 20 |64-920 Piła;2165;1008;1008;28;980;46.56;2.78
109105;301901;Szkoła Podstawowa Nr 4 im. Mikołaja Kopernika|Piła|ul. Grabowa 18 - Wejście A |64-920 Piła;1347;714;714;16;698;53.01;2.24
109106;301901;Szkoła Podstawowa Nr 4 im. Mikołaja Kopernika|Piła|ul. Grabowa 18 - Wejście B |64-920 Piła;1373;705;705;21;684;51.35;2.98
109107;301901;Zespół Szkół Muzycznych im. Fryderyka Chopina|Piła|ul. Walki Młodych 1 |64-920 Piła;1077;586;586;16;570;54.41;2.73
109108;301901;Publiczne Przedszkole Nr 7 im. Pszczółki Mai|Piła|ul. Wincentego Witosa 22A |64-920 Piła;1680;839;839;27;812;49.94;3.22
109109;301901;Gimnazjum Nr 5 im. Tadeusza Kościuszki|Piła|ul. Bydgoska 23 |64-920 Piła;1827;982;982;23;959;53.75;2.34
109110;301901;Szkoła Podstawowa Nr 2 im. Olimpijczyków Polskich|Piła|ul. Roosevelta 12 |64-920 Piła;1350;712;712;15;697;52.74;2.11
109111;301901;Publiczne Przedszkole Nr 16 im. Czerwonego Kapturka|Piła|Al. Powstańców Wlkp. 86A |64-920 Piła;2214;1133;1133;33;1100;51.17;2.91
109112;301901;Salezjańska Szkoła Podstawowa im. Jana Pawła II|Piła|ul. Andersa 34 |64-920 Piła;1167;618;618;15;603;52.96;2.43
109113;301901;Publiczne Przedszkole Nr 4|Piła|ul. Kusocińskiego 10A |64-920 Piła;1300;835;835;10;825;64.23;1.20
109114;301901;Specjalny Ośrodek Szkolno-Wychowawczy im. Marii Grzegorzewskiej|Piła|ul. Śniadeckich 27 |64-920 Piła;1133;684;684;23;661;60.37;3.36
109115;301901;Publiczne Przedszkole Nr 19 im. Misia Uszatka|Piła|ul. Królowej Jadwigi 20 |64-920 Piła;1100;701;701;11;690;63.73;1.57
109116;301901;Zespół Szkół Nr 2 im. Królowej Jadwigi|Piła|ul. Królowej Jadwigi 2 |64-920 Piła;2158;1241;1241;23;1218;57.51;1.85
109117;301901;Publiczne Przedszkole Nr 6 im. Jasia i Małgosi|Piła|ul. Żeleńskiego 15 |64-920 Piła;780;398;398;10;388;51.03;2.51
109118;301901;Liga Obrony Kraju Koło w Pile|Piła|Al. Niepodległości 154 |64-920 Piła;1142;616;616;14;602;53.94;2.27
109119;301901;Siedziba Rady i Zarządu Osiedla Koszyce|Piła|ul. Wenedów 8A-B |64-920 Piła;1069;688;688;5;683;64.36;0.73
109120;301901;Salka Parafialna przy Parafii Rzymskokatolickiej PW. Św. Rafała Kalinowskiego|Piła|ul. Rynek Koszycki 1 |64-920 Piła;1501;929;929;15;914;61.89;1.61
109121;301901;Publiczne Przedszkole Nr 14 im. Wróbelka Elemelka|Piła|ul. Jana Brzechwy 10 |64-920 Piła;1219;686;686;9;677;56.28;1.31
109122;301901;Zespół Szkół Nr 1 im. Jana Brzechwy|Piła|ul. Brzozowa 4 |64-920 Piła;1379;751;751;7;744;54.46;0.93
109123;301901;Liceum Ogólnokształcące Towarzystwa Salezjańskiego im. Św Jana Bosko|Piła|ul. Dembowskiego 4 |64-920 Piła;1180;715;715;15;700;60.59;2.10
109124;301901;ENEA Operator Sp. z o.o. Rejon Dystrybucji Piła|Piła|Al. Poznańska 34 |64-920 Piła;1327;730;730;11;719;55.01;1.51
109125;301901;Siedziba Zarządu Osiedla Motylewo|Piła|ul. Sowia 2 |64-920 Piła;659;391;391;4;387;59.33;1.02
109126;301901;Szkoła Podstawowa Nr 12 z Oddz. Integracyjnymi|Piła|ul. Lelewela 140 - Wejście A |64-920 Piła;1328;786;786;15;771;59.19;1.91
109127;301901;Szkoła Podstawowa Nr 12 z Oddz. Integracyjnymi|Piła|ul. Lelewela 140 - Wejście B |64-920 Piła;1375;749;749;12;737;54.47;1.60
109128;301901;Pływalnia "Wodnik"|Piła|ul. Kossaka 102 |64-920 Piła;2012;1155;1155;18;1137;57.41;1.56
109129;301901;Dom Pomocy Społecznej im. Jana Pawła II|Piła|11 Listopada 40 |64-920 Piła;48;21;21;5;16;43.75;23.81
109130;301901;Szpital Specjalistyczny w Pile im. Stanisława Staszica|Piła|Rydygiera 1 |64-920 Piła;298;131;131;4;127;43.96;3.05
109131;301902;Remiza Ochotniczej Straży Pożarnej|Białośliwie|ul. 4 Stycznia 65 |89-340 Białośliwie;1206;554;554;25;529;45.94;4.51
109132;301902;Gminny Ośrodek Kultury|Białośliwie|ul. Podgórna 47 |89-340 Białośliwie;1228;532;532;20;512;43.32;3.76
109133;301902;Świetlica wiejska|Krostkowo| 16a |89-334 Krostkowo;448;228;228;9;219;50.89;3.95
109134;301902;Szkoła Podstawowa|Nieżychowo| 16 |89-340 Białośliwie;576;227;227;14;213;39.41;6.17
109135;301902;Regionalne Centrum Sadownictwa|Pobórka Wielka| 59 |89-340 Białośliwie;328;153;153;5;148;46.65;3.27
109136;301903;Wiejski Dom Kultury|Śmiłowo|ul. Osiedle Sportowe 1 |64-810 Kaczory;1438;660;660;31;629;45.90;4.70
109137;301903;Gminny Ośrodek Kultury|Kaczory|ul. Pilska 1a |64-810 Kaczory;2314;1268;1268;41;1227;54.80;3.23
109138;301903;Wiejski Dom Kultury|Dziembowo| 33 |64-810 Kaczory;1197;574;574;30;544;47.95;5.23
109139;301903;Wiejski Dom Kutury|Rzadkowo| 17 |64-810 Kaczory;699;325;325;17;308;46.49;5.23
109140;301903;Wiejski Dom Kultury|Morzewo| 152 |64-810 Kaczory;484;267;267;10;257;55.17;3.75
109141;301904;Gimnazjum Publiczne|Łobżenica|ul.Adama Mickiewicza 20a |89-310 Łobżenica;1547;634;634;47;587;40.98;7.41
109142;301904;Szkoła Podstawowa|Łobżenica|ul.Sikorskiego 3 |89-310 Łobżenica;1403;742;742;40;702;52.89;5.39
109143;301904;Szkoła Podstawowa|Wiktorówko| 65 |89-310 Łobżenica;980;443;443;25;418;45.20;5.64
109144;301904;Szkoła Podstawowa|Fanianowo| 29 |89-310 Łobżenica;1093;364;364;37;327;33.30;10.16
109145;301904;Szkoła Podstawowa|Dźwierszno Małe| 8 |89-310 Łobżenica;1410;510;510;36;474;36.17;7.06
109146;301904;Sala OSP|Luchowo| 75B |89-310 Łobżenica;1095;441;441;20;421;40.27;4.54
109147;301905;Gminny Dom Kultury|Miasteczko Krajeńskie|ul.Dąbrowskiego 39 |89-350 Miasteczko Krajeńskie;1006;480;480;18;462;47.71;3.75
109148;301905;Zespół Szkół Centrum Kształcenia Rolniczego im. Michała Drzymały w Brzostowie|Brzostowo| 69 |89-350 Miasteczko Krajeńskie;936;330;330;14;316;35.26;4.24
109149;301905;Świetlica wiejska w Grabównie|Grabówno| 77 |89-350 Miasteczko Krajeńskie;605;237;237;13;224;39.17;5.49
109150;301906;Zespół Szkół|Szydłowo| 47A |64-930 Szydłowo;1476;676;676;20;656;45.80;2.96
109151;301906;Świetlica wiejska|Leżenica| 7 |64-930 Szydłowo;812;306;306;15;291;37.68;4.90
109152;301906;Zespół Szkół|Stara Łubianka|ul. Polna 11 |64-932 Stara Łubianka;1395;575;575;29;546;41.22;5.04
109153;301906;Szkoła Podstawowa|Róża Wielka| 31 |64-930 Róża Wielka;400;159;159;9;150;39.75;5.66
109154;301906;Szkoła Podstawowa|Skrzatusz| 1A |64-930 Szydłowo;617;224;224;13;211;36.30;5.80
109155;301906;Świetlica wiejska|Dobrzyca| 35A |64-930 Szydłowo;589;275;275;9;266;46.69;3.27
109156;301906;Świetlica wiejska w Kotuniu|Kotuń| 28 |64-930 Szydłowo;1411;773;773;21;752;54.78;2.72
109157;301907;Ujski Dom Kultury w Ujściu|Ujście|Czarnkowska 32 |64-850 Ujście;1692;800;800;56;744;47.28;7.00
109158;301907;Urząd Miejski w Ujściu|Ujście|Plac Wiosny Ludów 2 |64-850 Ujście;1332;601;601;19;582;45.12;3.16
109159;301907;Szkoła Podstawowa w Nowej Wsi Ujskiej - budynek w Mirosławiu|Mirosław| 22 |64-850 Ujście;457;205;205;17;188;44.86;8.29
109160;301907;Świetlica wiejska w Jabłonowie|Jabłonowo| 50 |64-850 Ujście;414;136;136;10;126;32.85;7.35
109161;301907;Wiejski Dom Kultury w Kruszewie|Kruszewo|Parkowa 2 |64-850 Ujście;820;367;367;27;340;44.76;7.36
109162;301907;Szkoła Podstawowa w Nowej Wsi Ujskiej - budynek w Nowej Wsi Ujskiej|Nowa Wieś Ujska| 1 |64-850 Ujście;814;341;341;18;323;41.89;5.28
109163;301907;Przedszkole Publiczne w Ujściu|Ujście|Sienkiewicza 9 |64-850 Ujście;424;185;185;6;179;43.63;3.24
109164;301907;Świetlica środowiskowa w Ługach Ujskich|Ługi Ujskie| 69 |64-850 Ujście;460;196;196;13;183;42.61;6.63
109165;301908;Siedziba Straży Miejskiej|Wyrzysk|ul. Bydgoska 32 |89-300 Wyrzysk;1222;554;554;30;524;45.34;5.42
109166;301908;Miejsko-Gminny Ośrodek Kultury|Wyrzysk|ul. Kościuszki 15 |89-300 Wyrzysk;1291;571;571;30;541;44.23;5.25
109167;301908;Klub Miejski|Wyrzysk|ul. Młyńska 2 |89-300 Wyrzysk;1622;755;755;31;724;46.55;4.11
109168;301908;Gimnazjum|Osiek nad Notecią|ul. Główna 58 |89-333 Osiek nad Notecią;1642;680;680;36;644;41.41;5.29
109169;301908;Szkoła Podstawowa|Osiek nad Notecią|ul. Szkolna 2 |89-333 Osiek nad Notecią;1382;633;633;34;599;45.80;5.37
109170;301908;Szkoła Podstawowa|Falmierowo| 29 |89-311 Falmierowo;668;227;227;15;212;33.98;6.61
109171;301908;Świetlica Wiejska|Kościerzyn Wielki| |89-311 Falmierowo;732;275;275;16;259;37.57;5.82
109172;301908;Szkoła Podstawowa|Glesno| 9 |89-300 Wyrzysk;891;278;278;29;249;31.20;10.43
109173;301908;Szkoła Podstawowa|Kosztowo| 79 |89-300 Wyrzysk;743;321;321;13;308;43.20;4.05
109174;301908;Przedszkole Publiczne|Osiek nad Notecią|ul. Bohaterów 28 |89-333 Osiek nad Notecią;854;230;230;16;214;26.93;6.96
109175;301908;Szpital Powiatowy w Wyrzysku Spółka z o.o.|Wyrzysk|22 Stycznia 41 |89-300 Wyrzysk;52;15;15;1;14;28.85;6.67
109176;301909;Sala ślubów, Urząd Miasta i Gminy w Wysokiej|Wysoka|Plac Powstańców Wielkopolskich 20/21 |89-320 Wysoka;2141;992;992;41;951;46.33;4.13
109177;301909;Świetlica wiejska, Czajcze|Czajcze| 16a |89-320 Wysoka;1510;625;625;31;594;41.39;4.96
109178;301909;Świetlica wiejska, Rudna|Rudna| 1a |89-320 Wysoka;789;219;219;6;213;27.76;2.74
109179;301909;Świetlica socjoterapeutyczna, Wysoka|Wysoka|Plac Powstańców Wielkopolskich 20/21 |89-320 Wysoka;867;283;283;12;271;32.64;4.24
109180;302001;Zespół Szkół w Choczu|Chocz|ul. Konopnickiej 6 |63-313 Chocz;1145;491;491;22;469;42.88;4.48
109181;302001;Zespół Szkół w Choczu|Chocz|ul. Konopnickiej 6 |63-313 Chocz;1143;494;494;30;464;43.22;6.07
109182;302001;Szkoła Podstawowa w Kuźni|Kuźnia| 36 |63-313 Chocz;563;259;259;12;247;46.00;4.63
109183;302001;Szkoła Podstawowa w Kwileniu|Stara Kaźmierka| 1 |63-313 Chocz;967;330;330;21;309;34.13;6.36
109184;302002;Zespół Szkół Publicznych w Broniszewicach|Broniszewice| 44a |63-304 Czermin;876;455;455;26;429;51.94;5.71
109185;302002;Zespół Szkół Publicznych w Czerminie|Czermin| 2B |63-304 Czermin;1392;664;664;34;630;47.70;5.12
109186;302002;Zespół Szkół Publicznych w Żegocinie|Żegocin| 8 |63-304 Czermin;1535;692;692;30;662;45.08;4.34
109187;302003;Gminne Centrum Kultury (mała sala)|Dobrzyca|ul.Koźmińska 10 |63-330 Dobrzyca;1071;512;512;22;490;47.81;4.30
109188;302003;Szkoła Podstawowa|Galew| 38 |63-330 Dobrzyca;797;355;355;18;337;44.54;5.07
109189;302003;Szkoła Podstawowa|Koźminiec| 52 |63-330 Dobrzyca;636;232;232;10;222;36.48;4.31
109190;302003;"Klub Świetlika" - przy sali wiejskiej|Sośnica| 37 |63-330 Dobrzyca;609;205;205;7;198;33.66;3.41
109191;302003;Sala wiejska|Fabianów|ul.Przemysłowa 4a |63-330 Dobrzyca;722;353;353;29;324;48.89;8.22
109192;302003;Gminne Centrum Kultury (duża sala)|Dobrzyca|ul. Koźmińska 10 |63-330 Dobrzyca;1116;591;591;29;562;52.96;4.91
109193;302003;Budynek Przedszkola|Karmin| 24 |63-330 Dobrzyca;898;291;291;27;264;32.41;9.28
109194;302003;Sala wiejska|Dobrzyca|ul. Krotoszyńska 45 |63-330 Dobrzyca;554;248;248;11;237;44.77;4.44
109195;302003;Dom Pomocy Społecznej|Fabianów|ul. Pleszewska 2 |63-330 Dobrzyca;77;14;14;3;11;18.18;21.43
109196;302004;Zespół Szkół|Gizałki|ul. Kaliska 25 |63-308 Gizałki;1239;512;512;36;476;41.32;7.03
109197;302004;Szkoła Podstawowa|Tomice|ul. Wrzesińska 2 |63-308 Gizałki;988;394;394;21;373;39.88;5.33
109198;302004;Szkoła Podstawowa|Wierzchy| 23 |63-308 Gizałki;856;296;296;13;283;34.58;4.39
109199;302004;Zespół Szkół|Białobłoty| 20 |63-308 Gizałki;583;190;190;4;186;32.59;2.11
109200;302005;Urząd Gminy w Gołuchowie|Gołuchów|ul. Lipowa 1 |63-322 Gołuchów;2331;1212;1212;57;1155;51.99;4.70
109201;302005;Szkoła Podstawowa w Tursku|Tursko| 10 |63-322 Gołuchów;879;406;406;15;391;46.19;3.69
109202;302005;Szkoła Podstawowa w Jedlcu|Jedlec| 154 |63-322 Gołuchów;580;264;264;6;258;45.52;2.27
109203;302005;Szkoła Podstawowa w Kucharach|Kuchary| 99 |63-322 Gołuchów;649;302;302;5;297;46.53;1.66
109204;302005;Szkoła Podstawowa w Kościelnej Wsi|Kościelna Wieś|ul. Kaliska 2 |62-811 Kościelna Wieś;2038;992;992;24;968;48.68;2.42
109205;302005;Szkoła Podstawowa w Kucharkach|Kucharki| 39 |63-322 Gołuchów;1365;514;515;32;482;37.66;6.23
109206;302005;Dom Strażaka w Krzywosądowie|Krzywosądów| 43B |63-322 Gołuchów;456;174;174;16;158;38.16;9.20
109207;302006;Zespół Szkół Publicznych w Kowalewie|Kowalew|ul. Bolesława Chrobrego 36 |63-300 Pleszew;1326;606;606;19;587;45.70;3.14
109208;302006;Przedszkole w Dobrej Nadziei|Dobra Nadzieja| 38 |63-300 Pleszew;714;275;275;10;265;38.52;3.64
109209;302006;Przedszkole w Zielonej Łące|Zielona Łąka| 21 |63-300 Pleszew;599;264;264;8;256;44.07;3.03
109210;302006;Zespół Szkół Publicznych w Taczanowie Drugim|Taczanów Drugi| 32C |63-300 Pleszew;1100;422;422;13;409;38.36;3.08
109211;302006;Przedszkole w Grodzisku|Grodzisko| 77 |63-300 Pleszew;844;314;314;12;302;37.20;3.82
109212;302006;Świetlica Wiejska w Pacanowicach|Pacanowice| 19 |63-300 Pleszew;226;72;72;1;71;31.86;1.39
109213;302006;Publiczna Szkoła Podstawowa w Kuczkowie|Kuczków|ul. Parkowa 11 |63-300 Pleszew;808;259;259;15;244;32.05;5.79
109214;302006;Dom Kultury w Piekarzewie|Piekarzew| 22 |63-300 Pleszew;454;169;169;1;168;37.22;0.59
109215;302006;Świetlica Wiejska w Suchorzewie|Suchorzew|ul. Kowalewska 4 |63-300 Pleszew;478;201;201;9;192;42.05;4.48
109216;302006;Zespół Szkół Publicznych w Lenartowicach|Lenartowice| 59 |63-300 Pleszew;768;305;305;9;296;39.71;2.95
109217;302006;Zespół Szkół Przyrodniczo-Politechnicznych, Centrum Kształcenia Ustawicznego w Marszewie|Marszew| 22 |63-300 Pleszew;618;257;257;16;241;41.59;6.23
109218;302006;Wiejski Dom Kultury w Brzeziu|Brzezie|ul. Stawiszyńska 1 |63-300 Pleszew;533;234;234;18;216;43.90;7.69
109219;302006;Sala Wiejska w Zawidowicach|Zawidowice| 7A |63-300 Pleszew;288;127;127;5;122;44.10;3.94
109220;302006;Zespół Szkół Publicznych w Sowinie Błotnej|Sowina Błotna| 30 |63-300 Pleszew;963;326;326;15;311;33.85;4.60
109221;302006;Zespół Szkół Technicznych w Pleszewie|Pleszew|ul. Zielona 3 |63-300 Pleszew;1593;807;807;21;786;50.66;2.60
109222;302006;Publiczne Przedszkole Nr 3 "Słoneczne" w Pleszewie|Pleszew|Aleje Wojska Polskiego 1 |63-300 Pleszew;639;335;335;6;329;52.43;1.79
109223;302006;Publiczne Przedszkole Nr 3 "Słoneczne" w Pleszewie|Pleszew|Aleje Wojska Polskiego 1 |63-300 Pleszew;944;455;455;4;451;48.20;0.88
109224;302006;Zespół Szkół Publicznych Nr 2 w Pleszewie|Pleszew|ul. Ogrodowa 2 |63-300 Pleszew;669;305;305;21;284;45.59;6.89
109225;302006;Zespół Szkół Publicznych Nr 1 w Pleszewie|Pleszew|ul. Szkolna 5 |63-300 Pleszew;1048;482;482;15;467;45.99;3.11
109226;302006;Zespół Szkół Publicznych Nr 1 w Pleszewie|Pleszew|ul. Szkolna 5 |63-300 Pleszew;953;464;464;12;452;48.69;2.59
109227;302006;I Liceum Ogólnokształcące im. St. Staszica w Pleszewie|Pleszew|ul. Poznańska 38 |63-300 Pleszew;1410;655;655;8;647;46.45;1.22
109228;302006;I Liceum Ogólnokształcące im. St. Staszica w Pleszewie|Pleszew|ul. Poznańska 38 |63-300 Pleszew;1348;739;739;19;720;54.82;2.57
109229;302006;Zespół Szkół Publicznych Nr 3 w Pleszewie|Pleszew|ul. Bolesława Krzywoustego 6 |63-300 Pleszew;1132;552;552;4;548;48.76;0.72
109230;302006;Zespół Szkół Publicznych Nr 3 w Pleszewie|Pleszew|ul. Bolesława Krzywoustego 6 |63-300 Pleszew;1226;679;679;16;663;55.38;2.36
109231;302006;Zespół Szkół Publicznych Nr 3 w Pleszewie|Pleszew|ul. Bolesława Krzywoustego 6 |63-300 Pleszew;1242;643;643;24;619;51.77;3.73
109232;302006;Zespół Szkół Publicznych Nr 2 w Pleszewie|Pleszew|ul. Ogrodowa 2 |63-300 Pleszew;1555;816;816;20;796;52.48;2.45
109233;302006;Pleszewskie Centrum Medyczne Sp. z o. o. w Pleszewie|Pleszew|ul. Poznańska 125A |63-300 Pleszew;151;46;46;5;41;30.46;10.87
109234;302006;Dom Pomocy Społecznej w Pleszewie|Pleszew|Plac Wolności im. Jana Pawła II 5 |63-300 Pleszew;203;41;41;3;38;20.20;7.32
109235;302101;Gimnazjum nr 1|Luboń|ul. Armii Poznań 27 |62-030 Luboń;1080;573;573;13;560;53.06;2.27
109236;302101;Szkoła Podstawowa nr 3|Luboń|ul. Jana Henryka Dąbrowskiego 2A |62-030 Luboń;1220;730;730;9;721;59.84;1.23
109237;302101;Przedsiębiorstwo Usług Komunalnych Kom-Lub Spółka z o.o|Luboń|ul. Niepodległości 11 |62-030 Luboń;1123;652;652;12;640;58.06;1.84
109238;302101;Biblioteka Miejska|Luboń|ul. Żabikowska 42 |62-030 Luboń;1009;641;641;11;630;63.53;1.72
109239;302101;Biblioteka Miejska|Luboń|ul. Żabikowska 42 |62-030 Luboń;925;603;603;15;588;65.19;2.49
109240;302101;Szkoła Podstawowa nr 2|Luboń|ul. Żabikowska 40 |62-030 Luboń;1021;672;672;10;662;65.82;1.49
109241;302101;Szkoła Podstawowa nr 2|Luboń|ul. Żabikowska 40 |62-030 Luboń;1094;616;616;12;604;56.31;1.95
109242;302101;Spółdzielnia Mieszkaniowa|Luboń|ul. Żabikowska 62 |62-030 Luboń;1215;705;705;14;691;58.02;1.99
109243;302101;Miejski Ośrodek Pomocy Społecznej|Luboń|ul. Źródlana 1 |62-030 Luboń;1158;691;691;15;676;59.67;2.17
109244;302101;Miejski Ośrodek Pomocy Społecznej|Luboń|ul. Źródlana 1 |62-030 Luboń;989;584;584;6;578;59.05;1.03
109245;302101;Szkoła Podstawowa nr 1|Luboń|ul. Józefa Poniatowskiego 16 |62-030 Luboń;1150;679;679;15;664;59.04;2.21
109246;302101;Gimnazjum nr 2|Luboń|ul. Hugona Kołłątaja 1 |62-030 Luboń;1103;697;697;16;681;63.19;2.30
109247;302101;Szkoła Podstawowa nr 1|Luboń|ul. Józefa Poniatowskiego 16 |62-030 Luboń;1162;786;786;21;765;67.64;2.67
109248;302101;Szkoła Podstawowa nr 2|Luboń|Żabikowska 40 |62-030 Luboń;1247;758;758;24;734;60.79;3.17
109249;302101;Luboński Ośrodek Sportu i Rekreacji|Luboń|Hugona Kołłątaja 2 |62-030 Luboń;1192;723;723;14;709;60.65;1.94
109250;302101;Luboński Ośrodek Sportu i Rekreacji|Luboń|Hugona Kołłątaja 2 |62-030 Luboń;1084;731;731;13;718;67.44;1.78
109251;302101;Gimnazjum nr 2|Luboń|Hugona Kołłątaja 1 |62-030 Luboń;1185;752;752;12;740;63.46;1.60
109252;302101;Szkoła Podstawowa nr 4|Luboń|1 Maja 10 |62-030 Luboń;1184;642;642;19;623;54.22;2.96
109253;302101;Luvena SA|Luboń|Romana Maya 1 |62-030 Luboń;1026;493;493;17;476;48.05;3.45
109254;302101;Szkoła Podstawowa nr 4|Luboń|1 Maja 10 |62-030 Luboń;973;568;568;5;563;58.38;0.88
109255;302101;Ośrodek Kultury|Luboń|Jana III Sobieskiego 97 |62-030 Luboń;1147;683;683;19;664;59.55;2.78
109256;302102;Gimnazjum nr 1|Puszczykowo|ul. Wysoka 1 |62-040 Puszczykowo;1623;1017;1017;17;1000;62.66;1.67
109257;302102;Szkoła Podstawowa nr 1|Puszczykowo|ul. Wysoka 1 |62-040 Puszczykowo;1029;673;673;6;667;65.40;0.89
109258;302102;Szkoła Podstawowa nr 1|Puszczykowo|ul. Wysoka 1 |62-040 Puszczykowo;1041;694;694;7;687;66.67;1.01
109259;302102;Szkoła Podstawowa nr 2|Puszczykowo|ul. Kasprowicza 1 |62-040 Puszczykowo;1522;1047;1047;13;1034;68.79;1.24
109260;302102;Szkoła Podstawowa nr 2|Puszczykowo|ul.Kasprowicza 1 |62-040 Puszczykowo;1089;738;738;14;724;67.77;1.90
109261;302102;Szkoła Podstawowa nr 2|Puszczykowo|ul.Kasprowicza 1 |62-040 Puszczykowo;1520;983;983;13;970;64.67;1.32
109262;302102;Szpital w Puszczykowie im.prof.Stefana Tytusa Dąbrowskiego S.A.|Puszczykowo|Kraszewskiego 11 |62-040 Puszczykowo;190;46;46;1;45;24.21;2.17
109263;302103;Kino "Wielkopolanin"|Buk|Pl. St. Reszki 29 |64-320 Buk;2047;1089;1089;40;1049;53.20;3.67
109264;302103;Hala Sportowa|Buk|ul. Szarych Szeregów 10 |64-320 Buk;2129;1222;1222;49;1173;57.40;4.01
109265;302103;Szkoła Podstawowa|Buk|ul. Szkolna 12 |64-320 Buk;2051;1053;1053;36;1017;51.34;3.42
109266;302103;Szkoła Podstawowa|Niepruszewo|ul. Starowiejska 26 |64-320 Buk;1314;668;668;29;639;50.84;4.34
109267;302103;Szkoła Podstawowa|Szewce|ul. Bukowska 151 |64-320 Buk;1069;446;446;33;413;41.72;7.40
109268;302103;Szkoła Podstawowa|Dobieżyn|ul. Powstańców Wielkopolskich 3 |64-320 Buk;982;497;497;16;481;50.61;3.22
109269;302104;Gimnazjum im. Kazimierza Górskiego|Bolechowo|ul. Wojska Polskiego 6 |62-005 Owińska;1948;1024;1024;38;986;52.57;3.71
109270;302104;Szkoła Podstwowa im. Józefa Wybickiego|Owińska|ul. Poprzeczna 10 |62-005 Owińska;1948;1106;1106;13;1093;56.78;1.18
109271;302104;Szkoła Podstawowa im Józefa Wybickiego|Owińska|ul. Poprzeczna 10 |62-005 Owińska;988;412;412;24;388;41.70;5.83
109272;302104;Gminne Przedszkole im. Dzieci z Leszczynowej Górki|Czerwonak|Plac Zielony 4 |62-004 Czerwonak;1824;911;911;28;883;49.95;3.07
109273;302104;Szkoła Podstawowa im. Józefa Wybickiego|Czerwonak|ul. Rolna 8 |62-004 Czerwonak;1039;669;669;12;657;64.39;1.79
109274;302104;Gminny Ośrodek Kultury "Sokół"|Czerwonak|ul. Gdyńska 47 |62-004 Czerwonak;1695;1060;1060;20;1040;62.54;1.89
109275;302104;Szkoła Podstawowa im A Cieszkowskiego|Kicin|ul. Gwarna 1 |62-004 Czerwonak;1707;1091;1091;12;1079;63.91;1.10
109276;302104;Szkoła Podstawowa im. gen. Stefana Roweckiego "Grota"|Koziegłowy|ul. Poznańska |62-028 Koziegłowy;779;418;419;11;407;53.66;2.63
109277;302104;Gimnazjum w Koziegłowach|Koziegłowy|ul. Piaskowa 15 |62-028 Koziegłowy;1164;750;750;11;739;64.43;1.47
109278;302104;Gimnazjum|Koziegłowy|ul. Piaskowa 15 |62-028 Koziegłowy;1155;683;683;8;675;59.13;1.17
109279;302104;Gimnazjum|Koziegłowy|ul. Piaskowa 15 |62-028 Koziegłowy;1080;596;596;11;585;55.19;1.85
109280;302104;Gimnazjum|Koziegłowy|ul. Piaskowa 15 |62-028 Koziegłowy;1182;632;632;13;619;53.47;2.06
109281;302104;Gimnazjum|Koziegłowy|ul. Piaskowa 15 |62-028 Koziegłowy;1122;716;716;13;703;63.81;1.82
109282;302104;Gimnazjum w Koziegłowach|Koziegłowy|ul. Piaskowa 15 |62-028 Koziegłowy;1200;784;784;9;775;65.33;1.15
109283;302104;Szkoła Podstawowa im. gen. Stefana Roweckiego "Grota"|Koziegłowy|ul. Poznańska |62-028 Koziegłowy;1469;929;929;10;919;63.24;1.08
109284;302104;Zakład Karny w Koziegłowach|Koziegłowy|Piaskowa 7 |62-028 Koziegłowy;405;151;151;20;131;37.28;13.25
109285;302105;Szkoła Podstawowa|Dąbrowa|ul. Szkolna 41 |62-070 Dopiewo;1273;797;797;13;784;62.61;1.63
109286;302105;Szkoła Podstawowa|Dąbrówka|ul. Malinowa 41 |62-070 Dopiewo;1506;1105;1105;8;1097;73.37;0.72
109287;302105;Szkoła Podstawowa|Dąbrówka|ul. Malinowa 41 |62-070 Dopiewo;815;612;612;5;607;75.09;0.82
109288;302105;Budynek byłego GOK|Dopiewiec|ul. Szkolna 11 |62-070 Dopiewo;942;553;553;15;538;58.70;2.71
109289;302105;Zespół Szkolno-Przedszkolny|Dopiewo|ul. Bukowska 13 |62-070 Dopiewo;1654;885;885;23;862;53.51;2.60
109290;302105;Zespół Szkolno-Przedszkolny|Dopiewo|ul. Bukowska 13 |62-070 Dopiewo;873;512;512;12;500;58.65;2.34
109291;302105;Świetlica Wiejska-Dom Strażaka|Palędzie|ul. Leśna 17 |62-070 Dopiewo;1349;813;813;14;799;60.27;1.72
109292;302105;Szkoła Podstawowa|Konarzewo|ul. Szkolna 16 |62-070 Dopiewo;1728;883;883;33;850;51.10;3.74
109293;302105;Szkoła Podstawowa|Skórzewo|ul. Poznańska 70 |60-185 Poznań;2528;1628;1628;33;1595;64.40;2.03
109294;302105;Szkoła Podstawowa|Skórzewo|ul. Poznańska 70 |60-185 Poznań;2245;1746;1746;10;1736;77.77;0.57
109295;302105;Zespół Szkolno-Przedszkolny|Więckowice|ul. Gromadzka 7 |62-070 Dopiewo;915;464;465;24;440;50.71;5.17
109296;302105;Dom Strażaka|Zakrzewo|ul. Długa 73 |62-070 Dopiewo;985;617;617;11;606;62.64;1.78
109297;302105;Dom Pomocy Społecznej w Lisówkach|Lisówki|Leśne Zacisze 2 |62-070 Dopiewo;81;33;33;10;23;40.74;30.30
109298;302106;Ośrodek Kultury|Kleszczewo|ul. Poznańska 6 |63-005 Kleszczewo;1892;994;994;29;965;52.54;2.92
109299;302106;Świetlica wiejska|Gowarzewo|ul. Swarzędzka 14 |63-004 Tulce;1496;902;902;19;883;60.29;2.11
109300;302106;Zespół Szkół|Tulce|ul.Poznańska 1 |63-004 Tulce;2043;1326;1326;22;1304;64.90;1.66
109301;302107;Wiejski Dom Kultury "Koźlak"|Chomęcice|ul.Poznańska 65 |62-052 Komorniki;816;458;458;12;446;56.13;2.62
109302;302107;Dom Kultury "Dworek"|Głuchowo|ul.Parkowa 2 |62-052 Komorniki;553;245;245;7;238;44.30;2.86
109303;302107;Gimnazjum|Komorniki|ul.Pocztowa 30 |62-052 Komorniki;750;518;518;10;508;69.07;1.93
109304;302107;Gimnazjum|Komorniki|ul. Pocztowa 30 |62-052 Komorniki;757;410;410;9;401;54.16;2.20
109305;302107;Gimnazjum|Komorniki|ul. Pocztowa 30 |62-052 Komorniki;1047;596;596;22;574;56.92;3.69
109306;302107;Szkoła Podstawowa|Komorniki|ul. Staszica 25 |62-052 Komorniki;963;595;595;15;580;61.79;2.52
109307;302107;Szkoła Podstawowa|Komorniki|ul.Staszica 25 |62-052 Komorniki;872;628;628;6;622;72.02;0.96
109308;302107;Szkoła Podstawowa|Komorniki|ul.Staszica 25 |62-052 Komorniki;1146;749;749;4;745;65.36;0.53
109309;302107;Szkoła Podstawowa|Plewiska|ul. Szkolna 64 |62-064 Plewiska;760;393;393;12;381;51.71;3.05
109310;302107;Szkoła Podstawowa|Plewiska|ul. Szkolna 64 |62-064 Plewiska;1012;671;671;12;659;66.30;1.79
109311;302107;Szkoła Podstawowa|Plewiska|ul. Szkolna 64 |62-064 Plewiska;742;488;488;7;481;65.77;1.43
109312;302107;Szkoła Podstawowa|Plewiska|ul. Szkolna 64 |62-064 Plewiska;846;519;519;9;510;61.35;1.73
109313;302107;Szkoła Podstawowa|Plewiska|ul. Szkolna 64 |62-064 Plewiska;889;536;536;9;527;60.29;1.68
109314;302107;Szkoła Podstawowa|Plewiska|ul. Szkolna 64 |62-064 Plewiska;1270;888;888;6;882;69.92;0.68
109315;302107;Szkoła Podstawowa|Plewiska|ul. Szkolna 64 |62-064 Plewiska;989;674;674;14;660;68.15;2.08
109316;302107;Dom Kultury "Klub"|Rosnówko|ul.1 Maja 50 |62-052 Komorniki;971;556;556;14;542;57.26;2.52
109317;302107;Świetlica Wiejska|Szreniawa|ul. Nowa 9 |62-052 Komorniki;601;335;336;11;324;55.74;3.28
109318;302107;Salka parafialna|Wiry|ul. Komornicka 175 |62-051 Komorniki;877;501;501;13;488;57.13;2.59
109319;302107;Dom Kultury|Wiry|ul. Łęczycka 101 |62-051 Komorniki;712;491;491;13;478;68.96;2.65
109320;302107;Dom Kultury|Wiry|ul. Łęczycka 101 |62-051 Komorniki;727;392;392;12;380;53.92;3.06
109321;302107;Dom Kultury Nad Wirynką|Łęczyca|ul. Poznańska 14 |62-051 Komorniki;718;410;410;12;398;57.10;2.93
109322;302107;Oddział Zewnętrzny Aresztu Śledczego|Rosnowo|Jarzębinowa 2 |62-052 Komorniki;65;59;59;4;55;90.77;6.78
109323;302108;Świetlica Wiejska|Gwiazdowo| 15 |62-025 Kostrzyn;777;275;275;8;267;35.39;2.91
109324;302108;Zespół Szkół|Iwno|ul. Szkolna 11 |62-025 Kostrzyn;919;375;375;25;350;40.81;6.67
109325;302108;Zespół Szkół|Brzeźno|ul. Długa 5 |62-025 Kostrzyn;753;291;291;15;276;38.65;5.15
109326;302108;Zespół Szkół|Gułtowy|ul. Średzka 8 |62-025 Kostrzyn;801;349;349;21;328;43.57;6.02
109327;302108;Zespół Szkół|Czerlejno|ul. Kostrzyńska 4 |62-025 Kostrzyn;1858;729;729;37;692;39.24;5.08
109328;302108;Zespół Szkół|Siekierki Wielkie|ul. Stanisława Karalusa 1 |62-025 Kostrzyn;1143;652;652;17;635;57.04;2.61
109329;302108;Gimnazjum|Kostrzyn|ul. Powstańców Wlkp. 28A |62-025 Kostrzyn;902;481;481;14;467;53.33;2.91
109330;302108;Urząd Miejski|Kostrzyn|ul. Dworcowa 5 |62-025 Kostrzyn;2133;1106;1106;44;1062;51.85;3.98
109331;302108;Miejsko-Gminny Ośrodek Kultury|Kostrzyn|ul. Poznańska 33 |62-025 Kostrzyn;1764;789;789;32;757;44.73;4.06
109332;302108;Przedszkole Miejskie|Kostrzyn|ul. Średzka 9 |62-025 Kostrzyn;943;493;493;19;474;52.28;3.85
109333;302108;Biblioteka Publiczna Miasta i Gminy|Kostrzyn|ul. Poznańska 20 |62-025 Kostrzyn;1712;832;832;29;803;48.60;3.49
109334;302109;Zespół Szkół w Kórniku|Kórnik|ul. Poznańska 2 |62-035 Kórnik;786;498;498;10;488;63.36;2.01
109335;302109;Szkoła Podstawowa nr 1 w Kórniku|Kórnik|ul. Dworcowa 11 |62-035 Kórnik;1664;1087;1087;24;1063;65.32;2.21
109336;302109;Zespół Szkół w Kórniku|Kórnik|Poznańska 2 |62-035 Kórnik;1331;789;789;17;772;59.28;2.15
109337;302109;Szkoła Podstawowa nr 2 w Kórniku|Kórnik|ul. Armii Krajowej 11 |62-035 Kórnik;2009;1100;1100;36;1064;54.75;3.27
109338;302109;Szkoła Podstawowa w Radzewie|Radzewo|ul. Dworzyskowa 3 |62-035 Kórnik;1505;755;755;32;723;50.17;4.24
109339;302109;Szkoła Podstawowa nr 2 w Kórniku|Kórnik|ul. Armii Krajowej 11 |62-035 Kórnik;1298;663;663;22;641;51.08;3.32
109340;302109;Budynek przy ul. Szkolnej 2 w Borówcu|Borówiec|ul. Szkolna 2 |62-023 Gądki;443;297;297;10;287;67.04;3.37
109341;302109;Szkoła Podstawowa w Szczodrzykowie|Szczodrzykowo|ul. Ogrodowa 21 |62-035 Kórnik;951;394;394;15;379;41.43;3.81
109342;302109;Szkoła Podstawowa w Szczodrzykowie|Szczodrzykowo|ul. Ogrodowa 21 |62-035 Kórnik;751;329;329;14;315;43.81;4.26
109343;302109;Gimnazjum w Robakowie|Robakowo|ul. Szkolna 3 |62-023 Gądki;1774;1049;1049;28;1021;59.13;2.67
109344;302109;Gimnazjum w Robakowie|Robakowo|ul. Szkolna 3 |62-023 Gądki;630;243;243;4;239;38.57;1.65
109345;302109;Budynek przy ul. Szkolnej 2 w Borówcu|Borówiec|ul. Szkolna 2 |62-023 Gądki;1669;1195;1195;14;1181;71.60;1.17
109346;302109;Dom Strażaka w Kamionkach|Kamionki|ul. Poznańska 78 |62-023 Gądki;2021;1426;1426;16;1410;70.56;1.12
109347;302109;Świetlica w Szczytnikach|Szczytniki|ul. Wspólna 16 |62-023 Gądki;1100;698;698;11;687;63.45;1.58
109348;302110;Świetlica Wiejska|Czapury|ul. Poznańska 78 |61-160 Poznań;1689;1036;1036;23;1013;61.34;2.22
109349;302110;Szkoła Podstawowa|Czapury|ul. Poznańska 78 |61-160 Poznań;999;492;492;21;471;49.25;4.27
109350;302110;Świetlica Wiejska|Daszewice|ul. Piotrowska 3 |61-160 Poznań;1341;845;845;10;835;63.01;1.18
109351;302110;Świetlica Wiejska|Rogalinek|ul. Kościelna 3 |62-022 Mosina;1380;742;742;22;720;53.77;2.96
109352;302110;Zespół Szkół|Rogalin|ul. Poznańska 2 |62-022 Mosina;829;367;367;12;355;44.27;3.27
109353;302110;Świetlica Wiejska|Mieczewo|ul. Szeroka 3 |62-022 Mosina;723;421;421;8;413;58.23;1.90
109354;302110;Klub Rolnika|Sowinki| 1C |62-050 Mosina;629;321;321;16;305;51.03;4.98
109355;302110;Centrum Kształcenia|Nowinki|ul. Powstańców Wielkopolskich 3 |62-053 Mosina;1012;500;500;21;479;49.41;4.20
109356;302110;Szkoła Podstawowa|Pecna|ul. Szkolna 19 |62-053 Mosina;1520;768;768;30;738;50.53;3.91
109357;302110;Szkoła Podstawowa|Krosinko|ul. Wiejska 43 |62-050 Mosina;1176;607;607;13;594;51.62;2.14
109358;302110;Zespół Szkół|Krosno|ul. Główna 43 |62-050 Mosina;803;382;382;9;373;47.57;2.36
109359;302110;Świetlica Wiejska|Krosno|ul. Piaskowa 6 |62-050 Mosina;1120;660;660;7;653;58.93;1.06
109360;302110;Specjalny Ośrodek Szkolno -Wychowawczy|Mosina|ul. Kościelna 2 |62-050 Mosina;1073;571;571;19;552;53.22;3.33
109361;302110;Szkoła Podstawowa Nr 1|Mosina|ul. Szkolna 1 |62-050 Mosina;1357;825;825;23;802;60.80;2.79
109362;302110;Przedszkole Nr 4|Mosina|ul. Kasprowicza 28 |62-050 Mosina;1004;582;582;14;568;57.97;2.41
109363;302110;Zespół Szkół|Mosina|ul. Krasickiego 16 |62-050 Mosina;1405;888;888;22;866;63.20;2.48
109364;302110;Mosiński Ośrodek Kultury|Mosina|ul. Dworcowa 4 |62-050 Mosina;910;519;519;5;514;57.03;0.96
109365;302110;Przedszkole Nr 2|Mosina|ul. Powstańców Wielkopolskich 1 |62-050 Mosina;1548;814;814;27;787;52.58;3.32
109366;302110;Zespół Szkół im. Adama Wodziczki|Mosina|ul. Topolowa 2 |62-050 Mosina;1156;718;718;13;705;62.11;1.81
109367;302110;Zespół Szkół w Mosinie|Mosina|ul. Sowiniecka 75 |62-050 Mosina;898;526;526;17;509;58.57;3.23
109368;302110;Zespół Szkół w Mosinie|Mosina|ul. Sowiniecka 75 |62-050 Mosina;924;585;585;12;573;63.31;2.05
109369;302110;Szpital w Ludwikowie|Ludwikowo|Leśna 1 |62-050 Mosina;144;85;85;8;77;59.03;9.41
109370;302111;Remiza OSP Mściszewo|Mściszewo| 31 |62-095 Murowana Goślina;385;182;182;5;177;47.27;2.75
109371;302111;Szkoła Podstawowa|Białężyn| 11 |62-095 Murowana Goślina;961;325;325;18;307;33.82;5.54
109372;302111;Przedszkole "Leśne skrzaty"|Przebędowo| 1 |62-095 Murowana Goślina;944;424;424;14;410;44.92;3.30
109373;302111;Szkoła Podstawowa|Długa Goślina| 22 |62-095 Murowana Goślina;900;390;390;10;380;43.33;2.56
109374;302111;Szkoła Podstawowa|Łopuchowo| 15 |62-095 Murowana Goślina;620;248;248;10;238;40.00;4.03
109375;302111;Remiza OSP Boduszewo|Boduszewo| 19B |62-095 Murowana Goślina;1036;552;552;12;540;53.28;2.17
109376;302111;Gimnazjum nr 1|Murowana Goślina|ul.Mściszewska 10 |62-095 Murowana Goślina;1509;779;779;27;752;51.62;3.47
109377;302111;Biblioteka Publiczna|Murowana Goślina|ul.Poznańska 16 |62-095 Murowana Goślina;1905;1079;1079;17;1062;56.64;1.58
109378;302111;Przedszkole "Słoneczko"|Murowana Goślina|ul. Leśna 9 |62-095 Murowana Goślina;764;433;433;16;417;56.68;3.70
109379;302111;Szkoła Podstawowa nr 2|Murowana Goślina|ul. Gen. Tadeusza Kutrzeby 3 |62-095 Murowana Goślina;1980;1089;1089;25;1064;55.00;2.30
109380;302111;Gimnazjum nr 2|Murowana Goślina|ul. Gen. Tadeusza Kutrzeby 3 |62-095 Murowana Goślina;2169;1274;1274;24;1250;58.74;1.88
109381;302112;Zespół Szkół im. Konstytucji 3 Maja Pobiedziska Letnisko|Pobiedziska|ul. Gajowa 22 |62-010 Pobiedziska;1180;717;717;22;695;60.76;3.07
109382;302112;Urząd Miasta i Gminy Pobiedziska|Pobiedziska|ul. Kościuszki 4 |62-010 Pobiedziska;994;511;511;28;483;51.41;5.48
109383;302112;Remiza OSP Pobiedziska|Pobiedziska|ul. Tysiąclecia 18 |62-010 Pobiedziska;984;496;496;10;486;50.41;2.02
109384;302112;Zespół Szkół Szkoła Podstawowa i Gimnazjum Pobiedziska|Pobiedziska|ul. Kostrzyńska 23 |62-010 Pobiedziska;1821;880;880;21;859;48.33;2.39
109385;302112;Przedszkole Pobiedziska|Pobiedziska|ul. Różana 4 |62-010 Pobiedziska;2073;1281;1281;37;1244;61.79;2.89
109386;302112;Ośrodek Kultury Pobiedziska|Pobiedziska|ul. Kostrzyńska 21 |62-010 Pobiedziska;1751;665;665;14;651;37.98;2.11
109387;302112;Zespół Szkół Szkoła Podstawowa i Gimnazjum|Wronczyn| 1a |62-010 Pobiedziska;1037;520;520;14;506;50.14;2.69
109388;302112;Szkoła Podstawowa|Węglewo| 16 |62-010 Pobiedziska;871;313;313;16;297;35.94;5.11
109389;302112;Zespół Szkół Szkoła Podstawowa i Gimnazjum|Jerzykowo|ul. Spokojna 3 |62-007 Biskupice;2065;1167;1167;34;1133;56.51;2.91
109390;302112;Zespół Szkoła Podstawowa i Przedszkole Biskupice|Biskupice|ul. Szkolna 2 |62-007 Biskupice;2000;1224;1224;33;1191;61.20;2.70
109391;302112;Areszt Śledczy Środa Wlkp. Oddział Zewnętrzny Pobiedziska|Pobiedziska|Władysława Jagiełły 34 |62-010 Pobiedziska;54;54;54;14;40;100.00;25.93
109392;302113;Szkoła Podstawowa im. J.Brzechwy w Rokietnicy|Rokietnica|ul. Szkolna 3c |62-090 Rokietnica;975;658;658;8;650;67.49;1.22
109393;302113;Szkoła Podstawowa im. J.Brzechwy w Rokietnicy|Rokietnica|ul. Szkolna 3c |62-090 Rokietnica;1852;1087;1087;30;1057;58.69;2.76
109394;302113;Gimnazjum im. Noblistów w Rokietnicy|Rokietnica|ul. Trakt Napoleoński 55 |62-090 Rokietnica;966;655;655;6;649;67.81;0.92
109395;302113;Klub Sołecki w Cerekwicy|Cerekwica|ul. Szamotulska 7 |62-090 Rokietnica;1768;1092;1092;18;1074;61.76;1.65
109396;302113;Zespół Szkolno-Przedszkolny w Napachaniu|Napachanie|ul. Poznańska 26 |62-090 Rokietnica;1046;596;596;3;593;56.98;0.50
109397;302113;Świetlica wiejska w Krzyszkowie|Krzyszkowo|ul. Koszycy 1 |62-090 Rokietnica;686;399;399;14;385;58.16;3.51
109398;302113;Świetlica wiejska w Żydowie|Żydowo|ul. Rostworowska 5 |62-090 Rokietnica;688;286;286;22;264;41.57;7.69
109399;302113;Gminny Ośrodek Kultury w Rokietnicy|Rokietnica|ul. Szkolna 3a |62-090 Rokietnica;469;258;258;8;250;55.01;3.10
109400;302113;Szkoła Podstawowa im. J.Brzechwy w Rokietnicy|Rokietnica|ul. Szkolna 3c |62-090 Rokietnica;1420;969;969;11;958;68.24;1.14
109401;302113;Gimnazjum im.Noblistów w Rokietnicy|Rokietnica|ul. Trakt Napoleoński 55 |62-090 Rokietnica;1391;799;799;15;784;57.44;1.88
109402;302114;Budynek oświatowy|Stęszew|ul. Korczaka 2 |62-060 Stęszew;1591;869;869;30;839;54.62;3.45
109403;302114;Klub "Siódemka"|Stęszew|ul. Poznańska 7 |62-060 Stęszew;1604;880;880;35;845;54.86;3.98
109404;302114;Gimnazjum|Stęszew|ul. Szkolna 1 |62-060 Stęszew;1424;732;732;37;695;51.40;5.05
109405;302114;Szkoła Podstawowa|Stęszew|ul. Poznańska 25 |62-060 Stęszew;1522;707;707;35;672;46.45;4.95
109406;302114;Budynek byłej szkoły|Łódź|ul. Szkolna 24 |62-060 Stęszew;1616;601;601;25;576;37.19;4.16
109407;302114;Szkoła Podstawowa|Modrze|ul. Kościuszki 14 |62-060 Stęszew;1091;436;436;31;405;39.96;7.11
109408;302114;Swietlica Wiejska|Strykowo|ul. Bukowska 2 |62-060 Stęszew;1170;501;501;34;467;42.82;6.79
109409;302114;Sala gimnastyczna|Jeziorki|ul. Ogrodowa 1 |62-060 Stęszew;1778;811;811;25;786;45.61;3.08
109410;302115;Dom Osiedlowy|Biedrusko|ul. Zjednoczenia 4 |62-003 Biedrusko;1753;1116;1116;25;1091;63.66;2.24
109411;302115;Zespół Szkół im. Ojca Mariana Żelazka|Chludowo|ul.Szkolna 3 |62-001 Chludowo;1455;841;841;19;822;57.80;2.26
109412;302115;Remiza Ochotniczej Straży Pożarnej|Suchy Las|ul. Wojciecha Bogusławskiego 36 |62-002 Suchy Las;1572;1201;1201;9;1192;76.40;0.75
109413;302115;Szkoła Podstawowa im. Wojciecha Bogusławskiego|Suchy Las|ul. Szkolna 15 |62-002 Suchy Las;1503;1054;1054;12;1042;70.13;1.14
109414;302115;Gimnazjum im. Jana Pawła II|Suchy Las|ul. Poziomkowa 11 |62-002 Suchy Las;1787;1301;1301;15;1286;72.80;1.15
109415;302115;Świetlica osiedlowa|Złotniki|Plac Grzybowy 16 |62-002 Suchy Las;1536;1180;1180;13;1167;76.82;1.10
109416;302115;Filia Ośrodka Kultury Gminy Suchy Las|Złotniki|ul. Żukowa 14 |62-002 Suchy Las;1420;900;900;20;880;63.38;2.22
109417;302115;Swietlica wiejska|Golęczewo|Dworcowa 61A |62-001 Chludowo;890;596;596;25;571;66.97;4.19
109418;302116;Szkoła Podstawowa nr 5|Swarzędz|os. Mielżyńskiego 3a |62-020 Swarzędz;1978;1203;1205;18;1185;60.82;1.50
109419;302116;Szkoła Podstawowa nr 5|Swarzędz|os. Mielżyńskiego 3a |62-020 Swarzędz;1943;1325;1326;26;1299;68.19;1.96
109420;302116;Szkoła Podstawowa nr 5|Swarzędz|os. Mielżyńskiego 3a |62-020 Swarzędz;1602;1041;1042;14;1027;64.98;1.34
109421;302116;Szkoła Podstawowa nr 5|Swarzędz|os.Mielżyńskiego 3a |62-020 Swarzędz;1305;935;935;21;914;71.65;2.25
109422;302116;Ośrodek Kultury|Swarzędz|ul. Poznańska 14 |62-020 Swarzędz;1849;918;918;33;885;49.65;3.59
109423;302116;Gimnazjum nr 2|Swarzędz|ul. Polna 21 |62-020 Swarzędz;1811;1177;1177;16;1161;64.99;1.36
109424;302116;Gimnazjum Nr 2|Swarzędz|ul. Polna 21 |62-020 Swarzędz;1893;1082;1082;16;1066;57.16;1.48
109425;302116;Cech Stolarzy|Swarzędz|ul. Wrzesińska 41 |62-020 Swarzędz;1807;1074;1074;19;1055;59.44;1.77
109426;302116;Szkoła Podstawowa nr 1|Swarzędz|ul. Zamkowa 20 |62-020 Swarzędz;1651;828;828;30;798;50.15;3.62
109427;302116;Gimnazjum Nr 3|Swarzędz|os. Czwartaków 1 |62-020 Swarzędz;1280;702;702;10;692;54.84;1.42
109428;302116;Gimnazjum Nr 3|Swarzędz|os. Czwartaków 1 |62-020 Swarzędz;1465;920;920;25;895;62.80;2.72
109429;302116;Szkoła Podstwowa Nr 4|Swarzędz|os. Kościuszkowców 4 |62-020 Swarzędz;1607;958;958;13;945;59.61;1.36
109430;302116;Szkoła Podstwowa Nr 4|Swarzędz|os. Kościuszkowców 4 |62-020 Swarzędz;1900;1149;1149;26;1123;60.47;2.26
109431;302116;Przedszkole nr 2|Swarzędz|os. Czwartaków 8 |62-020 Swarzędz;1621;955;955;14;941;58.91;1.47
109432;302116;Szkoła Podstawowa Nr 1|Swarzędz|Zamkowa 20 |62-020 Swarzędz;1058;592;592;8;584;55.95;1.35
109433;302116;Szkoła Podstawowa Nr 1|Swarzędz|Zamkowa 20 |62-020 Swarzędz;1344;624;624;15;609;46.43;2.40
109434;302116;Świetlica Wiejska|Zalasewo|Kórnicka 220 |62-020 Swarzędz;1285;847;847;11;836;65.91;1.30
109435;302116;Przedszkole Publiczne|Zalasewo|ul. Spacerowa 4 |62-020 Swarzędz;816;465;465;16;449;56.99;3.44
109436;302116;Szkoła Podstawowa|Wierzonka|ul. Karłowicka 3 |62-006 Kobylnica;606;210;210;9;201;34.65;4.29
109437;302116;Szkoła Podstawowa w Zespole Szkół|Paczkowo|ul. Szkolna 16 |62-021 Paczkowo;1422;819;819;30;789;57.59;3.66
109438;302116;Świetlica Wiejska|Gruszczyn|ul. Swarzędzka 40 |62-006 Kobylnica;1692;1097;1097;13;1084;64.83;1.19
109439;302116;Szkoła Podstawowa|Kobylnica|ul. Poznańska 50 |62-006 Kobylnica;1235;715;715;23;692;57.89;3.22
109440;302116;Klub Rolnika|Janikowo|ul. Asfaltowa 7 |62-006 Kobylnica;1496;836;836;10;826;55.88;1.20
109441;302116;Szkoła Podstawowa|Zalasewo|Heweliusza 26 |62-020 ;1231;918;918;8;910;74.57;0.87
109442;302117;Szkoła Podstawowa|Tarnowo Podgórne|ul. Szkolna 5 |62-080 Tarnowo Podgórne;1772;1147;1147;29;1118;64.73;2.53
109443;302117;Świetlica Wiejska|Lusowo|ul. Ogrodowa 13 |62-080 Tarnowo Podgórne;2144;1415;1415;45;1370;66.00;3.18
109444;302117;Szkoła Podstawowa|Przeźmierowo|ul. Kościelna 46/48 |62-081 Przeźmierowo;1717;1119;1119;24;1095;65.17;2.14
109445;302117;Świetlica Wiejska|Jankowice|ul. Wiśniowa 2a |62-080 Tarnowo Podgórne;848;418;418;16;402;49.29;3.83
109446;302117;Gimazjum w Auli|Baranowo|ul. Wypoczynkowa 93 |62-081 Przeźmierowo;1975;1325;1325;21;1304;67.09;1.58
109447;302117;Szkoła Podstawowa|Przeźmierowo|ul. Kościelna 46/48 |62-081 Przeźmierowo;1692;1083;1083;24;1059;64.01;2.22
109448;302117;GOK SEZAM|Tarnowo Podgórne|Ogrodowa 14 |62-080 Tarnowo Podgórne;1582;994;994;29;965;62.83;2.92
109449;302117;Szkoła Podstawowa|Tarnowo Podgórne|ul. Szkolna 5 |62-080 Tarnowo Podgórne;744;369;369;9;360;49.60;2.44
109450;302117;Szkoła Podstawowa|Przeźmierowo|ul. Kościelna 46/48 |62-081 Przeźmierowo;1677;1029;1029;14;1015;61.36;1.36
109451;302117;Gimnazjum w Auli|Baranowo|ul. Wypoczynkowa 93 |62-081 Przeźmierowo;725;569;569;3;566;78.48;0.53
109452;302117;Świetlica Wiejska|Batorowo|Stefana Batorego 67 |62-080 Tarnowo Podgórne;1101;668;668;18;650;60.67;2.69
109453;302117;Szkoła Podstawowa|Lusówko|Dopiewska 5 |62-080 Tarnowo Podgórne;1816;1125;1125;19;1106;61.95;1.69
109454;302117;Szkoła Podstawowa|Tarnowo Podgórne|Szkolna 5 |62-080 Tarnowo Podgórne;688;527;527;7;520;76.60;1.33
109455;302201;Szkoła Podstawowa|Bojanowo|ul. Lipowa 2A |63-940 Bojanowo;972;466;466;13;453;47.94;2.79
109456;302201;Szkoła Podstawowa|Bojanowo|ul. Lipowa 2A |63-940 Bojanowo;1416;636;636;29;607;44.92;4.56
109457;302201;Zespół Szkół Przyrodniczo-Technicznych Centrum Kształcenia Ustawicznego|Bojanowo|ul. Dworcowa 29 |63-940 Bojanowo;1620;667;667;26;641;41.17;3.90
109458;302201;Szkoła Podstawowa|Golina Wielka| 65A |63-940 Bojanowo;1272;455;455;34;421;35.77;7.47
109459;302201;Świetlica wiejska|Zaborowice| 5a |63-940 Bojanowo;883;260;260;15;245;29.45;5.77
109460;302201;Szkoła Podstawowa|Gościejewice| 31 |63-940 Bojanowo;745;193;193;12;181;25.91;6.22
109461;302201;Dom Pomocy Społecznej|Pakówka| 42 |63-940 Bojanowo;87;28;28;5;23;32.18;17.86
109462;302202;Zespół Szkół im. Jana Pawła II|Jutrosin|ul. Wrocławska 39 |63-930 Jutrosin;1542;732;732;37;695;47.47;5.05
109463;302202;Zespół Szkół im. Jana Pawła II|Jutrosin|ul. Wrocławska 39 |63-930 Jutrosin;1528;506;506;29;477;33.12;5.73
109464;302202;Szkoła Podstawowa|Dubin| 150 |63-930 Jutrosin;1178;452;452;19;433;38.37;4.20
109465;302202;Zespół Szkół|Szkaradowo| 1 |63-930 Jutrosin;1265;538;538;23;515;42.53;4.28
109466;302203;Ośrodek Kultury,Sportu i Aktywności Lokalnej|Miejska Górka|ul. Jana Pawła II 6 |63-910 Miejska Górka;1277;630;630;39;591;49.33;6.19
109467;302203;Ośrodek Kultury, Sportu i Aktywności Lokalnej|Miejska Górka|ul. Jana Pawła II 6 |63-910 Miejska Górka;1326;657;657;40;617;49.55;6.09
109468;302203;Zespół Szkół|Konary| 58 |63-910 Miejska Górka;1045;373;373;29;344;35.69;7.77
109469;302203;Szkoła Podstawowa|Sobiałkowo| 95 |63-910 Miejska Górka;851;321;321;27;294;37.72;8.41
109470;302203;Zespół Szkół|Dłoń| 53 |63-910 Miejska Górka;1012;333;333;22;311;32.91;6.61
109471;302203;Ośrodek Kultury, Sportu i Aktywności Lokalnej|Miejska Górka|ul. Jana Pawła II 6 |63-910 Miejska Górka;1907;744;744;52;692;39.01;6.99
109472;302204;Szkoła Podstawowa|Chojno| 6a |63-921 Chojno;1180;488;488;19;469;41.36;3.89
109473;302204;Dom Pomocy Społecznej|Osiek| 54 |63-920 Pakosław;631;254;254;8;246;40.25;3.15
109474;302204;Gimnazjum Gminne|Pakosław|ul. Parkowa 15 |63-920 Pakosław;1154;545;545;26;519;47.23;4.77
109475;302204;Szkoła Podstawowa|Sowy| 75 |63-920 Pakosław;684;286;286;14;272;41.81;4.90
109476;302205;Gimnazjum w Sierakowie|Sierakowo|ul. Przyjmy Przyjemskiego 35 |63-900 Rawicz;1063;557;557;14;543;52.40;2.51
109477;302205;SP ZOZ Centrum Rehabilitacji Medycznej i Ośrodek Osób Niepełnosprawnych w Rawiczu|Rawicz|ul. Sarnowska 9a |63-900 Rawicz;1090;542;542;12;530;49.72;2.21
109478;302205;I Liceum Ogólnokształcące w Rawiczu|Rawicz|Wały Jarosława Dąbrowskiego 29 |63-900 Rawicz;1020;496;496;9;487;48.63;1.81
109479;302205;I Liceum Ogólnokształcące w Rawiczu|Rawicz|Wały Jarosława Dąbrowskiego 29 |63-900 Rawicz;776;434;434;14;420;55.93;3.23
109480;302205;Filia Rawickiej Biblioteki Publicznej w Rawiczu|Rawicz|ul. Stanisława Staszica 4 |63-900 Rawicz;1089;450;450;17;433;41.32;3.78
109481;302205;Szkoła Podstawowa Nr 3 w Rawiczu|Rawicz|Wały Jarosława Dąbrowskiego 1 |63-900 Rawicz;1122;493;493;19;474;43.94;3.85
109482;302205;Szkoła Podstawowa Nr 1 w Rawiczu|Rawicz|ul. Adama Mickiewicza 16 |63-900 Rawicz;992;420;420;14;406;42.34;3.33
109483;302205;Gimnazjum Nr 1 w Rawiczu|Rawicz|ul. Szarych Szeregów 3 |63-900 Rawicz;845;325;325;11;314;38.46;3.38
109484;302205;Gimnazjum Nr 1 w Rawiczu|Rawicz|ul. Szarych Szeregów 3 |63-900 Rawicz;1170;467;467;13;454;39.91;2.78
109485;302205;Zespół Szkół Zawodowych w Rawiczu|Rawicz|ul. Gen. Józefa Hallera 12 |63-900 Rawicz;1133;536;536;15;521;47.31;2.80
109486;302205;Zespół Szkół Zawodowych w Rawiczu|Rawicz|ul. Gen. Józefa Hallera 12 |63-900 Rawicz;1004;483;483;17;466;48.11;3.52
109487;302205;Przedszkole Nr 6 w Rawiczu|Rawicz|ul. Stanisława Mikołajewicza 23 |63-900 Rawicz;1280;626;626;10;616;48.91;1.60
109488;302205;Szkoła Podstawowa Nr 4 w Rawiczu|Rawicz|ul. Władysława Broniewskiego 5 |63-900 Rawicz;1284;603;603;25;578;46.96;4.15
109489;302205;Dom Kultury w Rawiczu|Rawicz|ul. Targowa 1 |63-900 Rawicz;1128;558;558;17;541;49.47;3.05
109490;302205;Szkoła Podstawowa Nr 5 w Rawiczu|Rawicz|ul. Szkolna 3 |63-900 Rawicz;1404;637;637;22;615;45.37;3.45
109491;302205;Szkoła Podstawowa w Masłowie|Masłowo|ul.Śląska 58 |63-900 Rawicz;1185;591;591;13;578;49.87;2.20
109492;302205;Świetlica w Łaszczynie|Łaszczyn| 18 |63-900 Rawicz;1063;367;367;22;345;34.52;5.99
109493;302205;Gimnazjum w Sierakowie|Sierakowo|ul. Przyjmy Przyjemskiego 35 |63-900 Rawicz;1417;638;638;25;613;45.02;3.92
109494;302205;Budynek Oświatowy w Dębnie Polskim|Dębno Polskie|ul. Rawicka 26 |63-900 Rawicz;901;420;420;23;397;46.61;5.48
109495;302205;Szkoła Podstawowa w Słupi Kapitulnej|Słupia Kapitulna| 117 |63-900 Rawicz;1352;572;572;32;540;42.31;5.59
109496;302205;Szkoła Podstawowa w Zielonej Wsi|Zielona Wieś| 72 |63-900 Rawicz;1295;473;473;23;450;36.53;4.86
109497;302205;Szpital Powiatowy Sp. z o.o. w Rawiczu|Rawicz|Gen. Grota Roweckiego 6 |63-900 Rawicz;116;13;13;0;13;11.21;0.00
109498;302205;Zakład Karny w Rawiczu|Rawicz|17 Stycznia 28 |63-900 Rawicz;418;214;214;22;192;51.20;10.28
109499;302205;Zakład Karny w Rawiczu|Rawicz|17 Stycznia 28 |63-900 Rawicz;292;142;142;25;117;48.63;17.61
109500;302301;Liceum Ogólnokształcące w Słupcy|Słupca|Plac Szkolny 1 |62-400 Słupca;1374;712;712;23;689;51.82;3.23
109501;302301;Szkoła Podstawowa Nr 1 w Słupcy|Słupca|Plac Szkolny 1a |62-400 Słupca;1336;632;632;12;620;47.31;1.90
109502;302301;Gimnazjum w Słupcy|Słupca|ul. Armii Krajowej 27 |62-400 Słupca;2341;1243;1243;43;1200;53.10;3.46
109503;302301;Zespół Szkół Ekonomicznych w Słupcy|Słupca|ul. Powstańców Wielkopolskich 22 |62-400 Słupca;1672;895;895;31;864;53.53;3.46
109504;302301;Zespół Szkół Zawodowych w Słupcy|Słupca|ul. Kopernika 11a |62-400 Słupca;1437;768;768;13;755;53.44;1.69
109505;302301;Szkoła Podstawowa Nr 3 w Słupcy|Słupca|ul. Kopernika 13 |62-400 Słupca;1696;932;932;20;912;54.95;2.15
109506;302301;Urząd Miasta w Słupcy|Słupca|ul. Pułaskiego 21 |62-400 Słupca;1477;739;739;17;722;50.03;2.30
109507;302301;Samodzielny Publiczny Zakład Opieki Zdrowotnej w Słupcy - Szpital|Słupca|Traugutta 7E |62-400 Słupca;92;38;38;1;37;41.30;2.63
109508;302302;Szkoła Podstawowa|Ratyń| 15a |62-406 Lądek;847;351;351;20;331;41.44;5.70
109509;302302;Szkoła Podstawowa|Lądek|ul. Pyzderska 31 |62-406 Lądek;2276;1028;1028;38;990;45.17;3.70
109510;302302;Szkoła Podstawowa|Ciążeń|ul. Wolności 42a |62-404 Ciążeń;1568;605;605;26;579;38.58;4.30
109511;302303;Przedszkole Gminne w Orchowie|Orchowo|ul. Powstańców Wielkopolskich 4 |62-436 Orchowo;1139;560;560;27;533;49.17;4.82
109512;302303;Dom Pomocy Społecznej w Skubarczewie|Skubarczewo| 4 |62-436 Orchowo;368;153;153;11;142;41.58;7.19
109513;302303;Świetlica Wiejska w Osówcu|Osówiec| 10A |62-436 Orchowo;315;111;111;11;100;35.24;9.91
109514;302303;Niepubliczna Szkoła Podstawowa w Różannie|Różanna| 9 |62-436 Orchowo;350;117;117;7;110;33.43;5.98
109515;302303;Urząd Gminy Orchowo|Orchowo|Kościuszki 6 |62-436 Orchowo;444;164;164;7;157;36.94;4.27
109516;302303;Świetlica Wiejska w Bielsku|Bielsko| 99 |62-436 Orchowo;496;194;194;8;186;39.11;4.12
109517;302304;Urząd Gminy|Ostrowite|ul. Lipowa 2 |62-402 ostrowite;1534;663;663;20;643;43.22;3.02
109518;302304;Szkoła Podstawowa|Giewartów|ul. Armii Krajowej 9 |62-402 ostrowite;1228;518;518;20;498;42.18;3.86
109519;302304;Środowiskowy Dom Samopomocy|Lucynowo| 2 |62-402 ostrowite;625;193;193;12;181;30.88;6.22
109520;302304;Świetlica wiejska, Naprusewo|Naprusewo| 56 |62-402 ostrowite;789;253;253;15;238;32.07;5.93
109521;302305;Dom Kultury|Powidz|ul. Park Powstańców Wielkopolskich 25 |62-430 Powidz;1028;596;596;12;584;57.98;2.01
109522;302305;Strażnica OSP|Powidz|ul. Strzałkowska 16b |62-430 Powidz;834;334;334;8;326;40.05;2.40
109523;302306;Szkoła Podstawowa im. Ireny Kosmowskiej|Kotunia| 47 |62-400 Słupca;1349;557;557;28;529;41.29;5.03
109524;302306;Publiczne Gminazjum w Kowalewie-Opactwie|Kowalewo-Opactwo| 25 |62-400 Słupca;801;360;360;13;347;44.94;3.61
109525;302306;Szkoła Podstawowa im. Kazimierza Janickiego|Cienin Zaborny| 44 |62-400 Słupca;1145;451;451;19;432;39.39;4.21
109526;302306;Szkoła Podstawowa im. Bohaterów Września 1939r.|Cienin Kościelny| 82 |62-400 Słupca;1467;553;553;21;532;37.70;3.80
109527;302306;Szkoła Podstawowa im. Jana Pawła II|Młodojewo| 92 |62-400 Słupca;1556;617;617;35;582;39.65;5.67
109528;302306;Szkoła Podstawowa im. Józefa Janika|Koszuty| 17 |62-400 Słupca;1211;512;512;14;498;42.28;2.73
109529;302307;Urząd Gminy|Strzałkowo|Aleja Prymasa Wyszyńskiego 6 |62-420 Strzałkowo;1602;805;805;23;782;50.25;2.86
109530;302307;Gminny Ośrodek Kultury|Strzałkowo|ul. Powstańców Wielkopolskich 5 |62-420 Strzałkowo;1681;835;835;32;803;49.67;3.83
109531;302307;Gimnazjum im. Janusza Korczaka|Strzałkowo|Ostrowska 8B |62-420 Strzałkowo;1041;506;506;20;486;48.61;3.95
109532;302307;sala wiejska|Brudzewo| 10B |62-420 Strzałkowo;1443;602;602;19;583;41.72;3.16
109533;302307;sala wiejska|Graboszewo| 11A |62-420 Strzałkowo;1197;399;399;12;387;33.33;3.01
109534;302307;sala wiejska|Ostrowo Kościelne| 6 |62-420 Strzałkowo;983;390;390;20;370;39.67;5.13
109535;302307;Dom Pomocy Społecznej|Strzałkowo|Kościuszki 16 |62-420 Strzałkowo;63;26;26;5;21;41.27;19.23
109536;302308;Szkoła Podstawowa im. Michała Okurzałego|Zagórów|Plac Szkolny 1 |62-410 Zagórów;1359;627;627;31;596;46.14;4.94
109537;302308;Gimnazjum im. Królowej Jadwigi|Zagórów|ul. Pyzderska 75 |62-410 Zagórów;968;368;368;11;357;38.02;2.99
109538;302308;Szkoła Podstawowa im. Michała Okurzałego|Zagórów|Plac Szkolny 1 |62-410 Zagórów;1938;719;719;48;671;37.10;6.68
109539;302308;Zespół Szkolno-Gimnazjalny im. Unii Europejskiej|Trąbczyn| 50 |62-410 Zagórów;1600;636;636;37;599;39.75;5.82
109540;302308;Szkoła Podstawowa im. Kawalerów Orderu Uśmiechu|Łukom| 2 |62-410 Zagórów;1262;416;416;29;387;32.96;6.97
109541;302308;Dom Pomocy Społecznej|Zagórów|Lidmanowskiego 4 |62-410 Zagórów;55;41;41;1;40;74.55;2.44
109542;302401;Zespół Szkół|Obrzycko|Pl. Lipowy 12 |64-520 Obrzycko;1914;927;929;38;889;48.43;4.10
109543;302402;Gimnazjum w Dusznikach|Duszniki|ul.Broniewskiego 3 |64-550 Duszniki;1027;523;523;27;496;50.93;5.16
109544;302402;Gminny Ośrodek Pomocy Społecznej|Duszniki|Jana Pawła II 8 |64-550 Duszniki;1408;674;674;33;641;47.87;4.90
109545;302402;Świetlica Wiejska w Podrzewiu|Podrzewie|ul.Stawna 3 |64-541 Podrzewie;1679;727;727;74;653;43.30;10.18
109546;302402;Szkoła Podstawowa w Grzebienisku|Grzebienisko|ul.Szkolna 16 |64-553 Grzebienisko;1898;899;899;38;861;47.37;4.23
109547;302402;Szkoła Podstawowa w Sędzinku|Sędzinko|ul.Szkolna 9 |64-552 Sędziny;805;306;306;13;293;38.01;4.25
109548;302403;Gimnazjum|Kaźmierz|ul. Gimnazjalna 3 |64-530 Kaźmierz;1650;814;814;34;780;49.33;4.18
109549;302403;Szkoła Podstawowa|Bytyń|ul. Szkolna 5 |64-542 Bytyń;838;287;287;9;278;34.25;3.14
109550;302403;Szkoła Podstawowa|Sokolniki Wielkie| 8 |64-530 Kaźmierz;704;274;274;18;256;38.92;6.57
109551;302403;Szkoła Podstawowa|Gaj Wielki|ul. Kościelna 1 |64-530 Kaźmierz;709;236;236;12;224;33.29;5.08
109552;302403;Biblioteka Publiczna|Kaźmierz|ul. Dworcowa 14 |64-530 Kaźmierz;943;481;481;15;466;51.01;3.12
109553;302403;Gimnazjum|Kaźmierz|ul. Gimnazjalna 3 |64-530 Kaźmierz;1417;851;851;29;822;60.06;3.41
109554;302404;Świetlica Wiejska|Zielonagóra|ul. Szkolna 4a |64-520 Obrzycko;2241;885;885;40;845;39.49;4.52
109555;302404;Zespół Szkół|Gaj Mały| 32 |64-520 Obrzycko;1234;475;475;22;453;38.49;4.63
109556;302405;Zespół Szkół|Ostroróg|ul. Jana Ostroroga 14 |64-560 Ostroróg;1677;776;776;38;738;46.27;4.90
109557;302405;Urząd Miasta i Gminy|Ostroróg|ul. Wroniecka 14 |64-560 Ostroróg;2216;847;847;57;790;38.22;6.73
109558;302406;Liceum Ogólnokształcące|Pniewy|ul. św. Ducha 10 |62-045 Pniewy;2111;1092;1092;51;1041;51.73;4.67
109559;302406;Szkoła Podstawowa|Pniewy|ul. Strzelecka 11A |62-045 Pniewy;1993;1066;1066;38;1028;53.49;3.56
109560;302406;Szkoła Podstawowa|Chełmno| 26 |62-045 Pniewy;528;186;186;14;172;35.23;7.53
109561;302406;Szkoła Podstawowa|Nojewo| 41 |62-045 Pniewy;1251;535;535;48;487;42.77;8.97
109562;302406;Świetlica wiejska|Dębina| 12 |62-045 Pniewy;618;194;194;15;179;31.39;7.73
109563;302406;Zespół Szkół Zawodowych im.E.Sczanieckiej|Pniewy|ul. Wolności 10 |62-045 Pniewy;2060;1113;1113;57;1056;54.03;5.12
109564;302406;Gimnazjum|Pniewy|ul. Strzelecka 11A |62-045 Pniewy;1122;485;485;25;460;43.23;5.15
109565;302407;Dom Rzemiosła|Szamotuły|Wroniecka 39A |64-500 Szamotuły;1937;1022;1022;26;996;52.76;2.54
109566;302407;Szkoła Podstawowa Nr 3|Szamotuły|Szczuczyńska 5 |64-500 Szamotuły;1868;1023;1023;11;1012;54.76;1.08
109567;302407;Szkoła Podstawowa Nr 3|Szamotuły|Szczuczyńska 5 |64-500 Szamotuły;1679;922;922;21;901;54.91;2.28
109568;302407;Zespół Szkół Nr 3|Szamotuły|Adama Mickiewicza 4 |64-500 Szamotuły;1153;638;638;9;629;55.33;1.41
109569;302407;Zespół Szkół Nr 1|Szamotuły|Adama Mickiewicza 9 |64-500 Szamotuły;1223;646;646;10;636;52.82;1.55
109570;302407;Szkoła Podstawowa Nr 1|Szamotuły|Stanisława Staszica 1 |64-500 Szamotuły;863;487;487;15;472;56.43;3.08
109571;302407;Zespół Szkół Specjalnych|Szamotuły|Hugona Kołłątaja 1 |64-500 Szamotuły;1560;807;807;20;787;51.73;2.48
109572;302407;Szamotulski Ośrodek Kultury|Szamotuły|Dworcowa 43 |64-500 Szamotuły;1079;492;492;11;481;45.60;2.24
109573;302407;Spółdzielnia Mieszkaniowa|Szamotuły|Łąkowa 9 |64-500 Szamotuły;1297;707;707;20;687;54.51;2.83
109574;302407;Hala "Wacław"|Szamotuły|Sportowa 6 |64-500 Szamotuły;1352;764;764;17;747;56.51;2.23
109575;302407;Szkoła Podstawowa Nr 2|Szamotuły|Kapłańska 18 |64-500 Szamotuły;1082;405;405;21;384;37.43;5.19
109576;302407;Świetlica wiejska|Kąsinowo| 54 |64-500 Szamotuły;1453;582;582;21;561;40.06;3.61
109577;302407;Zespół Szkół|Pamiątkowo|Szkolna 13 |64-514 Pamiątkowo;1922;1006;1006;27;979;52.34;2.68
109578;302407;Świetlica wiejska|Otorowo|Łąkowa 2 |64-551 Otorowo;1854;855;855;46;809;46.12;5.38
109579;302407;Pałac Gałowo|Gałowo|Wierzbowa 10 |64-500 Szamotuły;1731;728;728;38;690;42.06;5.22
109580;302407;Zespół Szkół Nr 2|Szamotuły|Szczuczyńska 3 |64-500 Szamotuły;1012;350;350;11;339;34.58;3.14
109581;302407;Szpital Powiatowy|Szamotuły|Sukiennicza 13 |64-500 Szamotuły;31;11;11;1;10;35.48;9.09
109582;302407;Areszt Śledczy|Szamotuły|Aleja 1 Maja 5 |64-500 Szamotuły;176;76;76;13;63;43.18;17.11
109583;302408;Wroniecki Ośrodek Kultury|Wronki|ul. Poznańska 59 |64-510 Wronki;1805;1022;1022;34;988;56.62;3.33
109584;302408;Szkoła Podstawowa Nr 1|Wronki|ul. Mickiewicza 5 |64-510 Wronki;1052;469;469;29;440;44.58;6.18
109585;302408;Szkoła Podstawowa Nr 1|Wronki|ul. Mickiewicza 5 |64-510 Wronki;1032;519;519;26;493;50.29;5.01
109586;302408;Gimnazjum im. Z. Herberta|Wronki|ul. Polna 5 |64-510 Wronki;1082;526;526;21;505;48.61;3.99
109587;302408;Przedszkole "Bajkowy Świat"|Wronki|os. Borek 20 |64-510 Wronki;1055;559;559;17;542;52.99;3.04
109588;302408;Przedszkole "Bajkowy Świat"|Wronki|os. Borek 20 |64-510 Wronki;1374;757;757;23;734;55.09;3.04
109589;302408;Zespół Szkół nr 1|Wronki|ul. Leśna 17 |64-510 Wronki;1708;938;938;10;928;54.92;1.07
109590;302408;Zespół Szkół Nr 1|Wronki|ul. Leśna 17 |64-510 Wronki;1077;442;442;24;418;41.04;5.43
109591;302408;Szkoła Podstawowa|Nowa Wieś|ul. Szkolna 5 |64-510 Wronki;1298;621;621;23;598;47.84;3.70
109592;302408;Zespół Szkół|Biezdrowo| 9 |64-510 Wronki;996;472;472;14;458;47.39;2.97
109593;302408;Zespół Szkół|Biezdrowo| 9 |64-510 Wronki;1693;758;758;44;714;44.77;5.80
109594;302408;Dom Kultury Chojno-Wieś|Chojno-Wieś| 10 |64-510 Wronki;788;329;329;27;302;41.75;8.21
109595;302408;Świetlica Zakładu Karnego|Wronki|Partyzantów 1 |64-510 Wronki;1342;426;426;53;373;31.74;12.44
109596;302501;Szkoła Podstawowa|Dominowo|ul.Centralna 3 |63-012 Dominowo;1057;478;478;36;442;45.22;7.53
109597;302501;Szkoła Podstawowa|Murzynowo Kościelne| 30 |63-014 Murzynowo Kościelne;636;284;284;14;270;44.65;4.93
109598;302501;Gimnazjum|Giecz| 25 |63-012 Dominowo;594;239;239;12;227;40.24;5.02
109599;302502;Zespół Szkół w Krzykosach|Krzykosy|ul. Główna 39 |63-024 Krzykosy;1259;612;612;19;593;48.61;3.10
109600;302502;Zespół Szkół w Pięczkowie|Pięczkowo|ul. Szkolna 5 |63-025 Pięczkowo;1410;609;609;29;580;43.19;4.76
109601;302502;Zespół Szkół w Sulęcinku|Sulęcinek|ul. Szkolna 26 |63-023 Sulęcinek;1646;733;733;24;709;44.53;3.27
109602;302502;Szkoła Podstawowa w Murzynowie Leśnym|Murzynowo Leśne|ul. Poznańska 74 |63-023 Murzynowo Leśne;1048;363;363;28;335;34.64;7.71
109603;302503;Szkoła Podstawowa w Boguszynie|Boguszyn|ul. Śremska 35 |63-041 Chocicza;1405;576;576;21;555;41.00;3.65
109604;302503;Zespół Szkół w Klęce|Klęka| 9 |63-040 Nowe Miasto nad Wartą;1665;614;614;31;583;36.88;5.05
109605;302503;Szkoła Podstawowa w Kolniczkach|Kolniczki| 11A |63-041 Chocicza;1085;437;437;26;411;40.28;5.95
109606;302503;Zespół Szkół w Nowym Mieście nad Wartą|Nowe Miasto nad Wartą|ul. Szkolna 2 |63-040 Nowe Miasto nad Wartą;1527;770;770;22;748;50.43;2.86
109607;302503;Zespół Szkół w Chociczy|Chocicza|ul. Śremska 30 |63-041 Chocicza;1457;627;627;22;605;43.03;3.51
109608;302504;Galeria Miejska Muzeum Ziemi Średzkiej "Dwór w Koszutach"|Środa Wielkopolska|ul. Stary Rynek 16 |63-000 Środa Wielkopolska;1087;465;465;22;443;42.78;4.73
109609;302504;Gimnazjum n 1|Środa Wielkopolska|ul. Lipowa 9 |63-000 Środa Wielkopolska;1087;538;538;17;521;49.49;3.16
109610;302504;Szkoła Podstawowa nr 3|Środa Wielkopolska|ul. 20 Października 2 |63-000 Środa Wielkopolska;1219;727;727;9;718;59.64;1.24
109611;302504;Przedszkole nr 3|Środa Wielkopolska|ul. Górki 5 |63-000 Środa Wielkopolska;1229;721;721;16;705;58.67;2.22
109612;302504;Szkoła Podstawowa nr 2|Środa Wielkopolska|ul. Dąbrowskiego 50 |63-000 Środa Wielkopolska;1116;615;616;19;596;55.11;3.09
109613;302504;Ośrodek Kultury|Środa Wielkopolska|ul. 20 Października 30 |63-000 Środa Wielkopolska;1305;647;647;15;632;49.58;2.32
109614;302504;Zespół Szkół Rolniczych|Środa Wielkopolska|ul. Kosynierów 2b |63-000 Środa Wielkopolska;1331;831;831;26;805;62.43;3.13
109615;302504;Gimnazjum nr 1|Środa Wielkopolska|ul. Lipowa 9 |63-000 Środa Wielkopolska;1138;531;531;16;515;46.66;3.01
109616;302504;Centrum Kształcenia Zawodowego i Ustawicznego|Środa Wielkopolska|ul. Paderewskiego 27 |63-000 Środa Wielkopolska;1117;690;690;18;672;61.77;2.61
109617;302504;Szkoła Podstawowa nr 3|Środa Wielkopolska|ul. 20 Października 2 |63-000 Środa Wielkopolska;1219;676;676;26;650;55.46;3.85
109618;302504;Przedszkole nr 4|Środa Wielkopolska|ul. Staszica 10 |63-000 Środa Wielkopolska;1256;758;758;15;743;60.35;1.98
109619;302504;Szkoła Podstawowa Nr 2|Środa Wielkopolska|ul. Dąbrowskiego 50 |63-000 Środa Wielkopolska;1169;640;640;28;612;54.75;4.38
109620;302504;Szkoła Podstawowa nr 2|Środa Wielkopolska|ul. Dąbrowskiego 50 |63-000 Środa Wielkopolska;1107;577;577;13;564;52.12;2.25
109621;302504;Przedszkole nr 2|Środa Wielkopolska|ul. Kościuszki 12 |63-000 Środa Wielkopolska;1213;700;700;21;679;57.71;3.00
109622;302504;Ośrodek Kultury|Środa Wielkopolska|ul. 20 Października 30 |63-000 Środa Wielkopolska;1164;687;687;24;663;59.02;3.49
109623;302504;Niepubliczna Szkoła Podstawowa|Jarosławiec| 34a |63-000 Środa Wielkopolska;1058;414;415;19;395;39.13;4.59
109624;302504;Szkoła Podstawowa|Starkowiec Piątkowski| 2b |63-000 Środa Wielkopolska;1185;460;460;21;439;38.82;4.57
109625;302504;Niepubliczna Szkoła Podstawowa|Brodowo|ul. Szkolna 1 |63-000 Środa Wielkopolska;1226;450;450;15;435;36.70;3.33
109626;302504;Zespół Szkoły Podstawowej i Gimnazjum|Słupia Wielka| 28 |63-000 Środa Wielkopolska;1216;610;610;20;590;50.16;3.28
109627;302504;Niepubliczna Szkoła Podstawowa|Pławce| 38 |63-000 Środa Wielkopolska;1113;368;368;21;347;33.06;5.71
109628;302504;Dom Ludowy|Janowo| 100 |63-000 Środa Wielkopolska;1140;445;445;14;431;39.04;3.15
109629;302504;Szpital Średzki Sp.z o.o.|Środa Wielkopolska|Żwirki i Wigury 10 |63-000 Środa Wielkopolska;32;6;6;1;5;18.75;16.67
109630;302504;Areszt Śledczy|Środa Wielkopolska|Gancarska 1 |63-000 Środa Wielkopolska;78;51;51;9;42;65.38;17.65
109631;302505;Szkoła Podstawowa|Zaniemyśl|ul. Poznańska 28 |63-020 Zaniemyśl;1416;586;586;26;560;41.38;4.44
109632;302505;Gminny Ośrodek Kultury i Rekreacji|Zaniemyśl|ul. Sienkiewicza 3 |63-020 Zaniemyśl;2098;1288;1288;44;1244;61.39;3.42
109633;302505;Szkoła Podstawowa|Czarnotki| 47 |63-020 Zaniemyśl;772;307;307;12;295;39.77;3.91
109634;302505;Szkoła Podstawowa|Śnieciska|ul. Parkowa 3 |63-021 Śnieciska;996;425;425;23;402;42.67;5.41
109635;302601;Szkoła Podstawowa|Brodnica| 66 |63-112 Brodnica;1249;472;472;42;430;37.79;8.90
109636;302601;Szkoła Podstawowa|Iłówiec| 16 |63-112 Brodnica;952;331;331;18;313;34.77;5.44
109637;302601;Szkoła Podstawowa|Manieczki|ul. Szkolna 6 |63-112 Brodnica;1039;451;451;12;439;43.41;2.66
109638;302601;Szkoła Podstawowa|Żabno| 6 |63-112 Brodnica;617;319;319;13;306;51.70;4.08
109639;302602;Sala widowiskowa|Dolsk|pl. Wyzwolenia 3 |63-140 Dolsk;1261;616;616;21;595;48.85;3.41
109640;302602;Szkoła Podstawowa im. Janusza Kusocińskiego w Dolsku Filia Małachowo|Małachowo| 36 |63-140 Dolsk;902;263;263;12;251;29.16;4.56
109641;302602;Świetlica Wiejska|Ostrowieczno| 34 |63-140 Dolsk;615;192;192;8;184;31.22;4.17
109642;302602;Przedszkole Samorządowe|Wieszczyczyn|ul. Ks. Marciniaka 35 |63-140 Dolsk;864;352;352;9;343;40.74;2.56
109643;302602;Gimnazjum im. Powstańców Wielkopolskich w Dolsku|Dolsk|ul. Kościańska 8 |63-140 Dolsk;955;350;350;16;334;36.65;4.57
109644;302603;Szkoła Podstawowa|Książ Wielkopolski|Stacha Wichury 27 |63-130 Książ Wielkopolski;2165;961;961;51;910;44.39;5.31
109645;302603;Szkoła Podstawowa|Książ Wielkopolski|Stacha Wichury 27 |63-130 Książ Wielkopolski;1587;563;563;40;523;35.48;7.10
109646;302603;Zespół Szkół|Mchy| 39 |63-130 Książ Wielkopolski;1815;728;728;37;691;40.11;5.08
109647;302603;Szkoła Podstawowa|Konarzyce|Szkolna 6 |63-130 Książ Wielkopolski;1053;375;375;27;348;35.61;7.20
109648;302604;Szkoła Podstawowa Nr 4|Śrem|ul. Stefana Grota Roweckiego 10 |63-100 Śrem;1369;746;746;12;734;54.49;1.61
109649;302604;Klub "Relax" Spółdzielni Mieszkaniowej w Śremie|Śrem|ul. Dezyderego Chłapowskiego 3 |63-100 Śrem;1469;742;742;37;705;50.51;4.99
109650;302604;Przedszkole Nr 3 w Śremie|Śrem|ul. Tadeusza Bora Komorowskiego 3 |63-100 Śrem;1410;789;789;13;776;55.96;1.65
109651;302604;Gimnazjum nr 1 w Śremie|Śrem|ul. Dezyderego Chłapowskiego 12A |63-100 Śrem;1862;1008;1009;30;978;54.14;2.98
109652;302604;Przedszkole nr 5 w Śremie|Śrem|ul. Tadeusza Bora Komorowskiego 4 |63-100 Śrem;1589;850;850;21;829;53.49;2.47
109653;302604;Przedszkole nr 7 w Śremie|Śrem|ul. Dezyderego Chłapowskiego 12A |63-100 Śrem;1769;957;957;20;937;54.10;2.09
109654;302604;Szkoła Podstawowa nr 6 w Śremie|Śrem|ul. Konstytucji 3 Maja 2 |63-100 Śrem;1571;812;812;26;786;51.69;3.20
109655;302604;Szkoła Podstawowa Nr 6 w Śremie|Śrem|ul. Konstytucji 3 Maja 2 |63-100 Śrem;1535;846;846;33;813;55.11;3.90
109656;302604;Przedszkole "Słoneczna Szóstka" w Śremie|Śrem|ul. Konstytucji 3 Maja 2 |63-100 Śrem;1412;712;712;12;700;50.42;1.69
109657;302604;Salka Parafialna przy Parafii Rzymskokatolickiej p.w. Bł. Michała Kozala Bpa i M w Śremie|Śrem|Jacka Malczewskiego 8 |63-100 Śrem;1595;958;958;26;932;60.06;2.71
109658;302604;Szkoła Podstawowa nr 1 w Śremie|Śrem|ul. Jana Kochanowskiego 2 |63-100 Śrem;1597;827;827;31;796;51.78;3.75
109659;302604;Ośrodek Pomocy Społecznej w Śremie|Śrem|ul. Adama Mickiewicza 40 |63-100 Śrem;1186;601;601;23;578;50.67;3.83
109660;302604;Budynek gminny w Śremie|Śrem|ul. Jana Kilińskiego 2 |63-100 Śrem;1339;710;710;33;677;53.02;4.65
109661;302604;Zespół Szkół Politechnicznych w Śremie|Śrem|ul. Ks. Jerzego Popiełuszki 30 |63-100 Śrem;1569;624;624;23;601;39.77;3.69
109662;302604;Zespół Szkoły Podstawowej i Gimnazjum w Śremie|Śrem|ul. Szkolna 4 |63-100 Śrem;1923;899;899;32;867;46.75;3.56
109663;302604;Świetlica wsi Psarskie|Psarskie|ul. Owocowa 6 |63-100 Śrem;1681;908;908;32;876;54.02;3.52
109664;302604;Zespół Szkoły Podstawowej i Gimnazjum w Zbrudzewie|Zbrudzewo|ul. Śremska 49 |63-100 Śrem;1068;475;475;27;448;44.48;5.68
109665;302604;Zespół Szkoły Podstawowej i Gimnazjum w Dąbrowie|Dąbrowa|ul. Śremska 2 |63-100 Śrem;1210;550;550;17;533;45.45;3.09
109666;302604;Szkoła Podstawowa w Pyszącej|Pysząca|ul. Śremska 12 |63-100 Śrem;1401;605;605;26;579;43.18;4.30
109667;302604;Zespół Szkoły Podstawowej i Gimnazjum w Nochowie|Nochowo|ul. Szkolna 5 |63-100 Śrem;1577;808;808;22;786;51.24;2.72
109668;302604;Świetlica wsi Błociszewo|Błociszewo|ul. Kasztanowa 3 |63-100 Śrem;794;301;301;14;287;37.91;4.65
109669;302604;Świetlica wsi Wyrzeka|Wyrzeka|ul. Ks. Piotra Wawrzyniaka 13 |63-100 Śrem;958;444;444;13;431;46.35;2.93
109670;302604;Dom Pomocy Społecznej w Psarskiem|Psarskie|Owocowa 8 |63-100 Śrem;105;48;48;9;39;45.71;18.75
109671;302604;Zakład Pielęgnacyjno-Opiekuńczy Samodzielny Publiczny Zakład Opieki Zdrowotnej w Śremie|Śrem|ul. Promenada 7 |63-100 Śrem;79;51;51;2;49;64.56;3.92
109672;302604;Dom Pomocy Społecznej w Śremie|Śrem|ul. Farna 16 |63-100 Śrem;59;17;17;2;15;28.81;11.76
109673;302604;Szpital w Śremie Spółka z o.o.|Śrem|ul. Józefa Chełmońskiego 1 |63-100 Śrem;140;43;43;2;41;30.71;4.65
109674;302604;Areszt Śledczy w Śremie|Śrem|Ks. Piotra Wawrzyniaka 6 |63-100 Śrem;131;80;80;6;74;61.07;7.50
109675;302701;Szkoła Podstawowa Nr 4|Turek|ul. Sportowa 9 |62-700 Turek;1171;593;593;12;581;50.64;2.02
109676;302701;Klub Spółdzielni Mieszkaniowej "Tęcza"|Turek|ul. Spółdzielców 4 |62-700 Turek;2111;918;918;32;886;43.49;3.49
109677;302701;Szkoła Podstawowa Nr 4|Turek|ul. Sportowa 9 |62-700 Turek;1166;596;596;21;575;51.11;3.52
109678;302701;Szkoła Podstawowa Nr 1|Turek|ul. 3 Maja 29 |62-700 Turek;1216;655;655;15;640;53.87;2.29
109679;302701;Szkoła Podstawowa Nr 1|Turek|ul. 3 Maja 29 |62-700 Turek;1117;639;639;14;625;57.21;2.19
109680;302701;Przedszkole Nr 4|Turek|ul. Stawickiego 7 |62-700 Turek;1047;498;499;16;482;47.56;3.21
109681;302701;Przedszkole Nr 8|Turek|ul. Browarna 5 |62-700 Turek;1129;431;431;10;421;38.18;2.32
109682;302701;Zespół Szkół Technicznych|Turek|ul. Milewskiego 3b |62-700 Turek;1194;666;666;14;652;55.78;2.10
109683;302701;Gimnazjum Nr 2|Turek|ul. Parkowa 3 |62-700 Turek;1239;762;762;13;749;61.50;1.71
109684;302701;Gimnazjum Nr 2|Turek|ul. Parkowa 3 |62-700 Turek;1074;579;579;14;565;53.91;2.42
109685;302701;Przedszkole Nr 7|Turek|ul. Os. Wyzwolenia 1a |62-700 Turek;2022;1028;1028;26;1002;50.84;2.53
109686;302701;Przedszkole Nr 4|Turek|ul. Stawickiego 7 |62-700 Turek;1030;536;536;8;528;52.04;1.49
109687;302701;Gimnazjum Nr 1|Turek|ul. Broniewskiego 5 |62-700 Turek;1201;609;609;14;595;50.71;2.30
109688;302701;Przedszkole Nr 5|Turek|ul. Gen. Smorawińskiego 2 |62-700 Turek;1805;901;901;24;877;49.92;2.66
109689;302701;Szkoła Podstawowa Nr 5|Turek|ul. Os. Wyzwolenia 7a |62-700 ;2101;1063;1063;35;1028;50.59;3.29
109690;302701;Szkoła Podstawowa Nr 5|Turek|ul. Os. Wyzwolenia 7a |62-700 Turek;1111;618;618;13;605;55.63;2.10
109691;302701;Gimnazjum Nr 1|Turek|ul. Broniewskiego 5 |62-700 Turek;1071;592;592;5;587;55.28;0.84
109692;302701;SP ZOZ Turek|Turek|Poduchowne 1 |62-700 Turek;69;34;34;3;31;49.28;8.82
109693;302702;Zespół Szkolno-Gimnazjalny w Brudzewie|Brudzew|ul. Powstańców Wielkopolskich 35 |62-720 Brudzew;1182;550;550;18;532;46.53;3.27
109694;302702;Zespół Szkolno-Gimnazjalny w Brudzewie|Brudzew|ul. Powstańców Wielkopolskich 35 |62-720 Brudzew;1256;566;566;26;540;45.06;4.59
109695;302702;Szkoła Podstawowa w Koźminie|Koźmin| 2 |62-720 Brudzew;223;57;57;4;53;25.56;7.02
109696;302702;Szkoła Podstawowa w Koźminie|Koźmin| 2 |62-720 Brudzew;854;369;369;18;351;43.21;4.88
109697;302702;Szkoła Podstawowa w Koźminie filia w Krwonach|Krwony| 32 |62-720 Brudzew;385;169;169;14;155;43.90;8.28
109698;302702;Szkoła Podstawowa w Galewie|Galew| 7 |62-720 Brudzew;869;404;404;17;387;46.49;4.21
109699;302703;Zespół Szkolno-Przedszkolny w Dobrej|Długa Wieś| 28 |62-730 Dobra;1426;711;711;36;675;49.86;5.06
109700;302703;Centrum Kultury w Dobrej|Dobra|ul. Dekerta 34 |62-730 Dobra;1287;547;547;24;523;42.50;4.39
109701;302703;Strażnica OSP w Miłkowicach|Miłkowice| 36 |62-730 Dobra;823;342;342;17;325;41.56;4.97
109702;302703;Szkoła Filialna w Piekarach|Piekary| 49 |62-730 Dobra;768;357;357;8;349;46.48;2.24
109703;302703;Strażnica OSP w Dąbrowicy|Dąbrowica-Kolonia| 36 |62-730 Dobra;337;146;146;6;140;43.32;4.11
109704;302703;Dom Pomocy Społecznej w Skęczniewie|Skęczniew| 58 |62-730 Dobra;379;162;162;14;148;42.74;8.64
109705;302704;Zespół Szkół|Kawęczyn| 49 a|62-704 Kawęczyn;953;421;421;32;389;44.18;7.60
109706;302704;Szkoła Podstawowa|Tokary Pierwsze| 43 a|62-704 Kawęczyn;1294;460;460;19;441;35.55;4.13
109707;302704;Szkoła Podstawowa|Skarżyn| 26a |62-704 Kawęczyn;529;200;200;4;196;37.81;2.00
109708;302704;Zespół Szkół|Kowale Pańskie-Kolonia| 34 |62-704 Kawęczyn;1450;769;769;35;734;53.03;4.55
109709;302705;Szkoła Podstawowa|Dziadowice| 22 |62-709 Malanów;1431;486;486;29;457;33.96;5.97
109710;302705;Szkoła Podstawowa|Malanów|ul. Szkolna 14 |62-709 Malanów;1393;479;479;28;451;34.39;5.85
109711;302705;Szkoła Podstawowa|Miłaczew| 34 |62-709 Malanów;900;338;338;19;319;37.56;5.62
109712;302705;Gimnazjum|Malanów|ul. Parkowa 29 |62-709 Malanów;1415;628;628;21;607;44.38;3.34
109713;302706;Zespół Szkół w Przykonie Gimnazjum w Przykonie|Przykona|ul. Szkolna 4a |62-731 Przykona;2044;937;937;32;905;45.84;3.42
109714;302706;Szkoła Podstawowa w Boleszczynie|Boleszczyn| 67 |62-731 Przykona;1088;479;479;12;467;44.03;2.51
109715;302706;Szkoła Podstawowa w Sarbicach|Sarbice| 4 |62-731 Przykona;423;181;181;9;172;42.79;4.97
109716;302707;Zespół Szkół|Tuliszków|ul. Nortowska 1 |62-740 Tuliszków;1617;722;722;21;701;44.65;2.91
109717;302707;Zespół Szkół|Tuliszków|ul. Nortowska 1 |62-740 Tuliszków;1104;489;489;9;480;44.29;1.84
109718;302707;Miejsko-Gminny Ośrodek Kultury|Tuliszków|ul. M. Buczka 2 |62-740 Tuliszków;2217;877;877;42;835;39.56;4.79
109719;302707;Szkoła Podstawowa|Ogorzelczyn| 3 |62-740 Tuliszków;930;381;381;21;360;40.97;5.51
109720;302707;Zespół Szkolno-Przedszkolny|Grzymiszew|ul. Nowa 2 |62-740 Tuliszków;1868;751;751;42;709;40.20;5.59
109721;302707;Szkoła Podstawowa (filia Grzymiszew)|Smaszew| 33 |62-740 Tuliszków;694;257;257;16;241;37.03;6.23
109722;302708;Szkoła Podstawowa im.Józefa Mehoffera w Chlebowie|Chlebów| 15 |62-700 Turek;939;356;356;13;343;37.91;3.65
109723;302708;Szkoła Podstawowa im.Jana Pawła II w Kaczkach Średnich|Kaczki Średnie| 63 |62-700 Turek;548;236;236;13;223;43.07;5.51
109724;302708;Zespół Szkolno-Przedszkolny Słodkowie|Słodków| 21 |62-700 Turek;1549;695;695;36;659;44.87;5.18
109725;302708;Bursa Szkolna w Turku|Turek|Al. J. Piłsudskiego 5 |62-700 Turek;1639;797;797;17;780;48.63;2.13
109726;302708;Szkoła Podstawowa im.Marii Skłodowskiej-Curie w Żukach|Żuki| 92 |62-700 Turek;455;197;197;5;192;43.30;2.54
109727;302708;Szkoła Podstawowa im.Marii Konopnickiej w Turkowicach|Turkowice|ul.Jaśminowa 3 |62-700 Turek;703;329;329;15;314;46.80;4.56
109728;302708;Szkoła Podstawowa w Cisewie|Cisew| 55 |62-700 Turek;905;418;418;16;402;46.19;3.83
109729;302708;Wiejskie Centrum Lokalnej Aktywności w Kowalach Księżych|Kowale Księże| 38a |62-700 Turek;319;153;153;2;151;47.96;1.31
109730;302709;Strażnica OSP Międzylesie|Międzylesie| 10 |62-710 Władysławów;991;470;470;25;445;47.43;5.32
109731;302709;Zespół Szkół we Władysławowie|Władysławów|ul. Jagiellońska 1 B |62-710 Władysławów;1217;713;713;25;688;58.59;3.51
109732;302709;Szkoła Podstawowa w Natalii|Natalia| 22 |62-710 Władysławów;466;197;197;4;193;42.27;2.03
109733;302709;Szkoła Podstawowa w Wyszynie|Wyszyna|ul. Turkowska 1 |62-710 Władysławów;1308;652;652;26;626;49.85;3.99
109734;302709;Szkoła Podstawowa w Kunach|Kuny| 137 |62-710 Władysławów;791;346;346;23;323;43.74;6.65
109735;302709;Szkoła Podstawowa w Chylinie|Chylin| 87A |62-710 Władysławów;827;342;342;19;323;41.35;5.56
109736;302709;Dom Parafialny w Russocicach|Russocice| 19A |62-710 Władysławów;847;431;431;11;420;50.89;2.55
109737;302801;Szkoła Podstawowa Nr 3|Wągrowiec|ul. Letnia 1 |62-100 Wągrowiec;2134;1089;1089;19;1070;51.03;1.74
109738;302801;Miejski Dom Kultury|Wągrowiec|ul. Kościuszki 55 |62-100 Wągrowiec;1938;900;900;24;876;46.44;2.67
109739;302801;Miejska Biblioteka Publiczna|Wągrowiec|ul. Średnia 18 |62-100 Wągrowiec;1929;990;990;19;971;51.32;1.92
109740;302801;Szkoła Podstawowa nr 4|Wągrowiec|ul. Reja 10 |62-100 Wągrowiec;2051;994;994;20;974;48.46;2.01
109741;302801;Gimnazjum nr 1|Wągrowiec|ul. Św. Wojciecha 20 |62-100 Wągrowiec;1102;654;654;15;639;59.35;2.29
109742;302801;Szkoła Podstawowa nr 2|Wągrowiec|ul. Krótka 4 |62-100 Wągrowiec;1422;655;655;25;630;46.06;3.82
109743;302801;Zespół Szkół Ponadgimnazjalnych nr 1|Wągrowiec|ul. Kcyńska 48 |62-100 Wągrowiec;1616;791;791;29;762;48.95;3.67
109744;302801;Liceum Ogólnokształcące|Wągrowiec|ul. Klasztorna 17A |62-100 Wągrowiec;2206;827;827;23;804;37.49;2.78
109745;302801;Miejskie Przedsiębiorstwo Wodociągów i Kanalizacji Spółka z o.o.|Wągrowiec|ul. Janowiecka 100 |62-100 Wągrowiec;1812;919;919;25;894;50.72;2.72
109746;302801;Biblioteka Pedagogiczna|Wągrowiec|Wierzbowa 1 |62-100 Wągrowiec;1764;840;840;44;796;47.62;5.24
109747;302801;Spółdzielnia Mieszkaniowa|Wągrowiec|Osiedle Wschód 11 |62-100 Wągrowiec;1823;986;986;21;965;54.09;2.13
109748;302801;Szpital Powiatowy|Wągrowiec|Kościuszki 74 |62-100 Wągrowiec;93;29;29;2;27;31.18;6.90
109749;302802;Gminny Ośrodek Kultury|Damasławek|ul. Żnińska 9 |62-110 Damasławek;1678;849;849;33;816;50.60;3.89
109750;302802;Świetlica wiejska|Międzylesie| . |62-110 Damasławek;532;186;186;14;172;34.96;7.53
109751;302802;Świetlica wiejska|Niemczyn| . |62-110 Damasławek;1537;579;579;50;529;37.67;8.64
109752;302802;Świetlica wiejska|Mokronosy| . |62-110 Damasławek;609;237;237;10;227;38.92;4.22
109753;302803;Przedszkole Publiczne|Gołańcz|ul. Karola Libelta 1 |62-130 Gołańcz;1746;696;696;40;656;39.86;5.75
109754;302803;Gołaniecki Ośrodek Kultury|Gołańcz|ul. Dr Piotra Kowalika 1 |62-130 Gołańcz;1921;837;837;41;796;43.57;4.90
109755;302803;Zespół Szkół Ponadgimnazjalnych|Gołańcz|ul. Walki Młodych 35 |62-130 Gołańcz;841;316;316;20;296;37.57;6.33
109756;302803;Świetlica wiejska w Chojnie|Chojna| 55 |62-130 Gołańcz;710;235;235;17;218;33.10;7.23
109757;302803;Świetlica wiejska w Czesławicach|Czesławice| 20 |62-130 Gołańcz;462;162;162;16;146;35.06;9.88
109758;302803;Zespół Szkół w Panigrodzu|Panigródz| 24 |62-130 Gołańcz;493;203;203;27;176;41.18;13.30
109759;302803;Świetlica wiejska w Czeszewie|Czeszewo| 58 |62-130 Gołańcz;372;142;142;8;134;38.17;5.63
109760;302804;Sala widowiskowa Domu Kultury|Mieścisko|ul. Kościuszki 11 |62-290 Mieścisko;1953;853;853;31;822;43.68;3.63
109761;302804;Świetlica wiejska|Kłodzin| 28 |62-290 Mieścisko;335;135;135;7;128;40.30;5.19
109762;302804;Szkoła Podstawowa Milenium im. Jana Pawła II|Popowo Kościelne| 21 |62-285 Popowo Kościelne;1298;472;472;17;455;36.36;3.60
109763;302804;Świetlica wiejska|Żabiczyn| 28 |62-290 Mieścisko;266;78;78;3;75;29.32;3.85
109764;302804;Gminne Centrum Informacji z Klubem Pracy|Mieścisko|ul. Kościuszki 11 |62-290 Mieścisko;876;262;262;14;248;29.91;5.34
109765;302805;Szkoła Podstawowa|Skoki|ul. Poznańska 2 |62-085 Skoki;945;484;484;12;472;51.22;2.48
109766;302805;Przedszkole Samorządowe|Skoki|ul. Henryka Sienkiewicza 19 |62-085 Skoki;1045;568;568;19;549;54.35;3.35
109767;302805;Przedszkole Samorządowe|Skoki|ul. Henryka Sienkiewicza 19 |62-085 Skoki;1305;673;673;25;648;51.57;3.71
109768;302805;Świetlica Wiejska|Kakulin| 17A |62-285 Kakulin;619;188;188;8;180;30.37;4.26
109769;302805;Świetlica Wiejska|Bliżyce| 28A |62-085 Bliżyce;458;129;129;11;118;28.17;8.53
109770;302805;Świetlica Wiejska|Rejowiec| 34 |62-093 Rejowiec;1127;371;371;12;359;32.92;3.23
109771;302805;Świetlica Wiejska|Potrzanowo|ul. Skocka 45 |62-085 Potrzanowo;640;268;268;8;260;41.88;2.99
109772;302805;Szkoła Podstawowa|Lechlin| 9 |62-085 Lechlin;1068;391;391;25;366;36.61;6.39
109773;302806;Zespół Szkół|Wapno|Pl. Mickiewicza 2 |62-120 Wapno;1742;599;599;28;571;34.39;4.67
109774;302806;Dom Pomocy Społecznej|Srebrna Góra| 62 |62-120 Wapno;679;253;253;14;239;37.26;5.53
109775;302807;Gimnazjum Nr 1|Wągrowiec|ul. Kolejowa 14 |62-100 Wągrowiec;1886;779;779;9;770;41.30;1.16
109776;302807;Świetlica Wiejska|Łaziska| 51 |62-100 Wągrowiec;756;357;357;20;337;47.22;5.60
109777;302807;Świetlica Wiejska|Sienno| 26b |62-100 Wągrowiec;1160;446;446;15;431;38.45;3.36
109778;302807;Zespół Szkół|Żelice| 14A |62-113 Żelice;1647;526;526;23;503;31.94;4.37
109779;302807;Wiejski Ośrodek Integracji i Aktywizacji Wsi|Pawłowo Żońskie| 13a |62-104 Pawłowo Żońskie;1284;518;518;24;494;40.34;4.63
109780;302807;Zespół Szkolno - Przedszkolny|Łekno|Pocztowa 7 |62-105 Łekno;1862;773;773;30;743;41.51;3.88
109781;302807;Gimnazjum nr 3|Rąbczyn| 61 |62-106 Rąbczyn;562;183;183;20;163;32.56;10.93
109782;302901;Zespół Szkół Gimnazjum i Szkoła Podstawowa w Buczu|Bucz|ul. Kasztanowa 8 |64-234 Przemęt;1541;676;676;51;625;43.87;7.54
109783;302901;Sala wiejska Poświętno|Poświętno| 3 |64-234 Przemęt;705;275;275;16;259;39.01;5.82
109784;302901;Zespół Szkolno-Przedszkolny w Kluczewie|Kluczewo|ul. Szkolna 19 |64-234 Przemęt;911;344;344;12;332;37.76;3.49
109785;302901;Zespół Szkół w Przemęcie|Przemęt|ul. Szkolna 1 |64-234 Przemęt;2029;881;881;43;838;43.42;4.88
109786;302901;Zespół Szkół Gimnazjum i Szkoła Podstawowa w Mochach|Mochy|ul. Wolsztyńska 4 |64-234 Przemęt;2104;820;820;47;773;38.97;5.73
109787;302901;Zespół Szkół Gimnazjum, Szkoła Podstawowa i Przedszkole Samorządowe z Oddziałem Integracyjnym w Kaszczorze|Kaszczor|ul. Cysterska 9 |64-234 Przemęt;1643;819;819;33;786;49.85;4.03
109788;302901;Stowarzyszenie Przyjaciół Zespołu Szkolno-Przedszkolnego w Radomierzu|Radomierz|ul. Słoneczna 8 |64-234 Przemęt;1420;586;586;22;564;41.27;3.75
109789;302901;Przedszkole Samorządowe w Nowej Wsi|Nowa Wieś|ul. Przemęcka 22 |64-234 Przemęt;634;253;253;17;236;39.91;6.72
109790;302902;Gminny Ośrodek Kultury|Siedlec|Zbąszyńska 19 |64-212 Siedlec;1499;756;756;25;731;50.43;3.31
109791;302902;Świetlica Wiejska|Jaromierz| |64-225 Kopanica;804;293;293;25;268;36.44;8.53
109792;302902;Świetlica Wiejska|Żodyń| |64-212 Siedlec;740;347;347;14;333;46.89;4.03
109793;302902;Świetlica Ochotniczej Straży Pożarnej|Kopanica|Zbąszyńska 29 |64-225 Kopanica;1211;607;607;33;574;50.12;5.44
109794;302902;Zespół Przedszkola, Szkoły Podstawowej i Gimnazjum|Chobienice| |64-214 Chobienice;1407;624;624;26;598;44.35;4.17
109795;302902;Świetlica Wiejska|Tuchorza| |64-232 Tuchorza;1366;703;703;40;663;51.46;5.69
109796;302902;Świetlica Ochotniczej Straży Pożarnej|Boruja| |64-232 Tuchorza;421;193;193;13;180;45.84;6.74
109797;302902;Świetlica Wiejska|Belęcin| |64-231 Belęcin;1047;441;441;42;399;42.12;9.52
109798;302902;Świetlica Wiejska|Reklin| |64-212 Siedlec;1126;446;446;18;428;39.61;4.04
109799;302903;Gminny Żłobek|Wolsztyn|ul. Komorowska 1 |64-200 Wolsztyn;1085;602;602;11;591;55.48;1.83
109800;302903;Zespół Szkół Specjalnych|Wolsztyn|ul. 5 Stycznia 14 |64-200 Wolsztyn;1234;646;646;19;627;52.35;2.94
109801;302903;Zespół Szkół Ogólnokształcącycych|Wolsztyn|ul. Poniatowskiego 7 |64-200 Wolsztyn;1476;865;865;19;846;58.60;2.20
109802;302903;Szkoła Podstawowa Nr 5 z Oddziałami Integracyjnymi|Wolsztyn|ul. Żegockiego 26 |64-200 Wolsztyn;2309;1324;1324;42;1282;57.34;3.17
109803;302903;Przedszkole Nr 3|Wolsztyn|ul. Kusocińskiego 2 |64-200 Wolsztyn;880;512;512;14;498;58.18;2.73
109804;302903;Zespół Szkół Zawodowych|Wolsztyn|ul. Kusocińskiego 1 |64-200 Wolsztyn;2169;1243;1243;28;1215;57.31;2.25
109805;302903;Szkoła Podstawowa Nr 3 z Oddziałami Integracyjnymi|Wolsztyn|ul. Konopnickiej 1 |64-200 Wolsztyn;1354;773;773;21;752;57.09;2.72
109806;302903;Gimnazjum Nr 1 z Oddziałami Integracyjnymi|Wolsztyn|ul. Wschowska 15 |64-200 Wolsztyn;771;407;407;8;399;52.79;1.97
109807;302903;Świetlica wiejska|Niałek Wielki| 30 |64-200 Wolsztyn;598;371;371;15;356;62.04;4.04
109808;302903;Zespół Szkolno - Gimnazjalny|Obra|ul. Szkolna 19 |64-211 Obra;1768;879;879;54;825;49.72;6.14
109809;302903;Zespół Szkolno - Przedszkolny|Kębłowo|ul. Wolsztyńska 19 |64-223 Kębłowo;1480;617;617;49;568;41.69;7.94
109810;302903;Wiejski Dom Kultury|Świętno|ul. Poprzeczna 2 |64-224 Świętno;928;378;378;17;361;40.73;4.50
109811;302903;Szkoła Podstawowa|Wroniawy|ul. Dworcowa 33 |64-200 Wolsztyn;1030;435;435;14;421;42.23;3.22
109812;302903;Szkoła Podstawowa|Stary Widzim| 24 |64-200 Wolsztyn;1091;525;525;22;503;48.12;4.19
109813;302903;Zespół Szkół Rolniczych i Technicznych|Powodowo| 1 |64-200 Wolsztyn;429;210;210;20;190;48.95;9.52
109814;302903;Przedszkole|Chorzemin| 78 |64-200 Wolsztyn;654;287;287;23;264;43.88;8.01
109815;302903;Szkoła Podstawowa w Starym Widzimiu, Szkoła Filialna w Adamowie|Adamowo| 56 |64-200 Wolsztyn;801;400;400;15;385;49.94;3.75
109816;302903;Sala wiejska|Nowe Tłoki| 28C |64-200 Wolsztyn;481;253;253;9;244;52.60;3.56
109817;302903;Szkoła Podstawowa Nr 1 w Wolsztynie, Szkoła Filialna w Tłokach|Tłoki| 43 |64-200 Wolsztyn;577;248;248;18;230;42.98;7.26
109818;302903;Salka katechetyczna|Gościeszyn| 19 |64-200 Wolsztyn;1097;393;393;21;372;35.82;5.34
109819;302903;Szkoła Podstawowa|Karpicko|ul. Wczasowa 72 |64-200 Wolsztyn;1289;696;696;27;669;54.00;3.88
109820;302903;Dom Pomocy Społecznej|Wolsztyn|Poznańska 29 |64-200 Wolsztyn;80;49;49;0;49;61.25;0.00
109821;302903;Samodzielny Publiczny Zakład Opieki Zdrowotnej|Wolsztyn|Wschowska 3 |64-200 Wolsztyn;124;39;39;0;39;31.45;0.00
109822;303001;Sala Urzędu Gminy w Kołaczkowie|Kołaczkowo|pl. Reymonta 3 |62-306 Kołaczkowo;1283;624;624;25;599;48.64;4.01
109823;303001;Szkoła Podstawowa w Sokolnikach|Sokolniki|ul. Leśna 1 |62-305 Sokolniki;1309;521;521;25;496;39.80;4.80
109824;303001;Świetlica wiejska we Wszemborzu|Wszembórz| 70 A |62-306 Kołaczkowo;500;250;250;8;242;50.00;3.20
109825;303001;Szkoła Podstawowa w Bieganowie|Bieganowo| 43 |62-305 Sokolniki;925;315;315;16;299;34.05;5.08
109826;303001;Szkoła Podstawowa w Grabowie Król.|Grabowo Królewskie| 1 |62-306 Kołaczkowo;701;273;273;17;256;38.94;6.23
109827;303002;Miłosławskie Centrum Kultury|Miłosław|ul. Różowa 6 |62-320 Miłosław;1931;874;874;31;843;45.26;3.55
109828;303002;Szkoła Podstawowa|Bugaj| 7 |62-320 Miłosław;1445;543;543;28;515;37.58;5.16
109829;303002;Międzynarodowy Dom Spotkań Młodzieży|Mikuszewo| 23 |62-320 Miłosław;522;246;246;11;235;47.13;4.47
109830;303002;Zespół Szkół|Orzechowo|ul. Szkolna 18 |62-322 Orzechowo;1872;877;877;41;836;46.85;4.68
109831;303002;Świetlica Wiejska|Czeszewo|ul. Słoneczna 25 |62-322 Orzechowo;705;302;302;21;281;42.84;6.95
109832;303002;Świetlica Wiejska|Biechowo| 1 |62-320 Miłosław;855;287;287;7;280;33.57;2.44
109833;303002;Urząd Gminy|Miłosław|ul. Wrzesińska 19 |62-320 Miłosław;936;483;483;17;466;51.60;3.52
109834;303003;Zespół Szkół w Nekli|Nekla|ul. Klemensa Szczepańskiego 7 |62-330 Nekla;1952;957;957;39;918;49.03;4.08
109835;303003;Zespół Szkół w Nekli|Nekla|ul. Klemensa Szczepańskiego 7 |62-330 Nekla;1953;971;971;42;929;49.72;4.33
109836;303003;Zespół Szkół w Zasutowie|Zasutowo|ul. Kwiatowa 5 |62-330 Nekla;861;387;387;22;365;44.95;5.68
109837;303003;Zespół Szkół w Targowej Górce|Targowa Górka|ul. Karśnickiego 2 |62-330 Nekla;985;381;381;25;356;38.68;6.56
109838;303004;Remiza OSP|Pyzdry|ul. Kilińskiego 15 |62-310 Pyzdry;1553;689;689;20;669;44.37;2.90
109839;303004;Przedszkole Publiczne|Pyzdry|ul. Jana Pawła II 10 |62-310 Pyzdry;1195;595;595;21;574;49.79;3.53
109840;303004;Środowiskowy Dom Samopomocy|Pietrzyków| 49 |62-310 Pyzdry;845;331;331;28;303;39.17;8.46
109841;303004;Filia Samorządowej Szkoły Podstawowej w Pyzdrach|Wrąbczynkowskie Holendry| 13 |62-310 Pyzdry;766;239;239;7;232;31.20;2.93
109842;303004;Samorządowa Szkoła Podstawowa|Górne Grądy| 2 |62-310 Pyzdry;674;230;230;10;220;34.12;4.35
109843;303004;Samorządowa Szkoła Podstawowa|Lisewo| 108 |62-310 Pyzdry;679;275;275;7;268;40.50;2.55
109844;303005;Ratusz|Września|ul. Ratuszowa 1 |62-300 Września;1737;740;740;16;724;42.60;2.16
109845;303005;Urząd Stanu Cywilnego|Września|ul. Chopina 9 |62-300 Września;1344;612;612;16;596;45.54;2.61
109846;303005;Wrzesińskie Obiekty Sportowo-Rekreacyjne|Września|ul. Świętokrzyska 14-16 |62-300 Września;1824;994;994;14;980;54.50;1.41
109847;303005;Przedszkole|Września|ul. Gen. Tadeusza Kutrzeby 1 |62-300 Września;1875;1109;1109;13;1096;59.15;1.17
109848;303005;Gimnazjum nr 1|Września|ul. Kosynierów 32 |62-300 Września;1721;928;928;43;885;53.92;4.63
109849;303005;Gimnazjum nr 1|Września|ul. Kosynierów 32 |62-300 Września;1388;860;860;13;847;61.96;1.51
109850;303005;Liceum Ogólnokształcące|Września|ul. Witkowska 1 |62-300 Września;1352;633;633;15;618;46.82;2.37
109851;303005;Zespół Szkół Politechnicznych|Września|ul. Wojska Polskiego 1 |62-300 Września;1388;728;728;12;716;52.45;1.65
109852;303005;Gimnazjum nr 2|Września|ul. Słowackiego 41 |62-300 Września;1805;971;971;24;947;53.80;2.47
109853;303005;Samorządowa Szkoła Podstawowa nr 6|Września|ul. Batorego 8 |62-300 Września;1703;870;870;27;843;51.09;3.10
109854;303005;Wrzesińska Spółdzielnia Mieszkaniowa|Września|ul. Kilińskiego 10 |62-300 Września;1584;843;843;18;825;53.22;2.14
109855;303005;Zespół Szkół Technicznych i Ogólnokształcących|Września|ul. Kaliska 2a |62-300 Września;1683;902;902;20;882;53.59;2.22
109856;303005;Zespół Szkół Technicznych i Ogólnokształcących|Września|ul. Kaliska 2a |62-300 Września;1710;948;948;35;913;55.44;3.69
109857;303005;Wrzesiński Ośrodek Kultury|Września|ul. Kościuszki 21 |62-300 Września;2059;1081;1081;19;1062;52.50;1.76
109858;303005;Dom Młodzieżowy|Sokołowo|ul. Szlachecka 1 |62-300 Września;756;286;286;13;273;37.83;4.55
109859;303005;Zespół Szkół w Marzeninie|Marzenin|ul. Ks. Twardego 22 |62-301 Marzenin;959;403;403;22;381;42.02;5.46
109860;303005;Zespół Szkół Społecznych w Grzybowie|Grzybowo| 32 |62-309 Grzybowo;1383;597;597;18;579;43.17;3.02
109861;303005;Wiejski Dom Kultury w Sędziwojewie|Sędziwojewo| 69 |62-302 Węgierki;549;212;212;9;203;38.62;4.25
109862;303005;Świetlica w Psarach Polskich|Psary Polskie| 126 |62-300 Września;1526;706;706;18;688;46.26;2.55
109863;303005;Świetlica w Psarach Małych|Psary Małe|Długa 18 |62-300 Września;1161;534;534;12;522;45.99;2.25
109864;303005;Świetlica w Chociczy Wielkiej|Chocicza Wielka| 21 |62-300 Września;483;153;153;8;145;31.68;5.23
109865;303005;Wiejski Dom Kultury w Obłaczkowie|Obłaczkowo| 102 |62-323 Chwalibogowo;661;318;318;9;309;48.11;2.83
109866;303005;Samorządowa Szkoła Podstawowa w Chwalibogowie|Chwalibogowo| 38 |62-323 Chwalibogowo;737;264;264;17;247;35.82;6.44
109867;303005;Samorządowa Szkoła Podstawowa w Kaczanowie|Kaczanowo|ul. Kaliska 52 |62-303 Kaczanowo;2149;990;990;29;961;46.07;2.93
109868;303005;Świetlica w Gozdowie|Gozdowo| 57 |62-300 Września;659;263;263;13;250;39.91;4.94
109869;303005;Wiejski Dom Kultury w Węgierkach|Węgierki|ul. Wrzesińska 30 |62-302 Węgierki;1280;468;468;19;449;36.56;4.06
109870;303005;Szpital Powiatowy Sp. z o.o.|Września|Słowackiego 2 |62-300 Września;88;32;32;1;31;36.36;3.12
109871;303005;Dom Pomocy Społecznej|Września|Szkolna 25 |62-300 Września;40;15;15;0;15;37.50;0.00
109872;303101;Klub "Ziemowit"|Złotów|ul. Bohaterów Westerplatte 12 |77-400 Złotów;1980;1036;1036;22;1014;52.32;2.12
109873;303101;Świetlica Centrum Kształcenia Zawodowego i Ustawicznego|Złotów|ul. Norwida 10 |77-400 Złotów;1847;957;957;24;933;51.81;2.51
109874;303101;Sala Zespołu Szkół Katolickich|Złotów|ul. Moniuszki 18 |77-400 Złotów;2057;1051;1051;37;1014;51.09;3.52
109875;303101;Złotowskie Centrum Aktywności Społecznej|Złotów|al. Piasta 26 |77-400 Złotów;1779;892;892;21;871;50.14;2.35
109876;303101;Sala sesyjna Urzędu Miejskiego w Złotowie|Złotów|al. Piasta 1 |77-400 Złotów;1724;748;748;51;697;43.39;6.82
109877;303101;Stołówka Zespołu Szkół Samorządowych Nr 1|Złotów|ul. Królowej Jadwigi 54/56 |77-400 Złotów;1863;912;912;17;895;48.95;1.86
109878;303101;Sala Publicznego Przedszkola Nr 2|Złotów|ul. 8 Marca 18 |77-400 Złotów;2230;1209;1209;45;1164;54.22;3.72
109879;303101;Sala Gimnazjum nr 2|Złotów|ul. 8 Marca 16 |77-400 Złotów;1069;462;462;11;451;43.22;2.38
109880;303101;Biuro Dyrekcji Szpitala Powiatowego|Złotów|Szpitalna 28 |77-400 Złotów;124;47;47;8;39;37.90;17.02
109881;303101;Biuro Psychologa|Złotów|pl. Kościuszki 3 |77-400 Złotów;111;44;44;2;42;39.64;4.55
109882;303102;Publiczne Gimnazjum|Jastrowie|ul. Kilińszczaków 18 |64-915 Jastrowie;1592;713;713;28;685;44.79;3.93
109883;303102;Miejska Biblioteka Publiczna|Jastrowie|ul. Wojska Polskiego 11 |64-915 Jastrowie;1772;607;607;39;568;34.26;6.43
109884;303102;Specjalny Ośrodek Szkolno-Wychowawczy|Jastrowie|ul. Wojska Polskiego 25 |64-915 Jastrowie;2057;977;977;28;949;47.50;2.87
109885;303102;Miejsko-Gminny Ośrodek Pomocy Społecznej|Jastrowie|ul. Kieniewicza 19 |64-915 Jastrowie;1286;452;452;21;431;35.15;4.65
109886;303102;Publiczna Szkoła Podstawowa|Brzeźnica| bn |64-915 Jastrowie;1104;324;324;23;301;29.35;7.10
109887;303102;Dom Kultury|Sypniewo|Mickiewicza 43 |64-915 Jastrowie;1271;429;429;36;393;33.75;8.39
109888;303103;Krajeński Ośrodek Kultury|Krajenka|ul. Rynek 1 |77-430 Krajenka;1237;552;552;24;528;44.62;4.35
109889;303103;Warsztat Terapii Zajęciowej w Krajence|Krajenka|Bydgoska 3 |77-430 Krajenka;635;300;300;15;285;47.24;5.00
109890;303103;Dom Strażaka|Krajenka|ul. Floriańska 6 |77-430 Krajenka;1726;718;718;22;696;41.60;3.06
109891;303103;Szkoła Podstawowa|Głubczyn| 23 |77-430 Krajenka;538;255;255;10;245;47.40;3.92
109892;303103;Szkoła Podstawowa|Śmiardowo Krajeńskie| 13 |77-430 Krajenka;390;117;117;8;109;30.00;6.84
109893;303103;Szkoła Podstawowa w Podróżnej|Podróżna| 50 |77-430 Krajenka;350;148;148;9;139;42.29;6.08
109894;303103;Szkoła Podstawowa w Dolniku|Dolnik| 13 |77-430 Krajenka;445;145;145;3;142;32.58;2.07
109895;303103;Szkoła Podstawowa w Skórce|Skórka|ul. Złotowska 4 |64-917 Skórka;550;314;314;23;291;57.09;7.32
109896;303104;Wiejski Dom Kultury|Wielki Buczek| 1A |77-420 Lipka;561;243;243;8;235;43.32;3.29
109897;303104;Gminny Ośrodek Kultury|Lipka|ul.IV Dywizji Piechoty 2 |77-420 Lipka;1521;525;525;31;494;34.52;5.90
109898;303104;Gminny Ośrodek Kultury|Lipka|ul.IV Dywizji Piechoty 2 |77-420 Lipka;1353;652;652;24;628;48.19;3.68
109899;303104;Zespół Szkół|Łąkie| 89 |77-420 Lipka;947;310;310;21;289;32.73;6.77
109900;303105;Gimnazjum|Okonek|ul. Niepodległości 23 |64-965 Okonek;1244;541;541;32;509;43.49;5.91
109901;303105;Gimnazjum|Okonek|ul. Niepodległości 23 |64-965 Okonek;1838;785;785;45;740;42.71;5.73
109902;303105;Gimnazjum|Okonek|ul. Niepodległości 24 |64-965 Okonek;464;154;154;10;144;33.19;6.49
109903;303105;Gimnazjum|Lotyń|ul. Pocztowa 1 |64-918 Lotyń;1073;362;362;15;347;33.74;4.14
109904;303105;Świetlica Wiejska|Węgorzewo| 15 |64-965 Okonek;551;161;161;18;143;29.22;11.18
109905;303105;Świetlica Wiejska|Pniewo| 52 |64-965 Okonek;987;248;248;17;231;25.13;6.85
109906;303105;Świetlica Wiejska|Podgaje|ul. Gdańska 3 |64-965 Okonek;409;138;138;9;129;33.74;6.52
109907;303105;Świetlica Wiejska|Lędyczek|ul. Moniuszki 5 |64-965 Okonek;398;163;163;12;151;40.95;7.36
109908;303106;Zespół Szkół|Tarnówka|ul. Zwycięstwa 27 |77-416 Tarnówka;1670;668;668;35;633;40.00;5.24
109909;303106;Sala wiejska|Piecewo| 23 |77-416 Tarnówka;294;116;116;1;115;39.46;0.86
109910;303106;Świetlica wiejska|Węgierce| 4a |77-416 Tarnówka;491;138;138;15;123;28.11;10.87
109911;303107;"Dom Polski" - Zakrzewski Dom Kultury|Zakrzewo|ul. ks.dr Bolesława Domańskiego 18 |77-424 Zakrzewo;1204;568;568;14;554;47.18;2.46
109912;303107;Publiczna Szkoła Podstawowa|Stara Wiśniewka| 51 |77-411 Stara Wiśniewka;988;399;399;13;386;40.38;3.26
109913;303107;Publiczna Szkoła Podstawowa|Śmiardowo Złotowskie| 3 |77-424 Zakrzewo;462;201;201;4;197;43.51;1.99
109914;303107;Hala Sportowo-Widowiskowa|Zakrzewo|ul.29 Stycznia 29 |77-424 Zakrzewo;1255;574;574;12;562;45.74;2.09
109915;303108;Urząd Gminy|Złotów|ul.Leśna 7 |77-400 Złotów;2162;751;751;38;713;34.74;5.06
109916;303108;Publiczne Gimnazjum nr 1|Radawnica|ul.Szkolna 2 |77-400 Złotów;1664;616;616;36;580;37.02;5.84
109917;303108;Szkoła Podstawowa|Kleszczyna| 28 |77-400 Złotów;989;315;315;27;288;31.85;8.57
109918;303108;Publiczne Gimnazjum nr 2|Święta| 40 |77-400 Złotów;1603;685;685;23;662;42.73;3.36
109919;303108;Świetlica wiejska|Sławianowo| 1 |77-400 Złotów;789;307;307;10;297;38.91;3.26
109920;306101;I Liceum Ogólnokształcące im. Adama Asnyka|Kalisz|ul. Grodzka 1 |62-800 Kalisz;1700;744;744;12;732;43.76;1.61
109921;306101;Galeria Sztuki im. Jana Tarasina|Kalisz|Plac Św. Józefa 5 |62-800 Kalisz;1142;503;503;16;487;44.05;3.18
109922;306101;empik school Kalisz|Kalisz|Al. Wolności 6 |62-800 Kalisz;1273;540;540;14;526;42.42;2.59
109923;306101;Gimnazjum Nr 3 im. Polskich Noblistów|Kalisz|ul. Teatralna 3 |62-800 Kalisz;2077;1104;1104;7;1097;53.15;0.63
109924;306101;III Liceum Ogólnokształcące im. Mikołaja Kopernika|Kalisz|ul. Tadeusza Kościuszki 10 |62-800 Kalisz;1628;631;631;20;611;38.76;3.17
109925;306101;Gimnazjum Nr 2 im. Juliusza Słowackiego|Kalisz|ul. Ciasna 16 |62-800 Kalisz;1766;678;678;30;648;38.39;4.42
109926;306101;Szkoła Podstawowa Nr 1 im. Konstytucji 3-go Maja|Kalisz|ul. 3-go Maja 16 |62-800 Kalisz;2183;1078;1078;26;1052;49.38;2.41
109927;306101;Niepubliczne Przedszkole Niezapominajka|Kalisz|ul. Warszawska 8 |62-800 Kalisz;1158;540;540;6;534;46.63;1.11
109928;306101;Szkoła Podstawowa Nr 9 im. 25 Dywizji Piechoty Ziemi Kaliskiej|Kalisz|ul. Żwirki i Wigury 13 |62-800 Kalisz;2166;1273;1273;9;1264;58.77;0.71
109929;306101;Fundacja Kaliski Inkubator Przedsiębiorczości|Kalisz|ul. Częstochowska 25 |62-800 Kalisz;953;505;505;3;502;52.99;0.59
109930;306101;Uniwersytet im. Adama Mickiewicza w Poznaniu Wydział Pedagogiczno-Artystyczny w Kaliszu|Kalisz|ul. Nowy Świat 28-30 |62-800 Kalisz;799;362;362;6;356;45.31;1.66
109931;306101;Szkoła Podstawowa Nr 16 im. Powstańców Wielkopolskich 1918-1919|Kalisz|ul. Fabryczna 13-15 |62-800 Kalisz;1709;816;816;18;798;47.75;2.21
109932;306101;Zespół Szkół Ponadgimnazjalnych Nr 2|Kalisz|ul. Rzemieślnicza 6 |62-800 Kalisz;2124;1047;1047;29;1018;49.29;2.77
109933;306101;Zespół Szkół Zawodowych im. Zesłańców Sybiru|Kalisz|ul. Wąska 13 |62-800 Kalisz;784;400;400;4;396;51.02;1.00
109934;306101;Szkoła Podstawowa Nr 7 im. Adama Mickiewicza|Kalisz|ul. Robotnicza 5 |62-800 Kalisz;2204;1190;1190;22;1168;53.99;1.85
109935;306101;DOMCAR Sp. z o.o.|Kalisz|ul. Poznańska 24 |62-800 Kalisz;1813;1041;1041;15;1026;57.42;1.44
109936;306101;Szkoła Podstawowa Nr 12 im. księcia Bolesława Pobożnego|Kalisz|ul. Jana Długosza 14 |62-800 Kalisz;1393;596;596;19;577;42.79;3.19
109937;306101;Szkoła Podstawowa Nr 2 im. Jana Pawła II|Kalisz|ul. Juliana Tuwima 4 |62-800 Kalisz;1824;976;976;19;957;53.51;1.95
109938;306101;Publiczne Przedszkole Nr 27 Radość|Kalisz|ul. Józefa Koszutskiego 29 |62-800 Kalisz;2226;1302;1302;23;1279;58.49;1.77
109939;306101;Państwowa Wyższa Szkoła Zawodowa im. Prezydenta Stanisława Wojciechowskiego Collegium Medicum|Kalisz|ul. Kaszubska 13 |62-800 Kalisz;1100;623;623;8;615;56.64;1.28
109940;306101;Szkoła Podstawowa Nr 6 im. Henryka Sienkiewicza|Kalisz|ul. Chełmska 18 |62-800 Kalisz;1797;1009;1009;21;988;56.15;2.08
109941;306101;Zespół Szkół Techniczno-Elektronicznych|Kalisz|ul. Częstochowska 99 |62-800 Kalisz;1628;939;939;14;925;57.68;1.49
109942;306101;Dzienny Dom Pomocy Społecznej|Kalisz|ul. Cegielniana 6 |62-800 Kalisz;1965;1148;1148;14;1134;58.42;1.22
109943;306101;Przychodnia Medycyny Rodzinnej "Puls"|Kalisz|ul. Polna 29 |62-800 Kalisz;2163;1266;1266;11;1255;58.53;0.87
109944;306101;Niepubliczne Przedszkole im. Marii Konopnickiej|Kalisz|ul. Ostrowska 62 |62-800 Kalisz;1977;1213;1213;10;1203;61.36;0.82
109945;306101;Szkoła Podstawowa Nr 8 im. Bohaterów Westerplatte|Kalisz|ul. Serbinowska 22a |62-800 Kalisz;920;563;563;8;555;61.20;1.42
109946;306101;Klub Osiedlowy Kaliskiej Spółdzielni Mieszkaniowej Lokatorsko - Własnościowej|Kalisz|ul. Serbinowska 25 |62-800 Kalisz;1904;938;938;23;915;49.26;2.45
109947;306101;Gimnazjum Nr 4 im. Marii Dąbrowskiej|Kalisz|ul. Polna 17 |62-800 Kalisz;1669;868;868;12;856;52.01;1.38
109948;306101;Szkoła Podstawowa Nr 14 im. Władysława Broniewskiego|Kalisz|ul. Adama Mickiewicza 11 |62-800 Kalisz;1587;911;911;11;900;57.40;1.21
109949;306101;Publiczne Przedszkole Nr 19 z Oddziałami Integracyjnymi Razem|Kalisz|ul. Widok 98a |62-800 Kalisz;1772;964;964;20;944;54.40;2.07
109950;306101;Publiczne Przedszkole Nr 18 Chatka Puchatka|Kalisz|ul. Serbinowska 5a |62-800 Kalisz;1558;836;836;25;811;53.66;2.99
109951;306101;Niepubliczne Przedszkole Jacka i Agatki|Kalisz|ul. Serbinowska 21 |62-800 Kalisz;1856;1030;1030;17;1013;55.50;1.65
109952;306101;Zespół Szkół Nr 10|Kalisz|ul. Podmiejska 9a |62-800 Kalisz;2176;1255;1255;35;1220;57.67;2.79
109953;306101;Zespół Szkół Nr 7|Kalisz|ul. Karpacka 3 |62-800 Kalisz;2324;1512;1512;14;1498;65.06;0.93
109954;306101;Zespół Szkolno-Przedszkolny Nr 2 Szkoła Podstawowa Nr 21 im. Legionów Józefa Piłsudskiego|Kalisz|ul. 25 Pułku Artylerii 4-8 |62-800 Kalisz;1352;714;714;14;700;52.81;1.96
109955;306101;Zespół Szkolno-Przedszkolny Nr 1 Szkoła Podstawowa Nr 15 im. Szarych Szeregów|Kalisz|ul. Wykopaliskowa 45 |62-800 Kalisz;2222;1205;1205;14;1191;54.23;1.16
109956;306101;Szkoła Podstawowa Nr 17 z Oddziałami Integracyjnymi im. dr. Bronisława Koszutskiego|Kalisz|ul. Hanki Sawickiej 3b |62-800 Kalisz;1772;1022;1022;19;1003;57.67;1.86
109957;306101;Niepubliczne Przedszkole Bajka|Kalisz|ul. Hanki Sawickiej 3a |62-800 Kalisz;1885;1051;1051;20;1031;55.76;1.90
109958;306101;Niepubliczne Przedszkole Zielone Łąki|Kalisz|ul. Hanki Sawickiej 19a |62-800 Kalisz;845;466;466;5;461;55.15;1.07
109959;306101;Niepubliczne Przedszkole Calineczka|Kalisz|Al. Wojska Polskiego 30 |62-800 Kalisz;2231;1387;1387;29;1358;62.17;2.09
109960;306101;Zespół Szkolno-Przedszkolny Nr 3 Szkoła Podstawowa Nr 22 im. Józefa Piłsudskiego|Kalisz|ul. Św. Michała 1 |62-800 Kalisz;1168;759;759;12;747;64.98;1.58
109961;306101;Niepubliczne Przedszkole Szczęśliwa Trzynastka|Kalisz|ul. Krótka 9 |62-800 Kalisz;700;317;317;3;314;45.29;0.95
109962;306101;Żłobek Nr 4|Kalisz|Al. Wojska Polskiego 34 |62-800 Kalisz;1409;830;830;13;817;58.91;1.57
109963;306101;Warsztaty Szkolne Zespołu Szkół Ponadgimnazjalnych Nr 2|Kalisz|ul. Obywatelska 4 |62-800 Kalisz;1402;784;784;27;757;55.92;3.44
109964;306101;Zespół Szkół Ekonomicznych|Kalisz|ul. Legionów 6 |62-800 Kalisz;786;431;431;6;425;54.83;1.39
109965;306101;Szkoła Podstawowa Nr 23 im. Eligiusza Kor-Walczaka|Kalisz|ul. Sulisławicka 108-110 |62-800 Kalisz;713;365;365;8;357;51.19;2.19
109966;306101;Publiczne Przedszkole Nr 28 Bajka|Kalisz|ul. Cmentarna 1-3 |62-800 Kalisz;1298;602;602;13;589;46.38;2.16
109967;306101;Klub Seniora|Kalisz|ul. Hanki Sawickiej 43 |62-800 Kalisz;703;414;414;8;406;58.89;1.93
109968;306101;Ośrodek Sportu, Rehabilitacji i Rekreacji|Kalisz|ul. Łódzka 19-29 |62-800 Kalisz;1412;726;726;12;714;51.42;1.65
109969;306101;Zespół Szkół Nr 9 Gimnazjum Nr 9 im. Jana Pawła II|Kalisz|ul. Hanki Sawickiej 22-24 |62-800 Kalisz;1835;1195;1195;12;1183;65.12;1.00
109970;306101;Zespół Szkół Nr 9 Gimnazjum nr 9 im. Jana Pawła II|Kalisz|ul. Hanki Sawickiej 22-24 |62-800 Kalisz;1644;896;896;14;882;54.50;1.56
109971;306101;Wojewódzki Szpital Zespolony im. Ludwika Perzyny|Kalisz|ul. Poznańska 79 |62-800 Kalisz;165;108;108;2;106;65.45;1.85
109972;306101;Wojewódzki Szpital Zespolony im. Ludwika Perzyny|Kalisz|ul. Toruńska 7 |62-800 Kalisz;37;15;15;0;15;40.54;0.00
109973;306101;Zakład Karny|Kalisz|ul. Łódzka 2 |62-800 Kalisz;16;16;16;0;16;100.00;0.00
109974;306101;Dom Pomocy Społecznej|Kalisz|ul. Winiarska 26 |62-800 Kalisz;168;66;66;6;60;39.29;9.09
109975;306201;Przedsiębiorstwo Gospodarki Komunalnej i Mieszkaniowej Spółka z o.o.|Konin|M. Dąbrowskiej 8 |62-500 Konin;2016;968;968;31;937;48.02;3.20
109976;306201;Ośrodek Szkolno-Wychowawczy|Konin|Kaliska 19 |62-500 Konin;1855;962;962;12;950;51.86;1.25
109977;306201;Szkoła Podstawowa Nr 15|Konin|Turkusowa 1a |62-500 Konin;1985;1078;1078;24;1054;54.31;2.23
109978;306201;Przedszkole Nr 4|Konin|Turkusowa 1 |62-500 Konin;954;599;599;13;586;62.79;2.17
109979;306201;Gimnazjum Nr 2|Konin|Kryształowa 3 |62-500 Konin;924;472;472;11;461;51.08;2.33
109980;306201;Szkoła Podstawowa Nr 1|Konin|Kolska 2 |62-500 Konin;1742;877;877;24;853;50.34;2.74
109981;306201;Przedszkole Nr 1 Oddział Zamiejscowy w Wilkowie|Konin|Kamienna 57a |62-500 Konin;2127;1198;1198;11;1187;56.32;0.92
109982;306201;Przedszkole Nr 1|Konin|Kopernika 14 |62-500 Konin;1091;517;517;13;504;47.39;2.51
109983;306201;Zespół Szkół Centrum Kształcenia Ustawicznego im. S. Batorego|Konin|Wodna 1 |62-500 Konin;783;324;324;4;320;41.38;1.23
109984;306201;Szkoła Podstawowa Nr 4|Konin|K. Błaszaka 4 |62-510 Konin;1619;854;854;13;841;52.75;1.52
109985;306201;Przedszkole Nr 7|Konin|Kolejowa 30 |62-510 Konin;1410;714;714;21;693;50.64;2.94
109986;306201;Filia Miejskiej Biblioteki Publicznej dla Dzieci i Młodzieży|Konin|Powstańców Wlkp. 14 |62-510 Konin;824;405;405;10;395;49.15;2.47
109987;306201;Przedszkole Nr 25|Konin|Kosmonautów 4a |62-510 Konin;1179;588;588;13;575;49.87;2.21
109988;306201;Gimnazjum Nr 6|Konin|Bydgoska 2a |62-510 Konin;1252;652;652;12;640;52.08;1.84
109989;306201;Przedszkole Nr 6|Konin|L. Solskiego 4 |62-510 Konin;1763;843;843;18;825;47.82;2.14
109990;306201;Szkoła Podstawowa Nr 6|Konin|Kolejowa 2 |62-510 Konin;927;453;453;17;436;48.87;3.75
109991;306201;Zespół Szkół im. M. Kopernika|Konin|Aleje 1 Maja 22 |62-510 Konin;807;406;406;16;390;50.31;3.94
109992;306201;Szkoła Podstawowa Nr 9|Konin|Fikusowa 8 |62-510 Konin;2096;1272;1272;22;1250;60.69;1.73
109993;306201;Gimnazjum Nr 3|Konin|Fikusowa 8 |62-510 Konin;2058;1399;1399;14;1385;67.98;1.00
109994;306201;Przedszkole Nr 16|Konin|Szarotki 1 |62-510 Konin;1919;1152;1152;13;1139;60.03;1.13
109995;306201;Zespół Szkół im. M. Kopernika|Konin|Żeglarska 9 |62-510 Konin;652;424;424;2;422;65.03;0.47
109996;306201;Przedszkole Nr 8|Konin|Przemysłowa 12 |62-510 Konin;1350;682;682;10;672;50.52;1.47
109997;306201;Szkoła Podstawowa Nr 8|Konin|Kardynała Stefana Wyszyńskiego 24 |62-510 Konin;813;453;453;5;448;55.72;1.10
109998;306201;Zespół Szkół Górniczo-Energetycznych im. S. Staszica|Konin|Kardynała Stefana Wyszyńskiego 3 |62-510 Konin;1291;705;705;16;689;54.61;2.27
109999;306201;Państwowa Wyższa Szkoła Zawodowa w Koninie|Konin|Ks. Jerzego Popiełuszki 4 |62-510 Konin;1259;744;744;16;728;59.09;2.15
110000;306201;Państwowa Wyższa Szkoła Zawodowa w Koninie|Konin|Ks. Jerzego Popiełuszki 4 |62-510 Konin;1261;718;718;12;706;56.94;1.67
110001;306201;Zespół Szkół Budowlanych|Konin|Budowlanych 6 |62-510 Konin;1705;897;897;17;880;52.61;1.90
110002;306201;Przedszkole Nr 12|Konin|Kardynała Stefana Wyszyńskiego 42 |62-510 Konin;1275;649;649;14;635;50.90;2.16
110003;306201;Gimnazjum Nr 7|Konin|Kardynała Stefana Wyszyńskiego 44 |62-510 Konin;910;495;495;11;484;54.40;2.22
110004;306201;Dom Pomocy Społecznej|Konin|Południowa 1 |62-510 Konin;88;30;30;1;29;34.09;3.33
110005;306201;Przedszkole Nr 15|Konin|11 Listopada 32 |62-510 Konin;1472;768;768;18;750;52.17;2.34
110006;306201;Przedszkole Nr 17|Konin|Okólna 57 |62-510 Konin;1501;789;789;11;778;52.56;1.39
110007;306201;Przedszkole Nr 11|Konin|Sosnowa 8 |62-510 Konin;1071;563;563;16;547;52.57;2.84
110008;306201;Klub Mieszkańców Konińskiej Spółdzielni Mieszkaniowej|Konin|Wyzwolenia 13 |62-510 Konin;1485;793;793;29;764;53.40;3.66
110009;306201;Szkoła Podstawowa Nr 3|Konin|Sosnowa 16 |62-510 Konin;1430;815;815;17;798;56.99;2.09
110010;306201;Osiedlowy Dom Kultury SM "Zatorze"|Konin|T. Szeligowskiego 1 |62-510 Konin;948;564;564;15;549;59.49;2.66
110011;306201;Przedszkole Nr 2|Konin|Z. Noskowskiego 4 |62-510 Konin;924;551;551;5;546;59.63;0.91
110012;306201;Szkoła Podstawowa Nr 12|Konin|T. Szeligowskiego 5 |62-510 Konin;1644;963;963;19;944;58.58;1.97
110013;306201;Gimnazjum Nr 5|Konin|K. Szymanowskiego 5 |62-510 Konin;1680;1001;1001;16;985;59.58;1.60
110014;306201;Przedszkole Nr 2|Konin|Z. Noskowskiego 4 |62-510 Konin;648;317;317;3;314;48.92;0.95
110015;306201;Przedszkole Nr 31|Konin|L. Różyckiego 3 |62-510 Konin;1208;686;686;12;674;56.79;1.75
110016;306201;Przedszkole Nr 10|Konin|F. Chopina 11 |62-510 Konin;2043;1062;1062;25;1037;51.98;2.35
110017;306201;Świetlica Środowiskowa w Koninie|Konin|Przemysłowa 21 |62-510 Konin;1885;1048;1048;19;1029;55.60;1.81
110018;306201;Szkoła Podstawowa Nr 11|Konin|Łężyńska 9 |62-510 Konin;1908;829;829;39;790;43.45;4.70
110019;306201;Gimnazjum Nr 4|Konin|L. Staffa 5 |62-510 Konin;1612;670;670;17;653;41.56;2.54
110020;306201;Wojewódzki Szpital Zespolony|Konin|Kardynała Stefana Wyszyńskiego 1 |62-510 Konin;169;66;66;4;62;39.05;6.06
110021;306201;Wojewódzki Szpital Zespolony|Konin|Szpitalna 45 |62-500 Konin;63;42;42;5;37;66.67;11.90
110022;306301;Wojewódzki Szpital Zespolony|Leszno|Jana Kiepury 45 |64-100 Leszno;219;51;51;3;48;23.29;5.88
110023;306301;Klub "Na Piętrze"|Leszno|ul. Tadeusza Rejtana 43 |64-100 Leszno;2077;1136;1136;22;1114;54.69;1.94
110024;306301;Gimnazjum nr 7|Leszno|ul. Tadeusza Rejtana 1 |64-100 Leszno;1739;970;970;15;955;55.78;1.55
110025;306301;Szkoła Podstawowa nr 13|Leszno|ul. Tadeusza Rejtana 1 |64-100 Leszno;1674;1064;1064;13;1051;63.56;1.22
110026;306301;Szkoła Podstawowa nr 12|Leszno|ul. Rumuńska 6AB |64-100 Leszno;1609;853;853;25;828;53.01;2.93
110027;306301;Gimnazjum nr 8|Leszno|ul. Rumuńska 6AB |64-100 Leszno;2190;1315;1315;24;1291;60.05;1.83
110028;306301;Klub Osiedlowy "Kwadrat"|Leszno|ul. Armii Krajowej 15 |64-100 Leszno;1305;644;644;11;633;49.35;1.71
110029;306301;Przedszkole nr 21|Leszno|ul. Armii Krajowej 11 |64-100 Leszno;1802;1037;1037;16;1021;57.55;1.54
110030;306301;Przedszkole nr 8|Leszno|ul. Jagiellońska 6 |64-100 Leszno;1348;694;694;11;683;51.48;1.59
110031;306301;Przedszkole nr 11|Leszno|ul. Prochownia 25B |64-100 Leszno;1585;774;774;29;745;48.83;3.75
110032;306301;Szkoła Podstawowa nr 10|Leszno|ul. Jagiellońska 7 |64-100 Leszno;1379;708;708;24;684;51.34;3.39
110033;306301;Klub Osiedlowy|Leszno|ul. gen. Jarosława Dąbrowskiego 45a |64-100 Leszno;1057;498;498;20;478;47.11;4.02
110034;306301;Szkoła Podstawowa nr 7|Leszno|ul. Aleje Jana Pawła II 10 |64-100 Leszno;1110;653;653;6;647;58.83;0.92
110035;306301;Szkoła Podstawowa nr 7|Leszno|ul. Aleje Jana Pawła II 10 |64-100 Leszno;1368;711;711;18;693;51.97;2.53
110036;306301;Leszczyńska Spółdzielnia Mieszkaniowa|Leszno|ul. Osiedle Józefa Sułkowskiego 46 |64-100 leszno;1346;783;783;20;763;58.17;2.55
110037;306301;Przedszkole nr 10|Leszno|ul. Bolesława Prusa 22c |64-100 Leszno;1018;565;565;10;555;55.50;1.77
110038;306301;II LO im. M. Kopernika|Leszno|ul. Bolesława Prusa 33 |64-100 Leszno;1705;983;983;24;959;57.65;2.44
110039;306301;Zespół Szkół Rolniczo-Budowlanych|Leszno|ul. 1 Maja 1 |64-100 Leszno;1512;820;820;25;795;54.23;3.05
110040;306301;Przedszkole nr 4|Leszno|ul. Jana Poplińskiego 5 |64-100 Leszno;1384;638;638;13;625;46.10;2.04
110041;306301;Gimnazjum nr 1|Leszno|ul. pl. Jana Amosa Komeńskiego 1 |64-100 Leszno;1362;524;524;14;510;38.47;2.67
110042;306301;Zespół Szkół Ochrony Środowiska|Leszno|ul. pl. Jana Metziga 25 |64-100 Leszno;1133;422;422;16;406;37.25;3.79
110043;306301;Prywatny Zespół Szkół mgr Henryk Jóźwiak|Leszno|ul.Aleje Zygmunta Krasińskiego 22 |64-100 Leszno;1289;534;534;28;506;41.43;5.24
110044;306301;Bursa Międzyszkolna|Leszno|ul. Księcia Józefa Poniatowskiego 11 |64-100 Leszno;1501;584;584;20;564;38.91;3.42
110045;306301;III Liceum Ogólnokształcące|Leszno|ul. pl. Tadeusza Kościuszki 5 |64-100 Leszno;1894;972;972;25;947;51.32;2.57
110046;306301;Zespół Szkół Technicznych|Leszno|ul. Gabriela Narutowicza 74a |64-100 Leszno;1475;848;848;19;829;57.49;2.24
110047;306301;Szkoła Podstawowa nr 5|Leszno|ul. Łowiecka 50c |64-100 Leszno;1731;1087;1087;25;1062;62.80;2.30
110048;306301;Gimnazjum nr 5|Leszno|ul. Gronowska 45 |64-100 Leszno;2072;1042;1042;37;1005;50.29;3.55
110049;306301;Szkoła Podstawowa nr 9|Leszno|ul. Kardynała Stefana Wyszyńskiego 57 |64-100 Leszno;1432;903;903;12;891;63.06;1.33
110050;306301;Gimnazjum nr 9|Leszno|ul. Stanisława Szczepanowskiego 14 |64-100 Leszno;1947;1118;1118;66;1052;57.42;5.90
110051;306301;Przedszkole nr 3|Leszno|ul. Stanisława Wyspiańskiego 2 |64-100 Leszno;1715;988;988;23;965;57.61;2.33
110052;306301;Przedszkole nr 7|Leszno|ul. Stefana Żeromskiego 19 |64-100 Leszno;1700;954;954;15;939;56.12;1.57
110053;306301;Dom Harcerza|Leszno|ul. Sokoła 20 |64-100 Leszno;1292;765;765;38;727;59.21;4.97
110054;306301;Szkoła Podstawowa nr 4|Leszno|ul. Rynek Zaborowski 41 |64-100 Leszno;2317;1083;1083;22;1061;46.74;2.03
110055;306301;Areszt Śledczy|Leszno|pl. Tadeusz kościuszki 3 |64-100 Leszno;58;46;46;4;42;79.31;8.70
110056;306401;Zespół Szkół Mistrzostwa Sportowego nr 2|Poznań|al. Niepodległości 32 |61-714 Poznań;1553;949;949;12;937;61.11;1.26
110057;306401;Szkoła Podstawowa nr 40 z Oddziałami Integracyjnymi im. Mieszka I|Poznań|ul. Garbary 82 |61-758 Poznań;1589;919;919;13;906;57.84;1.41
110058;306401;Poznańskie Centrum Świadczeń|Poznań|ul. Wszystkich Świętych 1 |61-843 Poznań;1790;813;813;12;801;45.42;1.48
110059;306401;Muzeum Archeologiczne|Poznań|ul. Wodna 27 |61-781 Poznań;1821;926;926;17;909;50.85;1.84
110060;306401;Zespół Dziennych Domów Pomocy Filia nr 4 "Klub Starówka"|Poznań|ul. Wielka 1-6 |61-774 Poznań;1780;891;891;17;874;50.06;1.91
110061;306401;Zespół Szkół Komunikacji im. H. Cegielskiego|Poznań|ul. Aleksandra Fredry 13 |61-701 Poznań;1880;912;912;8;904;48.51;0.88
110062;306401;Zespół Szkół Zawodowych nr 6 im. Joachima Lelewela|Poznań|ul. Działyńskich 4/5 |61-727 Poznań;1775;906;906;18;888;51.04;1.99
110063;306401;Zespół Szkół z Oddziałami Integracyjnymi nr 3|Poznań|ul. Powstańców Wielkopolskich 3 |61-895 Poznań;1771;916;917;10;906;51.72;1.09
110064;306401;Zespół Szkół z Oddziałami Integracyjnymi nr 3|Poznań|ul. Powstańców Wielkopolskich 3 |61-895 Poznań;1499;647;647;18;629;43.16;2.78
110065;306401;III Liceum Ogólnokształcące im. św. Jana Kantego|Poznań|ul. Strzelecka 10 |61-845 Poznań;1694;802;802;24;778;47.34;2.99
110066;306401;Szkoła Podstawowa nr 82 im. Księcia Przemysła I|Poznań|ul. Krakowska 10 |61-889 Poznań;2036;1199;1199;14;1185;58.89;1.17
110067;306401;Zespół Szkół Budownictwa nr 1|Poznań|ul. Rybaki 17 |61-883 Poznań;1918;902;902;17;885;47.03;1.88
110068;306401;Zespół Szkół nr 5 im. Bolesława Chrobrego|Poznań|ul. Różana 1/3 |61-577 Poznań;949;521;521;19;502;54.90;3.65
110069;306401;Poznańskie Ośrodki Sportu i Rekreacji|Poznań|ul. Marcina Chwiałkowskiego 34 |61-553 Poznań;1915;1167;1167;8;1159;60.94;0.69
110070;306401;Przedszkole nr 87 im. Jacusia i Agatki|Poznań|ul. św. Czesława 6a |61-575 Poznań;1450;719;719;7;712;49.59;0.97
110071;306401;Zespół Szkół nr 5 im. Bolesława Chrobrego|Poznań|ul. Różana 1/3 |61-577 Poznań;1464;751;751;9;742;51.30;1.20
110072;306401;Zespół Szkół Gimnazjalno-Zawodowych nr 42|Poznań|ul. św. Jerzego 6/10 |61-546 Poznań;1703;926;926;20;906;54.37;2.16
110073;306401;Zespół Szkół Gimnazjalno-Zawodowych nr 42|Poznań|ul. św. Jerzego 6/10 |61-546 Poznań;1647;907;907;18;889;55.07;1.98
110074;306401;Szkoła Podstawowa nr 5 im. Romualda Traugutta|Poznań|ul. Romualda Traugutta 42 |61-514 Poznań;1494;828;828;14;814;55.42;1.69
110075;306401;V Liceum Ogólnokształcące im. Klaudyny Potockiej|Poznań|ul. Zmartwychwstańców 10 |61-501 Poznań;1628;864;864;9;855;53.07;1.04
110076;306401;Zespół Szkół z Oddziałami Integracyjnymi i Specjalnymi nr 2|Poznań|ul. Ignacego Prądzyńskiego 53 |61-527 Poznań;2047;926;926;16;910;45.24;1.73
110077;306401;Zespół Szkół z Oddziałami Integracyjnymi i Specjalnymi nr 2|Poznań|ul. Ignacego Prądzyńskiego 53 |61-527 Poznań;1816;848;848;13;835;46.70;1.53
110078;306401;V Liceum Ogólnokształcące im. Klaudyny Potockiej|Poznań|ul. Zmartwychwstańców 10 |61-501 Poznań;1874;843;843;31;812;44.98;3.68
110079;306401;H. Cegielski - Poznań Spółka Akcyjna|Poznań|ul. 28 Czerwca 1956 r. 223-229 |61-485 Poznań;2284;1385;1385;21;1364;60.64;1.52
110080;306401;Szkoła Podstawowa nr 5 im. Romualda Traugutta|Poznań|ul. Romualda Traugutta 42 |61-514 Poznań;1965;1039;1039;17;1022;52.88;1.64
110081;306401;Szkoła Podstawowa nr 84 im. Tadeusza Kościuszki|Poznań|ul. św. Szczepana 3 |61-465 Poznań;2201;1208;1208;27;1181;54.88;2.24
110082;306401;Gimnazjum nr 43 im. Poznańskiego Towarzystwa Przyjaciół Nauk|Poznań|ul. Łozowa 53 |61-448 Poznań;2146;1284;1284;29;1255;59.83;2.26
110083;306401;Szkoła Podstawowa nr 21 im. Filipiny Płaskowickiej|Poznań|ul. Łozowa 77 |61-448 Poznań;2160;1219;1219;30;1189;56.44;2.46
110084;306401;Zespół Szkół Licealno-Technicznych|Poznań|ul. 28 Czerwca 1956 r. nr 352/360 |61-441 Poznań;2102;1280;1280;39;1241;60.89;3.05
110085;306401;Zespół Szkół Licealno-Technicznych|Poznań|ul. 28 Czerwca 1956 r. nr 352/360 |61-441 Poznań;2194;1235;1235;18;1217;56.29;1.46
110086;306401;Zespół Szkół Mechanicznych im. Komisji Edukacji Narodowej|Poznań|ul. Świerkowa 8 |61-472 Poznań;1821;1138;1138;31;1107;62.49;2.72
110087;306401;Zespół Szkolno-Przedszkolny nr 3|Poznań|ul. Jesionowa 14 |61-432 Poznań;1586;829;829;21;808;52.27;2.53
110088;306401;Zespół Szkolno-Przedszkolny nr 3|Poznań|ul. Jesionowa 14 |61-432 Poznań;1561;785;785;9;776;50.29;1.15
110089;306401;Zespół Szkolno-Przedszkolny nr 3|Poznań|ul. Jesionowa 14 |61-432 Poznań;1768;1128;1128;8;1120;63.80;0.71
110090;306401;Gimnazjum nr 44 im. gen. bryg. Mariusza Zaruskiego|Poznań|ul. Jesionowa 14 |61-432 Poznań;1384;902;903;12;890;65.17;1.33
110091;306401;Gimnazjum nr 44 im. gen. bryg. Mariusza Zaruskiego|Poznań|ul. Jesionowa 14 |61-432 Poznań;1358;936;936;12;924;68.92;1.28
110092;306401;Zespół Szkół Mechanicznych im. Komisji Edukacji Narodowej|Poznań|ul. Świerkowa 8 |61-472 Poznań;1679;1180;1180;15;1165;70.28;1.27
110093;306401;Szkoła Podstawowa nr 77 im. 15 Pułku Ułanów Poznańskich|Poznań|ul. Romana Dmowskiego 50 |60-204 Poznań;1662;948;949;15;933;57.04;1.58
110094;306401;Zespół Szkół nr 8|Poznań|ul. Kazimierza Jarochowskiego 62 |60-246 Poznań;2033;1230;1230;15;1215;60.50;1.22
110095;306401;Zespół Szkół nr 8|Poznań|ul. Kazimierza Jarochowskiego 62 |60-246 Poznań;1744;965;965;12;953;55.33;1.24
110096;306401;Gimnazjum nr 51 im. Jana Pawła II|Poznań|ul. Klaudyny Potockiej 38 |60-211 Poznań;1921;1057;1057;13;1044;55.02;1.23
110097;306401;Gimnazjum nr 51 im. Jana Pawła II|Poznań|ul. Klaudyny Potockiej 38 |60-211 Poznań;1874;1193;1193;17;1176;63.66;1.42
110098;306401;Gimnazjum nr 51 im. Jana Pawła II|Poznań|ul. Klaudyny Potockiej 38 |60-211 Poznań;1981;1217;1217;10;1207;61.43;0.82
110099;306401;Zespół Szkół Gimnazjalno-Licealnych|Poznań|ul. Stanisława Wyspiańskiego 27 |60-751 Poznań;2026;1131;1131;12;1119;55.82;1.06
110100;306401;Zespół Szkół i Placówek Oświatowych|Poznań|ul. Ryszarda Berwińskiego 2/4 |60-765 Poznań;1925;966;966;16;950;50.18;1.66
110101;306401;Szkoła Podstawowa nr 9 im. dra Franciszka Witaszka|Poznań|ul. Józefa Łukaszewicza 9/13 |60-726 Poznań;1875;840;840;24;816;44.80;2.86
110102;306401;Szkoła Podstawowa nr 9 im. dra Franciszka Witaszka|Poznań|ul. Józefa Łukaszewicza 9/13 |60-726 Poznań;2047;1003;1003;18;985;49.00;1.79
110103;306401;Szkoła Podstawowa nr 9 im. dra Franciszka Witaszka|Poznań|ul. Józefa Łukaszewicza 9/13 |60-726 Poznań;1546;679;679;12;667;43.92;1.77
110104;306401;Zespół Szkół Handlowych im. Bohaterów Poznańskiego Czerwca `56|Poznań|ul. Śniadeckich 54/58 |60-774 Poznań;1568;797;797;17;780;50.83;2.13
110105;306401;Zespół Szkół Ogólnokształcących nr 12 II Liceum Ogólnokształcące im. Generałowej Zamoyskiej i Heleny Modrzejewskiej|Poznań|ul. Jana Matejki 8/10 |60-766 Poznań;1552;807;807;17;790;52.00;2.11
110106;306401;Zespół Szkół Ogólnokształcących nr 12 II Liceum Ogólnokształcące im. Generałowej Zamoyskiej i Heleny Modrzejewskiej|Poznań|ul. Jana Matejki 8/10 |60-766 Poznań;1844;1116;1116;10;1106;60.52;0.90
110107;306401;Szkoła Podstawowa nr 71 im. Janusza Kusocińskiego|Poznań|ul. Stanisława Przybyszewskiego 37 |60-356 Poznań;1706;985;986;14;971;57.74;1.42
110108;306401;Regionalne Centrum Krwiodawstwa i Krwiolecznictwa|Poznań|ul. Marcelińska 44 |60-354 Poznań;1353;834;834;6;828;61.64;0.72
110109;306401;Zespół Szkół Geodezyjno-Drogowych im. Rudolfa Modrzejewskiego|Poznań|ul. Szamotulska 33 |60-365 Poznań;1375;953;953;3;950;69.31;0.31
110110;306401;Przedszkole nr 86 "Tęczowy Świat"|Poznań|ul. Juliusza Słowackiego 15 |60-822 Poznań;1774;927;927;23;904;52.25;2.48
110111;306401;Gimnazjum nr 61 im. Ignacego Jana Paderewskiego|Poznań|ul. Juliusza Słowackiego 58/60 |60-521 Poznań;1210;597;597;8;589;49.34;1.34
110112;306401;Szkoła Podstawowa nr 71 im. Janusza Kusocińskiego|Poznań|ul. Stanisława Przybyszewskiego 37 |60-356 Poznań;1843;1132;1132;16;1116;61.42;1.41
110113;306401;Miejski Ośrodek Pomocy Rodzinie w Poznaniu Filia Jeżyce|Poznań|ul. Jana Długosza 18a |60-558 Poznań;1734;869;869;22;847;50.12;2.53
110114;306401;Szkoła Podstawowa nr 36 im. mjr. Henryka Sucharskiego|Poznań|ul. Juliusza Słowackiego 54/56 |60-521 Poznań;1409;671;671;11;660;47.62;1.64
110115;306401;Gimnazjum nr 61 im. Ignacego Jana Paderewskiego|Poznań|ul. Juliusza Słowackiego 58/60 |60-521 Poznań;1455;627;627;14;613;43.09;2.23
110116;306401;Szkoła Podstawowa nr 36 im. mjr. Henryka Sucharskiego|Poznań|ul. Juliusza Słowackiego 54/56 |60-521 Poznań;1380;727;727;13;714;52.68;1.79
110117;306401;Szkoła Podstawowa nr 23 im. gen. Józefa Bema|Poznań|ul. Cypriana Norwida 21 |60-867 Poznań;1896;995;995;13;982;52.48;1.31
110118;306401;Szkoła Podstawowa nr 23 im. gen. Józefa Bema|Poznań|ul. Cypriana Norwida 21 |60-867 Poznań;1779;1130;1130;13;1117;63.52;1.15
110119;306401;Zespół Szkół Zawodowych nr 1|Poznań|ul. św. Floriana 3 |60-536 Poznań;1853;1096;1096;8;1088;59.15;0.73
110120;306401;Zespół Szkół Ogólnokształcących nr 10 Gimnazjum Dwujęzyczne im. Dąbrówki, VII Liceum Ogólnokształcące im. Dąbrówki|Poznań|ul. Stefana Żeromskiego 8/12 |60-544 Poznań;1843;1045;1045;13;1032;56.70;1.24
110121;306401;Zespół Szkół Ogólnokształcących nr 10 Gimnazjum Dwujęzyczne im. Dąbrówki, VII Liceum Ogólnokształcące im. Dąbrówki|Poznań|ul. Stefana Żeromskiego 8/12 |60-544 Poznań;1474;875;875;8;867;59.36;0.91
110122;306401;Specjalny Ośrodek Szkolno-Wychowawczy dla Dzieci i Młodzieży Niepełnosprawnej im. Zbigniewa Tylewicza w Poznaniu|Poznań|ul. Augustyna Szamarzewskiego 78/82 |60-569 Poznań;1668;986;986;12;974;59.11;1.22
110123;306401;Szkoła Podstawowa nr 70 im. Mikołaja Kopernika|Poznań|ul. Piękna 37 |60-591 Poznań;1918;1238;1238;8;1230;64.55;0.65
110124;306401;Pływalnia Jednostki Wojskowej 1156|Poznań|ul. Jana Henryka Dąbrowskiego 252 |60-406 Poznań;1926;1358;1358;13;1345;70.51;0.96
110125;306401;Zespół Szkół nr 2|Poznań|ul. Hangarowa 14 |60-409 Poznań;1135;789;789;11;778;69.52;1.39
110126;306401;Zespół Szkół nr 2|Poznań|ul. Hangarowa 14 |60-409 Poznań;1251;816;816;12;804;65.23;1.47
110127;306401;Gimnazjum nr 63 im. Laureatów Nagrody Nobla|Poznań|ul. Michała Drzymały 4/6 |60-613 Poznań;2054;1137;1137;7;1130;55.36;0.62
110128;306401;Gimnazjum nr 63 im. Laureatów Nagrody Nobla|Poznań|ul. Michała Drzymały 4/6 |60-613 Poznań;1912;1255;1255;19;1236;65.64;1.51
110129;306401;Szkoła Podstawowa nr 89 im. Krzysztofa Kamila Baczyńskiego|Poznań|ul. Sochaczewska 3 |60-645 Poznań;1987;1384;1384;18;1366;69.65;1.30
110130;306401;Szkoła Podstawowa nr 89 im. Krzysztofa Kamila Baczyńskiego|Poznań|ul. Sochaczewska 3 |60-645 Poznań;2026;1293;1293;13;1280;63.82;1.01
110131;306401;XXV Liceum Ogólnokształcące im. Generałowej Jadwigi Zamoyskiej|Poznań|ul. Widna 1 |60-655 Poznań;2109;1298;1298;10;1288;61.55;0.77
110132;306401;Zespół Szkół nr 4 z Oddziałami Sportowymi|Poznań|os. Winiary 2 |60-665 Poznań;1568;1074;1074;14;1060;68.49;1.30
110133;306401;Uniwersytet Przyrodniczy w Poznaniu Instytut Melioracji, Kształtowania Środowiska i Geodezji|Poznań|ul. Piątkowska 94 |60-649 Poznań;2204;1286;1286;9;1277;58.35;0.70
110134;306401;Zespół Szkół nr 4 z Oddziałami Sportowymi|Poznań|os. Winiary 2 |60-665 Poznań;1906;1284;1284;8;1276;67.37;0.62
110135;306401;Zespół Szkół nr 7|Poznań|os. Zwycięstwa 101 |61-652 Poznań;1951;1264;1264;13;1251;64.79;1.03
110136;306401;Zespół Szkół nr 7|Poznań|os. Zwycięstwa 101 |61-652 Poznań;2035;1261;1264;25;1236;61.97;1.98
110137;306401;Zespół Szkół nr 7|Poznań|os. Zwycięstwa 101 |61-652 Poznań;2158;1427;1427;11;1416;66.13;0.77
110138;306401;Zespół Szkół Gimnazjalno-Licealnych nr 37|Poznań|os. Wichrowe Wzgórze 111 |61-699 Poznań;1978;1301;1301;22;1279;65.77;1.69
110139;306401;Szkoła Podstawowa nr 11 im. gen. Dezyderego Chłapowskiego|Poznań|os. Wichrowe Wzgórze 119 |61-699 Poznań;1902;1270;1270;11;1259;66.77;0.87
110140;306401;Szkoła Podstawowa nr 11 im. gen. Dezyderego Chłapowskiego|Poznań|os. Wichrowe Wzgórze 119 |61-699 Poznań;1821;1132;1132;23;1109;62.16;2.03
110141;306401;Zespół Szkół Gimnazjalno-Licealnych nr 37|Poznań|os. Wichrowe Wzgórze 111 |61-699 Poznań;1979;1267;1267;15;1252;64.02;1.18
110142;306401;Zespół Szkolno-Przedszkolny nr 5|Poznań|os. Kosmonautów 111 |61-641 Poznań;1573;1069;1069;11;1058;67.96;1.03
110143;306401;Zespół Szkolno-Przedszkolny nr 5|Poznań|os. Kosmonautów 111 |61-641 Poznań;1881;1119;1119;15;1104;59.49;1.34
110144;306401;Przedszkole nr 134 "Słoneczny Świat"|Poznań|os. Kosmonautów 108 |61-642 Poznań;1783;1105;1105;25;1080;61.97;2.26
110145;306401;Zespół Szkół z Oddziałami Sportowymi nr 1|Poznań|os. Pod Lipami 106 |61-638 Poznań;1884;1255;1255;15;1240;66.61;1.20
110146;306401;Zespół Szkół z Oddziałami Sportowymi nr 1|Poznań|os. Pod Lipami 106 |61-638 Poznań;1865;1248;1248;19;1229;66.92;1.52
110147;306401;Szkoła Podstawowa nr 66 im. Marii Skłodowskiej-Curie|Poznań|os. Przyjaźni 127 |61-689 Poznań;2020;1290;1290;17;1273;63.86;1.32
110148;306401;Gimnazjum nr 6 im. Edwarda Raczyńskiego|Poznań|os. Przyjaźni 136 |61-689 Poznań;1831;1237;1237;11;1226;67.56;0.89
110149;306401;Szkoła Podstawowa nr 66 im. Marii Skłodowskiej-Curie|Poznań|os. Przyjaźni 127 |61-689 Poznań;1137;719;719;9;710;63.24;1.25
110150;306401;Gimnazjum nr 6 im. Edwarda Raczyńskiego|Poznań|os. Przyjaźni 136 |61-689 Poznań;1786;1090;1090;15;1075;61.03;1.38
110151;306401;Przedszkole nr 129 im. Małych Przyjaciół|Poznań|os. Przyjaźni 135 |61-689 Poznań;1653;1068;1068;11;1057;64.61;1.03
110152;306401;Zespół Szkół Zawodowych nr 2 im. Janusza Korczaka|Poznań|ul. Żniwna 1 |61-663 Poznań;1957;1291;1291;18;1273;65.97;1.39
110153;306401;Zespół Szkół Łączności im. Mikołaja Kopernika|Poznań|ul. Przełajowa 4 |61-622 Poznań;1984;1512;1512;8;1504;76.21;0.53
110154;306401;Zespół Szkół Łączności im. Mikołaja Kopernika|Poznań|ul. Przełajowa 4 |61-622 Poznań;1973;1413;1413;5;1408;71.62;0.35
110155;306401;Siedziba Rady Osiedla Morasko-Radojewo|Poznań|ul. Morasko 57 |61-680 Poznań;1724;1066;1066;14;1052;61.83;1.31
110156;306401;Uniwersytet im. Adama Mickiewicza Wydział Nauk Geograficznych i Geologicznych|Poznań|ul. Dzięgielowa 27 |61-680 Poznań;1979;1472;1472;10;1462;74.38;0.68
110157;306401;Uniwersytet im. Adama Mickiewicza Wydział Nauk Geograficznych i Geologicznych|Poznań|ul. Dzięgielowa 27 |61-680 Poznań;1354;895;895;9;886;66.10;1.01
110158;306401;Szkoła Podstawowa nr 60 im. Wojciecha Bogusławskiego|Poznań|ul. Boranta 2 |61-608 Poznań;1708;1159;1159;16;1143;67.86;1.38
110159;306401;Szkoła Podstawowa nr 60 im. Wojciecha Bogusławskiego|Poznań|ul. Boranta 2 |61-608 Poznań;1703;1282;1282;9;1273;75.28;0.70
110160;306401;Zespół Szkolno-Przedszkolny nr 1|Poznań|os. Władysława Łokietka 104 |61-616 Poznań;1909;1292;1292;14;1278;67.68;1.08
110161;306401;Zespół Szkolno-Przedszkolny nr 1|Poznań|os. Władysława Łokietka 104 |61-616 Poznań;1974;1253;1253;9;1244;63.48;0.72
110162;306401;Szkoła Podstawowa nr 48 im. gen. Oswalda Franka|Poznań|ul. Sarmacka 105 |61-616 Poznań;1818;1124;1124;5;1119;61.83;0.44
110163;306401;Szkoła Podstawowa nr 48 im. gen. Oswalda Franka|Poznań|ul. Sarmacka 105 |61-616 Poznań;1781;1126;1126;9;1117;63.22;0.80
110164;306401;Szkoła Podstawowa nr 48 im. gen. Oswalda Franka|Poznań|ul. Sarmacka 105 |61-616 Poznań;1955;1462;1462;4;1458;74.78;0.27
110165;306401;Szkoła Podstawowa nr 45 im. Okrętu Rzeczypospolitej Polskiej "POZNAŃ"|Poznań|ul. Harcerska 3 |61-011 Poznań;1563;673;673;25;648;43.06;3.71
110166;306401;Gimnazjum nr 20 im. Ojca Mariana Żelazka|Poznań|ul. Główna 42 |61-007 Poznań;1777;886;887;28;858;49.86;3.16
110167;306401;Szkoła Podstawowa nr 85 im. Kawalerów Maltańskich|Poznań|ul. Piotra Tomickiego 16 |61-116 Poznań;1660;870;870;21;849;52.41;2.41
110168;306401;Poznańska Ogólnokształcąca Szkoła Muzyczna I stopnia nr 2 im. Tadeusza Szeligowskiego|Poznań|ul. Bydgoska 4 |61-127 Poznań;1159;548;548;7;541;47.28;1.28
110169;306401;Szkoła Podstawowa nr 85 im. Kawalerów Maltańskich|Poznań|ul. Piotra Tomickiego 16 |61-116 Poznań;2082;1204;1204;25;1179;57.83;2.08
110170;306401;Szkoła Podstawowa nr 46 im. Marii Dąbrowskiej|Poznań|ul. Inowrocławska 19 |61-044 Poznań;1736;834;834;14;820;48.04;1.68
110171;306401;Katolickie Stowarzyszenie Wychowawców Oddział w Poznaniu|Poznań|ul. Mińska 32 |61-049 Poznań;1880;1295;1295;6;1289;68.88;0.46
110172;306401;Szkoła Podstawowa nr 46 im. Marii Dąbrowskiej|Poznań|ul. Inowrocławska 19 |61-044 Poznań;1987;1233;1233;16;1217;62.05;1.30
110173;306401;Gimnazjum nr 22 im. Dezyderego Chłapowskiego|Poznań|ul. Leszka 42 |61-062 Poznań;1920;1210;1210;15;1195;63.02;1.24
110174;306401;Gimnazjum nr 22 im. Dezyderego Chłapowskiego|Poznań|ul. Leszka 42 |61-062 Poznań;2012;1292;1292;29;1263;64.21;2.24
110175;306401;Szkoła Podstawowa nr 55 im. Jurija Gagarina|Poznań|ul. Szpaków 1 |61-065 Poznań;1915;1194;1194;27;1167;62.35;2.26
110176;306401;Szkoła Podstawowa nr 55 im. Jurija Gagarina|Poznań|ul. Szpaków 1 |61-065 Poznań;1862;1129;1130;11;1118;60.63;0.97
110177;306401;Szkoła Podstawowa nr 6 im. Hipolita Cegielskiego z Oddziałami Integracyjnymi|Poznań|os. Rusa 56 |61-245 Poznań;1985;1227;1227;21;1206;61.81;1.71
110178;306401;Szkoła Podstawowa nr 6 im. Hipolita Cegielskiego z Oddziałami Integracyjnymi|Poznań|os. Rusa 56 |61-245 Poznań;2282;1461;1461;19;1442;64.02;1.30
110179;306401;Zespół Szkół Mistrzostwa Sportowego|Poznań|os. Tysiąclecia 43 |61-255 Poznań;1818;1265;1265;15;1250;69.58;1.19
110180;306401;Zespół Szkół Mistrzostwa Sportowego|Poznań|os. Tysiąclecia 43 |61-255 Poznań;1745;1009;1009;10;999;57.82;0.99
110181;306401;Szkoła Podstawowa nr 51 im. Bronisława Szwarca|Poznań|os. Lecha 37 |61-294 Poznań;2000;1339;1339;22;1317;66.95;1.64
110182;306401;Szkoła Podstawowa nr 51 im. Bronisława Szwarca|Poznań|os. Lecha 37 |61-294 Poznań;1943;1253;1253;25;1228;64.49;2.00
110183;306401;Zespół Szkół Ogólnokształcących nr 4|Poznań|os. Czecha 59 |61-288 Poznań;2018;1350;1350;23;1327;66.90;1.70
110184;306401;Szkoła Podstawowa nr 6 im. Hipolita Cegielskiego z Oddziałami Integracyjnymi|Poznań|os. Rusa 56 |61-245 Poznań;1783;1110;1110;13;1097;62.25;1.17
110185;306401;Szkoła Podstawowa nr 6 im. Hipolita Cegielskiego z Oddziałami Integracyjnymi|Poznań|os. Rusa 56 |61-245 Poznań;1738;1224;1224;13;1211;70.43;1.06
110186;306401;Zespół Szkół Ogólnokształcących nr 4|Poznań|os. Czecha 59 |61-288 Poznań;2017;1301;1301;10;1291;64.50;0.77
110187;306401;Zespół Szkół nr 6|Poznań|ul. Szczepankowo 74 |61-306 Poznań;1766;1175;1175;8;1167;66.53;0.68
110188;306401;Zespół Szkół nr 6|Poznań|ul. Szczepankowo 74 |61-306 Poznań;1705;1096;1096;11;1085;64.28;1.00
110189;306401;Zespół Szkół nr 6|Poznań|ul. Szczepankowo 74 |61-306 Poznań;1744;1179;1179;14;1165;67.60;1.19
110190;306401;Centrum Sportowe|Poznań|ul. Katowicka 95 |61-131 Poznań;1766;1300;1300;5;1295;73.61;0.38
110191;306401;Politechnika Poznańska (Piotrowo)|Poznań|ul. Jana Pawła II 28 |61-131 Poznań;1878;1329;1329;4;1325;70.77;0.30
110192;306401;Szkoła Podstawowa nr 3 im. Bolesława Krzywoustego|Poznań|os. Piastowskie 27 |61-149 Poznań;1964;1214;1214;17;1197;61.81;1.40
110193;306401;Zespół Szkół z Oddziałami Sportowymi nr 3|Poznań|os. Piastowskie 65 |61-156 Poznań;2041;1257;1257;24;1233;61.59;1.91
110194;306401;Gimnazjum nr 23 im. Szarych Szeregów|Poznań|os. Jagiellońskie 128 |61-223 Poznań;2006;1279;1279;14;1265;63.76;1.09
110195;306401;Szkoła Podstawowa nr 19 im. Stanisława Staszica|Poznań|os. Oświecenia 1 |61-205 Poznań;2015;1324;1324;18;1306;65.71;1.36
110196;306401;Szkoła Podstawowa nr 19 im. Stanisława Staszica|Poznań|os. Oświecenia 1 |61-205 Poznań;1991;1231;1231;10;1221;61.83;0.81
110197;306401;Klub "Złota Jesień"|Poznań|os. Powstań Narodowych 31 |61-215 Poznań;2106;1360;1360;12;1348;64.58;0.88
110198;306401;Szkoła Podstawowa nr 20 im. Stefana Batorego|Poznań|os. Rzeczypospolitej 44 |61-395 Poznań;2018;1346;1347;12;1334;66.70;0.89
110199;306401;XIV Liceum Ogólnokształcące im. Kazimierza Wielkiego|Poznań|os. Piastowskie 106 |61-164 Poznań;2012;1201;1201;18;1183;59.69;1.50
110200;306401;XIV Liceum Ogólnokształcące im. Kazimierza Wielkiego|Poznań|os. Piastowskie 106 |61-164 Poznań;1810;1185;1185;15;1170;65.47;1.27
110201;306401;Zespół Szkół Salezjańskich|Poznań|os. Bohaterów II Wojny Światowej 29 |61-387 Poznań;1900;1207;1207;19;1188;63.53;1.57
110202;306401;Zespół Szkół Salezjańskich|Poznań|os. Bohaterów II Wojny Światowej 29 |61-387 Poznań;1966;1233;1233;21;1212;62.72;1.70
110203;306401;Szkoła Podstawowa nr 18 im. Zofii Nałkowskiej|Poznań|os. Armii Krajowej 100 |61-381 Poznań;2139;1346;1346;20;1326;62.93;1.49
110204;306401;Szkoła Podstawowa nr 18 im. Zofii Nałkowskiej|Poznań|os. Armii Krajowej 100 |61-381 Poznań;1998;1286;1286;27;1259;64.36;2.10
110205;306401;Zespół Szkół z Oddziałami Integracyjnymi nr 1|Poznań|os. Stare Żegrze 1 |61-249 Poznań;2045;1314;1314;15;1299;64.25;1.14
110206;306401;Zespół Szkół z Oddziałami Integracyjnymi nr 1|Poznań|os. Stare Żegrze 1 |61-249 Poznań;1900;1329;1329;15;1314;69.95;1.13
110207;306401;Szkoła Podstawowa nr 64 im. Marii Konopnickiej|Poznań|os. Orła Białego 120 |61-251 Poznań;2078;1325;1325;13;1312;63.76;0.98
110208;306401;Szkoła Podstawowa nr 64 im. Marii Konopnickiej|Poznań|os. Orła Białego 120 |61-251 Poznań;1979;1320;1320;19;1301;66.70;1.44
110209;306401;Szkoła Podstawowa nr 64 im. Marii Konopnickiej|Poznań|os. Orła Białego 120 |61-251 Poznań;2092;1366;1366;9;1357;65.30;0.66
110210;306401;Szkoła Podstawowa nr 64 im. Marii Konopnickiej|Poznań|os. Orła Białego 120 |61-251 Poznań;2087;1285;1285;16;1269;61.57;1.25
110211;306401;Szkoła Podstawowa nr 64 im. Marii Konopnickiej|Poznań|os. Orła Białego 120 |61-251 Poznań;2065;1286;1286;14;1272;62.28;1.09
110212;306401;Zespół Szkół Ogólnokształcących nr 2 im. Charles`a de Gaulle`a|Poznań|ul. Tarnowska 27 |61-323 Poznań;1612;951;951;10;941;59.00;1.05
110213;306401;Wyższa Szkoła Techniczno-Humanistyczna Kadry dla Europy|Poznań|ul. Starołęcka 36/38 |61-361 Poznań;1959;1132;1132;23;1109;57.78;2.03
110214;306401;Przedszkole nr 15 "Calineczka"|Poznań|ul. św. Antoniego 42 |61-359 Poznań;1862;1100;1100;15;1085;59.08;1.36
110215;306401;Szkoła Podstawowa nr 59 im. gen. Jana Henryka Dąbrowskiego|Poznań|ul. Baranowska 1 |61-353 Poznań;1969;1306;1306;17;1289;66.33;1.30
110216;306401;Szkoła Podstawowa nr 63 im. Ksawerego Zakrzewskiego|Poznań|ul. Starołęcka 142 |61-341 Poznań;2008;1117;1117;17;1100;55.63;1.52
110217;306401;Zespół Szkół z Oddziałami Sportowymi nr 5|Poznań|ul. Głuszyna 187 |61-329 Poznań;1738;1046;1046;17;1029;60.18;1.63
110218;306401;Zespół Szkół z Oddziałami Sportowymi nr 5|Poznań|ul. Głuszyna 187 |61-329 Poznań;1514;832;832;16;816;54.95;1.92
110219;306401;Szkoła Podstawowa nr 58 im. Jerzego Kukuczki|Poznań|ul. Ławica 3 |60-186 Poznań;1812;1192;1192;29;1163;65.78;2.43
110220;306401;Szkoła Podstawowa nr 58 im. Jerzego Kukuczki|Poznań|ul. Ławica 3 |60-186 Poznań;1928;1472;1472;10;1462;76.35;0.68
110221;306401;Szkoła Podstawowa nr 58 im. Jerzego Kukuczki|Poznań|ul. Ławica 3 |60-186 Poznań;2026;1477;1477;9;1468;72.90;0.61
110222;306401;Zespół Szkół Specjalnych nr 101 im. Jana Brzechwy|Poznań|ul. Swoboda 41 |60-389 Poznań;1919;965;965;30;935;50.29;3.11
110223;306401;Zespół Szkół Elektrycznych nr 2 im. ks. Piotra Wawrzyniaka|Poznań|ul. Świt 25 |60-375 Poznań;2025;1039;1039;30;1009;51.31;2.89
110224;306401;Zespół Szkół Elektrycznych nr 2 im. ks. Piotra Wawrzyniaka|Poznań|ul. Świt 25 |60-375 Poznań;1910;1160;1160;8;1152;60.73;0.69
110225;306401;Zespół Szkół Specjalnych nr 101 im. Jana Brzechwy|Poznań|ul. Swoboda 41 |60-389 Poznań;1983;1063;1063;24;1039;53.61;2.26
110226;306401;Gimnazjum nr 56 im. Józefa Wybickiego|Poznań|ul. Promyk 4 |60-393 Poznań;1878;998;998;17;981;53.14;1.70
110227;306401;Szkoła Podstawowa nr 88 im. Poznańskich Koziołków|Poznań|ul. Swoboda 53 |60-389 Poznań;2016;1109;1109;23;1086;55.01;2.07
110228;306401;Zespół Szkół Gastronomicznych|Poznań|ul. Podkomorska 49 |60-326 Poznań;1802;1108;1128;12;1096;61.49;1.08
110229;306401;Zespół Szkół Gastronomicznych|Poznań|ul. Podkomorska 49 |60-326 Poznań;1767;1061;1061;11;1050;60.05;1.04
110230;306401;Szkoła Podstawowa nr 90 im. hr. Władysława Zamoyskiego|Poznań|ul. Józefa Chociszewskiego 56 |60-261 Poznań;2030;1475;1476;17;1458;72.66;1.15
110231;306401;XI Liceum Ogólnokształcące im. Jadwigi i Wacława Zembrzuskich|Poznań|ul. Piotra Ściegiennego 134 |60-304 Poznań;1675;1178;1178;6;1172;70.33;0.51
110232;306401;Szkoła Podstawowa nr 7 im. Erazma z Rotterdamu|Poznań|ul. Galileusza 14 |60-159 Poznań;1874;1261;1261;16;1245;67.29;1.27
110233;306401;International School of Poznań|Poznań|ul. Edmunda Taczanowskiego 18 |60-147 Poznań;1735;1110;1110;15;1095;63.98;1.35
110234;306401;Szkoła Podstawowa nr 7 im. Erazma z Rotterdamu|Poznań|ul. Galileusza 14 |60-159 Poznań;1849;1188;1188;10;1178;64.25;0.84
110235;306401;Szkoła Podstawowa nr 7 im. Erazma z Rotterdamu|Poznań|ul. Galileusza 14 |60-159 Poznań;1852;1211;1214;16;1195;65.39;1.32
110236;306401;Gimnazjum nr 54 Szkoła z Oddziałami Sportowymi im. Mikołaja Kopernika|Poznań|ul. Izaaka Newtona 2 |60-161 Poznań;2024;1340;1340;21;1319;66.21;1.57
110237;306401;Szkoła Podstawowa nr 80 im. Kornela Makuszyńskiego|Poznań|ul. Pogodna 84 |60-142 Poznań;2086;1303;1303;12;1291;62.46;0.92
110238;306401;Szkoła Podstawowa nr 80 im. Kornela Makuszyńskiego|Poznań|ul. Pogodna 84 |60-142 Poznań;1912;1226;1226;20;1206;64.12;1.63
110239;306401;Gimnazjum nr 50 im. Lotnictwa Polskiego|Poznań|ul. Piotra Ściegiennego 10 |60-128 Poznań;1917;1223;1223;18;1205;63.80;1.47
110240;306401;Gimnazjum nr 50 im. Lotnictwa Polskiego|Poznań|ul. Piotra Ściegiennego 10 |60-128 Poznań;1830;1077;1077;18;1059;58.85;1.67
110241;306401;Szkoła Podstawowa nr 10 im. Arkadego Fiedlera|Poznań|ul. Bosa 9 |60-125 Poznań;1715;1013;1013;10;1003;59.07;0.99
110242;306401;Szkoła Podstawowa nr 10 im. Arkadego Fiedlera|Poznań|ul. Bosa 9 |60-125 Poznań;1576;893;893;18;875;56.66;2.02
110243;306401;Przedszkole nr 67 im. Marii Konopnickiej|Poznań|ul. Słowicza 15 |60-121 Poznań;1639;887;887;9;878;54.12;1.01
110244;306401;Szkoła Podstawowa nr 4 im. Armii Poznań|Poznań|ul. Rawicka 12/14 |60-113 Poznań;1636;983;983;8;975;60.09;0.81
110245;306401;Publiczna Szkoła Podstawowa nr 52 Fundacji Familijny Poznań|Poznań|ul. Fabianowo 29 |60-005 Poznań;1384;766;766;16;750;55.35;2.09
110246;306401;Centrum Kształcenia Zawodowego i Ustawicznego|Poznań|ul. Jawornicka 1 |60-161 Poznań;1837;1301;1301;14;1287;70.82;1.08
110247;306401;Liceum Plastyczne im. Piotra Potworowskiego w Poznaniu|Poznań|ul. Junikowska 35 |60-163 Poznań;1733;1165;1165;10;1155;67.22;0.86
110248;306401;Szkoła Podstawowa nr 54 im. Jana Kasprowicza|Poznań|ul. Małoszyńska 38 |60-176 Poznań;2051;1509;1509;16;1493;73.57;1.06
110249;306401;Przedszkole nr 38 im. "Orle Gniazdo"|Poznań|ul. Junikowska 15 |60-163 Poznań;1692;1035;1035;9;1026;61.17;0.87
110250;306401;Dom Kultury "Stokrotka"|Poznań|ul. Cyniowa 11 |60-175 Poznań;1822;1175;1175;19;1156;64.49;1.62
110251;306401;Zespół Szkół z Oddziałami Integracyjnymi nr 2|Poznań|ul. Żonkilowa 34 |60-175 Poznań;1810;1245;1245;26;1219;68.78;2.09
110252;306401;Szkoła Podstawowa nr 15 im. Jana III Sobieskiego|Poznań|os. Jana III Sobieskiego 105 |60-688 Poznań;2106;1460;1460;13;1447;69.33;0.89
110253;306401;Szkoła Podstawowa nr 15 im. Jana III Sobieskiego|Poznań|os. Jana III Sobieskiego 105 |60-688 Poznań;1953;1251;1251;23;1228;64.06;1.84
110254;306401;Zespół Szkół Zakonu Pijarów im. św. Józefa Kalasancjusza|Poznań|os. Jana III Sobieskiego 114 |60-688 Poznań;2030;1305;1305;12;1293;64.29;0.92
110255;306401;Zespół Szkół Zakonu Pijarów im. św. Józefa Kalasancjusza|Poznań|os. Jana III Sobieskiego 114 |60-688 Poznań;1947;1246;1246;12;1234;64.00;0.96
110256;306401;Gimnazjum nr 12 im. Jacka Kuronia|Poznań|os. Stefana Batorego 101 |60-687 Poznań;1937;1378;1378;5;1373;71.14;0.36
110257;306401;Gimnazjum nr 12 im. Jacka Kuronia|Poznań|os. Stefana Batorego 101 |60-687 Poznań;1768;1258;1258;14;1244;71.15;1.11
110258;306401;Gimnazjum nr 12 im. Jacka Kuronia|Poznań|os. Stefana Batorego 101 |60-687 Poznań;2048;1412;1412;12;1400;68.95;0.85
110259;306401;Gimnazjum nr 12 im. Jacka Kuronia|Poznań|os. Stefana Batorego 101 |60-687 Poznań;1991;1287;1287;16;1271;64.64;1.24
110260;306401;Szkoła Podstawowa nr 34 im. Wojska Polskiego|Poznań|os. Bolesława Śmiałego 107 |60-682 Poznań;1963;1325;1325;20;1305;67.50;1.51
110261;306401;Szkoła Podstawowa nr 34 im. Wojska Polskiego|Poznań|os. Bolesława Śmiałego 107 |60-682 Poznań;2048;1296;1296;16;1280;63.28;1.23
110262;306401;Przedszkole nr 189|Poznań|os. Bolesława Śmiałego 105 |60-682 Poznań;2105;1375;1375;17;1358;65.32;1.24
110263;306401;Przedszkole nr 148 "Mali Europejczycy"|Poznań|os. Bolesława Chrobrego 121 |60-681 Poznań;2198;1488;1488;15;1473;67.70;1.01
110264;306401;Zespół Szkół Ogólnokształcących nr 15|Poznań|os. Bolesława Chrobrego 107 |60-681 Poznań;2061;1343;1343;12;1331;65.16;0.89
110265;306401;Zespół Szkół Ogólnokształcących nr 15|Poznań|os. Bolesława Chrobrego 107 |60-681 Poznań;2138;1429;1429;16;1413;66.84;1.12
110266;306401;Przedszkole nr 163 "Baśniowy Zamek"|Poznań|os. Bolesława Chrobrego 106 |60-681 Poznań;2153;1461;1461;24;1437;67.86;1.64
110267;306401;Szkoła Podstawowa nr 17 im. Józefa Ignacego Kraszewskiego|Poznań|os. Bolesława Chrobrego 105 |60-681 Poznań;2028;1377;1377;19;1358;67.90;1.38
110268;306401;Szkoła Podstawowa nr 17 im. Józefa Ignacego Kraszewskiego|Poznań|os. Bolesława Chrobrego 105 |60-681 Poznań;2064;1388;1388;15;1373;67.25;1.08
110269;306401;Piątkowska Szkoła Społeczna Szkoła Podstawowa im. dr Wandy Błeńskiej|Poznań|ul. Franciszka Stróżyńskiego 16 |60-688 Poznań;2089;1443;1443;8;1435;69.08;0.55
110270;306401;Szkoła Podstawowa nr 62 im. gen. Stanisława Taczaka|Poznań|ul. Druskienicka 32 |60-476 Poznań;1889;1337;1345;14;1323;70.78;1.05
110271;306401;Szkoła Podstawowa nr 62 im. gen. Stanisława Taczaka|Poznań|ul. Druskienicka 32 |60-476 Poznań;2254;1651;1651;21;1630;73.25;1.27
110272;306401;Szkoła Podstawowa nr 62 im. gen. Stanisława Taczaka|Poznań|ul. Druskienicka 32 |60-476 Poznań;2011;1197;1197;13;1184;59.52;1.09
110273;306401;Zespół Szkół nr 9|Poznań|ul. Hezjoda 15 |60-461 Poznań;1750;1335;1335;4;1331;76.29;0.30
110274;306401;Zespół Szkół nr 9|Poznań|ul. Hezjoda 15 |60-461 Poznań;1869;1465;1465;6;1459;78.38;0.41
110275;306401;Niepubliczne Szkolne Schronisko Młodzieżowe "Hanka"|Poznań|ul. Biskupińska 27 |60-463 Poznań;1663;1184;1185;10;1174;71.20;0.84
110276;306401;Zespół Szkół nr 1 im. Józefa Kostrzewskiego|Poznań|ul. Leśnowolska 35 |60-452 Poznań;2117;1367;1367;14;1353;64.57;1.02
110277;306401;Zespół Szkół nr 1 im. Józefa Kostrzewskiego|Poznań|ul. Leśnowolska 35 |60-452 Poznań;2142;1356;1356;10;1346;63.31;0.74
110278;306401;Zespół Szkół nr 1 im. Józefa Kostrzewskiego|Poznań|ul. Leśnowolska 35 |60-452 Poznań;2178;1461;1461;10;1451;67.08;0.68
110279;306401;Szkoła Podstawowa nr 28 im. Kornela Makuszyńskiego|Poznań|ul. Chojnicka 57 |60-480 Poznań;1448;939;939;8;931;64.85;0.85
110280;306401;Szpital Kliniczny Przemienienia Pańskiego Uniwersytetu Medycznego im. Karola Marcinkowskiego w Poznaniu|Poznań|ul. Długa 1/2 |61-848 Poznań;173;77;77;0;77;44.51;0.00
110281;306401;Wielkopolskie Centrum Onkologii im. Marii Skłodowskiej-Curie|Poznań|ul. Garbary 15 |61-866 Poznań;235;93;93;3;90;39.57;3.23
110282;306401;Zakład Opiekuńczo-Leczniczy Wielospecjalistycznego Szpitala Miejskiego im. Józefa Strusia w Poznaniu|Poznań|ul. Szkolna 8/12 |61-833 Poznań;38;4;4;0;4;10.53;0.00
110283;306401;Areszt Śledczy w Poznaniu|Poznań|ul. Młyńska 1 |61-729 Poznań;575;297;297;37;260;51.65;12.46
110284;306401;Centrum Medyczne HCP Sp. z o.o.|Poznań|ul. 28 Czerwca 1956 r. nr 194 |61-485 Poznań;249;74;74;5;69;29.72;6.76
110285;306401;Ortopedyczno-Rehabilitacyjny Szpital Kliniczny im. Wiktora Degi Uniwersytetu Medycznego im. Karola Macinkowskiego w Poznaniu|Poznań|ul. 28 Czerwca 1956 r. nr 135/147 |61-544 Poznań;163;108;108;6;102;66.26;5.56
110286;306401;Dom Pomocy Społecznej im. bł. Edmunda Bojanowskiego w Poznaniu|Poznań|ul. Mieczysława Niedziałkowskiego 22 |61-578 Poznań;40;21;21;1;20;52.50;4.76
110287;306401;Szpital Św. Rodziny Specjalistycznego Zespołu Opieki Zdrowotnej nad Matką i Dzieckiem w Poznaniu|Poznań|ul. Kazimierza Jarochowskiego 18 |60-235 Poznań;57;22;22;0;22;38.60;0.00
110288;306401;Szpital Kliniczny im. Heliodora Święcickiego Uniwersytetu Medycznego im. Karola Marcinkowskiego w Poznaniu|Poznań|ul. Grunwaldzka 16/18 |60-780 Poznań;194;65;65;2;63;33.51;3.08
110289;306401;Szpital Kliniczny im. Heliodora Święcickiego Uniwersytetu Medycznego im. Karola Marcinkowskiego w Poznaniu|Poznań|ul. Stanisława Przybyszewskiego 49 |60-355 Poznań;293;184;184;11;173;62.80;5.98
110290;306401;Dom Studencki „Eskulap” Uniwersytetu Medycznego im. Karola Marcinkowskiego w Poznaniu|Poznań|ul. Stanisława Przybyszewskiego 39 |60-356 Poznań;237;210;210;1;209;88.61;0.48
110291;306401;Ginekologiczno-Położniczy Szpital Kliniczny Uniwersytetu Medycznego im. Karola Marcinkowskiego w Poznaniu|Poznań|ul. Polna 33 |60-535 Poznań;158;87;87;1;86;55.06;1.15
110292;306401;Szpital Miejski im. Franciszka Raszei w Poznaniu|Poznań|ul. Adama Mickiewicza 2 |60-834 Poznań;140;73;73;2;71;52.14;2.74
110293;306401;Dom Pomocy Społecznej w Poznaniu|Poznań|ul. Bukowska 27/29 |60-501 Poznań;113;39;39;4;35;34.51;10.26
110294;306401;Wielkopolskie Centrum Pulmonologii i Torakochirurgii im. Eugenii i Janusza Zeylandów w Poznaniu|Poznań|ul. Augustyna Szamarzewskiego 62 |60-569 Poznań;183;110;110;3;107;60.11;2.73
110295;306401;Szpital Kliniczny Przemienienia Pańskiego Uniwersytetu Medycznego im. Karola Marcinkowskiego w Poznaniu|Poznań|ul. Augustyna Szamarzewskiego 82/84 |60-569 Poznań;112;60;60;0;60;53.57;0.00
110296;306401;Szpital Kliniczny im. Karola Jonschera Uniwersytetu Medycznego im. Karola Marcinkowskiego w Poznaniu|Poznań|ul. Szpitalna 27/33 |60-572 Poznań;83;34;34;0;34;40.96;0.00
110297;306401;Dom Pomocy Społecznej w Poznaniu|Poznań|ul. Ugory 18/20 |61-623 Poznań;132;71;71;10;61;53.79;14.08
110298;306401;Szpital Wojewódzki w Poznaniu|Poznań|ul. Juraszów 7/19 |60-479 Poznań;352;156;156;7;149;44.32;4.49
110299;306401;Samodzielny Publiczny Zakład Opieki Zdrowotnej Ministerstwa Spraw Wewnętrznych w Poznaniu im. prof. Ludwika Bierkowskiego|Poznań|ul. Dojazd 34 |60-631 Poznań;99;56;56;4;52;56.57;7.14
110300;306401;Dom Studencki „Zbyszko” Uniwersytetu im. Adama Mickiewicza w Poznaniu|Poznań|ul. Piątkowska 80 |60-649 Poznań;149;131;131;0;131;87.92;0.00
110301;306401;Dom Pomocy Społecznej w Poznaniu|Poznań|ul. Stanisława Konarskiego 11/13 |61-114 Poznań;84;48;48;2;46;57.14;4.17
110302;306401;Zakład Opiekuńczo-Leczniczy i Rehabilitacji Medycznej Samodzielny Publiczny Zakład Opieki Zdrowotnej|Poznań|ul. Mogileńska 42 |61-044 Poznań;125;58;58;1;57;46.40;1.72
110303;306401;Wielospecjalistyczny Szpital Miejski im. Józefa Strusia z Zakładem Opiekuńczo-Leczniczym Samodzielny Publiczny Zakład Opieki Zdrowotnej|Poznań|ul. Szwajcarska 3 |61-285 Poznań;349;158;158;7;151;45.27;4.43
110304;306401;Dom Pomocy Społecznej w Poznaniu|Poznań|ul. Mińska 14 |61-049 Poznań;75;57;57;0;57;76.00;0.00
110305;306401;Hospicjum Palium Szpitala Klinicznego Przemienienia Pańskiego Uniwersytetu Medycznego im. Karola Marcinkowskiego w Poznaniu|Poznań|os. Rusa 25a |61-245 Poznań;29;11;11;0;11;37.93;0.00
110306;306401;Dom Pomocy Społecznej w Poznaniu|Poznań|ul. Pokrzywno 1 |61-315 Poznań;59;52;52;0;52;88.14;0.00
110307;306401;Dom Pomocy Społecznej w Poznaniu|Poznań|ul. Ludwika Zamenhofa 142a |61-139 Poznań;68;33;33;4;29;48.53;12.12
110308;306401;Dom Studencki nr 6 Politechniki Poznańskiej|Poznań|ul. św. Rocha 11b |61-142 Poznań;192;177;177;0;177;92.19;0.00
110309;306401;Dom Pomocy Społecznej|Poznań|ul. Sielska 13 |60-129 Poznań;81;56;56;2;54;69.14;3.57
110310;306401;Oddział Zewnętrzny Aresztu Śledczego w Poznaniu|Poznań|ul. Nowosolska 40 |60-171 Poznań;183;115;115;15;100;62.84;13.04
110311;306401;Szpital Rehabilitacyjny w Poznaniu Szpitala Wojewódzkiego w Poznaniu|Poznań|ul. Uzdrowiskowa 2 |60-480 Poznań;77;57;57;5;52;74.03;8.77
110312;320101;Komenda Powiatowa Państwowej Straży Pożarnej w Białogardzie|Białogard|ul.Szosa Połczyńska 1 |78-200 Białogard;1477;658;658;20;638;44.55;3.04
110313;320101;Szkoła Podstawowa Nr 3 w Białogardzie|Białogard|ul. Chopina 8 |78-200 Białogard;947;477;477;18;459;50.37;3.77
110314;320101;Szkoła Podstawowa Nr 3 w Białogardzie|Białogard|ul. Chopina 8 |78-200 Białogard;1737;742;742;37;705;42.72;4.99
110315;320101;Szkoła Podstawowa Nr 4 w Białogardzie|Białogard|ul. Grunwaldzka 53 |78-200 Białogard;850;360;360;15;345;42.35;4.17
110316;320101;Przedszkole Miejskie Nr 3 w Białogardzie|Białogard|ul. Kochanowskiego 21 |78-200 Białogard;994;460;460;9;451;46.28;1.96
110317;320101;Centrum Kultury i Spotkań Europejskich w Białogardzie|Białogard|ul. 1 Maja 15 |78-200 Białogard;1759;808;808;24;784;45.94;2.97
110318;320101;Zespół Szkół Ponadgimnazjalnych w Białogardzie|Białogard|ul. Dąbrowszczaków 14 |78-200 Białogard;1825;885;885;24;861;48.49;2.71
110319;320101;Gimnazium Nr 2 w Białogardzie|Białogard|ul. Kościelna 1 |78-200 Białogard;880;289;289;12;277;32.84;4.15
110320;320101;Gimnazium Nr 2 w Białogardzie|Białogard|ul. Kościelna 1 |78-200 Białogard;922;376;376;11;365;40.78;2.93
110321;320101;Gimnazjum Nr 1 w Białogard|Białogard|ul. Świdwińska 7 |78-200 Białogard;917;387;387;19;368;42.20;4.91
110322;320101;Stacja Doświadczalna Oceny Odmian w Białogardzie|Białogard|ul. Kisielice Duże 28 |78-200 Białogard;891;424;424;9;415;47.59;2.12
110323;320101;Szkoła Podstawowa Nr 5 w Białogardzie|Białogard|ul. Kołobrzeska 23 |78-200 Białogard;835;397;397;16;381;47.54;4.03
110324;320101;Klub Osiedlowy Białogardzkiej Spółdzielni Mieszkaniowej|Białogard|ul. Władysława Komara 25 |78-200 Białogard;1832;941;941;27;914;51.36;2.87
110325;320101;Państwowa Szkoła Muzyczna I stopnia w Białogardzie|Białogard|ul.Dworcowa 4 |78-200 Białogard;1723;732;732;46;686;42.48;6.28
110326;320101;Klub Osiedlowy Białogardziej Spółdzielni Mieszkaniowej|Białogard|Kochanowskiego 26 |78-200 Białogard;1054;573;573;22;551;54.36;3.84
110327;320101;Regionalne Centrum Medyczne w Białogardzie|Białogard|Chopina 29 |78-200 Białogard;215;80;80;2;78;37.21;2.50
110328;320101;Regionalne Centrum Medyczne w Białogardzie|Białogard|Szpitalna 7 |78-200 Białogard;36;11;11;0;11;30.56;0.00
110329;320101;Dom Pomocy Społecznej w Białogardzie|Białogard|Mickiewicza 6 |78-200 Białogard;47;35;35;1;34;74.47;2.86
110330;320101;Dom Pomocy Społecznej w Białogardzie|Białogard|Świętego Brata Alberta 1 |78-200 Białogard;118;65;65;3;62;55.08;4.62
110331;320102;Świetlica Wiejska w Redlinie|Redlino| 7 |78-200 Białogard;760;262;262;18;244;34.47;6.87
110332;320102;Gimnazjum w Pomianowie|Pomianowo| 6 |78-200 Białogard;1243;343;343;18;325;27.59;5.25
110333;320102;Szkoła Podstawowa w Rogowie|Rogowo| 63 |78-200 Białogard;1544;375;375;18;357;24.29;4.80
110334;320102;Szkoła Podstawowa w Stanominie|Stanomino| 30 |78-217 Stanomino;1677;502;502;26;476;29.93;5.18
110335;320102;Szkoła Podstawowa w Kościernicy|Kościernica| 28 |78-200 Białogard;945;308;308;25;283;32.59;8.12
110336;320103;Karliński Ośrodek Kultury w Karlinie|Karlino|ul. Parkowa 1 |78-230 Karlino;1210;358;358;17;341;29.59;4.75
110337;320103;Szkoła Podstawowa|Karlino|ul. Traugutta 2 |78-230 Karlino;1747;684;684;32;652;39.15;4.68
110338;320103;Warsztat Terapii Zajęciowej w Karlinie|Karlino|ul. Kościuszki 3 |78-230 Karlino;1581;754;754;29;725;47.69;3.85
110339;320103;Szkoła Podstawowa|Daszewo| 56 |78-230 Karlino;840;188;188;13;175;22.38;6.91
110340;320103;Szkoła Podstawowa|Karścino| 18 |78-230 Karlino;1136;220;220;14;206;19.37;6.36
110341;320103;Szkoła Podstawowa|Karwin| 23 |78-230 Karlino;583;182;182;5;177;31.22;2.75
110342;320104;Świetlica wiejska|Sadkowo| 55 |78-220 Tychowo;857;244;244;15;229;28.47;6.15
110343;320104;Świetlica wiejska|Kowalki| 21 |78-220 Tychowo;726;196;196;13;183;27.00;6.63
110344;320104;Gimnazjum|Tychowo|ul. Dworcowa 11A |78-220 Tychowo;1579;551;551;24;527;34.90;4.36
110345;320104;Urząd Miejski w Tychowie|Tychowo|ul. Bobolicka 17 |78-220 Tychowo;1060;515;515;15;500;48.58;2.91
110346;320104;Zespół Szkół|Dobrowo| 24 |78-220 Tychowo;1233;379;379;40;339;30.74;10.55
110347;320104;Odział Zewnętrzny Dobrowo Aresztu Śledczego Koszalin|Dobrowo| 53 |78-220 Tychowo;404;206;206;22;184;50.99;10.68
110348;320201;Gimnazjum Publiczne|Bierzwnik|ul.Krajowej Rady Narodowej 18 |73-240 Bierzwnik;1804;715;715;34;681;39.63;4.76
110349;320201;Świetlica Wiejska|Breń| 30A |73-240 Bierzwnik;1303;341;341;19;322;26.17;5.57
110350;320201;Szkoła Podstawowa|Zieleniewo| 37 |73-240 Bierzwnik;803;246;246;9;237;30.64;3.66
110351;320202;Choszczeński Dom Kultury|Choszczno|ul. Bohaterów Warszawy 17 |73-200 Choszczno;866;404;404;11;393;46.65;2.72
110352;320202;Publiczne Przedszkole Nr 4|Choszczno|ul. Mur Południowy 4 |73-200 Choszczno;1539;754;754;17;737;48.99;2.25
110353;320202;Publiczne Przedszkole Nr 5|Choszczno|ul. Energetyków 1 |73-200 Choszczno;1450;696;696;11;685;48.00;1.58
110354;320202;Szkoła Podstawowa Nr 3|Choszczno|ul. Wolności 62 |73-200 Choszczno;1056;361;361;10;351;34.19;2.77
110355;320202;Urząd Miejski|Choszczno|ul. Wolności 24 |73-200 Choszczno;657;289;289;6;283;43.99;2.08
110356;320202;Publiczne Przedszkole Nr 2|Choszczno|ul. Sucharskiego 9 |73-200 Choszczno;871;354;354;11;343;40.64;3.11
110357;320202;Publiczne Gimnazjum|Choszczno|ul. Obrońców Westerplatte 1A |73-200 Choszczno;818;387;387;7;380;47.31;1.81
110358;320202;Środowiskowy Dom Samopomocy|Choszczno|ul. Dąbrowszczaków 40 |73-200 Choszczno;980;400;400;11;389;40.82;2.75
110359;320202;Miejska Biblioteka Publiczna im.Marii Dąbrowskiej|Choszczno|ul. Wolności 11 |73-200 Choszczno;817;332;332;13;319;40.64;3.92
110360;320202;Miejsko-Gminny Ośrodek Pomocy Społecznej|Choszczno|ul. Grunwaldzka 36 |73-200 Choszczno;1337;654;654;16;638;48.92;2.45
110361;320202;Zespół Szkół Nr 1|Choszczno|ul. Bolesława Chrobrego 31A |73-200 Choszczno;928;376;376;7;369;40.52;1.86
110362;320202;Przedszkole Nr 1 z Oddziałami Integracyjnymi|Choszczno|ul. Niedziałkowskiego 9 |73-200 Choszczno;860;319;319;16;303;37.09;5.02
110363;320202;Szkoła Podstawowa Nr 1|Choszczno|ul. Obrońców Westerplatte 1 |73-200 Choszczno;781;337;337;4;333;43.15;1.19
110364;320202;Szkoła Podstawowa w Sławęcinie|Sławęcin| 60 |73-200 Choszczno;749;231;231;15;216;30.84;6.49
110365;320202;Szkoła Podstawowa w Suliszewie|Suliszewo|ul. Zwycięstwa 26 |73-222 Suliszewo;1059;276;276;5;271;26.06;1.81
110366;320202;Szkoła Podstawowa w Zamęcinie|Zamęcin| 2 |73-200 Choszczno;939;308;308;8;300;32.80;2.60
110367;320202;Szkoła Podstawowa w Korytowie|Korytowo|ul. Szkolna 4 |73-222 Suliszewo;1000;297;297;22;275;29.70;7.41
110368;320202;Warsztat Terapii Zajęciowej w Piaseczniku|Piasecznik| 82 |73-200 Choszczno;605;196;196;13;183;32.40;6.63
110369;320202;Samodzielny Publiczny Zakład Opieki Zdrowotnej|Choszczno|ul. Niedziałkowskiego 4 |73-200 Choszczno;258;65;65;3;62;25.19;4.62
110370;320202;Areszt Śledczy|Choszczno|ul. Wolności 12 |73-200 Choszczno;110;76;76;15;61;69.09;19.74
110371;320202;Areszt Śledczy - Oddział Zewnętrzny|Choszczno|ul. Matejki 3 |73-200 Choszczno;94;46;46;7;39;48.94;15.22
110372;320203;Szkoła Podstawowa|Drawno|ul. Szkolna 25 |73-220 Drawno;1058;435;435;15;420;41.12;3.45
110373;320203;Szkoła Podstawowa|Drawno|ul. Szkolna 25 |73-220 Drawno;1303;451;451;11;440;34.61;2.44
110374;320203;Świetlica wiejska|Barnimie| 70 |73-220 Drawno;939;259;259;11;248;27.58;4.25
110375;320203;Świetlica wiejska|Brzeziny| 61A |73-220 Drawno;411;155;155;18;137;37.71;11.61
110376;320203;Świetlica wiejska|Święciechów| 3d |73-220 Drawno;460;120;120;13;107;26.09;10.83
110377;320203;Dom Pomocy Społecznej|Brzeziny| 1 |73-220 Drawno;79;29;29;1;28;36.71;3.45
110378;320204;Urząd Gminy|Krzęcin|ul. Tylna 7 |73-231 Krzęcin;1722;528;528;31;497;30.66;5.87
110379;320204;Gminne Centrum Kultury|Krzęcin|ul. Szkolna 2 |73-231 Krzęcin;1308;322;322;19;303;24.62;5.90
110380;320205;Zespół Szkół|Pełczyce|ul. Kościelna 3 |73-260 Pełczyce;2113;802;802;44;758;37.96;5.49
110381;320205;Zespół Szkół|Lubiana| 6 |73-260 Pełczyce;1581;508;508;38;470;32.13;7.48
110382;320205;Miejsko-Gminne Przedszkole|Pełczyce|ul. Bolesława Chrobrego 17 |73-260 Pełczyce;976;216;216;9;207;22.13;4.17
110383;320205;Szkoła Podstawowa|Będargowo| 14 |73-260 Pełczyce;1563;406;406;23;383;25.98;5.67
110384;320206;Szkoła Podstawowa|Recz|ul. Ratuszowa 29 |73-210 Recz;1451;484;484;16;468;33.36;3.31
110385;320206;Szkoła Podstawowa|Recz|ul.Ratuszowa 29 |73-210 Recz;1210;435;435;18;417;35.95;4.14
110386;320206;Świetlica wiejska Lubieniów|Lubieniów| 27a 8|73-210 Recz;958;168;168;10;158;17.54;5.95
110387;320206;Świetlica wiejska Sokoliniec|Sokoliniec| 32 |73-210 Recz;873;202;202;17;185;23.14;8.42
110388;320301;Gimnazjum|Czaplinek|ul. Słoneczna 27 |78-550 Czaplinek;1964;812;812;31;781;41.34;3.82
110389;320301;Czaplinecki Ośrodek Kultury|Czaplinek|ul. Pławieńska 1a |78-550 Czaplinek;1283;542;542;23;519;42.24;4.24
110390;320301;Szkoła Podstawowa|Czaplinek|ul. Wałecka 49 |78-550 Czaplinek;1170;543;543;11;532;46.41;2.03
110391;320301;Przedszkole Publiczne|Czaplinek|ul. Grunwaldzka 5b |78-550 Czaplinek;1289;494;494;13;481;38.32;2.63
110392;320301;Spółdzielnia Kółek Rolniczych Spółka z o.o.|Czaplinek|ul. Pławieńska 18 |78-550 Czaplinek;1285;402;402;13;389;31.28;3.23
110393;320301;Sala wiejska|Siemczyno| 63 |78-551 Siemczyno;605;199;199;14;185;32.89;7.04
110394;320301;Sala wiejska|Kluczewo|ul. Białego Orła 25 |78-552 Kluczewo;894;269;269;14;255;30.09;5.20
110395;320301;Świetlica wiejska|Broczyno| 33 |78-553 Broczyno;973;253;253;11;242;26.00;4.35
110396;320302;Świetlica Samorządu Mieszkańców Nr 2 w Drawsku Pomorskim|Drawsko Pomorskie|ul. Gierymskiego nr 3 |78-500 Drawsko Pomorskie;809;418;418;8;410;51.67;1.91
110397;320302;Świetlica Samorządu Mieszkańców Nr 2 w Drawsku Pomorskim|Drawsko Pomorskie|ul. Gierymskiego nr 3 |78-500 Drawsko Pomorskie;910;433;433;12;421;47.58;2.77
110398;320302;Przedszkole w Drawsku Pomorskim|Drawsko Pomorskie|ul. Obr. Westerplatte nr 47-49 |78-500 Drawsko Pomorskie;893;423;423;12;411;47.37;2.84
110399;320302;Szkoła Podstawowa w Drawsku Pomorskim|Drawsko Pomorskie|ul. Obr. Westerplatte nr 13 |78-500 Drawsko Pomorskie;911;459;459;13;446;50.38;2.83
110400;320302;Szkoła Podstawowa w Drawsku Pomorskim|Drawsko Pomorskie|ul. Obr. Westerplatte nr 13 |78-500 Drawsko Pomorskie;811;283;283;15;268;34.90;5.30
110401;320302;Przedszkole w Drawsku Pomorskim|Drawsko Pomorskie|ul. Obr. Westerplatte nr 47-49 |78-500 Drawsko Pomorskie;821;366;366;12;354;44.58;3.28
110402;320302;Szkoła Podstawowa w Drawsku Pomorskim|Drawsko Pomorskie|ul. Obr. Westerplatte nr 13 |78-500 Drawsko Pomorskie;778;311;311;10;301;39.97;3.22
110403;320302;Powiatowy Urząd Pracy w Drawsku Pomorskim|Drawsko Pomorskie|ul. Starogrodzka nr 9 |78-500 Drawsko Pomorskie;955;439;439;6;433;45.97;1.37
110404;320302;Przedszkole w Drawsku Pomorskim|Drawsko Pomorskie|ul. B. Chrobrego nr 4a |78-500 Drawsko Pomorskie;836;351;351;9;342;41.99;2.56
110405;320302;Gimnazjum w Drawsku Pomorskim|Drawsko Pomorskie|ul. Dworcowa nr 2A |78-500 Drawsko Pomorskie;846;362;362;16;346;42.79;4.42
110406;320302;Zespół Szkół Ponadgimnazjalnych w Drawsku Pomorskim Liceum Ogólnokształcące|Drawsko Pomorskie|ul. Złocieniecka nr 25 |78-500 Drawsko Pomorskie;841;320;320;13;307;38.05;4.06
110407;320302;Szkoła Podstawowa w Mielenku Drawskim|Mielenko Drawskie| nr 47 |78-500 Drawsko Pomorskie;1102;333;333;8;325;30.22;2.40
110408;320302;Gimnazjum w Drawsku Pomorskim|Drawsko Pomorskie|ul. Dworcowa nr 2A |78-500 Drawsko Pomorskie;695;171;171;7;164;24.60;4.09
110409;320302;Szkoła Podstawowa w Nętnie|Nętno| nr 38 |78-500 Drawsko Pomorskie;818;283;283;10;273;34.60;3.53
110410;320302;Świetlica Wiejska w Suliszewie|Suliszewo| nr 70A |78-500 Drawsko Pomorskie;1207;359;359;22;337;29.74;6.13
110411;320302;Szpitale Polskie S.A. - Drawskie Centrum Specjalistyczne w Drawsku Pomorskim|Drawsko Pomorskie|B.Chrobrego 4 |78-500 Drawsko Pomorskie;28;17;17;0;17;60.71;0.00
110412;320303;Zakład Przemysłu Drzewnego|Kalisz Pomorski|Wrocławska 1 |78-540 Kalisz Pomorski;791;259;259;10;249;32.74;3.86
110413;320303;Nadleśnictwo Kalisz Pomorski|Kalisz Pomorski|ul. Al. prof. Leona Mroczkiewicza 1 |78-540 Kalisz Pomorski;731;284;284;16;268;38.85;5.63
110414;320303;Miejsko Gminny Ośrodek Kultury Kalisz Pomorski|Kalisz Pomorski|ul. Dworcowa 6 |78-540 Kalisz Pomorski;1225;328;328;22;306;26.78;6.71
110415;320303;Pałac Wedlów|Kalisz Pomorski|Wolności 31 |78-540 Kalisz Pomorski;1139;451;451;24;427;39.60;5.32
110416;320303;Gimnazjum im. Marii Skłodowskiej-Curie|Kalisz Pomorski|Toruńska 9 |78-540 Kalisz Pomorski;797;285;285;11;274;35.76;3.86
110417;320303;Szkoła Podstawowa w Pomierzynie|Pomierzyn| 10 |78-540 Kalisz Pomorski;1084;280;280;15;265;25.83;5.36
110418;320304;Zespół Szkół|Ostrowice| 3 |78-506 Ostrowice;864;297;297;12;285;34.38;4.04
110419;320304;Świetlica wiejska|Nowe Worowo|Al. Wolności 2 |78-523 Nowe Worowo;675;263;263;18;245;38.96;6.84
110420;320304;Świetlica wiejska|Bolegorzyn| 1 |78-523 Nowe Worowo;237;66;66;3;63;27.85;4.55
110421;320304;Świetlica wiejska|Dołgie| 24 |78-506 Ostrowice;273;80;80;3;77;29.30;3.75
110422;320305;Zespół Szkół|Świerczyna| 85 |78-531 Świerczyna;903;296;296;13;283;32.78;4.39
110423;320305;Świetlica Wiejska|Wierzchowo|Plac Orła Białego 4 |78-530 Wierzchowo;720;219;219;5;214;30.42;2.28
110424;320305;Gimnazjum|Wierzchowo|ul. Długa 26a |78-530 Wierzchowo;940;335;335;16;319;35.64;4.78
110425;320305;Sala Wiejska "Lasek Arkoński"|Wierzchowo|Parkowa 7 |78-530 Wierzchowo;982;325;325;12;313;33.10;3.69
110426;320305;Zakład Karny|Wierzchowo|Szkolna 8 |78-530 Wierzchowo;382;225;225;42;183;58.90;18.67
110427;320306;Zakład Gospodarki Mieszkaniowej Sp. z o. o.|Złocieniec|ul. Piaskowa 1 |78-520 Złocieniec;779;391;391;13;378;50.19;3.32
110428;320306;Przedszkole|Złocieniec|ul. Okrzei 4 |78-520 Złocieniec;844;352;352;8;344;41.71;2.27
110429;320306;Biuro Powiatu Drawskiego ARiMR|Złocieniec|ul. Drawska 13 |78-520 Złocieniec;842;354;354;14;340;42.04;3.95
110430;320306;Gimnazjum Nr 1|Złocieniec|ul. Chopina 10 |78-520 Złocieniec;822;355;355;10;345;43.19;2.82
110431;320306;Filia Nr 1 Biblioteki Publicznej|Złocieniec|ul. Obrońców Westerplatte 3 |78-520 Złocieniec;908;445;445;12;433;49.01;2.70
110432;320306;Spółdzielnia Mieszkaniowa "Postęp"|Złocieniec|ul. Obrońców Westerplatte 3 |78-520 Złocieniec;1666;817;817;30;787;49.04;3.67
110433;320306;Szkoła Podstawowa Nr 1|Złocieniec|ul. I Dywizji Wojska Polskiego 4 |78-520 Złocieniec;832;373;373;6;367;44.83;1.61
110434;320306;Sala Widowiskowa|Złocieniec|ul. Wolności 6 |78-520 Złocieniec;1494;573;573;20;553;38.35;3.49
110435;320306;Urząd Miejski|Złocieniec|Stary Rynek 3 |78-520 Złocieniec;1475;661;661;25;636;44.81;3.78
110436;320306;Zespół Szkół w Złocieńcu|Złocieniec|Czwartaków 2 |78-520 Złocieniec;807;346;346;13;333;42.87;3.76
110437;320306;Świetlica Wiejska|Bobrowo| 14 |78-520 Złocieniec;268;95;95;3;92;35.45;3.16
110438;320306;Świetlica Wiejska|Stare Worowo| 7 |78-523 Nowe Worowo;561;181;181;13;168;32.26;7.18
110439;320306;Dom Pomocy Społecznej|Darskowo| 7 |78-520 Złocieniec;214;71;71;5;66;33.18;7.04
110440;320306;Świetlica Wiejska|Kosobudy| 21 |78-520 Złocieniec;320;118;118;7;111;36.88;5.93
110441;320306;Świetlica Wiejska|Lubieszewo| 30 |78-520 Złocieniec;380;145;145;9;136;38.16;6.21
110442;320306;Samodzielny Publiczny Zakład Opieki Zdrowotnej Szpital Specjalistyczny MSW|Złocieniec|Kańsko 1 |78-520 Złocieniec;106;82;82;7;75;77.36;8.54
110443;320402;Szkoła Podstawowa Nr 3|Goleniów|ul.Jodłowa 33 |72-100 Goleniów;1289;634;634;15;619;49.19;2.37
110444;320402;Miejska i Powiatowa Biblioteka Publiczna|Goleniów|ul.Konstytucji 3 Maja 26 |72-100 Goleniów;1217;593;593;19;574;48.73;3.20
110445;320402;Szkoła Podstawowa z Oddziałami Integracyjnymi Nr 2|Goleniów|ul. Szarych Szeregów 14 |72-100 Goleniów;1335;703;703;13;690;52.66;1.85
110446;320402;Goleniowskie Towarzystwo Budownictwa Społecznego|Goleniów|ul. Witosa 7 |72-100 Goleniów;1288;553;553;7;546;42.93;1.27
110447;320402;Przedszkole Publiczne Nr 4|Goleniów|ul. Jagiełły 12 |72-100 Goleniów;1352;577;577;17;560;42.68;2.95
110448;320402;Zespół Szkół nr 1|Goleniów|ul. Niepodległości 1 |72-100 Goleniów;1255;663;663;15;648;52.83;2.26
110449;320402;Przedszkole z Oddziałami Integracyjnymi "Tęczowa Kraina"|Goleniów|ul.Piaskowa 9 |72-100 Goleniów;1359;684;684;12;672;50.33;1.75
110450;320402;Przedszkole Publiczne Nr 2|Goleniów|ul.Akacjowa 19 |72-100 Goleniów;1210;599;599;9;590;49.50;1.50
110451;320402;Szkoła Podstawowa z Oddziałami Integracyjnymi Nr 4|Goleniów|ul.Szczecińska 36 |72-100 Goleniów;1282;648;648;17;631;50.55;2.62
110452;320402;Gimnazjum Nr 2|Goleniów|ul. Norwida 1 |72-100 Goleniów;1310;688;688;10;678;52.52;1.45
110453;320402;Urząd Gminy i Miasta|Goleniów|ul.Plac Lotników 1 |72-100 Goleniow;1341;598;598;13;585;44.59;2.17
110454;320402;Goleniowski Dom Kultury|Goleniów|ul.Słowackiego 1 |72-100 Goleniów;1170;516;516;8;508;44.10;1.55
110455;320402;Klub Centrum Animacji Młodzieży|Goleniów|ul. Matejki 3C |72-100 Goleniów;1305;722;722;17;705;55.33;2.35
110456;320402;Goleniowskie Towarzystwo Budownictwo Społecznego|Goleniów|ul. Witosa 7 |72-100 Goleniów;1242;629;629;16;613;50.64;2.54
110457;320402;Szkoła Podstawowa|Krępsko|ul. Szkolna 2 |72-105 Lubczyna;1285;469;469;3;466;36.50;0.64
110458;320402;Zespół Szkół Publicznych|Białuń|ul. Sielankowa 4 |72-100 Goleniów;1368;560;560;8;552;40.94;1.43
110459;320402;Zespół Szkół Publicznych|Mosty| 4 |72-132 Mosty;1285;474;474;29;445;36.89;6.12
110460;320402;Klub Stara Hydrofornia|Goleniów|ul. Krzywoustego 16 |72-100 Goleniów;1258;536;536;13;523;42.61;2.43
110461;320402;Zespół Szkół Publicznych|Kliniska Wielkie|ul. Piastowska 11 |72-123 Kliniska Wielkie;1701;903;903;12;891;53.09;1.33
110462;320402;Szkoła Podstawowa|Lubczyna|ul. Lipowa 14 |72-105 Lubczyna;1335;531;531;16;515;39.78;3.01
110463;320402;Przedszkole Niepubliczne "Kacper"|Załom|ul. Wierzbowa 2 |70-896 Załom;1292;631;631;6;625;48.84;0.95
110464;320402;Szpitalne Centrum Medyczne Sp. z o.o.|Goleniów|ul.Nowogardzka 2 |72-100 Goleniów;100;16;16;0;16;16.00;0.00
110465;320402;Zakład Karny|Goleniów|ul.Grenadierów 66 |72-100 Goleniów;922;356;356;52;304;38.61;14.61
110466;320402;Placówka "Nasz Dom"|Komarowo| 15A |72-105 Goleniów;23;23;23;1;22;100.00;4.35
110467;320403;Szkoła Podstawowa|Dębice| 29 |72-130 Maszewo;1768;492;492;30;462;27.83;6.10
110468;320403;Ośrodek Kultury i Sportu|Maszewo|ul. Szkolna 1A |72-130 Maszewo;1271;500;500;12;488;39.34;2.40
110469;320403;Gimnazjum|Maszewo|ul. Szkolna 14 |72-130 Maszewo;1348;539;539;27;512;39.99;5.01
110470;320403;Zespół Szkół Ponadgimnazjalnych|Maszewo|ul. Jedności Narodowej 6 |72-130 Maszewo;1353;353;353;12;341;26.09;3.40
110471;320403;Szkoła Podstawowa|Rożnowo Nowogardzkie| 60 |72-130 Maszewo;1076;378;378;21;357;35.13;5.56
110472;320404;Szkoła Podstawowa Nr 1|Nowogard|ul.Wojska Polskiego 6 |72-200 Nowogard;780;371;371;9;362;47.56;2.43
110473;320404;Publiczne Przedszkole Nr 4|Nowogard|ul.Tadeusza Kościuszki 3 |72-200 Nowogard;1947;1038;1038;29;1009;53.31;2.79
110474;320404;Szkoła Podstawowa Nr 4|Nowogard|ul.Gen. Józefa Bema 41 |72-200 Nowogard;1806;761;761;38;723;42.14;4.99
110475;320404;Nowogardzki Dom Kultury|Nowogard|ul.Plac Wolności 7 |72-200 Nowogard;1937;955;955;28;927;49.30;2.93
110476;320404;Prywatne Liceum Ogólnokształcące|Nowogard|ul.3 Maja 22 |72-200 Nowogard;1820;810;810;35;775;44.51;4.32
110477;320404;Szkoła Podstawowa Nr 2|Nowogard|ul.Stefana Żeromskiego 5 |72-200 Nowogard;945;406;406;10;396;42.96;2.46
110478;320404;Szkoła Podstawowa Nr 3|Nowogard|ul.Bohaterów Warszawy 78 |72-200 Nowogard;2004;981;981;31;950;48.95;3.16
110479;320404;Przedszkole Miejskie Nr 3|Nowogard|ul.Księcia Józefa Poniatowskiego 2a |72-200 Nowogard;1888;917;917;32;885;48.57;3.49
110480;320404;Szkoła Podstawowa|Długołęka| 16A |72-200 Nowogard;856;259;259;18;241;30.26;6.95
110481;320404;Szkoła Podstawowa|Wierzbięcin| 50 |72-200 Nowogard;861;270;270;12;258;31.36;4.44
110482;320404;Szkoła Podstawowa|Wierzbięcin| 50 |72-200 Nowogard;863;170;170;10;160;19.70;5.88
110483;320404;Szkoła Podstawowa|Żabowo| 17 |72-200 Nowogard;785;267;267;14;253;34.01;5.24
110484;320404;Szkoła Podstawowa|Orzechowo| 14 |72-200 Nowogard;931;239;239;10;229;25.67;4.18
110485;320404;Szkoła Podstawowa|Strzelewo| 54 |72-200 Nowogard;748;165;165;16;149;22.06;9.70
110486;320404;Szkoła Podstawowa|Błotno| 27 |72-200 Nowogard;932;270;270;13;257;28.97;4.81
110487;320404;Dom Pomocy Społecznej|Nowogard|ul.Smużyny 2 |72-200 Nowogard;83;42;42;4;38;50.60;9.52
110488;320404;Dom Pomocy Społecznej|Nowogard|ul.Marsz. Józefa Piłsudskiego 9 |72-200 Nowogard;39;19;19;8;11;48.72;42.11
110489;320404;Zakład Karny|Nowogard|ul.Zamkowa 7 |72-200 Nowogard;721;306;306;39;267;42.44;12.75
110490;320404;Samodzielny Publiczny Szpital Rejonowy|Nowoagrd|ul. Wojska Polskiego 7 |72-200 Nowogard;31;10;10;0;10;32.26;0.00
110491;320405;Zespół Szkół Publicznych im. B. Malinowskiego|Osina| 54 |72-221 Osina;1482;573;573;33;540;38.66;5.76
110492;320405;Świetlica wiejska|Węgorza| 52 |72-221 Osina;850;314;314;16;298;36.94;5.10
110493;320406;Gimnazjum Publiczne|Przybiernów|ul. Mieszka I 1 |72-110 Przybiernów;2119;808;808;25;783;38.13;3.09
110494;320406;Szkoła Podstawowa|Czarnogłowy|ul. Lipowa 11 |72-121 Czarnogłowy;1262;352;352;21;331;27.89;5.97
110495;320406;Wiejski Dom Spotkań i Animacji Społecznej|Budzieszewice| 8 |72-122 Łoźnica;630;242;242;15;227;38.41;6.20
110496;320407;Urząd Miasta i Gminy|Stepnica|ul. Tadeusza Kościuszki 4 |72-112 Stepnica;2340;866;866;51;815;37.01;5.89
110497;320407;Dom Kultury w Racimierzu|Racimierz|ul. Niepodległości 6A |72-111 Żarnowo;1016;316;316;20;296;31.10;6.33
110498;320407;Świetlica wiejska w Kopicach|Kopice| 6B |72-112 Stepnica;506;131;131;11;120;25.89;8.40
110499;320501;Sala Wiejska w Brojcach|Brojce|ul. Długa 43 |72-304 Brojce;1471;473;473;23;450;32.15;4.86
110500;320501;Szkoła Podstawowa w Dargosławiu|Dargosław| 32 |72-304 Brojce;864;182;182;26;156;21.06;14.29
110501;320501;Świetlica Wiejska w Przybiernowie|Przybiernowo|Wiejska 6a |72-304 Brojce;610;197;197;14;183;32.30;7.11
110502;320502;Spółdzielnia Mieszkaniowa Nad Regą|Gryfice|ul. Jana Dąbskiego 48 |72-300 Gryfice;1600;723;723;22;701;45.19;3.04
110503;320502;Szkoła Podstawowa, Budynek B|Trzygłów| 24 |72-300 Gryfice;1241;365;365;24;341;29.41;6.58
110504;320502;Świetlica Wiejska|Świeszewo| 27 |72-300 Gryfice;776;250;250;4;246;32.22;1.60
110505;320502;Szkoła Podstawowa|Górzyca| 20 |72-300 Gryfice;697;223;223;7;216;31.99;3.14
110506;320502;Szkoła Podstawowa|Prusinowo| 10 |72-300 Gryfice;980;386;386;14;372;39.39;3.63
110507;320502;Świetlica Wiejska|Rybokarty| 19 |72-300 Gryfice;443;114;114;4;110;25.73;3.51
110508;320502;Szkoła Podstawowa Nr 3|Gryfice|Rodziewiczówny 6 |72-300 Gryfice;2055;1025;1025;25;1000;49.88;2.44
110509;320502;Szkoła Podstawowa Nr 3 (dawny OSIR)|Gryfice|ul. Rodziewiczówny 2 |72-300 Gryfice;1996;956;956;19;937;47.90;1.99
110510;320502;Szkoła Podstawowa Nr 4 (mała sala)|Gryfice|ul. Sienkiewicza 10A |72-300 Gryfice;1536;611;611;20;591;39.78;3.27
110511;320502;Szkoła Podstawowa Nr 4 (szatnia)|Gryfice|Sienkiewicza 10A |72-300 Gryfice;821;401;401;12;389;48.84;2.99
110512;320502;Dom Pomocy Społecznej|Gryfice|ul. Kościuszki 35 |72-300 Gryfice;1541;673;673;14;659;43.67;2.08
110513;320502;Gryficki Dom Kultury|Gryfice|ul. Niepodległości 53 |72-300 Gryfice;1478;610;610;27;583;41.27;4.43
110514;320502;Gimnazjum Nr 1|Gryfice|ul. Marszałka Józefa Piłsudskiego 1 |72-300 Gryfice;1961;804;804;31;773;41.00;3.86
110515;320502;Gimnazjum Nr 2|Gryfice|ul. 3 Maja 8 |72-300 Gryfice;1859;820;820;30;790;44.11;3.66
110516;320502;SPZZOZ - Zachodniopomorski Szpital Specjalistyczny|Gryfice|Niechorska 27 |72-300 Gryfice;218;61;61;3;58;27.98;4.92
110517;320502;Dom Pomocy Społecznej|Gryfice|Kościuszki 71 |72-300 Gryfice;46;34;34;0;34;73.91;0.00
110518;320503;Zespół Szkół Publicznych im. Wisławy Szymborskiej w Karnicach|Karnice|ul.Szkolna 13 |72-343 Karnice;1523;599;599;23;576;39.33;3.84
110519;320503;Świetlica Wiejska w Cerkwicy|Cerkwica|ul.Szkolna 6 |72-342 Cerkwica;1794;659;659;21;638;36.73;3.19
110520;320504;Dom Strażaka|Płoty|ul. Tadeusza Kościuszki 8 |72-310 Płoty;1834;859;859;38;821;46.84;4.42
110521;320504;Miejsko - Gminny Ośrodek Kultury|Płoty|ul. Tadeusza Kościuszki 7 |72-310 Płoty;1483;680;680;19;661;45.85;2.79
110522;320504;Świetlica Wiejska|Płoty|ul. Wiejska 10 |72-310 Płoty;933;243;243;13;230;26.05;5.35
110523;320504;Świetlica Wiejska|Lisowo| 5A |72-310 Płoty;432;88;88;4;84;20.37;4.55
110524;320504;Świetlica Wiejska|Sowno| 11A |72-310 Płoty;324;121;121;7;114;37.35;5.79
110525;320504;Świetlica Wiejska|Mechowo| 22A |72-310 Płoty;636;185;185;13;172;29.09;7.03
110526;320504;Świetlica Wiejska|Wyszobór| 38A |72-310 Płoty;517;188;188;5;183;36.36;2.66
110527;320504;Świetlica Wiejska|Modlimowo| 18A |72-310 Płoty;261;101;101;4;97;38.70;3.96
110528;320504;Świetlica Wiejska|Wicimice| 30A |72-310 Płoty;310;65;65;4;61;20.97;6.15
110529;320504;Świetlica Wiejska|Pniewo| 45A |72-310 Płoty;447;111;111;5;106;24.83;4.50
110530;320504;Zakład Karny Oddział w Płotach|Płoty|ul. Koszalińska 2 |72-310 Płoty;233;89;89;11;78;38.20;12.36
110531;320507;Kompleks Rekreacyjno-Sportowy|Pobierowo|ul. Moniuszki 4 |72-346 Pobierowo;1172;632;632;17;615;53.92;2.69
110532;320507;Gminny Ośrodek Kultury|Rewal|ul. Słowackiego 1 |72-344 Rewal;1081;599;599;7;592;55.41;1.17
110533;320507;Muzeum Rybołówstwa Morskiego|Niechorze|Aleja Bursztynowa 28 |72-350 Niechorze;972;508;508;8;500;52.26;1.57
110534;320508;Szkoła Podstawowa Nr 1|Trzebiatów|ul.Kamieniecka 16 |72-320 Trzebiatów;947;436;436;24;412;46.04;5.50
110535;320508;Zespół Szkół Ponadgimnazjalnych|Trzebiatów|Pl. Lipowy 15 |72-320 Trzebiatów;1928;848;848;61;787;43.98;7.19
110536;320508;Publiczne Gimnazjum|Trzebiatów|ul. Wodna 2 |72-320 Trzebiatów;2074;814;814;52;762;39.25;6.39
110537;320508;Trzebiatowski Ośrodek Kultury|Trzebiatów|ul. Wojska Polskiego 67 |72-320 Trzebiatów;1572;563;563;23;540;35.81;4.09
110538;320508;Szkoła Podstawowa Nr 2|Trzebiatów|ul.Długa 11 |72-320 Trzebiatów;1649;629;629;25;604;38.14;3.97
110539;320508;Świetlica Wiejska|Rogozina| 25 |72-350 Niechorze;672;240;240;12;228;35.71;5.00
110540;320508;Świetlica Wiejska|Mirosławice| 26 |72-320 Trzebiatów;576;209;209;27;182;36.28;12.92
110541;320508;Świetlica Wiejska|Gołańcz Pomorska| 54 |72-320 Trzebiatów;573;175;175;27;148;30.54;15.43
110542;320508;Świetlica Wiejska|Gorzysław| 35 |72-320 Trzebiatów;1045;265;265;26;239;25.36;9.81
110543;320508;Zespół Szkół Z Oddziałami Intergarcyjnymi|Mrzeżyno|Aleja Tysiąclecia 32 |72-330 Mrzeżyno;1654;717;717;32;685;43.35;4.46
110544;320508;Dom Pomocy Społecznej|Trzebiatów|ul. Jaromin 50 |72-320 Trzebiatów;199;63;63;15;48;31.66;23.81
110545;320601;Urząd Gminy|Banie|ul. Skośna 6 |74-110 Banie;1776;700;700;42;658;39.41;6.00
110546;320601;Międzynarodowe Centrum Turystyki, Kultury i Sportu w Baniach|Banie|ul. Skośna 7 |74-110 Banie;833;184;184;10;174;22.09;5.43
110547;320601;Szkoła Podstawowa|Lubanowo| 53 |74-111 Lubanowo;1281;340;340;23;317;26.54;6.76
110548;320601;Szkoła Podstawowa|Swobnica| 12 |74-110 Banie;1215;351;351;26;325;28.89;7.41
110549;320602;Zespół Szkolno-Przedszkolny w Cedyni|Cedynia|ul. Michała Roli-Żymierskiego 21 |74-520 Cedynia;1370;486;486;24;462;35.47;4.94
110550;320602;Zespół Szkolno-Przedszkolny w Cedyni|Cedynia|ul.Michała Roli-Żymierskiego 21 |74-520 Cedynia;2215;554;554;30;524;25.01;5.42
110551;320603;Internat Zespołu Szkół Ponadgimnazjalnych|Chojna|ul. Żółkiewskiego 5 |74-500 Chojna;1471;670;670;14;656;45.55;2.09
110552;320603;Centrum Kultury (Biblioteka)|Chojna|ul. Plac Konstytucji 3 Maja 1 |74-500 Chojna;1560;696;696;21;675;44.62;3.02
110553;320603;Gimnazjum|Chojna|ul. Szkolna 15 |74-500 Chojna;1435;615;615;16;599;42.86;2.60
110554;320603;Szkoła Podstawowa|Chojna|ul. Żwirki i Wigury 10 |74-500 Chojna;1397;541;541;10;531;38.73;1.85
110555;320603;Swietlica Wiejska w Mętnie|Mętno| 59 |74-500 Chojna;395;113;113;4;109;28.61;3.54
110556;320603;Szkoła Podstawowa|Krzymów| 29 |74-500 Chojna;1059;262;262;9;253;24.74;3.44
110557;320603;Szkoła Podstawowa|Grzybno| 23 |74-500 Chojna;1122;344;344;16;328;30.66;4.65
110558;320603;Szkoła Podstawowa|Nawodna| 93 |74-500 Chojna;1310;369;369;22;347;28.17;5.96
110559;320603;Szkoła Podstawowa|Godków| 33 |74-500 Chojna;631;219;219;13;206;34.71;5.94
110560;320603;Szkoła Podstawowa|Brwice| 35 |74-500 Chojna;632;177;177;14;163;28.01;7.91
110561;320604;Gryfiński Dom Kultury w Gryfinie|Gryfino|ul. Szczecińska 17 |74-100 Gryfino;1102;514;514;11;503;46.64;2.14
110562;320604;Przedszkole nr 2 w Gryfinie|Gryfino|ul. Bolesława Krzywoustego 5 |74-100 Gryfino;1632;749;749;40;709;45.89;5.34
110563;320604;Przedszkole Nr 4 w Gryfinie|Gryfino|ul. Tadeusza Kościuszki 17 |74-100 Gryfino;1631;872;872;32;840;53.46;3.67
110564;320604;Zespół Szkół Ogólnokształcących w Gryfinie|Gryfino|ul. Niepodległości 16 |74-100 Gryfino;1519;718;718;14;704;47.27;1.95
110565;320604;Szkoła Podstawowa Nr 1 w Gryfinie|Gryfino|ul. Łużycka 22 |74-100 Gryfino;1453;727;730;28;699;50.03;3.85
110566;320604;Zespół Szkół Ponadgimnazjalnych Nr 2 w Gryfinie|Gryfino|ul. Łużycka 91 |74-100 Gryfino;1159;652;653;20;632;56.26;3.07
110567;320604;Przedszkole Nr 5 w Gryfinie|Gryfino|ul. Stefana Żeromskiego 12 |74-100 Gryfino;1286;792;792;16;776;61.59;2.02
110568;320604;Przedszkole Nr 3 w Gryfinie|Gryfino|ul. Zygmunta Krasińskiego 29 |74-100 Gryfino;1184;613;613;16;597;51.77;2.61
110569;320604;Zespół Szkół w Gryfinie|Gryfino|ul. Jarosława Iwaszkiewicza 70 |74-100 Gryfino;1373;775;775;15;760;56.45;1.94
110570;320604;Biblioteka Publiczna Filia Górny Taras w Gryfinie|Gryfino|ul. Zygmunta Krasińskiego 87a |74-100 Gryfino;1353;738;738;23;715;54.55;3.12
110571;320604;Szkoła Podstawowa nr 2 w Gryfinie|Gryfino|ul. 9 Maja 4 |74-100 Gryfino;2018;1022;1022;28;994;50.64;2.74
110572;320604;Przedszkole nr 1 w Gryfinie|Gryfino|ul. Wojska Polskiego 11 |74-100 Gryfino;1039;487;487;17;470;46.87;3.49
110573;320604;Świetlica Wiejska w Czepinie|Czepino|ul. Gryfińska 46 |74-100 Gryfino;1251;457;457;13;444;36.53;2.84
110574;320604;Szkoła Podstawowa w Radziszewie|Radziszewo|ul. Szczecińska 54 |74-100 Gryfino;1060;412;412;12;400;38.87;2.91
110575;320604;Zespół Szkół w Gardnie|Gardno|ul. Niepodległości 1 |74-100 Gryfino;1193;356;356;18;338;29.84;5.06
110576;320604;Świelica Wiejska w Dołgich|Dołgie| 12a |74-100 Gryfino;918;293;293;15;278;31.92;5.12
110577;320604;Świetlica Wiejska w Wełtyniu|Wełtyń|ul. Niepodległości 18 |74-100 Gryfino;1357;576;576;19;557;42.45;3.30
110578;320604;Dom Pomocy Społecznej w Nowym Czarnowie|Nowe Czarnowo| 66 |74-100 Gryfino;882;304;304;23;281;34.47;7.57
110579;320604;Biblioteka Publiczna w Gryfinie Filia w Pniewie|Pniewo|ul. Gryfińska 16 |74-105 Nowe Czarnowo;1404;780;780;33;747;55.56;4.23
110580;320604;Dom Pomocy Społecznej w Dębcach|Dębce| 11 |74-100 Gryfino;64;27;27;5;22;42.19;18.52
110581;320604;Szpital Powiatowy w Gryfinie Sp.z.o.o. Zakład Pielęgnacyjno -Opiekuńczy Psychiatryczny w Nowym Czarnowie|Nowe Czarnowo| 70 |74-100 Gryfino;27;18;18;1;17;66.67;5.56
110582;320604;Szpital Powiatowy w Gryfinie ul. Parkowa 5, Sp.z.o.o.|Gryfino|ul. Parkowa 5 |74-100 Gryfino;34;18;18;1;17;52.94;5.56
110583;320605;Szkoła Podstawowa|Mieszkowice|ul.Henryka Sienkiewicza 56 |74-505 Mieszkowice;1465;548;548;26;522;37.41;4.74
110584;320605;Miejsko-Gminny Ośrodek|Mieszkowice|ul.Tadeusza Kościuszki 48 |74-505 Mieszkowice;1289;569;569;14;555;44.14;2.46
110585;320605;Szkoła Podstawowa w Troszynie|Troszyn| 3 |74-505 Mieszkowice;958;274;274;21;253;28.60;7.66
110586;320605;Szkoła Podstawowa w Zielinie|Zielin|ul.Wincentego Witosa 48 |74-505 Mieszkowice;692;257;257;23;234;37.14;8.95
110587;320605;Gimnazjum|Mieszkowice|ul.Techników 4 |74-505 Mieszkowice;632;198;198;9;189;31.33;4.55
110588;320605;Szkoła Podstawowa w Czelinie|Czelin| 70 |74-505 Mieszkowice;727;206;206;11;195;28.34;5.34
110589;320606;Regionalne Biuro Geoparku|Moryń|ul. Plac Wolności 2 |74-503 Moryń;1729;723;723;27;696;41.82;3.73
110590;320606;Szkoła Podstawowa|Witnica|ul. Moryńska 15 |74-503 Moryń;1067;289;289;11;278;27.09;3.81
110591;320606;Wiejskie Centrum Administracji,Kultury,Sportu i Rekreacji|Klępicz| 7A |74-503 Moryń;599;131;131;9;122;21.87;6.87
110592;320606;Dom Pomocy Społecznej|Moryń|ul. Rynkowa 27 |74-503 Moryń;77;51;51;0;51;66.23;0.00
110593;320607;Świetlica wiejska|Żelisławiec|ul.Niepodległości 20 |74-106 Stare Czarnowo;640;272;272;16;256;42.50;5.88
110594;320607;Świetlica wiejska|Stare Czarnowo|ul.Polna 1 |74-106 Stare Czarnowo;982;421;421;34;387;42.87;8.08
110595;320607;Sala gimnastyczna|Kołbacz|ul.Anny Jagiellonki 1 |74-106 Stare Czarnowo;1484;576;576;35;541;38.81;6.08
110596;320608;Urząd Miejski|Trzcińsko-Zdrój|ul. Rynek 15 |74-510 Trzcińsko-Zdrój;1954;698;698;43;655;35.72;6.16
110597;320608;Trzcińskie Centrum Kultury|Trzcińsko-Zdrój|ul. Młyńska 4 |74-510 Trzcińsko-Zdrój;1292;389;389;15;374;30.11;3.86
110598;320608;Hala Widowiskowo-Sportowa|Trzcińsko-Zdrój|ul. Cmentarna 12 |74-510 Trzcińsko-Zdrój;1201;305;305;8;297;25.40;2.62
110599;320608;Dom Pomocy Społecznej|Trzcińsko-Zdrój|ul. Aleja Róż 1 |74-510 Trzcińsko-Zdrój;76;28;28;5;23;36.84;17.86
110600;320609;Zespół Szkół|Widuchowa|ul.Barnima III 1 |74-120 Widuchowa;1895;729;729;39;690;38.47;5.35
110601;320609;Szkoła Podstawowa|Krzywin|ul.Królewiecka 42 |74-121 Krzywin;1049;348;348;21;327;33.17;6.03
110602;320609;Świetlica Wiejska|Żelechowo| 24 |74-121 Krzywin;884;220;220;18;202;24.89;8.18
110603;320609;Świetlica Wiejska|Lubicz| 56 |74-120 Widuchowa;541;139;139;16;123;25.69;11.51
110604;320701;Świetlica środowiskowa|Dziwnówek|ul. Nad Zalewem 1 |72-420 Dziwnów;546;270;270;4;266;49.45;1.48
110605;320701;Świetlica środowiskowa|Dziwnów|ul. Niezłomnych 1A |72-420 Dziwnów;634;323;323;9;314;50.95;2.79
110606;320701;Szkoła Podstawowa|Dziwnów|ul. Adama Mickiewicza 27 |72-420 Dziwnów;987;521;521;9;512;52.79;1.73
110607;320701;Świetlica środowiskowa|Dziwnów|ul. Dziwna 4a 1|72-420 Dziwnów;629;319;319;6;313;50.72;1.88
110608;320701;Ośrodek Wczasowy "Gryf"|Międzywodzie|ul. Armii Krajowej 12 |72-415 Międzywodzie;689;386;386;7;379;56.02;1.81
110609;320702;Gimnazjum im. M. Skłodowskiej-Curie|Golczewo|ul. Szkolna 2 |72-410 Golczewo;2174;976;976;45;931;44.89;4.61
110610;320702;Przedszkole Publiczne|Golczewo|ul. Szkolna 9 |72-410 Golczewo;1258;320;320;14;306;25.44;4.38
110611;320702;Szkoła Podstawowa|Wysoka Kamieńska|ul. Szkolna 5 |72-410 Golczewo;1380;476;476;21;455;34.49;4.41
110612;320703;Szkoła Podstawowa nr 1|Kamień Pomorski|ul. Plac Katedralny 5 |72-400 Kamień Pomorski;1593;744;744;11;733;46.70;1.48
110613;320703;Ośrodek Rehabilitacyjno-Edukacyjno-Wychowawczy|Kamień Pomorski|ul. Garncarska 4 |72-400 Kamień Pomorski;1563;767;767;23;744;49.07;3.00
110614;320703;Polskie Stowarzyszenie na Rzecz Osób z Upośledzeniem Umysłowym|Kamień Pomorski|ul. M. Kopernika 22 |72-400 Kamień Pomorski;1550;716;716;17;699;46.19;2.37
110615;320703;Miejska i Powiatowa Biblioteka Publiczna|Kamień Pomorski|ul.Wolińska 9 |72-400 Kamień Pomorski;1597;756;756;14;742;47.34;1.85
110616;320703;Liceum Ogólnokształcące|Kamień Pomorski|ul. M. Konopnickiej 19 |72-400 Kamień Pomorski;1595;757;757;19;738;47.46;2.51
110617;320703;Szkoła Podstawowa|Wrzosowo| 37 |72-400 Kamień Pomorski;768;268;268;9;259;34.90;3.36
110618;320703;Świetlica OSP|Trzebieszewo| 13 |72-400 Kamień Pomorski;833;249;249;5;244;29.89;2.01
110619;320703;Szkoła Podstawowa|Jarszewo| 32 |72-400 Kamień Pomorski;890;280;280;17;263;31.46;6.07
110620;320703;Zespół Szkół Ponadgimnazjalnych|Benice| 12 |72-400 Kamień Pomorski;676;211;211;9;202;31.21;4.27
110621;320703;Szkoła Podstawowa|Górki| 8 |72-400 Kamień Pomorski;712;192;192;8;184;26.97;4.17
110622;320703;DOM POMOCY SPOŁECZNEJ|ŚNIATOWO| 17 |72-400 KAMIEŃ POMORSKI;68;27;27;1;26;39.71;3.70
110623;320703;SZPITAL|KAMIEŃ POMORSKI|ul.Szpitalna 10 |72-400 KAMIEŃ POMORSKI;16;5;5;0;5;31.25;0.00
110624;320703;ARESZT ŚLEDCZY|KAMIEŃ POMORSKI|ul.TADEUSZA KOŚCIUSZKI 13 |72-400 KAMIEŃ POMORSKI;46;39;39;3;36;84.78;7.69
110625;320703;ODDZIAŁ ZEWNĘTRZNY|BUNIEWICE| |72-400 KAMIEŃ POMORSKI;115;72;72;9;63;62.61;12.50
110626;320704;Gimnazjum Nr 1|Międzyzdroje|ul. Kolejowa 33 |72-500 Międzyzdroje;1143;546;546;19;527;47.77;3.48
110627;320704;Miejska Biblioteka Publiczna|Międzyzdroje|ul. Cypriana Kamila Norwida 15 |72-500 Międzyzdroje;1015;464;464;18;446;45.71;3.88
110628;320704;Międzynarodowy Dom Kultury|Międzyzdroje|ul. Bohaterów Warszawy 20 |72-500 Międzyzdroje;1202;485;485;17;468;40.35;3.51
110629;320704;Przedszkole Miejskie|Międzyzdroje|ul. Myśliwska 13 |72-500 Międzyzdroje;1267;592;592;13;579;46.72;2.20
110630;320704;Szkoła Podstawowa Nr 2|Wapnica|ul. Jodłowa 3 |72-500 Międzyzdroje;870;406;406;7;399;46.67;1.72
110631;320705;Świetlica wiejska|Świerzno| 30 |72-405 Świerzno;906;315;315;10;305;34.77;3.17
110632;320705;Szkoła Podstawowa|Gostyń| 5 |72-405 Świerzno;963;330;330;21;309;34.27;6.36
110633;320705;Świetlica wiejska|Chomino| 41 |72-405 Świerzno;546;129;129;6;123;23.63;4.65
110634;320705;Świetlica wiejska|Stuchowo| 2 |72-405 Świerzno;975;311;311;14;297;31.90;4.50
110635;320706;Publiczne Gimnazjum|Wolin|ul.Spokojna 1 |72-510 Wolin;740;366;366;17;349;49.46;4.64
110636;320706;Publiczna Szkoła Podstawowa|Wolin|ul.Spokojna 1 |72-510 Wolin;1187;525;525;23;502;44.23;4.38
110637;320706;Zespół Szkół Ponadgimnazjalnych|Wolin|ul.Słowiańska 2 |72-510 Wolin;1257;589;589;23;566;46.86;3.90
110638;320706;Biblioteka Publiczna|Wolin|ul.Rynek 2 |72-510 Wolin;738;330;330;11;319;44.72;3.33
110639;320706;Świetlica Wiejska|Dargobądz| 19 |72-510 Wolin;551;214;214;6;208;38.84;2.80
110640;320706;Świetlica Wiejska|Ładzin| 19 |72-518 Ładzin;609;223;223;4;219;36.62;1.79
110641;320706;Wiejski Ośrodek Kultury|Wisełka|ul.Nadmorska 1 |72-513 Wisełka;668;273;273;8;265;40.87;2.93
110642;320706;Świetlica Wiejska|Kołczewo|ul.Zwycięstwa 20A |72-514 Kołczewo;712;297;297;17;280;41.71;5.72
110643;320706;Publiczne Gimnazjum|Sierosław| 36 |72-514 Kołczewo;566;180;180;8;172;31.80;4.44
110644;320706;Wiejski Ośrodek Kultury|Troszyn| 7 |72-511 Troszyn;709;227;227;11;216;32.02;4.85
110645;320706;Świetlica Wiejska|Ostromice| 38D |72-510 Wolin;394;133;133;1;132;33.76;0.75
110646;320706;Publiczna Szkoła Podstawowa|Koniewo| 9 |72-510 Wolin;661;181;181;6;175;27.38;3.31
110647;320706;Świetlica Wiejska|Recław| 21 |72-510 Wolin;565;194;194;13;181;34.34;6.70
110648;320706;Świetlica Wiejska|Unin| 22 |72-510 Wolin;504;141;141;6;135;27.98;4.26
110649;320801;Gimnazjum nr 1 z Oddziałami Integracyjnymi|Kołobrzeg|ul. Portowa 37 |78-100 Kołobrzeg;2000;1218;1218;27;1191;60.90;2.22
110650;320801;Zespół Szkół nr 2|Kołobrzeg|ul. Piastowska 5 |78-100 Kołobrzeg;1609;784;784;16;768;48.73;2.04
110651;320801;Szkoła Podstawowa nr 4|Kołobrzeg|ul. Kupiecka 1 |78-100 Kołobrzeg;1759;1048;1048;41;1007;59.58;3.91
110652;320801;Gimnazjum nr 3|Kołobrzeg|ul. Okopowa 1A |78-100 Kołobrzeg;2073;1033;1033;38;995;49.83;3.68
110653;320801;Sala Sportowa MOSiR|Kołobrzeg|ul. Wąska 1 |78-100 Kołobrzeg;2205;1213;1213;35;1178;55.01;2.89
110654;320801;Zespół Szkół Ekonomiczno-Hotelarskich|Kołobrzeg|ul. Łopuskiego 13 |78-100 Kołobrzeg;1544;890;890;29;861;57.64;3.26
110655;320801;Urząd Miasta|Kołobrzeg|ul. Ratuszowa 13 |78-100 Kołobrzeg;1266;733;733;10;723;57.90;1.36
110656;320801;Szkoła Podstawowa nr 8|Kołobrzeg|ul. Bogusława X 22 |78-100 Kołobrzeg;1764;849;849;28;821;48.13;3.30
110657;320801;Przedszkole Miejskie nr 7|Kołobrzeg|ul. Bogusława X 17 |78-100 Kołobrzeg;1632;800;800;21;779;49.02;2.62
110658;320801;Regionalne Centrum Kultury w Kołobrzegu|Kołobrzeg|ul. Czarnieckiego 5F |78-100 Kołobrzeg;2121;1077;1077;29;1048;50.78;2.69
110659;320801;Regionalne Centrum Kultury w Kołobrzegu|Kołobrzeg|ul. Czarnieckiego 5F |78-100 Kołobrzeg;1759;973;973;19;954;55.32;1.95
110660;320801;Zespół Szkół Ogólnokształcących im.M. Kopernika|Kołobrzeg|ul. Łopuskiego 42-44 |78-100 Kołobrzeg;1826;973;975;24;949;53.29;2.47
110661;320801;Zespół Szkół im. H. Sienkiewicza|Kołobrzeg|ul. 1-go Maja 47 |78-100 Kołobrzeg;1950;962;962;23;939;49.33;2.39
110662;320801;Zespół Szkół Społecznych nr 1 im. Z. Herberta|Kołobrzeg|ul. Jedności Narodowej 58A |78-100 Kołobrzeg;1803;788;788;30;758;43.70;3.81
110663;320801;Szkoła Podstawowa nr 6|Kołobrzeg|ul. Poznańska 9 |78-100 Kołobrzeg;1963;1095;1096;12;1083;55.78;1.10
110664;320801;Zespół Szkół|Kołobrzeg|ul. Lwowska 7 |78-100 Kołobrzeg;1419;666;666;20;646;46.93;3.00
110665;320801;Regionalne Centrum Kultury w Kołobrzegu|Kołobrzeg|ul. Czarnieckiego 5F |78-100 Kołobrzeg;1161;633;633;15;618;54.52;2.37
110666;320801;Miejskie Przedszkole Integracyjne nr 6 im. Janusza Korczaka|Kołobrzeg|ul. Tadeusza Kościuszki 9 |78-100 Kołobrzeg;1695;1269;1269;19;1250;74.87;1.50
110667;320801;Przedszkole Miejskie nr 8|Kołobrzeg|ul. Bociania 4A |78-100 Kołobrzeg;1992;1036;1036;31;1005;52.01;2.99
110668;320801;Przedszkole Miejskie nr 3|Kołobrzeg|ul. Unii Lubelskiej 23 |78-100 Kołobrzeg;1263;637;637;7;630;50.44;1.10
110669;320801;Szkoła Podstawowa nr 5 z Oddziałami Integracyjnymi|Kołobrzeg|ul. Arciszewskiego 20 |78-100 Kołobrzeg;1294;696;696;9;687;53.79;1.29
110670;320801;Szkoła Podstawowa nr 6|Kołobrzeg|ul. Poznańska 9 |78-100 Kołobrzeg;2310;1159;1181;22;1137;50.17;1.90
110671;320801;Regionalny Szpital w Kołobrzegu|Kołobrzeg|Łopuskiego 31 |78-100 Kołobrzeg;175;79;79;2;77;45.14;2.53
110672;320801;Dom Pomocy Społecznej Włościbórz Filia w Kołobrzegu|Kołobrzeg|Ogrodowa 3 |78-100 Kołobrzeg;14;14;14;0;14;100.00;0.00
110673;320802;Świetlica Wiejska w Dygowie|Dygowo|ul. Ogrodowa 14 |78-113 Dygowo;1904;844;844;39;805;44.33;4.62
110674;320802;Świetlica Wiejska we Wrzosowie|Wrzosowo| 39 A |78-114 Wrzosowo;1122;410;410;30;380;36.54;7.32
110675;320802;Świetlica Wiejska w Piotrowicach|Piotrowice| 23 |78-114 Wrzosowo;436;97;97;3;94;22.25;3.09
110676;320802;Świetlica Wiejska w Czerninie|Czernin| 33 A |78-113 Dygowo;837;297;297;30;267;35.48;10.10
110677;320802;Dom Pomocy Społecznej we Włościborzu|Włościbórz| 1 |78-114 Wrzosowo;67;17;17;3;14;25.37;17.65
110678;320802;Dom Pomocy Społecznej w Piotrowicach|Piotrowice| 1 |78-114 Wrzosowo;24;20;20;3;17;83.33;15.00
110679;320803;Urząd Miejski|Gościno|ul. IV Dywizji Wojska Polskiego 58 |78-120 Gościno;641;219;219;7;212;34.17;3.20
110680;320803;Szkoła Podstawowa|Gościno|ul. Kościuszki 5 |78-120 Gościno;1099;428;428;22;406;38.94;5.14
110681;320803;Dom Kultury|Gościno|ul. Matejki 2 |78-120 Gościno;1001;410;410;18;392;40.96;4.39
110682;320803;Świetlica Wiejska|Robuń| 30 |78-120 Gościno;794;240;240;11;229;30.23;4.58
110683;320803;Świetlica Wiejska|Wartkowo| 27 |78-120 Gościno;471;158;158;5;153;33.55;3.16
110684;320803;Dom Pomocy Społecznej|Gościno|ul. Karlińska 1 |78-120 Gościno;54;26;26;5;21;48.15;19.23
110685;320804;Świetlica Wiejska w Budzistowie|Budzistowo|ul. Kołobrzeska 1 |78-100 Budzistowo;1075;464;464;19;445;43.16;4.09
110686;320804;Świetlica Wiejska w Obrotach|Obroty| 19 |78-100 Obroty;580;284;284;7;277;48.97;2.46
110687;320804;Biblioteka Gminna|Zieleniewo|ul. Szczecińska 12 |78-100 Zieleniewo;1830;919;919;32;887;50.22;3.48
110688;320804;Świetlica Wiejska w Starym Borku|Stary Borek| 15 |78-132 Stary Borek;651;281;281;12;269;43.16;4.27
110689;320804;Szkoła Podstawowa im. Jana Pawła II|Dźwirzyno|ul. Hanki Sawickiej 27 |78-131 Dźwirzyno;675;337;337;13;324;49.93;3.86
110690;320804;Gimnazjum im. Bolesława Chrobrego w Drzonowie|Drzonowo| 12 |78-133 Drzonowo;1249;479;479;15;464;38.35;3.13
110691;320804;Remiza Strażacka OSP w Karcinie|Karcino| 58 |78-133 Karcino;418;160;160;8;152;38.28;5.00
110692;320804;Świetlica Wiejska|Grzybowo|ul. Szkolna 1 |78-132 Grzybowo;1373;731;731;8;723;53.24;1.09
110693;320804;Świetlica Wiejska w Błotnicy|Błotnica| 3A |78-122 Błotnica;534;219;219;13;206;41.01;5.94
110694;320805;Urząd Gminy Rymań|Rymań|ul. Szkolna 7 |78-125 Rymań;981;414;414;16;398;42.20;3.86
110695;320805;Sala Wiejska Rymań|Rymań|Koszalińska 18 |78-125 Rymań;768;253;253;10;243;32.94;3.95
110696;320805;Sala Wiejska|Kinowo| 18 |78-124 Gorawino;595;200;200;13;187;33.61;6.50
110697;320805;Społeczna Szkoła Podstawowa|Gorawino| 44 |78-124 Gorawino;946;304;304;27;277;32.14;8.88
110698;320806;Publiczna Szkoła Podstawowa im. Armii Krajowej w Charzynie|Charzyno|ul. Wojska Polskiego 11 |78-122 Charzyno;1179;469;469;28;441;39.78;5.97
110699;320806;Zespół Szkół im. Noblistów Polskich w Siemyślu|Siemyśl|ul. Szkolna 10 |78-123 Siemyśl;1764;675;675;46;629;38.27;6.81
110700;320807;Gminny Ośrodek Kultury|Ustronie Morskie|ul. Nadbrzeżna 20 |78-111 Ustronie Morskie;2490;1260;1260;51;1209;50.60;4.05
110701;320807;Świetlica wiejska|Rusowo| 27 |78-111 Ustronie Morskie;549;175;175;7;168;31.88;4.00
110702;320901;Zespół Szkół im. Ludzi Morza, sala nr 19, ul. Szkolna 1A, 76-031 Mścice|Mścice|ul. Szkolna 1A |76-031 Mścice;1685;746;746;20;726;44.27;2.68
110703;320901;Zespół Szkół im. Ludzi Morza, sala nr 4, ul. Szkolna 1A, 76-031 Mścice|Mścice|ul. Szkolna 1A |76-031 Mścice;866;330;330;13;317;38.11;3.94
110704;320901;Gminny Ośrodek Kultury, Będzino 21, 76-037 Będzino|Będzino| 21 |76-037 Będzino;1005;438;438;31;407;43.58;7.08
110705;320901;Świetlica, Borkowice 3, 76-038 Dobrzyca|Borkowice| 3 |76-038 Dobrzyca;902;343;343;10;333;38.03;2.92
110706;320901;Dom Kultury, Dobrzyca 60, 76-038 Dobrzyca|Dobrzyca| 60 |76-038 Dobrzyca;1464;504;504;33;471;34.43;6.55
110707;320901;Zespół Szkół, im. Kardynała Ignacego Jeża, Tymień 49, 76-035 Tymień|Tymień| 49 |76-035 Tymień;882;283;283;15;268;32.09;5.30
110708;320902;Centrum Zdrowia i Opieki Społecznej w Biesiekierzu|Biesiekierz| 13 |76-039 Biesiekierz;1954;853;853;41;812;43.65;4.81
110709;320902;Szkoła Podstawowa w Starych Bielicach|Stare Bielice| 61 |76-039 Biesiekierz;2496;1397;1397;33;1364;55.97;2.36
110710;320902;Szkoła Podstawowa w Świeminie|Świemino| 19 |76-039 Biesiekierz;533;180;180;14;166;33.77;7.78
110711;320902;Domu Pomocy Społecznej w Parsowie|Parsowo| 25 |76-039 Biesiekierz;41;16;16;3;13;39.02;18.75
110712;320903;Gimnazjum im. Agaty Mróz-Olszewskiej|Bobolice|ul. Głowackiego 7d |76-020 Bobolice;2055;925;925;36;889;45.01;3.89
110713;320903;Szkoła Podstawowa im. Henryka Sienkiewicza|Bobolice|ul. Szkolna 1 |76-020 Bobolice;1324;579;579;31;548;43.73;5.35
110714;320903;Urząd Miejski|Bobolice|ul. Ratuszowa 1 |76-020 Bobolice;1214;338;338;9;329;27.84;2.66
110715;320903;Świetlica wiejska|Chmielno| 36 |76-020 Bobolice;406;104;104;7;97;25.62;6.73
110716;320903;Szkoła Podstawowa|Kurowo| 48 |76-020 Bobolice;495;147;147;8;139;29.70;5.44
110717;320903;Szkoła Podstawowa|Drzewiany| 76 |76-020 Bobolice;526;204;204;12;192;38.78;5.88
110718;320903;Zespół Szkół|Dargiń| 47 |76-020 Bobolice;651;146;146;6;140;22.43;4.11
110719;320903;Szkoła Podstawowa im. Jana Brzechwy|Kłanino| 7 |76-020 Bobolice;431;136;136;12;124;31.55;8.82
110720;320903;Świetlica wiejska|Gozd| 39 |76-020 Bobolice;324;77;77;7;70;23.77;9.09
110721;320903;Zakład Karny w Starem Bornem|Stare Borne| 14 |76-020 Bobolice;162;71;71;11;60;43.83;15.49
110722;320904;Sala posiedzeń Urzędu Gminy|Manowo| 40 |76-015 Manowo;774;360;360;13;347;46.51;3.61
110723;320904;Szkoła Podstawowa|Rosnowo| 34 |76-042 Rosnowo;1515;728;728;24;704;48.05;3.30
110724;320904;Przedszkole Gminne|Bonin| 9 |76-009 Bonin;927;410;410;30;380;44.23;7.32
110725;320904;Gminny Ośrodek Kultury|Wyszewo| 18 |76-015 Manowo;439;148;148;4;144;33.71;2.70
110726;320904;Klub Wiejski|Kretomino|ul. Kretomińska 8 |75-900 Koszalin;767;447;447;10;437;58.28;2.24
110727;320904;Klub Wiejski|Grzybnica| 17a |76-015 Manowo;229;91;91;7;84;39.74;7.69
110728;320904;Klub Wiejski|Wyszebórz| 28a |76-015 Manowo;303;88;88;9;79;29.04;10.23
110729;320904;Klub Wiejski|Cewlino| 9 |76-015 Manowo;291;154;154;4;150;52.92;2.60
110730;320905;Zespół Szkół,Gimnazjum, Mielno ul.Lechitów 19A,|Mielno|ul. Lechitów 19A |76-032 Mielno;1084;522;522;22;500;48.15;4.21
110731;320905;Zespół Szkół,Szkoła Podstawowa, Mielno ul.Lechitów 19|Mielno|Lechitów 19 |76-032 Mielno;1050;586;586;9;577;55.81;1.54
110732;320905;Świetlica Środowiskowa "Promyk", Gąski 6a|Gąski| 6a |76-034 Sarbinowo;378;155;155;4;151;41.01;2.58
110733;320905;Szkoła Podstawowa, Sarbinowo ul. Nadmorska 27a|Sarbinowo|ul.Nadmorska 27a |76-034 Sarbinowo;835;475;475;18;457;56.89;3.79
110734;320905;Instytut Zdrowia Sofra, Unieście ul. Chełmońskiego 2|Mielno|ul.Chełmońskiego 2 |76-032 Mielno;890;482;482;10;472;54.16;2.07
110735;320905;Dom Pomocy Społecznej w Mielnie ul. Spokojna 1|Mielno|Spokojna 1 -|76-032 Mielno;49;30;30;6;24;61.22;20.00
110736;320906;Urząd Miejski w Polanowie, Blok I|Polanów|Wolności 4 |76-010 Polanów;1473;680;680;25;655;46.16;3.68
110737;320906;Urząd Miejski w Polanowie, Blok II|Polanów|Wolności 4 |76-010 Polanów;921;412;412;13;399;44.73;3.16
110738;320906;Środowiskowy Dom Samopomocy|Krąg| 5 |76-010 Polanów;391;113;113;19;94;28.90;16.81
110739;320906;Polanowski Ośrodek Kultury i Sportu|Polanów|Polna 4 |76-010 Polanów;1326;286;286;14;272;21.57;4.90
110740;320906;Szkoła Podstawowa|Żydowo| 91 |76-010 Polanów;899;307;307;18;289;34.15;5.86
110741;320906;Szkoła Podstawowa|Bukowo| 19 |76-010 Polanów;625;193;193;6;187;30.88;3.11
110742;320906;Świetlica Wiejska|Nacław| 27A |76-010 Polanów;1283;341;341;26;315;26.58;7.62
110743;320906;Dom Pomocy Społecznej|Cetuń| 6 |76-010 Polanów;53;26;26;1;25;49.06;3.85
110744;320906;Dom Pomocy Społecznej|Żydowo| 112 |76-010 Polanów;90;21;21;10;11;23.33;47.62
110745;320907;Gimnazjum Gminne|Sianów|ul. Bolesława Chrobrego 4 |76-004 Sianów;1675;679;679;38;641;40.54;5.60
110746;320907;Przedszkole Gminne|Sianów|ul. Słowackiego 3 |76-004 Sianów;1460;723;723;36;687;49.52;4.98
110747;320907;Szkoła Podstawowa Nr 2|Sianów|ul. Dworcowa 26 a |76-004 Sianów;2041;922;922;28;894;45.17;3.04
110748;320907;Szkoła Podstawowa|Szczeglino| 15 |76-004 Sianów;907;354;354;17;337;39.03;4.80
110749;320907;Świetlica Wiejska|Iwięcino| 13 |76-003 Sianów;663;201;201;10;191;30.32;4.98
110750;320907;Szkoła Podstawowa|Sucha Koszalińska|ul. Morska 6 |76-003 Sianów;918;372;372;23;349;40.52;6.18
110751;320907;Zespół Szkół|Dąbrowa| 55 |76-004 Sianów;743;269;269;19;250;36.20;7.06
110752;320907;Świetlica Wiejska|Ratajki| 8 |76-004 Sianów;426;93;93;7;86;21.83;7.53
110753;320907;Świetlica Wiejska|Skibno| 24 a |76-003 Sianów;633;224;224;21;203;35.39;9.38
110754;320907;Świetlica Wiejska|Wierciszewo| 54 a |76-003 Sianów;584;207;207;9;198;35.45;4.35
110755;320907;Kino Zorza|Sianów|ul. Plac pod Lipami 2 |76-004 Sianów;762;363;363;13;350;47.64;3.58
110756;320908;Multimedialne Centrum Kultury e-Eureka Biblioteka Publiczna|Świeszyno| 36 |76-024 Świeszyno;1478;727;727;28;699;49.19;3.85
110757;320908;Świetlica wiejska|Konikowo| 47B |76-024 Świeszyno;977;557;557;23;534;57.01;4.13
110758;320908;Szkoła Podstawowa|Zegrze Pomorskie| 32A |76-024 Świeszyno;584;170;170;5;165;29.11;2.94
110759;320908;Świetlica wiejska|Niedalino| 29A |76-024 Świeszyno;666;264;264;16;248;39.64;6.06
110760;320908;Świetlica wiejska|Strzekęcino| 27-27A |76-024 Świeszyno;427;198;198;9;189;46.37;4.55
110761;320908;Świetlica wiejska|Dunowo| 16 |76-024 Świeszyno;561;183;183;12;171;32.62;6.56
110762;320908;Świetlica wiejska|Niekłonice| 26A |76-024 Świeszyno;702;426;426;17;409;60.68;3.99
110763;321001;Barlinecki Ośrodek Kultury|Barlinek|ul. Podwale 9 |74-320 Barlinek;1211;460;460;16;444;37.99;3.48
110764;321001;Przedszkole Miejskie Nr 2|Barlinek|ul. Podwale 11 |74-320 Barlinek;1040;450;450;20;430;43.27;4.44
110765;321001;Szkoła Podstawowa Nr 1|Barlinek|ul. Jeziorna 12 |74-320 Barlinek;1073;503;503;10;493;46.88;1.99
110766;321001;Spółdzielnia Mieszkaniowa "Piast"|Barlinek|ul. Wodna 2 |74-320 Barlinek;1150;485;485;17;468;42.17;3.51
110767;321001;Europejskie Centrum Spotkań|Barlinek|ul. Leśna 1 |74-320 Barlinek;842;378;378;11;367;44.89;2.91
110768;321001;Publiczne Gimnazjum Nr 1|Barlinek|ul. Leśna 10 |74-320 Barlinek;817;333;333;7;326;40.76;2.10
110769;321001;Nadleśnictwo Barlinek|Barlinek|ul Tunelowa 56a |74-320 Barlinek;1156;503;503;13;490;43.51;2.58
110770;321001;Szkoła Podstawowa Nr 4|Barlinek|ul. Kombatantów 3 |74-320 Barlinek;819;391;391;17;374;47.74;4.35
110771;321001;Szkoła Podstawowa Nr 4|Barlinek|ul. Kombatantów 3 |74-320 Barlinek;1073;479;479;23;456;44.64;4.80
110772;321001;Zespół Szkół Ponadgimnazjalnych Nr 1|Barlinek|ul. Szosowa 2 |74-320 Barlinek;974;438;438;15;423;44.97;3.42
110773;321001;Zespół Szkół Ponadgimnazjalnych|Barlinek|ul. Szosowa 2 |74-320 Barlinek;907;425;425;10;415;46.86;2.35
110774;321001;Środowiskowy Dom Samopomocy Osina|Osina| 19a |74-320 Barlinek;637;173;173;9;164;27.16;5.20
110775;321001;Świetlica wiejska Płonno|Płonno| 38 |74-320 Barlinek;538;184;184;16;168;34.20;8.70
110776;321001;Szkoła Podstawowa Mostkowo|Mostkowo| 36 |74-322 Mostkowo;970;345;345;21;324;35.57;6.09
110777;321001;Świetlica wiejska Rychnów|Rychnów| 45 |74-320 Barlinek;871;213;213;8;205;24.45;3.76
110778;321001;Świetlica wiejska|Moczkowo|ul. Gorzowska 15 |74-320 Barlinek;1270;509;510;14;495;40.08;2.75
110779;321001;Szpital Barlinek Sp. z o.o.|Barlinek|ul. Szpitalna 10 |74-320 Barlinek;60;6;6;0;6;10.00;0.00
110780;321002;Łącznik Szkoły Podstawowej|Boleszkowice|Plac Bolesława Chrobrego 3 |74-407 Boleszkowice;1415;490;490;24;466;34.63;4.90
110781;321002;Świetlica wiejska w Namyślinie|Namyślin| 70 |74-406 Namyślin;513;188;188;13;175;36.65;6.91
110782;321002;Świetlica wiejska w Gudziszu|Gudzisz| 23B |74-407 Boleszkowice;408;149;149;12;137;36.52;8.05
110783;321003;Szkoła Podstawowa Nr 1|Dębno|ul.Marsz. J. Piłsudskiego 10 |74-400 Dębno;2232;817;817;27;790;36.60;3.30
110784;321003;Gimnazjum Publiczne|Dębno|ul.Jana Pawła II 1 |74-400 Dębno;1583;634;634;33;601;40.05;5.21
110785;321003;Dębnowski Ośrodek Kultury|Dębno|ul. Daszyńskiego 20 |74-400 Dębno;2374;1154;1154;25;1129;48.61;2.17
110786;321003;Zespół Szkół Ponadgimnazjalnych|Dębno|ul.Zachodnia 4 |74-400 Dębno;1653;809;809;22;787;48.94;2.72
110787;321003;Szkoła Podstawowa Nr 3|Dębno|ul.Słowackiego 21 |74-400 Dębno;1575;633;633;19;614;40.19;3.00
110788;321003;Filia Szkoły Podstawowej Nr 3|Dębno|ul.Jana Pawła II 63 |74-400 Dębno;1427;649;649;27;622;45.48;4.16
110789;321003;Świetlica Wiejska|Różańsko| 22 |74-311 Różańsko;870;305;305;31;274;35.06;10.16
110790;321003;Szkoła Podstawowa|Cychry|ul. Jana Pawła II 85 |74-404 Cychry;947;344;344;20;324;36.33;5.81
110791;321003;Szkoła Podstawowa|Sarbinowo| 80 |74-404 Cychry;874;277;277;17;260;31.69;6.14
110792;321003;Szkoła Podstawowa|Smolnica| 20 |74-400 Dębno;1051;315;315;12;303;29.97;3.81
110793;321003;Zespół Placówek Oświatowych|Barnówko| 38 |74-311 Różańsko;703;205;205;14;191;29.16;6.83
110794;321003;Świetlica Wiejska|Oborzany| 42 |74-400 Dębno;415;145;145;4;141;34.94;2.76
110795;321003;Szkoła Podstawowa|Dargomyśl| 102 |74-404 Cychry;457;218;218;9;209;47.70;4.13
110796;321003;Szpital w Dębnie sp. z o.o.|Dębno|Kościuszki 58 |74-400 Dębno;111;17;17;1;16;15.32;5.88
110797;321004;Środowiskowy Dom Samopomocy|Myślibórz|ul. Kamienna 20 |74-300 Myślibórz;1557;574;574;16;558;36.87;2.79
110798;321004;Gimnazjum im. Henryka Sienkiewicza|Myślibórz|ul. Pionierów 13 |74-300 Myślibórz;1453;487;487;21;466;33.52;4.31
110799;321004;Specjalny Ośrodek Szkolno-Wychowawczy TPD|Myślibórz|ul. Felczaka 27 |74-300 Myślibórz;1442;578;578;24;554;40.08;4.15
110800;321004;Zespół Szkół im. Noblistów Polskich|Myślibórz|ul. Za Bramką 8 |74-300 Myślibórz;1529;638;638;27;611;41.73;4.23
110801;321004;Zespół Szkół Ponadgimnazjalnych Nr 3 im. S.Dariusa i S.Girenasa|Myślibórz|ul. Strzelecka 51 |74-300 Myślibórz;1628;624;624;17;607;38.33;2.72
110802;321004;Szkoła Podstawowa Nr 3 im. Leonida Teligi|Myślibórz|ul. Lipowa 18A |74-300 Myślibórz;1584;736;736;26;710;46.46;3.53
110803;321004;Szkoła Podstawowa Nr 3 im. Leonida Teligi|Myślibórz|ul. Lipowa 18A |74-300 Myślibórz;1349;513;513;12;501;38.03;2.34
110804;321004;Szkoła Podstawowa im. Jana Brzechwy|Nawrocko| 11 |74-300 Myślibórz;769;241;241;11;230;31.34;4.56
110805;321004;Świetlica Ochotniczej Straży Pożarnej|Sulimierz| 1 |74-300 Myślibórz;814;301;301;16;285;36.98;5.32
110806;321004;Miejska i Powiatowa Biblioteka Publiczna Filia w Golenicach|Golenice| 45 |74-300 Myślibórz;902;268;268;13;255;29.71;4.85
110807;321004;Szkoła Podstawowa im. Janusza Korczaka|Kierzków| 69 |74-300 Myślibórz;741;231;231;17;214;31.17;7.36
110808;321004;Świetlica Wiejska|Sitno|ul. Sportowa 20 |74-300 Myślibórz;711;133;133;6;127;18.71;4.51
110809;321004;Szkoła Podstawowa nr 2 im. Janusza Kusocińskiego|Myślibórz|ul. Józefa Piłsudskiego 18 |74-300 Myślibórz;1626;577;577;19;558;35.49;3.29
110810;321004;Dom Pomocy Społecznej|Myślibórz|ul.Celna 23 |74-300 Myślibórz;154;37;37;12;25;24.03;32.43
110811;321005;Sala Wiejska|Nowogródek Pomorski|ul. Pl.Św. Floriana 8 |74-304 Nowogródek Pomorski;1092;367;367;24;343;33.61;6.54
110812;321005;Sala wiejska|Karsko|ul. Mieszka I 13 |74-305 Karsko;1042;304;304;21;283;29.17;6.91
110813;321005;Sala Wiejska|Trzcinna| 26 |74-304 Nowogródek Pomoprski;565;203;203;12;191;35.93;5.91
110814;321101;Gminny Ośrodek Kultury|Dobra|ul. Graniczna 31 |72-003 Dobra;2334;1476;1476;24;1452;63.24;1.63
110815;321101;Klub w Dołujach|Dołuje|ul. Żubrza 7 |72-002 Dołuje;1711;914;914;26;888;53.42;2.84
110816;321101;Publiczna Szkoła Podstawowa|Mierzyn|ul. Kolorowa 27 |72-006 Mierzyn;1918;1350;1350;8;1342;70.39;0.59
110817;321101;Klub w Wołczkowie|Dobra|ul. Lipowa 11A |72-003 Dobra;0;0;0;0;0;-99;-99
110818;321101;Publiczna Szkoła Podstawowa|Mierzyn|ul. Kolorowa 27 |72-006 Mierzyn;1796;1164;1164;11;1153;64.81;0.95
110819;321101;Publiczna Szkoła Podstawowa|Bezrzecze|ul. Górna 3 |71-218 Bezrzecze;1207;790;790;16;774;65.45;2.03
110820;321101;Publiczna Szkoła Podstawowa|Dobra|ul. Poziomkowa 5 |72-003 Dobra;1126;395;395;12;383;35.08;3.04
110821;321101;Publiczna szkoła Podstawowa|Bezrzecze|Górna 3 |71-218 Bezrzecze;1957;1348;1348;12;1336;68.88;0.89
110822;321101;Publiczna Szkoła Podstawowa|Mierzyn|Kolorowa 27 |72-006 Mierzyn;1709;1016;1016;11;1005;59.45;1.08
110823;321102;Urząd Gminy|Kołbaskowo| 106 |72-001 Kołbaskowo;1986;894;895;39;855;45.02;4.36
110824;321102;Szkoła Podstawowa|Będargowo| 1 |72-005 Przecław;1890;781;781;30;751;41.32;3.84
110825;321102;Szkoła Podstawowa|Przecław| 27A |72-005 Przecław;1096;472;472;34;438;43.07;7.20
110826;321102;Szkoła Podstawowa|Przecław| 27A |72-005 Przecław;1584;1017;1017;18;999;64.20;1.77
110827;321102;Publiczne Gimnazjum|Przecław| 27C |72-005 Przecław;1106;702;702;9;693;63.47;1.28
110828;321102;Publiczne Gimnazjum|Przecław| 27C |72-005 Przecław;1104;724;724;6;718;65.58;0.83
110829;321103;Urząd Gminy|Nowe Warpno|Plac Zwycięstwa 1 |72-022 Nowe Warpno;981;463;463;16;447;47.20;3.46
110830;321103;Świetlica|Brzózki| 26a |72-022 Nowe Warpno;332;183;183;2;181;55.12;1.09
110831;321104;Szkoła Podstawowa im. Jerzego Noskiewicza w Tanowie Szkoła Filialna w Pilchowie|Tanowo|ul. Szczecińska 1a |72-004 Tanowo;1098;653;653;15;638;59.47;2.30
110832;321104;Świetlica Sołecka w Trzeszczynie|Trzeszczyn|ul. Kościuszki 34a |72-004 Tanowo;198;92;92;5;87;46.46;5.43
110833;321104;Szkoła Podstawowa im. Jerzego Noskiewicza|Tanowo|ul. Szczecińska 31 |72-004 Tanowo;1302;711;711;14;697;54.61;1.97
110834;321104;Zespół Szkół|Trzebież|ul. WOP 19a |72-020 Trzebież;1694;785;785;27;758;46.34;3.44
110835;321104;Zespół Szkół w Trzebieży Szkoła Filialna|Niekłończyca| 34 |72-015 Police 3;1075;436;436;14;422;40.56;3.21
110836;321104;Świetlica sołecka|Tatynia| 64 |72-015 Police 3;249;102;102;1;101;40.96;0.98
110837;321104;Świetlica sołecka|Drogoradz| 51 |72-015 Police 3;201;82;82;3;79;40.80;3.66
110838;321104;Zespół Szkół Nr 2|Police|ul. Owocowa 5 |72-015 Police 3;1045;390;390;26;364;37.32;6.67
110839;321104;Szkoła Podstawowa Nr 1 im. Tadeusza Kościuszki|Police|ul. Sikorskiego 8 |72-010 Police;1606;741;741;26;715;46.14;3.51
110840;321104;Świetlica Rady Osiedla Nr 2 Stare Miasto|Police|ul. M. Konopnickiej 2 |72-010 Police;1575;627;627;28;599;39.81;4.47
110841;321104;Szkoła Podstawowa Nr 2 im. Bolesława Kaczyńskiego|Police, Mścięcino|ul. Cisowa 2 |72-010 Police;1003;495;495;11;484;49.35;2.22
110842;321104;Świetlica sołecka w Przęsocinie|Przęsocin|ul. Centralna 20a |72-010 Police;498;248;248;5;243;49.80;2.02
110843;321104;Klub Nauczyciela|Police|ul. Ks. Barnima I 26 |72-010 Police;1396;796;796;7;789;57.02;0.88
110844;321104;Szkoła Podstawowa nr 3 im. Marii Skłodowskiej-Curie|Police|ul. Siedlecka 4 |72-010 Police;1134;502;502;12;490;44.27;2.39
110845;321104;Przedszkole Publiczne Nr 9 "Tęczowa Kraina"|Police|ul. Piaskowa 13 |72-010 Police;1977;986;986;34;952;49.87;3.45
110846;321104;Świetlica Rady Osiedla Nr 4 Dąbrówka|Police|ul. Piaskowa 49 |72-010 Police;1471;830;830;17;813;56.42;2.05
110847;321104;Miejski Żłobek|Police|ul. Robotnicza 15/17 |72-010 Police;1429;615;615;19;596;43.04;3.09
110848;321104;Przedszkole Publiczne Nr 5 im. Wandy Chotomskiej|Police|ul. Robotnicza 13 |72-010 Police;1950;881;881;23;858;45.18;2.61
110849;321104;"Bajkowe" Przedszkole Publiczne Nr 8|Police|ul. Kardynała Stefana Wyszyńskiego 31 |72-010 Police;1517;874;874;17;857;57.61;1.95
110850;321104;Przedszkole Publiczne Nr 10|Police|ul. Piaskowa 112 |72-010 Police;2006;1122;1122;29;1093;55.93;2.58
110851;321104;Świetlica Rady Osiedla Nr 7 Anny Jagiellonki|Police|ul. Roweckiego 40 |72-009 Police;1539;844;844;20;824;54.84;2.37
110852;321104;Przedszkole Publiczne Nr 11|Police|ul. Przyjaźni 1 |72-009 Police;1221;701;701;15;686;57.41;2.14
110853;321104;Szkoła Podstawowa nr 8 im. Jana Pawła II Szkoła Filialna|Police|ul. Przyjaźni 33 |72-009 Police;1314;708;708;11;697;53.88;1.55
110854;321104;Przedszkole Publiczne Nr 11|Police|ul. Przyjaźni 1 |72-009 Police;1274;655;655;11;644;51.41;1.68
110855;321104;Szkoła Podstawowa Nr 8 im. Jana Pawła II Szkoła Filialna|Police|ul. Przyjaźni 33 |72-009 Police;1615;783;783;16;767;48.48;2.04
110856;321104;Samodzielny Publiczny Szpital Kliniczny Nr 1 im. prof. Tadeusza Sokołowskiego Pomorskiego Uniwersytetu Medycznego Szczecin, ul. Unii Lubelskiej 1, Police|Police|ul. Siedlecka 2 |72-010 Police;82;29;29;0;29;35.37;0.00
110857;321201;Sala konferencyjna Urzędu Gminy|Bielice|ul. Niepokalanej 34 |74-202 Bielice;1445;499;499;18;481;34.53;3.61
110858;321201;Dom Strażaka|Babin| 43a |74-202 Bielice;1000;372;372;16;356;37.20;4.30
110859;321202;Szkoła Podstawowa|Kozielice| 73 |74-204 Kozielice;1358;465;465;23;442;34.24;4.95
110860;321202;Wiejski Dom Kultury|Tetyń| 64 |74-205 Tetyń;765;282;282;21;261;36.86;7.45
110861;321203;Miejsko-Gminny Ośrodek Kultury|Lipiany|ul. Okrzei 5 |74-240 Lipiany;1648;675;675;24;651;40.96;3.56
110862;321203;Miejsko-Gminna Biblioteka Publiczna|Lipiany|ul. Szkolna 17 |74-240 Lipiany;1266;518;518;40;478;40.92;7.72
110863;321203;Świetlica|Batowo| 23 |74-230 Mielęcin;892;256;256;8;248;28.70;3.12
110864;321203;Urząd Miejski|Lipiany|ul. Plac Wolności 1 |74-240 Lipiany;1011;382;382;11;371;37.78;2.88
110865;321204;Publiczna Szkoła Podstawowa|Jesionowo| 59 |74-210 Przelewice;674;224;224;9;215;33.23;4.02
110866;321204;Świetlica wiejska|Rosiny| 8 |74-210 Przelewice;976;315;315;12;303;32.27;3.81
110867;321204;Gminne Centrum Kultury|Przelewice| 53 |74-210 Przelewice;1359;510;510;22;488;37.53;4.31
110868;321204;Publiczna Szkoła Podstawowa|Żuków| 38 |73-115 Dolice;1171;313;313;21;292;26.73;6.71
110869;321205;Przedszkole Publiczne nr 4|Pyrzyce|ul.Zabytkowa 50 |74-200 Pyrzyce;1525;742;743;26;716;48.66;3.50
110870;321205;Zespół Szkół nr 1|Pyrzyce|ul.Lipiańska 2 |74-200 Pyrzyce;871;409;409;15;394;46.96;3.67
110871;321205;Publiczne Gimnazjum|Pyrzyce|ul.Tadeusza Rejtana 6 |74-200 Pyrzyce;2357;1082;1082;39;1043;45.91;3.60
110872;321205;Przedszkole Publiczne nr 3 z Oddziałem Integracyjnym|Pyrzyce|ul.Gabriela Narutowicza 5 |74-200 Pyrzyce;825;378;378;10;368;45.82;2.65
110873;321205;Świetlica Spółdzielni Mieszkaniowej|Pyrzyce|ul.Jana Henryka Dąbrowskiego 15 |74-200 Pyrzyce;1700;833;833;38;795;49.00;4.56
110874;321205;Szkoła Podstawowa z Oddziałami Integracyjnymi|Pyrzyce|ul.Poznańska 2 |74-200 Pyrzyce;1612;739;739;46;693;45.84;6.22
110875;321205;Świetlica Osiedla|Pyrzyce|ul.Słoneczna 11 |74-200 Pyrzyce;1185;537;537;23;514;45.32;4.28
110876;321205;Szkoła Podstawowa Żabów|Żabów| |74-200 Pyrzyce;1324;468;468;20;448;35.35;4.27
110877;321205;Szkoła Podstawowa Okunica|Okunica| |74-200 Pyrzyce;1484;558;558;28;530;37.60;5.02
110878;321205;Szkoła Podstawowa Brzesko|Brzesko| |74-211 Brzesko;1199;557;557;19;538;46.46;3.41
110879;321205;Szkoła Podstawowa Mielęcin|Mielęcin|ul. Główna |74-230 Mielęcin;735;241;241;13;228;32.79;5.39
110880;321205;Świetlica Wiejska Krzemlin|Krzemlin| 28 |74-230 Mielęcin;621;247;247;20;227;39.77;8.10
110881;321205;Szpital Powiatowy w Pyrzycach|Pyrzyce|Jana Pawła II 2 |74-200 Pyrzyce;114;16;16;2;14;14.04;12.50
110882;321206;Dom Strażaka|Warnice| 36A |74-201 Warnice;1605;587;587;25;562;36.57;4.26
110883;321206;Szkoła Podstawowa|Stary Przylep| 60 |74-211 Brzesko;1223;434;434;17;417;35.49;3.92
110884;321301;Zespół Szkół Społecznych im. Lotników Morskich|Darłowo|ul. Zwycięstwa 1 |76-150 Darłowo;1018;573;573;20;553;56.29;3.49
110885;321301;Niepubliczne Przedszkole "Akademia Przedszkolaka"|Darłowo|ul. Morska 53 |76-150 Darłowo;1507;667;667;28;639;44.26;4.20
110886;321301;Miejskie Gimnazjum im. Stanisława Dulewicza|Darłowo|ul. Franciszkańska 2 |76-150 Darłowo;1475;588;588;16;572;39.86;2.72
110887;321301;Niepupliczne Przedszkole"Jacek i Agatka"|Darłowo|ul. Zamkowa 6 |76-150 Darłowo;1478;711;711;17;694;48.11;2.39
110888;321301;Miejski Ośrodek Pomocy Społecznej|Darłowo|ul. Ojca Damiana Tynieckiego 20 |76-150 Darłowo;1306;641;641;18;623;49.08;2.81
110889;321301;Zespół Szkół im. Stefana Żeromskiego|Darłowo|ul. Fryderyka Chopina 4 |76-150 Darłowo;1480;772;772;29;743;52.16;3.76
110890;321301;Internat Zespołu Szkół Morskich|Darłowo|ul. Stefana Żeromskiego 25 |76-150 Darłowo;1520;688;688;22;666;45.26;3.20
110891;321301;Miejski Zarząd Budynków Komunalnych|Darłowo|ul. 1-go Maja 3 |76-150 Darłowo;1472;670;670;20;650;45.52;2.99
110892;321302;Szkoła Podstawowa Nr 3|Sławno|ul. Sempołowskiej 3 |76-100 Sławno;1848;908;908;37;871;49.13;4.07
110893;321302;Urząd Miejski|Sławno|ul. Skłodowskiej 9 |76-100 Sławno;2010;830;830;35;795;41.29;4.22
110894;321302;Gimnazjum Miejskie Nr 1|Sławno|Plac Sportowy 1 |76-100 Sławno;1866;858;858;25;833;45.98;2.91
110895;321302;Specjalny Ośrodek Szkolno-Wychowawczy dla Dzieci i Młodzieży Niepełnosprawnej im.M.Grzegorzewskiej|Sławno|ul. Kopernika 9 |76-100 Sławno;1963;896;896;31;865;45.64;3.46
110896;321302;Szkoła Podstawowa Nr 1|Sławno|ul. Juliusza Kossaka 31 |76-100 Sławno;2305;1083;1083;25;1058;46.98;2.31
110897;321302;Szpital Powiatowy w Sławnie|Sławno|ul. 1-go Pułku Ułanów 9 |76-100 Sławno;42;31;31;3;28;73.81;9.68
110898;321303;Świetlica Wiejska|Barzowice| 10 |76-150 Darłowo;341;130;130;9;121;38.12;6.92
110899;321303;Zespół Szkół nr 4|Kopnica| 24 |76-150 Darłowo;408;128;128;14;114;31.37;10.94
110900;321303;Świetlica Wiejska|Cisowo| 9 |76-150 Darłowo;418;163;163;5;158;39.00;3.07
110901;321303;Świetlica Wiejska|Kowalewice| 13 |76-150 Darłowo;399;141;141;16;125;35.34;11.35
110902;321303;Świetlica Wiejska|Domasławice| 31 |76-150 Darłowo;463;192;192;8;184;41.47;4.17
110903;321303;Świetlica Wiejska|Krupy| 17 |76-150 Darłowo;437;151;151;13;138;34.55;8.61
110904;321303;Świetlica Wiejska|Słowino| 77 |76-150 Darłowo;343;142;143;3;139;41.40;2.11
110905;321303;Szkoła Podstawowa z Oddziałem Przedszkolnym im. Ratowników Morskich|Dąbki|Darłowska 6 |76-156 Dąbki;749;499;499;16;483;66.62;3.21
110906;321303;Świetlica Wiejska|Porzecze| 32 |76-150 Darłowo;434;211;211;7;204;48.62;3.32
110907;321303;Świetlica Wiejska|Jeżyczki| 20 |76-150 Darłowo;529;180;180;2;178;34.03;1.11
110908;321303;Świetlica Wiejska|Wiekowice| 12a |76-150 Darłowo;345;138;138;7;131;40.00;5.07
110909;321303;Świetlica Wiejska|Dobiesław| 75 |76-150 Darłowo;508;169;169;5;164;33.27;2.96
110910;321303;Świetlica Wiejska|Boryszewo| 18 |76-150 Darłowo;315;132;132;5;127;41.90;3.79
110911;321303;Świetlica Wiejska|Bukowo Morskie| 20 |76-156 Dąbki;332;139;139;3;136;41.87;2.16
110912;321303;Świetlica Wiejska|Stary Jarosław| 92 |76-150 Darłowo;582;200;200;13;187;34.36;6.50
110913;321304;Szkoła Podstawowa w Niemicy|Niemica| 31 |76-142 Malechowo;1349;505;505;28;477;37.44;5.54
110914;321304;Gimnazjum w Malechowie|Malechowo| 65B |76-142 Malechowo;1685;629;629;22;607;37.33;3.50
110915;321304;Szkoła Podstawowa w Lejkowie|Lejkowo| 11 |76-142 Malechowo;1101;342;342;31;311;31.06;9.06
110916;321304;Zespół Szkół w Ostrowcu|Ostrowiec| 61 |76-129 Ostrowiec;1076;366;366;30;336;34.01;8.20
110917;321305;Zespół Szkół w Jarosławcu|Jarosławiec|Bałtycka 65B |76-107 Jarosławiec;1681;633;633;23;610;37.66;3.63
110918;321305;Urząd Gminy w Postominie|Postomino| 30 |76-113 Postomino;1735;662;662;24;638;38.16;3.63
110919;321305;Szkoła Podstawowa w Staniewicach|Staniewice| 61 |76-113 Postomino;747;235;235;11;224;31.46;4.68
110920;321305;Zespół Szkół w Pieszczu|Pieszcz| 46 |76-113 Postomino;682;209;209;16;193;30.65;7.66
110921;321305;Sala Wiejska w Masłowicach|Masłowice| 4 |76-113 Postomino;806;270;270;16;254;33.50;5.93
110922;321306;Świetlica Wiejska w Boleszewie|Boleszewo| 16c |76-100 Sławno;392;132;132;8;124;33.67;6.06
110923;321306;Świetlica Wiejska w Kwasowie|Kwasowo| 1a |76-100 Sławno;509;212;212;2;210;41.65;0.94
110924;321306;Szkoła Podstawowa w Bobrowicach|Bobrowice| 22 |76-100 Sławno;1185;377;377;18;359;31.81;4.77
110925;321306;Szkoła Podstawowa w Sławsku|Sławsko| 97A |76-100 Sławno;1108;355;355;13;342;32.04;3.66
110926;321306;Szkoła Podstawowa w Warszkowie|Warszkowo| 33a |76-100 Sławno;1430;488;488;22;466;34.13;4.51
110927;321306;Szkoła Podstawowa we Wrześnicy|Wrześnica| 19A |76-122 Wrześnica;1036;315;315;25;290;30.41;7.94
110928;321306;Szkoła Podstawowa w Żukowie|Żukowo| 65 |76-124 Żukowo;1308;387;387;24;363;29.59;6.20
110929;321401;Przedszkole Miejskie Nr 5|Stargard Szczeciński|ul. Lechicka 11 |73-110 Stargard Szczeciński;2323;1254;1254;35;1219;53.98;2.79
110930;321401;Szkoła Podstawowa Nr 7|Stargard Szczeciński|ul. Plac Majdanek 13 |73-110 Stargard Szczeciński;2072;1017;1017;30;987;49.08;2.95
110931;321401;Świetlica Spółdzielni Mieszkaniowej|Stargard Szczeciński|ul. Osiedle Zachód A7 |73-110 Stargard Szczeciński;1930;959;959;23;936;49.69;2.40
110932;321401;Gimnazjum Nr 3|Stargard Szczeciński|ul. Szkolna 2 |73-110 Stargard Szczeciński;1916;943;943;20;923;49.22;2.12
110933;321401;Gimnazjum Nr 4|Stargard Szczeciński|ul. Osiedle Zachód B15 |73-110 Stargard Szczeciński;1213;638;638;13;625;52.60;2.04
110934;321401;Zespół Szkół Nr 2|Stargard Szczeciński|ul. Osiedle Zachód B15/a |73-110 Stargard Szczeciński;1656;887;887;31;856;53.56;3.49
110935;321401;Przedszkole Miejskie Nr 4|Stargard Szczeciński|ul. Osiedle Zachód B2 |73-110 Stargard Szczeciński;1386;758;758;18;740;54.69;2.37
110936;321401;Przedszkole Miejskie Nr 3|Stargard Szczeciński|ul. Osiedle Zachód A18 |73-110 Stargard Szczeciński;1291;706;706;4;702;54.69;0.57
110937;321401;Zespół Szkół Ogólnokształcących|Stargard Szczeciński|ul. Osiedle Zachód A5 |73-110 Stargard Szczeciński;1773;914;914;19;895;51.55;2.08
110938;321401;Przedszkole Miejskie Nr 6|Stargard Szczeciński|ul. Stanisława Niewiadomskiego 14 |73-110 Stargard Szczeciński;1689;970;970;29;941;57.43;2.99
110939;321401;Szkoła Podstawowa Nr 4|Stargard Szczeciński|ul. Wielkopolska 30 |73-110 Stargard Szczeciński;1578;895;895;19;876;56.72;2.12
110940;321401;OHP - Ośrodek Szkolenia i Wychowania|Stargard Szczeciński|ul. Jugosłowiańska 22a |73-110 Stargard Szczeciński;1923;930;930;18;912;48.36;1.94
110941;321401;Gimnazjum Gminy Stargard|Stargard Szczeciński|ul. Ceglana 11 |73-110 Stargard Szczeciński;1368;728;728;13;715;53.22;1.79
110942;321401;Stargardzkie Centrum Kultury|Stargard Szczeciński|ul. Piłsudskiego 105 |73-110 Stargard Szczeciński;1208;544;544;13;531;45.03;2.39
110943;321401;Stargardzkie Centrum Kultury|Stargard Szczeciński|ul. Piłsudskiego 105 |73-110 Stargard Szczeciński;1452;631;631;19;612;43.46;3.01
110944;321401;Szkoła Podstawowa Nr 1|Stargard Szczeciński|ul. Henryka Sienkiewicza 8 (wejście od ul.Kwiatowej)|73-110 Stargard Szczeciński;2376;1148;1148;38;1110;48.32;3.31
110945;321401;Szkoła Podstawowa Nr 1|Stargard Szczeciński|ul. Henryka Sienkiewicza 8 |73-110 Stargard Szczeciński;1984;908;908;42;866;45.77;4.63
110946;321401;Środowiskowy Dom Samopomocy|Stargard Szczeciński|ul. Brzozowa 26 |73-110 Stargard Szczeciński;2159;1193;1193;19;1174;55.26;1.59
110947;321401;Szkoła Podstawowa Nr 3|Stargard Szczeciński|ul. Bolesława Limanowskiego 7 |73-110 Stargard Szczeciński;1384;681;681;23;658;49.21;3.38
110948;321401;Gimnazjum Nr 2|Stargard Szczeciński|ul. Bolesława Limanowskiego 9 |73-110 Stargard Szczeciński;1169;564;564;9;555;48.25;1.60
110949;321401;Świetlica Rejonu Dróg Krajowych|Stargard Szczeciński|ul. Bydgoska 13/15 |73-110 Stargard Szczeciński;1998;837;837;27;810;41.89;3.23
110950;321401;Szkoła Podstawowa Nr 5|Stargard Szczeciński|ul. Kuśnierzy 7 |73-110 Stargard Szczeciński;1340;719;719;16;703;53.66;2.23
110951;321401;Przedszkole Miejskie Nr 1|Stargard Szczeciński|ul. Spichrzowa 6 |73-110 Stargard Szczeciński;1170;540;540;15;525;46.15;2.78
110952;321401;Państwowa Szkoła Muzyczna I i II Stopnia|Stargard Szczeciński|ul. Kazimierza Wielkiego 13 |73-110 Stargard Szczeciński;1271;665;665;14;651;52.32;2.11
110953;321401;Przedszkole Miejskie Nr 2|Stargard Szczeciński|ul. Mieszka I 2 |73-110 Stargard Szczeciński;1591;794;794;21;773;49.91;2.64
110954;321401;Gimnazjum Nr 1|Stargard Szczeciński|ul. Popiela 2 |73-110 Stargard Szczeciński;1984;1064;1064;26;1038;53.63;2.44
110955;321401;II Liceum Ogólnokształcące|Stargard Szczeciński|ul. Mieszka I 4 |73-110 Stargard Szczeciński;1623;861;861;32;829;53.05;3.72
110956;321401;Gimnazjum Katolickie|Stargard Szczeciński|ul. Wojska Polskiego 3 |73-110 Stargard Szczeciński;1062;560;560;8;552;52.73;1.43
110957;321401;Szkoła Podstawowa Nr 6|Stargard Szczeciński|ul. Armii Krajowej 1 |73-110 Stargard Szczeciński;931;500;500;25;475;53.71;5.00
110958;321401;Szkoła Podstawowa Nr 6|Stargard Szczeciński|ul. Armii Krajowej 1 |73-110 Stargard Szczeciński;1553;829;829;13;816;53.38;1.57
110959;321401;Szkoła Podstawowa Nr 6|Stargard Szczeciński|ul. Armii Krajowej 1 |73-110 Stargard Szczeciński;1895;1187;1187;23;1164;62.64;1.94
110960;321401;Szkoła Podstawowa Nr 8|Stargard Szczeciński|ul. Romualda Traugutta 16 |73-110 Stargard Szczeciński;1458;510;510;28;482;34.98;5.49
110961;321401;Zespół Szkół Nr 5|Stargard Szczeciński|ul. Jana Śniadeckiego 4-6 |73-110 Stargard Szczeciński;1648;795;795;39;756;48.24;4.91
110962;321401;Samodzielny Publiczny Wielospecjalistyczny Zakład Opieki Zdrowotnej|Stargard Szczeciński|ul. Wojska Polskiego 27 |73-110 Stargard Szczeciński;194;27;27;0;27;13.92;0.00
110963;321401;Zakład Karny|Stargard Szczeciński|ul. Aleja Żołnierza 42 |73-110 Stargard Szczeciński;371;159;159;33;126;42.86;20.75
110964;321402;Hol hali wodowiskowo-sportowej|Chociwel|ul.Henryka Dąbrowskiego 15 |73-120 Chociwel;2191;670;670;40;630;30.58;5.97
110965;321402;Sala Konferencyjna w Budynku Administracyjnym|Chociwel|ul.Armii Krajowej 50 |73-120 Chociwel;1648;647;647;45;602;39.26;6.96
110966;321402;Szkoła Podstawowa i Gimnazjum|Chociwel|ul. Henryka Dąbrowskiego 15 |73-120 Chociwel;944;423;423;15;408;44.81;3.55
110967;321403;Urząd Miejski|Dobrzany|ul. Staszica 1 1|73-130 Dobrzany;2015;815;815;26;789;40.45;3.19
110968;321403;Przedszkole|Dobrzany|ul. Mickiewicza 43 2|73-130 Dobrzany;2103;578;579;43;535;27.48;7.44
110969;321404;Gminne Centrum Integracji Społecznej i Profilaktyki w Dolicach|Dolice|ul.Wiejska 4 |73-115 Dolice;1739;712;712;39;673;40.94;5.48
110970;321404;Szkoła Podstawowa w Dobropolu Pyrzyckim|Dobropole Pyrzyckie| 7 |73-115 Dolice;953;258;258;20;238;27.07;7.75
110971;321404;Szkoła Podstawowa w Sądowie|Sądów| 30 |73-115 Dolice;643;129;129;12;117;20.06;9.30
110972;321404;Budynek Remizy Ochotniczej Straży Pożarnej w Kolinie|Kolin| 59 |73-115 Dolice;1125;386;386;18;368;34.31;4.66
110973;321404;Szkoła Podstawowa w Rzeplinie|Rzeplino| 62 |73-115 Dolice;1128;290;290;22;268;25.71;7.59
110974;321404;Szkoła Podstawowa w Dolicach - budynek po byłej szkole Podstawowej Żalęcino|Żalęcino| 11 |73-115 Dolice;681;187;187;15;172;27.46;8.02
110975;321404;Świetlica Domu Pomocy Społecznej w Dolicach|Dolice|Wiśniowa 12 |73-115 Dolice;56;15;15;1;14;26.79;6.67
110976;321405;Centrum Oświatowo Kulturalne|Ińsko|ul. Poprzeczna 1 |73-140 Ińsko;1731;672;672;39;633;38.82;5.80
110977;321405;Kino "MORENA"|Ińsko|ul. Przybrzeżna 1 |73-140 Ińsko;1231;279;279;13;266;22.66;4.66
110978;321406;Gminny Ośrodek Kultury|Kobylanka|ul. Jeziorna 6 |73-108 Kobylanka;1435;840;840;11;829;58.54;1.31
110979;321406;Zespół Szkół Publicznych|Reptowo| 96a |73-108 Kobylanka;1284;648;648;26;622;50.47;4.01
110980;321406;Świetlica wiejska|Morzyczyn|ul. Oświaty 1 |73-108 Kobylanka;1360;752;752;14;738;55.29;1.86
110981;321408;Świetlicka Wiejska w Dzwonowie|Dzwonowo| 24 |73-121 Marianowo;580;184;184;23;161;31.72;12.50
110982;321408;Niepubliczna Szkoła Podstawowa w Gogolewie|Gogolewo| 18 |73-121 Marianowo;550;185;185;22;163;33.64;11.89
110983;321408;"Dom Strażaka" w Marianowie|Marianowo|ul. Stargardzka 55 |73-121 Marianowo;1010;456;456;26;430;45.15;5.70
110984;321408;Świetlica Wiejska w Sulinie|Sulino| 20 |73-121 Marianowo;338;96;96;18;78;28.40;18.75
110985;321409;Gminne Centrum Kultury|Stara Dąbrowa| 30c |73-112 Stara Dąbrowa;1135;404;404;21;383;35.59;5.20
110986;321409;Szkoła Podstawowa|Parlino| 17 |73-112 Stara Dąbrowa;932;283;283;33;250;30.36;11.66
110987;321409;Szkoła Podstawowa|Chlebówko| 9 |73-112 Stara Dąbrowa;847;195;195;6;189;23.02;3.08
110988;321410;Szkoła Podstawowa|Sowno|ul. Szkolna 4 |73-110 Stargard Szczeciński;638;271;271;8;263;42.48;2.95
110989;321410;Szkoła Podstawowa im. Mikołaja Kopernika|Pęzino| 66 |73-131 Pęzino;1510;359;359;27;332;23.77;7.52
110990;321410;Świetlica Wiejska|Krąpiel| 12b |73-131 Pęzino;686;220;220;19;201;32.07;8.64
110991;321410;Świetlica Wiejska|Strachocin| 44 |73-110 Stargard Szczeciński;905;439;439;17;422;48.51;3.87
110992;321410;Budynek Kurii|Witkowo Drugie|ul. Starowiejska 37 |73-102 Stargard Szczeciński;1259;476;476;26;450;37.81;5.46
110993;321410;Budynek po byłej Szkole Podstawowej|Koszewo| 2 |73-102 Stargard Szczeciński;926;286;286;12;274;30.89;4.20
110994;321410;Świetlica Wiejska|Grzędzice|ul. Gryfa 71 |73-110 Stargard Szczeciński;1313;659;659;28;631;50.19;4.25
110995;321410;Świetlica Wiejska|Małkocin| 36 |73-110 Stargard Szczeciński;1358;541;541;21;520;39.84;3.88
110996;321410;Świetlica Wiejska|Barzkowice| 33B |73-110 Stargard Szczeciński;545;204;204;21;183;37.43;10.29
110997;321410;Świetlica Wiejska|Żarowo| 51C |73-110 Stargard Szczeciński;691;348;348;16;332;50.36;4.60
110998;321411;Gminny Dom Kultury|Suchań|ul. K. A. Hlonda 1 |73-132 Suchań;1188;457;457;35;422;38.47;7.66
110999;321411;Świetlica|Wapnica| 17A |73-132 Suchań;720;255;255;16;239;35.42;6.27
111000;321411;Biblioteka|Brudzewice| 70B |73-131 Pęzino;682;233;233;22;211;34.16;9.44
111001;321411;Gminny Dom Kultury|Suchań|ul. K. A. Hlonda 1 |73-132 Suchań;852;224;224;10;214;26.29;4.46
111002;321501;Szkoła Podstawowa Nr 7|Szczecinek|ul. Krakowska 1 |78-400 Szczecinek;1177;639;639;18;621;54.29;2.82
111003;321501;Szkoła Podstawowa Nr 7|Szczecinek|ul. Krakowska 1 |78-400 Szczecinek;1570;875;875;10;865;55.73;1.14
111004;321501;Przedszkole "U Cioci Gosi"|Szczecinek|ul. Białogardzka 6 |78-400 Szczecinek;1897;1055;1055;29;1026;55.61;2.75
111005;321501;Przedszkole "Tęcza"|Szczecinek|ul. Nowa 2 |78-400 Szczecinek;1352;692;692;23;669;51.18;3.32
111006;321501;Zespół Szkół Technicznych|Szczecinek|ul. Koszalińska 81 |78-400 Szczecinek;1040;429;429;13;416;41.25;3.03
111007;321501;Zespół Szkół Technicznych|Szczecinek|ul. Koszalińska 81 |78-400 Szczecinek;1344;592;592;38;554;44.05;6.42
111008;321501;Zespół Szkół|Szczecinek|ul. Wiatraczna 5 |78-400 Szczecinek;1310;633;633;19;614;48.32;3.00
111009;321501;Zespół Szkół|Szczecinek|ul. Wiatraczna 5 |78-400 Szczecinek;1157;518;518;16;502;44.77;3.09
111010;321501;Szkoła Podstawowa Nr 4|Szczecinek|ul. Jasna 2 |78-400 Szczecinek;1347;676;676;22;654;50.19;3.25
111011;321501;INTERNAT Zespołu Szkół Nr 2|Szczecinek|ul. 1-go Maja 19 |78-400 Szczecinek;1113;538;538;28;510;48.34;5.20
111012;321501;INTERNAT Zespołu Szkół Nr 2|Szczecinek|ul. 1-go Maja 19 |78-400 Szczecinek;1165;564;564;17;547;48.41;3.01
111013;321501;Centrum Organizacji Pozarządowych|Szczecinek|ul. 9-go Maja 12 |78-400 Szczecinek;1834;893;893;15;878;48.69;1.68
111014;321501;Szkoła Muzyczna|Szczecinek|ul. 3-go Maja 2 |78-400 Szczecinek;1696;670;670;25;645;39.50;3.73
111015;321501;Samorządowa Agencja Promocji i Kultury|Szczecinek|ul. Wyszyńskiego 65 |78-400 Szczecinek;1747;735;735;31;704;42.07;4.22
111016;321501;Szkoła Podstawowa Nr 6|Szczecinek|ul. Kopernika 18 |78-400 Szczecinek;1607;887;887;18;869;55.20;2.03
111017;321501;Przedszkole "Słoneczko"|Szczecinek|ul. Kopernika 16 |78-400 Szczecinek;1772;890;890;27;863;50.23;3.03
111018;321501;Zespół Szkół Technicznych|Szczecinek|ul. Artyleryjska 9 |78-400 Szczecinek;1468;665;665;29;636;45.30;4.36
111019;321501;Przedszkole "Krasnoludek"|Szczecinek|ul. Przemysłowa 5 |78-400 Szczecinek;1477;716;716;19;697;48.48;2.65
111020;321501;Spółdzielczy Dom Kultury|Szczecinek|ul. 28-go Lutego 14A |78-400 Szczecinek;1332;679;679;19;660;50.98;2.80
111021;321501;Szkoła Podstawowa Nr 1|Szczecinek|Plac Wazów 1 |78-400 Szczecinek;2026;1109;1109;35;1074;54.74;3.16
111022;321501;Przedszkole "Miś"|Szczecinek|ul. Grudziądzka 2 |78-400 Szczecinek;2073;1074;1074;22;1052;51.81;2.05
111023;321501;"Szpital w Szczecinku" Sp. z o. o.|Szczecinek|Kościuszki 38 |78-400 Szczecinek;65;25;25;3;22;38.46;12.00
111024;321501;Zakład Karny|Szczecinek|Boh. Warszawy 42a |78-400 Szczecinek;158;95;95;5;90;60.13;5.26
111025;321501;"Patronka" Sp. z o. o.|Szczecinek|Lelewela 15 |78-400 Szczecinek;38;21;21;3;18;55.26;14.29
111026;321502;Ośrodek Kultury i Turystyki|Barwice|ul. W. Polskiego 15 |78-460 Barwice;1625;634;634;33;601;39.02;5.21
111027;321502;Miejsko-Gminny Ośrodek Pomocy Społecznej|Barwice|ul. Czaplinecka 14 |78-460 Barwice;1388;500;500;27;473;36.02;5.40
111028;321502;Świetlica wiejska|Białowąs| 8 |78-460 Barwice;805;209;209;17;192;25.96;8.13
111029;321502;Szkoła Podstawowa|Stary Chwalim| 39 |78-460 Barwice;1339;374;374;17;357;27.93;4.55
111030;321502;Szkoła Podstawowa|Barwice|ul. Pomorska 3 |78-460 Barwice;1756;439;439;15;424;25.00;3.42
111031;321503;Zespół Szkół nr 1 im. Henryka Sienkiewicza|Biały Bór|ul. Dworcowa 19 |78-425 Biały Bór;921;383;383;22;361;41.59;5.74
111032;321503;Białoborskie Centrum Kultury i Rekreacji|Biały Bór|ul. Tamka 3 |78-425 Biały Bór;943;389;389;18;371;41.25;4.63
111033;321503;Szkoła Podstawowa nr 2|Biały Bór|ul. Żymierskiego 27 |78-425 Biały Bór;785;189;189;5;184;24.08;2.65
111034;321503;Szkoła Podstawowa w Sępolnie Wielkim Filia Szkoły Podstawowej nr 1 im. H. Sienkiewicza w Białym Borze|Sępolno Wielkie| 13 |78-426 Biały Bór;484;153;153;14;139;31.61;9.15
111035;321503;Szkoła Podstawowa im. Juliana Tuwima w Drzonowie Filia Szkoły Podstawowej nr 1 im. H. Sienkiewicza w Białym Borze|Drzonowo| 48A |78-421 Drzonowo;1112;388;388;29;359;34.89;7.47
111036;321504;Miejska Biblioteka Publiczna|Borne Sulinowo|ul.Szpitalna 1 |78-449 Borne Suilinowo;1495;725;725;22;703;48.49;3.03
111037;321504;Budynek Kulturalno-Oświatowy przy Zespole Szkół|Borne Sulinowo|ul. Aleja Niepodległości 28 |78-449 Borne Sulinowo;2112;981;981;32;949;46.45;3.26
111038;321504;Świetlica Wiejska-Łubowo|Łubowo|ul. Kościuszki 32 |78-445 Łubowo;1355;477;477;25;452;35.20;5.24
111039;321504;Świetlica Wiejska-Juchowo|Juchowo| 33 |78-446 Silnowo;1604;441;441;22;419;27.49;4.99
111040;321504;Szkoła Podstawowa-Jeleń|Jeleń| 2 |78-446 Silnowo;949;333;333;11;322;35.09;3.30
111041;321504;Dom Pomocy Społecznej|Borne Sulinowo|ul. Szpitalna 5 |78-449 Borne Sulinowo;144;74;74;7;67;51.39;9.46
111042;321505;Dom Szkoleniowy|Grzmiąca|ul. Kolejowa 2 |78-450 Grzmiąca;2114;712;712;38;674;33.68;5.34
111043;321505;Szkoła Podstawowa|Mieszałki|ul. Szkolna 11 |78-450 Grzmiąca;608;167;167;6;161;27.47;3.59
111044;321505;Szkoła Podstawowa|Iwin| 12A |78-451 Przeradz;523;170;170;12;158;32.50;7.06
111045;321505;Budynek po byłej Szkole Podstawowej|Krosino|ul. Szkolna 3 |78-452 Krosino;811;260;260;19;241;32.06;7.31
111046;321506;Szkoła Podstawowa w Wierzchowie|Wierzchowo| 40 |78-411 Wierzchowo;1319;375;375;17;358;28.43;4.53
111047;321506;Szkoła Podstawowa w Wierzchowie, filia w Sporem|Spore| 7 |78-400 Szczecinek;567;185;185;15;170;32.63;8.11
111048;321506;Szkoła Podstawowa w Parsęcku|Parsęcko| 69 |78-400 Szczecinek;1529;454;454;21;433;29.69;4.63
111049;321506;Świetlica w Jeleninie|Jelenino| 38A |78-400 Szczecinek;468;174;174;14;160;37.18;8.05
111050;321506;Publiczne Gimnazjum w Turowie|Turowo| 78 |78-400 Szczecinek;1410;486;486;25;461;34.47;5.14
111051;321506;Szkoła Podstawowa w Żółtnicy|Żółtnica|ul. Szkolna 13 |78-400 Szczecinek;885;287;287;18;269;32.43;6.27
111052;321506;Świetlica w Gwdzie Wielkiej|Gwda Wielka|ul. Szczecinecka 15 |78-422 Gwda Wielka;1149;468;468;17;451;40.73;3.63
111053;321601;Zespół Szkół Ponadgimnazjalnych (nowy budynek)|Świdwin|ul. Kościuszki 28 |78-300 Świdwin;1852;687;687;30;657;37.10;4.37
111054;321601;Hala Sportowa|Świdwin|ul. 3 Marca 50 |78-300 Świdwin;1559;643;643;22;621;41.24;3.42
111055;321601;Publiczne Przedszkole nr 1|Świdwin|ul. Drawska 30 |78-300 Świdwin;1366;563;563;13;550;41.22;2.31
111056;321601;Świdwiński Ośrodek Kultury|Świdwin|ul. Niedziałkowskiego 17 |78-300 Świdwin;1591;714;714;27;687;44.88;3.78
111057;321601;Publiczne Gimnazjum nr 1|Świdwin|ul. Kombatantów Polskich 6 |78-300 Świdwin;1844;880;880;25;855;47.72;2.84
111058;321601;Budynek dawnej Szkoły Zawodowej|Świdwin|ul. Wojska Polskiego 14 |78-300 Świdwin;1799;845;845;19;826;46.97;2.25
111059;321601;Zespół Szkół Rolniczych Centrum Kształcenia Praktycznego|Świdwin|ul. Szczecińska 88 |78-300 Świdwin;1417;550;550;12;538;38.81;2.18
111060;321601;Publiczna Szkoła Podstawowa nr 3|Świdwin|ul. Szturmowców 1 |78-300 Świdwin;823;346;346;8;338;42.04;2.31
111061;321602;Remiza Ochotniczej Straży Pożarnej|Brzeżno| 7 |78-316 Brzeżno;1852;650;650;26;624;35.10;4.00
111062;321602;Świetlica|Słonowice| 35 1|78-316 Brzeżno;419;137;137;7;130;32.70;5.11
111063;321603;Publiczne Gimnazjum w Połczynie-Zdroju|Połczyn-Zdrój|ul. Mieszka I 19 |78-320 Połczyn-Zdrój;1047;545;545;12;533;52.05;2.20
111064;321603;Hala Widowiskowo-Sportowa w Połczynie-Zdroju|Połczyn-Zdrój|ul. Mieszka I 19 |78-320 Połczyn-Zdrój;1864;642;642;17;625;34.44;2.65
111065;321603;Zespól Szkół Ponadgimnazjalnych w Połczynie-Zdroju|Połczyn-Zdrój|ul. Staszica 6 |78-320 Połczyn-Zdrój;1444;674;674;36;638;46.68;5.34
111066;321603;Centrum Kultury w Połczynie-Zdroju|Połczyn-Zdrój|ul. Wojska Polskiego 54 |78-320 Połczyn-Zdrój;1836;752;752;26;726;40.96;3.46
111067;321603;Urząd Miejski w Połczynie-Zdroju|Połczyn-Zdrój|ul. Plac Wolności 3-4 |78-320 Połczyn-Zdrój;1990;1016;1016;43;973;51.06;4.23
111068;321603;Publiczna Szkoła Podstawowa Nr 1 w Połczynie-Zdroju|Połczyn-Zdrój|ul. Grunwaldzka 34 |78-320 Połczyn-Zdrój;1655;648;648;33;615;39.15;5.09
111069;321603;Publiczna Szkoła Podstawowa w Toporzyku|Toporzyk| 23 |78-320 Połczyn-Zdrój;766;207;207;9;198;27.02;4.35
111070;321603;Zespół Szkół Publicznych w Redle|Redło| 12 |78-320 Połczyn-Zdrój;1673;621;621;29;592;37.12;4.67
111071;321603;Publiczna Szkoła Podstawowa w Bolkowie|Bolkowo| 10 |78-320 Połczyn-Zdrój;684;213;213;21;192;31.14;9.86
111072;321603;Przyjazny Szpital w Połczynie-Zdroju|Połczyn-Zdrój|Gwardii Ludowej 5 |78-320 Połczyn-Zdrój;41;9;9;0;9;21.95;0.00
111073;321604;Zespół Szkół|Rąbino| 57 |78-331 Rąbino;1356;488;488;14;474;35.99;2.87
111074;321604;Szkoła Podstawowa|Nielep| 38 |78-331 Rąbino;665;175;175;11;164;26.32;6.29
111075;321604;Ośrodek Edukacji Ekologicznej|Lipie| 16 |78-331 Rąbino;527;132;132;12;120;25.05;9.09
111076;321604;Świetlica Wiejska|Rzecino| 12 |78-331 Rąbino;492;117;117;6;111;23.78;5.13
111077;321605;Ośrodek Kultury|Sławoborze|ul. Kolejowa 6 |78-314 Sławoborze;791;282;282;19;263;35.65;6.74
111078;321605;Środowiskowy Dom Samopomocy|Sławoborze|ul. Leśna 1a |78-314 Sławoborze;805;341;341;9;332;42.36;2.64
111079;321605;Szkoła Podstawowa|Sławoborze|ul. Lipowa 19 |78-314 Sławoborze;955;214;214;13;201;22.41;6.07
111080;321605;Świetlica Wiejska|Mysłowice| 51 |78-314 Sławoborze;717;197;197;19;178;27.48;9.64
111081;321605;Dom Pomocy Społecznej w Krzecku 5|Krzecko| 5 |78-314 Sławoborze;62;18;18;2;16;29.03;11.11
111082;321606;Świetlica Wiejska w Rusinowie|Rusinowo| 22 |78-311 Rusinowo;553;213;213;5;208;38.52;2.35
111083;321606;Świetlica OSP w Lekowie|Lekowo| 25a |78-312 Lekowo;665;211;211;9;202;31.73;4.27
111084;321606;Zespół Szkół w Bierzwnicy|Bierzwnica| 52 |78-324 Cieszeniewo;488;149;149;16;133;30.53;10.74
111085;321606;Świetlica Wiejska w Klępczewie|Klępczewo| 8 |78-312 Lekowo;533;188;188;9;179;35.27;4.79
111086;321606;Świetlica Wiejska w Smardzku|Smardzko| 14 |78-300 Świdwin;679;221;221;16;205;32.55;7.24
111087;321606;Szkoła Filialna w Oparznie|Oparzno| 31 |78-300 Świdwin;630;180;180;12;168;28.57;6.67
111088;321606;Szkoła Podstawowa Nr 2 w Świdwinie|Świdwin|ul. Armii Krajowej 19 |78-300 Świdwin;920;305;305;14;291;33.15;4.59
111089;321606;Świetlica Wiejska w Krosinie|Krosino| 21 |78-300 Świdwin;430;157;157;3;154;36.51;1.91
111090;321701;Rolnicze Centrum Kształcenia Ustawicznego|Wałcz|ul. Południowa 10 a |78-600 Wałcz;725;335;335;11;324;46.21;3.28
111091;321701;Szkoła Podstawowa Nr 4|Wałcz|Al. Tysiąclecia 19 |78-600 Wałcz;1844;913;913;21;892;49.51;2.30
111092;321701;Przedszkole nr 6|Wałcz|Al. Tysiąclecia 9 |78-600 Wałcz;1875;907;907;27;880;48.37;2.98
111093;321701;Szkoła Podstawowa Nr 1|Wałcz|ul. Robotnicza 23 |78-600 Wałcz;1864;825;825;28;797;44.26;3.39
111094;321701;Środowiskowy Dom Samopomocy|Wałcz|ul. Nowomiejska 4 |78-600 Wałcz;1965;936;937;25;911;47.63;2.67
111095;321701;Zespół Szkół Nr 3|Wałcz|ul. Bankowa 13 |78-600 Wałcz;1787;972;972;8;964;54.39;0.82
111096;321701;Szkoła Podstawowa Nr 5|Wałcz|os. Dolne Miasto 14A |78-600 Wałcz;1912;1042;1042;21;1021;54.50;2.02
111097;321701;Przedszkole Nr 8|Wałcz|os. Dolne Miasto 25a |78-600 Wałcz;1801;985;985;26;959;54.69;2.64
111098;321701;Zespół Szkół Miejskich Nr 2|Wałcz|ul. Sądowa 9 |78-600 Wałcz;1726;750;750;17;733;43.45;2.27
111099;321701;Przedszkole Nr 9|Wałcz|ul. Wojska Polskiego 53 |78-600 Wałcz;2379;1136;1136;47;1089;47.75;4.14
111100;321701;PKS Sp. z o.o.|Wałcz|ul. Wojska Polskiego 54 |78-600 Wałcz;2240;1198;1198;22;1176;53.48;1.84
111101;321701;107 Szpital Wojskowy z Przychodnią Samodzielny Publiczny Zakład Opieki Zdrowotnej w Wałczu|Wałcz|ul. Kołobrzeska 44 |78-600 Wałcz;83;68;68;3;65;81.93;4.41
111102;321701;Dom Pomocy Społecznej w Wałczu|Wałcz|ul. Orla 35 |78-600 Wałcz;56;24;24;5;19;42.86;20.83
111103;321702;Dom Kultury w Człopie|Człopa|Strzelecka 1 |78-630 Człopa;1894;795;795;38;757;41.97;4.78
111104;321702;Publiczne Gimnazjum im. Jana Pawła II|Człopa|Plac Zwycięstwa 6 |78-630 Człopa;1356;328;328;25;303;24.19;7.62
111105;321702;Świetlica Wiejska|Mielęcin|ul. Szkolna 5 |78-630 Człopa;340;130;130;10;120;38.24;7.69
111106;321702;Świetlica Wiejska|Wołowe Lasy| 22 |78-630 Człopa;458;167;167;15;152;36.46;8.98
111107;321703;Zespół Szkół w Mirosławcu|Mirosławiec|ul. Wolności 21 |78-650 Mirosławiec;1261;493;493;15;478;39.10;3.04
111108;321703;Ośrodek Kultury w Mirosławcu|Mirosławiec|ul. Parkowa 1 |78-650 Mirosławiec;1417;581;581;28;553;41.00;4.82
111109;321703;Świetlica Środowiskowa w Mirosławcu Górnym|Mirosławiec Górny|Osiedle XXX-Lecia LLP 4 1|78-651 Mirosławiec Górny;433;198;198;1;197;45.73;0.51
111110;321703;Świetlica Wiejska w Hankach|Hanki| 47 |78-652 Mirosławiec;597;180;180;8;172;30.15;4.44
111111;321703;Świetlica Wiejska w Piecniku|Piecnik| 53 |78-650 Mirosławiec;493;134;134;5;129;27.18;3.73
111112;321704;Hol Szkoły Podstawowej|Tuczno|ul. Świerczewskiego 41 |78-640 Tuczno;815;309;309;19;290;37.91;6.15
111113;321704;Szkoła Podstawowa|Marcinkowice| 46A |78-640 Tuczno;757;234;234;33;201;30.91;14.10
111114;321704;Świetlica Wiejska|Rzeczyca|1-go Maja 39 |78-640 Tuczno;824;260;260;10;250;31.55;3.85
111115;321704;Świetlica Wiejska|Zdbowo| 2 |78-640 Tuczno;394;109;109;22;87;27.66;20.18
111116;321704;Świetlica Wiejska|Miłogoszcz| 11 |78-640 Tuczno;417;87;87;5;82;20.86;5.75
111117;321704;Gminny Ośrodek Kultury w Tucznie|Tuczno|Wolności 26a |78-640 Tuczno;809;318;318;25;293;39.31;7.86
111118;321705;Szkoła Podstawowa|Dębołęka| 13A |78-607 Dębołęka;1307;380;380;17;363;29.07;4.47
111119;321705;Szkoła Podstawowa|Karsibór| 39 |78-609 Karsibór;1440;473;473;25;448;32.85;5.29
111120;321705;Świetlica Wiejska|Kłębowiec| 50A |78-600 Wałcz;681;293;293;16;277;43.02;5.46
111121;321705;Szkoła Podstawowa|Szwecja|Szkolna 21 |78-611 Szwecja;1368;650;650;9;641;47.51;1.38
111122;321705;Szkoła Podstawowa|Witankowo| 42 |78-600 Wałcz;744;246;246;18;228;33.06;7.32
111123;321705;Szkoła Podstawowa|Różewo| 8 |78-627 Różewo;1345;515;515;12;503;38.29;2.33
111124;321705;Szkoła Podstawowa|Gostomia| 36 |78-600 Wałcz;1171;359;359;13;346;30.66;3.62
111125;321705;Szkoła Podstawowa|Strączno| 53 |78-642 Strączno;1192;344;344;8;336;28.86;2.33
111126;321705;Gimnazjum|Chwiram| 1 |78-627 Różewo;592;241;241;12;229;40.71;4.98
111127;321801;Szkoła Podstawowa|Dobra|ul. Mieszczańska 2 |72-210 Dobra;1834;657;657;27;630;35.82;4.11
111128;321801;Urząd Miejski|Dobra|ul. Rynek 1 |72-210 Dobra;1105;249;249;18;231;22.53;7.23
111129;321801;Szkoła Podstawowa|Wojtaszyce| 39 |72-210 Dobra;593;162;162;12;150;27.32;7.41
111130;321802;Przedszkole Miejskie Nr 1|Łobez|ul. Mickiewicza 11 |73-150 Łobez;1467;730;730;23;707;49.76;3.15
111131;321802;Szkoła Podstawowa Nr 1|Łobez|ul.Bema 6 |73-150 Łobez;1474;680;680;17;663;46.13;2.50
111132;321802;Zespół Szkół Gimnazjalnych|Łobez|ul. Kościuszki 17 |73-150 Łobez;1414;596;596;20;576;42.15;3.36
111133;321802;Łobeski Dom Kultury|Łobez|ul. Niepodległości 52 |73-150 Łobez;741;305;305;6;299;41.16;1.97
111134;321802;Hala Widowiskowo-Sportowa|Łobez|ul.Orzeszkowej 7 |73-150 Łobez;1641;758;758;23;735;46.19;3.03
111135;321802;Agencja Restrukturyzacji i Modernizacji Rolnictwa Biuro Powiatu Łobeskiego|Łobez|Plac Spółdzielców 2 |73-150 Łobez;786;301;301;16;285;38.30;5.32
111136;321802;Środowiskowy Dom Samopomocy|Łobez|ul.Sawickiej 31 |73-150 Łobez;755;327;327;12;315;43.31;3.67
111137;321802;Świetlica wiejska w Dalnie|Dalno| |73-150 Łobez;682;174;174;13;161;25.51;7.47
111138;321802;Publiczna Szkoła Podstawowa w Bełcznie|Bełczna| 28A |73-150 Łobez;744;188;188;11;177;25.27;5.85
111139;321802;Światlica wiejska w Zajezierzu|Zajezierze| 34 |73-150 Łobez;701;207;207;8;199;29.53;3.86
111140;321802;Świetlica wiejska w Suliszewicach|Suliszewice| 21A |73-150 Łobez;794;190;190;9;181;23.93;4.74
111141;321803;Gminny Ośrodek Kultury|Radowo Małe| 5 |72-314 Radowo Małe;958;392;392;18;374;40.92;4.59
111142;321803;Świetlica Wiejska|Rogowo| 22 |72-314 Radowo Małe;559;130;130;16;114;23.26;12.31
111143;321803;Świetlica Wiejska|Gostomin| 8 |72-314 Radowo Małe;630;153;153;8;145;24.29;5.23
111144;321803;Szkoła podstawowa w Siedlicach|Siedlice| 16A |73-155 Węgorzyno;837;212;212;11;201;25.33;5.19
111145;321804;Zespół Szkół|Resko|ul. Bolesława Prusa 2 |72-315 Resko;1957;738;738;33;705;37.71;4.47
111146;321804;Centrum Kultury|Resko|ul. Wojska Polskiego 16 |72-315 Resko;2142;830;830;29;801;38.75;3.49
111147;321804;Szkoła Podstawowa Resko, Filia|Łosośnica| 23 |72-315 Resko;446;126;126;8;118;28.25;6.35
111148;321804;Budynek nr 32 (po byłej szkole podstawowej)|Łabuń Wielki| 32 |72-315 Resko;555;139;139;3;136;25.05;2.16
111149;321804;Szkoła Podstawowa|Starogard| 12 |72-315 Resko;1126;296;296;19;277;26.29;6.42
111150;321804;Dom Pomocy Społecznej Resko|Resko|ul.Wojska Polskiego 40 |72-315 Resko;55;27;27;5;22;49.09;18.52
111151;321804;SPZZOZ w Gryficach Oddział Zamiejscowy w Resku|Resko|ul.Szpitalna 8 |72-315 Resko;68;9;9;0;9;13.24;0.00
111152;321805;Gimnazjum|Węgorzyno|Kościuszki 29 |73-155 Węgorzyno;2177;860;860;49;811;39.50;5.70
111153;321805;Szkoła Podstawowa|Węgorzyno|Grunwaldzka 2 |73-155 Węgorzyno;1010;269;269;29;240;26.63;10.78
111154;321805;Niepubliczne Przedszkole TPD|Sielsko| 20 |73-155 Węgorzyno;852;246;246;11;235;28.87;4.47
111155;321805;Szkoła Podstawowa|Runowo Pomorskie|Węgorzyńska 29 |73-155 Węgorzyno;1680;485;485;23;462;28.87;4.74
111156;326101;Przedszkole Nr 14|Koszalin|ul. Melchiora Wańkowicza 15 |75-445 Koszalin;1557;892;892;11;881;57.29;1.23
111157;326101;Bursa Międzyszkolna|Koszalin|ul. Jana Pawła II 17 |75-452 Koszalin;1728;953;953;21;932;55.15;2.20
111158;326101;Żłobek Miejski "Smyk"|Koszalin|ul. Ignacego Chrzanowskiego 10 |75-327 Koszalin;1951;1175;1175;16;1159;60.23;1.36
111159;326101;Szkoła Podstawowa Integracyjna Nr 21|Koszalin|ul. Władysława Spasowskiego 14a |75-451 Koszalin;1700;1080;1080;16;1064;63.53;1.48
111160;326101;Politechnika Koszalińska|Koszalin|ul. Śniadeckich 2 |75-453 Koszalin;1947;1141;1141;14;1127;58.60;1.23
111161;326101;Przedszkole Nr 15|Koszalin|ul. Stanisława Staszica 11 |75-449 Koszalin;1538;965;965;19;946;62.74;1.97
111162;326101;Szkoła Podstawowa Nr 18|Koszalin|ul. Stanisława Staszica 6 |75-449 Koszalin;2171;1363;1363;17;1346;62.78;1.25
111163;326101;Gimnazjum Nr 9|Koszalin|ul. Stanisława Staszica 6 |75-449 Koszalin;1369;820;820;12;808;59.90;1.46
111164;326101;Przedszkole Nr 35|Koszalin|ul. Rodła 10 |75-361 Koszalin;2096;1437;1437;15;1422;68.56;1.04
111165;326101;Szkoła Podstawowa Nr 17|Koszalin|ul. Melchiora Wańkowicza 11 |75-445 Koszalin;2182;1173;1173;16;1157;53.76;1.36
111166;326101;Gimnazjum Nr 7|Koszalin|ul. Melchiora Wańkowicza 26 |75-446 Koszalin;2197;1207;1207;22;1185;54.94;1.82
111167;326101;Zespół Państwowych Szkół Muzycznych|Koszalin|ul. Juliana Fałata 32 |75-434 Koszalin;1911;993;993;18;975;51.96;1.81
111168;326101;Zespół Szkół Nr 7|Koszalin|ul. Orląt Lwowskich 18 |75-522 Koszalin;1656;884;884;23;861;53.38;2.60
111169;326101;Gimnazjum Nr 11|Koszalin|ul. Sportowa 19 |75-503 Koszalin;958;568;568;6;562;59.29;1.06
111170;326101;Koszalińska Biblioteka Publiczna|Koszalin|ul. Plac Polonii 1 |75-415 Koszalin;1183;539;540;11;528;45.56;2.04
111171;326101;Szkoła Podstawowa Nr 10|Koszalin|ul. Fryderyka Chopina 42 |75-567 Koszalin;1983;1127;1128;20;1107;56.83;1.77
111172;326101;Dzienny Dom Pomocy "Złoty Wiek"|Koszalin|ul. Marszałka Józefa Piłsudskiego 64 |75-525 Koszalin;2260;1194;1194;19;1175;52.83;1.59
111173;326101;Przedszkole Nr 7|Koszalin|ul. Marszałka Józefa Piłsudskiego 44 |75-512 Koszalin;2098;1020;1020;30;990;48.62;2.94
111174;326101;Przedszkole Nr 22|Koszalin|ul. Tytusa Chałubińskiego 6 |75-581 Koszalin;1723;1068;1068;18;1050;61.98;1.69
111175;326101;Zespół Szkół Nr 11|Koszalin|ul. Jabłoniowa 23 |75-679 Koszalin;1935;1174;1174;11;1163;60.67;0.94
111176;326101;Centrum Edukacji Nauczycieli|Koszalin|ul. Ferdynanda Ruszczyca 16 |75-654 Koszalin;2172;1279;1279;14;1265;58.89;1.09
111177;326101;PRO-WAM Spółka z o.o.|Koszalin|ul. Zwycięstwa 278 |75-653 Koszalin;2023;1322;1322;14;1308;65.35;1.06
111178;326101;II Liceum Ogólnokształcące im. Wł. Broniewskiego|Koszalin|ul. Józefa Chełmońskiego 7 |75-631 Koszalin;1908;1080;1080;19;1061;56.60;1.76
111179;326101;Klub KSM "Nasz Dom"|Koszalin|ul. Zwycięstwa 148 |75-613 Koszalin;1872;920;920;21;899;49.15;2.28
111180;326101;Szkoła Podstawowa Nr 7|Koszalin|ul. Wojska Polskiego 36 |75-712 Koszalin;1850;1095;1095;20;1075;59.19;1.83
111181;326101;Szkoła Podstawowa Nr 6|Koszalin|ul. Gnieźnieńska 3 |75-736 Koszalin;2356;1292;1292;12;1280;54.84;0.93
111182;326101;Archiwum Państwowe|Koszalin|ul. Marii Skłodowskiej-Curie 2 |75-803 Koszalin;1164;574;574;20;554;49.31;3.48
111183;326101;Centrum Kultury "105"|Koszalin|ul. Zwycięstwa 105 |75-001 Koszalin;535;291;291;7;284;54.39;2.41
111184;326101;Szkoła Podstawowa Nr 13|Koszalin|ul. Rzemieślnicza 9 |75-243 Koszalin;1745;861;861;26;835;49.34;3.02
111185;326101;Przedszkole Nr 10|Koszalin|ul. Rzemieślnicza 6 |75-243 Koszalin;1327;616;616;15;601;46.42;2.44
111186;326101;I Liceum Ogólnokształcące im. St. Dubois|Koszalin|ul. Komisji Edukacji Narodowej 1 |75-070 Koszalin;1378;701;701;7;694;50.87;1.00
111187;326101;Gimnazjum Nr 2|Koszalin|ul. Bolesława Krzywoustego 5 |75-064 Koszalin;1127;556;556;11;545;49.33;1.98
111188;326101;Polska Spółka Gazownictwa Sp. z o.o. Oddział w Poznaniu Zakład w Koszalinie|Koszalin|ul. Połczyńska 55-57 |75-808 Koszalin;1891;969;969;19;950;51.24;1.96
111189;326101;Szkoła Podstawowa Nr 9|Koszalin|ul. Powstańców Wielkopolskich 23 |75-100 Koszalin;1831;872;872;23;849;47.62;2.64
111190;326101;Miejska Energetyka Cieplna Sp. z o.o.|Koszalin|ul. Łużycka 25a |75-111 Koszalin;1512;687;687;28;659;45.44;4.08
111191;326101;Przedszkole Nr 12|Koszalin|ul. Lechicka 45 |75-842 Koszalin;981;415;415;19;396;42.30;4.58
111192;326101;Koszalińska Biblioteka Publiczna Filia Nr 1|Koszalin|ul. Wenedów 24b 8|75-847 Koszalin;1753;1060;1060;20;1040;60.47;1.89
111193;326101;Żłobek Miejski Oddział "Jacek i Agatka"|Koszalin|ul. Konstytucji 3 Maja 29 |75-823 Koszalin;1817;714;714;15;699;39.30;2.10
111194;326101;Koszalińskie Centrum Kształcenia Instytut Postępowania Twórczego|Koszalin|ul. Bohaterów Warszawy 22 |75-211 Koszalin;957;413;413;6;407;43.16;1.45
111195;326101;VI Liceum Ogólnokształcące|Koszalin|ul. Podgórna 55 |75-335 Koszalin;1461;775;775;22;753;53.05;2.84
111196;326101;Szkoła Podstawowa Nr 4|Koszalin|ul. Podgórna 45 |75-321 Koszalin;1714;895;895;20;875;52.22;2.23
111197;326101;Klub Osiedlowy KSM "Na Skarpie"|Koszalin|ul. Na Skarpie 17 |75-343 Koszalin;1822;1005;1005;8;997;55.16;0.80
111198;326101;Przedszkole Integracyjne|Koszalin|ul. Władysława IV 143 |75-342 Koszalin;2119;1366;1366;21;1345;64.46;1.54
111199;326101;Gimnazjum Nr 6|Koszalin|ul. Stanisława Dąbka 1 |75-354 Koszalin;1989;1128;1128;18;1110;56.71;1.60
111200;326101;Politechnika Koszalińska|Koszalin|ul. Eugeniusza Kwiatkowskiego 6e |75-343 Koszalin;1736;989;989;9;980;56.97;0.91
111201;326101;Klub "Bałtyk"|Koszalin|ul. Spokojna 48 |75-233 Koszalin;1868;1013;1013;14;999;54.23;1.38
111202;326101;Zespół Szkół Nr 13|Koszalin|ul. Franciszkańska 102 |75-255 Koszalin;2029;1141;1141;25;1116;56.23;2.19
111203;326101;Zespół Szkół Nr 8|Koszalin|ul. Morska 108 |75-235 Koszalin;1868;969;969;22;947;51.87;2.27
111204;326101;Przedszkole Integracyjne|Koszalin|ul. Szkolna 1 |75-900 Koszalin;981;547;547;8;539;55.76;1.46
111205;326101;Szpital Wojewódzki|Koszalin|ul. Tytusa Chałubińskiego 7 |75-581 Koszalin;290;120;120;2;118;41.38;1.67
111206;326101;Specjalistyczny Zespół Gruźlicy i Chorób Płuc|Koszalin|ul. Niepodległości 44-48 |75-252 Koszalin;79;25;25;2;23;31.65;8.00
111207;326101;Zakład Karny|Koszalin|ul. Strefowa 17 |75-950 Koszalin;343;169;169;26;143;49.27;15.38
111208;326101;Areszt Śledczy|Koszalin|ul. Młyńska 71 |75-950 Koszalin;265;166;166;39;127;62.64;23.49
111209;326101;Dom Pomocy Społecznej|Koszalin|Leonida Teligi 4 |75-235 Koszalin;80;36;36;3;33;45.00;8.33
111210;326201;Rada Osiedla Płonia,Śm.,Jezierzyce|Szczecin|ul. Pyrzycka 28 |70-892 Szczecin;1157;626;626;10;616;54.11;1.60
111211;326201;Warsztaty Terapii Zajeciowej|Szczecin|ul. Przyszłości 21 |70-893 Szczecin;2178;1089;1089;25;1064;50.00;2.30
111212;326201;Zespół Szkół Nr 13|Szczecin|ul. Bałtycka 1a |70-880 Szczecin;1385;696;696;9;687;50.25;1.29
111213;326201;Zespół Szkół Nr 13|Szczecin|ul. Bałtycka 1a |70-880 Szczecin;1710;955;955;15;940;55.85;1.57
111214;326201;Szkoła Podstawowa Nr 59|Szczecin|ul. Dąbska 105 |70-789 Szczecin;1692;1018;1018;13;1005;60.17;1.28
111215;326201;Szkoła Podstawowa Nr 59|Szczecin|ul. Dąbska 105 |70-789 Szczecin;1444;876;876;14;862;60.66;1.60
111216;326201;Przedszkole Publiczne Nr 11|Szczecin|"Osiedle Kasztanowe" 54 |70-895 Szczecin;1307;567;567;18;549;43.38;3.17
111217;326201;Przedszkole Publiczne Nr 11|Szczecin|"Osiedle Kasztanowe" 54 |70-895 Szczecin;1383;607;607;30;577;43.89;4.94
111218;326201;Szkoła Podstawowa Nr 71|Szczecin|ul. Bośniacka 7 |70-842 Szczecin;1451;797;797;10;787;54.93;1.25
111219;326201;Szkoła Podstawowa Nr 71|Szczecin|ul. Bośniacka 7 |70-842 Szczecin;1498;738;738;16;722;49.27;2.17
111220;326201;Zespół Szkół nr 2|Szczecin|ul. Portowa 21 |70-833 Szczecin;2248;1261;1261;20;1241;56.09;1.59
111221;326201;III Liceum Ogólnokształcące|Szczecin|ul. Pomorska 150 |70-812 Szczecin;1420;740;740;7;733;52.11;0.95
111222;326201;III Liceum Ogólnokształcące|Szczecin|ul. Pomorska 150 |70-812 Szczecin;2123;991;991;15;976;46.68;1.51
111223;326201;Szkoła Podstawowa Nr 23|Szczecin|ul. Miernicza 10 |70-823 Szczecin;2033;988;988;23;965;48.60;2.33
111224;326201;Przedszkole Publiczne Nr 62|Szczecin|ul. Jasna 74 |70-777 Szczecin;2013;1214;1214;27;1187;60.31;2.22
111225;326201;Przedszkole Prywatne|Szczecin|ul. Jasna 113 |70-777 Szczecin;1486;883;883;11;872;59.42;1.25
111226;326201;Prywatna Szkoła Podstawowa" Słoneczna"|Szczecin|ul. Rydla 5 |70-783 Szczecin;1483;824;824;13;811;55.56;1.58
111227;326201;Centrum Kształcenia Sportowego|Szczecin|ul. Rydla 49 |70-783 Szczecin;1829;1032;1032;14;1018;56.42;1.36
111228;326201;Centrum Kształcenia Sportowego|Szczecin|ul. Rydla 49 |70-783 Szczecin;1209;702;702;10;692;58.06;1.42
111229;326201;Przedszkole Publiczne Nr 9|Szczecin|ul. Kostki Napierskiego 13 |70-783 Szczecin;1573;900;900;8;892;57.22;0.89
111230;326201;NS ZOZ "Prawobrzeże-Medyk|Szczecin|ul.Kostki Napierskiego 6c |70-783 Szczecin;1444;813;813;11;802;56.30;1.35
111231;326201;Środowiskowe Ognisko Wychowawcze TPD|Szczecin|ul. Kosynierów 16 |70-786 Szczecin;1152;627;627;5;622;54.43;0.80
111232;326201;Gimnazjum Nr 7|Szczecin|ul. Zofii Nałkowskiej 33 |70-785 Szczecin;1631;927;927;10;917;56.84;1.08
111233;326201;Gimnazjum Nr 7|Szczecin|ul. Zofii Nałkowskiej 33 |70-785 Szczecin;1543;892;892;14;878;57.81;1.57
111234;326201;Przedszkole Publiczne Nr 61|Szczecin|ul. Maciejowicka 26 |70-786 Szczecin;1718;1010;1010;13;997;58.79;1.29
111235;326201;Szkoła Podstawowa Nr 37|Szczecin|ul. Rydla 6 |70-783 Szczecin;697;360;360;7;353;51.65;1.94
111236;326201;Klub Osiedlowy" Szpak"|Szczecin|ul. Seledynowa 75a |70-781 Szczecin;1885;1083;1083;24;1059;57.45;2.22
111237;326201;Klub Osiedlowy "Smyk"|Szczecin|ul. Różowa 17 |70-781 Szczecin;1383;703;703;10;693;50.83;1.42
111238;326201;Szkoła Podstawowa Nr 74|Szczecin|ul. Seledynowa 50 |70-781 Szczecin;1232;734;734;9;725;59.58;1.23
111239;326201;Przedszkole Publiczne Nr 8|Szczecin|ul. Różowa 24 |70-781 Szczecin;1842;1046;1046;12;1034;56.79;1.15
111240;326201;Szkoła Podstawowa Nr 74|Szczecin|ul. Seledynowa 50 |70-781 Szczecin;2271;1461;1461;8;1453;64.33;0.55
111241;326201;Szkoła Podstawowa Nr 74|Szczecin|ul. Seledynowa 50 |70-781 Szczecin;2053;1253;1253;16;1237;61.03;1.28
111242;326201;Poradnia Psychologiczno Pedagogiczna Nr 2|Szczecin|ul. Jaśminowa 4 |70-783 Szczecin;1892;1060;1060;21;1039;56.03;1.98
111243;326201;Zespół Szkół Nr 1|Szczecin|ul. Młodzieży Polskiej 9 |70-774 Szczecin;1468;864;864;12;852;58.86;1.39
111244;326201;Zespół Szkół Nr 1|Szczecin|ul. Młodzieży Polskiej 9 |70-774 Szczecin;1172;680;680;7;673;58.02;1.03
111245;326201;Zespół Szkół Specjalnych Nr 9|Szczecin|ul. Letniskowa 1 |70-763 Szczecin;2173;1095;1095;17;1078;50.39;1.55
111246;326201;Przedszkole Publiczne Nr 49|Szczecin|ul. Marmurowa 7 |70-747 Szczecin;1602;772;772;17;755;48.19;2.20
111247;326201;Zespół Szkół Nr 15|Szczecin|ul. Floriana Szarego 12 |70-743 Szczecin;1625;891;891;17;874;54.83;1.91
111248;326201;Zespół Szkół Nr 15|Szczecin|ul. Floriana Szarego 12 |70-743 Szczecin;2395;1336;1336;26;1310;55.78;1.95
111249;326201;Przedszkole Nr 79|Szczecin|ul. Krzemienna 42a |70-734 Szczecin;1479;726;726;10;716;49.09;1.38
111250;326201;Rada Osiedla Żydowce Klucz|Szczecin|ul. Rymarska 46/1a |70-700 Szczecin;1926;821;821;18;803;42.63;2.19
111251;326201;Przychodnia Portowa sp. z oo|Szczecin|ul. Energetyków 2 |70-656 Szczecin;869;327;327;13;314;37.63;3.98
111252;326201;Rada Osiedla Pomorzany|Szczecin|ul. Włościańska 1 |70-021 Szczecin;1114;597;597;9;588;53.59;1.51
111253;326201;Zespół Szkół Ogólnokształcących Nr 5|Szczecin|ul. Budziszyńska 2 |70-023 Szczecin;1892;1143;1143;8;1135;60.41;0.70
111254;326201;Szkoła Podstawowa Nr 20|Szczecin|ul. Dobrzyńska 2 |70-025 Szczecin;2130;1193;1193;16;1177;56.01;1.34
111255;326201;Zespół Szkół Rzemieślniczych|Szczecin|ul. Chmielewskiego 19 |70-028 Szczecin;1423;735;735;4;731;51.65;0.54
111256;326201;Zespół Szkół Ogólnokształcących Nr 3|Szczecin|ul. Orawska 1 |70-131 Szczecin;2137;1246;1246;17;1229;58.31;1.36
111257;326201;Gimnazjum Nr 9|Szczecin|ul. Dunikowskiego 1 |70-123 Szczecin;1861;1047;1047;11;1036;56.26;1.05
111258;326201;Gimnazjum Nr 9|Szczecin|ul. Dunikowskiego 1 |70-123 Szczecin;1940;1177;1177;19;1158;60.67;1.61
111259;326201;Specjalny Ośrodek Szkolno-Wych. dla Dzieci Niesłyszących|Szczecin|ul. Szpitalna 15 |70-116 Szczecin;1141;545;545;11;534;47.77;2.02
111260;326201;Przedszkole Publiczne Nr 48|Szczecin|ul. 9 Maja 13 |70-136 Szczecin;1571;907;907;10;897;57.73;1.10
111261;326201;Przedszkole Publiczne nr 44|Szczecin|ul. Ruska 16 |70-132 Szczecin;1533;878;878;15;863;57.27;1.71
111262;326201;Uniwersytet Szczeciński|Szczecin|ul. Cukrowa 8 |71-004 Szczecin;925;535;535;6;529;57.84;1.12
111263;326201;Szkoła Podstawowa Nr 16|Szczecin|ul. Chobolańska 20 |71-023 Szczecin;2357;1594;1594;20;1574;67.63;1.25
111264;326201;Szkoła Podstawowa Nr 16|Szczecin|ul. Chobolańska 20 |71-023 Szczecin;2396;1388;1388;14;1374;57.93;1.01
111265;326201;IV Liceum Ogólnokształcące|Szczecin|ul. Św. Kingi 2 |71-023 Szczecin;1042;734;734;5;729;70.44;0.68
111266;326201;IV Liceum Ogólnokształcące|Szczecin|ul. Św. Kingi 2 |71-023 Szczecin;1557;989;989;15;974;63.52;1.52
111267;326201;Uniwersytet Szczeciński|Szczecin|ul. Krakowska 71-79 |71-004 Szczecin;1218;697;697;5;692;57.22;0.72
111268;326201;Uniwersytet Szczeciński|Szczecin|ul. Krakowska 71-79 |71-004 Szczecin;1169;666;666;11;655;56.97;1.65
111269;326201;Gimnazjum Nr 20|Szczecin|ul. Brodnicka 10 |71-044 Szczecin;2027;1252;1252;16;1236;61.77;1.28
111270;326201;Gimnazjum Nr 20|Szczecin|ul. Brodnicka 10 |71-044 Szczecin;2406;1578;1578;11;1567;65.59;0.70
111271;326201;Gimnazjum Nr 20|Szczecin|ul. Brodnicka 10 |71-044 Szczecin;1778;1067;1067;11;1056;60.01;1.03
111272;326201;Zachodniopomorski Uniwersytet Technologiczny Wydział Technologii Chemii|Szczecin|Aleja Piastów 42 |71-065 Szczecin;2368;1429;1429;13;1416;60.35;0.91
111273;326201;Zachodniopomorski Uniwersytet Technologiczny Wydział Technologii i Inżynierii Chemicznej|Szczecin|ul. Pułaskiego 10 |70-322 Szczecin;1488;709;709;8;701;47.65;1.13
111274;326201;Zachodniopomorski Uniwersytet Technologiczny Wydział Inżynierii Mechanicznej i Mechatroniki|Szczecin|Aleja Piastów 19 |70-310 Szczecin;858;405;405;10;395;47.20;2.47
111275;326201;I Liceum Ogólnokształcące|Szczecin|Aleja Piastów 12 |70-331 Szczecin;1584;650;650;19;631;41.04;2.92
111276;326201;Gimnazjum Nr 21|Szczecin|ul. Mickiewicza 23 |70-783 Szczecin;1646;734;734;16;718;44.59;2.18
111277;326201;Gimnazjum Nr 21|Szczecin|ul. Mickiewicza 23 |70-383 Szczecin;1108;582;582;6;576;52.53;1.03
111278;326201;Zespół Szkół Nr 6|Szczecin|ul. Sowińskiego 3 |70-236 Szczecin;2302;1271;1271;12;1259;55.21;0.94
111279;326201;Zespół Szkół Nr 3|Szczecin|ul. Sowińskiego 1 |70-236 Szczecin;721;392;392;5;387;54.37;1.28
111280;326201;VI Liceum Ogólnokształcące|Szczecin|ul. Jagiellońska 41 |70-382 Szczecin;1648;847;847;17;830;51.40;2.01
111281;326201;VI Liceum Ogólnokształcące|Szczecin|ul. Jagiellońska 41 |70-382 Szczecin;1594;841;841;8;833;52.76;0.95
111282;326201;Szkoła Podstawowa Nr 1|Szczecin|Aleja Piastów 6 |70-327 Szczecin;1366;608;608;8;600;44.51;1.32
111283;326201;Ogólnokształcąca Szkoła Muzyczna I Stopnia|Szczecin|ul. Bolesława Śmiałego 42/43 |70-351 Szczecin;1837;763;763;11;752;41.54;1.44
111284;326201;Rada Osiedla Turzyn|Szczecin|ul. Pocztowa 17 |70-361 Szczecin;1742;945;945;35;910;54.25;3.70
111285;326201;Zachodniopomorskie Stowarzyszenie Rozwoju Gospodarczego S.C.P.|Szczecin|ul. Kolumba 86 |70-035 Szczecin;518;161;161;5;156;31.08;3.11
111286;326201;Szkoła Podstawowa Nr 61|Szczecin|ul. 3-go Maja 4/7 |70-214 Szczecin;1469;612;612;12;600;41.66;1.96
111287;326201;Szkoła Podstawowa Nr 61|Szczecin|ul. 3-go Maja 4/7 |70-214 Szczecin;1129;577;577;6;571;51.11;1.04
111288;326201;Zachodniopomorski Uniwersytet Technologiczny Budynek Jednostek Międzywydziałowych|Szczecin|Aleja Piastów 48 |70-311 Szczecin;1697;659;659;14;645;38.83;2.12
111289;326201;Szkoła Podstawowa nr 5|Szczecin|ul. Królowej Jadwigi 29 |70-262 Szczecin;1772;807;807;25;782;45.54;3.10
111290;326201;Szkoła Podstawowa Nr 5|Szczecin|ul. Królowej Jadwigi 29 |70-262 Szczecin;0;0;0;0;0;-99;-99
111291;326201;Zespół Szkół Ogólnokształcących Nr 2|Szczecin|ul. Kopernika 16a |70-241 Szczecin;1415;602;602;9;593;42.54;1.50
111292;326201;Zespół Szkół Ogólnokształcących Nr 9|Szczecin|ul. Małkowskiego 12 |70-306 Szczecin;1661;707;708;8;699;42.56;1.13
111293;326201;Zespół Szkół Ogólnokształcących Nr 9|Szczecin|ul. Małkowskiego 12 |70-306 Szczecin;1775;725;725;17;708;40.85;2.34
111294;326201;Przedszkole Publiczne Nr 33|Szczecin|ul. Ściegiennego 62/65 |70-353 Szczecin;1820;781;781;17;764;42.91;2.18
111295;326201;Pomorski Uniwersytet Medyczny|Szczecin|ul. Rybacka 1 |70-204 Szczecin;808;443;443;6;437;54.83;1.35
111296;326201;Szkoła Podstawowa Nr 63|Szczecin|ul. Grodzka 23 |70-543 Szczecin;1118;667;667;7;660;59.66;1.05
111297;326201;Zespół Szkół Ogólnokształcących Nr 6|Szczecin|Plac Mariacki 1 |70-546 Szczecin;2131;997;997;19;978;46.79;1.91
111298;326201;Zespół Szkół Ogólnokształcących Nr 9|Szczecin|ul. Małkowskiego 12 |70-306 Szczecin;2168;970;970;14;956;44.74;1.44
111299;326201;Centrum Mistrzostwa Sportowego|Szczecin|ul. Mazurska 40 |70-424 Szczecin;1665;864;864;11;853;51.89;1.27
111300;326201;Przedszkole "Jutrzenka"|Szczecin|ul. Mazowiecka 2 |70-526 Szczecin;1460;809;819;5;804;55.41;0.62
111301;326201;Szkoła Podstawowa Nr 54|Szczecin|ul. Generała Rayskiego 9 |70-426 Szczecin;1412;510;510;12;498;36.12;2.35
111302;326201;Szkoła Podstawowa Nr 54|Szczecin|ul. Generała Rayskiego 9 |70-426 Szczecin;1689;915;915;12;903;54.17;1.31
111303;326201;Szkoła Podstawowa Nr 46|Szczecin|ul. Felczaka 13 |71-417 Szczecin;1136;392;392;11;381;34.51;2.81
111304;326201;Szkoła Podstawowa Nr 46|Szczecin|ul. Felczaka 13 |71-417 Szczecin;1339;677;677;11;666;50.56;1.62
111305;326201;Polskie Towarzystwo Walki z Kalectwem|Szczecin|ul. Wielkopolska 32 |70-450 Szczecin;1788;718;718;7;711;40.16;0.97
111306;326201;Zespół Szkół Specjalnych Nr 12|Szczecin|ul. Wielkopolska 14 |70-450 Szczecin;1389;696;696;9;687;50.11;1.29
111307;326201;Uniwersytet Szczeciński|Szczecin|ul. Felczaka 3a |71-412 Szczecin;1602;855;855;10;845;53.37;1.17
111308;326201;Zespół Szkół Budowlanych|Szczecin|ul. Unisławy 32/33 |71-402 Szczecin;886;491;491;10;481;55.42;2.04
111309;326201;Centrum Mistrzostwa Sportowego|Szczecin|ul. Mazurska 40 |71-402 Szczecin;1859;906;906;12;894;48.74;1.32
111310;326201;Izba Skarbowa|Szczecin|ul. Roosvelta 1 |70-525 Szczecin;812;421;421;2;419;51.85;0.48
111311;326201;Zespół Szkół Ogólnokształcących Nr 1|Szczecin|ul. Ofiar Oświęcimia 14 |71-537 Szczecin;2118;1277;1277;13;1264;60.29;1.02
111312;326201;Szkoła Podstawowa Nr 56|Szczecin|ul. Malczewskiego 22 |71-612 Szczecin;1514;869;869;16;853;57.40;1.84
111313;326201;II Liceum Ogólnokształcące|Szczecin|ul. H.Pobożnego 2 |70-500 Szczecin;1007;592;592;3;589;58.79;0.51
111314;326201;Gimnazjum Nr 6|Szczecin|ul. Niemierzyńska 17 |71-441 Szczecin;1594;683;683;12;671;42.85;1.76
111315;326201;Zespół Szkół Ogółnokształcących Nr 7|Szczecin|ul. Unisławy 26 |71-413 Szczecin;1570;766;766;15;751;48.79;1.96
111316;326201;Szkoła Podstawowa Nr 69|Szczecin|ul. Zamoyskiego 2 |71-444 Szczecin;1992;1036;1036;15;1021;52.01;1.45
111317;326201;Szkoła Podstawowa Nr 69|Szczecin|ul. Zamoyskiego 2 |71-444 Szczecin;1686;630;630;13;617;37.37;2.06
111318;326201;Zespół Szkół Ogółnokształcących Nr 7|Szczecin|ul. Unisławy 26 |71-413 Szczecin;1145;686;686;4;682;59.91;0.58
111319;326201;Szkoła Podstawowa Nr 10|Szczecin|ul. Kazimierza Królewicza 63 |71-551 Szczecin;1259;743;743;14;729;59.02;1.88
111320;326201;Szkoła Podstawowa Nr 10|Szczecin|ul. Kazimierza Królewicza 63 |71-551 Szczecin;1705;882;882;17;865;51.73;1.93
111321;326201;Gimnazjum Nr 2|Szczecin|ul. Cyryla i Metodego 43 |71-553 Szczecin;1458;750;750;22;728;51.44;2.93
111322;326201;Szkoła Podstawowa Nr 41|Szczecin|ul. Cyryla i Metodego 44 |71-540 Szczecin;1173;645;645;13;632;54.99;2.02
111323;326201;Szkoła Podstawowa Nr 41|Szczecin|ul. Cyryla i Metodego 44 |71-540 Szczecin;1713;958;958;10;948;55.93;1.04
111324;326201;Gimnazjum Nr 2|Szczecin|ul. Cyryla i Metodego 43 |71-540 Szczecin;1979;1132;1133;11;1121;57.20;0.97
111325;326201;Rada Osiedla Niebuszewo-Bolinko|Szczecin|ul. Niemcewicza 39 |71-553 Szczecin;2246;1181;1181;13;1168;52.58;1.10
111326;326201;Zespół Szkół Łączności|Szczecin|ul. Ku Słońcu 27/30 |71-080 Szczecin;877;527;527;4;523;60.09;0.76
111327;326201;Gimnazjum Nr 27|Szczecin|ul. Mikołajczyka 20 |71-075 Szczecin;1356;799;799;8;791;58.92;1.00
111328;326201;Gimnazjum Nr 27|Szczecin|ul. Mikołajczyka 20 |71-075 Szczecin;1382;619;619;7;612;44.79;1.13
111329;326201;Publiczne Przedszkole Nr 74|Szczecin|ul. 26 Kwietnia 3 |71-126 Szczecin;1450;893;893;8;885;61.59;0.90
111330;326201;Publiczne Przedszkole Nr 74|Szczecin|ul. 26 Kwietnia 3 |71-126 Szczecin;1869;1087;1087;19;1068;58.16;1.75
111331;326201;Państwowy Instytut Geologiczny|Szczecin|ul. Wieniawskiego 20 |71-130 Szczecin;2042;1294;1295;13;1281;63.37;1.00
111332;326201;Gimnazjum Nr 18|Szczecin|ul. Witkiewicza 40 |71-122 Szczecin;1773;1043;1043;6;1037;58.83;0.58
111333;326201;Gimnazjum Nr 18|Szczecin|ul. Witkiewicza 40 |71-122 Szczecin;2155;1383;1383;15;1368;64.18;1.08
111334;326201;Szkoła Podstawowa Nr 51|Szczecin|ul. Jodłowa 21 |71-114 Szczecin;1013;622;622;8;614;61.40;1.29
111335;326201;Szkoła Podstawowa Nr 51|Szczecin|ul. Jodłowa 21 |71-114 Szczecin;1170;701;701;9;692;59.91;1.28
111336;326201;VII Liceum Ogólnokształcące|Szczecin|ul. Jana Styki 13 |71-138 Szczecin;1877;1102;1102;12;1090;58.71;1.09
111337;326201;Szkoła Podstawowa Nr 48|Szczecin|ul. Czorsztyńska 35 |71-201 Szczecin;2309;1467;1467;13;1454;63.53;0.89
111338;326201;Szkoła Podstawowa Nr 48|Szczecin|ul. Czorsztyńska 35 |71-201 Szczecin;2035;1310;1310;17;1293;64.37;1.30
111339;326201;Szkoła Podstawowa Nr 48|Szczecin|ul. Czorsztyńska 35 |71-163 Szczecin;2143;1328;1328;13;1315;61.97;0.98
111340;326201;Szkoła Podstawowa Nr 48|Szczecin|ul. Czorsztyńska 35 |71-201 Szczecin;2411;1512;1512;14;1498;62.71;0.93
111341;326201;Zespół Szkół Ogólnokształcących Nr 4|Szczecin|ul. Romera 2 |71-246 Szczecin;1849;1201;1201;8;1193;64.95;0.67
111342;326201;Zespół Szkół Samochodowych|Szczecin|ul. Klonowica 14 (dawny internat) |71-244 Szczecin;1048;538;538;9;529;51.34;1.67
111343;326201;Przedszkole Publiczne Nr 58|Szczecin|ul. Benesza 26 |71-241 Szczecin;1607;990;990;31;959;61.61;3.13
111344;326201;Szkoła Podstawowa Nr 45 z Oddziałami Integracyjnymi,|Szczecin|ul. Benesza 75 |71-246 Szczecin;1958;1224;1224;19;1205;62.51;1.55
111345;326201;Szkoła Podstawowa Nr 45 z Oddziałami Integracyjnymi|Szczecin|ul. Benesza 75 |71-246 Szczecin;1914;1109;1109;18;1091;57.94;1.62
111346;326201;Tramwaje Szczecińskie Sp.z.o.o. (budynek Zarządu)|Szczecin|ul. Klonowica 5 |71-241 Szczecin;2062;1235;1235;17;1218;59.89;1.38
111347;326201;Szkoła Podstawowa Nr 53|Szczecin|ul. Budzysza Wosia 8-9 |71-273 Szczecin;957;453;453;3;450;47.34;0.66
111348;326201;ZBILK Rejon 15|Szczecin|ul. Goszczyńskiego 4a |71-263 Szczecin;1713;857;857;20;837;50.03;2.33
111349;326201;Zespół Szkół Samochodowych|Szczecin|ul. Klonowica 14 |71-244 Szczecin;1463;832;832;13;819;56.87;1.56
111350;326201;Gimnazjum Nr 1|Szczecin|ul. Reymonta 23 |71-274 Szczecin;1453;957;957;15;942;65.86;1.57
111351;326201;Uniwersytet Szczeciński Wydział Nauk Ekonomicznych i Zarządzania|Szczecin|ul. Mickiewicza 64 |71-101 Szczecin;1463;852;852;4;848;58.24;0.47
111352;326201;Miejska Biblioteka Publiczna Filia Nr 17|Szczecin|ul. Łukasiewicza 8 |71-302 Szczecin;1593;975;975;12;963;61.21;1.23
111353;326201;Liceum Ogólnokształcące z Oddziałami Integracyjnymi|Szczecin|Aleja Wojska Polskiego 119 |70-490 Szczecin;1520;944;944;6;938;62.11;0.64
111354;326201;Liceum Ogólnokształcące z Oddziałami Integracyjnymi|Szczecin|Aleja Wojska Polskiego 119 |70-490 Szczecin;1227;630;630;4;626;51.34;0.63
111355;326201;Rada Osiedla Pogodno|Szczecin|ul. Krasickiego 6 |71-333 Szczecin;1749;1167;1167;10;1157;66.72;0.86
111356;326201;Publiczna Szkoła Podstawowa "Na Głębokim"|Szczecin|ul. Jaworowa 41 |71-382 Szczecin;970;640;640;4;636;65.98;0.62
111357;326201;Szkoła Podstawowa Nr 68|Szczecin|ul. Zakole 1a |70-454 Szczecin;2206;1367;1367;20;1347;61.97;1.46
111358;326201;Szkoła Podstawowa Nr 68|Szczecin|ul. Zakole 1a |71-454 Szczecin;1850;1180;1180;12;1168;63.78;1.02
111359;326201;Dom Akademicki Andromeda|Szczecin|ul. Chopina 59 |71-450 Szczecin;1871;956;956;15;941;51.10;1.57
111360;326201;Gimnazjum Nr 34|Szczecin|ul. Wojciechowskiego 50 |71-476 Szczecin;1928;1062;1062;10;1052;55.08;0.94
111361;326201;Gimnazjum Nr 34|Szczecin|ul. Wojciechowskiego 50 |71-476 Szczecin;1433;945;945;5;940;65.95;0.53
111362;326201;Zespół Szkół Elektr.-Elektronicznych|Szczecin|ul. Racibora 60 |71-631 Szczecin;928;423;423;10;413;45.58;2.36
111363;326201;Zespół Szkół Nr 16|Szczecin|ul. Dubois 41 |71-610 Szczecin;1846;847;847;12;835;45.88;1.42
111364;326201;Zespół Szkół Nr 16|Szczecin|ul. Emilii Plater 20 |71-632 Szczecin;2084;940;940;14;926;45.11;1.49
111365;326201;Przedszkole Publiczne Nr 73|Szczecin|ul. Ceglana 4 |71-636 Szczecin;1718;1033;1033;9;1024;60.13;0.87
111366;326201;Zespół Szkół Nr 16|Szczecin|ul. Dubois 38/41 |71-610 Szczecin;2347;1101;1101;14;1087;46.91;1.27
111367;326201;Zakład Energetyczny|Szczecin|ul. Malczewskiego 5/7 |71-616 Szczecin;2253;1170;1170;19;1151;51.93;1.62
111368;326201;Filia Przedszkola Publicznego Nr 50|Szczecin|ul. Junacka 13 |70-457 Szczecin;2429;1642;1642;21;1621;67.60;1.28
111369;326201;Przychodnia Zdrowia|Szczecin|ul. Łucznicza 64 |71-504 Szczecin;1303;774;774;12;762;59.40;1.55
111370;326201;Przychodnia Zdrowia|Szczecin|ul. Łucznicza 64 |71-504 Szczecin;1720;954;954;18;936;55.47;1.89
111371;326201;Rada Osiedla Warszewo|Szczecin|ul. Szczecińska 12 |71-786 Szczecin;1445;885;885;6;879;61.25;0.68
111372;326201;Sala Gimnastyczna|Szczecin|ul. Szczecińska 12 |71-786 Szczecin;2195;1590;1590;9;1581;72.44;0.57
111373;326201;Szkoła Podstawowa Nr 7|Szczecin|ul. Złotowska 86 |71-795 Szczecin;1994;1370;1370;6;1364;68.71;0.44
111374;326201;Szkoła Podstawowa Nr 7|Szczecin|ul. Złotowska 86 |71-793 Szczecin;2284;1583;1583;14;1569;69.31;0.88
111375;326201;Szkoła Podstawowa Nr 35|Szczecin|ul. Świętoborzyców 40 Blok A1 (Aula) |71-665 Szczecin;2012;1228;1228;23;1205;61.03;1.87
111376;326201;Szkoła Podstawowa Nr 35|Szczecin|ul. Świętoborzyców 40 Hala sportowa |71-665 Szczecin;2404;1505;1505;8;1497;62.60;0.53
111377;326201;Przedszkole Publiczne Nr 59|Szczecin|ul. Księżnej Zofii 3 |71-665 Szczecin;2063;1235;1235;14;1221;59.86;1.13
111378;326201;Przedszkole Publiczne Nr 59|Szczecin|ul. Księżnej Zofii 3 |71-665 Szczecin;1381;860;860;13;847;62.27;1.51
111379;326201;Przedszkole Publiczne Nr 14|Szczecin|ul. Biskupa Bandurskiego 56 |71-665 Szczecin;2393;1448;1448;9;1439;60.51;0.62
111380;326201;Gimnazjum Nr 5|Szczecin|ul. Komuny Paryskiej 20 |71-681 Szczecin;1812;905;905;24;881;49.94;2.65
111381;326201;Gimnazjum Nr 5|Szczecin|ul. Komuny Paryskiej 20 |71-681 Szczecin;1457;781;781;8;773;53.60;1.02
111382;326201;Szkoła Podstawowa Nr 18|Szczecin|ul. Komuny Paryskiej 20 |71-681 Szczecin;1815;920;920;16;904;50.69;1.74
111383;326201;Szkoła Podstawowa Nr 18|Szczecin|ul. Komuny Paryskiej 20 |71-681 Szczecin;2093;1078;1078;18;1060;51.51;1.67
111384;326201;Szkoła Podstawowa Nr 42|Szczecin|ul. Hoża 25 |71-699 Szczecin;2694;1589;1595;25;1564;58.98;1.57
111385;326201;Dom Pomocy Społecznej - Dom Kombatanta|Szczecin|ul. Krucza 17 |71-747 Szczecin;2019;1282;1282;14;1268;63.50;1.09
111386;326201;Ośrodek Szkolno-Wychowawczy dla Dzieci Słaboszłyszących|Szczecin|ul. Grzymińska 6 |71-711 Szczecin;1771;949;949;11;938;53.59;1.16
111387;326201;Zespół Szkół Nr 5|Szczecin|ul. Hoża 3 |71-711 Szczecin;1105;489;489;12;477;44.25;2.45
111388;326201;Tramwaje Szczecińskie Sp. z o. o|Szczecin|ul. Wiszesława 18 |71-751 Szczecin;823;328;328;9;319;39.85;2.74
111389;326201;Szkoła Podstawowa Nr 14|Szczecin|ul. Strzałowska 27a |71-730 Szczecin;768;314;314;6;308;40.89;1.91
111390;326201;Bursa Szkolna Nr 2 w ZSO|Szczecin|ul. Pokoju 48 |71-736 Szczecin;1490;894;894;8;886;60.00;0.89
111391;326201;Bursa Szkolna Nr 2 w ZSO|Szczecin|ul. Pokoju 48 |71-736 Szczecin;2197;1416;1416;12;1404;64.45;0.85
111392;326201;Środowiskowa Placówka Eduk.- Wych. Nr 1|Szczecin|ul. Koszalińska 13 |71-735 Szczecin;962;335;335;15;320;34.82;4.48
111393;326201;Zespół Szkół Nr 9|Szczecin|ul. Dąbrówki 10 |71-834 Szczecin;1922;811;811;7;804;42.20;0.86
111394;326201;Miejska Biblioteka Publiczna. Filia Nr 46|Szczecin|ul. Nad Odrą 26 |71-302 Szczecin;1327;406;406;21;385;30.60;5.17
111395;326201;Dom Kultury "Klub Skolwin"|Szczecin|ul. Stołczyńska 163 |71-870 Szczecin;1316;517;517;9;508;39.29;1.74
111396;326201;Młodzieżowy Ośrodek Wychowawczy|Szczecin|ul. Kamienna 22 |71-833 Szczecin;1165;545;545;9;536;46.78;1.65
111397;326201;S.P. Wojewódzki Szpital Zespolony|Szczecin|ul. Arkońska 4 |71-455 Szczecin;294;162;162;3;159;55.10;1.85
111398;326201;Dom Pomocy Społecznej|Szczecin|ul. Broniewskiego 4/6 |71-460 Szczecin;29;28;28;7;21;96.55;25.00
111399;326201;Specjalistyczny Szpital im. Profesora A. Sokołowskiego|Szczecin|ul. Sokołowskiego 11 |70-880 Szczecin;244;148;148;11;137;60.66;7.43
111400;326201;S.P. Specjalistyczny Zakład Opieki Zdrowotnej "Zdroje"|Szczecin|ul. Mączna 4 |70-780 Szczecin;64;43;43;4;39;67.19;9.30
111401;326201;S.P. Szpital Kliniczny Nr 2|Szczecin|ul. Powstańców Wielkopolskich 72 |70-111 Szczecin;140;81;81;5;76;57.86;6.17
111402;326201;S.P. Zakłed Opieki Zdrowotnej MSW|Szczecin|ul. Jagiellońska 44 |70-382 Szczecin;49;26;26;0;26;53.06;0.00
111403;326201;S.P. Szpital Kliniczny Nr 1|Szczecin|ul. Unii Lubelskiej 1 |71-252 Szczecin;104;73;73;2;71;70.19;2.74
111404;326201;S.P. Szpital Kliniczny Nr 1 Klinika Psychiatrii PUM|Szczecin|ul. Broniewskiego 26 |71-460 Szczecin;19;19;19;1;18;100.00;5.26
111405;326201;Dom Pomocy Społecznej "Dom Kombatanta i Pioniera Ziemi Szczecińskiej"|Szczecin|ul. Romera 21-29 |71-246 Szczecin;198;92;92;15;77;46.46;16.30
111406;326201;Zachodniopomorskie Centrum Onkologii|Szczecin|ul. Strzałowska 22 |71-740 Szczecin;141;90;90;9;81;63.83;10.00
111407;326201;Dom Pomocy Społecznej "Dom Kombatanta"|Szczecin|ul. Krucza 17 |71-747 Szczecin;206;85;85;6;79;41.26;7.06
111408;326201;Areszt Śledczy|Szczecin|ul. Kaszubska 28 |70-226 Szczecin;421;265;265;38;227;62.95;14.34
111409;326201;109 Szpital Wojskowy z Przychodnią S.P. Zakład Opieki Zdrowotnej|Szczecin|ul. Skargi 9-11 |71-422 Szczecin;88;63;63;1;62;71.59;1.59
111410;326201;Dom Pomocy Społecznej im. doktora Edmunda Wojtyły|Szczecin|ul. Lubomirskiego 7 |71-505 Szczecin;71;35;35;1;34;49.30;2.86
111411;326301;"HOSSA" Centrum Edukacji i Wspierania Przedsiębiorczości Szczecińskiej Fundacji "Talent-Promocja-Postęp"|Świnoujście|ul. J. Kasprowicza 4 |72-600 Świnoujście;937;710;710;5;705;75.77;0.70
111412;326301;Miejski Dom Kultury Galeria "ART"|Świnoujście|ul. Wojska Polskiego 1 1|72-600 Świnoujście;1940;1083;1083;9;1074;55.82;0.83
111413;326301;Szkoła Podstawowa Nr 1|Świnoujście|ul. G. Narutowicza 10 |72-600 Świnoujście;1200;584;584;16;568;48.67;2.74
111414;326301;Katolickie Liceum Ogólnokształcące|Świnoujście|ul. S. Wyspiańskiego 12 |72-600 Świnoujście;1147;607;607;12;595;52.92;1.98
111415;326301;Specjalny Ośrodek Szkolno-Wychowawczy|Świnoujście|ul. Piastowska 55 |72-600 Świnoujście;1426;735;735;16;719;51.54;2.18
111416;326301;Zespół Szkół Ogólnokształcących|Świnoujście|ul. W. Witosa 12 |72-600 Świnoujście;1660;752;752;15;737;45.30;1.99
111417;326301;Zespół Szkół Publicznych Nr 4|Świnoujście|ul. Szkolna 1 |72-600 Świnoujście;1511;839;839;8;831;55.53;0.95
111418;326301;Zespół Szkół Publicznych Nr 4|Świnoujście|ul. Szkolna 1 |72-600 Świnoujście;1597;837;837;16;821;52.41;1.91
111419;326301;Centrum Edukacji Zawodowej i Turystyki|Świnoujście|ul. Gdyńska 26 |72-600 Świnoujście;1760;921;921;9;912;52.33;0.98
111420;326301;Budynek użytkowy Zakładu Gospodarki Mieszkaniowej - były internat|Świnoujście|ul. Piastowska 62 |72-600 Świnoujście;957;422;422;9;413;44.10;2.13
111421;326301;Liceum Ogólnokształcące im. Mieszka I|Świnoujście|ul. M. Niedziałkowskiego 2 |72-600 Świnoujście;1252;620;620;13;607;49.52;2.10
111422;326301;Gimnazjum Publiczne Nr 2|Świnoujście|ul. T. Kościuszki 11 |72-600 Świnoujście;1786;972;972;14;958;54.42;1.44
111423;326301;Gimnazjum Publiczne Nr 2|Świnoujście|ul. T. Kościuszki 11 |72-600 Świnoujście;1500;731;731;13;718;48.73;1.78
111424;326301;Szkoła Podstawowa Nr 6|Świnoujście|ul. S. Staszica 17 |72-600 Świnoujście;1712;826;826;21;805;48.25;2.54
111425;326301;Dom Kultury S. M. L. - W. Słowianin|Świnoujście|ul. J. Matejki 43 |72-600 Świnoujście;1629;901;901;17;884;55.31;1.89
111426;326301;Szkoła Podstawowa Nr 6|Świnoujście|ul. S. Staszica 17 |72-600 Świnoujście;1720;812;812;20;792;47.21;2.46
111427;326301;I Liceum Społeczne Fundacji "Logos"|Świnoujście|ul. Grunwaldzka 47 |72-600 Świnoujście;1672;739;739;29;710;44.20;3.92
111428;326301;Biuro Informacji Turystycznej|Świnoujście|Plac Słowiański 6 1|72-600 Świnoujście;1347;615;615;13;602;45.66;2.11
111429;326301;Muzeum Rybołówstwa Morskiego|Świnoujście|Plac Rybaka 1 |72-600 Świnoujście;1498;804;804;10;794;53.67;1.24
111430;326301;Kapitanat Portu|Świnoujście|ul. Wybrzeże Władysława IV 7 |72-600 Świnoujście;1013;503;503;7;496;49.65;1.39
111431;326301;Szkoła Podstawowa Nr 2|Świnoujście, Warszów|ul. Białoruska 2 |72-602 Świnoujście;1414;577;577;13;564;40.81;2.25
111432;326301;Miejski Dom Kultury Filia Nr 2|Świnoujście, Warszów|ul. Sosnowa 18 |72-602 Świnoujście;1070;460;460;7;453;42.99;1.52
111433;326301;Miejski Dom Kultury Filia Nr 3|Świnoujście, Karsibór|ul. 1 Maja 40 |72-603 Świnoujście;566;272;272;9;263;48.06;3.31
111434;326301;Miejski Dom Kultury Filia Nr 1|Świnoujście, Przytór|ul. Zalewowa 40 |72-605 Świnoujście;963;543;543;9;534;56.39;1.66
111435;326301;Szpital Miejski im. Jana Garduły|Świnoujście|ul. Mieszka I 7 |72-600 Świnoujście;71;21;21;0;21;29.58;0.00
111436;326301;Samodzielny Publiczny Zakład Opieki Zdrowotnej Zakład Pielęgnacyjno - Opiekuńczy|Świnoujście|ul. Żeromskiego 21 |72-600 Świnoujście;31;1;1;0;1;3.23;0.00
111437;326301;Areszt Śledczy|Świnoujscie|ul. Marszałka J. Piłsudskiego 25a |72-600 Świnoujście;43;21;21;3;18;48.84;14.29
83579;020101;Miejskie Przedszkole Publiczne Nr 3|Bolesławiec|ul. Ceramiczna 5 |59-700 Bolesławiec;1549;732;732;10;722;47.26;1.37
83580;020101;Szkoła Podstawowa Nr 3|Bolesławiec|ul. Ceramiczna 5 |59-700 Bolesławiec;1383;764;764;10;754;55.24;1.31
83581;020101;Miejski Zespół Szkół Nr 1|Bolesławiec|ul. Dolne Młyny 60 |59-700 Bolesławiec;1483;762;762;12;750;51.38;1.57
83582;020101;Miejski Zespół Szkół Nr 1|Bolesławiec|ul. Dolne Młyny 60 |59-700 Bolesławiec;1542;788;788;23;765;51.10;2.92
83583;020101;Miejski Zespół Szkół Nr 1|Bolesławiec|ul. Dolne Młyny 60 |59-700 Bolesławiec;1485;738;738;20;718;49.70;2.71
83584;020101;Miejski Zespół Szkół Nr 3|Bolesławiec|ul. Juliusza Słowackiego 2 |59-700 Bolesławiec;1493;569;571;22;547;38.11;3.87
83585;020101;Miejski Zespół Szkół Nr 2|Bolesławiec|ul. Jana Pawła II 38c |59-700 Bolesławiec;1474;820;820;14;806;55.63;1.71
83586;020101;Miejski Zespół Szkół Nr 2|Bolesławiec|ul. Jana Pawła II 38c |59-700 Bolesławiec;1447;824;824;19;805;56.95;2.31
83587;020101;Miejskie Przedszkole Publiczne Nr 6|Bolesławiec|ul. Piotra i Pawła 2 |59-700 Bolesławiec;1487;730;730;17;713;49.09;2.33
83588;020101;Gimnazjum Samorządowe Nr 2|Bolesławiec|ul. Bielska 5 |59-700 Bolesławiec;1547;870;870;7;863;56.24;0.80
83589;020101;Miejskie Przedszkole Publiczne Nr 5|Bolesławiec|ul. Zygmunta Augusta 16b |59-700 Bolesławiec;1530;819;819;11;808;53.53;1.34
83590;020101;Centrum Wspierania Przedsiębiorczości|Bolesławiec|Aleja Wojska Polskiego 6 /1A|59-700 Bolesławiec;1421;772;772;19;753;54.33;2.46
83591;020101;Gimnazjum Samorządowe Nr 2|Bolesławiec|ul. Bielska 5 |59-700 Bolesławiec;1530;705;705;12;693;46.08;1.70
83592;020101;Miejskie Przedszkole Publiczne Nr 2|Bolesławiec|ul. Mikołaja Brody 17 |59-700 Bolesławiec;1534;826;826;20;806;53.85;2.42
83593;020101;Miejskie Przedszkole Publiczne Nr 7|Bolesławiec|ul. Górne Młyny 5 |59-700 Bolesławiec;1438;600;600;20;580;41.72;3.33
83594;020101;Miejskie Przedszkole Publiczne Nr 7|Bolesławiec|ul. Górne Młyny 5 |59-700 Bolesławiec;1420;644;644;17;627;45.35;2.64
83595;020101;Pałac Ślubów|Bolesławiec|Ratusz - Rynek 41 |59-700 Bolesławiec;1439;605;605;15;590;42.04;2.48
83596;020101;Szkoła Podstawowa Nr 4|Bolesławiec|ul. Mikołaja Brody 12 |59-700 Bolesławiec;1387;588;588;22;566;42.39;3.74
83597;020101;Szkoła Podstawowa Nr 4|Bolesławiec|ul. Mikołaja Brody 12 |59-700 Bolesławiec;1510;705;705;22;683;46.69;3.12
83598;020101;Gimnazjum Samorządowe Nr 2|Bolesławiec|ul. Bielska 5 |59-700 Bolesławiec;1443;761;761;17;744;52.74;2.23
83599;020101;Miejski Zespół Szkół Nr 3|Bolesławiec|ul. Juliusza Słowackiego 2 |59-700 Bolesławiec;1432;638;638;13;625;44.55;2.04
83600;020101;Zespół Opieki Zdrowotnej w Bolesławcu (Szpital Powiatowy)|Bolesławiec|ul. Jeleniogórska 4 |59-700 Bolesławiec;53;12;12;0;12;22.64;0.00
83601;020101;Wojewódzki Szpital dla Nerwowo i Psychicznie Chorych|Bolesławiec|Aleja Tysiąclecia 30 |59-700 Bolesławiec;319;66;66;14;52;20.69;21.21
83602;020101;Dom Pomocy Społecznej|Bolesławiec|ul. Piastów 17 |59-700 Bolesławiec;42;25;25;2;23;59.52;8.00
83603;020102;Dom Ludowy|Żeliszów| 102A |59-700 Bolesławiec;857;349;349;14;335;40.72;4.01
83604;020102;Zespół Szkolno-Przedszkolny|Bożejowice| 1 |59-700 Bolesławiec;824;430;430;11;419;52.18;2.56
83605;020102;Dom Ludowy|Otok| 44C |59-700 Bolesławiec;729;279;279;5;274;38.27;1.79
83606;020102;Dom Ludowy|Brzeźnik| 37 |59-700 Bolesławiec;657;280;280;17;263;42.62;6.07
83607;020102;Dom Ludowy|Dobra| 94 |59-700 Bolesławiec;806;356;356;8;348;44.17;2.25
83608;020102;Szkoła Podstawowa|Dąbrowa Bolesławiecka| 43 |59-700 Bolesławiec;1340;563;563;19;544;42.01;3.37
83609;020102;Dom Ludowy|Trzebień|ul. Lipowa 5 |59-700 Bolesławiec;1219;420;420;17;403;34.45;4.05
83610;020102;Dom Ludowy|Kraśnik Dolny| 24C |59-700 Bolesławiec;1444;577;577;14;563;39.96;2.43
83611;020102;Centrum Administracyjno-Kulturalne|Kruszyn|ul. Kasztanowa 1B |59-700 Bolesławiec;1352;672;672;11;661;49.70;1.64
83612;020102;Dom Ludowy|Łaziska| 30A |59-700 Bolesławiec;933;429;429;19;410;45.98;4.43
83613;020102;Dom Ludowy|Ocice| 54B |59-730 Nowogrodziec;792;360;360;19;341;45.45;5.28
83614;020103;Zespół Szkół w Gromadce|Gromadka|ul. gen. W. Sikorskiego 19 |59-706 Gromadka;1823;790;790;50;740;43.34;6.33
83615;020103;Świetlica wiejska w Wierzbowej|Wierzbowa| 57A |59-706 Gromadka;892;349;349;20;329;39.13;5.73
83616;020103;Świetlica wiejska w Różyńcu|Różyniec| 41B |59-706 Gromadka;1231;498;498;25;473;40.45;5.02
83617;020103;Szkoła Podstawowa w Modle|Modła| 76 |59-706 Gromadka;563;229;229;12;217;40.67;5.24
83618;020104;Szkoła Podstawowa w Czernej|Czerna| 52 |59-730 Nowogrodziec;839;292;292;18;274;34.80;6.16
83619;020104;Szkoła Podstawowa w Gierałtowie|Gierałtów| 47 |59-730 Nowogrodziec;848;275;275;16;259;32.43;5.82
83620;020104;Budynek byłej Szkoły Podstawowej w Godzieszowie|Godzieszów| 96 |59-730 Nowogrodziec;532;165;165;13;152;31.02;7.88
83621;020104;Szkoła Podstawowa w Gościszowie|Gościszów| 152 |59-730 Nowogrodziec;1130;360;360;19;341;31.86;5.28
83622;020104;Była remiza OSP w Milikowie|Milików| 142 |59-730 Nowogrodziec;973;307;307;25;282;31.55;8.14
83623;020104;Zespół Szkół w Nowej Wsi|Nowa Wieś| 26a |59-730 Nowogrodziec;722;255;255;10;245;35.32;3.92
83624;020104;Szkoła Podstawowa w Nowogrodźcu|Nowogrodziec|ul. Sienkiewicza 8 |59-730 Nowogrodziec;1685;688;688;42;646;40.83;6.10
83625;020104;Gminne Centrum Kultury i Sportu w Nowogrodźcu|Nowogrodziec|ul. Lubańska 42a |59-730 Nowogrodziec;1680;614;614;14;600;36.55;2.28
83626;020104;Budynek nr 63 w Parzycach (były Ośrodek Kultury w Parzycach)|Parzyce| 63 |59-730 Nowogrodziec;776;281;281;21;260;36.21;7.47
83627;020104;Świetlica Wiejska w Wykrotach|Wykroty|ul. 22 Lipca 27 |59-730 Nowogrodziec;1525;575;575;23;552;37.70;4.00
83628;020104;Świetlica Wiejska w Zebrzydowej|Zebrzydowa| 52 |59-730 Nowogrodziec;1139;437;437;19;418;38.37;4.35
83629;020104;Samodzielny Publiczny Zespół Zakładów Opieki Zdrowotnej w Nowogrodźcu|Nowogrodziec|ul. Cicha 4 |59-730 Nowogrodziec;66;3;3;1;2;4.55;33.33
83630;020105;Szkoła Podstawowa w Tomisławiu|Tomisław| 63A |59-724 Osiecznica;849;366;366;16;350;43.11;4.37
83631;020105;Gminny Ośrodek Sportu i Rekreacji w Osiecznicy|Osiecznica|ul. Lubańska 29b |59-724 Osiecznica;1282;531;531;16;515;41.42;3.01
83632;020105;Świetlica Wiejska w Przejęsławiu|Przejęsław| 10a |59-724 Osiecznica;450;171;171;9;162;38.00;5.26
83633;020105;Świetlica Wiejska w Ławszowej|Ławszowa| 81 |59-724 Osiecznica;592;213;213;11;202;35.98;5.16
83634;020105;Świetlica Wiejska w Parowej|Parowa| 89A |59-724 Osiecznica;893;286;286;22;264;32.03;7.69
83635;020105;Świetlica Wiejska w Ołoboku|Ołobok| 63 |59-724 Osiecznica;351;76;76;7;69;21.65;9.21
83636;020105;Zespół Szkół w Świętoszowie|Świętoszów|ul. Szkolna 10 |59-726 Świętoszów;1039;493;493;17;476;47.45;3.45
83637;020106;Urząd Gminy|Warta Bolesławiecka| 40C |59-720 Raciborowice Górne;966;417;417;12;405;43.17;2.88
83638;020106;Szkoła Podstawowa im. II Armii Wojska Polskiego|Tomaszów Bolesławiecki| 96 |59-720 Raciborowice Górne;1508;635;635;14;621;42.11;2.20
83639;020106;Świetlica Wiejska|Raciborowice Górne| 196 |59-720 Raciborowice Górne;1092;375;375;18;357;34.34;4.80
83640;020106;Zespół Szkolno-Przedszkolny|Iwiny Osiedle I| 6 |59-720 Raciborowice Górne;1295;550;550;21;529;42.47;3.82
83641;020106;Świetlica Wiejska|Szczytnica| 34A |59-720 Raciborowice Górne;1056;326;326;11;315;30.87;3.37
83642;020106;Świetlica Wiejska|Raciborowice Dolne| 196 |59-720 Raciborowice Górne;788;261;261;11;250;33.12;4.21
83643;020201;Bielawski Inkubator Przedsiębiorczości Sala Konferencyjna|Bielawa|ul. Wolności 24 |58-260 Bielawa;1141;452;452;12;440;39.61;2.65
83644;020201;Gimnazjum Nr 1|Bielawa|ul. Brzeżna 48 |58-260 Bielawa;1397;516;516;23;493;36.94;4.46
83645;020201;Zespół Szkół i Placówek Kształcenia Zawodowego|Bielawa|Stefana Żeromskiego 41 |58-260 Bielawa;1346;567;567;13;554;42.12;2.29
83646;020201;Klub Spółdzielni Mieszkaniowej|Bielawa|Osiedle Włókniarzy 1 |58-260 Bielawa;1406;675;675;19;656;48.01;2.81
83647;020201;Ekologiczna Szkoła Podstawowa Nr7|Bielawa|Osiedle Włókniarzy 10 |58-260 Bielawa;1123;522;522;11;511;46.48;2.11
83648;020201;Gimnazjum nr 2|Bielawa|ul. Parkowa 12 |58-260 Bielawa;1110;524;524;17;507;47.21;3.24
83649;020201;Gimnazjum nr 2|Bielawa|ul. Parkowa 12 |58-260 Bielawa;1401;665;665;20;645;47.47;3.01
83650;020201;Żłobek Publiczny|Bielawa|ul. Generała Grota Roweckiego 7 |58-260 Bielawa;1251;631;631;14;617;50.44;2.22
83651;020201;Ekologiczne Przedszkole Niepubliczne|Bielawa|ul. Parkowa 11 |58-260 Bielawa;1214;597;597;15;582;49.18;2.51
83652;020201;Klub "Sowa" Spółdzielni Mieszkaniowej|Bielawa|ul. Jana III Sobieskiego 17 |58-260 Bielawa;1141;592;592;18;574;51.88;3.04
83653;020201;Szkoła Podstawowa Nr 10|Bielawa|ul. Generała Grota Roweckiego 6 |58-260 Bielawa;1116;517;517;17;500;46.33;3.29
83654;020201;Szkoła Podstawowa Nr 10|Bielawa|ul. Generała Grota Roweckiego 6 |58-260 Bielawa;1116;548;548;14;534;49.10;2.55
83655;020201;Ośrodek Pomocy Społecznej|Bielawa|ul. 3 Maja 20 |58-260 Bielawa;1024;393;393;15;378;38.38;3.82
83656;020201;Zespół Szkół Ogólnokształcących|Bielawa|ul. Szkolna 5 |58-260 Bielawa;1250;666;666;16;650;53.28;2.40
83657;020201;Miejski Zarząd Budynków Mieszkalnych Sp. z o.o.|Bielawa|ul. 3 Maja 48 |58-260 Bielawa;1246;525;525;16;509;42.13;3.05
83658;020201;Gimnazjum Ekologiczne Nr 3 z Oddziałami Integracyjnymi|Bielawa|ul. Lotnicza 5 |58-260 Bielawa;1049;422;422;19;403;40.23;4.50
83659;020201;Szkoła Podstawowa nr 4|Bielawa|ul. Ludowa 11 |58-260 Bielawa;1037;315;315;19;296;30.38;6.03
83660;020201;Szkoła Podstawowa nr 4|Bielawa|ul. Ludowa 11 |58-260 Bielawa;1226;431;431;20;411;35.15;4.64
83661;020201;Zespół Szkół Cechu Rzemiosł Różnych Zasadnicza Szkoła Zawodowa Cechu Rzemiosł Różnych i Małej Przedsiębiorczości|Bielawa|ul. Polna 2 |58-260 Bielawa;1225;502;502;22;480;40.98;4.38
83662;020201;Szkoła Podstawowa nr 4|Bielawa|ul. Ludwika Waryńskiego 50 |58-260 Bielawa;1242;568;568;10;558;45.73;1.76
83663;020201;Szkoła Podstawowa nr 4|Bielawa|ul. Ludwika Waryńskiego 50 |58-260 Bielawa;939;341;341;20;321;36.32;5.87
83664;020201;Dom Pomocy Społecznej|Bielawa|Stefana Żeromskiego 2 |58-260 ;42;9;9;3;6;21.43;33.33
83665;020202;Dzienny Dom Pomocy Społecznej|Dzierżoniów|ul. I. Krasickiego 25 |58-200 Dzierżoniów;1339;546;546;16;530;40.78;2.93
83666;020202;Zespół Szkół Ogólnokształcących I L.O.|Dzierżoniów|ul. Piłsudskiego 10 |58-200 Dzierżoniów;1279;470;470;23;447;36.75;4.89
83667;020202;Dzierżoniowski Ośrodek Kultury|Dzierżoniów|ul. Świdnicka 23 |58-200 Dzierżoniów;1362;555;555;21;534;40.75;3.78
83668;020202;Szkoła Podstawowa Nr 3|Dzierżoniów|ul. Szkolna 24 |58-200 Dzierżoniów;1407;589;589;9;580;41.86;1.53
83669;020202;Przedszkole Niepubliczne "Słoneczna Piątka"|Dzierżoniów|ul. Świdnicka 41 |58-200 Dzierżoniów;1382;679;679;14;665;49.13;2.06
83670;020202;Szkoła Podstawowa Nr 6|Dzierżoniów|Os. Jasne 22 |58-200 Dzierżoniów;1109;565;637;5;560;50.95;0.88
83671;020202;Przedszkole Publiczne Nr 7|Dzierżoniów|Os. Tęczowe 3 |58-200 Dzierżoniów;1546;868;868;16;852;56.14;1.84
83672;020202;Ośrodek Pomocy Społecznej|Dzierżoniów|ul. Złota 8 |58-200 Dzierżoniów;1143;574;574;9;565;50.22;1.57
83673;020202;Szkoła Podstawowa Nr 5 z Oddziałami Integracyjnymi|Dzierżoniów|Os.Błękitne 25 |58-200 Dzierżoniów;1119;619;619;13;606;55.32;2.10
83674;020202;Szkoła Podstawowa Nr 5 z Oddziałami Integracyjnymi|Dzierżoniów|Os. Błękitne 25 |58-200 Dzierżoniów;1365;726;726;11;715;53.19;1.52
83675;020202;Przedszkole Niepubliczne Nr 3 "Pod Topolą"|Dzierżoniów|Os. Błękitne 26 |58-200 Dzierżoniów;1284;679;679;9;670;52.88;1.33
83676;020202;Przedszkole Niepubliczne Nr 4|Dzierżoniów|Os. Jasne 21 |58-200 Dzierżoniów;1172;686;686;12;674;58.53;1.75
83677;020202;Zespół Gimnazjów Nr 3|Dzierżoniów|ul. Sikorskiego 2 |58-200 Dzierżoniów;1200;608;608;5;603;50.67;0.82
83678;020202;Filia Miejsko-Powiatowej Biblioteki Publicznej im. K.K.Baczyńskiego|Dzierżoniów|ul. Sikorskiego 2 |58-200 Dzierżoniów;1262;684;684;13;671;54.20;1.90
83679;020202;Pracownicze Ogródki Działkowe "Jar"|Dzierżoniów|ul. Złota 10 |58-200 Dzierżoniów;1181;764;764;9;755;64.69;1.18
83680;020202;Zespół Szkół Sióstr Salezjanek|Dzierżoniów|ul. Wrocławska 51 |58-200 Dzierżoniów;1276;758;758;12;746;59.40;1.58
83681;020202;Gimnazjum Gminne|Dzierżoniów|ul. Ząbkowicka 70 |58-200 Dzierżoniów;1319;616;616;12;604;46.70;1.95
83682;020202;Instytucja Wspierająca Przedsiebiorczość (były biurowiec Silesiany)|Dzierżoniów|ul. Batalionów Chłopskich 19 |58-200 Dzierżoniów;1416;711;711;22;689;50.21;3.09
83683;020202;Przedszkole Publiczne Nr 1|Dzierżoniów|ul. Batalionów Chłopskich 20 |58-200 Dzierżoniów;1377;730;730;6;724;53.01;0.82
83684;020202;Wodociagi i Kanalizacja|Dzierżoniów|ul. Zielona 5 |58-200 Dzierżoniów;1418;517;517;12;505;36.46;2.32
83685;020202;Gimnazjum Nr 1 z Oddziałami Integracyjnymi|Dzierżoniów|ul. Nowowiejska 64 |58-200 Dzierżoniów;1375;451;451;15;436;32.80;3.33
83686;020202;Areszt Śledczy|Dzierżoniów|Ząbkowicka 53 |58-200 Dzierżoniów;192;127;127;25;102;66.15;19.69
83687;020202;Niepubliczny Zakład Opieki Zdrowotnej Szpital Powiatowy Spólka z o.o|Dzierżoniów|Cicha 1 |58-200 Dzierżoniów;84;25;25;0;25;29.76;0.00
83688;020203;Niepubliczna Szkoła Podstawowa-Nauczyciele dzieciom|Pieszyce|ul. Świdnicka 53 |58-250 Pieszyce;1016;423;423;14;409;41.63;3.31
83689;020203;Zespół Szkół im Ks.Dzierżonia|Pieszyce|ul. Mickiewicza 1 |58-250 Pieszyce;2004;702;702;26;676;35.03;3.70
83690;020203;Szkoła Podstawowa Nr 1|Pieszyce|ul. Ogrodowa 23 |58-250 Pieszyce;1482;707;707;20;687;47.71;2.83
83691;020203;Szkoła Podstawowa Nr 1-budynek Nr 2|Pieszyce|ul. Kopernika 124 |58-250 Pieszyce;1407;556;556;38;518;39.52;6.83
83692;020203;Sala Sołecka|Pieszyce|Kamionki 60 |58-250 Pieszyce;429;203;203;7;196;47.32;3.45
83693;020203;Sala Sołecka|Pieszyce|Piskorzów 48d |58-250 Pieszyce;678;322;322;10;312;47.49;3.11
83694;020203;Sala Sołecka|Pieszyce|Rościszów 45 |58-250 Pieszyce;597;254;254;13;241;42.55;5.12
83695;020203;Specjalistyczny Szpital Chorób Płuc|Pieszyce|Rościszów 11 |58-250 Pieszyce;57;16;16;0;16;28.07;0.00
83696;020204;Gimnazjum|Piława Górna|ul. Wiejska 2 |58-240 Piława Górna;1692;690;690;22;668;40.78;3.19
83697;020204;Szkoła Podstawowa|Piława Górna|ul. Kościuszki 1 |58-240 Piława Górna;1901;772;772;20;752;40.61;2.59
83698;020204;Świetlica Ochotniczej Straży Pożarnej|Piława Górna|ul. Limanowskiego 3 |58-240 Piława Górna;1686;699;699;38;661;41.46;5.44
83699;020205;Centrum Biblioteczno-Kulturalne|Mościsko|Kolejowa 12B |58-116 Mościsko;613;229;229;5;224;37.36;2.18
83700;020205;Centrum Biblioteczno-Kulturalne|Mościsko|Kolejowa 12B |58-116 Mościsko;569;257;257;14;243;45.17;5.45
83701;020205;Sala Integracji Społecznej|Włóki| 87 |58-207 Tuszyn;422;208;208;7;201;49.29;3.37
83702;020205;Szkoła Podstawowa im.Jana Pawła II|Tuszyn| 47 |58-207 Tuszyn;539;225;225;9;216;41.74;4.00
83703;020205;Park wiejski z infrastrukturą sportowo-rekreacyjną|Książnica| 5A |58-207 Tuszyn;432;186;186;7;179;43.06;3.76
83704;020205;Lokal gminny po byłej szkole|Uciechów|Piastowska 1 |58-211 Uciechów;852;400;400;22;378;46.95;5.50
83705;020205;Centrum Kulturalno-Sportowo-Oświatowe|Dobrocin|Kościuszki 14A |58-200 Dzierżoniów;543;188;188;9;179;34.62;4.79
83706;020205;Budynek wielofunkcyjny|Roztocznik| 41A |58-217 Gilów;394;167;167;14;153;42.39;8.38
83707;020205;Zespół Szkolno-Przedszkolny|Piława Dolna|Główna 50 |58-241 Piława Dolna;1252;584;584;22;562;46.65;3.77
83708;020205;Świetlica wiejska|Owiesno| 88 |58-262 Ostroszowice;515;197;197;15;182;38.25;7.61
83709;020205;Zespół Szkolno- Przedszkolny|Ostroszowice|Bielawska 58 |58-262 Ostroszowice;1062;457;457;16;441;43.03;3.50
83710;020205;Domek Myśliwski|Jodłownik| 40 |58-262 Ostroszowice;357;186;186;2;184;52.10;1.08
83711;020205;Biuro Wychowawcy|Piława Dolna|Błotnista 12 |58-241 Piława Dolna;116;72;72;11;61;62.07;15.28
83712;020206;Wiejska Świetlica Środowiskowa|Jaźwina| 75a |58-212 Jaźwina;894;364;364;21;343;40.72;5.77
83713;020206;Świetlica Wiejska|Ligota Wielka| 57 |58-210 Łagiewniki;928;400;400;20;380;43.10;5.00
83714;020206;Szkoła Podstawowa im. Janusza Korczaka|Oleszna|ul. Ślężna 1 |58-214 Oleszna;1161;488;488;13;475;42.03;2.66
83715;020206;Świetlica Wiejska|Radzików| 56 |58-210 Łagiewniki;568;192;192;6;186;33.80;3.12
83716;020206;Gminny Ośrodek Kultury, Bibliotek i Sportu|Łagiewniki|ul. Wrocławska 1 |58-210 Łagiewniki;1612;672;672;31;641;41.69;4.61
83717;020206;Gimnazjum im. Piastów Śląskich|Łagiewniki|ul. Jedności Narodowej 38 |58-210 Łagiewniki;922;397;397;18;379;43.06;4.53
83718;020207;Zespół Szkół|Niemcza|ul.Bolesława Chrobrego 25 |58-230 Niemcza;874;383;383;11;372;43.82;2.87
83719;020207;Niemczański Ośrodek Kultury|Niemcza|ul.Rynek 32 |58-230 Niemcza;707;260;260;9;251;36.78;3.46
83720;020207;Dom Pomocy Społecznej|Niemcza|ul.Świerczewskiego 14-16 |58-230 Niemcza;976;348;348;19;329;35.66;5.46
83721;020207;Niepubliczna Szkoła Podstawowa|Przerzeczyn-Zdrój|ul.Zdrojowa 14 |58-231 Niemcza;972;448;448;18;430;46.09;4.02
83722;020207;Budynek gminny|Wilków Wielki| 26 |58-230 Niemcza;562;216;216;13;203;38.43;6.02
83723;020207;Niepubliczna Szkoła Podstawowa|Gilów| 49 |58-217 Niemcza;659;281;281;7;274;42.64;2.49
83724;020301;Państwowa Wyższa Szkoła Zawodowa|Głogów|ul. Piotra Skargi 5 |67-200 Głogów;2193;1251;1251;10;1241;57.05;0.80
83725;020301;Zespół Szkół Politechnicznych|Głogów|Pl. Jana z Głogowa 7 |67-200 Głogów;2118;1076;1076;30;1046;50.80;2.79
83726;020301;Zespół Szkół Ogólnokształcących|Głogów|ul. Jedności Robotniczej 10 |67-200 Głogów;2303;1075;1075;21;1054;46.68;1.95
83727;020301;Szkoła Podstawowa Nr 2|Głogów|Al. Wolności 74 |67-200 Głogów;2141;923;923;36;887;43.11;3.90
83728;020301;Gimnazjum Nr 3 z Oddziałami Integracyjnymi|Głogów|ul. Morcinka 2 |67-200 Głogów;1128;622;622;9;613;55.14;1.45
83729;020301;Miejska Biblioteka Publiczna|Głogów|ul. Jedności Robotniczej 15 |67-200 Głogów;1422;747;747;28;719;52.53;3.75
83730;020301;Przedszkole Publiczne Nr 6|Głogów|ul. Morcinka 6 |67-200 Głogów;1428;706;706;21;685;49.44;2.97
83731;020301;Gimnazjum Nr 3 z Oddziałami Integracyjnymi|Głogów|ul. Morcinka 2 |67-200 Głogów;1180;615;615;14;601;52.12;2.28
83732;020301;Szkoła Podstawowa Nr 6|Głogów|ul. Kościuszki 18 |67-200 Głogów;1129;627;627;10;617;55.54;1.59
83733;020301;Szkoła Podstawowa Nr 12 z Oddziałami Integracyjnymi|Głogów|ul. Gomółki 43 |67-200 Głogów;1296;672;672;13;659;51.85;1.93
83734;020301;Stowarzyszenie na Rzecz Integracji i Usamodzielniania "Dom w Głogowie"|Głogów|ul. Okrężna 21 |67-200 Głogów;742;375;375;19;356;50.54;5.07
83735;020301;Przedszkole Publiczne Nr 9|Głogów|ul. Perseusza 3 |67-200 Głogów;1461;791;791;18;773;54.14;2.28
83736;020301;Szkoła Podstawowa Nr 12 z Oddziałami Integracyjnymi|Głogów|ul. Gomółki 43 |67-200 Głogów;2158;1118;1118;21;1097;51.81;1.88
83737;020301;Przedszkole Publiczne Nr 19|Głogów|ul. Plutona 3 |67-200 Głogów;2072;1049;1049;32;1017;50.63;3.05
83738;020301;Szkoła Podstawowa Nr 10|Głogów|ul. Andromedy 62 |67-200 Głogów;2090;1122;1122;22;1100;53.68;1.96
83739;020301;Gimnazjum Nr 5|Głogów|ul. Gwiaździsta 2 |67-200 Głogów;2169;1130;1130;27;1103;52.10;2.39
83740;020301;Gimnazjum Nr 5|Głogów|ul. Gwiaździsta 2 |67-200 Głogów;2185;1146;1146;27;1119;52.45;2.36
83741;020301;Przedszkole Publiczne Nr 20|Głogów|ul. Herkulesa 4 |67-200 Głogów;1920;1120;1120;30;1090;58.33;2.68
83742;020301;Przedszkole Publiczne Nr 20|Głogów|ul. Herkulesa 4 |67-200 Głogów;2278;1126;1126;15;1111;49.43;1.33
83743;020301;Szkoła Podstawowa Nr 7|Głogów|ul. Daszyńskiego 11 |67-200 Głogów;1384;718;718;16;702;51.88;2.23
83744;020301;Szkoła Podstawowa Nr 7|Głogów|ul. Daszyńskiego 11 |67-200 Głogów;1236;635;635;15;620;51.38;2.36
83745;020301;Miejskie Centrum Wspierania Rodziny|Głogów|ul. Legnicka 3 |67-200 Głogów;1242;623;623;13;610;50.16;2.09
83746;020301;Przedszkole Publiczne Nr 7|Głogów|ul. Moniuszki 4A |67-200 Głogów;1136;520;520;10;510;45.77;1.92
83747;020301;Gimnazjum Nr 4|Głogów|ul. Niedziałkowskiego 10 |67-200 Głogów;985;459;459;8;451;46.60;1.74
83748;020301;Zespół Szkół im. Jana Wyżykowskiego|Głogów|ul. Wita Stwosza 3A |67-200 Głogów;1532;720;720;13;707;47.00;1.81
83749;020301;Zespół Placówek Szkolno-Wychowawczych|Głogów|ul. Sportowa 1 |67-200 Głogów;1161;737;737;6;731;63.48;0.81
83750;020301;Szkoła Podstawowa Nr 13|Głogów|ul. Akacjowa 10 |67-200 Głogów;1313;613;613;19;594;46.69;3.10
83751;020301;Przedszkole Publiczne Nr 17|Głogów|ul. Królewska 14 |67-200 Głogów;1416;800;800;18;782;56.50;2.25
83752;020301;Przedszkole Publiczne Nr 17|Głogów|ul. Królewska 14 |67-200 Głogów;926;514;514;19;495;55.51;3.70
83753;020301;Szkoła Podstawowa Nr 14|Głogów|ul. Królewska 12 |67-200 Głogów;495;300;300;7;293;60.61;2.33
83754;020301;Gimnazjum Nr 2|Głogów|Pl. Mieszka I 22 |67-200 Głogów;1985;1107;1109;33;1074;55.77;2.98
83755;020301;Szkoła Podstawowa Nr 3|Głogów|Pl. Mieszka I 22 |67-200 Głogów;1321;719;719;9;710;54.43;1.25
83756;020301;Szkoła Podstawowa Nr 3|Głogów|Pl. Mieszka I 22 |67-200 Głogów;1162;575;575;14;561;49.48;2.43
83757;020301;Przedszkole Publiczne Nr 21|Głogów|ul. Jagiellońska 37 |67-200 Głogów;1363;726;726;19;707;53.26;2.62
83758;020301;Przedszkole Publiczne Nr 21|Głogów|ul. Jagiellońska 37 |67-200 Głogów;1218;576;576;12;564;47.29;2.08
83759;020301;Zakład Karny|Głogów|ul. Lipowa 21 |67-200 Głogów;277;133;133;22;111;48.01;16.54
83760;020301;Dom Pomocy Społecznej|Głogów|ul. Neptuna 22/24 |67-200 Głogów;95;36;36;7;29;37.89;19.44
83761;020301;Głogowski Szpital Powiatowy sp. z o.o.|Głogów|Kościuszki 15 |67-200 Głogów;209;18;18;1;17;8.61;5.56
83762;020302;Świetlica Wiejska|Ruszowice|ul. Tęczowa 55 |67-200 Głogów;1212;659;659;25;634;54.37;3.79
83763;020302;Zespół Szkół w Przedmościu|Przedmoście|ul. Szkolna 3 |67-210 Głogów;1144;552;552;31;521;48.25;5.62
83764;020302;Zespół Szkół w Serbach|Serby|ul. Ogrodowa 18 |67-210 Głogów;1885;990;990;38;952;52.52;3.84
83765;020302;Szkoła Podstawowa w Wilkowie|Wilków|ul. Głogowska 5 a |67-200 Głogów;949;438;438;19;419;46.15;4.34
83766;020303;Szkoła Podstawowa|Jaczów|ul. Główna 20 |67-200 Głogów;1342;750;750;22;728;55.89;2.93
83767;020303;Szkoła Podstawowa|Jerzmanowa|ul. Głogowska 19 |67-222 Jerzmanowa;925;544;544;23;521;58.81;4.23
83768;020303;Świetlica Wiejska|Kurowice| 42a |67-222 Jerzmanowa;713;363;363;10;353;50.91;2.75
83769;020303;Świetlica Wiejska|Potoczek| 15 |67-222 Jerzmanowa;583;276;276;7;269;47.34;2.54
83770;020304;Gimnazjum Gminne im. Zagłębia Miedziowego w Kotli|Kotla|ul. Szkolna 2 |67-240 Kotla;1483;571;571;22;549;38.50;3.85
83771;020304;Budynek komunalny|Chociemyśl| 23 |67-240 Kotla;450;158;158;11;147;35.11;6.96
83772;020304;Budynek komunalny|Sobczyce| 38 |67-240 Kotla;577;297;297;18;279;51.47;6.06
83773;020304;Sala wiejska|Głogówko| 21 |67-240 Kotla;483;219;219;6;213;45.34;2.74
83774;020304;Sala wiejska|Skidniów| 9 |67-240 Kotla;417;113;113;6;107;27.10;5.31
83775;020305;Gminny Ośrodek Kultury|Białołęka| 12 |67-221 Białołęka;1106;459;459;15;444;41.50;3.27
83776;020305;Świetlica Wiejska|Piersna| 26 |67-221 Białołęka;673;290;290;26;264;43.09;8.97
83777;020306;Szkoła Podstawowa|Nielubia| 80 |67-231 Żukowice;1373;577;577;24;553;42.02;4.16
83778;020306;Szkoła Podstawowa|Brzeg Głogowski| 27 |67-231 Żukowice;1395;570;570;26;544;40.86;4.56
83779;020401;SPZOZ Ośrodek Rehabilitacji Dzieci Niepełnosprawnych|Góra|Os. Kazimierza Wielkiego 25 |56-200 Góra;1410;627;627;15;612;44.47;2.39
83780;020401;Gimnazjum Nr 2|Góra|ul.Poznańska 2a |56-200 Góra;0;0;0;0;0;-99;-99
83781;020401;Przedszkole Publiczne Nr 1|Góra|ul. Stefana Żeromskiego 15 |56-200 Góra;1360;471;471;16;455;34.63;3.40
83782;020401;Gimnazjum Nr 1|Góra|ul. Szkolna 2 |56-200 Góra;1421;604;604;16;588;42.51;2.65
83783;020401;Administracja Lokali Komunalnych|Góra|ul. Starogórska 15 |56-200 Góra;1566;743;743;24;719;47.45;3.23
83784;020401;Szkoła Podstawowa Nr 1|Góra|ul. Marii Konopnickiej 2 |56-200 Góra;878;449;449;8;441;51.14;1.78
83785;020401;Szkoła Podstawowa Nr 1|Góra|ul. Piastów 32 |56-200 Góra;1561;697;697;8;689;44.65;1.15
83786;020401;Zespół Szkoła Podstawowa, Gimnazjum i Przedszkole|Czernina|ul.Szkolna 2 |56-200 Góra;1481;501;501;23;478;33.83;4.59
83787;020401;Świetlica Wiejska|Kłoda Górowska| 45 |56-200 Góra;1522;551;551;27;524;36.20;4.90
83788;020401;Świetlica Wiejska|Stara Góra| 33A |56-200 Góra;580;257;257;17;240;44.31;6.61
83789;020401;Świetlica Wiejska|Osetno| 25 |56-200 Góra;845;327;327;13;314;38.70;3.98
83790;020401;Zespół Szkolno-Przedszkolny z Oddziałami Integracyjnymi|Glinka| 6 |56-200 Góra;859;225;225;16;209;26.19;7.11
83791;020401;Zespół Szkoła Podstawowa i Przedszkole|Witoszyce| 10 |56-200 Góra;1062;352;352;18;334;33.15;5.11
83792;020401;Polskie Centrum Zdrowia Góra Śląska Sp. z o.o.|Góra|ul. Ludwika Hirszfelda 8 |56-200 Góra;36;3;3;0;3;8.33;0.00
83793;020402;Dom Kultury|Luboszyce| 15 |56-209 Jemielno;1009;359;359;9;350;35.58;2.51
83794;020402;Urząd Gminy|Jemielno| 81 |56-209 Jemielno;825;318;318;18;300;38.55;5.66
83795;020402;Świetlica Wiejska|Psary| 44 |56-209 Jemielno;645;174;174;10;164;26.98;5.75
83796;020403;Świetlica wiejska|Siciny| 81 |56-215 Niechlów;1229;405;405;24;381;32.95;5.93
83797;020403;Gminny Ośrodek Kultury|Niechlów|ul. Dworcowa 9 |56-215 Niechlów;1029;374;374;22;352;36.35;5.88
83798;020403;Świetlica wiejska|Lipowiec| 16 |56-215 Niechlów;917;286;286;19;267;31.19;6.64
83799;020403;Dom Pomocy Społecznej|Wroniniec| 59 |56-215 Niechlów;761;260;260;7;253;34.17;2.69
83800;020404;Szkoła Podstawowa|Czarnoborsko| 10 |56-210 Wąsosz;1099;420;420;17;403;38.22;4.05
83801;020404;Ośrodek Pomocy Społecznej|Wąsosz|ul. Krzywa 11 |56-210 Wąsosz;2195;896;896;35;861;40.82;3.91
83802;020404;Zespół Placówek Kultury|Wąsosz|ul. Zacisze 10 D |56-210 Wąsosz;933;263;263;17;246;28.19;6.46
83803;020404;Szkoła Podstawowa|Pobiel| 75 |56-210 Wąsosz;737;300;300;12;288;40.71;4.00
83804;020404;Świetlica Wiejska|Kamień Górowski| 1 |56-210 Wąsosz;901;247;247;21;226;27.41;8.50
83805;020501;Szkoła Podstawowa Nr 5|Jawor|ul. Armii Krajowej 9 |59-400 Jawor;2020;890;890;25;865;44.06;2.81
83806;020501;Europejskie Centrum Młodzieży Euroregionu NYSA|Jawor|ul. Parkowa 5 |59-400 Jawor;2170;1153;1153;20;1133;53.13;1.73
83807;020501;Powiatowe Centrum Kształcenia Zawodowego i Ustawicznego|Jawor|ul. Wrocławska 30a |59-400 Jawor;1172;569;569;9;560;48.55;1.58
83808;020501;Gimnazjum Nr 2|Jawor|pl. Bankowy 1 |59-400 Jawor;1638;732;732;12;720;44.69;1.64
83809;020501;Zespół Szkół w Jaworze|Jawor|ul. Adama Rapackiego 1 |59-400 Jawor;1613;616;616;24;592;38.19;3.90
83810;020501;Jaworski Ośrodek Kultury|Jawor|Rynek 5 |59-400 Jawor;1605;600;600;20;580;37.38;3.33
83811;020501;Filia Nr 1 Miejskiej Biblioteki Publicznej|Jawor|ul. Stanisława Moniuszki 10 |59-400 Jawor;1716;905;905;15;890;52.74;1.66
83812;020501;Gimnazjum Nr 1|Jawor|ul. Stanisława Moniuszki 4 |59-400 Jawor;1124;577;577;8;569;51.33;1.39
83813;020501;Specjalny Ośrodek Szkolno-Wychowawczy|Jawor|ul. Ignacego Paderewskiego 6 |59-400 Jawor;1878;798;799;21;777;42.49;2.63
83814;020501;Szkoła Podstawowa Nr 1|Jawor|ul. Bolesława Limanowskiego 10 |59-400 Jawor;1808;909;909;16;893;50.28;1.76
83815;020501;Szkoła Podstawowa Nr 1|Jawor|ul. Romana Dmowskiego 5 |59-400 Jawor;1570;836;836;17;819;53.25;2.03
83816;020501;Szkoła Podstawowa Nr 4|Jawor|ul. Starojaworska 82 |59-400 Jawor;1193;507;507;14;493;42.50;2.76
83817;020501;Dom Pomocy Społecznej|Jawor|pl. Seniora 3 |59-400 Jawor;59;28;28;2;26;47.46;7.14
83818;020501;Jaworskie Centrum Medyczne Sp. z o.o.|Jawor|Szpitalna 3 |59-400 Jawor;58;15;15;1;14;25.86;6.67
83819;020502;Gminno-Miejski Ośrodek Kultury,Sportu i Rekreacji|Bolków|ul. Szpitalna 16 |59-420 Bolków;1313;598;598;26;572;45.54;4.35
83820;020502;Internat Zespołu Szkół Agrobiznesu|Bolków|ul. Mickiewicza 1 |59-420 Bolków;1151;513;513;17;496;44.57;3.31
83821;020502;Gminno-Miejski Zakład Budżetowy Gospodarki Komunalnej i Mieszkaniowej|Bolków|ul. Kolejowa 5 |59-420 Bolków;1277;562;562;24;538;44.01;4.27
83822;020502;Przedszkole Samorządowe|Bolków|ul. Sienkiewicza 39 |59-420 Bolków;756;272;272;16;256;35.98;5.88
83823;020502;Świetlica Wiejska|Mysłów| 44 |59-420 Bolków;489;176;176;9;167;35.99;5.11
83824;020502;Świetlica Wiejska|Kaczorów|ul. Nowa Wieś 1B |59-420 Bolków;640;239;239;9;230;37.34;3.77
83825;020502;Świetlica Wiejska|Lipa| |59-420 Bolków;725;220;220;10;210;30.34;4.55
83826;020502;Szkoła Podstawowa|Sady Górne| 94 |59-420 Bolków;653;255;255;10;245;39.05;3.92
83827;020502;Świetlica Wiejska|Wierzchosławice| 106 |59-420 Bolków;782;271;271;12;259;34.65;4.43
83828;020502;Świetlica Wiejska|Stare Rochowice| 53 |59-420 Bolków;360;98;98;4;94;27.22;4.08
83829;020502;Świetlica Wiejska|Wolbromek| 43B |59-420 Bolków;424;159;159;8;151;37.50;5.03
83830;020502;Dom Pomocy Społecznej w Jaworze Filia w Bolkowie|Bolków|Kamiennogórska 3 |59-420 Bolków;47;25;25;0;25;53.19;0.00
83831;020502;Zakład Opiekuńczo-Leczniczy w Bolkowie|Bolków|Wysokogórska 19 |59-420 Bolków;74;9;9;0;9;12.16;0.00
83832;020503;Zespół Szkół|Męcinka| 10B |59-424 Męcinka;1397;628;628;27;601;44.95;4.30
83833;020503;Świetlica Wiejska|Małuszów| 17 |59-424 Męcinka;482;250;250;7;243;51.87;2.80
83834;020503;Była Szkoła Filialna|Pomocne| 51 |59-424 Męcinka;947;330;330;13;317;34.85;3.94
83835;020503;Szkoła Podstawowa|Piotrowice| 139 |59-424 Męcinka;1113;436;436;9;427;39.17;2.06
83836;020504;Szkoła Podstawowa w Targoszynie|Targoszyn| 51 |59-407 Mściwojów;1004;414;414;16;398;41.24;3.86
83837;020504;Szkoła Podstawowa w Snowidzy|Snowidza| 91A |59-407 Mściwojów;1166;484;484;15;469;41.51;3.10
83838;020504;Świetlica wiejska w Mściwojowie|Mściwojów| 54B |59-407 Mściwojów;1102;474;474;18;456;43.01;3.80
83839;020505;Świetlica wiejska w Paszowicach|Paszowice| 136 |59-411 Paszowice;1927;894;894;29;865;46.39;3.24
83840;020505;Ośrodek Zdrowia Filia w Sokolej|Sokola| 2 |59-411 Paszowice;1274;433;433;10;423;33.99;2.31
83841;020506;Gimnazjum|Budziszów Wielki| 10 |59-430 Wądroże Wielkie;1640;660;660;26;634;40.24;3.94
83842;020506;Szkoła Podstawowa|Wądroże Wielkie| 169 |59-430 Wądroże Wielkie;1596;622;622;24;598;38.97;3.86
83843;020506;Świetlica Domu Pomocy Społecznej w Jaworze - Dom Mierczyce|Mierczyce| 34 |59-430 Wądroże Wielkie;63;24;24;7;17;38.10;29.17
83844;020601;Gościniec "Leśny Dwór"|Karpacz|ul. Karkonoska 1 |58-540 Karpacz;852;372;372;10;362;43.66;2.69
83845;020601;Gimnazjum im. Ratowników Górskich|Karpacz|ul. Łączna 2 |58-540 Karpacz;821;381;381;8;373;46.41;2.10
83846;020601;Hala Widowiskowo-Sportowa|Karpacz|ul. Konstytucji 3 Maja 48a |58-540 Karpacz;887;445;445;5;440;50.17;1.12
83847;020601;OKW "Krucze Skały"|Karpacz|ul. Wilcza 1 |58-540 Karpacz;922;494;494;5;489;53.58;1.01
83848;020601;KCKiT|Karpacz|ul. Kolejowa 3 |58-540 Karpacz;868;434;434;9;425;50.00;2.07
83849;020601;Centrum Medyczne Karpacz "Zarzecze"|Karpacz|ul. Myśliwska 13 |58-540 Karpacz;22;16;16;1;15;72.73;6.25
83850;020601;Centrum Medyczne Karpacz "Świetlana Góra"|Karpacz|ul. Sanatoryjna 1 |58-540 Karpacz;52;42;42;2;40;80.77;4.76
83851;020602;Miejska Biblioteka Publiczna - Filia Wojków|Kowary|ul. Górna 2 |58-530 Kowary;575;294;294;6;288;51.13;2.04
83852;020602;Miejski Ośrodek Pomocy Społecznej|Kowary|ul. Zamkowa 5 |58-530 Kowary;1186;445;445;12;433;37.52;2.70
83853;020602;Szkoła Podstawowa Nr 3|Kowary|ul. 1 Maja 72 |58-530 Kowary;1899;823;823;35;788;43.34;4.25
83854;020602;Szkoła Podstawowa Nr 1, Centrum Wczesnej Profilaktyki Zdrowotnej|Kowary|ul. Staszica 18 |58-530 Kowary;1636;656;656;22;634;40.10;3.35
83855;020602;Miejski Ośrodek Kultury|Kowary|ul. Szkolna 2 |58-530 Kowary;1185;536;536;32;504;45.23;5.97
83856;020602;Miejski Ośrodek Kultury|Kowary|ul. Szkolna 2 |58-530 Kowary;1236;621;621;21;600;50.24;3.38
83857;020602;Prywatne Przedszkole "Krokodyl Schnappi"|Kowary|ul. Wiejska 3 |58-530 Kowary;1162;408;408;18;390;35.11;4.41
83858;020602;Dom Pomocy Społecznej|Kowary|ul. Waryńskiego 38 |58-530 Kowary;56;21;21;5;16;37.50;23.81
83859;020602;Powiatowe Centrum Zdrowia Spółka z o.o. w Kowarach, Szpital "Bukowiec"|Kowary|ul. Sanatoryjna 15 |58-530 Kowary;38;28;28;0;28;73.68;0.00
83860;020602;Wojewódzkie Centrum Szpitalne Kotliny Jeleniogórskiej Jednostka Medyczna WYSOKA ŁĄKA|Kowary|ul. Sanatoryjna 27 |58-530 Kowary;64;47;47;3;44;73.44;6.38
83861;020602;Powiatowe Centrum Zdrowia Sp. z o.o. w Kowarach Centrum Opieki Długoterminowej Hospicjum|Kowary|ul. Jeleniogórska 14 |58-530 Kowary;31;10;10;1;9;32.26;10.00
83862;020603;Przedszkole Samorządowe Nr 1|Piechowice|ul. Żymierskiego 77 |58-573 Piechowice;1724;752;752;27;725;43.62;3.59
83863;020603;Szkoła Podstawowa Nr 1|Piechowice|ul. Szkolna 6 |58-573 Piechowice;1361;664;664;18;646;48.79;2.71
83864;020603;Gimnazjum im. Jana Pawła II|Piechowice|ul. Tysiąclecia 28 |58-573 Piechowice;1623;810;810;21;789;49.91;2.59
83865;020603;POLCOLORIT S.A.|Piechowice|ul. Jeleniogórska 7 |58-573 Piechowice;538;229;229;6;223;42.57;2.62
83866;020604;Budynek po byłej Szkole Podstawowej Nr 3|Szklarska Poręba|ul. Kolejowa 22 |58-580 Szklarska Poręba;395;189;189;7;182;47.85;3.70
83867;020604;Ośrodek Konferencyjno-Szkoleniowy Politechniki Wrocławskiej|Szklarska Poręba|ul. Muzealna 2-5 |58-580 Szklarska Poręba;765;358;358;7;351;46.80;1.96
83868;020604;Miejski Ośrodek Kultury, Sportu i Aktywności Lokalnej|Szklarska Poręba|ul. Słowackiego 13 |58-580 Szklarska Poręba;760;309;309;4;305;40.66;1.29
83869;020604;Zespół Szkół Ogólnokształcących i Mistrzostwa Sportowego|Szklarska Poręba|ul.Obrońców Pokoju 17 |58-580 Szklarska Poręba;674;311;311;15;296;46.14;4.82
83870;020604;Miejski Ośrodek Pomocy Społecznej|Szklarska Poręba|ul. Jedności Narodowej 11 |58-580 Szklarska Poręba;1403;639;639;22;617;45.55;3.44
83871;020604;Szkoła Podstawowa Nr 1|Szklarska Poręba|ul. 1 Maja 32 |58-580 Szklarska Poręba;1509;787;787;11;776;52.15;1.40
83872;020605;Świetlica Wiejska|Komarno| 88 |58-508 Jelenia Góra;679;296;296;12;284;43.59;4.05
83873;020605;Centrum Informacji Turystycznej|Radomierz| 60a |58-520 Janowice Wielkie;394;180;180;7;173;45.69;3.89
83874;020605;Klub|Trzcińsko| 71 |58-520 Janowice Wielkie;466;173;173;9;164;37.12;5.20
83875;020605;Gminny Zespół Szkół im. W. Rutkiewicz|Janowice Wielkie|ul. Partyzantów 4 |58-520 Janowice Wielkie;1866;835;835;36;799;44.75;4.31
83876;020605;SP ZOZ Zespół Profilaktyki i Rehabilitacji w Janowicach Wielkich|Janowice Wielkie|ul. Karola Świerczewskiego 12 |58-520 Janowice Wielkie;80;55;55;2;53;68.75;3.64
83877;020606;Urząd Gminy Jeżów Sudecki|Jeżów Sudecki|ul. Długa 63 |58-521 Jeżów Sudecki;2211;1231;1231;38;1193;55.68;3.09
83878;020606;Punkt Biblioteczny|Dziwiszów| 157 |58-508 Jelenia Góra;1078;488;488;9;479;45.27;1.84
83879;020606;Szkoła Podstawowa|Siedlęcin|ul. Kościelna 5 |58-508 Jelenia Góra;1231;524;524;13;511;42.57;2.48
83880;020606;Szkoła Podstawowa|Czernica| 125 |58-521 Jeżów Sudecki;1097;377;377;4;373;34.37;1.06
83881;020607;Gminny Ośrodek Kultury w Mysłakowicach|Mysłakowice|ul. Daszyńskiego 29 |58-533 Mysłakowice;1661;738;738;34;704;44.43;4.61
83882;020607;Zespół Szkół Szkoła Podstawowa i Gimnazjum w Mysłakowicach|Mysłakowice|ul. Sułkowskiego 1 |58-533 Mysłakowice;1872;827;827;37;790;44.18;4.47
83883;020607;Świetlica Wiejska w Łomnicy przy Gminnym Ośrodku Kultury w Mysłakowicach|Łomnica|ul. Świerczewskiego 36 |58-508 Jelenia Góra;1552;746;746;37;709;48.07;4.96
83884;020607;Pałac Bukowiec|Bukowiec|ul. Robotnicza 6 |58-533 Mysłakowice;1253;541;541;16;525;43.18;2.96
83885;020607;Świetlica Wiejska w Karpnikach przy Gminnym Ośrodku Kultury w Mysłakowicach|Karpniki|ul. Rudawska 8 |58-533 Mysłakowice;871;338;338;6;332;38.81;1.78
83886;020607;Świetlica|Dąbrowica| 45 |58-508 Jelenia Góra;399;183;183;5;178;45.86;2.73
83887;020607;Świetlica Wiejska w Wojanowie przy Gminnym Ośrodku Kultury w Mysłakowicach|Wojanów| 38 |58-508 Jelenia Góra;575;256;256;12;244;44.52;4.69
83888;020608;Szkoła Podstawowa w Podgórzynie|Podgórzyn|ul. Żołnierska 113 |58-562 Podgórzyn;1719;858;858;17;841;49.91;1.98
83889;020608;Harcerska Baza Karkonoska w Przesiece|Przesieka|ul. Karkonoska 27 |58-562 Podgórzyn;444;206;206;3;203;46.40;1.46
83890;020608;Młodzieżowe Schronisko Turystyczne w Staniszowie|Staniszów| 59 |58-500 Jelenia Góra;910;455;455;13;442;50.00;2.86
83891;020608;Dom Strażaka w Sosnówce|Sosnówka|ul. Strażacka 7 |58-564 Sosnówka;997;442;442;19;423;44.33;4.30
83892;020608;Szkoła Podstawowa w Miłkowie|Miłków|ul. Szkolna 95 |58-535 Miłków;1655;681;681;33;648;41.15;4.85
83893;020608;Szkoła Podstawowa w Ściegnach|Ściegny| 110b |58-535 Miłków;840;340;340;9;331;40.48;2.65
83894;020608;Dom Pomocy Społecznej w Sosnówce|Sosnówka|ul. Liczyrzepy 87 |58-564 Sosnówka;63;25;25;1;24;39.68;4.00
83895;020609;Centrum Informacji Turystycznej w Starej Kamienicy|Stara Kamienica| 73 |58-512 Stara Kamienica;1295;532;532;21;511;41.08;3.95
83896;020609;Świetlica Wiejska w Rybnicy|Rybnica| 137 |58-512 Stara Kamienica;1041;376;376;6;370;36.12;1.60
83897;020609;Szkoła Podstawowa w Kopańcu|Kopaniec| 78 |58-512 Stara Kamienica;937;395;395;13;382;42.16;3.29
83898;020609;Świetlica Wiejska w Wojcieszycach|Wojcieszyce| 116 |58-560 Jelenia Góra;932;427;427;5;422;45.82;1.17
83899;020701;Zespół Szkół|Kamienna Góra|ul. Lubawska 8 |58-400 Kamienna Góra;1439;560;560;36;524;38.92;6.43
83900;020701;Muzeum Tkactwa|Kamienna Góra|Pl. Wolności 11 |58-400 Kamienna Góra;1333;498;498;15;483;37.36;3.01
83901;020701;Powiatowy Urząd Pracy|Kamienna Góra|ul. H. Sienkiewicza 6a |58-400 Kamienna Góra;1285;525;525;18;507;40.86;3.43
83902;020701;Przedszkole Publiczne Nr 3|Kamienna Góra|ul. Papieża Jana Pawła II 20 |58-400 Kamienna Góra;2178;879;879;42;837;40.36;4.78
83903;020701;Szkoła Podstawowa Nr 2|Kamienna Góra|ul. Jeleniogórska 7 |58-400 Kamienna Góra;1657;757;757;18;739;45.68;2.38
83904;020701;Osiedle Krzeszowskie|Kamienna Góra|ul. Wałbrzyska 26 |58-400 Kamienna Góra;1978;1018;1018;22;996;51.47;2.16
83905;020701;Centrum Gimnastyki Szkoły Podstawowej Nr 1|Kamienna Góra|ul. T. Kościuszki 17 |58-400 Kamienna Góra;1764;755;755;24;731;42.80;3.18
83906;020701;Szkoła Podstawowa Nr 1|Kamienna Góra|Plac Kościelny 1 |58-400 Kamienna Góra;640;257;257;6;251;40.16;2.33
83907;020701;Zespół Szkół Ogólnokształcących|Kamienna Góra|ul. M. Skłodowskiej-Curie 2 |58-400 Kamienna Góra;2033;1088;1088;13;1075;53.52;1.19
83908;020701;Zespół Szkół Zawodowych i Ogólnokształcących|Kamienna Góra|ul. R. Traugutta 2 |58-400 Kamienna Góra;1674;850;850;22;828;50.78;2.59
83909;020701;Dolnośląskie Centrum Rehabilitacji Sp. z o.o.|Kamienna Góra|ul. J. Korczaka 1 |58-400 Kamienna Góra;210;114;114;10;104;54.29;8.77
83910;020701;Powiatowe Centrum Zdrowia Sp. z o.o. NZOZ Szpital Powiatowy|Kamienna Góra|ul. Bohaterów Getta 10 |58-400 Kamienna Góra;81;16;16;1;15;19.75;6.25
83911;020702;Centrum Biblioteczno-Kulturalne Filia Biblioteki|Leszczyniec| 100 |58-400 Kamienna Góra;1185;460;460;20;440;38.82;4.35
83912;020702;Centrum Biblioteczno-Kulturalne Filia w Pisarzowicach|Pisarzowice| 72 |58-400 Kamienna Góra;1340;550;550;29;521;41.04;5.27
83913;020702;Świetlica Wiejska|Przedwojów| 43A |58-400 Kamienna Góra;818;365;365;17;348;44.62;4.66
83914;020702;Szkoła Podstawowa|Ptaszków| 49 |58-400 Kamienna Góra;643;265;265;12;253;41.21;4.53
83915;020702;Centrum Biblioteczno-Kulturalne|Krzeszów|ul. Kalwaria 1 |58-400 Kamienna Góra;1870;953;953;33;920;50.96;3.46
83916;020702;Świetlica Wiejska|Gorzeszów| 113 |58-400 Kamienna Góra;518;231;231;13;218;44.59;5.63
83917;020702;Świetlica Wiejska|Czadrów| 26 |58-400 Kamienna Góra;612;296;296;11;285;48.37;3.72
83918;020702;Dom Pomocy Społecznej|Szarocin| 1 |58-400 Kamienna Góra;27;18;18;6;12;66.67;33.33
83919;020703;Gimnazjum Publiczne|Lubawka|ul. Mickiewicza 4 |58-420 Lubawka;1325;636;636;27;609;48.00;4.25
83920;020703;Szkoła Podstawowa|Lubawka|ul. Boczna 13 |58-420 Lubawka;1828;816;816;30;786;44.64;3.68
83921;020703;Dom Kultury|Lubawka|ul. Kamiennogórska 19 |58-420 Lubawka;1869;966;966;38;928;51.69;3.93
83922;020703;Zespół Szkół Publicznych im. "Tkaczy Chełmskich"|Chełmsko Śląskie|ul. Kolonia 14 |58-420 Lubawka;2153;911;911;39;872;42.31;4.28
83923;020703;Świetlica Wiejska|Stara Białka| 35 |58-420 Lubawka;466;210;210;10;200;45.06;4.76
83924;020703;Szkoła Podstawowa w Miszkowicach|Miszkowice| 8 |58-420 Lubawka;811;341;341;29;312;42.05;8.50
83925;020703;Świetlica Wiejska|Opawa| 59 |58-420 Lubawka;672;315;315;6;309;46.88;1.90
83926;020704;Urząd Gminy w Marciszowie|Marciszów|ul. Szkolna 6 |58-410 Marciszów;1263;474;474;15;459;37.53;3.16
83927;020704;Świetlica wiejska w Ciechanowicach|Ciechanowice| 19a |58-410 Marciszów;800;293;293;14;279;36.62;4.78
83928;020704;Świetlica wiejska w Domanowie|Domanów| 44 |58-410 Marciszów;338;102;102;5;97;30.18;4.90
83929;020704;Świetlica wiejska w Pastewniku|Pastewnik| 49 |58-410 Marciszów;205;73;73;3;70;35.61;4.11
83930;020704;Świetlica wiejska w Świdniku|Świdnik| 50a |58-410 Marciszów;238;98;98;9;89;41.18;9.18
83931;020704;Świetlica wiejska w Sędzisławiu|Sędzisław| 25a |58-410 Marciszów;521;235;235;12;223;45.11;5.11
83932;020704;Świetlica wiejska w Wieściszowicach|Wieściszowice| 43 |58-410 Marciszów;369;116;116;4;112;31.44;3.45
83933;020801;Ośrodek Pomocy Społecznej|Duszniki-Zdrój|Słowackiego 16 |57-340 Duszniki-Zdrój;700;266;266;12;254;38.00;4.51
83934;020801;Miejski Zespół Szkół|Duszniki-Zdrój|ul. Wybickiego 2a |57-340 Duszniki-Zdrój;1105;464;464;18;446;41.99;3.88
83935;020801;Miejski Zespół Szkół|Duszniki-Zdrój|ul. Sportowa 6 |57-340 Duszniki-Zdrój;1217;597;597;24;573;49.06;4.02
83936;020801;Dworek Chopina|Duszniki-Zdrój|Park Zdrojowy |57-340 Duszniki-Zdrój;1155;672;672;17;655;58.18;2.53
83937;020802;Stowarzyszenie „Promyk” Kłodzka Pomoc Społeczna w Kłodzku|Kłodzko|ul. Armii Krajowej 1 |57-300 Kłodzko;1082;461;461;30;431;42.61;6.51
83938;020802;Urząd Miasta w Kłodzku|Kłodzko|Pl. B. Chrobrego 1 |57-300 Kłodzko;971;426;426;14;412;43.87;3.29
83939;020802;KCKSiR w Kłodzku pomieszczenie galerii|Kłodzko|Pl. Władysława Jagiełły 1 |57-300 Kłodzko;1103;489;489;13;476;44.33;2.66
83940;020802;Przedszkole nr 3 w Kłodzku|Kłodzko|ul. Warty 6 |57-300 Kłodzko;1167;520;520;6;514;44.56;1.15
83941;020802;Zesół Przedszkolno-Żłobkowy nr 1 w Kłodzku|Kłodzko|ul.Grunwaldzka 6 |57-300 Kłodzko;1184;526;526;14;512;44.43;2.66
83942;020802;Miejski Zespół Szkół w Kłodzku|Kłodzko|ul. H. Sienkiewicza 61 |57-300 Kłodzko;1161;619;619;14;605;53.32;2.26
83943;020802;ZAMGGM Kłodzko|Kłodzko|ul. Grunwaldzka 29 |57-300 Kłodzko;1123;503;503;12;491;44.79;2.39
83944;020802;Ośrodek Pomocy Społecznej w Kłodzku|Kłodzko|ul.Stanisława Wyspiańskiego 2d |57-300 Kłodzko;1122;568;568;6;562;50.62;1.06
83945;020802;Zespół Szkół Integracyjnych w Kłodzku|Kłodzko|ul. Zamiejska 24 |57-300 Kłodzko;1257;620;620;19;601;49.32;3.06
83946;020802;Hala Sportowa w Kłodzku|Kłodzko|ul. Wandy 1 |57-300 Kłodzko;1123;566;566;8;558;50.40;1.41
83947;020802;Szkoła Podstawowa nr 6 w Kłodzku|Kłodzko|ul. Bohaterów Getta 22 |57-300 Kłodzko;1074;501;501;5;496;46.65;1.00
83948;020802;Przedszkole nr 4 w Kłodzku|Kłodzko|ul. Bohaterów Getta 9 |57-300 Kłodzko;1175;565;566;8;557;48.09;1.42
83949;020802;KCKSiR w Kłodzku Hala Sportowa|Kłodzko|ul. J. Kusocińskiego 2 |57-300 Kłodzko;992;440;440;16;424;44.35;3.64
83950;020802;Dom Działkowca ROD w Kłodzku "Perła "|Kłodzko|ul. Łąkowa 7 |57-300 Kłodzko;1040;585;585;9;576;56.25;1.54
83951;020802;Szkoła Podstawowa nr 3 w Kłodzku (Sala gimnastyczna)|Kłodzko|ul. Jana Pawła II 4 |57-300 Kłodzko;1095;626;626;12;614;57.17;1.92
83952;020802;Szkoła Podstawowa nr 3 w Kłodzku - duży budynek|Kłodzko|ul. Jana Pawla II 4 |57-300 Kłodzko;1056;564;564;9;555;53.41;1.60
83953;020802;Przedszkole Niepubliczne "Promyczek"|Kłodzko|ul.Michała Drzymały 1a |57-300 Kłodzko;851;299;299;13;286;35.14;4.35
83954;020802;Szkoła Podstawowa nr 3 w Kłodzku-mały budynek|Kłodzko|Jana Pawła II 2 |57-300 Kłodzko;884;480;480;10;470;54.30;2.08
83955;020802;Kryta Pływalnia w Kłodzku|Kłodzko|ul. Jana Pawla II 4 |57-300 Kłodzko;824;484;484;19;465;58.74;3.93
83956;020802;Muzeum Ziemi Kłodzkiej|Kłodzko|Ignacego Łukasiewicza 4 |57-300 Kłodzko;877;437;437;8;429;49.83;1.83
83957;020802;Gimnazjum nr 1 w Kłodzku|Kłodzko|Zawiszy Czarnego 5 |57-300 Kłodzko;809;294;294;5;289;36.34;1.70
83958;020802;Samodzielny Publiczny Zespół Opieki Zdrowotnej w Kłodzku|Kłodzko|Szpitalna 1 |57-300 Kłodzko;158;72;72;7;65;45.57;9.72
83959;020802;Zakład Karny w Kłodzku|Kłodzko|Bohaterów Getta 16 |57-300 Kłodzko;603;264;264;32;232;43.78;12.12
83960;020803;"Caritas" Diecezji Świdnickiej|Kudowa-Zdrój|ul. Marchlewskiego 4 |57-350 Kudowa-Zdrój;1667;684;684;23;661;41.03;3.36
83961;020803;Zespół Szkół Publicznych im. Jana Pawła II|Kudowa-Zdrój|ul. Szkolna 8 |57-350 Kudowa-Zdrój;1308;622;622;18;604;47.55;2.89
83962;020803;Punkt Informacyjno-Konsultacyjny GKRPA|Kudowa-Zdrój|ul. Poznańska 2 |57-350 Kudowa-Zdrój;1448;764;764;8;756;52.76;1.05
83963;020803;Publiczna Szkoła Podstawowa Nr 3|Kudowa-Zdrój|ul. Tadeusza Kościuszki 58 |57-350 Kudowa-Zdrój;1137;518;518;16;502;45.56;3.09
83964;020803;Zespół Szkół Społecznych|Kudowa-Zdrój|ul. Słone 72 |57-350 Kudowa-Zdrój;474;221;221;8;213;46.62;3.62
83965;020803;Kudowski Zakład Wodociągów i Kanalizacji|Kudowa-Zdrój|ul. Aleksandra Fredry 8 |57-350 Kudowa-Zdrój;988;479;479;19;460;48.48;3.97
83966;020803;Zespół Szkół Publicznych im.Jana Pawła II|Kudowa-Zdrój|ul. Szkolna 8 |57-350 Kudowa-Zdrój;0;0;0;0;0;-99;-99
83967;020804;Miejska Biblioteka Publiczna|Nowa Ruda|ul. Bohaterów Getta 10 |57-400 Nowa Ruda;1692;612;612;27;585;36.17;4.41
83968;020804;Miejski Ośrodek Kultury|Nowa Ruda|ul. Strzelecka 2a |57-400 Nowa Ruda;0;0;0;0;0;-99;-99
83969;020804;Szkoła Podstawowa Nr 3|Nowa Ruda|ul. Srebrna 11 |57-400 Nowa Ruda;919;395;395;16;379;42.98;4.05
83970;020804;Liceum Ogólnokształcące|Nowa Ruda|Osiedle Piastowskie 17 |57-400 Nowa Ruda;0;0;0;0;0;-99;-99
83971;020804;Liceum Ogólnokształcące|Nowa Ruda|Osiedle Piastowskie 17 |57-400 Nowa Ruda;1962;954;954;48;906;48.62;5.03
83972;020804;Noworudzka Szkoła Techniczna|Nowa Ruda|ul.Obozowa 9 |57-401 Nowa Ruda;845;301;301;12;289;35.62;3.99
83973;020804;Noworudzka Szkoła Techniczna|Nowa Ruda|ul.Obozowa 9 |57-401 Nowa Ruda;867;262;262;8;254;30.22;3.05
83974;020804;Miejski Zespół Szkół Nr 1|Nowa Ruda|ul. Stara Droga 39 |57-401 Nowa Ruda;803;318;318;10;308;39.60;3.14
83975;020804;Miejski Zespół Szkół Nr 1|Nowa Ruda|ul. Stara Droga 39 |57-401 Nowa Ruda;804;264;264;13;251;32.84;4.92
83976;020804;Szkoła Podstawowa Nr 7|Nowa Ruda|ul. Szkolna 3 |57-402 Nowa Ruda;832;427;427;8;419;51.32;1.87
83977;020804;Szkoła Podstawowa Nr 7|Nowa Ruda|ul.Szkolna 3 |57-402 Nowa Ruda;802;293;293;4;289;36.53;1.37
83978;020804;Gimnazjum Nr 2|Nowa Ruda|ul.Akacjowa 8 |57-402 Nowa Ruda;792;283;283;12;271;35.73;4.24
83979;020804;Gimnazjmu Nr 2|Nowa Ruda|ul.Akacjowa 8 |57-402 Nowa Ruda;916;389;389;4;385;42.47;1.03
83980;020804;Filia Miejskiej Biblioteki Publicznej|Nowa Ruda|Słupiecka 2 |57-402 Nowa Ruda;1867;962;962;31;931;51.53;3.22
83981;020804;Szkoła Podstawowa Nr 7|Nowa Ruda|ul.Kłodzka 7 |57-402 Nowa Ruda;954;511;511;13;498;53.56;2.54
83982;020804;Dom Wypoczynkowy SPORT-CENTRUM|Nowa Ruda|ul.Kłodzka 16 |57-402 Nowa Ruda;2003;1014;1014;21;993;50.62;2.07
83983;020804;Dom Pomocy Społecznej|Nowa Ruda|ul.Parkowa 20 |57-402 Nowa Ruda;74;15;15;2;13;20.27;13.33
83984;020804;SPZOZ "Zespół Opieki Zdrowotnej" Szpital w Nowej Rudzie|Nowa Ruda|ul.Krańcowa 3 |57-400 Nowa Ruda;125;20;20;0;20;16.00;0.00
83985;020805;Szkoła Podstawowa Stowarzyszenia EDUKATOR|Polanica-Zdrój|ul. Kościuszki 13 |57-320 Polanica-Zdrój;1866;944;944;36;908;50.59;3.81
83986;020805;Szkoła Podstawowa Nr 2|Polanica-Zdrój|AL. Wojska Polskiego 23 |57-320 Polanica-Zdrój;1821;910;910;28;882;49.97;3.08
83987;020805;Urząd Miejski|Polanica-Zdrój|ul.Dąbrowskiego 3 |57-320 Polanica-Zdrój;2136;1113;1113;21;1092;52.11;1.89
83988;020805;Specjalistyczne Centrum Medyczne|Polanica-Zdrój|ul.Jana Pawła II 2 |57-320 Polanica-Zdrój;76;28;28;2;26;36.84;7.14
83989;020806;Biblioteka Publiczna Miasta i Gminy|Bystrzyca Kłodzka|Plac Wolności 16 |57-500 Bystrzyca Kłodzka;948;328;328;20;308;34.60;6.10
83990;020806;Ratusz|Bystrzyca Kłodzka|Plac Wolności 1 |57-500 Bystrzyca Kłodzka;1838;687;687;41;646;37.38;5.97
83991;020806;Miejsko-Gminny Ośrodek Kultury|Bystrzyca Kłodzka|ul. Wojska Polskiego 20 |57-500 Bystrzyca Kłodzka;1011;418;418;15;403;41.35;3.59
83992;020806;Szkoła Podstawowa nr 2|Bystrzyca Kłodzka|ul. Wojska Polskiego 68 |57-500 Bystrzyca Kłodzka;2366;1177;1177;16;1161;49.75;1.36
83993;020806;Ratusz|Bystrzyca Kłodzka|Plac Wolności 1 |57-500 Bystrzyca Kłodzka;2022;828;828;30;798;40.95;3.62
83994;020806;Wiejski Dom Kultury w Starym Waliszowie|Stary Waliszów| 91 |57-500 Bystrzyca Kłodzka;536;235;235;5;230;43.84;2.13
83995;020806;Publiczna Szkoła Podstawowa Stowarzyszenia "Stara Łomnica Dzieciom" w Starej Łomnicy|Stara Łomnica| 72A |57-521 Gorzanów;1054;453;453;12;441;42.98;2.65
83996;020806;Wiejski Dom Kultury w Idzikowie|Idzików| 102 |57-500 Bystrzyca Kłodzka;556;245;245;11;234;44.06;4.49
83997;020806;Wiejski Dom Kultury w Gorzanowie|Gorzanów|pl. Wolności 1 |57-521 Gorzanów;1012;463;463;9;454;45.75;1.94
83998;020806;Wiejski Dom Kultury w Nowym Waliszowie|Nowy Waliszów| 81 |57-500 Bystrzyca Kłodzka;723;309;309;10;299;42.74;3.24
83999;020806;Wiejski Dom Kultury w Starej Bystrzycy|Stara Bystrzyca|ul. Bystrzycka 41 |57-500 Bystrzyca Kłodzka;439;199;199;5;194;45.33;2.51
84000;020806;Pijalnia Wód Mineralnych w Domu Zdrojowym|Długopole-Zdrój|ul. Wolna 2 |57-520 Długopole-Zdrój;860;454;454;18;436;52.79;3.96
84001;020806;Budynek byłej Szkoły Podstawowej|Międzygórze|ul. Pocztowa 1 |57-500 Bystrzyca Kłodzka;423;195;195;11;184;46.10;5.64
84002;020806;Wiejski Dom Kultury w Wilkanowie|Wilkanów| 137 |57-500 Bystrzyca Kłodzka;879;396;396;15;381;45.05;3.79
84003;020806;Świetlica Wiejska w Nowej Bystrzycy|Nowa Bystrzyca| 21 |57-500 Bystrzyca Kłodzka;597;246;246;13;233;41.21;5.28
84004;020806;Świetlica Wiejska w Ponikwie|Ponikwa| 41A |57-520 Długopole-Zdrój;448;179;179;8;171;39.96;4.47
84005;020806;Bystrzyckie Centrum Zdrowia|Bystrzyca Kłodzka|Okrzei 49 |57-500 Bystrzyca Kłodzka;85;40;40;0;40;47.06;0.00
84006;020806;Dom Pomocy Społecznej|Bystrzyca Kłodzka|Plac Szpitalny 5 |57-500 Bystrzyca Kłodzka;31;16;16;3;13;51.61;18.75
84007;020806;Dom Pomocy Społecznej|Bystrzyca Kłodzka|Górna 23 |57-500 Bystrzyca Kłodzka;33;9;9;0;9;27.27;0.00
84008;020807;Świetlica wiejska|Boguszyn| 91a |57-300 Kłodzko;356;173;173;10;163;48.60;5.78
84009;020807;Dom Ludowy|Wojciechowice| 106 |57-300 Kłodzko;708;324;324;17;307;45.76;5.25
84010;020807;Szkoła Podstawowa|Jaszkowa Dolna| 63 e |57-312 Kłodzko;1149;543;543;20;523;47.26;3.68
84011;020807;Filia Biblioteki Publicznej Gminy Kłodzko|Jaszkowa Górna| 71 |57-312 Kłodzko;818;344;344;17;327;42.05;4.94
84012;020807;Ośrodek Kultury, Sportu i Rekreacji Gminy Kłodzko|Ołdrzychowice Kłodzkie|ul. Kłodzka 20 |57-360 Kłodzko;1828;771;771;29;742;42.18;3.76
84013;020807;Niepubliczna Szkoła Podstawowa i Niepubliczne Gimnazjum|Żelazno| 101 |57-361 Kłodzko;927;364;364;20;344;39.27;5.49
84014;020807;Szkoła Podstawowa|Krosnowice| 207 |57-362 Kłodzko;2261;966;966;42;924;42.72;4.35
84015;020807;Centrum Inicjatyw Społeczno-Kulturalnych|Stary Wielisław| 61 a |57-313 Kłodzko;923;410;410;12;398;44.42;2.93
84016;020807;Przedszkole Gminne|Szalejów Dolny| 100 |57-314 Kłodzko;758;284;284;11;273;37.47;3.87
84017;020807;Dom Ludowy|Szalejów Górny| 1 |57-314 Kłodzko;680;295;295;13;282;43.38;4.41
84018;020807;Świetlica wiejska|Piszkowice| 59 h |57-315 Kłodzko;565;225;225;5;220;39.82;2.22
84019;020807;Świetlica wiejska|Święcko| 18 |57-441 Nowa Ruda;361;164;164;7;157;45.43;4.27
84020;020807;Przedszkole Gminne z Oddziałami Integracyjnymi|Bierkowice| 3 |57-315 Kłodzko;846;359;359;22;337;42.43;6.13
84021;020807;Dom Ludowy|Wojbórz| 138 |57-442 Nowa Ruda;964;327;327;16;311;33.92;4.89
84022;020807;Świetlica wiejska|Ławica| 8 |57-300 Kłodzko;720;327;327;18;309;45.42;5.50
84023;020808;Szkoła Podstawowa nr 1|Lądek-Zdrój|ul. Kościelna 31 |57-540 Lądek-Zdrój;961;378;378;13;365;39.33;3.44
84024;020808;Szkoła Podstawowa nr 1|Lądek-Zdrój|ul.Kościelna 31 |57-540 Lądek-Zdrój;899;418;418;21;397;46.50;5.02
84025;020808;Centrum Kultury i Rekreacji|Lądek-Zdrój|pl. Staromłyński 5 |57-540 Lądek-Zdrój;1579;769;769;30;739;48.70;3.90
84026;020808;Kinoteatr|Lądek-Zdrój|ul. Orla 7 |57-540 Lądek-Zdrój;1166;682;682;4;678;58.49;0.59
84027;020808;Gminne Przedszkole Publiczne|Lądek-Zdrój|ul. Paderewskiego 2 |57-540 Lądek-Zdrój;662;270;270;13;257;40.79;4.81
84028;020808;Budynek byłej Szkoły Podstawowej w Radochowie|Radochów| 104 |57-540 Lądek-Zdrój;857;345;345;18;327;40.26;5.22
84029;020808;Szkoła Podstawowa w Trzebieszowicach|Trzebieszowice| 150 |57-540 Lądek-Zdrój;1174;473;473;29;444;40.29;6.13
84030;020809;Zespół Szkolno-Przedszkolny|Lewin Kłodzki|ul. Kościelna 1 |57-343 Lewin Kłodzki;891;348;348;6;342;39.06;1.72
84031;020809;Gminna Spółdzielnia "SCh"|Jeleniów|Pl. Spółdzielczy 49 |57-343 Lewin Kłodzki;702;257;257;9;248;36.61;3.50
84032;020810;Miejsko - Gminny Ośrodek Kultury|Międzylesie|Plac Wolności 15 |57-530 Międzylesie;1087;484;484;22;462;44.53;4.55
84033;020810;Biblioteka Publiczna Miasta i Gminy|Międzylesie|ul. Wojska Polskiego 11 |57-530 Międzylesie;1159;438;438;11;427;37.79;2.51
84034;020810;Świetlica Wiejska|Boboszów| 11 |57-530 Międzylesie;347;121;121;3;118;34.87;2.48
84035;020810;Różańskie Centrum Informacji Wiejskiej|Różanka| 53 |57-530 Międzylesie;408;154;154;7;147;37.75;4.55
84036;020810;Świetlica wiejska|Roztoki| 34 |57-530 Międzylesie;556;197;197;11;186;35.43;5.58
84037;020810;Filia Biblioteki Publicznej Miasta i Gminy|Długopole Górne|Długopole Górne 79 |57-520 Długopole-Zdrój;598;210;210;9;201;35.12;4.29
84038;020810;Filia Miejsko-Gminnego Ośrodka Kultury- Dom Kultury|Domaszków|Kolejowa 3 |57-522 Domaszków;946;337;337;21;316;35.62;6.23
84039;020810;Świetlica Koła Gospodyń Wiejskich|Goworów| 14 |57-530 Międzylesie;538;245;245;15;230;45.54;6.12
84040;020810;Świetlica Wiejska|Pisary| 36 |57-530 Międzylesie;391;108;108;2;106;27.62;1.85
84041;020811;Szkoła Podstawowa|Jugów|ul. Główna 85 |57-430 Jugów;610;199;199;1;198;32.62;0.50
84042;020811;Szkoła Podstawowa|Jugów|ul. Główna 85 |57-430 Jugów;624;231;231;10;221;37.02;4.33
84043;020811;Publiczne Gimnazjum Nr 1|Jugów|Główna 105 |57-430 Jugów;514;201;201;4;197;39.11;1.99
84044;020811;Świetlica wiejska "Jugowianka"|Jugów|Główna 155 |57-430 Jugów;601;224;224;7;217;37.27;3.12
84045;020811;Centrum Kultury Gminy Nowa Ruda|Ludwikowice Kłodzkie|Fabryczna 2 |57-450 Ludwikowice Kłodzkie;729;267;267;19;248;36.63;7.12
84046;020811;Centrum Kultury Gminy Nowa Ruda|Ludwikowice Kłodzkie|Fabryczna 2 |57-450 Ludwikowice Kłodzkie;663;243;243;7;236;36.65;2.88
84047;020811;Świetlica wiejska|Sokolec| 3 |57-450 Ludwikowice Kłodzkie;469;185;185;5;180;39.45;2.70
84048;020811;Szkoła Podstawowa|Bożków| 89e |57-441 Bożków;640;304;304;20;284;47.50;6.58
84049;020811;Szkoła Podstawowa|Bożków| 89e |57-441 Bożków;691;279;279;14;265;40.38;5.02
84050;020811;Biblioteka Publiczna|Przygórze| 218 |57-431 Przygórze;582;225;225;12;213;38.66;5.33
84051;020811;Remiza strażacka|Wolibórz| 116 |57-431 Wolibórz;870;353;353;3;350;40.57;0.85
84052;020811;Hala sportowa|Dzikowiec| 95 |57-432 Dzikowiec;706;294;294;9;285;41.64;3.06
84053;020811;Świetlica wiejska|Świerki| 61 |57-451 Świerki;741;282;282;13;269;38.06;4.61
84054;020811;Szkoła Podstawowa|Włodowice| 25 |57-400 Nowa Ruda;667;261;261;5;256;39.13;1.92
84055;020811;Świetlica wiejska|Czerwieńczyce| 16 |57-441 Bożków;551;228;228;5;223;41.38;2.19
84056;020811;Dom Pomocy Społecznej|Jugów|Główna 118 |57-430 Jugów;72;39;39;6;33;54.17;15.38
84057;020812;Urząd Miasta i Gminy|Radków|ul.Rynek 1 |57-420 Radków;2165;843;843;49;794;38.94;5.81
84058;020812;Świetlica Rady Sołeckiej|Ratno Dolne| 57 |57-420 Radków;563;216;216;6;210;38.37;2.78
84059;020812;Zespół Szkolno-Przedszkolny|Wambierzyce|ul. Szpitalna 5 |57-420 Radków;954;343;343;30;313;35.95;8.75
84060;020812;Sala Widowiskowa|Ścinawka Średnia|ul.Mickiewicza 12c |57-420 Radków;1743;716;716;22;694;41.08;3.07
84061;020812;Centrum Inicjatyw Wiejskich|Ścinawka Górna| 18a |57-420 Radków;504;190;190;5;185;37.70;2.63
84062;020812;Zespół Szkolno-Przedszkolny|Ścinawka Dolna| 21a |57-420 Radków;1041;414;414;17;397;39.77;4.11
84063;020812;Sala Domu Ludowego|Tłumaczów| 72 |57-420 Radków;444;178;178;10;168;40.09;5.62
84064;020812;Dom Pomocy Społecznej|Ścinawka Dolna| 17 |57-420 Radków;56;18;18;0;18;32.14;0.00
84065;020813;Szkoła Podstawowa w Stroniu Śląskim|Stronie Śląskie|ul. Kościuszki 57 |57-550 Stronie Śląskie;1134;495;495;22;473;43.65;4.44
84066;020813;Przedszkole Miejskie w Stroniu Śląskim|Stronie Śląskie|ul. Nadbrzeżna 30 |57-550 Stronie Śląskie;1485;630;630;26;604;42.42;4.13
84067;020813;Zespół Szkół Samorządowych w Stroniu Śląskim|Stronie Śląskie|ul. Kościelna 12 |57-550 Stronie Śląskie;1156;444;444;10;434;38.41;2.25
84068;020813;Szkoła Podstawowa w Stroniu Śląskim|Stronie Śląskie|ul. Kościuszki 57 |57-550 Stronie Śląskie;1300;536;536;23;513;41.23;4.29
84069;020813;Świetlica wiejska "Trzy Siostry"|Stary Gierałtów| 7a |57-550 Stronie Śląskie;540;221;221;7;214;40.93;3.17
84070;020813;Świetlica Wiejska|Bolesławów| 41 |57-550 Stronie Śląskie;426;178;178;9;169;41.78;5.06
84071;020813;Wojewódzkie Centrum Psychiatrii Długoterminowej Samodzielny Publiczny ZOZ w Stroniu Śląskim Budynek ZOL A|Stronie Śląskie|Morawka 1 |57-550 Stronie Śląskie;45;18;18;3;15;40.00;16.67
84072;020814;Gimnazjum|Szczytna|ul. Wolności 80 |57-330 Szczytna;714;243;243;8;235;34.03;3.29
84073;020814;Szkoła Podstawowa im. Orła Białego|Szczytna|ul. Kościelna 6 |57-330 Szczytna;1563;700;700;30;670;44.79;4.29
84074;020814;Miejski Ośrodek Kultury|Szczytna|ul. Sienkiewicza 16 |57-330 Szczytna;1983;815;815;27;788;41.10;3.31
84075;020814;Świetlica Wiejska|Niwa| 24 |57-320 Polanica-Zdrój;527;204;204;5;199;38.71;2.45
84076;020814;Wiejskie Centrum Aktywności Społecznej|Łężyce| 49a |57-340 Duszniki-Zdrój;641;199;199;7;192;31.05;3.52
84077;020814;Dom Ludowy|Wolany| 4 3|57-300 Kłodzko;508;162;162;4;158;31.89;2.47
84078;020901;Miejski Ośrodek Kultury, Sportu i Reakreacji w Chojnowie|Chojnów|ul. Małachowskiego 7 |59-225 Chojnów;1368;657;657;13;644;48.03;1.98
84079;020901;Szkoła Podstawowa nr 3 w Chojnowie|Chojnów|ul. Kościuszki 30 |59-225 Chojnów;2183;832;832;38;794;38.11;4.57
84080;020901;Dom Schrama w Chojnowie|Chojnów|ul. Rynek 20 |59-225 Chojnów;2016;791;791;23;768;39.24;2.91
84081;020901;Miejska Biblioteka Publiczna w Chojnowie|Chojnów|pl. Zamkowy 2 |59-225 Chojnów;1267;552;552;13;539;43.57;2.36
84082;020901;Szkoła Podstawowa Nr 4 w Chojnowie (mały budynek)|Chojnów|ul. Kilińskiego 23 |59-225 Chojnów;1747;796;796;25;771;45.56;3.14
84083;020901;Szkoła Podstawowa Nr 4 w Chojnowie (duży budynek)|Chojnów|ul. Kilińskiego 23 |59-225 Chojnów;2422;1124;1124;26;1098;46.41;2.31
84084;020901;Dolnoślaski Ośrodek Pielęgnacyjny "Niebieski Parasol"|Chojnów|ul. Szpitalna 20 |59-225 Chojnów;65;14;14;2;12;21.54;14.29
84085;020902;Świetlica Wiejska|Biała| 85 |59-225 Chojnów;1195;555;555;6;549;46.44;1.08
84086;020902;Zespół Szkolno Przedszkolny|Rokitki| 32/A |59-225 Chojnów;1023;425;425;24;401;41.54;5.65
84087;020902;Punkt Biblioteczny|Witków| 34B |59-225 Chojnów;1238;445;445;24;421;35.95;5.39
84088;020902;Szkoła Podstawowa|Krzywa| 52 |59-225 Chojnów;499;152;152;8;144;30.46;5.26
84089;020902;Szkoła Podstawowa|Okmiany| 65 |59-225 Chojnów;578;197;197;19;178;34.08;9.64
84090;020902;Świetlica Wiejska|Osetnica| 26B |59-225 Chojnów;1093;426;426;20;406;38.98;4.69
84091;020902;Szkoła Podstawowa|Budziwojów| 21 |59-225 Chojnów;974;382;382;16;366;39.22;4.19
84092;020902;Punkt Przedszkolny Goliszów przy Szkole Podstawowej w Niedźwiedzicach z siedzibą w Goliszowie|Goliszów| 35 |59-225 Chojnów;1015;383;383;15;368;37.73;3.92
84093;020903;Zespół Szkół w Krotoszycach|Krotoszyce|ul.Piastowska 41 |59-223 Krotoszyce;1193;568;568;31;537;47.61;5.46
84094;020903;Świetlica Wiejska|Winnica| 37 A |59-223 Krotoszyce;423;210;210;4;206;49.65;1.90
84095;020903;Szkoła Podstawowa im. H. Sienkiewicza|Kościelec| 9 |59-223 Krotoszyce;937;406;406;15;391;43.33;3.69
84096;020904;Świetlica Wiejska|Bieniowice| 15 |59-216 Kunice;1049;468;468;4;464;44.61;0.85
84097;020904;Szkoła Podstawowa|Kunice|ul. Staropolska 4 |59-216 Kunice;1291;764;764;12;752;59.18;1.57
84098;020904;Szkoła Podstawowa|Rosochata| 65 |59-216 Kunice;1047;439;439;12;427;41.93;2.73
84099;020904;Hala widowiskowo-sportowa przy Gimnazjum|Spalona|ul. Legnicka 52A |59-216 Kunice;844;464;464;9;455;54.98;1.94
84100;020904;Świetlica Wiejska|Grzybiany|ul. Legnicka 66 |59-216 Kunice;735;459;459;5;454;62.45;1.09
84101;020905;Zespół Szkół|Legnickie Pole|ul. Kosmy Damiana Asama 7 |59-241 Legnickie Pole;1154;602;602;15;587;52.17;2.49
84102;020905;Świetlica wiejska|Raczkowa| 1 |59-241 Legnickie Pole;419;180;180;7;173;42.96;3.89
84103;020905;Świetlica wiejska|Koskowice| 68 |59-241 Legnickie Pole;1163;565;565;8;557;48.58;1.42
84104;020905;Świetlica wiejska|Nowa Wieś Legnicka| 56 |59-241 Legnickie Pole;475;208;208;8;200;43.79;3.85
84105;020905;Zespół Szkół w Legnickim Polu - budynek w Mikołajowicach|Mikołajowice| 44 |59-241 Legnickie Pole;513;185;185;17;168;36.06;9.19
84106;020905;Świetlica Domu Pomocy Społecznej w Legnickim Polu|Legnickie Pole|Benedyktynów 4 |59-241 Legnickie Pole;54;25;25;3;22;46.30;12.00
84107;020906;Świetlica Środowiskowa|Gniewomirowice| nr 32 A |59-222 Miłkowice;455;220;220;6;214;48.35;2.73
84108;020906;Świetlica Wiejska przy Remizie Ochotniczej Straży Pożarnej|Grzymalin| nr 50 |59-222 Miłkowice;506;253;253;5;248;50.00;1.98
84109;020906;Świetlica Wiejska|Jakuszów| nr 1A |59-222 Miłkowice;574;263;263;8;255;45.82;3.04
84110;020906;Szkolno - Gimnazjalny Zespół Szkół|Miłkowice|ul. II Armii Wojska Polskiego nr 75 |59-222 Miłkowice;1493;667;667;29;638;44.68;4.35
84111;020906;Świetlica Wiejska|Rzeszotary|ul. Wiejska nr 66 |59-222 Miłkowice;797;424;424;13;411;53.20;3.07
84112;020906;Świetlica Środowiskowa|Ulesie| nr 99 |59-222 Miłkowice;563;259;259;10;249;46.00;3.86
84113;020906;Świetlica Wiejska w Gminnym Ośrodku Kultury i Sportu|Siedliska| nr 6 |59-222 Miłkowice;434;222;222;6;216;51.15;2.70
84114;020906;Świetlica Klubu Sportowego "Iskra"|Kochlice|ul. Sportowa nr 19 |59-222 Miłkowice;359;174;174;7;167;48.47;4.02
84115;020907;Szkoła Podstawowa|Prochowice|ul. Młyńska 3 |59-230 Prochowice;1281;662;662;39;623;51.68;5.89
84116;020907;Prochowicki Ośrodek Kultury i Sportu|Prochowice|ul. Karola Miarki 5 |59-230 Prochowice;1270;538;538;19;519;42.36;3.53
84117;020907;Przychodnia Rejonowa|Prochowice|ul. Antoniego Rymszy 3 |59-230 Prochowice;756;386;386;13;373;51.06;3.37
84118;020907;Świetlica Wiejska|Rogów Legnicki| 26 |59-230 Prochowice;938;449;450;24;425;47.87;5.35
84119;020907;Szkoła Podstawowa|Dąbie| 5a |59-230 Prochowice;651;199;199;9;190;30.57;4.52
84120;020907;Świetlica Wiejska|Lisowice| 90b |59-230 Prochowice;1137;517;517;33;484;45.47;6.38
84121;020908;Świetlica wiejska w Wągrodnie|Wągrodno| 59 |59-243 Ruja;912;293;293;15;278;32.13;5.12
84122;020908;Gimnazjum w Rui|Ruja| 61 |59-243 Ruja;1146;361;361;9;352;31.50;2.49
84123;020908;Dom Pomocy Społecznej "Prząśnik" w Brenniku|Brennik| 24 |59-243 Ruja;86;31;31;4;27;36.05;12.90
84124;021001;Galeria Łużycka - Tret|Lubań|Rynek-Sukiennice 38 |59-800 Lubań;1698;750;750;22;728;44.17;2.93
84125;021001;Miejski Ośrodek Pomocy Społecznej|Lubań|Pl. Lompy 1 |59-800 Lubań;1700;787;787;14;773;46.29;1.78
84126;021001;Gimnazjum Nr 2|Lubań|ul. Mickiewicza 1 |59-800 Lubań;1517;666;666;13;653;43.90;1.95
84127;021001;Szkoła Podstawowa Nr 1|Lubań|ul. Mickiewicza 1 |59-800 Lubań;751;274;274;4;270;36.48;1.46
84128;021001;Przedszkole Miejskie Nr 5|Lubań|ul. Mieszka II 1 |59-800 Lubań;1629;803;803;12;791;49.29;1.49
84129;021001;Zespół Szkół Ponadgimnazjalnych|Lubań|ul. Wł. Łokietka 2 |59-800 Lubań;1681;896;896;18;878;53.30;2.01
84130;021001;Świetlica Spółdzielni Mieszkaniowej|Lubań|ul. Łużycka 1 |59-800 Lubań;1690;697;697;10;687;41.24;1.43
84131;021001;Zespół Szkół Ponadgimnazjalnych|Lubań|ul. Kopernika 31 |59-800 Lubań;1641;744;744;12;732;45.34;1.61
84132;021001;Szkoła Podstawowa Nr 4|Lubań|ul. Kopernika 15 |59-800 Lubań;953;456;456;9;447;47.85;1.97
84133;021001;Żłobek Miejski|Lubań|ul. Różana 1 |59-800 Lubań;1684;703;703;13;690;41.75;1.85
84134;021001;Miejski Dom Kultury|Lubań|ul. Kościuszki 4 |59-800 Lubań;824;372;372;6;366;45.15;1.61
84135;021001;Gimnazjum Nr 1|Lubań|ul. Skalnicza 3 |59-800 Lubań;918;371;371;9;362;40.41;2.43
84136;021001;Szkoła Podstawowa Nr 2|Lubań|ul. Dolna 8 |59-800 Lubań;896;420;420;13;407;46.88;3.10
84137;021001;Niepubliczny Zakład Opieki Zdrowotnej Łużyckie Centrum Medyczne|Lubań|ul. Zawidowska 4 |59-800 Lubań;43;21;21;3;18;48.84;14.29
84138;021001;Areszt Śledczy|Lubań|ul. Podwale 1 |59-800 Lubań;119;70;70;5;65;58.82;7.14
84139;021002;Miejski Zespół Szkół|Świeradów-Zdrój|ul. Skłodowskiej-Curie 2 |59-850 Świeradów-Zdrój;1003;471;471;13;458;46.96;2.76
84140;021002;Miejski Zespół Szkół|Świeradów-Zdrój|ul. Skłodowskiej-Curie 2 |59-850 Świeradów-Zdrój;955;449;449;7;442;47.02;1.56
84141;021002;Miejski Zespół Szkół|Świeradów-Zdrój|ul. Skłodowskiej-Curie 2 |59-850 Świeradów-Zdrój;965;390;390;18;372;40.41;4.62
84142;021002;Szkoła Podstawowa Nr 2|Świeradów-Zdrój|ul. Sanatoryjna 3 |59-850 Świeradów-Zdrój;771;302;302;8;294;39.17;2.65
84143;021002;Uzdrowisko Świeradów-Czerniawa Spółka z o.o. Grupa PGU Szpital Centrum Rehabilitacji i Reumatologii "Goplana"|Świeradów-Zdrój|ul. Piłsudskiego 33 |59-850 Świeradów-Zdrój;33;28;28;1;27;84.85;3.57
84144;021003;Ośrodek Kultury i Sportu|Leśna|ul. Świerczewskiego 5a |59-820 Leśna;1528;683;683;24;659;44.70;3.51
84145;021003;Gimnazjum w Leśnej|Leśna|ul. Kościuszki 7-9 |59-820 Leśna;1597;708;708;20;688;44.33;2.82
84146;021003;Szkoła Podstawowa im. J. Pawła II|Smolnik| 52 |59-820 Leśna;1385;532;532;11;521;38.41;2.07
84147;021003;Zespół Szkolno-Przedszkolny w Pobiednej|Pobiedna|ul. Dworcowa 2 |59-814 Pobiedna;1200;420;420;24;396;35.00;5.71
84148;021003;Świetlica Wiejska w Świeciu|Świecie| 196A |59-820 Leśna;472;167;167;11;156;35.38;6.59
84149;021003;Świetlica Wiejska w Szyszkowej|Szyszkowa| 65 |59-820 Leśna;708;274;274;20;254;38.70;7.30
84150;021003;Świetlica OSP w Złotnikach Lubańskich|Złotniki Lubańskie| 43 |59-820 Leśna;632;245;245;7;238;38.77;2.86
84151;021003;Świetlica Wiejska w Grabiszycach Górnych|Grabiszyce Górne| 2 |59-820 Leśna;610;187;187;8;179;30.66;4.28
84152;021004;Budynek po szkole podstawowej w Henrykowie Lubańskim|Henryków Lubański| 385 |59-800 Lubań;671;234;234;14;220;34.87;5.98
84153;021004;Świetlica wiejska w Kościelniku|Kościelnik| 18A |59-800 Lubań;928;407;407;16;391;43.86;3.93
84154;021004;Świetlica wiejska w Mściszowie|Mściszów| 86 |59-800 Lubań;286;108;108;9;99;37.76;8.33
84155;021004;Świetlica wiejska w Radogoszczy|Radogoszcz| 60 |59-800 Lubań;313;151;151;3;148;48.24;1.99
84156;021004;Świetlica wiejska w Nawojowie Łużyckim|Nawojów Łużycki| 76 |59-800 Lubań;537;180;180;10;170;33.52;5.56
84157;021004;Remiza Ochotniczej Straży Pożarnej w Pisarzowicach|Pisarzowice| 274A |59-800 Lubań;1264;531;531;24;507;42.01;4.52
84158;021004;Świetlica wiejska w Radostowie Średnim|Radostów Średni| 24a |59-800 Lubań;813;270;270;12;258;33.21;4.44
84159;021004;Sołtysówka|Lubań|ul. Różana 18 |59-800 Lubań;390;193;193;2;191;49.49;1.04
84160;021005;Gminne Gimnazjum Publiczne|Olszyna|ul. Wolności 17 |59-830 Olszyna;1955;727;727;22;705;37.19;3.03
84161;021005;Gminny Ośrodek Kultury|Olszyna|ul. Wolności 20D |59-830 Olszyna;1947;761;761;25;736;39.09;3.29
84162;021005;Świetlica Wiejska|Biedrzychowice| 24B |59-830 Olszyna;1072;457;457;20;437;42.63;4.38
84163;021005;Świetlica Wiejska|Grodnica| 44 |59-830 Olszyna;373;136;136;5;131;36.46;3.68
84164;021006;Szkoła Podstawowa w Platerówce|Platerówka| 213 |59-816 Platerówka;704;283;283;7;276;40.20;2.47
84165;021006;Gimnazjum we Włosieniu|Włosień| 207 |59-816 Platerówka;603;281;281;3;278;46.60;1.07
84166;021007;Dom Kultury w Siekierczynie|Siekierczyn| 1 |59-818 Siekierczyn;1689;716;716;32;684;42.39;4.47
84167;021007;Zespół Szkół w Zarębie|Zaręba|ul. Szkolna 2 |59-800 Lubań;1611;688;688;28;660;42.71;4.07
84168;021007;Rudzica Nr 135 (dawna szkoła podstawowa)|Rudzica| 135 |59-818 Siekierczyn;364;137;137;8;129;37.64;5.84
84169;021007;Zakład Karny w Zarębie|Zaręba|ul. Leśna 4 |59-800 Lubań;421;232;232;31;201;55.11;13.36
84170;021101;Przedszkole Miejskie Nr 9|Lubin|ul. Szkolna 23 |59-300 Lubin;971;442;442;15;427;45.52;3.39
84171;021101;Szkoła Podstawowa Nr 5|Lubin|ul. Kilińskiego 12 |59-300 Lubin;1244;582;582;18;564;46.78;3.09
84172;021101;Gimnazjum Nr 5|Lubin|ul. Szkolna 25 |59-300 Lubin;1469;648;648;9;639;44.11;1.39
84173;021101;Gimnazjum Nr 5|Lubin|ul. Szkolna 25 |59-300 Lubin;1590;753;753;32;721;47.36;4.25
84174;021101;Zespół Szkół i Placówek Oświatowych|Lubin|ul. Składowa 3 |59-300 Lubin;1159;584;584;18;566;50.39;3.08
84175;021101;Żłobek Nr 2|Lubin|ul. Cedyńska 13 |59-300 Lubin;1005;484;484;10;474;48.16;2.07
84176;021101;Przedszkole Miejskie Nr 3|Lubin|ul. Kilińskiego 35 |59-300 Lubin;1367;718;718;28;690;52.52;3.90
84177;021101;Przedszkole Miejskie Nr 4|Lubin|ul. Kościuszki 10 |59-300 Lubin;1305;718;718;9;709;55.02;1.25
84178;021101;II Liceum Ogólnokształcące|Lubin|Aleja Niepodległości 31 |59-300 Lubin;1421;645;645;15;630;45.39;2.33
84179;021101;Zespół Szkół Integracyjnych|Lubin|ul. Skłodowskiej - Curie 4 |59-300 Lubin;1514;775;775;18;757;51.19;2.32
84180;021101;I Liceum Ogólnokształcące|Lubin|ul. Kopernika 7 |59-300 Lubin;1279;638;638;18;620;49.88;2.82
84181;021101;I Liceum Ogólnokształcące|Lubin|ul. Kopernika 7 |59-300 Lubin;1343;617;617;21;596;45.94;3.40
84182;021101;Przedszkole Miejskie Nr 6|Lubin|ul. Łużycka 6 |59-300 Lubin;1311;644;644;15;629;49.12;2.33
84183;021101;Zespół Szkół Sportowych|Lubin|ul. Sybiraków 11 |59-300 Lubin;1481;773;773;19;754;52.19;2.46
84184;021101;Ośrodek Opiekuńczo-Rehabilitacyjny|Lubin|ul. Jastrzębia 1 |59-300 Lubin;1521;825;825;17;808;54.24;2.06
84185;021101;Przedszkole Miejskie Nr 12|Lubin|ul. Jastrzębia 2 |59-300 Lubin;1481;798;798;18;780;53.88;2.26
84186;021101;Szkoła Podstawowa Nr 9|Lubin|ul. Legnicka 1 |59-300 Lubin;1034;561;561;15;546;54.26;2.67
84187;021101;Szkoła Podstawowa Nr 9|Lubin|ul. Legnicka 1 |59-300 Lubin;1478;836;836;24;812;56.56;2.87
84188;021101;Szkoła Podstawowa Nr 10|Lubin|ul. Prymasa Wyszyńskiego 3 |59-300 Lubin;1153;635;635;10;625;55.07;1.57
84189;021101;Gimnazjum Nr 1|Lubin|ul. Szpakowa 2 |59-300 Lubin;1128;593;593;18;575;52.57;3.04
84190;021101;Przedszkole Miejskie Nr 15|Lubin|ul. Orla 75 |59-300 Lubin;1163;677;677;15;662;58.21;2.22
84191;021101;Żłobek Nr 3|Lubin|ul. Orla 47a |59-300 Lubin;1219;824;824;4;820;67.60;0.49
84192;021101;Zespół Szkół Nr 2|Lubin|ul. Szpakowa 1 |59-300 Lubin;1170;678;678;8;670;57.95;1.18
84193;021101;Zespół Szkół Nr 2|Lubin|ul. Szpakowa 1 |59-300 Lubin;942;534;534;11;523;56.69;2.06
84194;021101;Przedszkole Miejskie Nr 14|Lubin|ul. Sokola 44 |59-300 Lubin;1591;1038;1038;13;1025;65.24;1.25
84195;021101;Przedszkole Miejskie Nr 14|Lubin|ul. Sokola 44 |59-300 Lubin;1414;785;785;27;758;55.52;3.44
84196;021101;Szkoła Podstawowa Nr 12|Lubin|ul. Sowia 7 |59-300 Lubin;1269;788;788;11;777;62.10;1.40
84197;021101;Szkoła Podstawowa Nr 12|Lubin|ul. Sowia 7 |59-300 Lubin;1354;818;825;17;801;60.41;2.08
84198;021101;Szkoła Podstawowa|Krzeczyn Wielki| 9 |59-311 Lubin;742;488;488;8;480;65.77;1.64
84199;021101;Przedszkole Nr 10 z Odziałami Integracyjnymi|Lubin|ul. II Armii Wojska Polskiego 21 |59-300 Lubin;820;477;477;6;471;58.17;1.26
84200;021101;Szkoła Podstawowa Nr 8|Lubin|ul. Parkowa 2 |59-300 Lubin;1287;746;746;15;731;57.96;2.01
84201;021101;Szkoła Podstawowa Nr 8|Lubin|ul. Parkowa 2 |59-300 Lubin;1097;617;617;16;601;56.24;2.59
84202;021101;Pałac Ślubów|Lubin|ul. Skłodowskiej - Curie 6 |59-300 Lubin;719;330;330;10;320;45.90;3.03
84203;021101;Szkoła Podstawowa Nr 8|Lubin|ul. Parkowa 2 |59-300 Lubin;1727;992;992;15;977;57.44;1.51
84204;021101;Przedszkole Miejskie Nr 7|Lubin|ul. Osiedlowa 7A |59-300 Lubin;1313;781;781;9;772;59.48;1.15
84205;021101;Przedszkole Miejskie Nr 7|Lubin|ul. Osiedlowa 7A |59-300 Lubin;1342;732;732;26;706;54.55;3.55
84206;021101;Przedszkole Miejskie Nr 1|Lubin|ul. Krupińskiego 17 |59-300 Lubin;1422;784;784;23;761;55.13;2.93
84207;021101;Przedszkole Miejskie Nr 1|Lubin|ul. Krupińskiego 17 |59-300 Lubin;1610;876;876;26;850;54.41;2.97
84208;021101;Zespół Szkół Nr 3|Lubin|ul. Gwarków 93 |59-300 Lubin;1525;884;884;16;868;57.97;1.81
84209;021101;Zespół Szkół Nr 3|Lubin|ul. Gwarków 93 |59-300 Lubin;1534;933;933;17;916;60.82;1.82
84210;021101;Gimnazjum Nr 4|Lubin|ul. Konopnickiej 5 |59-300 Lubin;1362;787;787;12;775;57.78;1.52
84211;021101;Gimnazjum Nr 4|Lubin|ul. Konopnickiej 5 |59-300 Lubin;1299;742;742;16;726;57.12;2.16
84212;021101;Przedszkole Miejskie Nr 5|Lubin|ul. Orzeszkowej 11 |59-300 Lubin;946;533;533;9;524;56.34;1.69
84213;021101;Przedszkole Miejskie Nr 5|Lubin|ul. Orzeszkowej 11 |59-300 Lubin;1062;621;621;15;606;58.47;2.42
84214;021101;Szkoła Podstawowa Nr 14|Lubin|ul. Norwida 10 |59-300 Lubin;929;589;589;9;580;63.40;1.53
84215;021101;Szkoła Podstawowa Nr 14|Lubin|ul. Norwida 10 |59-300 Lubin;1026;611;611;20;591;59.55;3.27
84216;021101;Regionalne Centrum Zdrowia Spółka z o.o.|Lubin|Gen. Józefa Bema 5-6 |59-300 Lubin;85;56;56;1;55;65.88;1.79
84217;021101;Miedziowe Centrum Zdrowia S.A. budynek szpitala D-40|Lubin|M. Skłodowskiej-Curie 54 |59-300 Lubin;93;57;57;3;54;61.29;5.26
84218;021101;Cuprum-Med Spółka z o.o.|Lubin|M. Skłodowskiej-Curie 70 |59-300 Lubin;27;5;5;0;5;18.52;0.00
84219;021102;Szkoła Podstawowa|Krzeczyn Wielki| 9 |59-311 Lubin;1281;712;712;22;690;55.58;3.09
84220;021102;Szkoła Podstawowa|Siedlce| 29 |59-300 Lubin;2171;1044;1044;27;1017;48.09;2.59
84221;021102;Szkoła Podstawowa|Raszówka|ul. 1 Maja 10 |59-307 Lubin;1109;581;581;19;562;52.39;3.27
84222;021102;Świetlica wiejska|Obora|ul. Tulipanowa 2 |59-335 Lubin;1049;589;589;13;576;56.15;2.21
84223;021102;Świetlica wiejska|Miłoradzice| 80 |59-323 Lubin;805;431;433;18;413;53.54;4.18
84224;021102;Szkoła Podstawowa|Niemstów| 68 |59-323 Lubin;780;343;343;11;332;43.97;3.21
84225;021102;Szkoła Podstawowa|Szklary Górne| 48 |59-335 Lubin;864;480;480;20;460;55.56;4.17
84226;021102;Pawilon Klubowo-Sportowy|Zimna Woda| 45C |59-307 Lubin;766;329;329;16;313;42.95;4.86
84227;021102;Świetlica wiejska|Chróstnik| 2a |59-311 Lubin;747;444;444;16;428;59.44;3.60
84228;021102;Świetlica wiejska|Osiek|ul. Miedziana 69 |59-300 Lubin;1347;858;858;19;839;63.70;2.21
84229;021102;Świetlica wiejska|Pieszków| 26a |59-323 Lubin;767;368;368;11;357;47.98;2.99
84230;021103;Sala "ORLIK 2012"|Rudna|ul. Leśna |59-305 Rudna;807;434;434;27;407;53.78;6.22
84231;021103;Gimnazjum w Rudnej|Rudna|ul. Piaskowa 3b |59-305 Rudna;1294;744;744;26;718;57.50;3.49
84232;021103;Świetlica Wiejska|Mleczno| 12 |59-305 Rudna;874;457;457;28;429;52.29;6.13
84233;021103;Świetlica Wiejska|Kębłów| 14a |59-305 Rudna;770;335;335;21;314;43.51;6.27
84234;021103;Świetlica Wiejska|Kliszów| 15 |59-305 Rudna;774;341;341;12;329;44.06;3.52
84235;021103;Chobieński Ośrodek Kultury|Chobienia|ul. Rynek 6 |59-305 Rudna;765;332;332;14;318;43.40;4.22
84236;021103;Przedszkole w Chobieni|Chobienia|ul. Nadrzeczna 11a |59-305 Rudna;847;433;433;21;412;51.12;4.85
84237;021104;Gimnazjum Publiczne|Ścinawa|ul. Lipowa 1 |59-330 Ścinawa;1349;723;723;30;693;53.60;4.15
84238;021104;Centrum Turystyki i Kultury|Ścinawa|ul. T. Kościuszki 1 |59-330 Ścinawa;1676;829;829;36;793;49.46;4.34
84239;021104;Budynek po siedzibie Centrum Turystyki i Kultury|Ścinawa|ul. Jana Pawła II 17 |59-330 Ścinawa;1475;721;721;20;701;48.88;2.77
84240;021104;Szkoła Podstawowa|Tymowa| 71 |59-330 Ścinawa;1096;481;481;22;459;43.89;4.57
84241;021104;Świetlica Wiejska|Przychowa| 29 |59-330 Ścinawa;429;188;188;12;176;43.82;6.38
84242;021104;Centrum Turystyki i Kultury|Ścinawa|ul.T. Kościuszki 1 |59-330 Ścinawa;497;175;175;6;169;35.21;3.43
84243;021104;Remiza Strażacka|Parszowice| 36A |59-330 Ścinawa;791;338;338;10;328;42.73;2.96
84244;021104;Świetlica Wiejska|Zaborów| 50 |59-330 Ścinawa;789;315;315;23;292;39.92;7.30
84245;021201;Gimnazjum sala gimnastyczna|Gryfów Śląski|ul. Uczniowska 11a |59-620 Gryfów Śląski;1589;616;616;20;596;38.77;3.25
84246;021201;Szkoła Podstawowa|Gryfów Śląski|ul. Uczniowska 17 |59-620 Gryfów Śląski;1255;556;556;15;541;44.30;2.70
84247;021201;Miejsko-Gminny Ośrodek Kultury|Gryfów Śląski|ul. Kolejowa 33a |59-620 Gryfów Śląski;1703;719;719;22;697;42.22;3.06
84248;021201;Urząd Gminy i Miasta Ratusz - parter|Gryfów Śląski|ul. Rynek 1 |59-620 Gryfów Śląski;2028;724;724;35;689;35.70;4.83
84249;021201;Szkoła Podstawowa w Rząsinach|Rząsiny| 94 |59-620 Gryfów Śląski;480;180;180;16;164;37.50;8.89
84250;021201;Szkoła Podstawowa w Uboczu|Ubocze| 169 |59-620 Gryfów Ślaski;1001;429;429;11;418;42.86;2.56
84251;021201;Szpital w Gryfowie Śląskim|Gryfów Śląski|ul. Rzeczna 25 |59-620 Gryfów Śląski;47;30;30;2;28;63.83;6.67
84252;021202;Internat Zespołu Szkół w Lubomierzu - Sala Teatralna|Lubomierz|Plac Kościelny 5 |59-623 Lubomierz;1646;626;626;26;600;38.03;4.15
84253;021202;Szkoła Podstawowa|Pławna Górna| 23 |59-623 Lubomierz;879;317;317;19;298;36.06;5.99
84254;021202;Przedszkole Miejskie w Lubomierzu Oddział Przedszkolny Filia w Pasieczniku|Pasiecznik| 92 |59-623 Lubomierz;555;217;217;6;211;39.10;2.76
84255;021202;Świetlica Wiejska w Chmieleniu|Chmieleń| 80 |59-623 Lubomierz;756;272;272;9;263;35.98;3.31
84256;021202;Filia Szkoły Podstawowej w Pławnej z siedzibą w Wojciechowie|Wojciechów| 35 |59-623 Lubomierz;575;205;205;5;200;35.65;2.44
84257;021202;Świetlica Wiejska w Olesznej Podgórskiej|Oleszna Podgórska| 67A |59-623 Lubomierz;432;155;155;13;142;35.88;8.39
84258;021202;Szpital Rehabilitacyjny Jolly Med w Popielówku|Popielówek| 1 |59-623 Lubomierz;77;43;43;2;41;55.84;4.65
84259;021203;Ratusz|Lwówek Śląski|Plac Wolności 1 |59-600 Lwówek Śląski;1806;854;854;21;833;47.29;2.46
84260;021203;Hala Sportowa|Lwówek Śląski|Aleja Wojska Polskiego 1 |59-600 Lwówek Śląski;936;448;448;13;435;47.86;2.90
84261;021203;Zespół Szkół Ogólnokształcących i Zawodowych|Lwówek Śląski|ul. Henryka Brodatego 1 |59-600 Lwówek Śląski;969;431;431;4;427;44.48;0.93
84262;021203;Budynek byłych "PZZ-ów"|Lwówek Śląski|ul. Jaśkiewicza 20 |59-600 Lwówek Śląski;1154;525;525;9;516;45.49;1.71
84263;021203;Gimnazjum im. Jana Pawła II|Lwówek Śląski|ul. Jana Pawła II 35 |59-600 Lwówek Śląski;1994;898;898;8;890;45.04;0.89
84264;021203;Szkoła Podstawowa Nr 3|Lwówek Śląski|ul. Pałacowa 11 |59-600 Lwówek Śląski;899;410;410;8;402;45.61;1.95
84265;021203;Powiatowa i Miejska Biblioteka Publiczna w Lwówku Śląskim Filia w Sobocie|Sobota| 51 |59-600 Lwówek Śląski;893;271;271;12;259;30.35;4.43
84266;021203;Szkoła Podstawowa nr 3 w Lwówku Śląskim Filia w Zbylutowie|Zbylutów| 133 |59-600 Lwówek Śląski;880;313;313;12;301;35.57;3.83
84267;021203;Powiatowa i Miejska Biblioteka Publiczna w Lwówku Śląskim Filia w Chmielnie|Chmielno| 50 |59-600 Lwówek Śląski;841;247;247;10;237;29.37;4.05
84268;021203;Powiatowa i Miejska Biblioteka Publiczna w Lwówku Śląskim Filia w Kotliskach|Kotliska| 26 |59-600 Lwówek Śląski;1002;355;355;17;338;35.43;4.79
84269;021203;Szkoła Podstawowa w Niwnicach|Niwnice| 149 |59-600 Lwówek Śląski;865;266;266;14;252;30.75;5.26
84270;021203;Szkoła Podstawowa w Płóczkach Górnych|Płóczki Górne| 58 |59-600 Lwówek Śląski;937;287;287;16;271;30.63;5.57
84271;021203;Zespół Szkół Ekonomiczno - Technicznych w Rakowicach Wielkich|Rakowice Wielkie| 48 |59-600 Lwówek Śląski;962;373;373;11;362;38.77;2.95
84272;021204;Biblioteka Publiczna Miasta i Gminy Mirsk|Mirsk|Plac Wolności 39 |59-630 Mirsk;1733;703;703;36;667;40.57;5.12
84273;021204;Środowiskowy Klub Profilaktyczno-Integracyjny|Mirsk|Plac Wolności 15 |59-630 Mirsk;1951;776;776;44;732;39.77;5.67
84274;021204;Szkoła Podstawowa Giebułtów|Giebułtówek| 1 |59-630 Mirsk;1060;401;401;26;375;37.83;6.48
84275;021204;Szkoła Podstawowa Krobica|Krobica| 33 |59-630 Mirsk;1125;419;419;21;398;37.24;5.01
84276;021204;Szkoła Podstawowa Rębiszów|Rębiszów| 125 |59-630 Mirsk;1115;434;434;17;417;38.92;3.92
84277;021204;Dom Pomocy Społecznej w Mirsku|Mirsk|ul. Zielona 12 |59-630 Mirsk;64;27;27;6;21;42.19;22.22
84278;021205;Zespół Szkół im. św. Jadwigi Śląskiej we Wleniu|Wleń|ul. Dworcowa 10 |59-610 Wleń;1514;698;698;25;673;46.10;3.58
84279;021205;Ośrodek Kultury, Sportu i Turystyki|Wleń|ul. Fryderyka Chopina 2 |59-610 Wleń;610;194;194;13;181;31.80;6.70
84280;021205;Centrum Kulturalno Sportowe|Pilchowice| 42 |59-610 Wleń;955;378;378;14;364;39.58;3.70
84281;021205;Świetlica Wiejska|Marczów| 18 |59-610 Wleń;440;158;158;8;150;35.91;5.06
84282;021205;Ośrodek Rehabilitacyjno-Opiekuńczy Sióstr Św. Elżbiety|Wleń|ul. Jana Kazimierza 1 |59-610 Wleń;43;40;40;2;38;93.02;5.00
84283;021205;Dom Pomocy Społecznej w Nielestnie|Nielestno| 17 |59-610 Wleń;57;31;31;10;21;54.39;32.26
84284;021301;Gminne Centrum Kultury w Cieszkowie|Cieszków|ul.Gen.Władysława Sikorskiego 35 |56-330 Cieszków;2254;1073;1073;22;1051;47.60;2.05
84285;021301;Świetlica wiejska w Trzebicku|Trzebicko| 33 |56-330 Cieszków;514;192;192;8;184;37.35;4.17
84286;021301;Szkoła Podstawowa w Pakosławsku|Pakosławsko| 58 |56-330 Cieszków;980;388;388;17;371;39.59;4.38
84287;021302;Centrum Edukacyjno - Turystyczno - Sportowe w Krośnicach|Krośnice|ul.Sanatoryjna 19 |56-320 Krośnice;1902;845;845;30;815;44.43;3.55
84288;021302;Zespół Szkół Szkoła Podstawowa i Gimnazjum w Bukowicach|Bukowice|ul. Wrocławska 43 |56-321 Bukowice;2315;957;957;43;914;41.34;4.49
84289;021302;Zespół Szkół Szkoła Podstawowa i Gimnazjum w Kuźnicy Czeszyckiej|Kuźnica Czeszycka| 1 |56-320 Krośnice;943;348;348;26;322;36.90;7.47
84290;021302;Świetlica Środowiskowa w Wierzchowicach|Wierzchowice|ul. Kościelna 3a |56-320 Krośnice;1148;418;418;17;401;36.41;4.07
84291;021302;Dom Pomocy Społecznej|Krośnice|ul. Kwiatowa 9 |56-320 Krośnice;75;32;32;11;21;42.67;34.38
84292;021303;Pogotowie Ratunkowe w Miliczu|Milicz|ul. Krotoszyńska 6 |56-300 Milicz;1704;742;742;51;691;43.54;6.87
84293;021303;Gimnazjum w Miliczu|Milicz|ul. Armii Krajowej 7 |56-300 Milicz;1512;694;694;18;676;45.90;2.59
84294;021303;Gimnazjum w Miliczu|Milicz|ul. Armii Krajowej 7 |56-300 Milicz;759;403;403;16;387;53.10;3.97
84295;021303;Zespół Szkół w Miliczu|Milicz|ul.Trzebnicka 4 |56-300 Milicz;1851;1034;1034;10;1024;55.86;0.97
84296;021303;Szkoła Podstawowa w Miliczu|Milicz|ul. Mikołaja Kopernika 18 |56-300 Milicz;1303;677;677;16;661;51.96;2.36
84297;021303;Szkoła Podstawowa w Miliczu|Milicz|ul. Mikołaja Kopernika 18 |56-300 Milicz;1029;466;466;15;451;45.29;3.22
84298;021303;Nadleśnictwo Państwowe w Miliczu|Milicz|ul. Trzebnicka 18 |56-300 Milicz;1203;663;663;23;640;55.11;3.47
84299;021303;Gimnazjum we Wróblińcu|Wróbliniec| 24 |56-300 Milicz;432;135;135;11;124;31.25;8.15
84300;021303;Szkoła Podstawowa w Czatkowicach|Czatkowice|ul. Szosowa 2 |56-300 Milicz;659;266;266;13;253;40.36;4.89
84301;021303;Świetlica Wiejska w Gądkowicach|Gądkowice| 45a |56-300 Milicz;962;316;316;25;291;32.85;7.91
84302;021303;Świetlica Wiejska w Ostrowąsach|Ostrowąsy| 31 |56-300 Milicz;426;168;168;12;156;39.44;7.14
84303;021303;Świetlica Wiejska w Potaszni|Potasznia| 12 |56-300 Milicz;706;244;244;9;235;34.56;3.69
84304;021303;Szkoła Podstawowa w Nowym Grodzisku|Nowe Grodzisko| 9 |56-300 Milicz;331;145;145;5;140;43.81;3.45
84305;021303;Świetlica Wiejska we Wszewilkach|Wszewilki| 51a |56-300 Milicz;956;392;392;10;382;41.00;2.55
84306;021303;Szkoła Podstawowa w Dunkowej|Dunkowa| 1 |56-300 Milicz;945;305;305;16;289;32.28;5.25
84307;021303;Szkoła Podstawowa w Sułowie|Sułów|ul. Szkolna 6 |56-300 Milicz;1254;593;593;23;570;47.29;3.88
84308;021303;Szkoła Podstawowa w Sułowie|Sułów|ul. Szkolna 6 |56-300 Milicz;507;215;215;2;213;42.41;0.93
84309;021303;Świetlica Wiejska w Sławoszowicach|Sławoszowice|ul. 3 Maja 12a |56-300 Milicz;684;327;327;9;318;47.81;2.75
84310;021303;Świetlica Wiejska w Piękocinie|Piękocin| 38 |56-300 Milicz;600;242;242;6;236;40.33;2.48
84311;021303;Świetlica Wiejska w Olszy|Olsza| 3a |56-300 Milicz;401;137;137;6;131;34.16;4.38
84312;021303;Nadleśnictwo Państwowe w Miliczu|Milicz|ul. Trzebnicka 18 |56-300 Milicz;997;393;393;15;378;39.42;3.82
84313;021303;Wielospecjalistyczny Szpital w Miliczu|Milicz|ul. Grzybowa 1 |56-300 Milicz;222;87;87;7;80;39.19;8.05
84314;021401;Zespół Szkół Ponadgimnazjalnych im. Marii Skłodowskiej-Curie w Oleśnicy|Oleśnica|ul.Wojska Polskiego 67/69 |56-400 Oleśnica;1306;643;643;12;631;49.23;1.87
84315;021401;Szkoła Podstawowa nr 2 im. Jana Kilińskiego w Oleśnicy|Oleśnica|ul. Św. Jadwigi 1a |56-400 Oleśnica;1270;581;581;11;570;45.75;1.89
84316;021401;Szkoła Podstawowa nr 2 im. Jana Kilińskiego w Oleśnicy|Oleśnica|ul. Św. Jadwigi 1a |56-400 Oleśnica;1467;645;645;24;621;43.97;3.72
84317;021401;Urząd Miasta Oleśnicy|Oleśnica|Rynek-Ratusz |56-400 Oleśnica;1625;810;810;30;780;49.85;3.70
84318;021401;Szkoła Podstawowa nr 7 im. Jana Pawła II w Oleśnicy|Oleśnica|ul. 11 Listopada 10 |56-400 Oleśnica;1544;778;778;30;748;50.39;3.86
84319;021401;Miejski Ośrodek Kultury i Sportu w Oleśnicy|Oleśnica|ul. Jana Kochanowskiego 4 |56-400 Oleśnica;1502;682;682;10;672;45.41;1.47
84320;021401;Szkoła Podstawowa nr 4 im. Romana Podoskiego w Oleśnicy|Oleśnica|ul. Ignacego Paderewskiego 2 |56-400 Oleśnica;1284;643;643;17;626;50.08;2.64
84321;021401;Gimnazjum nr 1 im. Książąt Oleśnickich w Oleśnicy|Oleśnica|ul. Armii Krajowej 47 |56-400 Oleśnica;1436;737;737;12;725;51.32;1.63
84322;021401;Szkoła Podstawowa nr 4 im. Romana Podoskiego w Oleśnicy|Oleśnica|ul.Ignacego Paderewskiego 2 |56-400 Oleśnica;1281;628;628;12;616;49.02;1.91
84323;021401;Gimnazjum nr 3 im. Podróżników i Odkrywców Polskich w Oleśnicy|Oleśnica|ul. Jana Kochanowskiego 8 |56-400 Oleśnica;1480;691;691;30;661;46.69;4.34
84324;021401;Szkoła Podstawowa z Oddziałami Integracyjnymi nr 6 im. Janusza Korczaka w Oleśnicy|Oleśnica|ul. gen. Franciszka Kleeberga 4 |56-400 Oleśnica;1519;763;763;17;746;50.23;2.23
84325;021401;Szkoła Podstawowa z Oddziałami Integracyjnymi nr 6 im. Janusza Korczaka w Oleśnicy|Oleśnica|ul. gen. Franciszka Kleeberga 4 |56-400 Oleśnica;1327;738;738;12;726;55.61;1.63
84326;021401;Spółdzielczy Dom Kultury KORELAT II w Oleśnicy|Oleśnica|ul. Jana Kochanowskiego 5 |56-400 Oleśnica;1583;904;904;8;896;57.11;0.88
84327;021401;Zakład Budynków Komunalnych w Oleśnicy|Oleśnica|ul. Wojska Polskiego 13 |56-400 Oleśnica;1458;751;751;18;733;51.51;2.40
84328;021401;Cech Rzemiosł Różnych oraz Małej i Średniej Przedsiębiorczości w Oleśnicy|Oleśnica|ul. Wrocławska 41-43 |56-400 Oleśnica;1444;820;820;15;805;56.79;1.83
84329;021401;Oleśnicka Biblioteka Publiczna im.Mikołaja Reja w Oleśnicy|Oleśnica|ul. Mikołaja Reja 10 |56-400 Oleśnica;1387;722;722;12;710;52.05;1.66
84330;021401;Szkoła Podstawowa nr 8 im. Noblistów Polskich w Oleśnicy|Oleśnica|ul.Wiejska 35 |56-400 Oleśnica;1171;666;666;16;650;56.87;2.40
84331;021401;Gimnazjum nr 2 im. Armii Krajowej w Oleśnicy|Oleśnica|ul. Juliusza Słowackiego 4 |56-400 Oleśnica;1463;682;682;14;668;46.62;2.05
84332;021401;Zespół Szkół Ponadgimnazjalnych im. Marii Skłodowskiej-Curie w Oleśnicy|Oleśnica|ul. Wojska Polskiego 67/69 |56-400 Oleśnica;1265;654;654;14;640;51.70;2.14
84333;021401;Przedszkole nr 6 w Oleśnicy|Oleśnica|ul. Kazimierza Wielkiego 7 |56-400 Oleśnica;1544;873;873;20;853;56.54;2.29
84334;021401;Gimnazjum nr 3 im. Podróżników i Odkrywców Polskich w Oleśnicy|Oleśnica|ul. Jana Kochanowskiego 8 |56-400 Oleśnica;1584;916;916;15;901;57.83;1.64
84335;021401;Powiatowy Zespół Szpitali w Oleśnicy|Oleśnica|ul.Armii Krajowej 1 |56-400 Oleśnica;84;35;35;2;33;41.67;5.71
84336;021401;Zakład Karny w Oleśnicy|Oleśnica|ul.Wały Jagiellońskie 1 |56-400 Oleśnica;143;83;83;14;69;58.04;16.87
84337;021402;Gimnazjum w Bierutowie|Bierutów|ul. Kolejowa 7 |56-420 Bierutów;2250;1074;1074;48;1026;47.73;4.47
84338;021402;Zespół Szkół Ponadgimnazjalnych w Bierutowie|Bierutów|pl. Kościelny 2 |56-420 Bierutów;2093;842;842;46;796;40.23;5.46
84339;021402;Szkoła Podstawowa w Wabienicach|Wabienice| 92 |56-420 Bierutów;1359;431;431;30;401;31.71;6.96
84340;021402;Szkoła Podstawowa w Zbytowej|Zbytowa| 59a |56-420 Bierutów;889;350;350;23;327;39.37;6.57
84341;021402;Budynek po szkole w Posadowicach|Posadowice| 7 |56-420 Bierutów;393;137;137;7;130;34.86;5.11
84342;021402;Budynek po szkole w Solnikach Wielkich|Solniki Wielkie| 22 |56-420 Bierutów;622;194;194;9;185;31.19;4.64
84343;021402;Budynek po szkole w Paczkowie|Paczków| 24 |56-420 Bierutów;503;172;172;18;154;34.19;10.47
84344;021403;Gimnazjum Gminne|Dobroszyce|ul. Parkowa 3 |56-410 Dobroszyce;2099;1044;1044;38;1006;49.74;3.64
84345;021403;Szkoła Podstawowa im.Ireny Sendlerowej|Dobroszyce|ul.Parkowa 5 |56-410 Dobroszyce;1868;724;724;27;697;38.76;3.73
84346;021403;Szkoła Podstawowa|Dobrzeń| 9A |56-410 Dobroszyce;1214;451;451;17;434;37.15;3.77
84347;021404;Gimnazjum w Dziadowej Kłodzie|Dziadowa Kłoda|ul. Słoneczna 5 |56-504 Dziadowa Kłoda;1410;558;558;28;530;39.57;5.02
84348;021404;Szkoła Podstawowa w Miłowicach|Miłowice| 27 |56-504 Dziadowa Kłoda;1298;447;447;26;421;34.44;5.82
84349;021404;Świetlica wiejska w Dalborowicach|Dalborowice|ul. Namysłowska 19 |56-504 Dziadowa Kłoda;932;288;288;9;279;30.90;3.12
84350;021405;Miejsko-Gminny Ośrodek Kultury w Międzyborzu|Międzybórz|ul.Wrocławska 8 |56-513 Międzybórz;1007;436;436;14;422;43.30;3.21
84351;021405;Miejsko-Gminny Ośrodek Kultury w Międzyborzu|Międzybórz|ul.Wrocławska 8 |56-513 Międzybórz;832;407;407;17;390;48.92;4.18
84352;021405;Szkoła Podstawowa w Bukowinie Sycowskiej|Bukowina Sycowska| 20 |56-513 Międzybórz;866;313;313;12;301;36.14;3.83
84353;021405;Gimnazjum Samorządowe w Międzyborzu|Międzybórz|ul.Wrocławska 6 |56-513 Międzybórz;1284;428;428;28;400;33.33;6.54
84354;021406;Hala Sportowa przy Gimnazjum Gminy Oleśnica im.Szarych Szeregów|Oleśnica|ul.Wileńska 32A |56-400 Oleśnica;1782;747;747;23;724;41.92;3.08
84355;021406;Szkoła Podstawowa w Ligocie Małej|Ligota Mała| 15 |56-400 Oleśnica;1104;488;488;17;471;44.20;3.48
84356;021406;Szkoła Podstawowa w Ligocie Polskiej|Ligota Polska| 3 |56-400 Oleśnica;1268;517;517;8;509;40.77;1.55
84357;021406;Klub "Na Dole" Gminnego Ośrodka Kultury|Boguszyce| 118a |56-400 Oleśnica;1459;613;613;27;586;42.02;4.40
84358;021406;Szkoła Podstawowa we Wszechświętem|Wszechświęte| 16b |56-400 Oleśnica;915;337;337;22;315;36.83;6.53
84359;021406;Szkoła Podstawowa w Smolnej|Smolna| 70 |56-400 Oleśnica;1434;592;592;24;568;41.28;4.05
84360;021406;Szkoła Podstawowa w Sokołowicach|Sokołowice| 24 |56-400 Oleśnica;1513;662;662;28;634;43.75;4.23
84361;021406;Powiatowy Dom Pomocy Społecznej w Ostrowinie|Ostrowina| 21 |56-400 Oleśnica;514;162;162;7;155;31.52;4.32
84362;021407;Publiczne Przedszkole nr 1|Syców|ul.Kaliska 8 |56-500 Syców;1995;1066;1066;22;1044;53.43;2.06
84363;021407;Szkoła Podstawowa nr 2|Syców|ul.Mickiewicza 5 |56-500 Syców;2022;931;931;26;905;46.04;2.79
84364;021407;Biblioteka Publiczna w Sycowie|Syców|ul. Kościelna 3A |56-500 Syców;1762;895;895;22;873;50.79;2.46
84365;021407;Sala Ślubów Urzędu Stanu Cywilnego w Sycowie|Syców|pl. Wolności 7/3 |56-500 Syców;1952;937;937;23;914;48.00;2.45
84366;021407;Szkoła Podstawowa w Stradomi Wierzchniej|Stradomia Wierzchnia| 64 |56-500 Syców;1429;503;503;19;484;35.20;3.78
84367;021407;Szkoła Podstawowa w Drołtowicach|Drołtowice| 12 |56-500 Syców;944;401;401;19;382;42.48;4.74
84368;021407;Szkoła Podstawowa w Działoszy|Działosza| 62 |56-500 Syców;974;395;395;24;371;40.55;6.08
84369;021407;Publiczne Przedszkole nr 2 z Grupą Żłobkową|Syców|ul.Komorowska 2 |56-500 Syców;1683;849;849;29;820;50.45;3.42
84370;021407;Świetlica wiejska|Ślizów| 80d |56-500 Syców;432;167;167;12;155;38.66;7.19
84371;021407;Powiatowy Zespół Szpitali - Szpital w Sycowie|Syców|Oleśnicka 25 |56-500 Syców;88;28;28;3;25;31.82;10.71
84372;021408;Gimnazjum Nr 1 im. Polskich Olimpijczyków|Twardogóra|ul. Stefana Batorego 5 |56-416 Twardogóra;2116;1035;1035;34;1001;48.91;3.29
84373;021408;Szkoła Podstawowa Nr 1 im. Polskich Noblistów|Twardogóra|ul. Świętej Jadwigi 7 |56-416 Twardogóra;2063;905;905;27;878;43.87;2.98
84374;021408;Gminny Ośrodek Sportu i Rekreacji|Twardogóra|ul. 1 Maja 2 |56-416 Twardogóra;2248;1010;1010;51;959;44.93;5.05
84375;021408;Gimnazjum Nr 1 im. Polskich Olimpijczyków|Twardogóra|ul. Stefana Batorego 5 |56-416 Twardogóra;1262;445;445;24;421;35.26;5.39
84376;021408;Szkoła Podstawowa|Goszcz|ul. Szkolna 1 |56-416 Twardogóra;1856;828;828;89;739;44.61;10.75
84377;021408;Szkoła Podstawowa|Grabowno Wielkie| 139a |56-416 Twardogóra;851;317;317;24;293;37.25;7.57
84378;021501;Szkoła Tańca "Athina"|Oława|ul.1 Maja 33A |55-200 Oława;1292;715;715;16;699;55.34;2.24
84379;021501;Szkoła Podstawowa Nr 5|Oława|ul.Kamienna 8 |55-200 Oława;1514;827;827;19;808;54.62;2.30
84380;021501;Zespół Szkół Ponadgimnazjalnych Nr 2|Oława|ul.3 Maja 18 |55-200 Oława;1306;646;646;19;627;49.46;2.94
84381;021501;Klub "Parnas"|Oława|ul.1 Maja 13 |55-200 Oława;1178;604;604;7;597;51.27;1.16
84382;021501;Niepubliczne Przedszkole "Kredka"|Oława|ul.Zwierzyniec Duży 23 |55-200 Oława;891;413;413;10;403;46.35;2.42
84383;021501;Szkoła Podstawowa Nr 2|Oława|ul.Rybacka 6 |55-200 Oława;2172;1120;1120;38;1082;51.57;3.39
84384;021501;Przedszkole Nr 3|Oława|ul. Chrobrego 30a |55-200 Oława;1382;735;735;11;724;53.18;1.50
84385;021501;Gimnazjum Nr 1|Oława|ul.Sportowa 6 |55-200 Oława;2022;1054;1054;23;1031;52.13;2.18
84386;021501;Liceum Ogólnokształcące Nr I|Oława|Pl. Zamkowy 10 |55-200 Oława;1735;906;906;30;876;52.22;3.31
84387;021501;Ośrodek Kultury|Oława|ul. 11 Listopada 27 |55-200 Oława;1946;904;904;25;879;46.45;2.77
84388;021501;Zespół Szkół Ponadgimnazjalnych Nr 1|Oława|ul. Ks.F.Kutrowskiego 31 |55-200 Oława;1035;645;645;10;635;62.32;1.55
84389;021501;Zespół Szkół Ponadgimnazjalnych Nr 1|Oława|ul.Ks.F. Kutrowskiego 31 |55-200 Oława;1330;763;763;14;749;57.37;1.83
84390;021501;Zespół Szkół Specjalnych|Oława|ul. Broniewskiego 6 |55-200 Oława;1458;909;909;12;897;62.35;1.32
84391;021501;Zespół Szkół Specjalnych|Oława|ul. Broniewskiego 6 |55-200 Oława;1462;894;894;19;875;61.15;2.13
84392;021501;Zespół Szkolno-Przedszkolny Nr 1|Oława|ul.Iwaszkiewicza 11 |55-200 Oława;1843;1080;1080;16;1064;58.60;1.48
84393;021501;Zespół Szkolno-Przedszkolny Nr 1|Oława|ul.Iwaszkiewicza 11 |55-200 Oława;1374;751;751;22;729;54.66;2.93
84394;021501;Zespół Szkolno-Przedszkolny nr 1|Oława|ul.Iwaszkiewicza 11 |55-200 Oława;1604;887;887;29;858;55.30;3.27
84395;021501;Zespół Opieki Zdrowotnej w Oławie|Oława|ul. Baczyńskiego 1 |55-200 Oława;110;49;49;5;44;44.55;10.20
84396;021501;Dom Pomocy Społecznej w Oławie|Oława|ul. Lwowska 6 |55-200 Oława;97;67;67;2;65;69.07;2.99
84397;021502;Szkoła Podstawowa w Domaniowie|Domaniów| 144 |55-216 Domaniów;642;332;332;8;324;51.71;2.41
84398;021502;Gimnazjum w Domaniowie|Domaniów| 144 |55-216 Domaniów;883;377;377;23;354;42.70;6.10
84399;021502;Publiczna Szkoła Podstawowa Fundacji Świat Dzieci i Dorosłych w Goszczynie|Goszczyna| 28 |55-216 Domaniów;800;357;357;21;336;44.62;5.88
84400;021502;Świetlica Wiejska|Swojków| 11 |55-216 Domaniów;569;216;216;9;207;37.96;4.17
84401;021502;Szkoła Podstawowa w Wierzbnie|Wierzbno| 84 |55-216 Domaniów;761;305;305;29;276;40.08;9.51
84402;021502;Gimnazjum w Wierzbnie|Wierzbno| 84 |55-216 Domaniów;545;228;228;9;219;41.83;3.95
84403;021503;Publiczna Szkoła Podstawowa|Wójcice|ul. Główna 87 |55-220 Jelcz-Laskowice;985;476;476;30;446;48.32;6.30
84404;021503;Świetlica wiejska|Miłocice|ul. Główna 26 |55-220 Jelcz-Laskowice;811;250;250;17;233;30.83;6.80
84405;021503;Zespół Szkół|Minkowice Oławskie|ul. Kościelna 20 |55-220 Jelcz-Laskowice;758;358;358;16;342;47.23;4.47
84406;021503;Społeczne Konserwatorium Edukacji Ekologicznej|Chwałowice|ul. Szkolna 4 |55-220 Jelcz-Laskowice;1244;630;630;7;623;50.64;1.11
84407;021503;Publiczna Szkoła Podstawowa|Miłoszyce|ul. Główna 24 |55-220 Jelcz-Laskowice;1883;938;938;9;929;49.81;0.96
84408;021503;Zespół Szkół Ponadgimnazjalnych|Jelcz-Laskowice|ul. Techników 26 |55-220 Jelcz-Laskowice;1056;362;362;18;344;34.28;4.97
84409;021503;Publiczna Szkoła Podstawowa nr 3|Jelcz-Laskowice|ul. B. Prusa 2 |55-220 Jelcz-Laskowice;760;436;436;10;426;57.37;2.29
84410;021503;Publiczna Szkoła Podstawowa nr 2 (aula)|Jelcz-Laskowice|al. Młodych 1 |55-220 Jelcz-Laskowice;2254;1217;1217;33;1184;53.99;2.71
84411;021503;Publiczna Szkoła Podstawowa nr 2 (stołówka)|Jelcz-Laskowice|al. Młodych 1 |55-220 Jelcz-Laskowice;1898;1034;1034;18;1016;54.48;1.74
84412;021503;Urząd Miasta i Gminy|Jelcz-Laskowice|ul. Witosa 24 |55-220 Jelcz-Laskowice;1443;780;780;16;764;54.05;2.05
84413;021503;Hala Sportowa|Jelcz-Laskowice|ul. Partyzantów 1 |55-220 Jelcz-Laskowice;2041;1048;1048;24;1024;51.35;2.29
84414;021503;Środowiskowy Klub "Kuźnia"|Jelcz-Laskowice|al. Wolności 34A |55-220 Jelcz-Laskowice;1931;978;978;28;950;50.65;2.86
84415;021503;Filia Publicznej Szkoły Podstawowej nr 3|Jelcz-Laskowice|ul. Hirszfelda 92 |55-220 Jelcz-Laskowice;993;499;499;20;479;50.25;4.01
84416;021504;Zespół Szkół|Bystrzyca|ul. Kościuszki 45 |55-200 Oława;1914;999;999;32;967;52.19;3.20
84417;021504;Szkoła Podstawowa|Marcinkowice|ul. Szkolna 1 |55-200 Oława;2038;1127;1127;36;1091;55.30;3.19
84418;021504;Świetlica Wiejska|Sobocisko| 70 |55-200 Oława;602;286;286;10;276;47.51;3.50
84419;021504;Szkoła Podstawowa|Drzemlikowice| 14 |55-200 Oława;821;343;343;16;327;41.78;4.66
84420;021504;Szkoła Podstawowa|Osiek| 124 |55-200 Oława;1244;479;479;35;444;38.50;7.31
84421;021504;Szkoła Podstawowa|Ścinawa Polska| 26 |55-200 Oława;688;280;280;13;267;40.70;4.64
84422;021504;Świetlica Wiejska|Godzikowice|ul.Sportowa 18 |55-200 Oława;632;378;378;20;358;59.81;5.29
84423;021504;Świetlica Wiejska|Gaj Oławski| 51 b |55-200 Oława;864;465;465;22;443;53.82;4.73
84424;021504;Świetlica Wiejska|Stanowice|ul. Słonecznikowa 5 |55-200 Oława;1033;533;533;10;523;51.60;1.88
84425;021504;Świetlica Wiejska|Janików|ul. Batorego 22 a |55-200 Oława;537;273;273;5;268;50.84;1.83
84426;021504;Świetlica Wiejska|Gać| 8a |55-200 Oława;641;273;273;10;263;42.59;3.66
84427;021504;Świetlica Wiejska|Owczary| 22a |55-200 Oława;720;300;300;11;289;41.67;3.67
84428;021601;Szkoła Podstawowa|Chocianów|ul. Wesoła 16 |59-140 Chocianów;1660;842;842;19;823;50.72;2.26
84429;021601;Gimnazjum im. Odkrywców Polskiej Miedzi (hala sportowo-widowiskowa)|Chocianów|ul. Szkolna 1 |59-140 Chocianów;662;352;352;28;324;53.17;7.95
84430;021601;Chocianowski Ośrodek Kultury|Chocianów|ul. T. Kościuszki 5 |59-140 Chocianów;1439;609;609;39;570;42.32;6.40
84431;021601;Zespół Szkół|Chocianów|ul. Kolonialna 13 |59-140 Chocianów;1288;587;587;19;568;45.57;3.24
84432;021601;Ośrodek Pomocy Społecznej|Chocianów|ul. Odrodzenia 31 |59-140 Chocianów;1344;727;727;20;707;54.09;2.75
84433;021601;Świetlica Wiejska|Brunów| 74 |59-140 Chocianów;556;257;257;4;253;46.22;1.56
84434;021601;Świetlica Wiejska|Żabice| 21A |59-140 Chocianów;502;246;246;11;235;49.00;4.47
84435;021601;Wiejski Ośrodek Kultury|Chocianowiec| 101A |59-140 Chocianów;687;380;380;16;364;55.31;4.21
84436;021601;Szkoła Podstawowa|Parchów| 29 |59-140 Chocianów;719;409;409;11;398;56.88;2.69
84437;021601;Szkoła Podstawowa im J. Pawła II|Szklary Dolne| 48 |59-140 Chocianów;659;336;336;15;321;50.99;4.46
84438;021601;Szkoła Podstawowa im. Wł. St. Reymonta|Trzebnice| 113A |59-140 Chocianów;760;360;360;21;339;47.37;5.83
84439;021602;Dom Kultury "JOWISZ"|Gaworzyce|ul. Dworcowa 95 |59-180 Gaworzyce;1767;874;874;37;837;49.46;4.23
84440;021602;Punkt Biblioteczny|Kłobuczyn| 42 |59-180 Gaworzyce;445;252;252;3;249;56.63;1.19
84441;021602;Punkt Biblioteczny|Dalków| 1c |59-180 Gaworzyce;507;240;240;6;234;47.34;2.50
84442;021602;Świetlica|Wierzchowice| 41 |59-180 Gaworzyce;403;182;182;15;167;45.16;8.24
84443;021603;Gminny Ośrodek Kultury i Biblioteka|Grębocice|ul. Kościelna 21 |59-150 Grębocice;1160;551;551;18;533;47.50;3.27
84444;021603;Wiejski Ośrodek Kultury|Rzeczyca| |59-150 Grębocice;1146;430;430;22;408;37.52;5.12
84445;021603;Wiejski Ośrodek Kultury|Krzydłowice| |59-150 Grębocice;897;362;362;26;336;40.36;7.18
84446;021603;Wiejski Ośrodek Kultury|Kwielice| |59-150 Grębocice;975;381;381;12;369;39.08;3.15
84447;021604;Przedszkole nr 6|Polkowice|ul. mjr Hubala 1A |59-100 Polkowice;1186;388;388;22;366;32.72;5.67
84448;021604;Przedszkole Nr 6|Polkowice|ul. mjr Hubala 1A |59-100 Polkowice;1334;703;703;18;685;52.70;2.56
84449;021604;Szkoła Podstawowa Nr 2 (świetlica)|Polkowice|ul. Dąbrowskiego 1A |59-100 Polkowice;2192;1163;1163;46;1117;53.06;3.96
84450;021604;Szkoła Podstawowa Nr 2 (sala gimnastyczna)|Polkowice|ul. Dąbrowskiego 1A |59-100 Polkowice;1000;628;628;16;612;62.80;2.55
84451;021604;Przedszkole Nr 4|Polkowice|ul. Lipowa 11 |59-100 Polkowice;1876;966;966;47;919;51.49;4.87
84452;021604;Przedszkole Nr 2|Polkowice|ul. 11-go Lutego 18 |59-100 Polkowice;1183;598;598;18;580;50.55;3.01
84453;021604;Szkoła Podstawowa Nr 1 (świetlica)|Polkowice|ul. Kmicica 23 |59-100 Polkowice;1932;969;969;37;932;50.16;3.82
84454;021604;Gimnazjum Nr 1|Polkowice|ul. Ociosowa 3 |59-101 Polkowice;1215;727;727;18;709;59.84;2.48
84455;021604;Szkoła Podstawowa Nr 3|Polkowice|ul. Kardynała Bolesława Kominka 1 |59-100 Polkowice;1403;813;813;26;787;57.95;3.20
84456;021604;Polkowickie Centrum Usług Zdrowotnych|Polkowice|ul. Kardynała Bolesława Kominka 7 |59-100 Polkowice;1156;585;585;17;568;50.61;2.91
84457;021604;Polkowickie Centrum Usług Zdrowotnych|Polkowice|ul. Kardynała Bolesława Kominka 7 |59-100 Polkowice;1284;720;720;22;698;56.07;3.06
84458;021604;Klub RELAX|Polkowice|ul. Chocianowska 78 |59-101 Polkowice;1419;775;775;27;748;54.62;3.48
84459;021604;Strażnica|Sucha Górna| |59-101 Polkowice;865;434;434;23;411;50.17;5.30
84460;021604;Świetlica Wiejska|Trzebcz| |59-101 Polkowice;750;374;374;22;352;49.87;5.88
84461;021604;Świetlica Wiejska|Tarnówek| |59-101 Polkowice;619;260;260;26;234;42.00;10.00
84462;021604;Szkoła Podstawowa Integracyjna|Jędrzychów| |59-101 Polkowice;1393;802;802;36;766;57.57;4.49
84463;021605;Sala gimnastyczna Szkoły Podstawowej Nr 2|Przemków|ul.Rybna 3a |59-170 Przemków;1036;492;492;15;477;47.49;3.05
84464;021605;Świetlica Szkoły Podstawowej Nr 2|Przemków|ul. Rybna 3a |59-170 Przemków;1388;563;563;29;534;40.56;5.15
84465;021605;Świetlica wsi Ostaszów|Ostaszów| 11a |59-170 Przemków;483;238;238;19;219;49.28;7.98
84466;021605;Świetlica wsi Piotrowice|Piotrowice| 89 |59-170 Przemków;536;187;187;7;180;34.89;3.74
84467;021605;Sala gimnastyczna Szkoły Podstawowej|Wysoka| 16a |59-170 Przemków;780;321;321;17;304;41.15;5.30
84468;021605;Miejsko - Gminna Biblioteka Publiczna|Przemków|ul.Plac Targowy 1 |59-170 Przemków;1270;524;524;16;508;41.26;3.05
84469;021605;Przemkowski Ośrodek Kultury w Przemkowie|Przemków|ul.Głogowska 17 |59-170 Przemków;1446;675;675;40;635;46.68;5.93
84470;021606;Sala Gimnastyczna|Radwanice|ul. Sportowa 4 |59-160 Radwanice;1534;813;813;21;792;53.00;2.58
84471;021606;Sala Gimnastyczna|Buczyna| 20 |59-160 Radwanice;1148;444;444;13;431;38.68;2.93
84472;021606;Świetlica Wiejska|Przesieczna| 2A |59-160 Radwanice;1034;434;434;19;415;41.97;4.38
84473;021701;Zespół Szkół Publicznych w Borowie|Borów|ul. Wrocławska 24 |57-160 Borów;1762;816;816;39;777;46.31;4.78
84474;021701;Szkoła Podstawowa w Borku Strzelińskim|Borek Strzeliński|ul. Szkolna 3 |57-160 Borów;1608;747;747;23;724;46.46;3.08
84475;021701;Szkoła Podstawowa w Zielenicach|Zielenice| 26 |57-160 Borów;956;425;425;18;407;44.46;4.24
84476;021702;Gminny Ośrodek Kultury|Kondratowice|ul.Długa 23 |57-150 Prusy;616;266;266;10;256;43.18;3.76
84477;021702;Świetlica Wiejska|Prusy|ul. Kościelna 4 |57-150 Prusy;1016;409;409;22;387;40.26;5.38
84478;021702;Świetlica Wiejska|Górka Sobocka| 10 |57-150 Prusy;448;161;161;3;158;35.94;1.86
84479;021702;Szkoła Podstawowa im. Jana Pawła II|Żelowice| 24 |57-150 Prusy;831;262;262;14;248;31.53;5.34
84480;021702;Świetlica Wiejska|Karczyn| 19 |57-150 Prusy;755;278;278;14;264;36.82;5.04
84481;021703;Urząd Gminy w Przewornie|Przeworno|ul. Kolejowa 4A |57-130 Przeworno;1440;554;554;36;518;38.47;6.50
84482;021703;Świetlica wiejska w Jegłowej|Jegłowa|ul. Janusza Korczaka 6A |57-130 Przeworno;613;258;258;10;248;42.09;3.88
84483;021703;Świetlica wiejska w Samborowiczkach|Samborowiczki| 32 |57-130 Przeworno;500;163;163;5;158;32.60;3.07
84484;021703;Świetlica wiejska w Romanowie|Romanów| 25 |57-130 Przeworno;221;96;96;4;92;43.44;4.17
84485;021703;Świetlica wiejska w Sarbach|Sarby| 55a |57-130 Przeworno;769;239;239;16;223;31.08;6.69
84486;021703;Świetlica wiejska w Karnkowie|Karnków| 13a |57-130 Przeworno;501;211;211;10;201;42.12;4.74
84487;021704;Szkoła Podstawowa Nr 4|Strzelin|ul. Sienkiewicza 41 |57-100 Strzelin;1592;708;708;17;691;44.47;2.40
84488;021704;Prywatna Szkoła "SLAVIA"|Strzelin|ul. Generała Grota Roweckiego 1 |57-100 Strzelin;1839;984;984;36;948;53.51;3.66
84489;021704;Hala Sportowa OSiR|Strzelin|ul. Staromiejska 64 |57-100 Strzelin;1678;858;858;19;839;51.13;2.21
84490;021704;Centrum Kształcenia Zawodowego i Ustawicznego|Strzelin|ul. Staszica 5 |57-100 Strzelin;1627;835;835;14;821;51.32;1.68
84491;021704;Gimnazjum Nr 2|Strzelin|Plac 1 Maja 10 |57-100 Strzelin;1646;854;854;21;833;51.88;2.46
84492;021704;Liceum Ogólnokształcące|Strzelin|ul. Jana Pawła II 23 |57-100 Strzelin;1636;777;777;29;748;47.49;3.73
84493;021704;Szkoła Podstawowa|Biały Kościół|ul. Kamienna 18 |57-100 Strzelin;863;411;411;11;400;47.62;2.68
84494;021704;Świetlica Wiejska|Kazanów| 19 |57-100 Strzelin;805;284;284;11;273;35.28;3.87
84495;021704;Zespół Szkół|Kuropatnik|ul. Szkolna 1 |57-100 Strzelin;1736;877;877;27;850;50.52;3.08
84496;021704;Remiza OSP|Brożec| 73B |57-100 Strzelin;838;291;291;23;268;34.73;7.90
84497;021704;Świetlica Wiejska|Karszówek| 37 |57-100 Strzelin;760;287;287;7;280;37.76;2.44
84498;021704;Świetlica Wiejska|Karszów| 54A |57-100 Strzelin;841;363;363;15;348;43.16;4.13
84499;021704;Świetlica Wiejska|Szczawin|Aleja Lipowa 59 |57-100 Strzelin;863;414;414;11;403;47.97;2.66
84500;021704;Dom Dziecka w Górcu|Górzec| 21 |57-100 Strzelin;871;385;385;9;376;44.20;2.34
84501;021704;NZOZ Strzelińskie Centrum Medyczne Sp. z o.o. w Strzelinie|Strzelin|ul. Wrocławska 46 |57-100 Strzelin;65;6;6;1;5;9.23;16.67
84502;021704;Zakład Karny w Strzelinie|Strzelin|ul. Ząbkowicka 68 |57-100 Strzelin;641;376;376;22;354;58.66;5.85
84503;021705;Sala Obrad Urzędu Miasta i Gminy w Wiązowie|Wiązów|pl. Wolności 37 |57-120 Wiązów;2112;952;952;29;923;45.08;3.05
84504;021705;Świetlica wiejska w Starym Wiązowie|Stary Wiązów| - |57-120 Wiązów;1091;485;485;20;465;44.45;4.12
84505;021705;Świetlica wiejska w Częstocicach|Częstocice| - |57-120 Wiązów;810;295;295;22;273;36.42;7.46
84506;021705;Świetlica wiejska w Jutrzynie|Jutrzyna| - |57-120 Wiązów;1108;403;403;11;392;36.37;2.73
84507;021705;Świetlica wiejska w Jędrzychowicach|Jędrzychowice| 12b |57-120 Wiązów;818;360;360;14;346;44.01;3.89
84508;021801;Gminny Ośrodek Kultury w Kostomłotach|Kostomłoty|ul. Rynek 25 |55-311 Kostomłoty;2283;1018;1018;46;972;44.59;4.52
84509;021801;Szkoła Podstawowa w Mieczkowie|Mieczków| 14 |55-311 Kostomłoty;832;288;288;17;271;34.62;5.90
84510;021801;Zespół Szkolno-Przedszkolny "Nasza Szkoła" w Piotrowicach|Piotrowice| 31 |55-311 Kostomłoty;1361;549;549;26;523;40.34;4.74
84511;021801;Szkoła Podstawowa w Karczycach|Karczyce| 12 |55-311 Kostomłoty;1260;446;446;22;424;35.40;4.93
84512;021802;Szkoła Podstawowa|Malczyce|ul.Szkolna 6 |55-320 Malczyce;1607;664;664;28;636;41.32;4.22
84513;021802;Szkoła Podstawowa|Malczyce|ul.Dworcowa 4 |55-320 Malczyce;1617;691;691;28;663;42.73;4.05
84514;021802;Świetlica wiejska|Wilczków|ul.Strzegomska 19 |55-320 Malczyce;789;351;351;13;338;44.49;3.70
84515;021802;Świetlica wiejska|Dębice|ul.Szkolna 8B |55-320 Malczyce;746;256;256;20;236;34.32;7.81
84516;021803;Urząd Gminy|Miękinia|ul.Kościuszki 41 |55-330 Miękinia;1583;796;796;23;773;50.28;2.89
84517;021803;Świetlica Wiejska|Mrozów|ul.Wyzwolenia 24 |55-330 Miękinia;1680;931;931;24;907;55.42;2.58
84518;021803;Szkoła Podstawowa|Pisarzowice|ul. Szkolna 3A |55-330 Miękinia;1469;663;663;23;640;45.13;3.47
84519;021803;Sala Sportowa|Lutynia|ul. Kościuszki 38A |55-330 Miękinia;1451;842;842;25;817;58.03;2.97
84520;021803;Świetlica Wiejska|Białków| 19 |55-330 Miękinia;1492;638;638;27;611;42.76;4.23
84521;021803;Sala Sportowa|Pisarzowice|ul. Szkolna 3A |55-330 Miękinia;1556;847;847;27;820;54.43;3.19
84522;021803;Samorządowy Ośrodek Kultury|Miękinia|ul. Kościuszki 43 |55-330 Miękinia;751;252;252;19;233;33.56;7.54
84523;021803;Świetlica Wiejska|Lutynia|ul.Kościuszki 38A |55-330 Miękinia;1164;579;579;14;565;49.74;2.42
84524;021804;Szkoła Podstawowa nr 3|Środa Śląska|ul.Górna 2 |55-300 Środa Śląska;2100;1157;1157;24;1133;55.10;2.07
84525;021804;Gimnazjum w Środzie Śląskiej|Środa Śląska|ul. Kościuszki 62 |55-300 Środa Śląska;2116;925;925;28;897;43.71;3.03
84526;021804;Zespół Szkół Rolniczych w Środzie Śląskiej|Środa Śląska|ul. Św. Andrzeja 3 |55-300 Środa Śląska;2150;1129;1129;24;1105;52.51;2.13
84527;021804;Urząd Stanu Cywilnego w Środzie Śląskiej|Środa Śląska|pl. Wolności 3 |55-300 Środa Śląska;1889;747;747;24;723;39.54;3.21
84528;021804;Świetlica wiejska w Komornikach|Komorniki|ul. Okrężna 6 |55-300 Środa Śląska;1169;455;455;11;444;38.92;2.42
84529;021804;Lokalne Centrum Aktywności Wiejskiej w Szczepanowie|Szczepanów|ul. Średzka 19a |55-300 Środa Śląska;2207;1017;1017;30;987;46.08;2.95
84530;021804;Zespół Szkół w Ciechowie|Ciechów|ul.Średzka 1 |55-300 Środa Śląska;2250;842;842;24;818;37.42;2.85
84531;021804;Świetlica wiejska Bukówek|Bukówek| 19 |55-300 Środa Śląska;766;266;266;3;263;34.73;1.13
84532;021804;Zespół Szkół w Rakoszycach|Rakoszyce|ul. Wrocławska 44 |55-300 Środa Śląska;1046;396;396;10;386;37.86;2.53
84533;021805;Udanin - Szkoła Podstawowa|Udanin| 48 |55-340 Udanin;1359;527;527;12;515;38.78;2.28
84534;021805;Ujazd Górny - Świetlica Wiejska|Ujazd Górny| 15a |55-340 Udanin;1154;442;442;15;427;38.30;3.39
84535;021805;Konary - Świetlica Wiejska|Konary| 3 |55-340 Udanin;973;372;372;22;350;38.23;5.91
84536;021805;Pichorowice - Świetlica Wiejska|Pichorowice| 31 |55-340 Udanin;954;364;364;17;347;38.16;4.67
84537;021901;Gimnazjum nr 1|Świdnica|ul. Mieczysława Kozara Słobódzkiego 21 |58-105 Świdnica;1937;1191;1191;21;1170;61.49;1.76
84538;021901;Szkoła Podstawowa nr 1 z Oddziałami Integracyjnymi (sala nr 30)|Świdnica|ul. Galla Anonima 1 |58-100 Świdnica;2140;1228;1228;40;1188;57.38;3.26
84539;021901;Szkoła Podstawowa nr 1 z Oddziałami Integracyjnymi (sala nr 16)|Świdnica|ul. Galla Anonima 1 |58-100 Świdnica;2110;1268;1268;20;1248;60.09;1.58
84540;021901;Gimnazjum nr 3 z Oddziałami Sportowymi (sala nr 10)|Świdnica|ul. Saperów 27a |58-100 Świdnica;1864;869;869;14;855;46.62;1.61
84541;021901;Gimnazjum nr 3 z Oddziałami Sportowymi (sala nr 11)|Świdnica|ul. Saperów 27a |58-100 Świdnica;1971;923;923;28;895;46.83;3.03
84542;021901;Miejska Biblioteka Publiczna (sala Cysterska - I piętro)|Świdnica|ul. Franciszkańska 18 |58-100 Świdnica;2043;910;910;26;884;44.54;2.86
84543;021901;Przedszkole Miejskie nr 6|Świdnica|ul. Komunardów 2 |58-100 Świdnica;1984;871;871;27;844;43.90;3.10
84544;021901;Gimnazjum nr 2 z Oddziałami Integracyjnymi (sala kolumnowa)|Świdnica|ul. Ofiar Oświęcimskich 30 |58-105 Świdnica;1811;916;916;29;887;50.58;3.17
84545;021901;Przedszkole Miejskie nr 14|Świdnica|ul. Mieczysława Kozara Słobódzkiego 10 |58-105 Świdnica;2244;1187;1187;22;1165;52.90;1.85
84546;021901;Miejskie Przedszkole Integracyjne nr 16|Świdnica|ul. Karola Marcinkowskiego 10 |58-105 Świdnica;2033;1203;1203;33;1170;59.17;2.74
84547;021901;Szkoła Podstawowa nr 4|Świdnica|ul. Karola Marcinkowskiego 4-6 |58-105 Świdnica;2159;1237;1237;17;1220;57.30;1.37
84548;021901;Młodzieżowy Dom Kultury|Świdnica|ul. Karola Marcinkowskiego 4-6 |58-105 Świdnica;2270;1331;1331;21;1310;58.63;1.58
84549;021901;Urząd Stanu Cywilnego|Świdnica|ul. Armii Krajowej 47 |58-100 Świdnica;1996;1148;1148;19;1129;57.52;1.66
84550;021901;Szkoła Podstawowa nr 8 (sala nr 6-budynek główny)|Świdnica|ul. Wałbrzyska 39 |58-100 Świdnica;2172;1251;1251;24;1227;57.60;1.92
84551;021901;Szkoła Podstawowa nr 8 (aula-budynek główny)|Świdnica|ul. Wałbrzyska 39 |58-100 Świdnica;1911;1159;1159;19;1140;60.65;1.64
84552;021901;Szkoła Podstawowa nr 315|Świdnica|pl. Wojska Polskiego 3 |58-100 Świdnica;2089;882;882;26;856;42.22;2.95
84553;021901;Świdnicki Ośrodek Kultury Teatr Miejski|Świdnica|Rynek 43 |58-100 Świdnica;2092;926;926;21;905;44.26;2.27
84554;021901;Sudeckie Centrum Wspierania Organizacji Pozarządowych|Świdnica|ul. Długa 33 |58-100 Świdnica;2109;984;984;43;941;46.66;4.37
84555;021901;Szkoła Podstawowa nr 6 (hol)|Świdnica|ul. Wodna 5-7 |58-100 Świdnica;1987;930;930;25;905;46.80;2.69
84556;021901;Gimnazjum nr 4 (sala nr 4)|Świdnica|ul. Jodłowa 21 |58-100 Świdnica;1951;1025;1025;25;1000;52.54;2.44
84557;021901;Gimnazjum Nr 4 (sala nr 17)|Świdnica|ul. Jodłowa 21 |58-100 Świdnica;1875;923;923;23;900;49.23;2.49
84558;021901;Miejski Ośrodek Pomocy Społecznej Sekcja Terenowa nr 3|Świdnica|ul. Westerplatte 47 |58-100 Świdnica;1932;950;950;35;915;49.17;3.68
84559;021901;Miejska Biblioteka Publiczna Filia nr 5|Świdnica|ul. Kraszowicka 55 |58-100 Świdnica;2132;1255;1255;16;1239;58.86;1.27
84560;021901;Regionalny Szpital Specjalistyczny "Latawiec"|Świdnica|ul. Leśna 27-29 |58-100 Świdnica;135;70;70;3;67;51.85;4.29
84561;021901;Areszt Śledczy|Świdnica|ul. Trybunalska 16 |58-100 Świdnica;243;129;129;13;116;53.09;10.08
84562;021902;Administracja Spółdzielni Mieszkaniowej|Świebodzice|Siemowita 31 |58-160 Świebodzice;1087;608;608;20;588;55.93;3.29
84563;021902;Publiczne Przedszkole Nr 2 z oddziałami integracyjnymi im. Jana Pawła II|Świebodzice|Bolesława Krzywoustego 46 |58-160 Świebodzice;781;403;403;18;385;51.60;4.47
84564;021902;Publiczne Przedszkole Nr 2 z oddziałami integracyjnymi im. Jana Pawła II|Świebodzice|Księcia Bolka 17 |58-160 Świebodzice;800;453;453;9;444;56.62;1.99
84565;021902;Publiczne Przedszkole Nr 2 z oddziałami integracyjnymi im. Jana Pawła II|Świebodzice|Księcia Bolka 17 |58-160 Świebodzice;899;503;503;7;496;55.95;1.39
84566;021902;Publiczny Zespół Szkół Podstawowo-Gimnazjalnych z oddziałami integracyjnymi Publiczna Szkoła Podstawowa Nr 2 im. Nauczycieli Tajnego Nauczania|Świebodzice|Mieszka Starego 4 |58-160 Świebodzice;825;431;431;2;429;52.24;0.46
84567;021902;Publiczny Zespół Szkół Podstawowo-Gimnazjalnych z oddziałami integracyjnymi Publiczna Szkoła Podstawowa Nr 2 im. Nauczycieli Tajnego Nauczania|Świebodzice|Mieszka Starego 4 |58-160 Świebodzice;980;553;553;10;543;56.43;1.81
84568;021902;Publiczna Szkoła Podstawowa Nr 4 im. Janusza Korczaka (sala gimnastyczna)|Świebodzice|Ofiar Oświęcimskich 58 |58-160 Świebodzice;831;405;405;10;395;48.74;2.47
84569;021902;Publiczna Szkoła Podstawowa Nr 4 im. Janusza Korczaka (sala lekcyjna nr 3)|Świebodzice|Ofiar Oświęcimskich 58 |58-160 Świebodzice;862;440;440;14;426;51.04;3.18
84570;021902;Budynek biurowy "Termet" S.A.|Świebodzice|Długa 13 |58-160 Świebodzice;829;361;361;19;342;43.55;5.26
84571;021902;Publiczna Szkoła Podstawowa Nr 4 im. Janusza Korczaka (sala gimnastyczna)|Świebodzice|Ofiar Oświęcimskich 58 |58-160 Świebodzice;794;352;352;13;339;44.33;3.69
84572;021902;Publiczne Gimnazjum Nr 1 im. Sybiraków (sala lekcyjna nr 7)|Świebodzice|Marszałka Józefa Piłsudskiego 28 |58-160 Świebodzice;804;317;317;10;307;39.43;3.15
84573;021902;Publiczna Szkoła Podstawowa Nr 3 im. Władysława Broniewskiego|Świebodzice|Świdnicka 13 |58-160 Świebodzice;1048;511;511;9;502;48.76;1.76
84574;021902;Publiczne Gimnazjum Nr 1 im. Sybiraków ( sala gimnastyczna)|Świebodzice|Marszałka Józefa Piłsudskiego 28 |58-160 Świebodzice;893;348;348;18;330;38.97;5.17
84575;021902;Publiczne Gimnazjum Nr 1 im. Sybiraków (sala gimnastyczna)|Świebodzice|ul. Marszałka Józefa Piłsudskiego 28 |58-160 Świebodzice;805;361;363;26;335;44.84;7.20
84576;021902;Budynek biurowy Urzędu Miejskiego|Świebodzice|ul. Stefana Żeromskiego 27 |58-160 Świebodzice;923;308;308;16;292;33.37;5.19
84577;021902;Publiczna Szkoła Podstawowa Nr 3 im. Władysława Broniewskiego|Świebodzice|Wolności 23 |58-160 Świebodzice;920;382;382;6;376;41.52;1.57
84578;021902;Miejska Biblioteka Publiczna im. Marii Dąbrowskiej Oddział Dziecięcy|Świebodzice|Wolności 23 |58-160 Świebodzice;1033;506;506;15;491;48.98;2.96
84579;021902;Publiczne Przedszkole Nr 3 Niezapominajka|Świebodzice|Spokojna 3 |58-160 Świebodzice;852;430;430;11;419;50.47;2.56
84580;021902;Publiczne Przedszkole Nr 3 Niezapominajka|Świebodzice|Spokojna 3 |58-160 Świebodzice;835;415;415;13;402;49.70;3.13
84581;021902;Publiczny Zespół Szkół Integracyjnych|Świebodzice|Ciernie 30 |58-160 Świebodzice;745;282;282;13;269;37.85;4.61
84582;021902;Publiczny Zespół Szkół Integracyjnych|Świebodzice|Ciernie 30 |58-160 Świebodzice;755;365;365;11;354;48.34;3.01
84583;021902;NZOZ "MIKULICZ"|ŚWIEBODZICE|MARII SKŁODOWSKIEJ-CURIE 3 - 7 |58-160 ŚWIEBODZICE;83;10;10;1;9;12.05;10.00
84584;021903;Gminny Ośrodek Kultury, Sportu i Rekreacji w Dobromierzu|Dobromierz|Plac Wolności 19 |58-170 Dobromierz;727;262;262;10;252;36.04;3.82
84585;021903;Gminny Ośrodek Kultury, Sportu i Rekreacji w Dobromierzu|Dobromierz|Plac Wolności 19 |58-170 Dobromierz;758;332;332;7;325;43.80;2.11
84586;021903;Zespół Szkół w Roztoce|Roztoka|ul. Jana Pawła II 7 /9|58-173 Roztoka;820;344;344;10;334;41.95;2.91
84587;021903;Zespół Szkół w Roztoce|Roztoka|Jana Pawła II 7/9 |58-173 Roztoka;852;377;377;27;350;44.25;7.16
84588;021903;Szkoła Podstawowa w Gniewkowie|Gniewków| 3 |58-173 Roztoka;1147;455;455;32;423;39.67;7.03
84589;021904;Gimnazjum nr 1|Jaworzyna Śląska|ul. Jana Pawła II 16 |58-140 Jaworzyna Śląska;1674;707;707;24;683;42.23;3.39
84590;021904;Gimnazjum nr 1|Jaworzyna Śląska|ul. Jana Pawła II 16 |58-140 Jaworzyna Śląska;1012;452;452;12;440;44.66;2.65
84591;021904;Szkoła Podstawowa /stary budynek główny/|Jaworzyna Śląska|ul Mickiewicza 9-11 |58-140 Jaworzyna Śląska;1067;477;477;12;465;44.70;2.52
84592;021904;Szkoła Podstawowa /sala sportowa/|Jaworzyna Śląska|Mickiewicza 10 |58-140 Jaworzyna Śląska;1125;441;441;16;425;39.20;3.63
84593;021904;Świetlica wiejska|Pastuchów|Wyzwolenia 22 |58-140 Jaworzyna Śląska;1407;482;482;23;459;34.26;4.77
84594;021904;Szkoła Podstawowa w Starym Jaworowie|Stary Jaworów| 38 |58-140 Jaworzyna Śląska;1364;589;589;15;574;43.18;2.55
84595;021904;Dom Strażaka w Bolesławicach|Bolesławice| 51B |58-140 Jaworzyna Śląska;707;345;345;10;335;48.80;2.90
84596;021905;Sala gimnastyczna|Wiry| 10a |58-124 Marcinowice;1025;421;421;10;411;41.07;2.38
84597;021905;Świetlica wiejska|Mysłaków| 22 |58-124 Marcinowice;1045;503;503;19;484;48.13;3.78
84598;021905;Świetlica wiejska|Biała| 46 |58-124 Marcinowice;338;148;148;12;136;43.79;8.11
84599;021905;Świetlica wiejska|Chwałków| 4a |58-124 Marcinowice;308;114;114;8;106;37.01;7.02
84600;021905;Świetlica wiejska|Gola Świdnicka| 43 |58-124 Marcinowice;421;174;174;6;168;41.33;3.45
84601;021905;Świetlica wiejska|Szczepanów| 9a |58-124 Marcinowice;937;389;389;23;366;41.52;5.91
84602;021905;Urząd Gminy|Marcinowice|ul. J.Tuwima 2 |58-124 Marcinowice;686;348;348;6;342;50.73;1.72
84603;021905;Świetlica wiejska|Śmiałowice| 34 |58-124 Marcinowice;0;0;0;0;0;-99;-99
84604;021906;Publiczna Szkoła Podstawowa Nr 2|Strzegom|ul. Adama Mickiewicza 1 |58-150 Strzegom;1045;595;595;16;579;56.94;2.69
84605;021906;Gimnazjum Nr 2|Strzegom|ul. Adama Mickiewicza 1 |58-150 Strzegom;1087;551;551;16;535;50.69;2.90
84606;021906;Zespół Szkół Ogólnokształcących|Strzegom|Ul. Tadeusza Kościuszki 31 |58-150 Strzegom;1084;451;451;14;437;41.61;3.10
84607;021906;Zespół Szkół|Strzegom|ul. Krótka 6 |58-150 Strzegom;1085;469;469;24;445;43.23;5.12
84608;021906;Zespół Szkół|Strzegom|ul. Krótka 6 |58-150 Strzegom;1143;498;498;19;479;43.57;3.82
84609;021906;Publiczna Szkoła Podstawowa Nr 4|Strzegom|Aleja Wojska Polskiego 3-5 |58-150 Strzegom;1053;507;507;20;487;48.15;3.94
84610;021906;Zespół Szkół Ogólnokształcących|Strzegom|ul. T.Kościuszki 31 |58-150 Strzegom;1188;625;625;15;610;52.61;2.40
84611;021906;Strzegomskie Centrum Kultury|Strzegom|ul. Ignacego Jana Paderewskiego 36 |58-150 Strzegom;1013;393;393;19;374;38.80;4.83
84612;021906;Publiczna Szkoła Podstawowa Nr 3|Strzegom|ul. Jeleniogórska 19 |58-150 Strzegom;926;322;322;10;312;34.77;3.11
84613;021906;Publiczna Szkoła Podstawowa Nr 4|Strzegom|Aleja Wojska Polskiego 3-5 |58-150 Strzegom;1009;439;439;16;423;43.51;3.64
84614;021906;Gimnazjum Nr 1|Strzegom|ul. Brzegowa 1 |58-150 Strzegom;927;409;409;11;398;44.12;2.69
84615;021906;Gimnazjum Nr 1|Strzegom|Brzegowa 1 |58-150 Strzegom;911;451;451;18;433;49.51;3.99
84616;021906;Publiczna Szkoła Podstawowa Nr 2|Strzegom|ul. Adama Mickiewicza 1 |58-150 Strzegom;934;404;404;20;384;43.25;4.95
84617;021906;Świetlica Wiejska w Goczałkowie|Goczałków|Rogoźnicka 17 |58-152 Goczałków;1070;445;445;20;425;41.59;4.49
84618;021906;Zespół Szkolno-Przedszkolny w Jaroszowie|Jaroszów| 98 |58-120 Jaroszów;709;255;255;15;240;35.97;5.88
84619;021906;Świetlica Wiejska w Rusku|Rusko| 8 |58-120 Jaroszów;308;120;120;6;114;38.96;5.00
84620;021906;Zespół Szkolno-Przedszkolny w Jaroszowie|Jaroszów| 98 |58-120 Jaroszów;1044;385;385;19;366;36.88;4.94
84621;021906;Świetlica Wiejska w Wieśnicy|Wieśnica| 18 |58-150 Strzegom;404;160;160;13;147;39.60;8.12
84622;021906;Świetlica Wiejska w Żółkiewce|Żółkiewka| 54 |58-150 Strzegom;545;212;212;3;209;38.90;1.42
84623;021906;Publiczna Szkoła Podstawowa w Kostrzy|Kostrza|ul. Żeromskiego 22 |58-150 Strzegom;532;207;207;14;193;38.91;6.76
84624;021906;Szkoła Podstawowa w Rogoźnicy|Rogoźnica|ul. Parkowa 1 |58-152 Goczałków;571;251;251;18;233;43.96;7.17
84625;021906;Świetlica Wiejska w Granicy|Granica| 5A |58-150 Strzegom;762;324;324;12;312;42.52;3.70
84626;021906;Świetlica Wiejska w Międzyrzeczu|Międzyrzecze| 2 |58-150 Strzegom;410;174;174;8;166;42.44;4.60
84627;021906;Zespół Szkolno-Przedszkolny|Stanowice|ul. Świebodzka 9 |58-141 Stanowice;817;328;328;19;309;40.15;5.79
84628;021906;Publiczna Szkoła Podstawowa w Olszanach|Olszany| 33a |58-141 Stanowice;837;350;350;15;335;41.82;4.29
84629;021907;Świetlica wiejska|Bystrzyca Górna| 23 |58-114 Lubachów;2126;1056;1056;35;1021;49.67;3.31
84630;021907;Świetlica wiejska|Gogołów| 1 |58-124 Marcinowice;724;308;308;10;298;42.54;3.25
84631;021907;Szkoła Podstawowa im. Jana Pawła II|Grodziszcze| 63 A |58-112 Grodziszcze;1780;808;808;36;772;45.39;4.46
84632;021907;Gimnazjum im. Unii Europejskiej|Lutomia Dolna| 12 |58-113 Lutomia Dolna;1763;674;674;45;629;38.23;6.68
84633;021907;Szkoła Podstawowa|Mokrzeszów| 23 A |58-160 Świebodzice;877;354;354;14;340;40.36;3.95
84634;021907;Świetlica wiejska|Opoczka| 30 |58-100 Świdnica;877;340;340;19;321;38.77;5.59
84635;021907;Świetlica wiejska|Pszenno|Wrocławska 1 |58-125 Pszenno;1334;670;670;29;641;50.22;4.33
84636;021907;Świetlica wiejska|Słotwina| 36 |58-100 Świdnica;840;430;430;14;416;51.19;3.26
84637;021907;Świetlica wiejska|Wilków| 32 |58-125 Pszenno;934;382;382;14;368;40.90;3.66
84638;021907;Gimnazjum im. Książąt Świdnickich|Witoszów Dolny| 59-60 |58-100 Świdnica;2162;997;997;62;935;46.11;6.22
84639;021908;Gimnazjum|Żarów|Piastowska 10 |58-130 Żarów;613;335;335;7;328;54.65;2.09
84640;021908;Przedszkole Miejskie|Żarów|ul. Wałdysława Łokietka 14 |58-130 Żarów;606;360;360;6;354;59.41;1.67
84641;021908;Gimnazjum|Żarów|ul. Piastowska 10 |58-130 Żarów;694;334;334;7;327;48.13;2.10
84642;021908;Biblioteka Publiczna|Żarów|ul. Piastowska 10 |58-130 Żarów;809;394;394;18;376;48.70;4.57
84643;021908;Szkoła Podstawowa|Żarów|ul. Ogrodowa 1 |58-130 Żarów;1343;530;530;24;506;39.46;4.53
84644;021908;Szkoła Podstawowa|Żarów|ul. Armii Krajowej 60 |58-130 Żarów;1486;579;579;21;558;38.96;3.63
84645;021908;Świetlica Wiejska|Łażany|ul. Strzegomska 4 |58-130 Żarów;1166;445;445;13;432;38.16;2.92
84646;021908;Świetlica Wiejska|Mrowiny|ul. Wojska Polskiego 57 |58-130 Żarów;794;356;356;13;343;44.84;3.65
84647;021908;Świetlica Wiejska|Wierzbna|ul. Świdnicka 21A |58-130 Żarów;1274;611;611;10;601;47.96;1.64
84648;021908;Szkoła Podstawowa|Imbramowice|ul. Żarowska 45 |58-130 Żarów;1317;523;523;33;490;39.71;6.31
84649;021908;Szpital Reaumtologiczno-Rehabilitacyjny w Żarowie|Żarów|Wojska Polskiego 7 |58-130 Żarów;22;20;20;1;19;90.91;5.00
84650;022001;Gimnazjum|Oborniki Śląskie|ul.Kownackiego 3 |55-120 Oborniki Śląskie;1424;736;736;17;719;51.69;2.31
84651;022001;Szkoła Podstawowa Nr 2 w Obornikach Śląskich|Oborniki Śląskie|ul. Kard. Wyszyńskiego 24 |55-120 Oborniki Śląskie;1524;893;893;15;878;58.60;1.68
84652;022001;Szkoła Podstawowa Nr 3|Oborniki Śląskie|ul.Trzebnicka 33 |55-120 Oborniki Śląskie;2369;1458;1458;17;1441;61.54;1.17
84653;022001;Liceum Ogólnokształcące|Oborniki Śląskie|ul. Wrocławska 18 |55-120 Oborniki Śląskie;1457;824;824;18;806;56.55;2.18
84654;022001;Powiatowy Zespół Szkół|Oborniki Śląskie|ul. Parkowa 8 |55-120 Oborniki Śląskie;1221;669;669;17;652;54.79;2.54
84655;022001;Świetlica Wiejska|Wilczyn|ul. Parkowa 1 |55-120 Oborniki Śląskie;799;354;354;5;349;44.31;1.41
84656;022001;Gimnazjum|Pęgów|ul. Główna 101 |55-120 Oborniki Śląskie;853;375;375;13;362;43.96;3.47
84657;022001;Remiza OSP|Rościsławice|ul. Żmigrodzka 2 |55-120 Oborniki Śląskie;660;266;266;7;259;40.30;2.63
84658;022001;Szkoła Podstawowa|Uraz|ul. Wołowska 55 |55-120 Oborniki Śląskie;881;467;467;21;446;53.01;4.50
84659;022001;Świetlica Wiejska|Lubnów|ul. Pęgowska 3 |55-120 Oborniki Śląskie;900;425;425;16;409;47.22;3.76
84660;022001;Szkoła Podstawowa|Osolin|ul. Marszałka Piłsudskiego 5 |55-120 Oborniki Śląskie;1807;872;872;16;856;48.26;1.83
84661;022001;Szkoła Podstawowa|Pęgów|ul. Główna 101 |55-120 Oborniki Śląskie;1508;819;819;21;798;54.31;2.56
84662;022001;Dom Pomocy Społecznej w Obornikach Śląskich, Filia w Rościsławicach|Rościsławice|ul. Polna 43 |55-120 Oborniki Śląskie;92;34;34;10;24;36.96;29.41
84663;022001;Dom Pomocy Społecznej w Obornikach Śląskich|Oborniki Śląskie|ul. Kardynała Wyszyńskiego 33 |55-120 Oborniki Śląskie;67;29;29;9;20;43.28;31.03
84664;022001;Dolnośląskie Centrum Chorób Płuc we Wrocławiu, Oddział I i I A Chorób Płuc w Obornikach Śląskich|Oborniki Śląskie|ul. Dunikowskiego 2-8 |55-120 Oborniki Śląskie;56;16;16;1;15;28.57;6.25
84665;022002;GOKiS w Prusicach|Prusice|ul.Jana Pawła II 7 |55-110 Prusice;1817;689;689;38;651;37.92;5.52
84666;022002;Szkoła Podstawowa w Skokowej|Skokowa|ul.Wrocławska 9 |55-110 Prusice;1828;809;809;20;789;44.26;2.47
84667;022002;Szkoła Podstawowa w Piotrkowicach|Piotrkowice| 19 |55-110 Prusice;979;405;405;27;378;41.37;6.67
84668;022002;Gminna Biblioteka Publiczna w Prusicach "Multiteka"|Prusice|ul. Żmigrodzka 43A |55-110 Prusice;2184;776;776;23;753;35.53;2.96
84669;022002;Świetlica we Wszemirowie|Wszemirów| 67 |55-110 Prusice;694;296;296;6;290;42.65;2.03
84670;022003;Trzebnickie Centrum Kultury i Sportu|Trzebnica|ul. Prusicka 12 |55-100 Trzebnica;1880;894;894;10;884;47.55;1.12
84671;022003;Szkoła Podstawowa Nr 3 w Trzebnicy|Trzebnica|ul. M.Konopnickiej 14 |55-100 Trzebnica;1629;951;951;14;937;58.38;1.47
84672;022003;Powiatowy Zespół Szkół Nr 2 w Trzebnicy|Trzebnica|ul. Żeromskiego 25 |55-100 Trzebnica;1644;946;946;9;937;57.54;0.95
84673;022003;Szkoła Podstawowa Nr 2 w Trzebnicy|Trzebnica|ul. 3 Maja 5 |55-100 Trzebnica;1061;658;658;7;651;62.02;1.06
84674;022003;Siedziba Związku Emerytów i Rencistów|Trzebnica|ul. Księdza Dziekana Bochenka 12 |55-100 Trzebnica;2008;1148;1148;31;1117;57.17;2.70
84675;022003;Gimnazjum Nr 1 w Trzebnicy|Trzebnica|ul. Św. Jadwigi 10 |55-100 Trzebnica;1975;1043;1043;16;1027;52.81;1.53
84676;022003;Ratusz|Trzebnica|Rynek 25 |55-100 Trzebnica;868;494;494;14;480;56.91;2.83
84677;022003;Świetlica Wiejska|Głuchów Górny| 73 |55-100 Trzebnica;1071;418;418;15;403;39.03;3.59
84678;022003;Świetlica Wiejska, budynek stacji PKP|Taczów Wielki| 55 |55-100 Trzebnica;703;249;249;10;239;35.42;4.02
84679;022003;Świetlica Wiejska|Nowy Dwór| 28 |55-100 Trzebnica;785;340;340;7;333;43.31;2.06
84680;022003;Świetlica Wiejska|Cerekwica|ul. Trzebnicka 11 |55-100 Trzebnica;728;257;257;23;234;35.30;8.95
84681;022003;Świetlica Wiejska|Brzyków| 75 |55-100 Trzebnica;788;289;289;12;277;36.68;4.15
84682;022003;Świetlica Wiejska|Jaźwiny| 15 |55-100 Trzebnica;723;262;262;6;256;36.24;2.29
84683;022003;Zespół Szkół w Ujeźdźcu Wielkim|Ujeździec Wielki| 46 |55-100 Trzebnica;919;292;292;12;280;31.77;4.11
84684;022003;Świetlica Wiejska|Biedaszków Wielki| 31 |55-100 Trzebnica;790;271;271;9;262;34.30;3.32
84685;022003;Świetlica Wiejska|Skoroszów| 14 |55-100 Trzebnica;742;297;297;7;290;40.03;2.36
84686;022003;Szpital im. Św. Jadwigi w Trzebnicy|Trzebnica|ul. Prusicka 55 |55-100 Trzebnica;116;50;50;2;48;43.10;4.00
84687;022004;Ośrodek Kultury Sportu i Rekreacji|Wisznia Mała|ul. Szkolna 1 |55-114 Wisznia Mała;1642;775;775;16;759;47.20;2.06
84688;022004;Szkoła Podstawowa|Psary|ul. Główna 40 |51-180 Wrocław;2103;1291;1291;21;1270;61.39;1.63
84689;022004;Przedszkole Publiczne|Strzeszów|ul. Lipowa 35 |55-114 Wisznia Mała;1956;852;852;36;816;43.56;4.23
84690;022004;Zespół Szkół|Kryniczno|ul. Szkolna 6 |55-114 Wisznia Mała;2054;1213;1213;30;1183;59.06;2.47
84691;022005;Sala widowiskowa Gminnego Ośrodka Kultury i Biblioteka w Zawoni|Zawonia|ul. Trzebnicka 11 |55-106 Zawonia;1923;835;835;35;800;43.42;4.19
84692;022005;Hala sportowo-widowiskowa przy Zespole Szkół w Zawoni|Tarnowiec| 9 |55-106 Zawonia;1276;436;436;17;419;34.17;3.90
84693;022005;Sala nr 4 Zespołu Szkół w Czeszowie|Czeszów|ul. M. Konopnickiej 18 |55-106 Zawonia;1465;584;584;42;542;39.86;7.19
84694;022006;Publiczne Przedszkole "Zielona Dolina"|Żmigród|ul. Czereśniowa 9 |55-140 Żmigród;1878;880;880;16;864;46.86;1.82
84695;022006;Zespół Placówek Kultury|Żmigród|ul. Wrocławska 12 |55-140 Żmigród;1823;893;893;33;860;48.99;3.70
84696;022006;Zespół Szkół Dwujęzycznych|Żmigród|ul. Sienkiewicza 6 |55-140 Żmigród;1506;636;637;26;610;42.23;4.09
84697;022006;Szkoła Podstawowa im. Janusza Korczaka|Barkowo| 75 |55-140 Żmigród;1279;405;405;27;378;31.67;6.67
84698;022006;Szkoła Podstawowa im. Polskich Olimpijczyków|Korzeńsko|ul. Kolejowa 16 |55-140 Żmigród;1616;533;533;18;515;32.98;3.38
84699;022006;Świetlica Wiejska|Radziądz| 86 a |55-140 Żmigród;899;354;354;17;337;39.38;4.80
84700;022006;Świetlica Wiejska|Borzęcin| 16 A |55-140 Żmigród;689;228;228;14;214;33.09;6.14
84701;022006;Szkoła Podstawowa im. Ks. Jana Twardowskiego|Powidzko| 49 |55-140 Żmigród;1520;420;420;17;403;27.63;4.05
84702;022006;Świetlica Wiejska|Żmigródek| 47 |55-140 Żmigród;571;242;242;10;232;42.38;4.13
84703;022006;Szpital Rehabilitacyjny i Opieki Długoterminowej w Żmigrodzie|Żmigród|ul. Willowa 4 |55-140 Żmigród;46;23;23;4;19;50.00;17.39
84704;022101;Zespół Szkół Samorządowych w Boguszowie-Gorcach|Boguszów-Gorce|ul. Stanisława Staszica 5 |58-371 Boguszów-Gorce;1691;689;689;27;662;40.75;3.92
84705;022101;Zespół Szkół Samorządowych w Boguszowie-Gorcach|Boguszów-Gorce|ul. Stanisława Staszica 5 |58-371 Boguszów-Gorce;1734;792;792;26;766;45.67;3.28
84706;022101;Miejska Biblioteka Publicza-Centrum Kultury w Boguszowie-Gorcach|Boguszów-Gorce|Pl. Odrodzenia 4 |58-370 Boguszów-Gorce;887;326;326;6;320;36.75;1.84
84707;022101;Zespół Szkolno-Przedszkolny w Boguszowie-Gorcach-Publiczna Szkoła Podstawowa Nr 1|Boguszów-Gorce|ul. Szkolna 3 |58-370 Boguszów-Gorce;1853;704;704;26;678;37.99;3.69
84708;022101;Gimnazjum Nr 1 w Boguszowie-Gorcach|Boguszów-Gorce|ul. Ludwika Waryńskiego 10 |58-370 Boguszów-Gorce;1882;715;715;22;693;37.99;3.08
84709;022101;Miejska Biblioteka Publiczna-Centrum Kultury w Boguszowie-Gorcach|Boguszów-Gorce|Plac Odrodzenia 4 |58-370 Boguszów-Gorce;1834;661;661;33;628;36.04;4.99
84710;022101;Świetlica Środowiskowa Nr 4 w Boguszowie-Gorcach|Boguszów-Gorce|ul. Stefana Żeromskiego 17 |58-372 Boguszów-Gorce;1355;528;528;25;503;38.97;4.73
84711;022101;Publiczna Szkoła Podstawowa Nr 6 w Boguszowie-Gorcach|Boguszów-Gorce|ul. Mikołaja Kopernika 7 |58-372 Boguszów-Gorce;894;323;323;8;315;36.13;2.48
84712;022101;Miejska Biblioteka Publiczna-Centrum Kultury w Boguszowie-Gorcach Filia Nr 5|Boguszów-Gorce|Kosynierów 81 |58-370 Boguszów-Gorce;617;253;253;8;245;41.00;3.16
84713;022102;Centrum Kultury|Jedlina-Zdrój|ul. Piastowska 13 |58-330 Jedlina-Zdrój;827;387;387;17;370;46.80;4.39
84714;022102;Centrum Kultury|Jedlina-Zdrój|ul. Piastowska 13 |58-330 Jedlina-Zdrój;749;367;367;7;360;49.00;1.91
84715;022102;Gimnazjum Miejskie im. Jana Pawła II|Jedlina-Zdrój|ul. Słowackiego 5 |58-330 Jedlina-Zdrój;807;386;386;17;369;47.83;4.40
84716;022102;Świetlica|Jedlina-Zdrój|ul. Jasna 3 |58-330 Jedlina-Zdrój;621;261;261;11;250;42.03;4.21
84717;022102;Centrum Bankietowo Pobytowe Moniuszko|Jedlina-Zdrój|ul. Moniuszki 6 |58-330 Jedlina-Zdrój;923;357;357;10;347;38.68;2.80
84718;022103;Teatr Zdrojowy im. H. Wieniawskiego|Szczawno-Zdrój|Kościuszki 19 |58-310 Szczawno-Zdrój;1015;595;595;9;586;58.62;1.51
84719;022103;Publiczne Gimnazjum|Szczawno-Zdrój|Boczna 1 |58-310 Szczawno-Zdrój;964;577;577;14;563;59.85;2.43
84720;022103;Zespół Szkół im. Marii Skłodowskiej-Curie|Szczawno-Zdrój|Kolejowa 2 |58-310 Szczawno-Zdrój;915;464;464;20;444;50.71;4.31
84721;022103;Miejska Biblioteka Publiczna im. Tadeusza Boya-Żeleńskiego|Szczawno-Zdrój|Wojska Polskiego 4a |58-310 Szczawno-Zdrój;1121;697;697;8;689;62.18;1.15
84722;022103;Miejska Szkoła Podstawowa|Szczawno-Zdrój|Sienkiewicza 32 |58-310 Szczawno-Zdrój;937;464;464;17;447;49.52;3.66
84723;022104;Gminna Biblioteka Publiczna|Czarny Bór|ul. Sportowa 43 |58-379 Czarny Bór;1088;501;501;30;471;46.05;5.99
84724;022104;Gminny Zespół Szkolno-Przedszkolny (Filia Szkoły Podstawowej)|Witków| 89 |58-379 Czarny Bór;800;363;363;16;347;45.38;4.41
84725;022104;Świetlica Wiejska|Grzędy| 50 |58-379 Czarny Bór;555;243;243;8;235;43.78;3.29
84726;022104;Świetlica Wiejska|Jaczków| 15A |58-379 Czarny Bór;384;173;173;14;159;45.05;8.09
84727;022104;Gminna Biblioteka Publiczna|Czarny Bór|ul. Sportowa 43 |58-379 Czarny Bór;1032;576;576;15;561;55.81;2.60
84728;022105;Szkoła Podstawowa Nr 2|Głuszyca|ul. Sienkiewicza 53 |58-340 Głuszyca;1989;787;787;29;758;39.57;3.68
84729;022105;Szkoła Podstawowa Nr 3|Głuszyca|ul. Kolejowa 8 |58-340 Głuszyca;2035;982;982;31;951;48.26;3.16
84730;022105;Centrum Kultury - Miejska Biblioteka Publiczna|Głuszyca|ul. Grunwaldzka 26 |58-340 Głuszyca;1602;631;631;29;602;39.39;4.60
84731;022105;Świetlica Wiejska|Głuszyca Górna|ul. Kłodzka 61 |58-340 Głuszyca;843;316;316;13;303;37.49;4.11
84732;022105;Świetlica Wiejska|Kolce|ul. Pamięci Narodowej 39 |58-340 Głuszyca;325;119;119;0;119;36.62;0.00
84733;022105;Świetlica Wiejska|Grzmiąca|ul. Wiejska 1 |58-340 Głuszyca;427;158;158;2;156;37.00;1.27
84734;022106;Mieroszowskie Centrum Kultury|Mieroszów|ul. Stefana Żeromskiego 28 |58-350 Mieroszów;670;224;224;12;212;33.43;5.36
84735;022106;Publiczne Gimnazjum im. Krzysztofa Kieślowskiego|Mieroszów|Stefana Żeromskiego 30 |58-350 Mieroszów;698;253;253;11;242;36.25;4.35
84736;022106;Przedszkole Miejskie|Mieroszów|Wolności 27 |58-350 Mieroszów;642;248;248;7;241;38.63;2.82
84737;022106;Publiczna Szkoła Podstawowa|Mieroszów|Wolności 19 |58-350 Mieroszów;733;319;319;7;312;43.52;2.19
84738;022106;Sala Sportowa|Mieroszów|Hoża 4 |58-350 Mieroszów;871;263;263;7;256;30.20;2.66
84739;022106;Publiczna Szkoła Podstawowa|Kowalowa|Wałbrzyska 38 |58-350 Mieroszów;657;266;266;4;262;40.49;1.50
84740;022106;Biblioteka Publiczna Mieroszowskiego Centrum Kultury Filia nr 1|Unisław Śląski| 4b |58-350 Mieroszów;644;294;294;11;283;45.65;3.74
84741;022106;Biblioteka Publiczna Mieroszowskiego Centrum Kultury Filia nr 2|Sokołowsko|Słoneczna 2 |58-350 Mieroszów;618;291;291;10;281;47.09;3.44
84742;022106;Dolnośląski Ośrodek Opieki Międzypokoleniowej "Biały Orzeł" w Sokołowsku|Sokołowsko|Parkowa 5 |58-350 Mieroszów;99;7;7;1;6;7.07;14.29
84743;022107;Szkoła Podstawowa|Stare Bogaczowice|ul. Główna 172a |58-312 Stare Bogaczowice;1048;458;458;18;440;43.70;3.93
84744;022107;Świetlica Wiejska|Chwaliszów|ul Główna 49 |58-312 Stare Bogaczowice;562;245;245;9;236;43.59;3.67
84745;022107;Szkoła Filialna|Struga|ul. Szkolna 2 |58-311 Struga;696;324;324;18;306;46.55;5.56
84746;022107;Świetlica Wiejska|Jabłów|ul. Główna 74 |58-371 Boguszów-Gorce;329;155;155;5;150;47.11;3.23
84747;022107;Świetlica Wiejska|Gostków|ul. Główna 42 |58-312 Stare Bogaczowice;436;163;163;8;155;37.39;4.91
84748;022107;Filia Gminnej Biblioteki Publicznej|Lubomin|ul. Główna 5 |58-311 Struga;275;127;127;4;123;46.18;3.15
84749;022108;Centrum Kultury i Turystyki w Walimiu|Walim|ul. Tadeusza Kościuszki 2 |58-320 Walim;981;361;361;23;338;36.80;6.37
84750;022108;Centrum Sportu i Rekreacji w Walimiu|Walim|ul. Boczna 8A |58-320 Walim;993;377;377;17;360;37.97;4.51
84751;022108;Świetlica-Klub Strażaka|Zagórze Śląskie|ul. Główna 10 |58-321 Jugowice;789;323;323;14;309;40.94;4.33
84752;022108;Publiczna Szkoła Podstawowa|Jugowice|Główna 34 |58-321 Jugowice;731;346;346;18;328;47.33;5.20
84753;022108;Wiejski Dom Kultury|Dziećmorowice|ul. Henryka Sienkiewicza 75 |58-308 Wałbrzych;1123;476;476;10;466;42.39;2.10
84754;022201;Dolnobrzeski Ośrodek Kultury|Brzeg Dolny|ul.Kolejowa 29 |56-120 Brzeg Dolny;1906;892;892;28;864;46.80;3.14
84755;022201;Szkoła Podstawowa Nr 5|Brzeg Dolny|ul. Zwycięstwa 10 |56-120 Brzeg Dolny;1528;770;770;31;739;50.39;4.03
84756;022201;DOK Dział Dziecięco-Młodzieżowy|Brzeg Dolny|ul. Zwycięstwa 5 |56-120 Brzeg Dolny;1730;847;847;30;817;48.96;3.54
84757;022201;Publiczne Gimnazjum Nr 1|Brzeg Dolny|ul.Młodzieżowa 2 |56-120 Brzeg Dolny;1547;735;735;16;719;47.51;2.18
84758;022201;Szkoła Podstawowa Nr 6|Brzeg Dolny|ul. Wilcza 4 |56-120 Brzeg Dolny;1085;567;567;14;553;52.26;2.47
84759;022201;Świetlica w Godzięcinie|Godzięcin| 46a |56-120 Brzeg Dolny;500;223;223;17;206;44.60;7.62
84760;022201;Świetlica w Jodłowicach|Jodłowice| 12 |56-120 Brzeg Dolny;523;214;214;3;211;40.92;1.40
84761;022201;Szkoła Podstawowa w Pogalewie Wielkim|Pogalewo Wielkie| 12H |56-120 Brzeg Dolny;869;276;276;16;260;31.76;5.80
84762;022201;Świetlica w Radeczu|Radecz| 37 |56-120 Brzeg Dolny;897;320;320;20;300;35.67;6.25
84763;022201;Przedszkole Samorządowe Nr 3|Brzeg Dolny|ul. Przedszkolna 1 |56-120 Brzeg Dolny;1632;823;823;18;805;50.43;2.19
84764;022201;Przedszkole Samorządowe Nr 1|Brzeg Dolny|ul. Zwycięstwa 3 |56-120 Brzeg Dolny;750;383;383;6;377;51.07;1.57
84765;022202;Gminny Ośrodek Kultury|Wińsko|ul. Marszałka Piłsudskiego 42 |56-160 Wińsko;1797;801;801;32;769;44.57;4.00
84766;022202;Zespół Szkoła Podstawowa i Przedszkole|Wińsko|ul. Nowa 2 |56-160 Wińsko;960;356;356;18;338;37.08;5.06
84767;022202;Szkoła Podstawowa im. Jana Adama de Garnier|Głębowice| 10 |56-160 Wińsko;865;315;315;28;287;36.42;8.89
84768;022202;Szkoła Podstawowa im. Świętego Mikołaja z Miry|Krzelów| 125 |56-160 Wińsko;1400;568;568;19;549;40.57;3.35
84769;022202;Szkoła Podstawowa im. Jana Markiewicza|Orzeszków| 9 |56-160 Wińsko;1030;334;334;23;311;32.43;6.89
84770;022202;Świetlica wiejska|Rajczyn| 1 1|56-160 Wińsko;383;140;140;8;132;36.55;5.71
84771;022202;Świetlica wiejska|Rudawa| 5 |56-160 Wińsko;492;169;169;13;156;34.35;7.69
84772;022203;Zespół Szkół Publicznych w Wołowie|Wołów|ul.Trzebnicka 14 |56-100 Wołów;2288;1076;1076;20;1056;47.03;1.86
84773;022203;Urząd Miejski w Wołowie|Wołów|Rynek 34 |56-100 Wołów;1409;637;637;28;609;45.21;4.40
84774;022203;Wołowski Ośrodek Kultury|Wołów|ul.Generała Władysława Sikorskiego 6 |56-100 Wołów;2198;1093;1093;33;1060;49.73;3.02
84775;022203;Publiczne Gimnazjum w Wołowie|Wołów|ul.Komuny Paryskiej 18 |56-100 Wołów;1963;993;993;20;973;50.59;2.01
84776;022203;Centrum Kształcenia Zawodowego i Ustawicznego w Wołowie|Wołów|ul. Tadeusza Kościuszki 27 |56-100 Wołów;1554;768;768;18;750;49.42;2.34
84777;022203;Szkoła Podstawowa Nr 2 w Wołowie|Wołów|ul.Fryderyka Chopina 10 |56-100 Wołów;1446;719;719;22;697;49.72;3.06
84778;022203;Szkoła Podstawowa w Krzydlinie Wielkiej|Krzydlina Wielka| 27A |56-100 Wołów;839;311;311;13;298;37.07;4.18
84779;022203;Zespół Szkół Publicznych w Lubiążu|Lubiąż|ul. Wojska Polskiego 3A |56-100 Wołów;2196;897;897;32;865;40.85;3.57
84780;022203;Szkoła Podstawowa w Mojęcicach|Mojęcice|ul. Wołowska 4 |56-100 Wołów;1102;352;352;15;337;31.94;4.26
84781;022203;Świetlica Wiejska w Gródku|Gródek| 25A |56-100 Wołów;634;237;237;5;232;37.38;2.11
84782;022203;Szkoła Podstawowa w Warzęgowie|Warzęgowo| 15 |56-100 Wołów;1043;369;369;17;352;35.38;4.61
84783;022203;Szkoła Podstawowa w Starym Wołowie|Stary Wołów| 56 |56-100 Wołów;974;356;356;11;345;36.55;3.09
84784;022203;Świetlica Wiejska w Dębnie|Dębno| 1 |56-100 Wołów;578;222;222;5;217;38.41;2.25
84785;022203;Zakład Karny w Wołowie|Wołów|ul. Więzienna 6 |56-100 Wołów;965;526;526;76;450;54.51;14.45
84786;022203;Niepubliczny Zakład Opieki Zdrowotnej Powiatowe Centrum Medyczne w Wołowie - Obiekt Szpitala w Wołowie|Wołów|ul. Inwalidów Wojennych 26 |56-100 Wołów;79;30;30;11;19;37.97;36.67
84787;022203;Wojewódzki Szpital dla Nerwowo i Psychicznie Chorych w Lubiążu|Lubiąż|ul. Adama Mickiewicza 1 |56-100 Wołów;276;74;74;5;69;26.81;6.76
84788;022301;Świetlica wiejska w Czernicy|Czernica|ul. Odrzańska 2 |55-003 Czernica;2309;1388;1388;22;1366;60.11;1.59
84789;022301;Gimnazjum i Szkoła Podstawowa w Kamieńcu Wroc.|Kamieniec Wrocławski|ul. Kolejowa 8 |55-002 Kamieniec Wrocławski;2033;1343;1343;13;1330;66.06;0.97
84790;022301;Remiza OSP w Nadolicach Wielkich|Nadolice Wielkie|ul. Wrocławska 56 |55-003 Czernica;1488;964;964;13;951;64.78;1.35
84791;022301;Zespół Szkół w Chrząstawie Wielkiej|Chrząstawa Wielka|ul. Wrocławska 19 |55-003 Czernica;1627;910;910;16;894;55.93;1.76
84792;022301;Szkoła Podstawowa w Ratowicach|Ratowice|ul. Wrocławska 36 |55-003 Czernica;773;448;448;19;429;57.96;4.24
84793;022301;Świetlica wiejska w Gajkowie|Gajków|ul. Przedszkolna 3 |55-002 Kamieniec Wrocławski;889;555;555;12;543;62.43;2.16
84794;022301;Szkoła Podstawowa w Dobrzykowicach|Dobrzykowice|ul. Szkolna 1 |55-002 Kamieniec Wrocławski;1159;746;746;10;736;64.37;1.34
84795;022302;Zespół Szkolno-Przedszkolny w Długołęce|Długołęka|ul. Szkolna 40 |55-095 Mirków;1739;1172;1173;22;1150;67.40;1.88
84796;022302;Szkoła Podstawowa w Borowej|Borowa|ul. Parkowa 2/4 |55-093 Kiełczów;924;472;472;9;463;51.08;1.91
84797;022302;Zespół Szkół w Brzeziej Łące|Brzezia Łąka|ul. Szkolna 10 |55-093 Kiełczów;984;556;556;14;542;56.50;2.52
84798;022302;Szkoła Podstawowa w Kiełczowie|Kiełczów|ul. Szkolna 3 |55-093 Kiełczów;1475;1019;1019;23;996;69.08;2.26
84799;022302;Świetlica Wiejska w Januszkowicach|Januszkowice|ul. Klonowa 1 |55-095 Mirków;914;376;376;7;369;41.14;1.86
84800;022302;Zespół Szkół w Łozinie|Łozina|ul. Milicka 15 |55-095 Mirków;872;459;459;14;445;52.64;3.05
84801;022302;Świetlica Wiejska w Pasikurowicach|Pasikurowice|ul. Wrocławska 30 |55-095 Mirków;945;571;571;18;553;60.42;3.15
84802;022302;Szkoła Podstawowa w Szczodrem|Szczodre|ul. Trzebnicka 42 |55-095 Mirków;853;441;441;16;425;51.70;3.63
84803;022302;Budynek byłej Szkoły Podstawowej|Węgrów| 31 |55-095 Mirków;997;386;386;19;367;38.72;4.92
84804;022302;Zespół Szkolno-Przedszkolny w Mirkowie|Mirków|ul. Słowackiego 17 |55-095 Mirków;1762;1098;1098;12;1086;62.32;1.09
84805;022302;Zespół Szkół w Siedlcu|Siedlec|ul. Wrocławska 22 |55-095 Mirków;1283;642;642;14;628;50.04;2.18
84806;022302;Gimnazjum Publiczne w Wilczycach|Wilczyce|ul. Wrocławska 15 |51-361 Wrocław;1531;1021;1021;23;998;66.69;2.25
84807;022302;Świetlica Wiejska w Piecowicach|Piecowice|ul. Stawowa 20 |55-093 Kiełczów;1187;567;567;13;554;47.77;2.29
84808;022302;Szkoła Podstawowa w Kiełczowie|Kiełczów|ul. Szkolna 3 |55-093 Kiełczów;1409;940;940;18;922;66.71;1.91
84809;022302;Świetlica Wiejska w Bykowie|Byków|ul. Ogrodowa 2 |55-095 Mirków;982;496;496;14;482;50.51;2.82
84810;022302;Gminny Ośrodek Kultury w Długołęce|Długołęka|ul. Wiejska 23 |55-095 Mirków;795;484;484;11;473;60.88;2.27
84811;022302;Świetlica Wiejska w Kątnej|Kątna| 36 |55-093 Kiełczów;817;390;390;17;373;47.74;4.36
84812;022302;Świetlica Wiejska w Pruszowicach|Pruszowice|ul. Parkowa 11 |51-217 Wrocław;1027;579;579;8;571;56.38;1.38
84813;022302;Szkoła Podstawowa w Kiełczowie|Kiełczów|ul. Szkolna 3 |55-093 Kiełczów;1129;655;655;21;634;58.02;3.21
84814;022303;Świetlica Wiejska w Jordanowie Śląskim|Jordanów Śląski|ul.Wrocławska 55 |55-065 Jordanów Śląski;1955;899;899;41;858;45.98;4.56
84815;022303;Świetlica Wiejska w Janówku|Janówek| 3a |55-065 Jordanów Śląski;613;252;252;17;235;41.11;6.75
84816;022304;Szkoła Podstawowa Nr 1 w Kątach Wr.|Kąty Wrocławskie|ul. 1 Maja 59 |55-080 Kąty Wrocławskie;1462;850;850;12;838;58.14;1.41
84817;022304;Gimnazjum im. Mikołaja Kopernika w Kątach Wr.|Kąty Wrocławskie|ul. Brzozowa 6 |55-080 Kąty Wrocławskie;1712;918;918;21;897;53.62;2.29
84818;022304;Gminny Ośrodek Kultury i Sportu w Kątach Wr.|Kąty Wrocławskie|ul. Zwycięstwa 23 |55-080 Kąty Wrocławskie;1832;977;977;29;948;53.33;2.97
84819;022304;Szkoła Podstawowa nr 2 w Kątach Wrocławskich|Kąty Wrocławskie|ul. Brzozowa 6 |55-080 Kąty Wrocławskie;1716;786;786;17;769;45.80;2.16
84820;022304;Świetlica Wiejska w Skałce|Skałka|ul. Szkolna 2a |55-080 Kąty Wrocławskie;1576;778;778;11;767;49.37;1.41
84821;022304;Zespół Szkolno-Przedszkolny w Smolcu|Smolec|ul. Kościelna 2 |55-080 Kąty Wrocławskie;1896;1363;1363;13;1350;71.89;0.95
84822;022304;Świetlica Wiejska w Smolcu|Smolec|ul. Główna 47 |55-080 Kąty Wrocławskie;975;602;602;23;579;61.74;3.82
84823;022304;Gimnazjum w Jaszkotlu|Jaszkotle| 27 |55-080 Kąty Wrocławskie;2047;1080;1080;23;1057;52.76;2.13
84824;022304;Szkoła Podstawowa w Sadkowie|Sadków|ul. Szkolna 9 |55-080 Kąty Wrocławskie;1505;753;753;16;737;50.03;2.12
84825;022304;Szkoła Podstawowa w Gniechowicach|Gniechowice|ul. Szkolna 4 |55-080 Kąty Wrocławskie;1383;581;581;20;561;42.01;3.44
84826;022304;Niepubliczna Szkoła Podstawowa w Zachowicach|Zachowice|ul. Słoneczna 4 |55-080 Kąty Wrocławskie;773;329;329;14;315;42.56;4.26
84827;022305;Gminny Zespół Szkół|Bielany Wrocławskie|ul. Akacjowa 1 |55-040 Kobierzyce;1550;1033;1033;16;1017;66.65;1.55
84828;022305;Świetlica Wiejska|Tyniec Mały|ul. Świdnicka 6 |55-040 Kobierzyce;1817;1071;1071;27;1044;58.94;2.52
84829;022305;Powiatowy Zespół Szkół Nr 1|Krzyżowice|ul. Główna 2 |55-040 Kobierzyce;1168;592;592;18;574;50.68;3.04
84830;022305;Szkoła Podstawowa|Kobierzyce|ul. Parkowa 7 |55-040 Kobierzyce;1649;891;891;24;867;54.03;2.69
84831;022305;Zespół Szkolno-Przedszkolny|Pustków Żurawski|ul. Kolejowa 46 |55-040 Kobierzyce;867;343;343;18;325;39.56;5.25
84832;022305;Świetlica Wiejska|Wierzbice|ul. Tarnopolska 15 |55-040 Kobierzyce;846;364;364;11;353;43.03;3.02
84833;022305;Świetlica Wiejska|Rolantowice| 4a |55-040 Kobierzyce;775;297;297;9;288;38.32;3.03
84834;022305;Świetlica Wiejska|Tyniec nad Ślęzą|ul. Szkolna 23 |55-040 Kobierzyce;831;320;320;22;298;38.51;6.88
84835;022305;Gimnazjum|Kobierzyce|ul. Parkowa 7 |55-040 Kobierzyce;802;334;334;12;322;41.65;3.59
84836;022305;Przedszkole Samorządowe|Ślęza|ul. Przystankowa 2 |55-040 Kobierzyce;1248;753;753;12;741;60.34;1.59
84837;022305;Świetlica Wiejska|Ślęza|ul. Przystankowa 2 |55-040 Kobierzyce;1304;898;900;10;888;68.87;1.11
84838;022305;Gminny Zespół Szkół|Bielany Wrocławskie|ul. Akacjowa 1 |55-040 Kobierzyce;937;671;671;10;661;71.61;1.49
84839;022306;Gminny Ośrodek Kultury w Mietkowie|Mietków|ul. Spółdzielcza 6 |55-081 Mietków;1794;865;865;18;847;48.22;2.08
84840;022306;Świetlica wiejska w Maniowie|Maniów|ul. Główna 2C |55-081 Mietków;779;365;365;17;348;46.85;4.66
84841;022306;Świetlica wiejska w Domanicach|Domanice| 12A |55-081 Mietków;552;222;222;12;210;40.22;5.41
84842;022306;Dom Pomocy Społecznej "Dom Nad Zalewem" w Borzygniewie|Borzygniew|ul.Sportowa 2 |55-081 Mietków;54;14;14;1;13;25.93;7.14
84843;022307;Szkoła Podstawowa Nr 1 w Sobótce|Sobótka|ul.Świdnicka 20 |55-050 Sobótka;2350;1181;1181;38;1143;50.26;3.22
84844;022307;Gimnazjum Gminne w Sobótce|Sobótka|ul.Świdnicka 20a |55-050 Sobótka;1491;803;804;17;786;53.86;2.12
84845;022307;Szkoła Podstawowa Nr 2 w Sobótce|Sobótka|ul.Marii Skłodowskiej-Curie 19 |55-050 Sobótka;1807;923;923;34;889;51.08;3.68
84846;022307;Szkoła Podstawowa w Świątnikach|Świątniki|ul. Parkowa 6 |55-050 Sobótka;1902;879;879;29;850;46.21;3.30
84847;022307;Szkoła Podstawowa w Rogowie Sobóckim|Rogów Sobócki|ul. Szkolna 7 |55-050 Sobótka;1385;554;554;30;524;40.00;5.42
84848;022307;Niepubliczna Szkoła Podstawowa w Rękowie|Ręków|ul. Nasławicka 21 |55-050 Sobótka;1433;458;458;11;447;31.96;2.40
84849;022308;Centrum Kultury w Siechnicach|Święta Katarzyna|ul. Główna 82 |55-010 Święta Katarzyna;1026;640;640;8;632;62.38;1.25
84850;022308;Zakład Opiekuńczo - Leczniczy|Święta Katarzyna|ul. Generała Dąbrowskiego 8 |55-010 Święta Katarzyna;125;107;107;0;107;85.60;0.00
84851;022308;Centrum Kultury w Siechnicach|Święta Katarzyna|ul. Główna 82 |55-010 Święta Katarzyna;912;548;548;8;540;60.09;1.46
84852;022308;Świetlica w Sulimowie|Sulimów|ul. Kochanowskiego 38 |55-010 Święta Katarzyna;699;383;383;10;373;54.79;2.61
84853;022308;Świetlica w Groblicach|Groblice|ul. Kotowicka 5 |55-010 Święta Katarzyna;1023;619;619;10;609;60.51;1.62
84854;022308;Szkoła Podstawowa w Kotowicach|Kotowice|ul. Podwalna 1 |55-010 Święta Katarzyna;602;297;297;15;282;49.34;5.05
84855;022308;Przedszkole w Siechnicach|Siechnice|ul. Osiedlowa 23a |55-011 Siechnice;841;503;503;7;496;59.81;1.39
84856;022308;Przedszkole w Siechnicach|Siechnice|ul. Osiedlowa 23a |55-011 Siechnice;1098;664;664;10;654;60.47;1.51
84857;022308;Gimnazjum w Siechnicach|Siechnice|ul. Świerczewskiego 40 |55-011 Siechnice;1307;730;730;10;720;55.85;1.37
84858;022308;Szkoła Podstawowa w Siechnicach|Siechnice|ul. Szkolna 4 |55-011 Siechnice;707;326;326;13;313;46.11;3.99
84859;022308;Urząd Miejski w Siechnicach|Siechnice|ul. Jana Pawła II 12 |55-011 Siechnice;1010;613;614;7;606;60.69;1.14
84860;022308;Świetlica w Radwanicach|Radwanice|ul. Kolejowa 8 |55-010 Święta Katarzyna;893;510;510;13;497;57.11;2.55
84861;022308;Szkoła Podstawowa w Radwanicach|Radwanice|ul. Szkolna 14a |55-010 Święta Katarzyna;1430;859;859;10;849;60.07;1.16
84862;022308;Punkt Informacji Turystycznej w Mokrym Dworze|Mokry Dwór|ul. Batorego 6a |50-458 Wrocław;416;182;182;6;176;43.75;3.30
84863;022308;Świetlica w Iwinach|Iwiny|ul. Miodowa 12 |52-116 Wrocław;795;568;568;8;560;71.45;1.41
84864;022308;Świetlica w Żernikach Wrocławskich|Żerniki Wrocławskie|ul. Parkowa 2 |55-010 Święta Katarzyna;580;397;397;3;394;68.45;0.76
84865;022308;Szkoła Podstawowa w Żernikach Wrocławskich|Żerniki Wrocławskie|ul. Kolejowa 7a |55-010 Święta Katarzyna;1341;873;873;10;863;65.10;1.15
84866;022309;Gminne Centrum Kultury w Żórawinie|Żórawina|Al. Niepodległości 6 |55-020 Żórawina;1952;1096;1096;26;1070;56.15;2.37
84867;022309;Szkoła Podstawowa w Węgrach|Węgry|ul.Szkolna 3 |55-020 Żórawina;1029;349;349;20;329;33.92;5.73
84868;022309;Świetlica w Starym Śleszowie|Stary Śleszów|ul. Oławska 16 |55-020 Żórawina;902;425;425;27;398;47.12;6.35
84869;022309;Świetlica w Turowie|Turów|ul. Wrocławska 6 |55-020 Żórawina;1064;551;551;18;533;51.79;3.27
84870;022309;Szkoła Podstawowa w Wilczkowie|Wilczków|ul.M. Kopernika 29 |55-020 Żórawina;1265;516;516;15;501;40.79;2.91
84871;022309;Szkoła Podstawowa w Rzeplinie|Rzeplin|Al. Lipowa 46 |55-020 Żórawina;995;561;561;29;532;56.38;5.17
84872;022309;Świetlica w Karwianach|Karwiany|ul. Majowa 3a |52-200 Wrocław;756;465;465;2;463;61.51;0.43
84873;022401;Centrum Kultury i Promocji|Bardo|ul. Kolejowa 12 |57-256 Bardo;1377;602;602;23;579;43.72;3.82
84874;022401;Urząd Miasta i Gminy|Bardo|ul. Rynek 2 |57-256 Bardo;1164;543;543;14;529;46.65;2.58
84875;022401;Publiczne Gimnazjum, im. Janusza Kusocińskiego|Przyłęk|ul. Fabryczna 7 |57-255 Bardo;986;421;421;13;408;42.70;3.09
84876;022401;Wiejski Dom Kultury|Brzeźnica| 46 |57-257 Bardo;888;356;356;17;339;40.09;4.78
84877;022402;Zespół Szkól Samorządowych|Ciepłowody|Szkolna 2 |57-211 Ciepłowody;869;281;281;7;274;32.34;2.49
84878;022402;Zespół Szkół Samorządowych|Ciepłowody|Szkolna 2 |57-211 Ciepłowody;888;349;349;9;340;39.30;2.58
84879;022402;Świetlica Wiejska|Stary Henryków| 46 |57-210 Henryków;793;272;272;8;264;34.30;2.94
84880;022403;Szkoła Podstawowa nr 2|Kamieniec Ząbkowicki|ul.Szkolna 10 |57-230 Kamieniec Ząbkowicki;1169;493;493;38;455;42.17;7.71
84881;022403;Gminne Centrum Kultury|Kamieniec Ząbkowicki|ul. Złotostocka 27 |57-230 Kamieniec Ząbkowicki;1260;515;515;26;489;40.87;5.05
84882;022403;Świetlica Wiejska|Ożary| 38 |57-230 Kamieniec Ząbkowicki;463;190;190;9;181;41.04;4.74
84883;022403;Świetlica Wiejska|Topola| 25 |57-230 Kamieniec Ząbkowicki;429;150;150;11;139;34.97;7.33
84884;022403;Świetlica Wiejska|Mrokocin| 33 |57-220 Ziębice;445;191;191;26;165;42.92;13.61
84885;022403;Świetlica Wiejska|Doboszowice| 86 |57-230 Kamieniec Ząbkowicki;530;224;224;17;207;42.26;7.59
84886;022403;Świetlica Wiejska|Starczów| 47 |57-230 Kamieniec Ząbkowicki;526;176;176;19;157;33.46;10.80
84887;022403;Szkoła Podstawowa Nr 1|Kamieniec Ząbkowicki|Zamkowa 4 |57-230 Kamieniec Ząbkowicki;707;420;420;7;413;59.41;1.67
84888;022403;Szkoła Podstawowa nr 1|Kamieniec Ząbkowicki|ul.Zamkowa 4 |57-230 Kamieniec Ząbkowicki;979;458;458;25;433;46.78;5.46
84889;022403;Świetlica Wiejska|Byczeń| 18 |57-230 Kamieniec Ząbkowicki;336;115;115;10;105;34.23;8.70
84890;022404;Publiczne Gimnazjum|Budzów| 108 |57-214 Budzów;907;367;367;13;354;40.46;3.54
84891;022404;Zespół Szkół Publicznych|Grodziszcze| 2 |58-262 Ostroszowice;793;296;296;10;286;37.33;3.38
84892;022404;Świetlica Wiejska|Przedborowa| 30 |57-208 Przedborowa;783;292;292;15;277;37.29;5.14
84893;022404;Srebrnogórska Przestrzeń Artystyczna|Srebrna Góra|Pl. Wypoczynkowy 4 |57-215 Srebrna Góra;950;400;400;11;389;42.11;2.75
84894;022404;Świetlica Wiejska|Stoszowice| 43 |57-213 Stoszowice;1027;403;403;15;388;39.24;3.72
84895;022405;Publiczne Gimnazjum Nr 2|Ząbkowice Śląskie|Plac Marii Skłodowskiej-Curie 1 |57-200 Ząbkowice Śląskie;897;350;350;25;325;39.02;7.14
84896;022405;Klub Seniora|Ząbkowice Śląskie|ul. Ziębicka 30 |57-200 Ząbkowice Śląskie;844;295;295;19;276;34.95;6.44
84897;022405;Ząbkowicki Ośrodek Kultury|Ząbkowice Śląskie|Rynek 24 |57-200 Ząbkowice Śląskie;792;284;284;7;277;35.86;2.46
84898;022405;Szkoła Podstawowa nr 1|Ząbkowice Śląskie|ul. Krzywa 9 |57-200 Ząbkowice Śląskie;702;272;272;14;258;38.75;5.15
84899;022405;Centrum Terapeutyczne|Ząbkowice Śląskie|ul. 1 Maja 15 C |57-200 Ząbkowice Śląskie;845;375;375;4;371;44.38;1.07
84900;022405;Zespół Szkół Ponadgimnazjalnych Nr 2|Ząbkowice Śląskie|ul. Wrocławska 17 |57-200 Ząbkowice Śląskie;989;480;480;13;467;48.53;2.71
84901;022405;Szkoła Podstawowa Nr 3|Ząbkowice Śląskie|ul. Orkana 32 |57-200 Ząbkowice Śląskie;860;421;421;6;415;48.95;1.43
84902;022405;Ośrodek Pomocy Społecznej|Ząbkowice Śląskie|Osiedle XX lecia 52 |57-200 Ząbkowice Śląskie;899;473;473;7;466;52.61;1.48
84903;022405;Publiczne Przedszkole Nr 4|Ząbkowice Śląskie|Osiedle XX lecia 53 |57-200 Ząbkowice Śląskie;966;548;548;14;534;56.73;2.55
84904;022405;Publiczne Przedszkole Nr 5|Ząbkowice Śląskie|ul. Ziębicka 34 |57-200 Ząbkowice Śląskie;1091;635;635;17;618;58.20;2.68
84905;022405;Publiczne Gimnazjum Nr 1|Ząbkowice Śląskie|ul. Powstańców Warszawy 8B, C |57-200 Ząbkowice Śląskie;1064;603;603;8;595;56.67;1.33
84906;022405;Świetlica Wiejska|Ząbkowice Śląskie|Kamieniecka 35 |57-200 Ząbkowice Śląskie;860;427;427;27;400;49.65;6.32
84907;022405;Zarząd Dróg Powiatowych|Ząbkowice Śląskie|ul. Daleka 19 |57-200 Ząbkowice Śląskie;840;402;402;10;392;47.86;2.49
84908;022405;Szkoła Podstawowa Nr 2|Ząbkowice Śląskie|ul. Piastowska 1 |57-200 Ząbkowice Śląskie;808;433;433;15;418;53.59;3.46
84909;022405;Świetlica Wiejska|Stolec| 93 |57-200 Ząbkowice Śląskie;872;400;400;13;387;45.87;3.25
84910;022405;Świetlica Wiejska|Zwrócona| 20 |57-200 Ząbkowice Śląskie;623;272;272;6;266;43.66;2.21
84911;022405;Budynek Wielofunkcyjny|Braszowice| 61A |57-200 Ząbkowice Śląskie;1102;489;489;12;477;44.37;2.45
84912;022405;Świetlica Wiejska|Tarnów| 21 |57-200 Ząbkowice Śląskie;1018;432;432;15;417;42.44;3.47
84913;022405;Świetlica Wiejska|Brodziszów| 28 |57-200 Ząbkowice Śląskie;524;201;201;6;195;38.36;2.99
84914;022405;Świetlica Wiejska|Sulisławice| 12 |57-200 Ząbkowice Śląskie;712;243;243;10;233;34.13;4.12
84915;022405;Świetlica Wiejska|Bobolice| 23 |57-200 Ząbkowice Śląskie;727;249;249;5;244;34.25;2.01
84916;022405;Dom Pomocy Społecznej|Ząbkowice Śląskie|Szpitalna 3 |57-200 Ząbkowice Śląskie;110;81;81;8;73;73.64;9.88
84917;022405;Szpital Świętego Antoniego|Ząbkowice Śląskie|Bolesława Chrobrego 5 |57-200 Ząbkowice Śląskie;29;4;4;0;4;13.79;0.00
84918;022406;Szkoła Podstawowa nr 2 im.Henryka Sienkiewicza|Ziębice|Plac Wolności 1 |57-220 Ziębice;960;442;442;5;437;46.04;1.13
84919;022406;Stadion Miejski w Ziębicach|Ziębice|Sportowa 4 |57-220 Ziębice;1008;418;418;6;412;41.47;1.44
84920;022406;Urząd Miejski w Ziębicach|Ziębice|Przemysłowa 10 |57-220 Ziębice;921;360;360;16;344;39.09;4.44
84921;022406;Ziębickie Centrum Kultury|Ziębice|Wojska Polskiego 10 |57-220 Ziębice;938;432;432;18;414;46.06;4.17
84922;022406;Miejsko - Gminny Ośrodek Pomocy Społecznej|Ziębice|Wałowa 65 |57-220 Ziębice;954;359;359;6;353;37.63;1.67
84923;022406;Ratusz|Ziębice|Rynek 44 |57-220 Ziębice;1655;595;595;12;583;35.95;2.02
84924;022406;Zespół Opiekuńczo Wychowawczy|Ziębice|Klasztorna 6 |57-220 Ziębice;758;276;276;9;267;36.41;3.26
84925;022406;Świetlica Wiejska w Niedźwiedniku|Niedźwiednik| 66 |57-224 Niedźwiednik;620;223;223;6;217;35.97;2.69
84926;022406;Świetlica Wiejska w Biernacicach|Biernacice| 29 |57-220 Ziębice;398;161;161;10;151;40.45;6.21
84927;022406;Świetlica Wiejska w Nowym Dworze|Nowy Dwór| 40 |57-210 Henryków;580;225;225;9;216;38.79;4.00
84928;022406;Przedszkole Publiczne w Wadochowicach|Wadochowice| 22 |57-210 Henryków;554;204;204;13;191;36.82;6.37
84929;022406;Niepubliczna Szkoła Podstawowa w Lubnowie|Lubnów| 42 |57-223 Lubnów;470;215;215;11;204;45.74;5.12
84930;022406;Zespół Szkół i Przedszkoli w Niedźwiedziu|Niedźwiedź| 93c |57-222 Niedźwiedź;490;215;215;16;199;43.88;7.44
84931;022406;Szkoła Podstawowa w Starczówku|Starczówek| 20 |57-222 Niedźwiedź;470;139;139;2;137;29.57;1.44
84932;022406;Świetlica Wiejska w Pomianowie Dolnym|Pomianów Dolny| 81A |57-223 Lubnów;502;223;223;11;212;44.42;4.93
84933;022406;Świetlica Wiejska w Czerńczycach|Czerńczyce| 28c |57-221 Czerńczyce;728;236;236;9;227;32.42;3.81
84934;022406;Zespół Szkół Samorządowych|Henryków|Polna 9 |57-210 Henryków;1086;473;473;22;451;43.55;4.65
84935;022406;Budynek poszkolny|Wigańcice| 88 |57-220 Ziębice;587;190;190;3;187;32.37;1.58
84936;022406;Świetlica Wiejska w Dębowcu|Dębowiec| 26B |57-220 Ziębice;467;164;164;6;158;35.12;3.66
84937;022406;Dom Pomocy Społecznej w Ziębicach|Ziębice|Kościelna 10 |57-220 Ziębice;84;49;49;9;40;58.33;18.37
84938;022406;Dom Opieki Św. Jadwigi Śląskiej Caritas Archidiecezji Wrocławskiej w Henrykowie|Henryków|Plac Cystersów 4D |57-210 Henryków;71;41;41;6;35;57.75;14.63
84939;022406;Polskie Centrum Zdrowia Instytut Medyczny Oddział Terenowy Ziębice Zakład Opiekuńczo-Leczniczy|Ziębice|Kolejowa 29 |57-220 Ziębice;88;35;35;1;34;39.77;2.86
84940;022407;Samorządowy Zespół Szkół|Złoty Stok|ul.Chemików 8 |57-250 Złoty Stok;784;294;294;8;286;37.50;2.72
84941;022407;Samorządowy Zespół Szkół|Złoty Stok|ul. Chemików 8 |57-250 Złoty Stok;773;279;279;11;268;36.09;3.94
84942;022407;Samorządowy Zespół Szkół|Złoty Stok|Chemików 8 |57-250 Złoty Stok;792;377;377;11;366;47.60;2.92
84943;022407;Świetlica Wiejska|Błotnica| 15 |57-250 Złoty Stok;300;102;102;6;96;34.00;5.88
84944;022407;Remiza OSP|Mąkolno| 48a |57-250 Złoty Stok;435;175;175;3;172;40.23;1.71
84945;022407;Świetlica Wiejska|Chwalisław| 50 |57-250 Złoty Stok;195;73;73;1;72;37.44;1.37
84946;022407;Świetlica Wiejska|Laski| 126 |57-251 Złoty Stok;529;195;195;6;189;36.86;3.08
84947;022501;Ośrodek Kultury w Zawidowie|Zawidów|ul. Zgorzelecka 39 |59-970 Zawidów;1714;726;726;22;704;42.36;3.03
84948;022501;Zespół Szkół Szkoły Podstawowej im. Bolesława Chrobrego i Gimnazjum w Zawidowie|Zawidów|ul. Szkolna 4 |59-970 Zawidów;1697;742;742;46;696;43.72;6.20
84949;022502;Gimnazjum Nr 1 im. Bolesława Chrobrego|Zgorzelec|ul. Kościuszki 68 |59-900 Zgorzelec;1238;628;628;19;609;50.73;3.03
84950;022502;Przedszkole Niepubliczne Nr 2|Zgorzelec|ul. Brzozowa 1 |59-900 Zgorzelec;1122;518;518;11;507;46.17;2.12
84951;022502;Szkoła Podstawowa Nr 5 im. Marii Skłodowskiej-Curie|Zgorzelec|ul. Prusa 17 |59-900 Zgorzelec;1220;623;623;9;614;51.07;1.44
84952;022502;Przedszkole Publiczne Nr 12|Zgorzelec|ul. Wyspiańskiego 9a |59-900 Zgorzelec;1288;686;686;10;676;53.26;1.46
84953;022502;Gimnazjum Nr 1 im. Bolesława Chrobrego|Zgorzelec|ul. Kościuszki 68 |59-900 Zgorzelec;1242;604;604;17;587;48.63;2.81
84954;022502;Przedszkole Niepubliczne Nr 4 z Oddziałami Integracyjnymi|Zgorzelec|ul. Broniewskiego 27a |59-900 Zgorzelec;1237;607;607;10;597;49.07;1.65
84955;022502;Miejski Ośrodek Pomocy Społecznej|Zgorzelec|ul. Traugutta 77b |59-900 Zgorzelec;1249;653;653;15;638;52.28;2.30
84956;022502;Przedszkole Niepubliczne Nr 3 "Pajacyk"|Zgorzelec|ul. Tuwima 2a |59-900 Zgorzelec;1222;603;603;14;589;49.35;2.32
84957;022502;Szkoła Podstawowa Nr 3 im. Janusza Korczaka|Zgorzelec|ul. Armii Krajowej 10a |59-900 Zgorzelec;1200;605;605;8;597;50.42;1.32
84958;022502;DPFA Europrymus sp. z o.o.|Zgorzelec|ul. Bohaterów II Armii WP 16 |59-900 Zgorzelec;1208;689;689;5;684;57.04;0.73
84959;022502;Szkoła Podstawowa Nr 3 im. Janusza Korczaka|Zgorzelec|ul. Armii Krajowej 10a |59-900 Zgorzelec;1172;616;616;12;604;52.56;1.95
84960;022502;Państwowa Szkoła Muzyczna I i II stopnia im. Feliksa Nowowiejskiego|Zgorzelec|ul. Langiewicza 29 |59-900 Zgorzelec;1153;535;535;16;519;46.40;2.99
84961;022502;Przedszkole Publiczne Nr 2|Zgorzelec|ul. Kościuszki 1 |59-900 Zgorzelec;1222;593;593;21;572;48.53;3.54
84962;022502;Gimnazjum Nr 3 im. Armii Krajowej|Zgorzelec|ul. Piłsudskiego 1 |59-900 Zgorzelec;1187;411;411;11;400;34.63;2.68
84963;022502;Liceum Ogólnokształcące im. Braci Śniadeckich|Zgorzelec|ul. Partyzantów 4 |59-900 Zgorzelec;1210;578;578;10;568;47.77;1.73
84964;022502;Centrum Sportowo Rekreacyjne Sp. z o.o.|Zgorzelec|ul. Maratońska 2 |59-900 Zgorzelec;1159;547;547;18;529;47.20;3.29
84965;022502;Zespół Szkół Ponadgimnazjalnych im. Emilii Plater|Zgorzelec|ul. Francuska 6 |59-900 Zgorzelec;1205;542;542;12;530;44.98;2.21
84966;022502;Przedszkole Publiczne Nr 8 z Oddziałami Integracyjnymi|Zgorzelec|ul. Świętego Jana 21a |59-900 Zgorzelec;1199;529;529;10;519;44.12;1.89
84967;022502;Szkoła Podstawowa Nr 2 z Oddziałami Integracyjnymi im. Jarosława Iwaszkiewicza|Zgorzelec|ul. Reymonta 16 |59-900 Zgorzelec;1296;768;768;13;755;59.26;1.69
84968;022502;Szkoła Podstawowa Nr 2 z Oddziałami Integracyjnymi im. Jarosława Iwaszkiewicza|Zgorzelec|ul. Reymonta 16 |59-900 Zgorzelec;1260;622;622;10;612;49.37;1.61
84969;022502;Gimazjum Nr 2 z Oddziałami Integracyjnymi im. Jana Pawła II|Zgorzelec|ul. Orzeszkowej 60 |59-900 Zgorzelec;1255;673;673;7;666;53.63;1.04
84970;022502;Dom Pomocy Społecznej "Jutrzenka" w Zgorzelcu|Zgorzelec|ul. Przechodnia 8 |59-900 Zgorzelec;90;21;21;4;17;23.33;19.05
84971;022502;Wielospecjalistyczny Szpital - Samodzielny Publiczny Zespół Opieki Zdrowotnej w Zgorzelcu Szpital Powiatowy im. Jana Pawła II w Zgorzelcu|Zgorzelec|ul. Lubańska 11-12 |59-900 Zgorzelec;41;26;26;2;24;63.41;7.69
84972;022502;Dom Pomocy Społecznej "Ostoja" w Zgorzelcu|Zgorzelec|ul. Pułaskiego 11 |59-900 ;72;34;34;3;31;47.22;8.82
84973;022503;Świetlica wiejska|Kopaczów|ul. Główna 20 |59-921 Sieniawka;280;111;111;7;104;39.64;6.31
84974;022503;Strażnica Ochotniczej Straży Pożarnej|Sieniawka|ul. Rolnicza 1b |59-921 Sieniawka;710;243;243;12;231;34.23;4.94
84975;022503;Zespół Szkoły Podstawowej i Gimnazjum z Oddziałami Integracyjnymi|Porajów|ul. Górnicza 1c |59-921 Sieniawka;1170;458;458;15;443;39.15;3.28
84976;022503;Publiczna Szkoła Podstawowa|Opolno Zdrój|ul. Świerczewskiego 7 |59-921 Sieniawka;1007;383;383;14;369;38.03;3.66
84977;022503;Zespół Szkoły Podstawowej i Gimnazjum|Działoszyn| 33 |59-920 Bogatynia;1245;449;449;24;425;36.06;5.35
84978;022503;Dom Kultury|Bogatynia|ul. Ogrodowa 1 |59-920 Bogatynia;787;344;344;19;325;43.71;5.52
84979;022503;Zespół Szkoły Podstawowej i Gimnazjum z siedzibą w Bogatyni|Bogatynia|ul. Młodych Energetyków 24 |59-920 Bogatynia;703;234;234;25;209;33.29;10.68
84980;022503;Sala Sportowa w byłym gimnazjum nr 2|Bogatynia|ul. Daszyńskiego 53 |59-920 Bogatynia;931;301;301;14;287;32.33;4.65
84981;022503;Publiczna Szkoła Podstawowa nr 1|Bogatynia|Plac Bohaterów Warszawy 1 |59-920 Bogatynia;916;399;399;11;388;43.56;2.76
84982;022503;Przedsiębiorstwo Energetyki Cieplnej|Bogatynia|ul. Daszyńskiego 29 |59-920 Bogatynia;958;463;463;14;449;48.33;3.02
84983;022503;Hala Sportowa|Bogatynia|ul. Sportowa 8 |59-920 Bogatynia;900;434;434;17;417;48.22;3.92
84984;022503;Publiczne Gimnazjum nr 1|Bogatynia|ul. Chopina 15 |59-920 Bogatynia;908;487;487;9;478;53.63;1.85
84985;022503;Bogatyński Ośrodek Kultury|Bogatynia|ul. II Armii Wojska Polskiego 1 |59-920 Bogatynia;903;399;399;19;380;44.19;4.76
84986;022503;Liceum Ogólnokształcące im. Marii Skłodowskiej-Curie|Bogatynia|ul. II Armii Wojska Polskiego 5 |59-920 Bogatynia;886;353;353;13;340;39.84;3.68
84987;022503;Publiczne Przedszkole nr 5|Bogatynia|ul. Fryderyka Chopina 13 |59-920 Bogatynia;948;510;510;7;503;53.80;1.37
84988;022503;Publiczne Przedszkole nr 6|Bogatynia|ul. Wyczółkowskiego 32a |59-920 Bogatynia;895;445;445;22;423;49.72;4.94
84989;022503;Zespół Szkół z Oddziałami Integracyjnymi|Bogatynia|ul. Wyczółkowskiego 42a |59-920 Bogatynia;931;440;440;13;427;47.26;2.95
84990;022503;Samodzielny Publiczny Zespół Opieki Zdrowotnej|Bogatynia|ul. Wyczółkowskiego 15 |59-920 Bogatynia;893;472;472;15;457;52.86;3.18
84991;022503;Zespół Szkół z Oddziałami Integracyjnymi|Bogatynia|ul. Wyczółkowskiego 42a |59-920 Bogatynia;887;428;428;9;419;48.25;2.10
84992;022503;Zespół Szkół Zawodowych im. Św. Barbary|Bogatynia|ul. Kościuszki 33 |59-920 Bogatynia;1126;562;562;13;549;49.91;2.31
84993;022503;Multifunkcjonalne Centrum Trójstyku|Bogatynia|ul. Nadrzeczna 18 |59-920 Bogatynia;965;419;419;14;405;43.42;3.34
84994;022503;Szpital Gminny Samodzielnego Publicznego Zespołu Opieki Zdrowotnej w Bogatyni|Bogatynia|ul. Szpitalna 16 |59-920 Bogatynia;39;21;21;0;21;53.85;0.00
84995;022503;Wielospecjalistyczny Szpital - Samodzielny Publiczny Zespół Opieki Zdrowotnej w Zgorzelcu, Zakład dla Nerwowo i Psychicznie Chorych im. M. Marzyńskiego|Sieniawka|ul. Rolnicza 25 |59-921 Sieniawka;173;26;26;3;23;15.03;11.54
84996;022504;Szkoła Podstawowa nr 1 w Pieńsku|Pieńsk|ul. Szkolna 1 |59-930 Pieńsk;1067;491;491;13;478;46.02;2.65
84997;022504;Szkoła Podstawowa nr 1 w Pieńsku|Pieńsk|ul. Szkolna 1 |59-930 Pieńsk;930;337;337;21;316;36.24;6.23
84998;022504;Euroregionalne Centrum Kultury i Komunikacji|Pieńsk|ul. Świerczewskiego 23 |59-930 Pieńsk;981;354;354;24;330;36.09;6.78
84999;022504;Gimnazjum w Pieńsku|Pieńsk|ul. Zgorzelecka 29 |59-930 Pieńsk;770;254;254;22;232;32.99;8.66
85000;022504;Gimnazjum Hala Widowiskowo Sportowa w Pieńsku|Pieńsk|ul. Zgorzelecka 29 |59-930 Pieńsk;926;349;349;19;330;37.69;5.44
85001;022504;Świetlica Wiejska|Stojanów| 18 |59-930 Pieńsk;386;72;72;5;67;18.65;6.94
85002;022504;Sala Gimnastyczna przy Szkole Podstawowej w Dłużynie Dolnej|Dłużyna Dolna| 66A |59-930 Pieńsk;577;180;180;11;169;31.20;6.11
85003;022504;Szkoła Podstawowa w Dłużynie Dolnej|Dłużyna Dolna| 66A |59-930 Pieńsk;684;253;253;12;241;36.99;4.74
85004;022504;Świetlica Wiejska|Lasów| 13 |59-950 Pieńsk;507;169;169;8;161;33.33;4.73
85005;022504;Świetlica Wiejska|Żarki Średnie| 107b |59-950 Pieńsk;492;150;150;5;145;30.49;3.33
85006;022505;Zespół Szkoły Podstawowej i Gimnazjum im. Jana Pawła II w Sulikowie|Sulików|ul. Zgorzelecka 28 |59-975 Sulików;983;433;433;13;420;44.05;3.00
85007;022505;Gminny Ośrodek Kultury w Sulikowie|Sulików|Plac Wolności 9 |59-975 Sulików;1063;515;515;17;498;48.45;3.30
85008;022505;Szkoła Podstawowa w Biernej|Bierna| 57 |59-970 Zawidów;1117;405;405;20;385;36.26;4.94
85009;022505;Świetlica Wiejska we Wrociszowie Górnym|Wrociszów Górny| 8 |59-970 Zawidów;850;318;318;19;299;37.41;5.97
85010;022505;Świetlica Wiejska w Studniskach Dolnych|Studniska Dolne| 66A |59-975 Sulików;858;357;357;17;340;41.61;4.76
85011;022506;Węglinieckie Centrum Kultury|Węgliniec|Plac Wolności 1 |59-940 Węgliniec;979;360;360;26;334;36.77;7.22
85012;022506;Węglinieckie Centrum Kultury|Węgliniec|Plac Wolności 1 |59-940 Węgliniec;1446;699;699;23;676;48.34;3.29
85013;022506;Klub "Relax"|Zielonka| 7 |59-940 Węgliniec;236;84;84;6;78;35.59;7.14
85014;022506;Dom Kultury|Stary Węgliniec|ul. Konopnickiej 3 |59-940 Węgliniec;813;315;315;12;303;38.75;3.81
85015;022506;Dom Kultury|Jagodzin| 30 |59-950 Ruszów;494;182;182;10;172;36.84;5.49
85016;022506;Dom Kultury|Ruszów|ul. Strzelecka 3 |59-950 Ruszów;875;333;333;16;317;38.06;4.80
85017;022506;Dom Kultury|Ruszów|ul. Strzelecka 3 |59-940 Węgliniec;780;282;282;22;260;36.15;7.80
85018;022506;Szkoła Podstawowa|Czerwona Woda|ul. Kolejowa 22 |59-940 Węgliniec;1296;470;470;20;450;36.27;4.26
85019;022507;Szkoła Podstawowa im. W. Chotomskiej w Łagowie|Łagów|ul. Szkolna 2 |59-900 Zgorzelec;510;293;293;7;286;57.45;2.39
85020;022507;Szkoła Podstawowa im. W. Chotomskiej w Łagowie|Łagów|ul. Szkolna 2 |59-900 Zgorzelec;616;286;286;6;280;46.43;2.10
85021;022507;Szkoła Podstawowa im. Osadników Wojskowych w Trójcy|Trójca| 77 |59-900 Zgorzelec;455;195;195;4;191;42.86;2.05
85022;022507;Świetlica Wiejska w Białogórzu|Białogórze| 16 |59-900 Zgorzelec;351;143;143;3;140;40.74;2.10
85023;022507;Remiza w Sławnikowicach|Sławnikowice| 59 |59-900 Zgorzelec;527;196;196;7;189;37.19;3.57
85024;022507;Szkoła Podstawowa im. J. Brzechwy w Żarskiej Wsi|Żarska Wieś| 32 |59-900 Zgorzelec;424;157;157;6;151;37.03;3.82
85025;022507;Szkoła Podstawowa im. J. Brzechwy w Żarskiej Wsi|Żarska Wieś| 32 |59-900 Zgorzelec;357;126;126;4;122;35.29;3.17
85026;022507;Świetlica Środowiskowa w Tylicach|Tylice| 29A |59-900 Zgorzelec;502;216;216;6;210;43.03;2.78
85027;022507;Świetlica Wiejska w Koźminie|Koźmin| 22 |59-900 Zgorzelec;364;153;153;7;146;42.03;4.58
85028;022507;Szkoła Podstawowa w Osieku Łużyckim|Osiek Łużycki| 56 |59-900 Zgorzelec;440;144;144;12;132;32.73;8.33
85029;022507;Świetlica Wiejska w Radomierzycach|Radomierzyce| 14a |59-900 Zgorzelec;365;173;173;3;170;47.40;1.73
85030;022507;Świetlica Wiejska w Ręczynie|Ręczyn| 29A |59-900 Zgorzelec;512;204;204;10;194;39.84;4.90
85031;022507;Gimnazjum im. Sybiraków w Jerzmankach|Jerzmanki| 43 |59-900 Zgorzelec;335;110;110;7;103;32.84;6.36
85032;022507;Gimnazjum im. Sybiraków w Jerzmankach|Jerzmanki| 43 |59-900 Zgorzelec;384;157;157;3;154;40.89;1.91
85033;022507;Publiczne Przedszkole Krasnoludki w Jedrzychowicach|Jędrzychowice| 74 |59-900 Zgorzelec;572;217;217;17;200;37.94;7.83
85034;022601;Miejska Biblioteka Publiczna|Wojcieszów|ul. Juliusza Słowackiego 6 |59-550 Wojcieszów;1382;523;523;24;499;37.84;4.59
85035;022601;Miejski Ośrodek Pomocy Społecznej|Wojcieszów|ul.Bolesława Chrobrego 105 |59-550 Wojcieszów;862;305;305;13;292;35.38;4.26
85036;022601;Remiza Ochotniczej Straży Pożarnej|Wojcieszów|ul. Bolesława Chrobrego 197 |59-550 Wojcieszów;808;289;289;9;280;35.77;3.11
85037;022602;Przedsiębiorstwo Produkcyjno-Handlowe "Vitbis"|Złotoryja|ul. Legnicka 31 |59-500 Złotoryja;986;472;472;16;456;47.87;3.39
85038;022602;Złotoryjski Ośrodek Kultury i Rekreacji|Złotoryja|pl. Reymonta 5 |59-500 Zlotoryja;1630;787;787;30;757;48.28;3.81
85039;022602;Liceum Ogólnokształcące|Złotoryja|ul. Kolejowa 4 |59-500 Złotoryja;1700;599;599;29;570;35.24;4.84
85040;022602;Szkoła Podstawowa Nr 3|Złotoryja|ul. Wilcza 41 |59-500 Złotoryja;1778;930;930;11;919;52.31;1.18
85041;022602;Szkoła Podstawowa Nr 1|Złotoryja|pl.Niepodległości 7 |59-500 Złotoryja;1529;584;584;21;563;38.19;3.60
85042;022602;Zespół Szkół Zawodowych|Złotoryja|ul. Wojska Polskiego 50 |59-500 Złotoryja;860;426;426;11;415;49.53;2.58
85043;022602;Przedszkole Miejskie Nr 2|Złotoryja|ul. Górnicza 21/23 |59-500 Złotoryja;1828;989;989;31;958;54.10;3.13
85044;022602;Powiatowy Urząd Pracy|Złotoryja|al. Miła 18 |59-500 Złotoryja;865;350;350;14;336;40.46;4.00
85045;022602;Hala Sportowa "Tęcza" przy Szkole Podstawowej nr 3|Złotoryja|Wilcza 43 |59-500 Złotoryja;1926;901;901;25;876;46.78;2.77
85046;022602;Szpital im. Andrzeja Wolańczyka|Złotoryja|Hoża 11 |59-500 Złotoryja;153;44;44;0;44;28.76;0.00
85047;022602;Wojewódzki Szpital Psychiatryczny|Złotoryja|Szpitalna 9 |59-500 Złotoryja;119;48;48;8;40;40.34;16.67
85048;022603;Świetlica Wiejska|Czaple| 29 |59-524 Pielgrzymka;247;107;107;3;104;43.32;2.80
85049;022603;Urząd Gminy|Pielgrzymka| 109A/1 |59-524 Pielgrzymka;770;294;294;18;276;38.18;6.12
85050;022603;Warsztat Terapii Zajęciowej|Wojcieszyn| 37 |59-524 Pielgrzymka;412;157;157;8;149;38.11;5.10
85051;022603;Świetlica Wiejska|Nowa Wieś Grodziska| 45a |59-524 Pielgrzymka;652;268;268;7;261;41.10;2.61
85052;022603;Sala Gimnastyczna|Sędzimirów| 47 |59-524 Pielgrzymka;317;111;111;5;106;35.02;4.50
85053;022603;Świetlica Wiejska|Proboszczów| 45a |59-524 Pielgrzymka;794;267;267;12;255;33.63;4.49
85054;022603;Zespół Szkolno - Przedszkolny|Twardocice| 53 |59-524 Pielgrzymka;529;188;188;8;180;35.54;4.26
85055;022604;Centrum Kultury, Sportu i Turystyki|Świerzawa|ul. Jeleniogórska 58 |59-540 Świerzawa;2105;834;834;33;801;39.62;3.96
85056;022604;Szkoła Podstawowa|Nowy Kościół|ul. Szkolna 12 |59-540 Świerzawa;1091;392;392;17;375;35.93;4.34
85057;022604;Świetlica Wiejska|Stara Kraśnica| 41 |59-540 Świerzawa;477;182;182;6;176;38.16;3.30
85058;022604;Świetlica Wiejska|Sędziszowa|ul. Górna 19 |59-540 Świerzawa;392;150;150;11;139;38.27;7.33
85059;022604;Szkoła Podstawowa|Sokołowiec| 105 |59-540 Świerzawa;549;156;156;6;150;28.42;3.85
85060;022604;Remiza OSP|Podgórki| 137 |59-550 Wojcieszów;355;136;136;7;129;38.31;5.15
85061;022604;Wiejski Dom Kultury|Lubiechowa|ul. Długa 31 |59-540 Świerzawa;466;214;214;16;198;45.92;7.48
85062;022604;Wiejski Dom Kultury|Dobków| 64 |59-540 Świerzawa;395;139;139;1;138;35.19;0.72
85063;022604;Świetlica Wiejska|Rząśnik| 21 |59-540 Świerzawa;357;120;120;15;105;33.61;12.50
85064;022605;Świetlica wiejska|Brochocin| 26 A |59-516 Zagrodno;746;234;234;7;227;31.37;2.99
85065;022605;Szkoła Podstawowa|Radziechów| 80 |59-516 Zagrodno;804;328;328;16;312;40.80;4.88
85066;022605;Świetlica Wiejska|Grodziec| 99A |59-516 Zagrodno;340;129;129;6;123;37.94;4.65
85067;022605;Remiza OSP|Olszanica| 79B |59-516 Zagrodno;742;312;312;17;295;42.05;5.45
85068;022605;Remiza OSP|Zagrodno| 52A |59-516 Zagrodno;1217;537;537;20;517;44.12;3.72
85069;022605;Świetlica Wiejska|Uniejowice| 109A |59-516 Zagrodno;583;256;256;8;248;43.91;3.12
85070;022606;Świetlica wiejska|Jerzmanice-Zdrój| 68a |59-500 Złotoryja;764;325;325;9;316;42.54;2.77
85071;022606;Szkoła Podstawowa|Gierałtowiec| 42 |59-500 Złotoryja;1104;441;441;14;427;39.95;3.17
85072;022606;Świetlica wiejska|Lubiatów| 39b |59-500 Złotoryja;631;198;198;11;187;31.38;5.56
85073;022606;Szkoła Podstawowa|Rokitnica| 35 |59-500 Złotoryja;941;483;483;13;470;51.33;2.69
85074;022606;Świetlica wiejska|Prusice| 16 |59-500 Złotoryja;663;239;239;11;228;36.05;4.60
85075;022606;Świetlica wiejska|Wilków| 52 |59-500 Złotoryja;616;232;232;12;220;37.66;5.17
85076;022606;Świetlica|Wilków-Osiedle|ul. Kochanowskiego 1 |59-500 Złotoryja;937;421;421;12;409;44.93;2.85
85077;026101;Budynek przy ulicy Goduszyńskiej|Jelenia Góra|ul. Goduszyńska 11 |58-500 Jelenia Góra;384;147;147;3;144;38.28;2.04
85078;026101;Biuro Wystaw Artystycznych|Jelenia Góra|ul. Długa 1 |58-500 Jelenia Góra;1659;866;866;14;852;52.20;1.62
85079;026101;Powiatowa Stacja Sanitarno-Epidemiologiczna|Jelenia Góra|ul. Kasprowicza 17 |58-500 Jelenia Góra;1638;714;714;7;707;43.59;0.98
85080;026101;Zespół Szkół Technicznych "Mechanik"|Jelenia Góra|ul. Obrońców Pokoju 10 |58-500 Jelenia Góra;1156;447;447;12;435;38.67;2.68
85081;026101;Szkoła Podstawowa Nr 13|Jelenia Góra|ul. P. Skargi 19 |58-500 Jelenia Góra;1836;793;793;20;773;43.19;2.52
85082;026101;Zespół Szkół Elektronicznych i Gimnazjum Nr 3|Jelenia Góra|ul. Grunwaldzka 64a |58-500 Jelenia Góra;1329;589;589;7;582;44.32;1.19
85083;026101;Przychodnia "Jelmed"|Jelenia Góra|ul. Powstańców Śl. 6 |58-500 Jelenia Góra;1793;761;761;20;741;42.44;2.63
85084;026101;Szkoła Podstawowa Nr 5|Jelenia Góra|ul. Lotnictwa 1 |58-500 Jelenia Góra;858;338;338;14;324;39.39;4.14
85085;026101;Budynek Aeroklubu Jeleniogórskiego|Jelenia Góra|ul. Łomnicka |58-500 Jelenia Góra;495;254;254;6;248;51.31;2.36
85086;026101;Jeleniogórskie Centrum Kultury|Jelenia Góra|ul. 1 Maja 60 |58-500 Jelenia Góra;1896;943;943;35;908;49.74;3.71
85087;026101;Teatr im. Cypriana Kamila Norwida|Jelenia Góra|ul. Wojska Polskiego 38 |58-500 Jelenia Góra;1628;731;731;13;718;44.90;1.78
85088;026101;Ośrodek Zdrowia|Jelenia Góra|ul. Wrocławska 71 |58-506 Jelenia Góra;857;415;415;10;405;48.42;2.41
85089;026101;Szkoła Podstawowa nr 11|Jelenia Góra|ul. Moniuszki 9 |58-506 Jelenia Góra;1233;605;605;11;594;49.07;1.82
85090;026101;Zespół Szkół Ogólnokształcących i Technicznych|Jelenia Góra|Al. Jana Pawła II 25 |58-506 Jelenia Góra;1312;710;710;4;706;54.12;0.56
85091;026101;Niepubliczne Przedszkole "Kacperek"|Jelenia Góra|ul. Różyckiego 2 |58-506 Jelenia Góra;1478;762;762;18;744;51.56;2.36
85092;026101;Szkoła Podstawowa Nr 8|Jelenia Góra|ul. Paderewskiego 13 |58-506 Jelenia Góra;1911;954;954;10;944;49.92;1.05
85093;026101;Gimnazjum Nr 4|Jelenia Góra|ul. Karłowicza 33 |58-506 Jelenia Góra;2228;1169;1169;26;1143;52.47;2.22
85094;026101;Szkoła Podstawowa Nr 11|Jelenia Góra|ul. Moniuszki 9 |58-506 Jelenia Góra;2305;1329;1329;21;1308;57.66;1.58
85095;026101;Zakład Ubezpieczeń Społecznych|Jelenia Góra|ul. Sygietyńskiego 10 |58-506 Jelenia Góra;2077;1205;1205;16;1189;58.02;1.33
85096;026101;Spółdzielnia Mieszkaniowa "Związkowiec" (świetlica)|Jelenia Góra|ul. Kiepury 59 |58-506 Jelenia Góra;2177;1297;1297;21;1276;59.58;1.62
85097;026101;Urząd Pocztowy Jelenia Góra 14|Jelenia Góra|ul. Sygietyńskiego 8 |58-506 Jelenia Góra;2090;1189;1189;19;1170;56.89;1.60
85098;026101;Osiedlowy Dom Kultury|Jelenia Góra|ul. Komedy Trzcińskiego 12 |58-506 Jelenia Góra;1915;1063;1063;19;1044;55.51;1.79
85099;026101;Zespół Szkół Ogólnokształcących i Technicznych|Jelenia Góra|Al. Jana Pawła II 25 |58-506 Jelenia Góra;1659;863;863;12;851;52.02;1.39
85100;026101;Uniwersytet Ekonomiczny we Wrocławiu Wydział Ekonomii, Zarządzania i Turystyki w Jeleniej Górze|Jelenia Góra|ul. Nowowiejska 3 |58-500 Jelenia Góra;1569;819;819;10;809;52.20;1.22
85101;026101;Książnica Karkonoska|Jelenia Góra|ul. Bankowa 27 |58-500 Jelenia Góra;879;370;370;17;353;42.09;4.59
85102;026101;Szkoła Podstawowa Nr 10|Jelenia Góra|ul. Morcinka 31 |58-500 Jelenia Góra;2055;1104;1104;16;1088;53.72;1.45
85103;026101;Poradnia Profilaktyki i Terapii Uzależnień Monar|Jelenia Góra|ul. Wolności 70 |58-500 Jelenia Góra;1742;753;753;24;729;43.23;3.19
85104;026101;Agroland|Jelenia Góra|ul. Kalinowa 16 |58-500 Jelenia Góra;1475;830;830;20;810;56.27;2.41
85105;026101;Szkoła Podstawowa Nr 7|Jelenia Góra|ul. Sudecka 53 |58-500 Jelenia Góra;1732;810;810;9;801;46.77;1.11
85106;026101;Budynek Administracyjny MZK|Jelenia Góra|ul. Wolności 145 |58-500 Jelenia Góra;1369;629;629;8;621;45.95;1.27
85107;026101;Szkoła Podstawowa Nr 10|Jelenia Góra|ul. Morcinka 31 |58-500 Jelenia Góra;2097;1058;1058;10;1048;50.45;0.95
85108;026101;Filia Politechniki Wrocławskiej|Jelenia Góra|Pl. Piastowski 27 |58-560 Jelenia Góra;1225;565;565;16;549;46.12;2.83
85109;026101;Termy Cieplickie Spółka z o.o.|Jelenia Góra|ul. Park Zdrojowy 5 |58-560 Jelenia Góra;1894;1012;1012;19;993;53.43;1.88
85110;026101;Szkoła Podstawowa Nr 3|Jelenia Góra|ul. PCK 14a |58-560 Jelenia Góra;1588;907;907;10;897;57.12;1.10
85111;026101;Miejskie Integracyjne Przedszkole Nr 14|Jelenia Góra|ul. Junaków 2a |58-560 Jelenia Góra;2271;1157;1157;18;1139;50.95;1.56
85112;026101;Zespół Szkół Rzemiosł Artystycznych|Jelenia Góra|ul. Cieplicka 34 |58-560 Jelenia Góra;1794;895;895;25;870;49.89;2.79
85113;026101;Szkoła Podstawowa Nr 6|Jelenia Góra|ul. Cieplicka 74 |58-560 Jelenia Góra;1811;971;971;13;958;53.62;1.34
85114;026101;Zespół Szkół Ogólnokształcących Nr 2|Jelenia Góra|ul. Gimnazjalna 2 |58-560 Jelenia Góra;1421;642;642;11;631;45.18;1.71
85115;026101;Miejski Dom Kultury "MUFLON"|Jelenia Góra|ul. Cieplicka 172 |58-570 Jelenia Góra;2007;1048;1048;26;1022;52.22;2.48
85116;026101;Zespół Szkoły Podstawowej Nr 15 i Gimnazjum Nr 5|Jelenia Góra|ul. Kamiennogórska 9 |58-570 Jelenia Góra;1285;619;619;15;604;48.17;2.42
85117;026101;Watra Jagniątkowska|Jelenia Góra|ul. Karkonoska 118 |58-570 Jelenia Góra;561;286;286;5;281;50.98;1.75
85118;026101;Zakład Opiekuńczo-Leczniczy o Profilu Rehabilitacyjnym|Jelenia Góra|ul. Żeromskiego 2 |58-500 Jelenia Góra;76;22;22;1;21;28.95;4.55
85119;026101;Wojewódzkie Centrum Szpitalne Kotliny Jeleniogórskiej w Jeleniej Górze|Jelenia Góra|ul. Ogińskiego 6 |58-506 Jelenia Góra;500;106;106;3;103;21.20;2.83
85120;026101;Areszt Śledczy|Jelenia Góra|ul. Grottgera 2 |58-500 Jelenia Góra;285;149;149;14;135;52.28;9.40
85121;026101;Zespół Szpitalno-Sanatoryjny|Jelenia Góra|Pl.Piastowski 38 |58-560 Jelenia Góra;312;290;290;2;288;92.95;0.69
85122;026101;Dom Pomocy Społecznej "Pogodna Jesień"|Jelenia Góra|ul. Leśna 3 |58-560 Jelenia Góra;87;63;63;2;61;72.41;3.17
85123;026201;d. Zespół Szkół Rolniczych|Legnica|ul. Jaworzyńska 219 |59-220 Legnica;2382;1237;1237;29;1208;51.93;2.34
85124;026201;Zespół Szkół Budowlanych|Legnica|ul. Grabskiego 14/22 |59-220 Legnica;1609;744;744;15;729;46.24;2.02
85125;026201;Szkoła Podstawowa nr 10|Legnica|ul. Jaworzyńska 47 |59-220 Legnica;1962;968;968;15;953;49.34;1.55
85126;026201;Zespół Szkół Elektryczno-Mechanicznych|Legnica|ul. Skarbka 4 |59-220 Legnica;1763;867;867;14;853;49.18;1.61
85127;026201;Zespół Szkół Ekonomicznych|Legnica|Plac Słowiański 5 |59-220 Legnica;1721;781;781;21;760;45.38;2.69
85128;026201;Młodzieżowe Centrum Kultury|Legnica|ul. Mickiewicza 3 |59-220 Legnica;1465;650;650;15;635;44.37;2.31
85129;026201;Szkoła Podstawowa Nr 19|Legnica|Al. Rzeczypospolitej 129 |59-220 Legnica;2279;1310;1310;23;1287;57.48;1.76
85130;026201;Sala gimnastyczna Szkoły Podstawowej Nr 6|Legnica|Aleja Piłsudskiego (wejście od podwórka) 3 |59-220 Legnica;1900;977;977;16;961;51.42;1.64
85131;026201;Klub Seniora|Legnica|ul. Moniuszki 9 |59-220 Legnica;1865;798;798;13;785;42.79;1.63
85132;026201;Szkoła Podstawowa Nr 1|Legnica|ul. Kamienna 20a |59-220 Legnica;1267;470;470;11;459;37.10;2.34
85133;026201;Sala gimnastyczna Szkoły Podstawowej Nr 1|Legnica|ul. Kamienna 20a |59-220 Legnica;1457;415;415;6;409;28.48;1.45
85134;026201;Świetlica Terapeutyczna Nr 1|Legnica|ul. Bracka 16 |59-220 Legnica;1894;643;643;17;626;33.95;2.64
85135;026201;Sala konferencyjna Wojewódzkiego Szpitala Specjalistycznego|Legnica|ul. Iwaszkiewicza 5 |59-220 Legnica;2000;969;969;16;953;48.45;1.65
85136;026201;Przedszkole Niepubliczne "Tęczowy Zakątek"|Legnica|ul. Witkiewicza 4 |59-220 Legnica;1902;1076;1076;21;1055;56.57;1.95
85137;026201;Zespół Szkół Integracyjnych|Legnica|ul. Wierzyńskiego (wejście główne) 1 |59-220 Legnica;1652;887;887;14;873;53.69;1.58
85138;026201;Zespół Szkół Integracyjnych|Legnica|ul. Wierzyńskiego (wejście od ul. Gałczyńskiego) 1 |59-220 Legnica;1765;1032;1032;18;1014;58.47;1.74
85139;026201;Zespół Szkół Integracyjnych|Legnica|ul. Wierzyńskiego (wejście od Al. Piłsudskiego) 1 |59-220 Legnica;1807;1044;1044;14;1030;57.78;1.34
85140;026201;Miejskie Przedszkole Nr 18|Legnica|ul. Staffa 6 |59-220 Legnica;2052;1263;1263;13;1250;61.55;1.03
85141;026201;Sala konferencyjna Spółdzielni Mieszkaniowej "PIEKARY"|Legnica|ul. Bieszczadzka 1a |59-220 Legnica;1661;895;895;21;874;53.88;2.35
85142;026201;Szkoła Podstawowa Nr 16|Legnica|ul. Tatrzańska 9 |59-220 Legnica;1616;929;929;8;921;57.49;0.86
85143;026201;Zespół Szkół Ogólnokształcących Nr 3|Legnica|ul. Mazowiecka 3 |59-220 Legnica;1699;925;925;15;910;54.44;1.62
85144;026201;Sala gimnastyczna Zespołu Szkół Ogólnokształcących Nr 3|Legnica|ul.Mazowiecka (wejście od ul.Kujawskiej-k/basenu) 3 |59-220 Legnica;1669;892;892;12;880;53.45;1.35
85145;026201;Szkoła Podstawowa Nr 7|Legnica|ul. Polarna 1 |59-220 Legnica;1452;772;772;8;764;53.17;1.04
85146;026201;Spółdzielczy Dom Kultury "KOPERNIK"|Legnica|ul. Koziorożca 9 |59-220 Legnica;1860;1068;1068;15;1053;57.42;1.40
85147;026201;Sala konferencyjna Legnickiej Spółdzielni Mieszkaniowej|Legnica|ul. Gwiezdna 8 |59-220 Legnica;1279;693;693;18;675;54.18;2.60
85148;026201;Miejskie Przedszkole Nr 6|Legnica|ul. Andromedy 14 |59-220 Legnica;1668;962;962;12;950;57.67;1.25
85149;026201;Miejskie Przedszkole Nr 13|Legnica|ul. Wielkiej Niedźwiedzicy 14a |59-220 Legnica;1307;781;781;16;765;59.76;2.05
85150;026201;Zespół Szkół Ogólnokształcących Nr 2|Legnica|ul. Radosna 17 |59-220 Legnica;2012;1253;1253;19;1234;62.28;1.52
85151;026201;Szkoła Podstawowa Nr 6|Legnica|Al. Piłsudskiego 3 |59-220 Legnica;1409;805;805;6;799;57.13;0.75
85152;026201;I Liceum Ogólnokształcące|Legnica|Plac Klasztorny 7 |59-220 Legnica;1061;425;425;6;419;40.06;1.41
85153;026201;II Liceum Ogólnokształcące|Legnica|ul. Zielona 17 |59-220 Legnica;1403;572;572;13;559;40.77;2.27
85154;026201;Zamek Piastowski Wejście "A"|Legnica|Plac Zamkowy 1 |59-220 Legnica;912;365;365;9;356;40.02;2.47
85155;026201;Urząd Stanu Cywilnego|Legnica|ul. Chojnowska (poczekalnia Sali Ślubów) 2 |59-220 Legnica;1215;682;682;14;668;56.13;2.05
85156;026201;Sala gimnastyczna Zespołu Placówek Specjalnych|Legnica|ul. Rycerska 13 |59-220 Legnica;854;491;491;3;488;57.49;0.61
85157;026201;Szkoła Podstawowa Nr 4|Legnica|ul. Piastowska 3 |59-220 Legnica;1164;506;506;16;490;43.47;3.16
85158;026201;Hala Sportowa|Legnica|ul. Głogowska 16 |59-220 Legnica;1951;748;748;32;716;38.34;4.28
85159;026201;Zespół Szkół Samochodowych|Legnica|ul. Słubicka 7 |59-220 Legnica;2319;1293;1293;26;1267;55.76;2.01
85160;026201;V Liceum Ogólnokształcące|Legnica|ul. Senatorska 32 |59-220 Legnica;1636;608;608;20;588;37.16;3.29
85161;026201;Sala gimnastyczna Szkoły Podstawowej Nr 4|Legnica|ul. Piastowska 3 |59-220 Legnica;1546;607;607;22;585;39.26;3.62
85162;026201;Miejskie Przedszkole Nr 16|Legnica|ul. Żwirki i Wigury 32 |59-220 Legnica;1704;730;730;25;705;42.84;3.42
85163;026201;Politechnika Wrocławska ZOD|Legnica|ul. Stefana Batorego 9 |59-220 Legnica;1686;854;854;14;840;50.65;1.64
85164;026201;Filia Szkoły Podstawowej Nr 9|Legnica|ul. Krzemieniecka 1 |59-220 Legnica;1369;743;743;24;719;54.27;3.23
85165;026201;Hala Sportowa|Legnica|ul. Sejmowa 3a |59-220 Legnica;1810;769;769;15;754;42.49;1.95
85166;026201;MOPS Ośrodek Interwencji Kryzysowej|Legnica|ul. Okrzei 9 |59-220 Legnica;1782;839;839;8;831;47.08;0.95
85167;026201;Centrum Kształcenia Zawodowego i Ustawicznego|Legnica|ul. Lotnicza 26 |59-220 Legnica;1575;859;859;11;848;54.54;1.28
85168;026201;Szkoła Podstawowa Nr 9|Legnica|ul. Marynarska 31 |59-220 Legnica;1995;1229;1229;10;1219;61.60;0.81
85169;026201;Zespół Szkół Technicznych i Ogólnokształcących|Legnica|ul. Złotoryjska 144 |59-220 Legnica;2134;1171;1171;29;1142;54.87;2.48
85170;026201;Wojewódzki Szpital Specjalistyczny|Legnica|ul. Iwaszkiewicza 5 |59-220 Legnica;314;89;89;2;87;28.34;2.25
85171;026201;MOPS Dom Pomocy Społecznej dla Dorosłych|Legnica|ul. Grabskiego 11 |59-220 Legnica;52;16;16;1;15;30.77;6.25
85172;026401;Szkoła Podstawowa nr 63|Wrocław|ul. Mennicza 21-23 |50-057 Wrocław;1624;912;912;10;902;56.16;1.10
85173;026401;Budynek Uniwersytetu Wrocławskiego|Wrocław|ul. Kuźnicza 49/55 |50-138 Wrocław;1833;1096;1096;15;1081;59.79;1.37
85174;026401;Gimnazjum nr 29|Wrocław|ul. Księdza Kraińskiego 1 |50-153 Wrocław;1245;791;791;23;768;63.53;2.91
85175;026401;Przedszkole nr 65|Wrocław|ul. Nożownicza 35a |50-147 Wrocław;1558;875;875;17;858;56.16;1.94
85176;026401;BWA Galerie Sztuki Współczesnej|Wrocław|ul. Wita Stwosza 32 |50-149 Wrocław;1475;915;915;1;914;62.03;0.11
85177;026401;Muzeum Militariów-Arsenał|Wrocław|ul. Cieszyńskiego 9 |50-136 Wrocław;1114;613;613;10;603;55.03;1.63
85178;026401;Szkoła Podstawowa nr 84|Wrocław|ul. Świętokrzyska 47 |50-327 Wrocław;791;516;516;3;513;65.23;0.58
85179;026401;Zespół Szkół nr 7|Wrocław|ul. Pawłowa 15 |53-604 Wrocław;2042;1295;1295;15;1280;63.42;1.16
85180;026401;Liceum Ogólnokształcące nr XVII|Wrocław|ul. Tęczowa 60 |53-603 Wrocław;1395;856;856;8;848;61.36;0.93
85181;026401;Liceum Ogólnokształcące nr XVII|Wrocław|ul. Tęczowa 60 |53-603 Wrocław;1550;773;773;6;767;49.87;0.78
85182;026401;Zespół Szkół nr 7 (Szkoła Podstawowa nr 97)|Wrocław|ul. Prosta 16 |53-509 Wrocław;1480;869;869;7;862;58.72;0.81
85183;026401;Zespół Szkolno-Przedszkolny nr 13|Wrocław|pl. Muzealny 20 |50-035 Wrocław;1580;923;923;11;912;58.42;1.19
85184;026401;Klub Muzyki i Literatury|Wrocław|pl. Kościuszki 10 |50-028 Wrocław;1901;1070;1070;15;1055;56.29;1.40
85185;026401;Gimnazjum nr 14|Wrocław|ul. Kołłątaja 1-6 |50-002 Wrocław;2053;1127;1130;16;1111;54.90;1.42
85186;026401;Szkoła Podstawowa nr 71|Wrocław|ul. Podwale 57 |50-039 Wrocław;1300;750;750;19;731;57.69;2.53
85187;026401;Szkoła Podstawowa Nr 68|Wrocław|ul. Szczęśliwa 28 |53-446 Wrocław;1628;936;936;13;923;57.49;1.39
85188;026401;Szkoła Podstawowa Nr 68|Wrocław|ul. Szczęśliwa 28 |53-446 Wrocław;1985;1025;1025;11;1014;51.64;1.07
85189;026401;Szkoła Podstawowa Nr 68|Wrocław|ul. Szczęśliwa 28 |53-446 Wrocław;1625;900;900;15;885;55.38;1.67
85190;026401;Gimnajzum Nr 16|Wrocław|ul. Jemiołowa 57 |53-447 Wrocław;1585;817;817;16;801;51.55;1.96
85191;026401;Zespół Szkół Nr 11|Wrocław|ul. Grochowa 36-38 |53-424 Wrocław;1968;1102;1102;14;1088;56.00;1.27
85192;026401;Zespół Szkół Nr 11|Wrocław|ul. Grochowa 36-38 |53-424 Wrocław;1968;1172;1172;12;1160;59.55;1.02
85193;026401;Gimnazjum Nr 16|Wrocław|ul. Jemiołowa 57 |53-447 Wrocław;1934;1157;1157;13;1144;59.82;1.12
85194;026401;Zespół Szkół Ogólnokształcących Nr 5|Wrocław|ul. Grochowa 13 |53-423 Wrocław;1303;758;758;15;743;58.17;1.98
85195;026401;Zespół Szkół Nr 11|Wrocław|ul. Grochowa 36-38 |53-424 Wrocław;2186;1323;1323;19;1304;60.52;1.44
85196;026401;Przedszkole Nr 141|Wrocław|Aleja Generała Hallera 77a |53-325 Wrocław;2039;1236;1236;15;1221;60.62;1.21
85197;026401;Liceum Ogólnokształcące Nr VII|Wrocław|ul. Krucza 49 |53-410 Wrocław;1609;911;911;12;899;56.62;1.32
85198;026401;Liceum Ogólnokształcące Nr VII|Wrocław|ul. Krucza 49 |53-410 Wrocław;1927;1260;1260;15;1245;65.39;1.19
85199;026401;Gimnazjum nr 6|Wrocław|Aleja Pracy 24 |53-232 Wrocław;1561;931;931;16;915;59.64;1.72
85200;026401;Szkoła Podstawowa nr 109|Wrocław|ul. Inżynierska 54 |53-230 Wrocław;1724;1104;1104;15;1089;64.04;1.36
85201;026401;Szkoła Podstawowa nr 109|Wrocław|ul. Inżynierska 54 |53-230 Wrocław;2017;1267;1267;15;1252;62.82;1.18
85202;026401;Zespół Szkół Budowlanych|Wrocław|ul. Grabiszyńska 236 |53-235 Wrocław;1991;1141;1141;11;1130;57.31;0.96
85203;026401;Szkoła Podstawowa Nr 82|Wrocław|ul. Blacharska 13 |53-206 Wrocław;1942;1324;1324;7;1317;68.18;0.53
85204;026401;Szkoła Podstawowa Nr 82|Wrocław|ul. Blacharska 13 |53-206 Wrocław;2115;1620;1620;49;1571;76.60;3.02
85205;026401;Liceum Ogólnokształcące nr III|Wrocław|ul. Składowa 5 |50-220 Wrocław;1336;576;576;10;566;43.11;1.74
85206;026401;Liceum Ogólnokształcące nr III|Wrocław|ul. Składowa 5 |50-220 Wrocław;1626;630;630;14;616;38.75;2.22
85207;026401;Rada Osiedla Nadodrze|Wrocław|ul. Rydygiera 43 |50-248 Wrocław;1905;923;923;18;905;48.45;1.95
85208;026401;Gimnazjum nr 4|Wrocław|ul. Paulińska 14 |50-247 Wrocław;1833;917;917;13;904;50.03;1.42
85209;026401;Szkoła Podstawowa nr 108|Wrocław|ul. Bolesława Chrobrego 3 |50-254 Wrocław;1968;982;982;14;968;49.90;1.43
85210;026401;Szkoła Podstawowa nr 108|Wrocław|ul. Bolesława Chrobrego 3 |50-254 Wrocław;1210;583;583;13;570;48.18;2.23
85211;026401;Zespół Szkolno-Przedszkolny nr 8|Wrocław|ul. Składowa 2-4 |50-209 Wrocław;1852;776;776;15;761;41.90;1.93
85212;026401;Zespół Szkolno-Przedszkolny nr 8|Wrocław|ul. Składowa 2-4 |50-209 Wrocław;1471;689;689;13;676;46.84;1.89
85213;026401;Zespół Szkolno-Przedszkolny nr 8|Wrocław|ul. Składowa 2-4 |50-204 Wrocław;1934;927;928;15;912;47.93;1.62
85214;026401;Szkoła Podstawowa nr 93|Wrocław|ul. Niemcewicza 29-31 |50-238 Wrocław;2204;1051;1051;19;1032;47.69;1.81
85215;026401;Klub "Iskierka"|Wrocław|ul. Niemcewicza 27 |50-238 Wrocław;1937;961;961;21;940;49.61;2.19
85216;026401;Publiczne Przedszkole "Leonardo"|Wrocław|ul. Roosevelta 15 |50-236 Wrocław;1779;845;845;12;833;47.50;1.42
85217;026401;Szkoła Podstawowa nr 74|Wrocław|ul. Kleczkowska 2 |50-227 Wrocław;2137;1212;1212;35;1177;56.72;2.89
85218;026401;Szkoła Podstawowa nr 74|Wrocław|ul. Kleczkowska 2 |50-227 Wrocław;1499;708;708;28;680;47.23;3.95
85219;026401;Szkoła Podstawowa Nr 74|Wrocław|ul. Kleczkowska 2 |50-227 Wrocław;1532;657;657;16;641;42.89;2.44
85220;026401;Rada Osiedla Ołbin|Wrocław|ul. Na Szańcach 14 |50-001 Wrocław;938;571;571;4;567;60.87;0.70
85221;026401;Liceum Ogólnokształcące nr I|Wrocław|ul. Ks. J. Poniatowskiego 9 |50-326 Wrocław;1952;959;959;7;952;49.13;0.73
85222;026401;Gimnazjum nr 15|Wrocław|ul. Jedności Narodowej 117 |50-525 Wrocław;2104;1113;1113;18;1095;52.90;1.62
85223;026401;Gimnazjum nr 15|Wrocław|ul. Jedności Narodowej 117 |50-301 Wrocław;1904;951;951;16;935;49.95;1.68
85224;026401;Gimnazjum nr 15|Wrocław|ul. Jedności Narodowej 117 |50-301 Wrocław;1820;894;894;10;884;49.12;1.12
85225;026401;Szkoła Podstawowa Nr 78|Wrocław|ul. Jedności Narodowej 195 |50-303 Wrocław;1901;1126;1126;13;1113;59.23;1.15
85226;026401;Szkoła Podstawowa Nr 78|Wrocław|ul. Jedności Narodowej 195 |50-303 Wrocław;1855;1056;1056;16;1040;56.93;1.52
85227;026401;Szkoła Podstawowa Nr 78|Wrocław|ul. Jedności Narodowej 195 |50-303 Wrocław;1627;1068;1068;14;1054;65.64;1.31
85228;026401;Szkoła Podstawowa nr 1|Wrocław|ul. Nowowiejska 78 |50-315 Wrocław;1920;977;977;8;969;50.89;0.82
85229;026401;Przedszkole nr 55|Wrocław|ul. Nowowiejska 36 |50-315 Wrocław;1475;807;807;10;797;54.71;1.24
85230;026401;Szkoła Podstawowa nr 1|Wrocław|ul. Nowowiejska 78 |50-315 Wrocław;956;552;552;7;545;57.74;1.27
85231;026401;Szkoła Podstawowa nr 1|Wrocław|ul. Nowowiejska 78 |50-315 Wrocław;1913;998;998;11;987;52.17;1.10
85232;026401;Szkoła Podstawowa nr 107|Wrocław|ul. B. Prusa 64 |50-318 Wrocław;1999;1060;1060;23;1037;53.03;2.17
85233;026401;Szkoła Podstawowa nr 107|Wrocław|ul. B. Prusa 64 |50-318 Wrocław;2065;1036;1036;26;1010;50.17;2.51
85234;026401;Przedszkole nr 74 "Mały Piekarczyk"|Wrocław|ul. Krzywa 3 |50-338 Wrocław;1833;1019;1019;6;1013;55.59;0.59
85235;026401;Przedszkole nr 109|Wrocław|ul. Nowowiejska 80a |50-315 Wrocław;1935;1147;1147;11;1136;59.28;0.96
85236;026401;Dolnośląski Oddział Okręgowy Polskiego Czerwonego Krzyża|Wrocław|ul. Bujwida 34 |50-345 Wrocław;1792;1104;1104;15;1089;61.61;1.36
85237;026401;Rada Osiedla Plac Grunwaldzki|Wrocław|ul. Sępa Szarzyńskiego 51 |51-351 Wrocław;1806;942;942;16;926;52.16;1.70
85238;026401;Gimnazjum nr 13|Wrocław|ul. Mikołaja Reja 3 |50-354 Wrocław;2208;1292;1292;23;1269;58.51;1.78
85239;026401;Szkoła Podstawowa nr 12|Wrocław|ul. Janiszewskiego 14 |50-372 Wrocław;2120;1247;1247;28;1219;58.82;2.25
85240;026401;Szkoła Podstawowa nr 12|Wrocław|ul. Janiszewskiego 14 |50-372 Wrocław;1992;1179;1179;14;1165;59.19;1.19
85241;026401;Dom Studencki "Parawanowiec"|Wrocław|pl. Grunwaldzki 28 |50-363 Wrocław;1894;1176;1176;20;1156;62.09;1.70
85242;026401;Dom Studencki "Dwudziestolatka"|Wrocław|ul. Piastowska 1 |50-359 Wrocław;2093;1085;1085;10;1075;51.84;0.92
85243;026401;Szkoła Podstawowa nr 36|Wrocław|ul. Chopina 9 b |51-609 Wrocław;1560;1110;1110;9;1101;71.15;0.81
85244;026401;Szkoła Podstawowa nr 36|Wrocław|ul. Chopina 9 b |51-609 Wrocław;1222;815;815;1;814;66.69;0.12
85245;026401;Zespół Szkół nr 22|Wrocław|ul. Parkowa 18-26 |51-616 Wrocław;585;386;386;4;382;65.98;1.04
85246;026401;Zespół Szkół nr 9|Wrocław|ul. Krajewskiego 1 |51-690 Wrocław;1818;1210;1210;13;1197;66.56;1.07
85247;026401;Gimnazjum nr 19|Wrocław|ul. Dembowskiego 39 |51-670 Wrocław;1600;1015;1015;11;1004;63.44;1.08
85248;026401;Zespół Szkół nr 9|Wrocław|ul. Krajewskiego 1 |51-690 Wrocław;1510;943;943;4;939;62.45;0.42
85249;026401;Zespół Szkół nr 9|Wrocław|ul. Krajewskiego 1 |51-690 Wrocław;1874;1177;1178;13;1164;62.81;1.10
85250;026401;Dom Studencki "Arka"|Wrocław|ul. Olszewskiego 25 |51-642 Wrocław;2547;1829;1829;8;1821;71.81;0.44
85251;026401;Gimnazjum nr 20|Wrocław|ul. Pautscha 9 |51-651 Wrocław;2103;1492;1492;9;1483;70.95;0.60
85252;026401;Zespół Szkół nr 19|Wrocław|ul. Spółdzielcza 2a |51-662 Wrocław;1304;864;864;7;857;66.26;0.81
85253;026401;Szkoła Podstawowa nr 91|Wrocław|ul. Sempołowskiej 54 |51-661 Wrocław;2155;1537;1537;20;1517;71.32;1.30
85254;026401;Szkoła Podstawowa nr 91|Wrocław|ul. Sempołowskiej 54 |51-661 Wrocław;1636;1083;1083;9;1074;66.20;0.83
85255;026401;Straż Miejska Wrocławia|Wrocław|ul. Pautscha 4 |51-651 Wrocław;1461;993;996;7;986;67.97;0.70
85256;026401;Sportowa Szkoła Podstawowa Nr 72|Wrocław|ul. Trwała 17-19 |53-335 Wrocław;1894;1264;1264;9;1255;66.74;0.71
85257;026401;Gimnazjum nr 17|Wrocław|ul. Ślężna 2-24 |53-312 Wrocław;1817;1246;1246;3;1243;68.57;0.24
85258;026401;Gimnazjum nr 17|Wrocław|ul. Ślężna 2-24 |53-312 Wrocław;1578;1050;1050;9;1041;66.54;0.86
85259;026401;Szkoła Podstawowa nr 30|Wrocław|ul. Zaporoska 28 |53-330 Wrocław;2020;1385;1385;10;1375;68.56;0.72
85260;026401;Centrum Kształcenia Ustawicznego Budynek C|Wrocław|ul. Swobodna 73 |53-335 Wrocław;2030;1348;1348;17;1331;66.40;1.26
85261;026401;Centrum Kształcenia Ustawicznego Budynek B|Wrocław|ul. Swobodna 73 |53-553 Wrocław;1316;804;804;13;791;61.09;1.62
85262;026401;Sportowa Szkoła Podstawowa nr 72|Wrocław|ul. Trwała 17-19 |53-330 Wrocław;2007;1330;1330;8;1322;66.27;0.60
85263;026401;Zespół Szkół Ekonomicznych|Wrocław|ul. Drukarska 50 |53-320 Wrocław;1821;1201;1201;15;1186;65.95;1.25
85264;026401;Zespół Szkół Ekonomicznych|Wrocław|ul. Drukarska 50 |53-320 Wrocław;1720;1229;1229;19;1210;71.45;1.55
85265;026401;Gimnazjum nr 30|Wrocław|ul. Jantarowa 5 |50-552 Wrocław;1457;851;851;11;840;58.41;1.29
85266;026401;Gimnazjum nr 30|Wrocław|ul. Jantarowa 5 |53-320 Wrocław;1522;925;925;14;911;60.78;1.51
85267;026401;Liceum Ogólnokształcące nr VIII|Wrocław|ul. Zaporoska 71 |53-320 Wrocław;1528;812;812;11;801;53.14;1.35
85268;026401;Liceum Ogólnokształcące nr VIII|Wrocław|ul. Zaporoska 71 |50-540 Wrocław;1371;664;664;8;656;48.43;1.20
85269;026401;Szkoła Podstawowa nr 76|Wrocław|ul. Wandy 13 |50-540 Wrocław;1542;954;954;15;939;61.87;1.57
85270;026401;Szkoła Podstawowa nr 76|Wrocław|ul. Wandy 13 |50-540 Wrocław;1543;936;936;5;931;60.66;0.53
85271;026401;Gimnazjum nr 23|Wrocław|ul. Jastrzębia 26 |50-540 Wrocław;1939;1307;1307;24;1283;67.41;1.84
85272;026401;Gimnazjum nr 23|Wrocław|ul. Jastrzębia 26 |50-540 Wrocław;1907;1285;1285;6;1279;67.38;0.47
85273;026401;Przedszkole nr 61|Wrocław|ul. Gajowicka 199 |53-148 Wrocław;1389;898;898;5;893;64.65;0.56
85274;026401;Zespół Szkół nr 4|Wrocław|ul. Powstańców Śl. 210-218 |53-148 Wrocław;1884;1175;1175;10;1165;62.37;0.85
85275;026401;Dolnośląski Zakład Doskonalenia Zawodowego Zespół Szkół|Wrocław|Al. Wiśniowa 81 |53-148 Wrocław;2292;1511;1511;10;1501;65.92;0.66
85276;026401;Szkoła Podstawowa nr 47|Wrocław|ul. Januszowicka 35-37 |53-128 Wrocław;1743;1166;1166;13;1153;66.90;1.11
85277;026401;Ośrodek Postaw Twórczych|Wrocław|ul. Działkowa 15 |53-129 Wrocław;2102;1448;1448;6;1442;68.89;0.41
85278;026401;Ośrodek Postaw Twórczych|Wrocław|ul. Działkowa 15 |50-538 Wrocław;1986;1385;1385;14;1371;69.74;1.01
85279;026401;Komenda Wojewódzka Państwowej Straży Pożarnej|Wrocław|ul. Borowska 138 |50-224 Wrocław;2046;1380;1380;8;1372;67.45;0.58
85280;026401;Szkoła Podstawowa Nr 90|Wrocław|ul. Orzechowa 62 |50-249 Wrocław;2158;1362;1362;9;1353;63.11;0.66
85281;026401;Szkoła Podstawowa nr 90|Wrocław|ul. Orzechowa 62 |50-540 Wrocław;2250;1265;1265;15;1250;56.22;1.19
85282;026401;Szkoła Podstawowa nr 90|Wrocław|ul. Orzechowa 62 |50-540 Wrocław;2157;1553;1553;13;1540;72.00;0.84
85283;026401;Szkoła Podstawowa nr 90|Wrocław|ul. Orzechowa 62 |50-540 Wrocław;2024;1345;1345;10;1335;66.45;0.74
85284;026401;Ośrodek Szkolenia Zawodowego we Wrocławiu|Wrocław|ul. Orzechowa 2 |50-540 Wrocław;1943;1265;1265;22;1243;65.11;1.74
85285;026401;Dzienny Dom Pomocy "Na Ciepłej"|Wrocław|ul. Ciepła 15b |50-524 Wrocław;1939;1207;1207;11;1196;62.25;0.91
85286;026401;Szkoła Podstawowa nr 73|Wrocław|ul. Gliniana 30 |50-525 Wrocław;1687;938;938;13;925;55.60;1.39
85287;026401;Zespół Szkół nr 23|Wrocław|ul. Dawida 9-11 |50-527 Wrocław;1969;1204;1204;20;1184;61.15;1.66
85288;026401;Przedszkole nr 119 "Zielona Łąka"|Wrocław|ul. Łódzka 23 |50-521 Wrocław;1695;984;984;8;976;58.05;0.81
85289;026401;Zespół Szkolno-Przedszkolny nr 17|Wrocław|ul. Wieczysta 105 |50-550 Wrocław;1597;915;915;10;905;57.29;1.09
85290;026401;Zespół Szkół nr 23|Wrocław|ul. Dawida 9-11 |50-527 Wrocław;1819;977;977;13;964;53.71;1.33
85291;026401;Gimnazjum nr 21|Wrocław|ul. Świętego Jerzego 4 |50-518 Wrocław;2024;1152;1152;14;1138;56.92;1.22
85292;026401;Gimnazjum nr 21|Wrocław|ul. Świętego Jerzego 4 |50-518 Wrocław;1728;1056;1056;10;1046;61.11;0.95
85293;026401;Zespół Szkół nr 2|Wrocław|ul. Borowska 105 |50-551 Wrocław;1916;1232;1232;25;1207;64.30;2.03
85294;026401;Zespół Szkolno-Przedszkolny nr 17|Wrocław|ul. Wieczysta 105 |50-550 Wrocław;1936;1185;1185;16;1169;61.21;1.35
85295;026401;Szkoła Podstawowa nr 9|Wrocław|ul. Nyska 66 |50-505 Wrocław;1897;1144;1144;6;1138;60.31;0.52
85296;026401;Szkoła Podstawowa nr 9|Wrocław|ul.Nyska 66 |50-505 Wrocław;1674;1122;1122;10;1112;67.03;0.89
85297;026401;Wrocławskie Mieszkania Sp. z o.o. BOK nr 6|Wrocław|ul. Gazowa 20 |50-505 Wrocław;1636;1042;1042;14;1028;63.69;1.34
85298;026401;Szkoła Podstawowa nr 96|Wrocław|ul. Krakowska 2 |50-425 Wrocław;1649;845;845;14;831;51.24;1.66
85299;026401;Przedszkole Integracyjne nr 12|Wrocław|ul. Zgodna 10-14 |50-432 Wrocław;1653;862;862;8;854;52.15;0.93
85300;026401;Gimnazjum nr 3|Wrocław|ul. Świstackiego 12a |50-430 Wrocław;1962;857;857;16;841;43.68;1.87
85301;026401;Liceum Ogólnokształcące nr IV|Wrocław|ul. Świstackiego 12-14 |50-430 Wrocław;2157;1032;1032;20;1012;47.84;1.94
85302;026401;Przedszkole nr 35 "Tęczowy Domek"|Wrocław|ul. Generała Pułaskiego 20a |50-446 Wrocław;1977;967;967;7;960;48.91;0.72
85303;026401;Muzeum Etnograficzne|Wrocław|ul. Traugutta 111/113 |50-419 Wrocław;1921;897;897;9;888;46.69;1.00
85304;026401;Szkoła Podstawowa nr 2|Wrocław|ul. Komuny Paryskiej 36-38 |50-451 Wrocław;1222;649;649;4;645;53.11;0.62
85305;026401;Szermiercza Sportowa Szkoła Podstawowa nr 85|Wrocław|ul. Traugutta 37 |50-416 Wrocław;1469;802;802;13;789;54.59;1.62
85306;026401;Zespół Szkół nr 5|Wrocław|ul. Generała Haukego-Bosaka 33-37 |50-447 Wrocław;1693;788;788;14;774;46.54;1.78
85307;026401;Zespół Szkół Teleinformatycznych i Elektronicznych|Wrocław|ul. Generała Józefa Haukego-Bosaka 21 |50-447 Wrocław;1307;645;645;13;632;49.35;2.02
85308;026401;Zespół Szkół Ekonomiczno-Administracyjnych|Wrocław|ul. Worcella 3 |50-448 Wrocław;2108;1093;1093;14;1079;51.85;1.28
85309;026401;Terapeutyczna Szkoła Podstawowa Nr 119|Wrocław|ul. Bytomska 7 |52-024 Wrocław;2187;1197;1197;19;1178;54.73;1.59
85310;026401;Terapeutyczna Szkoła Podstawowa Nr 119|Wrocław|ul. Bytomska 7 |52-024 Wrocław;2383;1466;1466;32;1434;61.52;2.18
85311;026401;Przedszkole nr 51|Wrocław|ul. Semaforowa 42 |52-115 Wrocław;1995;1161;1161;6;1155;58.20;0.52
85312;026401;Szkoła Podstawowa nr 80|Wrocław|ul. Polna 4 |52-120 Wrocław;1897;1084;1084;13;1071;57.14;1.20
85313;026401;Szkoła Podstawowa Nr 80|Wrocław|ul. Polna 4 |52-120 Wrocław;2079;1086;1086;20;1066;52.24;1.84
85314;026401;Rada Osiedla Jagodno|Wrocław|ul. Jagodzińska 15 |52-129 Wrocław;1086;714;714;7;707;65.75;0.98
85315;026401;Świetlica Cztery Pory Roku "Zima"|Wrocław|ul. Ryszarda Wagnera 3 |52-129 Wrocław;2100;1511;1511;3;1508;71.95;0.20
85316;026401;Szkoła Podstawowa Nr 23|Wrocław|ul. Przystankowa 32 |52-231 Wrocław;2081;1453;1453;8;1445;69.82;0.55
85317;026401;Szkoła Podstawowa Nr 23|Wrocław|ul. Przystankowa 32 |52-231 Wrocław;1992;1499;1499;5;1494;75.25;0.33
85318;026401;Zespół Szkolno-Przedszkolny Nr 6|Wrocław|ul. Gałczyńskiego 8 |52-214 Wrocław;1653;1220;1220;6;1214;73.81;0.49
85319;026401;Zespół Szkolno-Przedszkolny Nr 6|Wrocław|ul. Gałczyńskiego 8 |52-214 Wrocław;1530;1082;1082;10;1072;70.72;0.92
85320;026401;Zespół Szkolno-Przedszkolny nr 6|Wrocław|ul. Gałczyńskiego 8 |52-214 Wrocław;1696;1231;1231;13;1218;72.58;1.06
85321;026401;Rada Osiedla Krzyki-Partynice|Wrocław|ul. Wiosenna 14 |53-017 Wrocław;2322;1598;1598;24;1574;68.82;1.50
85322;026401;Szkoła Podstawowa Nr 64|Wrocław|ul. Wojszycka 1 |53-006 Wrocław;2219;1563;1563;14;1549;70.44;0.90
85323;026401;Szkoła Podstawowa Nr 64|Wrocław|ul. Wojszycka 1 |53-006 Wrocław;1952;1385;1385;12;1373;70.95;0.87
85324;026401;Zespół Szkolno-Przedszkolny nr 16|Wrocław|ul. Wietrzna 50 |53-025 Wrocław;1861;1338;1340;14;1324;71.90;1.05
85325;026401;Szkoła Podstawowa nr 61|Wrocław|ul.Skarbowców 8 |55-035 Wrocław;2076;1467;1467;8;1459;70.66;0.55
85326;026401;Zespół Szkolno-Przedszkolny nr 16|Wrocław|ul. Wietrzna 50 |53-025 Wrocław;1784;1288;1294;9;1279;72.20;0.70
85327;026401;Szkoła Podstawowa nr 61|Wrocław|ul. Skarbowców 8 |53-025 Wrocław;1547;1110;1110;10;1100;71.75;0.90
85328;026401;Zespół Placówek Oświatowych Nr 1|Wrocław|ul. Wałbrzyska 50 |52-314 Wrocław;2278;1482;1482;19;1463;65.06;1.28
85329;026401;Zespół Placówek Oświatowych nr 1|Wrocław|ul. Wałbrzyska 50 |52-314 Wrocław;2232;1446;1446;7;1439;64.78;0.48
85330;026401;Zespół Szkolno-Przedszkolny nr 9|Wrocław|ul. Solskiego 13 |52-401 Wrocław;1707;1158;1160;13;1145;67.84;1.12
85331;026401;Zespół Szkolno-Przedszkolny nr 9|Wrocław|ul. Solskiego 13 |52-401 Wrocław;1424;985;985;10;975;69.17;1.02
85332;026401;Gimnazjum nr 40|Wrocław|ul. Morelowskiego 43 |52-429 Wrocław;2067;1544;1544;13;1531;74.70;0.84
85333;026401;Sportowa Szkoła Podstawowa nr 46|Wrocław|ul. Ścinawska 21 |53-628 Wrocław;1846;1077;1077;9;1068;58.34;0.84
85334;026401;Sportowa Szkoła Podstawowa nr 46|Wrocław|ul. Ścinawska 21 |53-628 Wrocław;1190;711;711;5;706;59.75;0.70
85335;026401;Zespół Szkół nr 1|Wrocław|ul. Słubicka 29-33 |53-615 Wrocław;1353;824;824;14;810;60.90;1.70
85336;026401;Wrocławski Zakład Aktywności Zawodowej|Wrocław|ul. Litomska 10 |53-641 Wrocław;1379;959;959;6;953;69.54;0.63
85337;026401;Wrocławski Zakład Aktywności Zawodowej|Wrocław|ul. Litomska 10 |53-641 Wrocław;1368;909;909;4;905;66.45;0.44
85338;026401;Zespół Szkolno-Przedszkolny nr 18|Wrocław|ul. Poznańska 26 |53-630 Wrocław;1147;737;737;12;725;64.25;1.63
85339;026401;Elektroniczne Zakłady Naukowe|Wrocław|ul. Braniborska 57 |53-680 Wrocław;2230;1157;1157;12;1145;51.88;1.04
85340;026401;Zespół Szkolno-Przedszkolny nr 18|Wrocław|ul. Poznańska 26 |53-630 Wrocław;1176;785;785;8;777;66.75;1.02
85341;026401;Gimnazjum nr 28|Wrocław|ul. Zachodnia 2 |53-644 Wrocław;1451;962;962;10;952;66.30;1.04
85342;026401;Gimnazjum nr 28|Wrocław|ul. Zachodnia 2 |53-644 Wrocław;1141;638;638;12;626;55.92;1.88
85343;026401;Wrocławski Zakład Aktywności Zawodowej|Wrocław|ul. Litomska 10 |53-641 Wrocław;1384;841;841;10;831;60.77;1.19
85344;026401;Elektroniczne Zakłady Naukowe|Wrocław|ul. Braniborska 57 |53-680 Wrocław;1343;688;688;7;681;51.23;1.02
85345;026401;NZOZ Ośrodek Medyczny "Ziemo-Vita" Sp. z o.o.|Wrocław|ul. Ziemowita 1-9 |53-678 Wrocław;1437;758;758;8;750;52.75;1.06
85346;026401;Gimnazjum nr 18|Wrocław|ul. Kłodnicka 36 |54-218 Wrocław;1605;1089;1093;6;1083;67.85;0.55
85347;026401;Przedszkole nr 122 "Wesoła Gromadka"|Wrocław|ul. Kłodnicka 23 |54-217 Wrocław;1798;1257;1257;17;1240;69.91;1.35
85348;026401;Gimnazjum nr 18|Wrocław|ul.Kłodnicka 36 |54-218 Wrocław;2074;1426;1426;8;1418;68.76;0.56
85349;026401;Szkoła Podstawowa nr 118|Wrocław|ul. Bulwar Ikara 19 |54-130 Wrocław;2012;1309;1309;16;1293;65.06;1.22
85350;026401;Szkoła Podstawowa nr 118|Wrocław|ul. Bulwar Ikara 19 |54-130 Wrocław;2185;1461;1461;10;1451;66.86;0.68
85351;026401;Szkoła Podstawowa nr 118|Wrocław|ul. Bulwar Ikara 19 |54-130 Wrocław;2122;1475;1475;3;1472;69.51;0.20
85352;026401;Przedszkole nr 113 "Akademia Przedszkolaka"|Wrocław|ul. Lotnicza 22 |54-155 Wrocław;2284;1585;1585;4;1581;69.40;0.25
85353;026401;Przedszkole nr 113 "Akademia Przedszkolaka"|Wrocław|ul. Lotnicza 22 |54-155 Wrocław;1814;1203;1203;13;1190;66.32;1.08
85354;026401;Zespół Szkolno-Przedszkolny nr 2|Wrocław|ul. Horbaczewskiego 61 |54-130 Wrocław;1870;1167;1167;10;1157;62.41;0.86
85355;026401;Zespół Szkolno-Przedszkolny nr 2|Wrocław|ul. Horbaczewskiego 61 |54-130 Wrocław;1767;1155;1160;15;1140;65.37;1.30
85356;026401;Zespół Szkolno-Przedszkolny nr 2|Wrocław|ul. Horbaczewskiego 61 |54-130 Wrocław;1907;1226;1226;0;1226;64.29;0.00
85357;026401;Zespół Szkolno-Przedszkolny nr 7|Wrocław|ul. Koszykarska 2-4 |54-134 Wrocław;1641;991;991;11;980;60.39;1.11
85358;026401;Liceum Ogólnokształcące nr VI|Wrocław|ul. Hutnicza 45 |54-139 Wrocław;1433;858;858;9;849;59.87;1.05
85359;026401;Liceum Ogólnokształcące nr VI|Wrocław|ul. Hutnicza 45 |54-139 Wrocław;2192;1184;1184;9;1175;54.01;0.76
85360;026401;Gimnazjum nr 7|Wrocław|ul. Kolista 17 |54-152 Wrocław;2086;1378;1378;11;1367;66.06;0.80
85361;026401;Przedszkole nr 150 "Wesołe Nutki"|Wrocław|ul. Ignuta 30 |54-151 Wrocław;2220;1319;1319;12;1307;59.41;0.91
85362;026401;Zespół Szkół nr 21|Wrocław|ul. Ignuta 28 |54-151 Wrocław;2065;1240;1240;21;1219;60.05;1.69
85363;026401;Zespół Szkół nr 21|Wrocław|ul. Ignuta 28 |54-151 Wrocław;1593;1028;1028;9;1019;64.53;0.88
85364;026401;Gimnazjum nr 7|Wrocław|ul. Kolista 17 |54-152 Wrocław;1859;1174;1174;14;1160;63.15;1.19
85365;026401;Gimnazjum nr 7|Wrocław|ul. Kolista 17 |54-152 Wrocław;1993;1325;1325;10;1315;66.48;0.75
85366;026401;Gimnazjum nr 7|Wrocław|ul. Kolista 17 |54-152 Wrocław;1742;1124;1124;11;1113;64.52;0.98
85367;026401;Szkoła Podstawowa nr 3|Wrocław|ul. Bobrza 27 |54-220 Wrocław;1604;1043;1043;9;1034;65.02;0.86
85368;026401;Szkoła Podstawowa nr 3|Wrocław|ul. Bobrza 27 |54-220 Wrocław;1552;1057;1057;13;1044;68.11;1.23
85369;026401;Gimnazjum nr 1|Wrocław|ul. Jelenia 7 |54-242 Wrocław;1278;816;816;14;802;63.85;1.72
85370;026401;Gimnazjum nr 1|Wrocław|ul. Jelenia 7 |54-242 Wrocław;1954;1271;1271;13;1258;65.05;1.02
85371;026401;Gimnazjum nr 1|Wrocław|ul. Jelenia 7 |54-242 Wrocław;1484;957;957;10;947;64.49;1.04
85372;026401;Szkoła Podstawowa nr 3|Wrocław|ul. Bobrza 27 |54-220 Wrocław;1819;1166;1166;12;1154;64.10;1.03
85373;026401;Zespół Szkół nr 3|Wrocław|ul. Szkocka 64 |54-402 Wrocław;2155;1274;1274;18;1256;59.12;1.41
85374;026401;Zespół Szkół nr 3|Wrocław|ul. Szkocka 64 |54-402 Wrocław;1612;976;976;11;965;60.55;1.13
85375;026401;Szkoła Podstawowa nr 28|Wrocław|ul. Grecka 59 |54-406 Wrocław;1624;1055;1055;10;1045;64.96;0.95
85376;026401;Szkoła Podstawowa nr 28|Wrocław|ul. Grecka 59 |54-406 Wrocław;1691;1131;1131;10;1121;66.88;0.88
85377;026401;Przedszkole nr 22 "Muchoborek"|Wrocław|ul. Stanisławowska 90 |54-611 Wrocław;1915;1252;1252;9;1243;65.38;0.72
85378;026401;Zespół Szkolno-Przedszkolny nr 15|Wrocław|ul. Stanisławowska 38-44 |54-611 Wrocław;1937;1330;1330;8;1322;68.66;0.60
85379;026401;Zespół Szkolno-Przedszkolny nr 15|Wrocław|ul. Stanisławowska 38-44 |54-611 Wrocław;2035;1224;1224;17;1207;60.15;1.39
85380;026401;Zespół Szkolno-Przedszkolny nr 15|Wrocław|ul. Stanisławowska 38-44 |54-611 Wrocław;2004;1395;1395;19;1376;69.61;1.36
85381;026401;Przedszkole nr 148|Wrocław|ul. Rogowska 18a |54-440 Wrocław;2053;1253;1253;14;1239;61.03;1.12
85382;026401;Zespół Szkół nr 6|Wrocław|ul. Nowodworska 70-82 |54-438 Wrocław;1765;1084;1084;10;1074;61.42;0.92
85383;026401;Zespół Szkół nr 6|Wrocław|ul. Nowodworska 70-82 |54-438 Wrocław;1377;866;866;7;859;62.89;0.81
85384;026401;Zespół Szkół nr 6|Wrocław|ul. Nowodworska 70-82 |54-438 Wrocław;2064;1179;1179;14;1165;57.12;1.19
85385;026401;Liceum Ogólnokształcące nr XV|Wrocław|ul. Wojrowicka 58 |54-436 Wrocław;2240;1300;1300;14;1286;58.04;1.08
85386;026401;Zespół Szkolno-Przedszkolny nr 1|Wrocław|ul. Zemska 16c |54-438 Wrocław;1735;1127;1127;12;1115;64.96;1.06
85387;026401;Zespół Szkolno-Przedszkolny nr 1|Wrocław|ul. Zemska 16c |54-438 Wrocław;1455;861;861;7;854;59.18;0.81
85388;026401;Liceum Ogólnokształcące nr XV|Wrocław|ul. Wojrowicka 58 |54-436 Wrocław;1428;912;912;5;907;63.87;0.55
85389;026401;Rada Osiedla Kuźniki|Wrocław|ul. Sarbinowska 19-21 |54-320 Wrocław;1579;1018;1018;12;1006;64.47;1.18
85390;026401;Rada Osiedla Kuźniki|Wrocław|ul. Sarbinowska 19-21 |54-320 Wrocław;1719;1035;1035;8;1027;60.21;0.77
85391;026401;Rada Osiedla Kuźniki|Wrocław|ul. Sarbinowska 19-21 |54-320 Wrocław;1683;1059;1059;9;1050;62.92;0.85
85392;026401;Zespół Szkolno-Przedszkolny nr 10|Wrocław|ul. Rumiankowa 34 |54-512 Wrocław;1586;1030;1030;5;1025;64.94;0.49
85393;026401;Zespół Szkolno-Przedszkolny nr 10|Wrocław|ul. Rumiankowa 34 |54-512 Wrocław;1599;1042;1042;13;1029;65.17;1.25
85394;026401;Rada Osiedla Jerzmanowo-Jarnołtów-Strachowice-Osiniec|Wrocław|ul. Jerzmanowska 102 |54-530 Wrocław;1567;899;899;8;891;57.37;0.89
85395;026401;Centrum Kultury "ZAMEK"|Wrocław|pl. Świętojański 1 |54-076 Wrocław;2111;1077;1077;9;1068;51.02;0.84
85396;026401;Szkoła Podstawowa nr 95|Wrocław|ul. Starogajowa 66-68 |54-047 Wrocław;2104;1236;1236;19;1217;58.75;1.54
85397;026401;Zespół Szkół nr 24|Wrocław|ul. Eluarda 51-55 |54-019 Wrocław;1948;1098;1098;13;1085;56.37;1.18
85398;026401;Zespół Szkół nr 24|Wrocław|ul. Eluarda 51-55 |54-019 Wrocław;1798;1036;1036;13;1023;57.62;1.25
85399;026401;Przedszkole nr 66 "BAJKOLANDIA"|Wrocław|ul. Łączna 1-5 |54-004 Wrocław;2054;975;975;18;957;47.47;1.85
85400;026401;Zespół Szkolno-Przedszkolny nr 14|Wrocław|ul. Częstochowska 42 |54-031 Wrocław;1564;992;992;8;984;63.43;0.81
85401;026401;Zespół Szkolno-Przedszkolny nr 14|Wrocław|ul. Częstochowska 42 |54-031 Wrocław;2260;1487;1487;19;1468;65.80;1.28
85402;026401;Szkoła Podstawowa nr 95|Wrocław|ul. Starogajowa 66-68 |54-047 Wrocław;2152;1210;1213;16;1194;56.23;1.32
85403;026401;Szkoła Podstawowa nr 95|Wrocław|ul. Starogajowa 66-68 |54-047 Wrocław;2132;1386;1386;10;1376;65.01;0.72
85404;026401;Szkoła Podstawowa nr 95|Wrocław|ul. Starogajowa 66-68 |54-047 Wrocław;2106;1229;1229;9;1220;58.36;0.73
85405;026401;Dolnośląski Specjalny Ośrodek Szkolno-Wychowawczy nr 13 dla Niewidomych i Słabowidzących|Wrocław|ul. Kamiennogórska 16 |54-034 Wrocław;604;362;362;7;355;59.93;1.93
85406;026401;Gimnazjum nr 22|Wrocław|ul. Lubelska 95a |54-101 Wrocław;1685;1101;1101;5;1096;65.34;0.45
85407;026401;Zespół Szkolno-Przedszkolny nr 12|Wrocław|ul. Suwalska 5 |54-104 Wrocław;1700;1212;1212;9;1203;71.29;0.74
85408;026401;Zespół Szkolno-Przedszkolny nr 12|Wrocław|ul. Suwalska 5 |51-104 Wrocław;1473;1010;1010;6;1004;68.57;0.59
85409;026401;Zespół Szkolno-Przedszkolny nr 12|Wrocław|ul. Suwalska 5 |54-104 Wrocław;1838;1073;1073;9;1064;58.38;0.84
85410;026401;Szkoła Podstawowa nr 22|Wrocław|ul. Stabłowicka 143 |54-062 Wrocław;1311;763;763;18;745;58.20;2.36
85411;026401;Szkoła Podstawowa nr 22|Wrocław|ul. Stabłowicka 143 |54-062 Wrocław;1800;1048;1048;8;1040;58.22;0.76
85412;026401;Zespół Szkół nr 14|Wrocław|Al. Brücknera 10 |51-410 Wrocław;2131;1238;1238;7;1231;58.09;0.57
85413;026401;Szkoła Podstawowa nr 83|Wrocław|Al. Boya- Żeleńskiego 32 |51-160 Wrocław;2315;1417;1417;9;1408;61.21;0.64
85414;026401;Przedszkole Integracyjne nr 68|Wrocław|ul. J. Długosza 29 |51-162 Wrocław;2024;1282;1282;7;1275;63.34;0.55
85415;026401;Szkoła Podstawowa nr 83|Wrocław|Al. Boya-Żeleńskiego 32 |51-160 Wrocław;2070;1409;1409;5;1404;68.07;0.35
85416;026401;Gimnazjum nr 24|Wrocław|ul. Przybyszewskiego 59 |51-151 Wrocław;1681;990;990;14;976;58.89;1.41
85417;026401;Gimnazjum nr 24|Wrocław|ul. Przybyszewskiego 59 |51-151 Wrocław;1395;872;872;13;859;62.51;1.49
85418;026401;Szkoła Podstawowa nr 20|Wrocław|ul. Kamieńskiego 24 |51-124 Wrocław;2034;1302;1302;18;1284;64.01;1.38
85419;026401;Szkoła Podstawowa nr 20|Wrocław|ul. Kamieńskiego 24 |51-124 Wrocław;2029;1194;1194;12;1182;58.85;1.01
85420;026401;Przedszkole nr 149 "Tęczowa Polanka"|Wrocław|ul. Obornicka 21 |51-114 Wrocław;1217;782;782;5;777;64.26;0.64
85421;026401;Szkoła Podstawowa nr 50|Wrocław|ul. Czeska 38 |51-112 Wrocław;1587;903;903;14;889;56.90;1.55
85422;026401;Szkoła Podstawowa nr 50|Wrocław|ul. Czeska 38 |51-112 Wrocław;999;629;629;8;621;62.96;1.27
85423;026401;Liceum Ogólnokształcące nr X|Wrocław|ul. Piesza 1 |51-009 Wrocław;2150;1331;1331;12;1319;61.91;0.90
85424;026401;Liceum Ogólnokształcące nr X|Wrocław|ul. Piesza 1 |51-009 Wrocław;1916;1232;1232;18;1214;64.30;1.46
85425;026401;Gimnazjum nr 27|Wrocław|ul. Czeska 40 |51-112 Wrocław;851;563;563;5;558;66.16;0.89
85426;026401;Gimnazjum nr 27|Wrocław|ul. Czeska 40 |51-112 Wrocław;1587;993;995;8;985;62.57;0.81
85427;026401;Gimnazjum nr 27|Wrocław|ul. Czeska 40 |51-112 Wrocław;1861;1156;1156;9;1147;62.12;0.78
85428;026401;Szkoła Podstawowa nr 8|Wrocław|ul. Kowalska 105 |51-424 Wrocław;1096;663;663;8;655;60.49;1.21
85429;026401;Zespół Szkół nr 14|Wrocław|Al. Brücknera 10 |51-410 Wrocław;739;419;419;2;417;56.70;0.48
85430;026401;Zespół Szkolno-Przedszkolny nr 11|Wrocław|ul. Strachocińska 155-157 |51-518 Wrocław;1296;825;825;8;817;63.66;0.97
85431;026401;Zespół Szkolno-Przedszkolny nr 11|Wrocław|ul. Strachocińska 155-157 |51-518 Wrocław;1339;975;975;10;965;72.82;1.03
85432;026401;Ekologiczne Przedszkole Niepubliczne|Wrocław|ul. Miłoszycka 23 |51-502 Wrocław;1748;1207;1208;11;1196;69.05;0.91
85433;026401;Przedszkole nr 140 "Pod Platanem"|Wrocław|ul. Nadbrzeżna 14 |51-349 Wrocław;1308;815;815;9;806;62.31;1.10
85434;026401;Zespół Szkolno-Przedszkolny nr 3|Wrocław|ul. Inflancka 13 |51-354 Wrocław;2076;1377;1377;13;1364;66.33;0.94
85435;026401;Zespół Szkolno-Przedszkolny nr 3|Wrocław|ul. Inflancka 13 |51-354 Wrocław;1777;1063;1063;12;1051;59.82;1.13
85436;026401;Zespół Szkolno-Przedszkolny nr 3|Wrocław|ul. Inflancka 13 |51-354 Wrocław;1776;1145;1145;22;1123;64.47;1.92
85437;026401;Zespół Szkolno-Przedszkolny nr 3|Wrocław|ul. Inflancka 13 |51-354 Wrocław;2076;1248;1248;17;1231;60.12;1.36
85438;026401;Szkoła Podstawowa nr 98|Wrocław|ul. Sycowska 22a |51-319 Wrocław;1792;840;840;16;824;46.88;1.90
85439;026401;Szkoła Podstawowa nr 98|Wrocław|ul. Sycowska 22a |51-319 Wrocław;1524;920;920;13;907;60.37;1.41
85440;026401;Gimnazjum nr 2|Wrocław|ul. Gorlicka 25 |51-314 Wrocław;2034;1250;1250;8;1242;61.46;0.64
85441;026401;Zespół Szkół nr 10|Wrocław|ul. Wilanowska 31 |51-206 Wrocław;2288;1303;1303;18;1285;56.95;1.38
85442;026401;Zespół Szkół nr 10|Wrocław|ul. Wilanowska 31 |51-206 Wrocław;2123;1307;1307;18;1289;61.56;1.38
85443;026401;Fundacja "Przyjazny Dom" im. Stanisława Jabłonki|Wrocław|ul. Okulickiego 2 |51-215 Wrocław;1808;955;955;20;935;52.82;2.09
85444;026401;Publiczna Szkoła Podstawowa i Przedszkole "MARCOPOLO"|Wrocław|ul. Zatorska 11 |51-215 Wrocław;2177;1457;1457;7;1450;66.93;0.48
85445;026401;Szkoła Podstawowa nr 39|Wrocław|ul. Przedwiośnie 47 |51-211 Wrocław;1670;1013;1013;12;1001;60.66;1.18
85446;026401;Zespół Szkolno-Przedszkolny nr 4 (Szkoła Podstawowa nr 40)|Wrocław|ul. Sołtysowicka 34 |51-168 Wrocław;1246;716;716;5;711;57.46;0.70
85447;026401;Zespół Szkolno-Przedszkolny nr 4 (Szkoła Podstawowa nr 40)|Wrocław|ul. Sołtysowicka 34 |51-168 Wrocław;1354;927;927;8;919;68.46;0.86
85448;026401;Ośrodek Opiekuńczo-Adaptacyjny "Pensjonat dla Osób Starszych"|Wrocław|ul. Kamieńskiego 190 |51-124 Wrocław;1836;1134;1134;24;1110;61.76;2.12
85449;026401;Rada Osiedla Polanowice-Poświętne-Ligota(budynek Ośrodka Opiekuńczo-Adaptacyjnego "Pensjonat dla Osób Starszych")|Wrocław|ul. Kamieńskiego 190 |51-124 Wrocław;1273;802;802;11;791;63.00;1.37
85450;026401;Dom Pomocy Społecznej|Wrocław|ul. Kaletnicza 8 |51-180 Wrocław;1154;643;643;14;629;55.72;2.18
85451;026401;Rada Osiedla Świniary|Wrocław|ul. Pęgowska 14 |51-180 Wrocław;1357;705;705;11;694;51.95;1.56
85452;026401;Zespół Szkolno-Przedszkolny nr 5|Wrocław|ul. Osobowicka 127 |51-004 Wrocław;2250;1311;1311;20;1291;58.27;1.53
85453;026401;Zakład Opiekuńczo-Leczniczy o Profilu Rehabilitacyjnym Zgromadzenia Sióstr Św. Elżbiety|Wrocław|ul. Św. Józefa 2/4 |50-329 Wrocław;92;49;49;1;48;53.26;2.04
85454;026401;Areszt Śledczy|Wrocław|ul. Świebodzka 1 |50-046 Wrocław;717;473;473;79;394;65.97;16.70
85455;026401;Dolnośląskie Centrum Chorób Płuc we Wrocławiu|Wrocław|ul. Grabiszyńska 105 |53-439 Wrocław;401;100;100;4;96;24.94;4.00
85456;026401;Zakład Karny Nr 2|Wrocław|ul. Fiołkowa 38 |53-239 Wrocław;500;240;240;34;206;48.00;14.17
85457;026401;Samodzielny Publiczny Zakład Opieki Zdrowotnej MSW we Wrocławiu|Wrocław|ul. Ołbińska 32 |50-233 Wrocław;65;40;40;2;38;61.54;5.00
85458;026401;"Dolnośląskie Centrum Zdrowia Psychicznego" sp. z o.o.|Wrocław|Wybrzeże J.Conrada- Korzeniowskiego 18 |50-226 Wrocław;121;41;41;5;36;33.88;12.20
85459;026401;Zakład Karny Nr 1|Wrocław|ul.Kleczkowska 35 |50-227 Wrocław;1219;531;611;105;426;43.56;19.77
85460;026401;Samodzielny Publiczny Szpital Kliniczny Nr 1 we Wrocławiu budynek Kliniki Ginekologii i Położnictwa|Wrocław|ul. Chałubińskiego 3 |50-368 Wrocław;238;102;102;3;99;42.86;2.94
85461;026401;Wrocławskie Centrum Rehabilitacji i Medycyny Sportowej Sp. z o.o.|Wrocław|ul. Chopina 5/7 |51-609 Wrocław;61;54;54;3;51;88.52;5.56
85462;026401;Dolnośląskie Centrum Onkologii we Wrocławiu|Wrocław|pl. Hirszfelda 12 |53-413 Wrocław;121;63;63;1;62;52.07;1.59
85463;026401;4 Wojskowy Szpital Kliniczny z Polikliniką SP ZOZ we Wrocławiu|Wrocław|ul. Weigla 5 |50-981 Wrocław;563;126;126;5;121;22.38;3.97
85464;026401;Uniwersytecki Szpital Kliniczny im. Jana Mikulicza-Radeckiego we Wrocławiu - budynek H|Wrocław|ul. Borowska 213 |50-556 Wrocław;314;125;125;7;118;39.81;5.60
85465;026401;Uniwersytecki Szpital Kliniczny im. Jana Mikulicza-Radeckiego we Wrocławiu - budynek J|Wrocław|ul. Borowska 213 |50-556 Wrocław;301;147;147;1;146;48.84;0.68
85466;026401;Dom Pomocy Społecznej "Samarytanin"|Wrocław|ul. Świątnicka 25/27 |52-018 Wrocław;100;44;44;2;42;44.00;4.55
85467;026401;Szpital Specjalistyczny im. A.Falkiewicza budynek Ginekologiczno-Położniczy|Wrocław|ul. Warszawska 2 |52-114 Wrocław;179;50;50;2;48;27.93;4.00
85468;026401;Dom Pomocy Społecznej|Wrocław|ul. Karmelkowa 25 |52-437 Wrocław;206;92;92;4;88;44.66;4.35
85469;026401;Dom Pomocy Społecznej|Wrocław|ul. Mącza 3 |54-131 Wrocław;140;54;54;10;44;38.57;18.52
85470;026401;Dom Pomocy Społecznej "Miłosierny Samarytanin"|Wrocław|ul. Wejherowska 28 |54-239 Wrocław;58;17;17;1;16;29.31;5.88
85471;026401;Dolnośląski Szpital Specjalistyczny im.T. Marciniaka - Centrum Medycyny Ratunkowej|Wrocław|ul. Generała Augusta Emila Fieldorfa 2 |54-049 Wrocław;415;98;98;3;95;23.61;3.06
85472;026401;Dom Pomocy Społecznej|Wrocław|ul. Rędzińska 66/68 |54-106 Wrocław;137;32;32;5;27;23.36;15.62
85473;026401;Wojewódzki Szpital Specjalistyczny im. J. Gromkowskiego - oddział zakaźny|Wrocław|ul. Koszarowa 5 |51-168 Wrocław;63;15;15;0;15;23.81;0.00
85474;026401;Wojewódzki Szpital Specjalistyczny im.J.Gromkowskiego- oddział niezakaźny|Wrocław|ul. Koszarowa 5 |51-149 Wrocław;252;40;40;0;40;15.87;0.00
85475;026401;Wojewódzki Szpital Specjalistyczny we Wrocławiu|Wrocław|ul. Kamieńskiego 73a |51-121 Wrocław;177;77;77;3;74;43.50;3.90
85476;026401;NZOZ Medinet Dolnośląskie Centrum Chorób Serca|Wrocław|ul. Kamieńskiego 73a |51-121 Wrocław;21;20;20;0;20;95.24;0.00
85477;026401;Wojewódzki Szpital Specjalistyczny we Wrocławiu Oddział Zamiejscowy|Wrocław|ul. Poświęcka 8 |51-128 Wrocław;87;56;56;4;52;64.37;7.14
85478;026501;Rada Wspólnoty Samorządowej "Lubiechów"|Wałbrzych|ul.Wilcza 12 /1|58-306 Wałbrzych;405;182;182;4;178;44.94;2.20
85479;026501;Przedszkole Niepubliczne "Bajkolandia"|Wałbrzych|ul. Wrocławska 169 |58-306 Wałbrzych;1616;954;954;16;938;59.03;1.68
85480;026501;Rada Wspólnoty Samorządowej "Szczawienko,Książ"|Wałbrzych|ul.Wrocławska 129 |58-306 Wałbrzych;1313;491;491;18;473;37.40;3.67
85481;026501;Przedszkole Samorządowe Nr 17 z Oddziałami Integracyjnymi i Oddziałami Specjalnymi Filia|Wałbrzych|ul.Sosnowa 25a |58-307 Wałbrzych;1584;733;733;14;719;46.28;1.91
85482;026501;Zespół Szkół Nr 4|Wałbrzych|ul. Alfreda Sokołowskiego 75 |58-309 Wałbrzych;1283;822;822;8;814;64.07;0.97
85483;026501;Publiczna Szkoła Podstawowa Nr 15|Wałbrzych|ul. Ludwika Hirszfelda 1 |58-309 Wałbrzych;2000;1073;1073;20;1053;53.65;1.86
85484;026501;Publiczna Szkoła Podstawowa Nr 15|Wałbrzych|ul. Ludwika Hirszfelda 1 |58-309 Wałbrzych;1653;858;858;11;847;51.91;1.28
85485;026501;Publiczna Szkoła Podstawowa Nr 15|Wałbrzych|ul. Ludwika Hirszfelda 1 |58-309 Wałbrzych;1721;900;900;15;885;52.30;1.67
85486;026501;Publiczne Gimnazjum Nr 6|Wałbrzych|ul. Główna 2 |58-309 Wałbrzych;1648;822;822;27;795;49.88;3.28
85487;026501;Publiczna Szkoła Podstawowa Nr 37|Wałbrzych|ul. Ksawerego Dunikowskiego 39 |58-309 Wałbrzych;1906;987;987;18;969;51.78;1.82
85488;026501;Publiczna Szkoła Podstawowa Nr 37|Wałbrzych|ul. Ksawerego Dunikowskiego 39 |58-309 Wałbrzych;1845;935;935;10;925;50.68;1.07
85489;026501;Zespół Szkół Muzycznych|Wałbrzych|ul. Piętnastolecia 24 |58-309 Wałbrzych;980;506;506;6;500;51.63;1.19
85490;026501;Publiczne Gimnazjum Nr 6|Wałbrzych|ul. Główna 2 |58-309 Wałbrzych;1321;673;673;9;664;50.95;1.34
85491;026501;Miejski Ośrodek Pomocy Społecznej, Filia|Wałbrzych|ul. Gen. Stefana Grota-Roweckiego 3 |58-309 Wałbrzych;1692;735;735;17;718;43.44;2.31
85492;026501;Publiczna Szkoła Podstawowa Nr 21|Wałbrzych|ul. Grodzka 71 |58-316 Wałbrzych;1668;952;952;16;936;57.07;1.68
85493;026501;Publiczna Szkoła Podstawowa Nr 21|Wałbrzych|ul. Grodzka 71 |58-316 Wałbrzych;2226;1290;1290;21;1269;57.95;1.63
85494;026501;Publiczna Szkoła Podstawowa Nr 21|Wałbrzych|ul. Grodzka 71 |58-316 Wałbrzych;1925;1138;1138;13;1125;59.12;1.14
85495;026501;Niepubliczne Przedszkole "Stokrotka"|Wałbrzych|ul. Grodzka 13 |58-316 Wałbrzych;1962;1118;1118;20;1098;56.98;1.79
85496;026501;Zespół Żłobków Samorządowych Nr 2|Wałbrzych|ul. Kasztelańska 7 |58-316 Wałbrzych;1513;850;850;21;829;56.18;2.47
85497;026501;Zespół Żłobków Samorządowych Nr 2|Wałbrzych|ul. Kasztelańska 7 |58-316 Wałbrzych;1696;938;938;17;921;55.31;1.81
85498;026501;Zespół Szkół z Oddziałami Integracyjnymi|Wałbrzych|ul. Palisadowa 48 |58-316 Wałbrzych;1824;1024;1024;19;1005;56.14;1.86
85499;026501;Zespół Szkół z Oddziałami Integracyjnymi|Wałbrzych|ul. Palisadowa 48 |58-316 Wałbrzych;2173;1181;1181;16;1165;54.35;1.35
85500;026501;Zespół Szkół z Oddziałami Integracyjnymi|Wałbrzych|ul. Palisadowa 48 |58-316 Wałbrzych;1548;910;910;14;896;58.79;1.54
85501;026501;Zespół Szkół z Oddziałami Intergacyjnymi|Wałbrzych|ul. Palisadowa 48 |58-316 Wałbrzych;1465;824;824;17;807;56.25;2.06
85502;026501;Politechnika Wrocławska Zamiejscowy Ośrodek Dydaktyczny w Wałbrzychu|Wałbrzych|ul. Armii Krajowej 78 |58-302 Wałbrzych;1168;381;381;22;359;32.62;5.77
85503;026501;Zespół Szkół Techniczno-Budowlanych|Wałbrzych|ul. Przywodna 1 |58-302 Wałbrzych;1259;489;489;13;476;38.84;2.66
85504;026501;Zespół Szkół Techniczno-Budowlanych|Wałbrzych|ul. Przywodna 1 |58-302 Wałbrzych;1218;506;506;9;497;41.54;1.78
85505;026501;Publiczna Szkoła Podstawowa Nr 30|Wałbrzych|ul. Tytusa Chałubińskiego 13 |58-302 Wałbrzych;1547;729;729;33;696;47.12;4.53
85506;026501;Gminny Zespół Szkół Nr 2|Wałbrzych|ul. 11 Listopada 75 |58-302 Wałbrzych;869;250;250;10;240;28.77;4.00
85507;026501;Gminny Zespół Szkół Nr 2|Wałbrzych|ul. 11 Listopada 75 |58-302 Wałbrzych;1303;568;568;12;556;43.59;2.11
85508;026501;Zespół Szkół Nr 1|Wałbrzych|ul. Ignacego Paderewskiego 17 |58-301 Wałbrzych;1569;649;649;21;628;41.36;3.24
85509;026501;Zespół Szkół Nr 1|Wałbrzych|ul. Ignacego Paderewskiego 17 |58-301 Wałbrzych;1503;618;618;14;604;41.12;2.27
85510;026501;Publiczna Szkoła Podstawowa Nr 23|Wałbrzych|ul. Andrzeja Struga 3 |58-301 Wałbrzych;1569;548;548;20;528;34.93;3.65
85511;026501;Publiczna Szkoła Podstawowa Nr 23|Wałbrzych|ul. Andrzeja Struga 3 |58-301 Wałbrzych;1246;527;527;8;519;42.30;1.52
85512;026501;Publiczna Szkoła Podstawowa Nr 23|Wałbrzych|ul. Andrzeja Struga 3 |58-301 Wałbrzych;1695;497;497;19;478;29.32;3.82
85513;026501;Publiczna Szkoła Podstawowa Nr 5|Wałbrzych|ul. Poznańska 8 |58-303 Wałbrzych;773;234;234;5;229;30.27;2.14
85514;026501;Zespół Szkół Nr 7|Wałbrzych|ul. Kłodzka 29 |58-308 Wałbrzych;1080;506;506;15;491;46.85;2.96
85515;026501;Rada Wspólnoty Samorządowej "Rusinowa, Kozice"|Wałbrzych|ul. Osiedle Górnicze 48 |58-308 Wałbrzych;1196;472;472;10;462;39.46;2.12
85516;026501;Publiczna Szkoła Podstawowa Nr 5|Wałbrzych|ul. Poznańska 8 |58-303 Wałbrzych;1909;662;662;17;645;34.68;2.57
85517;026501;Rada Wspólnoty Samorządowej "Podgórze,Nowy i Stary Glinik", Filia|Wałbrzych|ul. Glinicka 1 |58-303 Wałbrzych;508;170;170;10;160;33.46;5.88
85518;026501;Publiczna Szkoła Podstawowa Nr 5|Wałbrzych|ul. Poznańska 8 |58-303 Wałbrzych;1442;574;574;19;555;39.81;3.31
85519;026501;Zespół Szkolno - Przedszkolny nr 2|Wałbrzych|ul. Królewiecka 7 |58-300 Wałbrzych;899;370;370;14;356;41.16;3.78
85520;026501;Przedszkole Niepubliczne "Pod Grzybkiem"|Wałbrzych|ul. Niepodległości 90 |58-303 Wałbrzych;945;361;361;12;349;38.20;3.32
85521;026501;Publiczne Gimnazjum Nr 3|Wałbrzych|ul. Piotra Skargi 49 |58-300 Wałbrzych;1115;397;397;21;376;35.61;5.29
85522;026501;Publiczne Gimnazjum Nr 3|Wałbrzych|ul. Piotra Skargi 49 |58-300 Wałbrzych;906;375;375;5;370;41.39;1.33
85523;026501;Publiczne Gimnazjum Nr 3|Wałbrzych|ul. Piotra Skargi 49 |58-300 Wałbrzych;1376;708;708;14;694;51.45;1.98
85524;026501;Zespół Szkół Politechnicznych "Energetyk"|Wałbrzych|Al. Wyzwolenia 5 |58-300 Wałbrzych;911;393;393;6;387;43.14;1.53
85525;026501;Zespół Szkół Politechnicznych "Energetyk"|Wałbrzych|Al. Wyzwolenia 5 |58-300 Wałbrzych;563;258;258;9;249;45.83;3.49
85526;026501;Zespół Szkół Politechnicznych "Energetyk"|Wałbrzych|Al. Wyzwolenia 5 |58-300 Wałbrzych;1320;403;403;24;379;30.53;5.96
85527;026501;Publiczna Szkoła Podstawowa Nr 28|Wałbrzych|Al. Wyzwolenia 43 |58-300 Wałbrzych;875;319;319;15;304;36.46;4.70
85528;026501;Publiczna Szkoła Podstawowa Nr 28|Wałbrzych|Al. Wyzwolenia 43 |58-300 Wałbrzych;938;327;327;15;312;34.86;4.59
85529;026501;Publiczne Gimnazjum Nr 1|Wałbrzych|ul. Bolesława Limanowskiego 12 |58-300 Wałbrzych;927;377;377;8;369;40.67;2.12
85530;026501;Centrum Aktywności Lokalnej|Wałbrzych|ul. Adama Mickiewicza 26 |58-300 Wałbrzych;1182;404;404;14;390;34.18;3.47
85531;026501;Centrum Aktywności Lokalnej|Wałbrzych|ul. Adama Mickiewicza 26 |58-300 Wałbrzych;1224;414;414;17;397;33.82;4.11
85532;026501;Zespół Szkół Politechnicznych "Energetyk"|Wałbrzych|Al. Wyzwolenia 5 |58-300 Wałbrzych;664;366;366;8;358;55.12;2.19
85533;026501;Publiczna Szkoła Podstawowa Nr 17|Wałbrzych|ul. 1 Maja 105 |58-305 Wałbrzych;1660;435;435;20;415;26.20;4.60
85534;026501;Zespół Szkół Nr 3|Wałbrzych|ul. Henryka Jordana 4 |58-305 Wałbrzych;1379;470;470;21;449;34.08;4.47
85535;026501;Zespół Szkół Nr 3|Wałbrzych|ul. Henryka Jordana 4 |58-305 Wałbrzych;1807;828;828;20;808;45.82;2.42
85536;026501;Publiczna Szkoła Podstawowa Nr 6|Wałbrzych|ul. Gen.Władysława Andersa 50 |58-304 Wałbrzych;1515;666;666;13;653;43.96;1.95
85537;026501;Publiczna Szkoła Podstawowa Nr 6|Wałbrzych|ul. Gen.Władysława Andersa 50 |58-304 Wałbrzych;1462;606;606;23;583;41.45;3.80
85538;026501;Powiatowa i Miejska Bilblioteka Publiczna "Biblioteka Pod Atlantami", Filia Nr 6|Wałbrzych|ul. Gen.Władysława Andersa 137 |58-304 Wałbrzych;1565;649;649;25;624;41.47;3.85
85539;026501;Publiczna Szkoła Podstawowa Nr 2|Wałbrzych|ul. Melchiora Wańkowicza 13 |58-304 Wałbrzych;1218;590;590;7;583;48.44;1.19
85540;026501;Publiczna Szkoła Podstawowa Nr 2|Wałbrzych|ul. Melchiora Wańkowicza 13 |58-304 Wałbrzych;1793;840;840;15;825;46.85;1.79
85541;026501;Publiczna Szkoła Podstawowa Nr 2|Wałbrzych|ul. Melchiora Wańkowicza 13 |58-304 Wałbrzych;1507;532;532;21;511;35.30;3.95
85542;026501;Muzeum Gross-Rosen|Wałbrzych|ul. Szarych Szeregów 9 |58-304 Wałbrzych;1418;498;498;12;486;35.12;2.41
85543;026501;Publiczna Szkoła Podstawowa Nr 2|Wałbrzych|ul. Melchiora Wańkowicza 13 |58-304 Wałbrzych;1286;506;506;18;488;39.35;3.56
85544;026501;Dom Pomocy Społecznej|Wałbrzych|ul.Zachodnia 17 |58-305 Wałbrzych;42;20;20;1;19;47.62;5.00
85545;026501;Specjalistyczny Szpital Ginekologiczno-Położniczy|Wałbrzych|ul.Ignacego Paderewskiego 10 |58-301 Wałbrzych;69;10;10;0;10;14.49;0.00
85546;026501;Specjalistyczny Szpital im. Alfreda Sokołowskiego Oddziały przy ul. Batorego 4|Wałbrzych|ul.Stefana Batorego 4 |58-300 Wałbrzych;177;55;55;2;53;31.07;3.64
85547;026501;Specjalistyczny Szpital im. Alfreda Sokołowskiego Oddziały przy ul. A. Sokołowskiego 4|Wałbrzych|ul.Alfreda Sokołowskiego 4 |58-309 Wałbrzych;219;69;69;5;64;31.51;7.25
85548;026501;Areszt Śledczy|Wałbrzych|ul.Juliusza Słowackiego 10a |58-300 Wałbrzych;61;39;39;8;31;63.93;20.51
85549;026501;Dom Seniora Rusinowa|Wałbrzych|ul.Osiedle Górnicze 19a |58-308 Wałbrzych;46;24;24;6;18;52.17;25.00
85550;040101;Środowiskowy Dom Samopomocy|Aleksandrów Kujawski|Limanowskiego 12 |87-700 Aleksandrów Kujawski;1399;586;586;11;575;41.89;1.88
85551;040101;Publiczne Gimnazjum Nr 1 im. Lotników Polskich|Aleksandrów Kujawski|Długa 8 |87-700 Aleksandrów Kujawski;1354;547;547;22;525;40.40;4.02
85552;040101;Zespół Szkół Nr 3|Aleksandrów Kujawski|Strażacka 22 |87-700 Aleksandrów Kujawski;1356;594;594;22;572;43.81;3.70
85553;040101;Zespół Szkół Nr 3|Aleksandrów Kujawski|Strażacka 22 |87-700 Aleksandrów Kujawski;559;194;194;7;187;34.70;3.61
85554;040101;Szkoła Podstawowa Nr 1 im. Polskich Podróżników|Aleksandrów Kujawski|Sikorskiego 5 |87-700 Aleksandrów Kujawski;1395;618;618;12;606;44.30;1.94
85555;040101;Szkoła Podstawowa Nr 3 im Józefa Wybickiego|Aleksandrów Kujawski|Szkolna 6 |87-700 Aleksandrów Kujawski;1072;503;503;10;493;46.92;1.99
85556;040101;Miejskie Centrum Kultury|Aleksandrów Kujawski|Parkowa 3 |87-700 Aleksandrów Kujawski;1317;613;613;14;599;46.55;2.28
85557;040101;Przedszkole Samorządowe Nr 1|Aleksandrów Kujawski|Wojska Polskiego 19 |87-700 Aleksandrów Kujawski;1278;587;587;22;565;45.93;3.75
85558;040101;Sala przy Izbie Przyjęć Powiatowego Szpitala w Aleksandrowie Kujawskim Sp. z o.o.|Aleksandrów Kujawski|Słowackiego 18 |87-700 Aleksandrów Kujawski;124;49;49;2;47;39.52;4.08
85559;040101;Świetlica Kolejowego Szpitala Uzdrowiskowego Sp. z o.o. w Ciechocinku Oddział Zamiejscowy w Aleksandrowie Kujawskim|Aleksandrów Kujawski|Narutowicza 12 |87-700 Aleksandrów Kujawski;50;8;8;0;8;16.00;0.00
85560;040102;Przedszkole Samorządowe Nr 2|Ciechocinek|ul. Wierzbowa 10 |87-720 Ciechocinek;1289;774;774;14;760;60.05;1.81
85561;040102;Przedszkole Samorządowe Nr 1|Ciechocinek|ul. Widok 9 |87-720 Ciechocinek;1726;1149;1149;22;1127;66.57;1.91
85562;040102;Szkoła Podstawowa Nr 1|Ciechocinek|ul. Kopernika 18 |87-720 Ciechocinek;1248;798;798;35;763;63.94;4.39
85563;040102;Szkoła Podstawowa Nr 1|Ciechocinek|ul. Kopernika 18 |87-720 Ciechocinek;1421;783;783;17;766;55.10;2.17
85564;040102;Miejski Ośrodek Pomocy Społecznej|Ciechocinek|ul. Kopernika 14 |87-720 Ciechocinek;1277;829;829;18;811;64.92;2.17
85565;040102;Gimnazjum|Ciechocinek|ul. Wojska Polskiego 37 |87-720 Ciechocinek;1209;747;747;10;737;61.79;1.34
85566;040102;Gimnazjum|Ciechocinek|ul. Wojska Polskiego 37 |87-720 Ciechocinek;1965;1156;1156;30;1126;58.83;2.60
85567;040103;Muzeum im. Stanisława Noakowskiego|Nieszawa|ul. Mickiewicza 6 |87-730 Nieszawa;572;264;264;16;248;46.15;6.06
85568;040103;Szkoła Podstawowa|Nieszawa|Kościuszki 6 |87-730 Nieszawa;527;276;276;12;264;52.37;4.35
85569;040103;Gimnazjum|Nieszawa|Zjazd 5 |87-730 Nieszawa;508;225;225;7;218;44.29;3.11
85570;040104;Zespół Szkół|Służewo|ul. Toruńska 8 |87-710 Służewo;1413;515;515;19;496;36.45;3.69
85571;040104;Świetlica wiejska|Nowa Wieś| 17a |87-700 Aleksandrów Kujawski;1252;495;495;11;484;39.54;2.22
85572;040104;Publiczna Szkoła Podstawowa w Przybranowie|Przybranowo| 46 |87-700 Aleksandrów Kujawski;658;238;238;7;231;36.17;2.94
85573;040104;Publiczna Szkoła Podstawowa w Ostrowąsie|Ostrowąs| 81 |87-700 Aleksandrów Kujawski;1258;429;429;26;403;34.10;6.06
85574;040104;Remiza OSP|Odolion|ul.Dworcowa 5 |87-700 Aleksandrów Kujawski;1049;449;449;20;429;42.80;4.45
85575;040104;Świetlica wiejska|Łazieniec|ul.Podgórna 1 |87-700 Aleksandrów Kujawski;551;253;253;9;244;45.92;3.56
85576;040104;Zespół Szkół|Stawki|Szkolna 4 |87-700 Aleksandrów Kujawski;755;288;288;17;271;38.15;5.90
85577;040104;Publiczna Szkoła Podstawowa w Opokach|Opoki| 43 |87-700 Aleksandrów Kujawski;858;303;303;19;284;35.31;6.27
85578;040104;Świetlica wiejska|Wołuszewo| 30 |87-720 Wołuszewo;1165;487;487;11;476;41.80;2.26
85579;040105;Zespół Szkolno-Przedszkolny w Bądkowie Publiczne Gimnazjum|Bądkowo|ul.Włocławska 13 |87-704 Bądkowo;816;381;381;17;364;46.69;4.46
85580;040105;Ochotnicza Straż Pożarna w Wysocinie|Wysocin| 42 |87-704 Bądkowo;869;310;310;27;283;35.67;8.71
85581;040105;Świetlica wiejska w Łowiczku|Łowiczek| 19 |87-704 Bądkowo;908;324;324;28;296;35.68;8.64
85582;040105;Zespół Szkolno-Przedszkolny w Bądkowie Szkoła Podstawowa|Bądkowo|ul.Włocławska 13 |87-704 Bądkowo;961;412;412;20;392;42.87;4.85
85583;040106;Gminny Ośrodek Kultury w Konecku|Koneck| 24 |87-702 Koneck;565;191;191;7;184;33.81;3.66
85584;040106;Szkoła Podstawowa w Świętem|Święte| 1 |87-702 Koneck;473;165;165;6;159;34.88;3.64
85585;040106;Szkoła Podstawowa w Straszewie|Straszewo| 17 |87-702 Koneck;621;215;215;12;203;34.62;5.58
85586;040106;Świetlica Wiejska w Kruszynku|Kruszynek| 8a |87-702 Koneck;517;173;173;9;164;33.46;5.20
85587;040106;Zespół Szkół w Konecku|Koneck|Koneck 28 |87-702 Koneck;525;211;211;12;199;40.19;5.69
85588;040107;Zespół Szkół|Raciążek|ul. Szkolna 3 |87-721 Raciążek;669;264;264;11;253;39.46;4.17
85589;040107;Gminny Ośrodek Kultury Sala Widowiskowa|Raciążek|ul. Wysoka 4 |87-721 Raciążek;569;241;241;11;230;42.36;4.56
85590;040107;Gminny Ośrodek Kultury Kawiarnia|Raciążek|Wysoka 4 |87-721 Raciążek;620;305;305;13;292;49.19;4.26
85591;040107;Remiza Ochotniczej Straży Pożarnej|Raciążek|Rynkowa 6a |87-721 Raciążek;535;231;231;9;222;43.18;3.90
85592;040107;Świetlica Samodzielnego Publicznego Zakładu Leczniczo-Opiekuńczego w Raciążku|Raciążek|Przedmiejska 1 |87-721 Raciążek;179;40;40;11;29;22.35;27.50
85593;040108;Sala Urzędu Gminy w Wagańcu|Waganiec|ul. Dworcowa 11 |87-731 Waganiec;665;264;264;10;254;39.70;3.79
85594;040108;Gminna Biblioteka Publiczna w Wagańcu|Waganiec|ul. Dworcowa 9 |87-731 Waganiec;562;255;255;24;231;45.37;9.41
85595;040108;Przedszkole w Zespole Szkół im. I.J. Paderewskiego w Zbrachlinie|Zbrachlin| 16 |87-731 Waganiec;628;260;260;5;255;41.40;1.92
85596;040108;Szkoła Podstawowa im. Orła Białego w Niszczewach|Niszczewy| 2 |87-731 Waganiec;519;183;183;13;170;35.26;7.10
85597;040108;Zespół Szkół w Brudnowie|Brudnowo| 25 |87-731 Waganiec;386;143;143;10;133;37.05;6.99
85598;040108;Remiza OSP w Sierzchowie|Sierzchowo| 52a |87-731 Waganiec;386;149;149;4;145;38.60;2.68
85599;040108;Budynek po Szkole Podstawowej w Wólnem|Wólne| 33 |87-731 Waganiec;489;192;192;12;180;39.26;6.25
85600;040109;Dom Kultury w Zakrzewie|Zakrzewo|ul. Dworcowa 1 |87-707 Zakrzewo;602;254;254;12;242;42.19;4.72
85601;040109;Publiczna Szkoła Podstawowa w Zakrzewie|Zakrzewo|ul. Osiedlowa 25 |87-707 Zakrzewo;501;172;172;9;163;34.33;5.23
85602;040109;Publiczna Szkoła Podstawowa w Sędzinie|Sędzin| 27A |87-706 Sędzin;924;364;364;21;343;39.39;5.77
85603;040109;Szkoła Podstawowa Stowarzyszenia Przyjaciół Szkół Katolickich Siniarzewo|Siniarzewo| 74 |87-705 Siniarzewo;798;321;321;21;300;40.23;6.54
85604;040109;Świetlica Domu Pomocy Społecznej w Zakrzewie|Zakrzewo|ul. Inowrocławska 20 |87-707 Zakrzewo;92;39;39;8;31;42.39;20.51
85605;040201;Przedszkole Nr 6|Brodnica|ul. Batalionów Chłopskich 28 |87-300 Brodnica;1182;580;580;3;577;49.07;0.52
85606;040201;Dom Pomocy Społecznej|Brodnica|ul. Wiejska 1 |87-300 Brodnica;1075;518;518;20;498;48.19;3.86
85607;040201;Szkoła Podstawowa Nr 2|Brodnica|ul. Kolejowa 62 |87-300 Brodnica;1793;805;805;17;788;44.90;2.11
85608;040201;Przedszkole Nr 8|Brodnica|ul. Zielona 3 |87-300 Brodnica;2027;1054;1054;26;1028;52.00;2.47
85609;040201;Brodnicki Dom Kultury|Brodnica|ul. Przykop 43 |87-300 Brodnica;1951;978;978;31;947;50.13;3.17
85610;040201;Szkoła Podstawowa Nr 1|Brodnica|ul. 3 Maja 2 |87-300 Brodnica;990;411;411;21;390;41.52;5.11
85611;040201;Pałac Anny Wazówny|Brodnica|ul. Zamkowa 1 |87-300 Brodnica;1126;590;590;10;580;52.40;1.69
85612;040201;I Liceum Ogólnokształcące|Brodnica|ul. Lidzbarska 14 |87-300 Brodnica;1843;811;811;22;789;44.00;2.71
85613;040201;Zespół Szkół Nr 1|Brodnica|ul. Matejki 5 |87-300 Brodnica;1812;930;930;20;910;51.32;2.15
85614;040201;Zespół Szkół Nr 1|Brodnica|ul. Matejki 5 |87-300 Brodnica;1046;524;524;10;514;50.10;1.91
85615;040201;Przedszkole im. Marii Konopnickiej|Brodnica|ul. Wyspiańskiego 12a |87-300 Brodnica;1263;678;678;15;663;53.68;2.21
85616;040201;Przedszkole im. Marii Konopnickiej|Brodnica|ul. Wyspiańskiego 12a |87-300 Brodnica;1469;748;749;14;734;50.92;1.87
85617;040201;Warsztat Terapii Zajęciowej|Brodnica|ul. Wyspiańskiego 13 |87-300 Brodnica;1110;582;582;15;567;52.43;2.58
85618;040201;Szkoła Podstawowa Nr 4|Brodnica|ul. Nowa 34 |87-300 Brodnica;1541;821;821;8;813;53.28;0.97
85619;040201;Szkoła Podstawowa Nr 4|Brodnica|ul. Nowa 34 |87-300 Brodnica;1225;520;520;13;507;42.45;2.50
85620;040201;Zespół Opieki Zdrowotnej (Budynek Szpitala)|Brodnica|ul. Wiejska 9 |87-300 Brodnica;105;22;22;0;22;20.95;0.00
85621;040202;Gminny Ośrodek Kultury|Bobrowo| 52 |87-327 Bobrowo;975;402;402;25;377;41.23;6.22
85622;040202;Świetlica Wiejska|Grzybno| 56 |87-327 Bobrowo;930;398;398;16;382;42.80;4.02
85623;040202;Wiejski Dom Kultury|Nieżywięć| 40 |87-326 Bobrowo;604;217;217;9;208;35.93;4.15
85624;040202;Wiejski Dom Kultury|Nieżywięć| 40 |87-326 Bobrowo;782;322;322;13;309;41.18;4.04
85625;040202;Szkoła Podstawowa|Kruszyny| 7A |87-326 Nieżywięć;692;203;203;18;185;29.34;8.87
85626;040202;Szkoła Podstawowa|Małki| 30 |87-325 Bobrowo;1036;393;393;15;378;37.93;3.82
85627;040202;Zakład Opiekuńczo-Leczniczy|Wichulec| 14 A |87-327 Bobrowo;34;11;11;5;6;32.35;45.45
85628;040203;Dom Kultury|Karbowo|ul. Klubowa 25 |87-300 Brodnica;1404;680;680;22;658;48.43;3.24
85629;040203;Szkoła Podstawowa|Cielęta| 15 |87-300 Brodnica;948;373;373;11;362;39.35;2.95
85630;040203;Gimnazjum|Szczuka| 34 |87-300 Brodnica;966;403;403;20;383;41.72;4.96
85631;040203;Szkoła Podstawowa|Gortatowo| 7 |87-300 Brodnica;398;164;164;8;156;41.21;4.88
85632;040203;Szkoła Podstawowa|Gorczenica| 87 |87-300 Brodnica;978;385;385;29;356;39.37;7.53
85633;040203;Szkoła Podstawowa|Szabda| 59 |87-300 Brodnica;1331;527;527;18;509;39.59;3.42
85634;040204;Szkoła Podstawowa|Brzozie| |87-313 Brzozie;799;373;373;30;343;46.68;8.04
85635;040204;Szkoła Podstawowa|Wielkie Leźno| |87-313 Brzozie;614;237;237;12;225;38.60;5.06
85636;040204;Szkoła Podstawowa|Jajkowo| |87-313 Brzozie;641;221;221;11;210;34.48;4.98
85637;040204;Gimnazjum|Brzozie| |87-313 Brzozie;852;404;404;17;387;47.42;4.21
85638;040205;Zespół Szkół|Górzno|ul. Chopina 1 |87-320 Górzno;1140;563;563;24;539;49.39;4.26
85639;040205;Gminny Ośrodek Kultury|Górzno|ul. Rynek 14a |87-320 Górzno;450;134;134;7;127;29.78;5.22
85640;040205;Niepubliczna Szkoła|Gołkowo| 26 |87-320 Górzno;485;174;174;10;164;35.88;5.75
85641;040205;Niepubliczna Szkoła Podstawowa|Miesiączkowo| 25 |87-320 Górzno;453;176;176;12;164;38.85;6.82
85642;040205;Liceum Ogólnokształcące SPSK|Górzno|ul. Kościelna 7 |87-320 Górzno;642;277;277;20;257;43.15;7.22
85643;040206;Szkoła Podstawowa|Radoszki| |87-321 Bartniczka;900;377;377;31;346;41.89;8.22
85644;040206;Świetlica Wiejska|Grążawy| |87-321 Bartniczka;1015;452;452;24;428;44.53;5.31
85645;040206;Przedszkole Publiczne|Łaszewo| |87-321 Bartniczka;610;260;260;10;250;42.62;3.85
85646;040206;Publiczne Gimnazjum|Jastrzębie| |87-321 Bartniczka;1148;452;452;16;436;39.37;3.54
85647;040207;Miejsko-Gminny Ośrodek Kultury|Jabłonowo Pomorskie|ul. Rynek 9 |87-330 Jabłonowo Pomorskie;1493;687;687;37;650;46.01;5.39
85648;040207;Szkoła Podstawowa|Jabłonowo Pomorskie|ul. Kościelna 8 |87-330 Jabłonowo Pomorskie;1470;652;652;57;595;44.35;8.74
85649;040207;Gimnazjum|Jabłonowo Pomorskie|ul. Słoneczna 2 |87-330 Jabłonowo Pomorskie;1472;543;543;27;516;36.89;4.97
85650;040207;Szkoła Podstawowa|Płowęż| |87-330 Jabłonowo Pomorskie;585;156;156;14;142;26.67;8.97
85651;040207;Spółdzielnia Mieszkaniowa "Osiedle Mileszewy"|Mileszewy| |87-330 Jabłonowo Pomorskie;1310;484;484;25;459;36.95;5.17
85652;040207;Szkoła Podstawowa|Górale| |87-330 Jabłonowo Pomorskie;836;303;303;20;283;36.24;6.60
85653;040208;Szkoła Podstawowa|Strzygi| |87-340 Osiek;973;402;402;26;376;41.32;6.47
85654;040208;Szkoła Podstawowa|Osiek| |87-340 Osiek;1235;397;397;29;368;32.15;7.30
85655;040208;Szkoła Podstawowa|Osiek| |87-340 Osiek;1007;332;332;15;317;32.97;4.52
85656;040209;Szkoła Podstawowa (świetlica)|Świedziebnia| |87-335 Świedziebnia;1037;552;552;13;539;53.23;2.36
85657;040209;Szkoła Podstawowa (sala nr 7)|Świedziebnia| |87-335 Świedziebnia;1142;482;482;18;464;42.21;3.73
85658;040209;Szkoła Filialna|Michałki| |87-335 Świedziebnia;551;158;158;7;151;28.68;4.43
85659;040209;Szkoła Podstawowa|Janowo| |87-335 Świedziebnia;959;358;358;14;344;37.33;3.91
85660;040209;Szkoła Filialna|Zasady| |87-335 Świedziebnia;483;228;228;6;222;47.20;2.63
85661;040210;Świetlica GOKSiR|Zbiczno| 170 |87-305 Zbiczno;1186;502;502;19;483;42.33;3.78
85662;040210;Świetlica GOKSiR|Pokrzydowo| 32 |87-312 Zbiczno;1313;620;620;17;603;47.22;2.74
85663;040210;Świetlica GOKSiR|Sumowo| 24 |87-305 Zbiczno;868;294;294;13;281;33.87;4.42
85664;040210;Świetlica GOKSiR|Ciche| 26 |87-305 Zbiczno;477;216;216;10;206;45.28;4.63
85665;040301;SZKOŁA PODSTAWOWA|BIAŁE BŁOTA|UL. CENTRALNA 27 |86-005 BIAŁE BŁOTA;818;427;427;12;415;52.20;2.81
85666;040301;SZKOŁA PODSTAWOWA|BIAŁE BŁOTA|UL.CENTRALNA 27 |86-005 BIAŁE BŁOTA;951;561;561;9;552;58.99;1.60
85667;040301;SZKOŁA PODSTAWOWA|BIAŁE BŁOTA|UL. CZERSKA 10 |86-005 BIAŁE BŁOTA;775;409;409;15;394;52.77;3.67
85668;040301;GIMNAZJUM PUBLICZNE|BIAŁE BŁOTA|UL. CZYSTA 1A |86-005 BIAŁE BŁOTA;705;370;370;7;363;52.48;1.89
85669;040301;ZAKŁAD AKTYWNOŚCI ZAWODOWEJ|BIAŁE BŁOTA|UL. CENTRALNA 27A |86-005 BIAŁE BŁOTA;1193;606;606;6;600;50.80;0.99
85670;040301;GIMNAZJUM PUBLICZNE|BIAŁE BŁOTA|UL. CZYSTA 1A |86-005 BIAŁE BŁOTA;901;481;481;5;476;53.39;1.04
85671;040301;ŚWIETLICA WIEJSKA|CIELE|UL. OSIEDLE 4 |86-005 BIAŁE BŁOTA;999;535;535;23;512;53.55;4.30
85672;040301;ŚWIETLICA WIEJSKA|KRUSZYN KRAJEŃSKI|UL.ŚWIERKOWA 5 |86-005 BIAŁE BŁOTA;1209;704;704;7;697;58.23;0.99
85673;040301;ŚWIETLICA WIEJSKA|LISI OGON|UL.WYCZYNOWA 2 |86-065 ŁOCHOWO;613;318;318;5;313;51.88;1.57
85674;040301;ŚWIETLICA WIEJSKA|ŁOCHOWICE|UL. SPOKOJNA 3 |86-065 ŁOCHOWO;994;600;600;6;594;60.36;1.00
85675;040301;GMINNE CENTRUM KULTURY|ŁOCHOWO|UL. JAŁOWCOWA 7 |86-065 ŁOCHOWO;1215;703;703;15;688;57.86;2.13
85676;040301;ZESPÓŁ SZKÓŁ|ŁOCHOWO|UL. WIERZBOWA 2 |00-000 ŁOCHOWO;1209;699;699;13;686;57.82;1.86
85677;040301;ŚWIETLICA WIEJSKA|Murowaniec|UL. STAROSZKOLNA 13 |86-005 BIAŁE BŁOTA;1081;632;632;13;619;58.46;2.06
85678;040301;GMINNE PRZEDZKOLE "WRÓŻKA" W BIAŁYCH BŁOTACH ODDZIAŁ W ZIELONCE|ZIELONKA|UL. BYDGOSKA 11 |86-005 BIAŁE BŁOTA;1222;712;713;9;703;58.27;1.26
85679;040301;SZKOŁA PODSTAWOWA|PRZYŁĘKI|UL. ZABYTKOWA 5 |86-005 BIAŁE BŁOTA;862;479;479;7;472;55.57;1.46
85680;040302;Świetlica w BOLUMINIE|Bolumin|Bolumin 30 |86-070 DĄBROWA CHEŁMIŃSKA;331;117;117;2;115;35.35;1.71
85681;040302;Świetlica w CZEMLEWIE|Czemlewo| 4 |86-070 DĄBROWA CHEŁMIŃSKA;513;170;170;6;164;33.14;3.53
85682;040302;Świetlica w GZINIE|Gzin| 26 |86-070 DĄBROWA CHEŁMIŃSKA;404;179;179;3;176;44.31;1.68
85683;040302;ZESPÓŁ SZKÓŁ w Dąbrowie Chełmińskiej oddział zamiejscowy w WAŁDOWIE KRÓLEWSKIM|Wałdowo Królewskie|Długa 32 |86-070 DĄBROWA CHEŁMIŃSKA;446;214;214;9;205;47.98;4.21
85684;040302;Zespół Szkół w OSTROMECKU|Ostromecko|Szkolna 2 |86-070 DĄBROWA CHEŁMIŃSKA;713;289;289;8;281;40.53;2.77
85685;040302;Zespół Szkół w OSTROMECKU|Ostromecko|Szkolna 2 |86-070 DĄBROWA CHEŁMIŃSKA;781;412;412;9;403;52.75;2.18
85686;040302;Zespół Szkół w CZARŻU|Czarże|Chełmińska 47 |86-070 DĄBROWA CHEŁMIŃSKA;667;261;261;6;255;39.13;2.30
85687;040302;Zespół Szkół w CZARŻU|Czarże|Chełmińska 47 |86-070 DĄBROWA CHEŁMIŃSKA;547;198;198;8;190;36.20;4.04
85688;040302;Zespół Szkół w DĄBROWIE CHEŁMIŃSKIEJ|Dąbrowa Chełmińska|Sportowa 1 |86-070 DĄBROWA CHEŁMIŃSKA;880;340;340;13;327;38.64;3.82
85689;040302;Zespół Szkół w DĄBROWIE CHEŁMIŃSKIEJ|Dąbrowa Chełmińska|Sportowa 1 |86-070 DĄBROWA CHEŁMIŃSKA;938;397;397;16;381;42.32;4.03
85690;040303;ZESPÓŁ SZKÓŁ W DOBRCZU|DOBRCZ|DŁUGA 33 |86-022 DOBRCZ;1382;740;740;26;714;53.55;3.51
85691;040303;ZESPÓŁ SZKÓŁ W KOTOMIERZU|KOTOMIERZ|KORONOWSKA 2 |86-022 DOBRCZ;1302;556;556;18;538;42.70;3.24
85692;040303;ZESPÓŁ SZKÓŁ W WUDZYNIE|WUDZYN|ZAMKOWA 12 |86-022 DOBRCZ;1379;619;619;23;596;44.89;3.72
85693;040303;SZKOŁA PODSTAWOWA W KOZIELCU|KOZIELEC| 24 |86-022 DOBRCZ;1095;544;544;22;522;49.68;4.04
85694;040303;ZESPÓŁ SZKÓŁ W BORÓWNIE|BORÓWNO|SZKOLNA 13 |86-022 DOBRCZ;988;523;523;9;514;52.94;1.72
85695;040303;SZKOŁA PODSTAWOWA W STRZELCACH GÓRNYCH|STRZELCE GÓRNE|SZKOLNA 6 |86-022 DOBRCZ;704;384;384;16;368;54.55;4.17
85696;040303;ŚWIETLICA WIEJSKA W KUSOWIE|Kusowo|Gdańska 26 |86-022 Dobrcz;594;251;251;10;241;42.26;3.98
85697;040303;ZESPÓŁ SZKÓŁ W DOBRCZU|Dobrcz|Długa 33 |86-022 Dobrcz;479;192;192;8;184;40.08;4.17
85698;040303;ŚWIETLICA WIEJSKA W WUDZYNKU|Wudzynek|Główna 16 |86-022 Dobrcz;575;258;258;11;247;44.87;4.26
85699;040304;Liceum Ogólnokształcące im. Leona Wyczółkowskiego|Koronowo|ul. Szkolna 4 |86-010 Koronowo;988;279;279;18;261;28.24;6.45
85700;040304;Zespół Szkół|Koronowo|ul. Jana Sobieskiego 16 |86-010 Koronowo;1180;339;339;12;327;28.73;3.54
85701;040304;Szkoła Podstawowa Nr 2 im. Jana Pawła II|Koronowo|ul. Dworcowa 48 |86-010 Koronowo;1501;608;608;20;588;40.51;3.29
85702;040304;Gimnazjum Nr 1 im. Komisji Edukacji Narodowej|Koronowo|ul. Pomianowskiego 16 |86-010 Koronowo;984;529;529;14;515;53.76;2.65
85703;040304;Gimnazjum Nr 1 im. Komisji Edukacji Narodowej|Koronowo|ul. Pomianowskiego 16 |86-010 Koronowo;1077;559;559;17;542;51.90;3.04
85704;040304;Urząd Miejski|Koronowo|ul. Pomianowskiego 1 |86-010 Koronowo;1034;503;503;18;485;48.65;3.58
85705;040304;Szkoła Podstawowa Nr 2 im. Jana Pawła II|Koronowo|ul. Dworcowa 48 |86-010 Koronowo;998;493;493;5;488;49.40;1.01
85706;040304;Gimnazjum Nr 1 im. Komisji Edukacji Narodowej|Koronowo|ul. Pomianowskiego 16 |86-010 Koronowo;864;442;442;10;432;51.16;2.26
85707;040304;Wiejski Dom Kultury|Mąkowarsko|ul. Tucholska 29 |86-013 Mąkowarsko;1092;348;348;18;330;31.87;5.17
85708;040304;Świetlica Wiejska|Nowy Jasiniec| 29 |86-010 Koronowo;608;203;203;8;195;33.39;3.94
85709;040304;Zespół Szkół|Wtelno|ul. Szkolna 7 |86-011 Wtelno;1114;501;501;13;488;44.97;2.59
85710;040304;Szkoła Podstawowa|Buszkowo| 53 |86-010 Koronowo;859;352;352;6;346;40.98;1.70
85711;040304;Szkoła Podstawowa|Witoldowo| 33 |86-011 Wtelno;617;258;258;14;244;41.82;5.43
85712;040304;Zespół Szkół|Wierzchucin Królewski| 35 |86-017 Wierzchucin Królewski;965;366;366;10;356;37.93;2.73
85713;040304;Liceum Ogólnokształcące im. Leona Wyczółkowskiego|Koronowo|ul. Szkolna 4 |86-010 Koronowo;974;321;321;9;312;32.96;2.80
85714;040304;Świetlica Wiejska|Salno| 51 |86-010 Koronowo;667;255;255;8;247;38.23;3.14
85715;040304;Świetlica Wiejska|Lucim| |86-013 Mąkowarsko;751;247;247;12;235;32.89;4.86
85716;040304;Świetlica Wiejska|Wiskitno| |86-017 Wierzchucin Królewski;897;299;299;25;274;33.33;8.36
85717;040304;Świetlica Wiejska|Tryszczyn| |86-011 Wtelno;935;534;534;4;530;57.11;0.75
85718;040304;Świetlica Wiejska|Samociążek| |86-010 Koronowo;353;195;195;10;185;55.24;5.13
85719;040304;,,Biurowiec" Fundacji Potulickiej w Krąpiewie|Krąpiewo| |86-017 Wierzchucin Królewski;196;84;84;0;84;42.86;0.00
85720;040304;Dom Pomocy Społecznej|Koronowo|ul. Paderewskiego 35 |86-010 Koronowo;31;18;18;3;15;58.06;16.67
85721;040304;Zakład Karny|Koronowo|ul. Bydgoska 27 |86-010 Koronowo;622;220;220;18;202;35.37;8.18
85722;040305;GMINNY OŚRODEK POMOCY SPOŁECZNEJ|NOWA WIEŚ WIELKA|OGRODOWA 2A |86-060 Nowa Wieś Wielka;1624;672;672;27;645;41.38;4.02
85723;040305;GIMNAZJUM|BRZOZA|POWSTAŃCÓW WIELKOPOLSKICH 31A |86-061 Brzoza;1651;779;779;17;762;47.18;2.18
85724;040305;GIMNAZJUM|NOWA WIEŚ WIELKA|OGRODOWA 1 |86-060 Nowa Wieś Wielka;1246;555;555;12;543;44.54;2.16
85725;040305;GIMNAZJUM|BRZOZA|POWSTAŃCÓW WIELKOPOLSKICH 31A |86-061 Brzoza;1360;749;749;10;739;55.07;1.34
85726;040305;ŚWIETLICA WIEJSKA|NOWE SMOLNO| 10 |86-061 Brzoza;499;221;221;1;220;44.29;0.45
85727;040305;ŚWIETLICA WIEJSKA|PRĄDOCIN|BYDGOSKA 14 |86-060 Nowa Wieś Wielka;619;303;303;11;292;48.95;3.63
85728;040305;ŚWIETLICA WIEJSKA|DĄBROWA WIELKA| 17 |86-060 Nowa Wieś Wielka;186;44;44;3;41;23.66;6.82
85729;040305;ŚWIETLICA WIEJSKA|TARKOWO DOLNE| 43 |86-060 Nowa Wieś Wielka;326;102;102;5;97;31.29;4.90
85730;040306;ZESPÓŁ SZKÓŁ W OSIELSKU|OSIELSKO|CENTRALNA 7 |86-031 OSIELSKO;1363;968;968;6;962;71.02;0.62
85731;040306;ŚWIETLICA ŻOŁĘDOWO|ŻOŁĘDOWO|WIERZBOWA 6 |86-031 OSIELSKO;1144;643;643;17;626;56.21;2.64
85732;040306;ŚWIETLICA MAKSYMILIANOWO|MAKSYMILIANOWO|KOŚCIELNA 2 |86-021 MAKSYMILIANOWO;1292;719;719;16;703;55.65;2.23
85733;040306;ŚWIETLICA JARUŻYN|JARUŻYN|STAROWIEJSKA 16 |86-031 OSIELSKO;396;205;205;7;198;51.77;3.41
85734;040306;SZKOŁA PODSTAWOWA W NIEMCZU|NIEMCZ|BYDGOSKA 35 |86-032 NIEMCZ;759;528;528;11;517;69.57;2.08
85735;040306;ŚWIETLICA BOŻENKOWO|BOŻENKOWO|HARCERSKA 2 |86-021 OSIELSKO;322;134;134;7;127;41.61;5.22
85736;040306;ŚWIETLICA NIWY-WILCZE|Wilcze|Słupska 4 |86-031 OSIELSKO;663;393;393;5;388;59.28;1.27
85737;040306;ZESPÓŁ SZKÓŁ W OSIELSKU|OSIELSKO|CENTRALNA 7 |86-031 OSIELSKO;1383;840;840;11;829;60.74;1.31
85738;040306;GMINNY OŚRODEK KULTURY OSIELSKO|Osielsko|SZOSA GDAŃSKA 57 |86-031 OSIELSKO;678;429;429;7;422;63.27;1.63
85739;040306;SZKOŁA PODSTAWOWA W NIEMCZU|Niemcz|Bydgoska 35 |86-032 NIEMCZ;726;539;539;6;533;74.24;1.11
85740;040306;Szkoła Podstawowa w Niemczu|Niemcz|Bydgoska 35 |86-032 Niemcz;754;564;564;4;560;74.80;0.71
85741;040307;ŚWIETLICA WIEJSKA W MURUCINIE|MURUCIN| 7 |86-010 KORONOWO;444;181;181;9;172;40.77;4.97
85742;040307;SZKOŁA PODSTAWOWA W TRZEMIĘTOWIE|TRZEMIĘTOWO| 2 |86-014 SICIENKO;1009;389;389;22;367;38.55;5.66
85743;040307;ZESPÓŁ SZKÓŁ W WOJNOWIE|WOJNOWO| 1 |86-014 SICIENKO;613;227;227;12;215;37.03;5.29
85744;040307;ŚWIETLICA WIEJSKA W MOCHLU|MOCHLE| 74 |86-014 SICIENKO;554;247;247;10;237;44.58;4.05
85745;040307;ŚWIETLICA WIEJSKA W OSÓWCU|OSÓWIEC|DĄBROWIECKA 1 |86-014 SICIENKO;1168;594;594;11;583;50.86;1.85
85746;040307;SZKOŁA PODSTAWOWA W SAMSIECZNIE|SAMSIECZNO| 34A |86-014 SICIENKO;506;180;180;14;166;35.57;7.78
85747;040307;IZBA TRADYCJI KULTURALNEJ W SICIENKU|SICIENKO|BYDGOSKA 6 |86-014 SICIENKO;939;438;438;12;426;46.65;2.74
85748;040307;WIEJSKI DOM KULTURY W STRZELEWIE|STRZELEWO| 30 |86-014 SICIENKO;450;145;145;9;136;32.22;6.21
85749;040307;WIEJSKI DOM KULTURY W KRUSZYNIE|KRUSZYN|STRAŻACKA 9 |86-014 SICIENKO;1457;731;731;20;711;50.17;2.74
85750;040307;ŚWIETLICA WIEJSKA W ZIELONCZYNIE|ZIELONCZYN|SPACEROWA 10 |86-014 SICIENKO;444;251;251;5;246;56.53;1.99
85751;040307;ZAKŁAD KARNY W KORONOWIE ODDZIAŁ ZEWNĘTRZNY W STRZELEWIE|STRZELEWO| 61 |86-014 SICIENKO;233;78;78;7;71;33.48;8.97
85752;040308;GIMNAZJUM PUBLICZNE NR 2|SOLEC KUJAWSKI|UL. 29 LISTOPADA 7 |86-050 SOLEC KUJAWSKI;1605;752;752;19;733;46.85;2.53
85753;040308;GIMNAZJUM PUBLICZNE NR 2|SOLEC KUJAWSKI|UL. 29 LISTOPADA 7 |86-050 SOLEC KUJAWSKI;1940;1092;1092;21;1071;56.29;1.92
85754;040308;SZKOŁA MUZYCZNA I STOPNIA IM. FRYDERYKA CHOPINA W SOLCU KUJAWSKIM|SOLEC KUJAWSKI|UL. KOŚCIUSZKI 12 |86-050 SOLEC KUJAWSKI;909;464;464;6;458;51.05;1.29
85755;040308;SZKOŁA PODSTAWOWA NR 4|SOLEC KUJAWSKI|UL. JULIUSZA SŁOWACKIEGO 4 |86-050 SOLEC KUJAWSKI;1146;602;602;17;585;52.53;2.82
85756;040308;SZKOŁA PODSTAWOWA NR 4|SOLEC KUJAWSKI|UL. JULIUSZA SŁOWACKIEGO 4 |86-050 SOLEC KUJAWSKI;1153;566;566;29;537;49.09;5.12
85757;040308;ZESPÓŁ SZKÓŁ OGÓLNOKSZTAŁCĄCYCH I ZAWODOWYCH|SOLEC KUJAWSKI|UL. 23 STYCZNIA 13 |86-050 SOLEC KUJAWSKI;1683;753;753;21;732;44.74;2.79
85758;040308;ZESPÓŁ SZKÓŁ W SOLCU KUJAWSKIM|SOLEC KUJAWSKI|UL. TARTACZNA 25 |86-050 SOLEC KUJAWSKI;1678;845;845;16;829;50.36;1.89
85759;040308;ZESPÓŁ SZKÓŁ W SOLCU KUJAWSKIM|SOLEC KUJAWSKI|UL. TARTACZNA 25 |86-050 SOLEC KUJAWSKI;1152;520;520;8;512;45.14;1.54
85760;040308;ŚWIETLICA "JAGÓDKA"|SOLEC KUJAWSKI|UL. KUJAWSKA 17A |86-050 SOLEC KUJAWSKI;674;310;310;12;298;45.99;3.87
85761;040308;ŚWIETLICA WIEJSKA|Chrośna| 11 |86-050 SOLEC KUJAWSKI;128;50;50;0;50;39.06;0.00
85762;040308;ŚWIETLICA WIEJSKA|Przyłubie| 8 |86-050 SOLEC KUJAWSKI;188;70;70;3;67;37.23;4.29
85763;040308;ŚWIETLICA "MAKOWIANKA"|Makowiska| 14 |86-050 SOLEC KUJAWSKI;510;195;195;5;190;38.24;2.56
85764;040401;Gimnazjum Nr 1|Chełmno|ul. Szkolna 6 |86-200 Chełmno;1047;432;432;29;403;41.26;6.71
85765;040401;Zespół Szkół Ogólnokształcących Nr 1|Chełmno|ul. Dominikańska 35 |86-200 Chełmno;928;402;402;12;390;43.32;2.99
85766;040401;Zespół Szkół Ogólnokształcących Nr 1|Chełmno|ul. Dominikańska 35 |86-200 Chełmno;1009;350;350;25;325;34.69;7.14
85767;040401;Szkoła Podstawowa Nr 2|Chełmno|ul. 22 Stycznia 4 |86-200 Chełmno;977;305;305;21;284;31.22;6.89
85768;040401;Gimnazjum nr 1|Chełmno|ul. Szkolna 6 |86-200 Chełmno;1132;582;582;10;572;51.41;1.72
85769;040401;Szkoła Podstawowa nr 2|Chełmno|ul. 22 Stycznia 4 |86-200 Chełmno;1017;548;548;14;534;53.88;2.55
85770;040401;Miejski Ośrodek Profilaktyki i Rozwiązywania Problemów Uzależnień|Chełmno|ul. Kamionka 3 |86-200 Chełmno;963;367;367;11;356;38.11;3.00
85771;040401;Gimnazjum Nr 2|Chełmno|ul. Kościuszki 11 |86-200 Chełmno;863;466;466;7;459;54.00;1.50
85772;040401;Gimnazjum Nr 2|Chełmno|ul. Kościuszki 11 |86-200 Chełmno;900;455;455;5;450;50.56;1.10
85773;040401;Szkoła Podstawowa nr 4|Chełmno|os. M.C. Skłodowskiej 16 |86-200 Chełmno;1064;589;589;20;569;55.36;3.40
85774;040401;Spółdzielnia Mieszkaniowa|Chełmno|ul. Młyńska 7 |86-200 Chełmno;1033;515;515;15;500;49.85;2.91
85775;040401;Szkoła Podstawowa Nr 4|Chełmno|os. M.C.Skłodowskiej 16 |86-200 Chełmno;961;496;496;13;483;51.61;2.62
85776;040401;Szkoła Podstawowa Nr 4|Chełmno|os. M.C.Skłodowskiej 16 |86-200 Chełmno;1002;518;518;18;500;51.70;3.47
85777;040401;Szkoła Podstawowa Specjalna|Chełmno|ul. Dworcowa 20/22 |86-200 Chełmno;1193;547;547;20;527;45.85;3.66
85778;040401;Szkoła Podstawowa Specjalna|Chełmno|ul. Dworcowa 20/22 |86-200 Chełmno;1090;476;476;23;453;43.67;4.83
85779;040401;Samodzielny Publiczny Zespół Opieki Zdrowotnej|Chełmno|Plac dr Rydygiera 1 |86-200 Chełmno;143;37;37;3;34;25.87;8.11
85780;040401;Oddział Zewnętrzny Zakładu Karnego nr 2 w Grudziądzu|Chełmno|ul. 22 Stycznia 3a |86-200 Chełmno;65;32;32;5;27;49.23;15.62
85781;040401;Dom Pomocy Społecznej|Chełmno|ul. Dominikańska 40 |86-200 Chełmno;31;17;17;1;16;54.84;5.88
85782;040402;Zespół Szkół|Starogród| 33 |86-200 Chełmno;1223;430;430;10;420;35.16;2.33
85783;040402;Szkoła Podstawowa im. Mikołaja Kopernika|Kolno| 33 |86-200 Chełmno;1200;409;409;14;395;34.08;3.42
85784;040402;Publiczne Gimnazjum im. Ziemi Chełmińskiej|Podwiesk| 43 |86-200 Chełmno;937;275;275;7;268;29.35;2.55
85785;040402;Szkoła Podstawowa im. Bronisława Malinowskiego|Małe Łunawy| 21 |86-200 Chełmno;1064;412;412;14;398;38.72;3.40
85786;040403;Szkoła Podstawowa|Brzozowo| 88 |86-200 Chełmno;764;361;361;7;354;47.25;1.94
85787;040403;Zespół Publicznych Szkół|Kijewo Królewskie|ul. Św. Wawrzyńca 6 |86-253 Kijewo Królewskie;1116;507;507;19;488;45.43;3.75
85788;040403;Świetlica Wiejska|Płutowo| |86-253 Kijewo Królewskie;623;208;208;8;200;33.39;3.85
85789;040403;Szkoła Podstawowa|Trzebczyk| 2 |86-253 Kijewo Królewskie;478;168;168;14;154;35.15;8.33
85790;040403;Szkoła Podstawowa|Trzebcz Szlachecki| 18 |86-253 Kijewo Królewskie;525;182;182;10;172;34.67;5.49
85791;040404;Szkoła Podstawowa|Krusin| 53 |86-230 Lisewo;898;308;308;16;292;34.30;5.19
85792;040404;Szkoła Podstawowa|Lisewo|ul. Toruńska 16 |86-230 Lisewo;1364;613;613;24;589;44.94;3.92
85793;040404;Gminne Gimnazjum|Lisewo|ul. Toruńska 17 |86-230 Lisewo;959;343;343;18;325;35.77;5.25
85794;040404;Świetlica Środowiskowa|Pniewite| 1 |86-230 Lisewo;835;294;295;20;274;35.21;6.80
85795;040404;Dom Pomocy Społecznej|Mgoszcz| 54 |86-230 Lisewo;27;25;25;2;23;92.59;8.00
85796;040405;Szkoła Podstawowa im. Mikołaja Kopernika|Dubielno| 14 |86-221 Papowo Biskupie;552;186;186;2;184;33.70;1.08
85797;040405;Świetlica Wiejska|Nowy Dwór Królewski| |86-221 Papowo Biskupie;599;170;170;7;163;28.38;4.12
85798;040405;Gimnazjum im. Noblistów Polskich|Papowo Biskupie| 127A |86-221 Papowo Biskupie;1139;432;432;14;418;37.93;3.24
85799;040405;Szkoła Podstawowa im. Romualda Traugutta|Zegartowice| 13 |86-221 Papowo Biskupie;586;204;204;5;199;34.81;2.45
85800;040405;Świetlica Wiejska|Jeleniec| 61 |86-221 Papowo Biskupie;575;169;169;9;160;29.39;5.33
85801;040406;Świetlica wiejska|Cepno| |86-212 Stolno;444;130;130;10;120;29.28;7.69
85802;040406;Budynek po byłej Szkole Podstawowej|Małe Czyste| |86-212 Stolno;434;151;151;3;148;34.79;1.99
85803;040406;Świetlica wiejska|Grubno| |86-212 Stolno;485;221;221;10;211;45.57;4.52
85804;040406;Zespół Szkół Nr 1|Stolno| |86-212 Stolno;938;331;331;24;307;35.29;7.25
85805;040406;Świetlica wiejska|Wabcz| |86-212 Stolno;634;256;256;6;250;40.38;2.34
85806;040406;Zespół Szkół Nr 2|Robakowo| |86-212 Stolno;1117;412;412;15;397;36.88;3.64
85807;040407;Zespół Szkół w Unisławiu|Unisław|ul. Lipowa 33 |86-260 Unisław;1399;707;707;15;692;50.54;2.12
85808;040407;Hala Widowiskowo-Sportowa|Unisław|ul. Spokojna 16 |86-260 Unisław;1163;421;421;14;407;36.20;3.33
85809;040407;Gminny Ośrodek Kultury|Unisław|ul. Parkowa 22 |86-260 Unisław;1114;431;431;16;415;38.69;3.71
85810;040407;Szkoła Podstawowa w Kokocku|Kokocko| 49 |86-260 Unisław;576;196;196;16;180;34.03;8.16
85811;040407;Przedszkole Gminne Krasnoludek|Unisław|ul. Lipowa 31 |86-260 Unisław;1117;533;533;18;515;47.72;3.38
85812;040501;Szkoła Podstawowa Nr 1 im. Konstytucji 3 Maja|Golub-Dobrzyń|ul. Zamkowa 19 |87-400 Golub-Dobrzyń;1463;553;553;30;523;37.80;5.42
85813;040501;Urząd Miasta|Golub-Dobrzyń|ul. Plac Tysiąclecia 25 |87-400 Golub-Dobrzyń;1829;735;735;27;708;40.19;3.67
85814;040501;Gimnazjum im. Ignacego Działyńskiego|Golub-Dobrzyń|ul. Szkolna 37 |87-400 Golub-Dobrzyń;1341;538;538;14;524;40.12;2.60
85815;040501;Hala widowiskowo-sportowa|Golub-Dobrzyń|ul. Sosnowa 2A |87-400 Golub-Dobrzyń;2116;1052;1052;33;1019;49.72;3.14
85816;040501;Zespół Szkół Miejskich|Golub-Dobrzyń|ul. Żeromskiego 11 |87-400 Golub-Dobrzyń;1846;965;965;27;938;52.28;2.80
85817;040501;Zespół Szkół Miejskich|Golub-Dobrzyń|ul. Żeromskiego 11 |87-400 Golub-Dobrzyń;1296;523;523;7;516;40.35;1.34
85818;040501;Szpital Powiatowy Sp. z o.o.|Golub-Dobrzyń|ul. Dr J. G. Koppa 1E |87-400 Golub-Dobrzyń;68;9;9;0;9;13.24;0.00
85819;040502;Szkoła Podstawowa w Ciechocinie|Ciechocin| |87-408 Ciechocin;866;400;400;16;384;46.19;4.00
85820;040502;Świetlica wiejska w Elgiszewie|Elgiszewo| |87-408 Ciechocin;604;275;275;14;261;45.53;5.09
85821;040502;Gimnazjum im. Czesława Miłosza|Nowa Wieś| |87-408 Ciechocin;813;315;315;5;310;38.75;1.59
85822;040502;Szkoła Podstawowa im. Bohaterów Września 1939 r.|Świętosław| |87-408 Ciechocin;887;348;348;27;321;39.23;7.76
85823;040503;Zespół Szkolno-Przedszkolny|Wrocki| |87-400 Golub-Dobrzyń;1495;538;538;38;500;35.99;7.06
85824;040503;Publiczne Gimnazjum im. Mikołaja Kopernika|Gałczewo| |87-400 Golub-Dobrzyń;1403;492;492;27;465;35.07;5.49
85825;040503;Zespół Szkolno-Przedszkolny|Ostrowite| |87-400 Golub-Dobrzyń;1170;437;437;12;425;37.35;2.75
85826;040503;Szkoła Podstawowa im. Tadeusza Kościuszki|Nowogród| |87-400 Golub-Dobrzyń;1448;629;629;23;606;43.44;3.66
85827;040503;Urząd Gminy|Golub-Dobrzyń|ul. Plac Tysiąclecia 25 |87-400 Golub-Dobrzyń;1433;510;510;14;496;35.59;2.75
85828;040504;Szkoła Podstawowa|Kowalewo Pomorskie|ul. Konopnickiej 13 |87-410 Kowalewo Pomorskie;1901;917;917;25;892;48.24;2.73
85829;040504;Miejsko-Gminny Ośrodek Kultury|Kowalewo Pomorskie|Plac Wolności 13 |87-410 Kowalewo Pomorskie;2087;986;986;35;951;47.24;3.55
85830;040504;Szkoła Podstawowa|Wielka Łąka| |87-410 Kowalewo Pomorskie;1218;460;460;9;451;37.77;1.96
85831;040504;Szkoła Podstawowa|Pluskowęsy| |87-410 Kowalewo Pomorskie;1312;490;490;20;470;37.35;4.08
85832;040504;Świetlica wiejska|Chełmonie| |87-410 Kowalewo Pomorskie;527;214;214;9;205;40.61;4.21
85833;040504;Świetlica wiejska|Mlewiec| |87-410 Kowalewo Pomorskie;441;168;168;9;159;38.10;5.36
85834;040504;Szkoła Podstawowa|Wielkie Rychnowo| |87-410 Kowalewo Pomorskie;1183;493;493;15;478;41.67;3.04
85835;040504;Świetlica wiejska|Sierakowo| |87-410 Kowalewo Pomorskie;488;174;174;3;171;35.66;1.72
85836;040505;Publiczne Gimnazjum im. Fryderyka Chopina|Radomin| 14 |87-404 Radomin;830;366;366;13;353;44.10;3.55
85837;040505;Wiejski Dom Kultury|Dulsk| 69 |87-404 Radomin;643;280;280;10;270;43.55;3.57
85838;040505;Szkoła Podstawowa im. Dziewanowskich|Płonne| 69 |87-404 Radomin;1163;413;413;9;404;35.51;2.18
85839;040505;Szkoła Podstawowa|Radomin| 21 |87-404 Radomin;679;256;256;9;247;37.70;3.52
85840;040506;Zespół Szkół|Działyń| 57 |87-645 Zbójno;1124;383;383;19;364;34.07;4.96
85841;040506;Szkoła Podstawowa|Ruże| 5 |87-645 Zbójno;445;185;185;15;170;41.57;8.11
85842;040506;Szkoła Podstawowa|Klonowo| 62 |87-645 Zbójno;812;234;234;17;217;28.82;7.26
85843;040506;Publiczne Gimnazjum|Zbójno| 178 |87-645 Zbójno;1113;415;415;18;397;37.29;4.34
85844;040601;Remizo-świetlica|Wielki Wełcz| 17 |86-302 Wielki Wełcz;277;119;119;6;113;42.96;5.04
85845;040601;Zespół Szkół|Mokre| 122 |86-302 Mokre;1023;383;383;19;364;37.44;4.96
85846;040601;Szkoła Podstawowa|Nowa Wieś|ul. Grudziądzka 43 |86-302 Nowa Wieś;1444;648;648;12;636;44.88;1.85
85847;040601;Zespół Szkół|Piaski| 10 |86-302 Piaski;1229;457;457;5;452;37.18;1.09
85848;040601;Zespół Szkół|Wałdowo Szlacheckie| 57 |86-302 Wałdowo Szlacheckie;1281;584;584;12;572;45.59;2.05
85849;040601;Gminny Ośrodek Kultury|Mały Rudnik| 35A |86-302 Mały Rudnik;1438;702;702;10;692;48.82;1.42
85850;040601;Szkoła Podstawowa|Sosnówka| 3 |86-302 Sosnówka;578;196;196;5;191;33.91;2.55
85851;040601;Spółdzielnia Mieszkaniowa|Wielkie Lniska| |86-302 Wielkie Lniska;467;166;166;13;153;35.55;7.83
85852;040601;Szkoła Podstawowa|Dusocin| 9 |86-302 Dusocin;342;130;130;12;118;38.01;9.23
85853;040601;Świetlica Wiejska|Węgrowo| |86-302 Węgrowo;728;383;383;5;378;52.61;1.31
85854;040601;Swojska Chata|Świerkocin| 38B |86-302 Świerkocin;482;204;204;2;202;42.32;0.98
85855;040602;Zespół Szkół|Gruta| |86-330 Mełno;821;379;379;8;371;46.16;2.11
85856;040602;Przedszkole Samorządowe|Mełno| |86-330 Mełno;988;340;340;14;326;34.41;4.12
85857;040602;Szkoła Podstawowa|Nicwałd| |86-330 Mełno;658;278;278;6;272;42.25;2.16
85858;040602;Szkoła Podstawowa|Boguszewo| |86-330 Mełno;596;239;239;14;225;40.10;5.86
85859;040602;Świetlica wiejska|Okonin| |86-330 Mełno;754;282;282;9;273;37.40;3.19
85860;040602;Szkoła Podstawowa|Dąbrówka Królewska| |86-330 Mełno;496;143;143;6;137;28.83;4.20
85861;040602;Zespół Szkół|Gruta| |86-330 Mełno;888;308;308;12;296;34.68;3.90
85862;040603;Zespół Szkół Ponadgimnazjalnych im. Kazimierza Jagiellończyka|Łasin|ul. Odrodzenia Polski 3 |86-320 Łasin;874;381;381;20;361;43.59;5.25
85863;040603;Miejsko-Gminny Ośrodek Kultury i Sportu|Łasin|ul. Curie- Skłodowskiej 1 |86-320 Łasin;813;354;354;7;347;43.54;1.98
85864;040603;Warsztaty Terapii Zajęciowej im. Jana Pawła II|Łasin|ul. Ks. Kard. Wyszyńskiego 1 |86-320 Łasin;904;415;415;16;399;45.91;3.86
85865;040603;Zespół Szkół Publicznych im. Bojowników o Wolność i Demokrację|Łasin|ul. Curie-Skłodowskiej 14 |86-320 Łasin;652;230;230;13;217;35.28;5.65
85866;040603;Szkoła Podstawowa|Szonowo| 81 |86-320 Łasin;779;258;258;9;249;33.12;3.49
85867;040603;Szkoła Podstawowa|Wydrzno| 9 |86-320 Łasin;831;255;255;12;243;30.69;4.71
85868;040603;Gimnazjum Nr 2|Jankowice| 18 |86-320 Łasin;845;246;246;12;234;29.11;4.88
85869;040603;Remiza Strażacka|Szczepanki| |86-320 Łasin;701;211;211;7;204;30.10;3.32
85870;040603;Samodzielny Publiczny Zakład Opieki Zdrowotnej im. Macieja z Miechowa|Łasin|ul. Grudziądzka 2 |86-320 Łasin;46;5;5;1;4;10.87;20.00
85871;040604;Zespół Szkół|Radzyń Chełmiński|ul. Sady 18 |87-220 Radzyń Chełmiński;819;280;280;14;266;34.19;5.00
85872;040604;Zespół Szkół|Radzyń Chełmiński|ul. Sady 18 |87-220 Radzyń Chełmiński;724;226;226;5;221;31.22;2.21
85873;040604;Budynek poszkolny|Zielnowo| 32 |87-220 Radzyń Chełmiński;668;177;177;15;162;26.50;8.47
85874;040604;Budynek poszkolny|Szumiłowo| 13 |87-220 Radzyń Chełmiński;493;166;166;1;165;33.67;0.60
85875;040604;Przedszkole Samorządowe|Radzyń Chełmiński|ul. Sady 18 |87-220 Radzyń Chełmiński;545;195;195;11;184;35.78;5.64
85876;040604;Budynek poszkolny|Rywałd| 46 |87-220 Radzyń Chełmiński;527;208;208;14;194;39.47;6.73
85877;040605;Stowarzyszenie Kulturalno-Oświatowe "PROMIEŃ"|Szembruk| |86-318 Rogóźno;985;344;344;5;339;34.92;1.45
85878;040605;Gminny Ośrodek Kultury|Rogóźno| |86-318 Rogóźno;1197;506;506;20;486;42.27;3.95
85879;040605;Szkoła Podstawowa|Białochowo| |86-318 Rogóźno;618;197;197;13;184;31.88;6.60
85880;040605;Świetlica wiejska|Rogóźno-Zamek| |86-318 Rogóźno;425;157;157;4;153;36.94;2.55
85881;040606;Szkoła Podstawowa im. Józefa Wybickiego|Linowo| |86-341 Świecie nad Osą;647;137;137;10;127;21.17;7.30
85882;040606;Szkoła Podstawowa im. ks. Jana Twardowskiego|Lisnowo| |86-342 Lisnowo;974;289;289;13;276;29.67;4.50
85883;040606;Środowiskowy Dom Samopomocy|Świecie nad Osą| |86-341 Świecie nad Osą;599;263;263;2;261;43.91;0.76
85884;040606;Szkoła Podstawowa|Bursztynowo| |86-341 Świecie nad Osą;723;230;230;9;221;31.81;3.91
85885;040606;Świetlica Wiejska|Mędrzyce| |86-320 Łasin;415;88;88;6;82;21.20;6.82
85886;040701;FILIA NR 4 BIBLIOTEKI MIEJSKIEJ IM. JANA KASPROWICZA|INOWROCŁAW|UL. POPRZECZNA 29 |88-100 INOWROCŁAW;1440;674;674;21;653;46.81;3.12
85887;040701;GIMNAZJUM NR 1 IM ŚW. WOJCIECHA|INOWROCŁAW|UL. TORUŃSKA 46-48 |88-100 INOWROCŁAW;1162;676;676;13;663;58.18;1.92
85888;040701;GIMNAZJUM NR 1 IM. ŚW. WOJCIECHA|INOWROCŁAW|UL. TORUŃSKA 46-48 |88-100 INOWROCŁAW;1096;377;377;13;364;34.40;3.45
85889;040701;PRZEDSZKOLE NR 14 "MUZYCZNA KRAINA"|INOWROCŁAW|UL. MARII SKŁODOWSKIEJ-CURIE 41 |88-100 INOWROCŁAW;1362;613;613;18;595;45.01;2.94
85890;040701;KLUB "KOPERNIK" KUJAWSKIEJ SPÓŁDZIELNI MIESZKANIOWEJ W INOWROCŁAWIU|INOWROCŁAW|UL. TORUŃSKA 60 |88-100 INOWROCŁAW;1199;581;581;17;564;48.46;2.93
85891;040701;ŚRODOWISKOWY DOM SAMOPOMOCY|INOWROCŁAW|UL. ŚW. DUCHA 90 |88-100 INOWROCŁAW;1243;528;528;12;516;42.48;2.27
85892;040701;ZESPÓŁ SZKÓŁ OGÓLNOKSZTAŁCĄCYCH W INOWROCŁAWIU|INOWROCŁAW|UL. 3 MAJA 11/13 |88-100 INOWROCŁAW;1403;464;464;15;449;33.07;3.23
85893;040701;KUJAWSKIE CENTRUM KULTURY SALA WYSTAW CZASOWYCH|INOWROCŁAW|UL. KASZTELAŃSKA 22 |88-100 INOWROCŁAW;1361;465;465;9;456;34.17;1.94
85894;040701;BIBLIOTEKA MIEJSKA IM. JANA KASPROWICZA|INOWROCŁAW|UL. JANA KILIŃSKIEGO 16 |88-100 INOWROCŁAW;1632;507;507;22;485;31.07;4.34
85895;040701;PRZEDSIĘBIORSTWO GOSPODARKI KOMUNALNEJ i MIESZKANIOWEJ SP. Z O. O. UL. KS. PIOTRA WAWRZYNIAKA 33|INOWROCŁAW|UL. KS. PIOTRA WAWRZYNIAKA 33 |88-100 INOWROCŁAW;1309;606;606;12;594;46.29;1.98
85896;040701;PRZEDSIĘBIORSTWO GOSPODARKI KOMUNALNEJ I MIESZKANIOWEJ SP. ZO.O|INOWROCŁAW|UL. KS. PIOTRA WAWRZYNIAKA 33 |88-100 INOWROCŁAW;1144;355;355;14;341;31.03;3.94
85897;040701;PRZEDSZKOLE NR 14 "MUZYCZNA KRAINA"|INOWROCŁAW|UL. ŚW. DUCHA 86 |88-100 INOWROCŁAW;1347;642;642;28;614;47.66;4.36
85898;040701;MIEJSKI OŚRODEK POMOCY SPOŁECZNEJ|INOWROCŁAW|UL. ŚW. DUCHA 90 |88-100 INOWROCŁAW;1490;770;770;17;753;51.68;2.21
85899;040701;ADMINISTRACJA OSIEDLA PIASTOWSKIEGO KUJAWSKIEJ SPÓŁDZIELNI MIESZKANIOWEJ|INOWROCŁAW|UL. BOLESŁAWA KRZYWOUSTEGO 23 |88-100 INOWROCŁAW;1822;900;900;22;878;49.40;2.44
85900;040701;GIMNAZJUM NR 3 IM. 4 KUJAWSKIEGO PUŁKU ARTYLERII LEKKIEJ|INOWROCŁAW|UL. WŁADYSŁAWA ŁOKIETKA 3 |88-100 INOWROCŁAW;1305;595;595;9;586;45.59;1.51
85901;040701;GIMNAZJUM NR 3 IM. 4 KUJAWSKIEGO PUŁKU ARTYLERII LEKKIEJ|INOWROCŁAW|UL. WŁADYSŁAWA ŁOKIETKA 3 |88-100 INOWROCŁAW;1325;639;639;26;613;48.23;4.07
85902;040701;PRZEDSZKOLE NIEPUBLICZNE "POD TĘCZĄ"|INOWROCŁAW|UL. WŁADYSŁAWA ŁOKIETKA 2 |88-100 INOWROCŁAW;1222;608;608;18;590;49.75;2.96
85903;040701;DRUKARNIA POZKAL SPÓŁKA Z O.O. SPÓŁKA KOMANDYTOWA|INOWROCŁAW|UL. CEGIELNA 10/12 |88-100 INOWROCŁAW;1164;558;558;21;537;47.94;3.76
85904;040701;SZKOŁA PODSTAWOWA NR 11 IM. STEFANA BATOREGO|INOWROCŁAW|UL. JANA III SOBIESKIEGO 5/7 |88-100 INOWROCŁAW;1732;1026;1026;23;1003;59.24;2.24
85905;040701;SZKOŁA PODSTAWOWA NR 11 IM. STEFANA BATOREGO|INOWROCŁAW|UL. JANA III SOBIESKIEGO 5/7 |88-100 INOWROCŁAW;1779;1043;1043;13;1030;58.63;1.25
85906;040701;SZKOŁA PODSTAWOWA NR 10 IM. JANA KASPROWICZA|INOWROCŁAW|UL. STANISŁAWA PRZYBYSZEWSKIEGO 119 |88-100 INOWROCŁAW;734;375;375;6;369;51.09;1.60
85907;040701;ZESPÓŁ SZKÓŁ PONADGIMNAZJALNYCH NR 1 IM. JANA PAWŁA II|INOWROCŁAW|UL. POZNAŃSKA 345 |88-100 INOWROCŁAW;1467;567;567;24;543;38.65;4.23
85908;040701;SZKOŁA PODSTAWOWA NR 9 IM. MARII SKŁODOWSKIEJ-CURIE|INOWROCŁAW|UL. CHEMICZNA 9 |88-100 INOWROCŁAW;1105;508;508;15;493;45.97;2.95
85909;040701;GIMNAZJUM NR 4 Z ODZIAŁAMI DWUJĘZYCZNYMI IM. ZYGMUNTA WILKOŃSKIEGO|INOWROCŁAW|UL. IGNACEGO DASZYŃSKIEGO 29 |88-100 INOWROCŁAW;1252;573;573;12;561;45.77;2.09
85910;040701;GIMNAZJUM NR 4 Z ODDZIAŁAMI DWUJĘZYCZNYMI IM. ZYGMUNTA WILKOŃSKIEGO|INOWROCŁAW|UL. IGNACEGO DASZYŃSKIEGO 29 |88-100 INOWROCŁAW;1435;738;738;22;716;51.43;2.98
85911;040701;KUJAWSKA SPÓŁDZIELNIA MIESZKANIOWA|INOWROCŁAW|UL. ALEJE MIKOŁAJA KOPERNIKA 7 |88-100 INOWROCŁAW;1857;845;845;38;807;45.50;4.50
85912;040701;ZESPÓŁ SZKÓŁ IM. MARKA KOTAŃSKIEGO|INOWROCŁAW|UL. SOLANKOWA 21 |88-100 INOWROCŁAW;1059;513;513;11;502;48.44;2.14
85913;040701;FILIA NR 1 BIBLIOTEKI MIEJSKIEJ IM. JANA KASPROWICZA|INOWROCŁAW|UL. ZYGMUNTA WILKOŃSKIEGO 32 |88-100 INOWROCŁAW;1160;667;667;8;659;57.50;1.20
85914;040701;ZESPÓŁ SZKÓŁ INTEGRACYJNYCH IM. POWSTAŃCÓW WIELKOPOLSKICH|INOWROCŁAW|UL. JÓZEFA KRZYMIŃSKIEGO 4 |88-100 INOWROCŁAW;1270;732;732;16;716;57.64;2.19
85915;040701;ZESPÓŁ SZKÓŁ INTEGRACYJNYCH IM. POWSTAŃCÓW WIELKOPOLSKIECH|INOWROCŁAW|UL. JÓZEFA KRZYMIŃSKIEGO 4 |88-100 INOWROCŁAW;1313;632;632;13;619;48.13;2.06
85916;040701;ZESPÓŁ SZKÓŁ PONADGIMNAZJALNYCH NR 4|INOWROCŁAW|UL. JÓZEFA KRZYMIŃSKIEGO 8 |88-100 INOWROCŁAW;726;394;394;2;392;54.27;0.51
85917;040701;SZKOŁA PODSTAWOWA NR 4 IM. JANUSZA KUSOCIŃSKIEGO|INOWROCŁAW|UL. JANUSZA KUSOCIŃSKIEGO 24 |88-100 INOWROCŁAW;799;390;390;13;377;48.81;3.33
85918;040701;POLSKIE TOWARZYSTWO EKONOMICZNE ODDZIAŁ W BYDGOSZCZY OŚRODEK WSPIERANIA PRZEDSIĘBIORCZOŚCI FUNDUSZ ROZWOJU PRZEDSIĘBIORCZOŚCI W INOWROCŁAWIU|INOWROCŁAW|UL. POZNAŃSKA 185 |88-100 INOWROCŁAW;1001;647;647;10;637;64.64;1.55
85919;040701;SZKOŁA PODSTAWOWA NR 4 IM. JANUSZA KUSOCIŃSKIEGO|INOWROCŁAW|UL. JANUSZA KUSOCIŃSKIEGO 24 |88-100 INOWROCŁAW;1097;663;663;8;655;60.44;1.21
85920;040701;PRZEDSZKOLE NR 4 Z ODDZIAŁAMI INTEGRACYJNYMI "SŁONECZKO"|INOWROCŁAW|UL. JANUSZA KUSOCIŃSKIEGO 11 |88-100 INOWROCŁAW;1349;714;714;24;690;52.93;3.36
85921;040701;SZKOŁA PODSTAWOWA NR 4 IM. JANUSZA KUSOCIŃSKIEGO|INOWROCŁAW|UL. SZARYCH SZEREGÓW 1 |88-100 INOWROCŁAW;1207;642;642;15;627;53.19;2.34
85922;040701;SZKOŁA PODSTAWOWA NR 4 IM. JANUSZA KUSOCIŃSKIEGO|INOWROCŁAW|UL. SZARYCH SZEREGÓW 1 |88-100 INOWROCŁAW;1210;653;653;15;638;53.97;2.30
85923;040701;GIMNAZJUM NR 2 IM. DRA JÓZEFA KRZYMIŃSKIEGO|INOWROCŁAW|UL. STANISŁAWA KIEŁBASIEWICZA 7 |88-100 INOWROCŁAW;1381;750;750;10;740;54.31;1.33
85924;040701;GIMNAZJUM NR 2 IM. DRA JÓZEFA KRZYMIŃSKIEGO|INOWROCŁAW|UL. STANISŁAWA KIEŁBASIEWICZA 7 |88-100 INOWROCŁAW;1158;618;618;13;605;53.37;2.10
85925;040701;PRZEDSZKOLE NR 20 "KUJAWSKIE DZIECI"|INOWROCŁAW|UL. IWANA ALEJNIKA 13 |88-100 INOWROCŁAW;1378;734;734;24;710;53.27;3.27
85926;040701;WARSZTAT TERAPII ZAJĘCIOWEJ PRZY STOWARZYSZENIU POMOCY UPOŚLEDZONYM UMYSŁOWO|INOWROCŁAW|UL. EMILII PLATER 3 |88-100 INOWROCŁAW;1911;974;974;21;953;50.97;2.16
85927;040701;GIMNAZJUM NR 2 IM. DRA JÓZEFA KRZYMIŃSKIEGO|Inowrocław|ul. STANISŁAWA KIEŁBASIEWICZA 7 |88-100 INOWROCŁAW;1500;775;775;21;754;51.67;2.71
85928;040701;WARSZTAT TERAPII ZAJĘCIOWEJ PRZY STOWARZYSZENIU POMOCY UPOŚLEDZONYM UMYSŁOWO|Inowrocław|ul. EMILII PLATER 3 |88-100 INOWROCŁAW;1525;796;796;21;775;52.20;2.64
85929;040701;PRZEDSZKOLE NR 20 "KUJAWSKIE DZIECI"|Inowrocław|UL. WOJSKA POLSKIEGO 13a |88-100 INOWROCŁAW;1271;701;701;23;678;55.15;3.28
85930;040701;ZAKŁAD ROBÓT PUBLICZNYCH|Inowrocław|MARSZAŁKA JÓZEFA PIŁSUDSKIEGO 15 |88-100 INOWROCŁAW;1335;610;610;20;590;45.69;3.28
85931;040701;DOM POMOCY SPOŁECZNEJ W INOWROCŁAWIU|INOWROCŁAW|MACIEJA WIERZBIŃSKIEGO 49 |88-100 INOWROCŁAW;81;32;32;8;24;39.51;25.00
85932;040701;SZPITAL WIELOSPECJALISTYCZNY IM. DR. LUDWIKA BŁAŻKA W INOWROCŁAWIU|INOWROCŁAW|POZNAŃSKA 97 |88-100 INOWROCŁAW;260;59;59;2;57;22.69;3.39
85933;040701;ZAKŁAD KARNY W INOWROCŁAWIU|INOWROCŁAW|PREZYDENTA GABRIELA NARUTOWICZA 46 |88-100 INOWROCŁAW;323;94;94;8;86;29.10;8.51
85934;040701;"SOLANKI" UZDROWISKO INOWROCŁAW SPÓŁKA Z O.O., W SKŁAD KTÓREGO WCHODZĄ: ZESPÓŁ SANATORYJNO-SZPITALNY "KUJAWIAK", SANATORIUM "AS", SANATORIUM "OSTOJA", SANATORIUM "KUJAWIANKA", Z SIEDZIBĄ W ZESPOLE SANATORYJNO-SZPITALNYM "KUJAWIAK"|INOWROCŁAW|ZYGMUNTA WILKOŃSKIEGO 23 |88-100 INOWROCŁAW;747;548;548;12;536;73.36;2.19
85935;040701;SANATORIUM UZDROWISKOWE OŚRODEK REHABILITACJI I ODNOWY BIOLOGICZNEJ "OAZA" SPÓŁKA Z O.O. W INOWROCŁAWIU|INOWROCŁAW|ŚWIĘTOKRZYSKA 76 |88-100 INOWROCŁAW;182;154;154;1;153;84.62;0.65
85936;040701;SANATORIUM UZDROWISKOWE "PRZY TĘŻNI" IM. DR. JÓZEFA KRZYMIŃSKIEGO W INOWROCŁAWIU SAMODZIELNY PUBLICZNY ZAKŁAD OPIEKI ZDROWOTNEJ|INOWROCŁAW|PRZY STAWKU 12 |88-100 INOWROCŁAW;407;334;334;7;327;82.06;2.10
85937;040701;SANATORIUM UZDROWISKOWE "MODRZEW" W INOWROCŁAWIU|INOWROCŁAW|MACIEJA WIERZBIŃSKIEGO 50a |88-100 INOWROCŁAW;198;175;175;4;171;88.38;2.29
85938;040702;GMINNY OŚRODEK KULTURY, SPORTU I REKREACJI|DĄBROWA BISKUPIA|DŁUGA 48 |88-133 DĄBROWA BISKUPIA;805;302;302;12;290;37.52;3.97
85939;040702;SZKOŁA PODSTAWOWA|PIERANIE| 7 |88-133 DĄBROWA BISKUPIA;951;276;276;12;264;29.02;4.35
85940;040702;ŚWIETLICA WIEJSKA|CHLEWISKA| 19 |88-133 DĄBROWA BISKUPIA;563;172;172;13;159;30.55;7.56
85941;040702;SZKOŁA PODSTAWOWA|OŚNISZCZEWKO| 1 |88-133 DĄBROWA BISKUPIA;486;152;152;10;142;31.28;6.58
85942;040702;SZKOŁA PODSTAWOWA|OŚNISZCZEWKO| 1 |88-133 DĄBROWA BISKUPIA;543;176;176;4;172;32.41;2.27
85943;040702;SZKOŁA PODSTAWOWA|PARCHANIE| 38 |88-110 INOWROCŁAW 2;671;252;252;8;244;37.56;3.17
85944;040702;DOM POMOCY SPOŁECZNEJ|Parchanie| 9 |88-110 Inowrocław 2;48;37;37;2;35;77.08;5.41
85945;040703;Samorządowe Przedszkole|GNIEWKOWO|ul.St.Moniuszki 2 |88-140 GNIEWKOWO;1012;471;471;11;460;46.54;2.34
85946;040703;Urząd Stanu Cywilnego|GNIEWKOWO|ul. Dworcowa 17 |88-140 GNIEWKOWO;924;428;428;10;418;46.32;2.34
85947;040703;Gimnazjum Nr 1|GNIEWKOWO|ul.Dworcowa 11 |88-140 GNIEWKOWO;661;253;253;7;246;38.28;2.77
85948;040703;Szkoła Podstawowa Nr 1|GNIEWKOWO|ul.Toruńska 40 |88-140 GNIEWKOWO;848;397;397;10;387;46.82;2.52
85949;040703;Łącznica Kulturalna|Gniewkowo|ul.Dworcowa 5 |88-140 GNIEWKOWO;1044;360;360;10;350;34.48;2.78
85950;040703;Szkoła Zawodowa|Gniewkowo|ul.Powstańców Wlkp 5 |88-140 GNIEWKOWO;888;464;464;9;455;52.25;1.94
85951;040703;Muzeum Regionalne|Gniewkowo|ul.Podgórna 2 |88-140 GNIEWKOWO;744;227;227;17;210;30.51;7.49
85952;040703;Szkoła Podstawowa|Wierzchosławice| 19 |88-140 GNIEWKOWO;941;351;351;23;328;37.30;6.55
85953;040703;Szkoła Podstawowa|Szadłowice| 36 |88-140 GNIEWKOWO;706;235;235;10;225;33.29;4.26
85954;040703;Niepubliczna Szkoła Podstawowa|Gąski| 19 |88-140 GNIEWKOWO;694;270;270;15;255;38.90;5.56
85955;040703;Świetlica wiejska|Ostrowo| 24a |88-140 GNIEWKOWO;689;220;220;13;207;31.93;5.91
85956;040703;Świetlica wiejska|Suchatówka| 24A |88-140 GNIEWKOWO;694;276;276;8;268;39.77;2.90
85957;040703;Szkoła Podstawowa|Kijewo| 40 |88-140 GNIEWKOWO;709;244;244;11;233;34.41;4.51
85958;040703;Szkoła Podstawowa|Murzynno| 51 |88-140 Gniewkowo;803;284;284;11;273;35.37;3.87
85959;040703;Dom Pomocy Społecznej|Warzyn| 1 |88-140 Gniewkowo;52;25;25;5;20;48.08;20.00
85960;040704;Szkoła Podstawowa w Tupadłach|Tupadły| 95 |88-101 Inowrocław;618;293;293;12;281;47.41;4.10
85961;040704;Świetlica w Orłowie|Orłowo| 128 |88-100 Inowrocław;1310;500;500;15;485;38.17;3.00
85962;040704;Świetlica w Sławęcinku|Sławęcinek| 101 |88-100 Inowrocław;1303;454;454;16;438;34.84;3.52
85963;040704;Budynek komunalny pn."Dom Kultury w Górze"|Góra| 44 |88-100 Inowrocław;710;273;273;15;258;38.45;5.49
85964;040704;Świetlica w Jacewie|Jacewo| 61 |88-100 Inowrocław;512;302;302;5;297;58.98;1.66
85965;040704;Świetlica w Jaksicach|Jaksice|Dworcowa 10 |88-181 Jaksice;1568;602;602;25;577;38.39;4.15
85966;040704;Świetlica w Komaszycach|Komaszyce| 13 |88-100 Inowrocław;672;288;288;8;280;42.86;2.78
85967;040704;Świetlica w Kruszy Podlotowej|Krusza Podlotowa| 30 |88-100 Inowrocław;660;292;292;9;283;44.24;3.08
85968;040704;Budynek komunalny pn."Dom Kultury i Rekreacji w Łojewie"|Łojewo| 34A |88-100 Inowrocław;406;146;146;13;133;35.96;8.90
85969;040704;Szkoła Podstawowa w Turzanach|Turzany| 6 |88-100 Inowrocław;938;418;418;22;396;44.56;5.26
85970;040704;Świetlica w Miechowicach|Miechowice| 34 |88-100 Inowrocław;615;288;288;9;279;46.83;3.12
85971;040705;SZKOŁA PODSTAWOWA|JANIKOWO|UL. SZKOLNA 1 |88-160 JANIKOWO;786;326;326;15;311;41.48;4.60
85972;040705;MIEJSKO-GMINNY OŚRODEK KULTURY|JANIKOWO|UL. PRZEMYSŁOWA 26 |88-160 JANIKOWO;1368;638;638;17;621;46.64;2.66
85973;040705;GIMNAZJUM|JANIKOWO|UL. GŁÓWNA 6 |88-160 JANIKOWO;1415;539;539;33;506;38.09;6.12
85974;040705;PRZEDSZKOLE|JANIKOWO|UL. SŁONECZNA 31 |88-160 JANIKOWO;653;314;314;15;299;48.09;4.78
85975;040705;KLUB KUJAWSKIEJ SPÓŁDZIELNI MIESZKANIOWEJ|JANIKOWO|UL. DWORCOWA 1 |88-160 JANIKOWO;1575;692;692;16;676;43.94;2.31
85976;040705;SZKOŁA PODSTAWOWA|JANIKOWO|UL. BISKUPA MICHAŁA KOZALA 3 |88-160 JANIKOWO;1628;774;774;16;758;47.54;2.07
85977;040705;SZKOŁA PODSTAWOWA|BRONIEWICE| 3 |88-160 JANIKOWO;649;242;242;14;228;37.29;5.79
85978;040705;SZKOŁA PODSTAWOWA|KOŁODZIEJEWO|UL. SZKOLNA 10 |88-160 JANIKOWO;1434;586;586;31;555;40.86;5.29
85979;040705;SZKOŁA PODSTAWOWA|LUDZISKO| 10 |88-160 JANIKOWO;1329;461;461;16;445;34.69;3.47
85980;040705;Dom Pomocy Społecznej|Ludzisko| 78 |88-160 JANIKOWO;50;27;27;9;18;54.00;33.33
85981;040706;ZESPÓŁ SZKÓŁ OGÓLNOKSZTAŁCĄCYCH W KRUSZWICY|KRUSZWICA|UL. KASPROWICZA 7 |88-150 KRUSZWICA;847;380;380;18;362;44.86;4.74
85982;040706;ŚRODOWISKOWY DOM SAMOPOMOCY W KRUSZWICY|KRUSZWICA|UL. RYNEK 22 |88-150 KRUSZWICA;890;354;354;20;334;39.78;5.65
85983;040706;PRZEDSZKOLE NR 1 W KRUSZWICY|KRUSZWICA|UL. KOLEGIACKA 13 |88-153 KRUSZWICA;1166;550;550;16;534;47.17;2.91
85984;040706;SZKOŁA PODSTAWOWA NR 1 W KRUSZWICY|KRUSZWICA|UL. KUJAWSKA 22 |88-153 KRUSZWICA;1218;579;579;10;569;47.54;1.73
85985;040706;DOM SOCJALNO-KULTURALNY W KRUSZWICY|KRUSZWICA|UL. NADGOPLAŃSKA 8 |88-153 KRUSZWICA;1125;516;516;12;504;45.87;2.33
85986;040706;NIEPUBLICZNA SZKOŁA PODSTAWOWA W RACICACH|RACICE| 16 |88-150 KRUSZWICA;413;170;170;12;158;41.16;7.06
85987;040706;SZKOŁA PODSTAWOWA w CHEŁMCACH|CHEŁMCE| 50 |88-121 CHEŁMCE;601;252;252;18;234;41.93;7.14
85988;040706;REMIZA OSP W WITOWICACH|WITOWICE| 27 |88-121 CHEŁMCE;594;202;202;8;194;34.01;3.96
85989;040706;ŚWIETLICA WIEJSKA W JANOCINIE|JANOCIN| 19 |88-121 CHEŁMCE;527;189;189;6;183;35.86;3.17
85990;040706;SZKOŁA PODSTAWOWA W POLANOWICACH|POLANOWICE| 27 |88-150 KRUSZWICA;660;206;206;8;198;31.21;3.88
85991;040706;GIMNAZJUM NR 3 W BACHORCACH|BACHORCE| 42 |88-153 KRUSZWICA;584;188;188;9;179;32.19;4.79
85992;040706;ŚWIETLICA WIEJSKA W SUKOWACH|SUKOWY| 93 |88-150 KRUSZWICA;630;255;255;22;233;40.48;8.63
85993;040706;ŚWIETLICA WIEJSKA W SZARLEJU|SZARLEJ| |88-150 KRUSZWICA;394;106;106;5;101;26.90;4.72
85994;040706;ŚWIETLICA WIEJSKA W OSTROWIE|OSTROWO| 41 |88-121 CHEŁMCE;434;162;162;3;159;37.33;1.85
85995;040706;SZKOŁA PODSTAWOWA W WOLI WAPOWSKIEJ|WOLA WAPOWSKA| 6 |88-153 KRUSZWICA;804;218;218;17;201;27.11;7.80
85996;040706;SZKOŁA PODSTAWOWA W SŁAWSKU WIELKIM|SŁAWSK WIELKI| 77 |88-150 KRUSZWICA;722;284;284;10;274;39.34;3.52
85997;040706;ŚWIETLICA WIEJSKA W KOBYLNIKACH|KOBYLNIKI| 26A |88-150 KRUSZWICA;632;272;272;11;261;43.04;4.04
85998;040706;CENTRUM KULTURY I SPORTU "ZIEMOWIT" W KRUSZWICY|KRUSZWICA|UL. POZNAŃSKA 17 |88-150 KRUSZWICA;441;126;126;4;122;28.57;3.17
85999;040706;ZESPÓŁ SZKÓŁ PONADGIMNAZJALNYCH W KRUSZWICY|KRUSZWICA|UL. KUJAWSKA 20 |88-153 KRUSZWICA;582;289;289;10;279;49.66;3.46
86000;040706;ZESPÓŁ SZKÓŁ OGÓLNOKSZTAŁCĄCYCH W KRUSZWICY|KRUSZWICA|UL. KASPROWICZA 7 |88-150 KRUSZWICA;881;383;383;21;362;43.47;5.48
86001;040706;GIMNAZJUM NR 1 W KRUSZWICY|KRUSZWICA|UL. KUJAWSKA 22 |88-153 KRUSZWICA;1128;523;523;12;511;46.37;2.29
86002;040706;ŚWIETLICA WIEJSKA W GOCANOWIE|GOCANOWO| 10 |88-153 KRUSZWICA;464;156;156;6;150;33.62;3.85
86003;040707;KLUB "JUBILAT"|PAKOŚĆ|UL. MOGILEŃSKA 21A |88-170 PAKOŚĆ;1268;615;615;24;591;48.50;3.90
86004;040707;OŚRODEK KULTURY I TURYSTYKI|PAKOŚĆ|UL. ŚW. JANA 12 |88-170 PAKOŚĆ;944;491;491;15;476;52.01;3.05
86005;040707;OŚRODEK POMOCY SPOŁECZNEJ|PAKOŚĆ|UL. INOWROCŁAWSKA 14 |88-170 PAKOŚĆ;1140;392;392;17;375;34.39;4.34
86006;040707;GIMNAZJUM|PAKOŚĆ|UL. SZKOLNA 44 |88-170 PAKOŚĆ;839;294;294;16;278;35.04;5.44
86007;040707;SZKOŁA PODSTAWOWA|PAKOŚĆ|UL. BŁONIE 2 |88-170 PAKOŚĆ;246;95;95;4;91;38.62;4.21
86008;040707;SZKOŁA PODSTAWOWA|PAKOŚĆ|BŁONIE 2 |88-170 PAKOŚĆ;330;104;104;3;101;31.52;2.88
86009;040707;CENTRUM INFORMACJI TURYSTYCZNEJ|PAKOŚĆ|BARCIŃSKA 11 |88-170 PAKOŚĆ;1046;463;463;14;449;44.26;3.02
86010;040707;ZESPÓŁ PLACÓWEK OŚWIATOWYCH|KOŚCIELEC| 14 |88-170 PAKOŚĆ;1138;453;453;14;439;39.81;3.09
86011;040707;ŚWIETLICA WIEJSKA|RYCERZEWO| |88-170 PAKOŚĆ;209;91;91;5;86;43.54;5.49
86012;040707;ŚWIETLICA WIEJSKA|WIELOWIEŚ| |88-170 PAKOŚĆ;323;139;139;5;134;43.03;3.60
86013;040707;ŚWIETLICA WIEJSKA|RADŁOWO| |88-170 PAKOŚĆ;439;147;147;8;139;33.49;5.44
86014;040708;ZESPÓŁ SZKÓŁ ROJEWO SZKOŁA PODSTAWOWA ROJEWO|Rojewo| 105 |88-111 ROJEWO;494;263;263;17;246;53.24;6.46
86015;040708;SZKOŁA PODSTAWOWA IMIENIA BŁOGOSŁAWIONEGO KSIĘDZA MARIANA SKRZYPCZAKA|Rojewice| 19 |88-111 ROJEWO;585;195;195;12;183;33.33;6.15
86016;040708;ZESPÓŁ SZKÓŁ ROJEWO SZKOŁA PODSTAWOWA ROJEWO -FILIA LISZKOWO|Liszkowo| 82A |88-180 ZŁOTNIKI KUJAWSKIE;532;210;210;10;200;39.47;4.76
86017;040708;ŚWIETLICA WIEJSKA|Płonkowo| 29 |88-111 ROJEWO;523;242;242;9;233;46.27;3.72
86018;040708;ZESPÓŁ SZKÓŁ ROJEWO SZKOŁA PODSTAWOWA ROJEWO-FILIA ŚCIBORZE|Ściborze| 7A |88-111 ROJEWO;595;249;249;18;231;41.85;7.23
86019;040708;ZESPÓŁ SZKÓŁ ROJEWO SZKOŁA PODSTAWOWA ROJEWO-FILIA LISZKOWO|Liszkowo| 82A |88-180 ZŁOTNIKI KUJAWSKIE;456;144;144;10;134;31.58;6.94
86020;040708;BUDYNEK SOCJALNY ROLNICZEJ SPÓŁDZIELNI PRODUKCYJNEJ"NOWOŚĆ"|JEZUICKA STRUGA| 16 |88-111 ROJEWO;530;185;185;17;168;34.91;9.19
86021;040709;GIMNAZJUM im. KAROLA URBAŃSKIEGO|ZŁOTNIKI KUJAWSKIE|POWSTAŃCÓW WIELKOPOLSKICH 1 |88-180 ZŁOTNIKI KUJAWSKIE;1467;695;695;22;673;47.38;3.17
86022;040709;ZESPÓŁ PLACÓWEK OŚWIATOWYCH|TUCZNO|PAKOSKA 32 |88-180 ZŁOTNIKI KUJAWSKIE;1378;517;517;46;471;37.52;8.90
86023;040709;ŚWIETLICA WIEJSKA|GNIEWKÓWIEC| 25 A |88-180 ZŁOTNIKI KUJAWSKIE;568;228;228;5;223;40.14;2.19
86024;040709;ŚWIETLICA WIEJSKA|RUCEWO| 37 |88-180 ZŁOTNIKI KUJAWSKIE;460;168;168;8;160;36.52;4.76
86025;040709;ŚWIETLICA WIEJSKA|JORDANOWO| 33 10|88-180 ZŁOTNIKI KUJAWSKIE;506;139;139;11;128;27.47;7.91
86026;040709;SZKOŁA PODSTAWOWA IM.KARDYNAŁA STEFANA WYSZYŃSKIEGO STOWARZYSZENIA PRZYJACIÓŁ SZKÓŁ KATOLICKICH|LISEWO KOŚCIELNE| 33 |88-180 ZŁOTNIKI KUJAWSKIE;501;219;219;4;215;43.71;1.83
86027;040709;ŚWIETLICA WIEJSKA|NISZCZEWICE| 17 1|88-180 ZŁOTNIKI KUJAWSKIE;529;172;172;7;165;32.51;4.07
86028;040709;ŚWIETLICA WIEJSKA|PALCZYN| 6 |86-060 NOWA WIEŚ WIELKA;666;196;196;15;181;29.43;7.65
86029;040709;BIURO DZIERŻAWCY GRUNTÓW AGENCJI NIERUCHOMOŚCI ROLNYCH SKARBU PAŃSTWA|BĘDZITOWO| 24 |88-180 ZŁOTNIKI KUJAWSKIE;326;99;99;5;94;30.37;5.05
86030;040709;GIMNAZJUM im. KAROLA URBAŃSKIEGO|ZŁOTNIKI KUJAWSKIE|POWSTAŃCÓW WIELKOPOLSKICH 1 |88-180 ZŁOTNIKI KUJAWSKIE;966;440;440;23;417;45.55;5.23
86031;040801;Szkoła Podstawowa Nr 2|Lipno|ul.Okrzei 1 |87-600 Lipno;1672;659;659;28;631;39.41;4.25
86032;040801;Publiczne Gimnazjum Nr 1|Lipno|ul.Szkolna 2 |87-600 Lipno;1533;591;591;22;569;38.55;3.72
86033;040801;Miejskie Centrum Kulturalne|Lipno|ul. Piłsudskiego 22 |87-600 Lipno;1446;599;599;23;576;41.42;3.84
86034;040801;Szkoła Podstawowa Nr 5|Lipno|Plac 11 Listopada 13 |87-600 Lipno;1312;549;549;23;526;41.84;4.19
86035;040801;Miejski Ośrodek Pomocy Społecznej|Lipno|Włocławska 16a |87-600 Lipno;780;408;408;11;397;52.31;2.70
86036;040801;Miejski Ośrodek Pomocy Społecznej|Lipno|ul.Włocławska 16a |87-600 Lipno;1241;534;534;12;522;43.03;2.25
86037;040801;Szkoła Podstawowa Nr 3|Lipno|ul. R.Traugutta 2 |87-600 Lipno;1526;612;612;25;587;40.10;4.08
86038;040801;Zespół Szkół im. Romualda Traugutta|Lipno|ul. R.Traugutta 1 |87-600 Lipno;1004;516;516;15;501;51.39;2.91
86039;040801;Przedszkole Miejskie Nr 4|Lipno|ul.Kazimierza Różyckiego 4 |87-600 Lipno;845;428;428;9;419;50.65;2.10
86040;040801;Szpital Lipno|Lipno|Nieszawska 6 |87-600 Lipno;98;57;57;5;52;58.16;8.77
86041;040802;Gimnazjum im. Ziemi Dobrzyńskiej w Bobrownikach|Bobrowniki|ul.Kościelna 5 |87-617 Bobrowniki;692;383;383;25;358;55.35;6.53
86042;040802;Gimnazjum im. Ziemi Dobrzyńskiej w Bobrownikach|Bobrowniki|Kościelna 5 |87-617 Bobrowniki;491;249;249;19;230;50.71;7.63
86043;040802;Gimnazjum im. Ziemi Dobrzyńskiej w Bobrownikach|Bobrowniki|Kościelna 5 |87-617 Bobrowniki;656;242;242;14;228;36.89;5.79
86044;040802;Świetlica sołecka w Gnojnie|Gnojno| 24A |87-617 Bobrowniki;311;102;102;6;96;32.80;5.88
86045;040802;Szkoła Podstawowa w Rachcinie|Rachcin| 8a |87-617 Bobrowniki;315;83;83;2;81;26.35;2.41
86046;040803;Sala posiedzeń Urzędu Gminy w Chrostkowie|Chrostkowo| 99 |87-602 Chrostkowo;601;226;226;11;215;37.60;4.87
86047;040803;Szkoła Podstawowa w Stalmierzu|Stalmierz| 70 |87-602 Chrostkowo;798;262;262;14;248;32.83;5.34
86048;040803;Świetlica Wiejska w Makówcu|Makówiec| 35 |87-602 Chrostkowo;513;176;176;11;165;34.31;6.25
86049;040803;Zespół Szkół w Chrostkowie|Chrostkowo| 80 |87-602 Chrostkowo;510;167;167;13;154;32.75;7.78
86050;040804;Dobrzyńskie Centrum Sportu i Turystyki|Dobrzyń nad Wisłą|Licealna 1A |87-610 Dobrzyń nad Wisłą;918;331;331;28;303;36.06;8.46
86051;040804;Dobrzyńskie Centrum Sportu i Turystyki|Dobrzyń nad Wisłą|Licealna 1A |87-610 Dobrzyń nad Wisłą;933;443;443;20;423;47.48;4.51
86052;040804;Dobrzyńskie Centrum Sportu i Turystyki|Dobrzyń nad Wisłą|Licealna 1A |87-610 Dobrzyń nad Wisłą;814;275;275;7;268;33.78;2.55
86053;040804;Publiczne Gimnazjum w Chalinie|Chalin| 36 |87-610 Dobrzyń nad Wisłą;458;170;170;16;154;37.12;9.41
86054;040804;Szkoła Podstawowa w Dyblinie|Dyblin| 1 |87-610 Dobrzyń nad Wisłą;781;231;231;20;211;29.58;8.66
86055;040804;Remiza OSP w Grochowalsku|Grochowalsk| 35 |87-610 Dobrzyń nad Wisłą;776;275;275;20;255;35.44;7.27
86056;040804;Świetlica w Kamienicy|Michałkowo| |87-610 Dobrzyń nad Wisłą;374;142;142;4;138;37.97;2.82
86057;040804;Remiza OSP w Krojczynie|Krojczyn| 70 |87-610 Dobrzyń nad Wisłą;387;129;129;6;123;33.33;4.65
86058;040804;Remiza OSP w Mokowie|Mokowo| 24 |87-610 Dobrzyń nad Wisłą;439;149;149;13;136;33.94;8.72
86059;040804;Remiza OSP w Płomianach|Płomiany| 20A |87-610 Dobrzyń nad Wisłą;446;115;115;11;104;25.78;9.57
86060;040805;Zespół Szkół w Kikole|Kikół|ul.Targowa 6 |87-620 Kikół;775;393;393;17;376;50.71;4.33
86061;040805;Sala Gimnastyczna przy Zespole Szkół w Kikole|Kikół|Targowa 6 |87-620 Kikół;1026;530;530;33;497;51.66;6.23
86062;040805;Świetlica Wiejska w Grodzeniu|Grodzeń| |87-620 Kikół;773;291;291;13;278;37.65;4.47
86063;040805;Szkoła Podstawowa w Zajeziorzu|Zajeziorze| |87-620 Kikół;785;251;251;22;229;31.97;8.76
86064;040805;Szkoła Podstawowa w Woli|Wola| |87-620 Kikół;1420;499;499;15;484;35.14;3.01
86065;040805;Świetlica Wiejska w Kikole|Kikół|Targowa 1A |87-620 Kikół;929;324;324;35;289;34.88;10.80
86066;040806;Biblioteka Publiczna Gminy Lipno Filia Nr 1 w Jastrzębiu|Jastrzębie| 2A |87-600 Lipno;1300;512;512;20;492;39.38;3.91
86067;040806;Wiejski Dom Kultury w Trzebiegoszczu|Trzebiegoszcz| 27A |87-600 Lipno;453;185;185;11;174;40.84;5.95
86068;040806;Zespoł Szkół w Karnkowie|Karnkowo| 42 |87-600 Lipno;1239;448;448;20;428;36.16;4.46
86069;040806;Remiza Ochotniczej Straży Pożarnej w Wierzbicku|Wierzbick| 54 |87-600 Lipno;626;223;223;19;204;35.62;8.52
86070;040806;Zespół Szkół w Radomicach|Radomice| 115 |87-600 Lipno;1309;459;459;35;424;35.06;7.63
86071;040806;Ośrodek Kultury Gminy Lipno z/s w Wichowie|Wichowo| 19A |87-600 Lipno;1236;385;385;19;366;31.15;4.94
86072;040806;Świetlica Wiejska w Krzyżówkach|Krzyżówki| 49 |87-600 Lipno;1211;369;369;23;346;30.47;6.23
86073;040806;Szkoła Podstawowa w Maliszewie|Maliszewo| 29 |87-600 Lipno;741;301;301;32;269;40.62;10.63
86074;040806;Świetlica Wiejska w Kłokocku|Kłokock| 29A |87-600 Lipno;1087;398;398;17;381;36.61;4.27
86075;040807;Szkoła Podstawowa w Skępem|Skępe|Al. 1 Maja 89 |87-630 Skępe;1288;558;558;22;536;43.32;3.94
86076;040807;Zespół Szkół w Skępem|Skępe|ul.Wymyślińska 2 |87-630 Skępe;846;402;402;10;392;47.52;2.49
86077;040807;Szkoła Podstawowa w Skępem Filia w Łąkiem|Łąkie| 41 |87-630 Skępe;784;173;173;11;162;22.07;6.36
86078;040807;Remiza OSP w Wólce|Wólka| 126a |87-630 Skępe;717;249;249;11;238;34.73;4.42
86079;040807;Szkoła Podstawowa w Czermnie|Czermno| 19A |87-630 Skępe;447;136;136;8;128;30.43;5.88
86080;040807;Remiza OSP w Hucie|Huta| 13 |87-630 Skępe;338;79;79;1;78;23.37;1.27
86081;040807;Remiza OSP w Wiosce|Wioska| 7 |87-630 Skępe;829;302;302;21;281;36.43;6.95
86082;040807;Remiza OSP w Skępem|Skępe|Dobrzyńska 1 |87-630 Skępe;785;380;380;15;365;48.41;3.95
86083;040808;Gminny Ośrodek Kultury w Tłuchowie|Tłuchowo|Sierpecka 26 |87-605 Tłuchowo;941;475;475;14;461;50.48;2.95
86084;040808;Gimnazjum Publiczne w Tłuchowie|Tłuchowo|Szkolna 3 |87-605 Tłuchowo;775;295;295;12;283;38.06;4.07
86085;040808;Świetlica Wiejska|Jasień| 51 |87-605 Tłuchowo;591;174;174;11;163;29.44;6.32
86086;040808;Szkoła Podstawowa w Mysłakówku|Mysłakówko| 12 |87-605 Tłuchowo;784;260;260;7;253;33.16;2.69
86087;040808;Świetlica Wiejska w Turzy Wilczej|Turza Wilcza| 4a |87-605 Tłuchowo;581;192;192;10;182;33.05;5.21
86088;040809;Centrum Kulturalno-Oświatowo-Rekreacyjne w Czarnem|Czarne| 82 |87-603 Wielgie;688;247;247;15;232;35.90;6.07
86089;040809;Świetlica Zakrzewo|Zakrzewo| 15A |87-606 Chalin;276;91;91;9;82;32.97;9.89
86090;040809;Szkoła Podstawowa im.W. Broniewskiego|Wielgie|ul.Szkolna 5 |87-603 Wielgie;1074;452;452;16;436;42.09;3.54
86091;040809;Szkoła Podstawowa im.M.Kopernika|Zaduszniki| 4 |87-603 Wielgie;933;296;296;7;289;31.73;2.36
86092;040809;Dom Pomocy Społecznej|Nowa Wieś| 1 |87-603 Wielgie;378;137;137;7;130;36.24;5.11
86093;040809;Ośrodek Kultury Gminy Wielgie|Wielgie|Szkolna 5a |87-603 Wielgie;577;197;197;12;185;34.14;6.09
86094;040809;Centrum Kulturalno-Oświatowo-Rekreacyjne w Suradówku|Suradówek| 36 |87-603 Wielgie;316;114;114;3;111;36.08;2.63
86095;040809;Świetlica Wiejska w Witkowie|Witkowo| 51 |87-603 Wielgie;338;125;125;6;119;36.98;4.80
86096;040809;Centrum Kulturalno-Oświatowo-Rekreacyjne w Płonczynie|Płonczyn| 26 |87-600 Chalin;332;96;96;9;87;28.92;9.38
86097;040809;Świetlica Wiejska w Suszewie|Suszewo| 46 |87-600 Lipno;289;97;97;11;86;33.56;11.34
86098;040809;Świetlica Domu Pomocy Społecznej w Nowej Wsi|Nowa Wieś| 1 |87-603 Wielgie;60;48;48;4;44;80.00;8.33
86099;040901;ZESPÓŁ SZKÓŁ W DĄBROWIE|DĄBROWA|SZKOLNA 15 |88-306 DĄBROWA;658;283;283;12;271;43.01;4.24
86100;040901;ZESPÓŁ SZKÓŁ W DĄBROWIE|DĄBROWA|SZKOLNA 15 |88-306 DĄBROWA;522;198;198;12;186;37.93;6.06
86101;040901;SZKOŁA PODSTAWOWA Z ODDZIAŁAMI INTEGRACYJNYMI W PARLINIE|Parlin| 38 |88-306 DĄBROWA;641;183;183;20;163;28.55;10.93
86102;040901;PAŁAC W SŁABOSZEWKU|Słaboszewko| 9 |88-306 DĄBROWA;583;222;222;14;208;38.08;6.31
86103;040901;SZKOŁA PODSTAWOWA W SŁABOSZEWIE|Słaboszewo| 36 |88-306 DĄBROWA;692;239;239;15;224;34.54;6.28
86104;040901;SZKOŁA PODSTAWOWA W SZCZEPANOWIE|Szczepanowo|SZKOLNA 1 |88-306 DĄBROWA;612;247;247;5;242;40.36;2.02
86105;040902;Publiczna Szkoła Podstawowa w Jeziorach Wielkich|Jeziora Wielkie| 104 |88-324 Jeziora Wielkie;699;288;288;8;280;41.20;2.78
86106;040902;Publiczna Szkoła Podstawowa w Jeziorach Wielkich|Jeziora Wielkie| 104 |88-324 Jeziora Wielkie;596;221;221;15;206;37.08;6.79
86107;040902;Publiczna Szkoła Podstawowa w Wójcinie|Wójcin| 59 |88-324 Jeziora Wielkie;889;332;332;19;313;37.35;5.72
86108;040902;Publiczna Szkoła Podstawowa w Wójcinie|Wójcin| 59 |88-324 Jeziora Wielkie;815;238;238;10;228;29.20;4.20
86109;040902;Sala wiejska|Kościeszki| 39 |88-324 Jeziora Wielkie;473;215;215;17;198;45.45;7.91
86110;040902;Publiczna Szkoła Podstawowa w Rzeszynku|Rzeszynek| 37 |88-324 Jeziora Wielkie;453;170;170;9;161;37.53;5.29
86111;040902;Dom Pomocy Społecznej w Siemionkach Siemionki 13|Siemionki| 13 |88-324 Jeziora Wielkie;49;27;27;4;23;55.10;14.81
86112;040903;Gimnazjum w Mogilnie|Mogilno|Powst. Wlkp. 33 |88-300 Mogilno;1085;559;559;10;549;51.52;1.79
86113;040903;Mogileński Dom Kultury w Mogilnie|Mogilno|Rynek 10 |88-300 Mogilno;995;449;449;14;435;45.13;3.12
86114;040903;Szkoła Podstawowa nr 2 w Mogilnie|Mogilno|Sądowa 13 |88-300 Mogilno;792;354;354;7;347;44.70;1.98
86115;040903;KS "Pogoń"|Mogilno|Mickiewicza 42 |88-300 Mogilno;922;434;434;10;424;47.07;2.30
86116;040903;Szkoła Podstawowa nr 2 w Mogilnie|Mogilno|Sądowa 13 |88-300 Mogilno;958;426;426;15;411;44.47;3.52
86117;040903;Szkoła Podstawowa nr 3 w Mogilnie|Mogilno|Piłsudskiego 16 |88-300 Mogilno;912;458;458;13;445;50.22;2.84
86118;040903;Zespół Szkół w Mogilnie|Mogilno|Dworcowa 9 |88-300 Mogilno;983;483;483;15;468;49.14;3.11
86119;040903;Zespół Szkół w Mogilnie|Mogilno|Dworcowa 9 |88-300 Mogilno;1038;476;476;15;461;45.86;3.15
86120;040903;Starostwo Powiatowe w Mogilnie|Mogilno|Ogrodowa 10 |88-300 Mogilno;1151;546;546;14;532;47.44;2.56
86121;040903;Przedszkole nr 3 w Mogilnie|Mogilno|Konopnickiej 15a |88-300 Mogilno;997;487;487;15;472;48.85;3.08
86122;040903;Świetlica Wiejska w Procyniu|Procyń| 41 |88-330 Gębice;850;298;298;9;289;35.06;3.02
86123;040903;Przedszkole w Gębicach|Gębice|Rynek 11 |88-330 Gębice;874;343;343;15;328;39.24;4.37
86124;040903;Szkoła Podstawowa w Gębicach|Marcinkowo| 72 |88-330 Gębice;1049;434;434;23;411;41.37;5.30
86125;040903;Szkoła Podstawowa w Wylatowie|Wylatowo| 88 |88-342 Wylatowo;1016;404;404;24;380;39.76;5.94
86126;040903;Szkoła Podstawowa w Kwieciszewie|Kwieciszewo| 45 |88-321 Kwieciszewo;1069;418;418;20;398;39.10;4.78
86127;040903;Szkoła Podstawowa w Strzelcach|Strzelce| 13 |88-300 Mogilno;727;271;271;15;256;37.28;5.54
86128;040903;Świetlica Wiejska w Dąbrówce|Dąbrówka| |88-300 Mogilno;1097;431;431;21;410;39.29;4.87
86129;040903;Szkoła Podstawowa we Wszedniu|Wszedzień| 7 |88-300 Mogilno;794;349;349;10;339;43.95;2.87
86130;040903;Zespół Szkolno-Przedszkolny w Padniewie|Padniewo| 55 |88-300 Mogilno;860;400;400;11;389;46.51;2.75
86131;040903;Szkoła Podstawowa nr 3 w Mogilnie|Mogilno|Piłsudskiego 16 |88-300 Mogilno;815;356;356;10;346;43.68;2.81
86132;040903;Świetlica Wiejska w Józefowie|Józefowo| |88-300 Mogilno;982;376;376;11;365;38.29;2.93
86133;040903;Szpital Powiatowy w Mogilnie|Mogilno|Kościuszki 6 |88-300 Mogilno;18;4;4;1;3;22.22;25.00
86134;040904;ZESPÓŁ SZKÓŁ W STRZELNIE|STRZELNO|UL. KOŚCIUSZKI 15 |88-320 STRZELNO;1376;700;700;14;686;50.87;2.00
86135;040904;SZKOŁA PODSTAWOWA|STRZELNO|UL.KARDYNAŁA WYSZYŃSKIEGO 2 |88-320 STRZELNO;1102;538;538;31;507;48.82;5.76
86136;040904;GIMNAZJUM|STRZELNO|UL.GIMNAZJALNA 17 |88-320 STRZELNO;1430;612;612;41;571;42.80;6.70
86137;040904;ZESPÓŁ SZKÓŁ W STRZELNIE|STRZELNO|UL.GIMNAZJALNA 7 |88-320 STRZELNO;1167;413;413;22;391;35.39;5.33
86138;040904;SZKOŁA PODSTAWOWA|MARKOWICE| 28 |88-320 STRZELNO;1061;385;385;21;364;36.29;5.45
86139;040904;ŚWIETLICA OCHOTNICZEJ STRAŻY POŻARNEJ|OSTROWO| 18 |88-320 STRZELNO;545;252;252;14;238;46.24;5.56
86140;040904;SZKOŁA PODSTAWOWA|STODOŁY| 25 |88-320 STRZELNO;585;211;211;15;196;36.07;7.11
86141;040904;SZKOŁA PODSTAWOWA|WRONOWY| 28 |88-320 STRZELNO;796;297;297;11;286;37.31;3.70
86142;040904;SZKOŁA PODSTAWOWA|CIECHRZ| 30 |88-320 STRZELNO;700;251;251;11;240;35.86;4.38
86143;040904;ŚRODOWISKOWY DOM SAMOPOMOCY|STRZELNO|KOLEJOWA 5 |88-320 STRZELNO;747;245;245;19;226;32.80;7.76
86144;040904;SZPITAL POWIATOWY W STRZELNIE|STRZELNO|POWSTANIA WIELKOPOLSKIEGO 8 |88-320 STRZELNO;32;11;11;1;10;34.38;9.09
86145;041001;ZESPÓŁ SZKÓŁ TECHNICZNYCH W KCYNI|KCYNIA|UL. JURCZYKA 3 |89-240 KCYNIA;1565;744;744;35;709;47.54;4.70
86146;041001;SZKOŁA PODSTAWOWA|KCYNIA|UL. WYRZYSKA 12 |89-240 KCYNIA;1527;679;679;33;646;44.47;4.86
86147;041001;GMINNE CENTRUM KULTURY I BIBLIOTEKI im.KLARY PRILLOWEJ w KCYNI|KCYNIA|UL.LIBELTA 27 |89-240 KCYNIA;1379;626;626;27;599;45.40;4.31
86148;041001;ŚWIETLICA WIEJSKA W MALICACH|MALICE| 29 |89-240 KCYNIA;472;184;184;10;174;38.98;5.43
86149;041001;ŚWIETLICA WIEJSKA W KOWALEWKU|KOWALEWKO| 34 |89-240 KCYNIA;571;284;284;20;264;49.74;7.04
86150;041001;GIMNAZJUM W CHWALISZEWIE|CHWALISZEWO| 27 |89-240 KCYNIA;810;311;311;32;279;38.40;10.29
86151;041001;ZESPÓŁ SZKÓŁ W DZIEWIERZEWIE|DZIEWIERZEWO| 34 |89-240 KCYNIA;962;480;480;11;469;49.90;2.29
86152;041001;ŚWIETLICA WIEJSKA W GÓRKACH ZAGAJNYCH|GÓRKI ZAGAJNE| 33a |89-240 KCYNIA;331;128;128;11;117;38.67;8.59
86153;041001;SZKOŁA PODSTAWOWA W SIPIORACH|SIPIORY| 51 |89-240 KCYNIA;668;233;233;28;205;34.88;12.02
86154;041001;ZESPÓŁ SZKÓŁ OGÓLNOKSZTAŁCĄCYCH W KCYNI|KCYNIA|UL.22 STYCZNIA 1 |89-240 KCYNIA;888;293;293;21;272;33.00;7.17
86155;041001;ŚWIETLICA WIEJSKA W LASKOWNICY|LASKOWNICA| 16A |89-240 KCYNIA;593;165;165;10;155;27.82;6.06
86156;041001;ŚWIETLICA WIEJSKA W GROCHOLINIE|GROCHOLIN| 30b |89-240 KCYNIA;541;195;195;13;182;36.04;6.67
86157;041001;ZESPÓŁ SZKÓŁ OGÓLNOKSZTAŁCĄCYCH W KCYNI|KCYNIA|UL.22 STYCZNIA 1 |89-240 KCYNIA;331;113;113;7;106;34.14;6.19
86158;041002;SZKOŁA PODSTAWOWA|MROCZA|UL.30 LECIA LWP 4 |89-115 MROCZA;885;341;341;16;325;38.53;4.69
86159;041002;GIMNAZJUM|MROCZA|UL. SPORTOWA 2 |89-115 MROCZA;362;143;143;6;137;39.50;4.20
86160;041002;MIEJSKO-GMINNY OŚRODEK KULTURY I REKREACJI|MROCZA|UL. ŚLUZOWA 6 |89-115 MROCZA;1156;437;437;23;414;37.80;5.26
86161;041002;REMIZA OSP|MROCZA|UL. WODNA 1 |89-115 MROCZA;966;430;430;13;417;44.51;3.02
86162;041002;ŚWIETLICA WIEJSKA|WIELE| 4 |89-115 MROCZA;628;230;230;9;221;36.62;3.91
86163;041002;ŚWIETLICA WIEJSKA|DRZEWIANOWO| |89-115 MROCZA;485;183;183;5;178;37.73;2.73
86164;041002;ŚWIETLICA WIEJSKA|DRĄŻNO| 23 |89-115 MROCZA;583;266;266;13;253;45.63;4.89
86165;041002;SZKOŁA PODSTAWOWA|KOSOWO| 20 |89-115 MROCZA;353;124;124;3;121;35.13;2.42
86166;041002;ŚWIETLICA WIEJSKA|MATYLDZIN| 41 |89-115 MROCZA;498;159;159;6;153;31.93;3.77
86167;041002;WIEJSKI DOM KULTURY|WITOSŁAW| 33 |89-114 WITOSŁAW;592;221;221;6;215;37.33;2.71
86168;041002;SZKOŁA PODSTAWOWA|WITOSŁAW| 9 |89-114 WITOSŁAW;632;232;232;8;224;36.71;3.45
86169;041003;ZESPÓŁ SZKOLNO-PRZEDSZKOLNY NR 3|Nakło nad Notecią|UL. MROTECKA 1a |89-100 Nakło nad Notecią;1251;644;644;11;633;51.48;1.71
86170;041003;GIMNAZJUM NR 3|Nakło nad Notecią|UL. MROTECKA 1a |89-100 Nakło nad Notecią;978;507;507;9;498;51.84;1.78
86171;041003;NZOZ MEDICUS|Nakło nad Notecią|OSIEDLE B. CHROBREGO 15 |89-100 Nakło nad Notecią;1646;920;920;15;905;55.89;1.63
86172;041003;MUZEUM ZIEMI KRAJEŃSKIEJ|Nakło nad Notecią|UL. POCZTOWA 14 |89-100 Nakło nad Notecią;1554;649;649;21;628;41.76;3.24
86173;041003;SZKOŁA PODSTAWOWA NR 2|Nakło nad Notecią|UL. BYDGOSKA 24 |89-100 Nakło nad Notecią;1237;535;535;28;507;43.25;5.23
86174;041003;ZESPÓŁ SZKÓŁ ŻEGLUGI ŚRÓDLĄDOWEJ|Nakło nad Notecią|UL. GEN. DĄBROWSKIEGO 4 |89-100 Nakło nad Notecią;749;262;262;16;246;34.98;6.11
86175;041003;URZĄD STANU CYWILNEGO|Nakło nad Notecią|UL. GIMNAZJALNA 2 |89-100 Nakło nad Notecią;1287;620;620;32;588;48.17;5.16
86176;041003;POWIATOWA I MIEJSKA BIBLIOTEKA PUBLICZNA|Nakło nad Notecią|UL. GEN. DĄBROWSKIEGO 20 |89-100 Nakło nad Notecią;844;350;350;19;331;41.47;5.43
86177;041003;URZĄD SKARBOWY|Nakło nad Notecią|UL. SĄDOWA 8 |89-100 Nakło nad Notecią;1312;528;528;21;507;40.24;3.98
86178;041003;ZESPÓŁ SZKÓŁ PONADGIMNAZJALNYCH|Nakło nad Notecią|UL. STASZICA 18 |89-100 Nakło nad Notecią;1283;635;635;16;619;49.49;2.52
86179;041003;SZKOŁA PODSTAWOWA NR 4|Nakło nad Notecią|OSIEDLE W. ŁOKIETKA 15 |89-100 Nakło nad Notecią;1271;710;710;9;701;55.86;1.27
86180;041003;NAKIELSKI OŚRODEK KULTURY|Nakło nad Notecią|UL. MICKIEWICZA 3 |89-100 Nakło nad Notecią;1107;591;591;17;574;53.39;2.88
86181;041003;NIEPUBLICZNA SZKOŁA PODSTAWOWA|Olszewka| 22 |89-100 Nakło nad Notecią;734;257;257;15;242;35.01;5.84
86182;041003;WIEJSKI DOM KULTURY|Paterek|UL. WYZWOLENIA 3 |89-100 Nakło nad Notecią;1239;465;465;21;444;37.53;4.52
86183;041003;ZESPÓŁ SZKÓŁ|Paterek|UL. KCYŃSKA 6a |89-100 Nakło nad Notecią;1456;694;694;39;655;47.66;5.62
86184;041003;ZESPÓŁ SZKÓŁ|Występ|UL. WIEJSKA 1 |89-100 Nakło nad Notecią;1321;647;647;20;627;48.98;3.09
86185;041003;ZESPÓŁ SZKÓŁ|Potulice|UL. SZKOLNA 4 |89-120 Potulice;1415;624;624;24;600;44.10;3.85
86186;041003;WIEJSKI DOM KULTURY|Ślesin|UL. STRAŻACKA 2 |89-121 Ślesin;1257;572;572;23;549;45.51;4.02
86187;041003;ZESPÓL SZKÓŁ|Ślesin|UL. DWORCOWA 9 |89-121 Ślesin;656;228;228;6;222;34.76;2.63
86188;041003;CENTRUM EKOLOGICZNO-KULTURALNE|Trzeciewnica|UL. POWSTAŃCÓW WIELKOPOLSKICH 25A |89-100 Nakło nad Notecią;878;400;400;15;385;45.56;3.75
86189;041003;STACJA DOŚWIADCZALNA OCENY ODMIAN|Chrząstowo| 8 |89-100 Nakło nad Notecią;1039;427;427;18;409;41.10;4.22
86190;041003;KOMUNALNE PRZEDSIĘBIORSTWO WODOCIĄGÓW I KANALIZACJI|Nakło nad Notecią|UL. DRZYMAŁY 4a |89-100 Nakło nad Notecią;126;56;56;1;55;44.44;1.79
86191;041003;ZAKŁAD KARNY|Potulice|UL. ALEJA PARKOWA 1 |89-120 Potulice;975;409;409;83;326;41.95;20.29
86192;041003;ZAKŁAD OPIEKI ZDROWOTNEJ ZAKŁAD KARNY|Potulice|UL. ALEJA PARKOWA 1 |89-120 Potulice;30;28;28;13;15;93.33;46.43
86193;041003;NOWY SZPITAL W NAKLE I SZUBINIE|Nakło nad Notecią|UL. MICKIEWICZA 7 |89-100 Nakło nad Notecią;60;4;4;0;4;6.67;0.00
86194;041003;DOM POMOCY SPOŁECZNEJ|Nakło nad Notecią|UL. PARKOWA 8 |89-100 Nakło nad Notecią;65;33;33;2;31;50.77;6.06
86195;041004;Urząd Gminy|Sadki|ul. Strażacka 11 |89-110 Sadki;804;350;350;14;336;43.53;4.00
86196;041004;Szkoła Podstawowa w Sadkach|Sadki|ul. Mickiewicza 1 |89-110 Sadki;801;338;338;18;320;42.20;5.33
86197;041004;Zespół Szkół Ponadpodstawowych|Samostrzel| 8a |89-110 Sadki;451;190;190;13;177;42.13;6.84
86198;041004;Świetlica Wiejska Bnin|Bnin| 29a |89-110 Sadki;360;145;145;18;127;40.28;12.41
86199;041004;Świetlica Wiejska Mrozowo|Mrozowo| 24 |89-110 Sadki;510;116;116;10;106;22.75;8.62
86200;041004;Świetlica Wiejska Radzicz|Radzicz| 38 |89-110 Sadki;496;139;139;8;131;28.02;5.76
86201;041004;Świetlica Wiejska Dębionek|Dębionek| 33 |89-110 Sadki;494;167;167;11;156;33.81;6.59
86202;041004;Szkoła Podstawowa w Dębowie|Dębowo|ul. Bohaterów 9 |89-110 Sadki;677;283;283;16;267;41.80;5.65
86203;041004;Świetlica Wiejska Śmielin|Śmielin|ul. Główna 2 |89-110 Sadki;522;206;206;5;201;39.46;2.43
86204;041004;Zespół Szkół Stowarzyszenia "Żakus" w Anielinach|Anieliny| 30 |89-110 Sadki;584;199;199;13;186;34.08;6.53
86205;041005;Zespół Szkół Ponadgimnazjalnych|Szubin|Kochanowskiego 1 |89-200 Szubin;1037;587;587;24;563;56.61;4.09
86206;041005;Szkoła Podstawowa Nr 1|Szubin|Wyzwolenia 21 |89-200 Szubin;1080;509;509;16;493;47.13;3.14
86207;041005;Przedszkole Samorządowe Nr 2|Szubin|Dąbrowskiego 16 |89-200 Szubin;824;467;467;15;452;56.67;3.21
86208;041005;Medyk sp. z o.o. Przychodnia|Szubin|Bema 6 |89-200 Szubin;1028;573;573;14;559;55.74;2.44
86209;041005;Spółdzielnia Mieszkaniowa|Szubin|Bema 1 |89-200 SZUBIN;819;466;466;14;452;56.90;3.00
86210;041005;Gimnazjum Nr 1|Szubin|Św. Marcina 11 |89-200 Szubin;817;366;366;16;350;44.80;4.37
86211;041005;Szubiński Dom Kultury|Szubin|Kcyńska 13 |89-200 Szubin;834;378;378;23;355;45.32;6.08
86212;041005;Zespół Szkół|Szubin|Tysiąclecia 1 |89-200 Szubin;988;566;566;17;549;57.29;3.00
86213;041005;Szkoła Podstawowa|Kołaczkowo|Szkolna 6 |89-200 Szubin;910;396;396;20;376;43.52;5.05
86214;041005;Świetlica wiejska|Rynarzewo|Bydgoska 2 |89-200 Szubin;970;505;505;13;492;52.06;2.57
86215;041005;Zespół Szkół w Rynarzewie|Rynarzewo|Strażacka 20 |89-200 Szubin;844;394;394;13;381;46.68;3.30
86216;041005;Świetlica wiejska|Zamość|Wierzbowa 1 |89-200 Szubin;753;395;395;9;386;52.46;2.28
86217;041005;Świetlica wiejska|Zamość|Wierzbowa 1 |89-200 Szubin;740;363;363;15;348;49.05;4.13
86218;041005;Szkoła Podstawowa|Tur|Bydgoska 28 |89-200 Szubin;828;373;373;16;357;45.05;4.29
86219;041005;Świetlica wiejska|Samoklęski Duże| 19a |89-200 Szubin;1013;337;337;19;318;33.27;5.64
86220;041005;Świetlica wiejska|Szaradowo| 9 |89-200 Szubin;907;281;281;10;271;30.98;3.56
86221;041005;Rejonowa Biblioteka Publiczna|Szubin|Kcyńska 11 |89-200 Szubin;1112;452;452;35;417;40.65;7.74
86222;041005;Świetlica wiejska|Królikowo|Chraplewska 1 |89-200 Szubin;755;262;262;9;253;34.70;3.44
86223;041005;Świetlica wiejska|Ciężkowo| 10 |89-200 Szubin;741;207;207;14;193;27.94;6.76
86224;041005;Świetlica wiejska|Chomętowo| 25 |89-200 Szubin;893;372;372;19;353;41.66;5.11
86225;041005;Zespół Szkół w Kowalewie|Kowalewo|Szkolna 5 |89-200 Szubin;808;327;327;9;318;40.47;2.75
86226;041005;Nowy Szpital w Nakle i Szubinie sp. z.o.o. budynek główny, II piętro, korytarz|Szubin|Ogrodowa 9 |89-200 Szubin;40;9;9;1;8;22.50;11.11
86227;041101;Miejski Zespół Szkół w Radziejowie|Radziejów|Szkolna 28 |88-200 Radziejów;893;405;405;17;388;45.35;4.20
86228;041101;Miejski Zespół Szkół w Radziejowie|Radziejów|Szkolna 28 |88-200 Radziejów;938;415;415;13;402;44.24;3.13
86229;041101;Urząd Miasta Radziejów|Radziejów|Kościuszki 20/22 |88-200 Radziejów;955;403;403;17;386;42.20;4.22
86230;041101;Miejska i Powiatowa Biblioteka Publiczna w Radziejowie|Radziejów|Objezdna 33 |88-200 Radziejów;919;464;464;16;448;50.49;3.45
86231;041101;Radziejowski Dom Kultury|Radziejów|Objezdna 40 |88-200 Radziejów;929;466;466;10;456;50.16;2.15
86232;041101;Samodzielny Publiczny Zakład Opieki Zdrowotnej w Radziejowie|Radziejów|Szpitalna 3 |88-200 Radziejów;175;63;63;10;53;36.00;15.87
86233;041102;Wiejskie Centrum Kultury i Biblioteka Publiczna w Bytoniu|Bytoń| 72 |88-231 Bytoń;747;302;302;14;288;40.43;4.64
86234;041102;Remiza Ochotniczej Straży Pożarnej w Budzisławiu|Budzisław| 3 |88-231 Bytoń;412;137;137;2;135;33.25;1.46
86235;041102;Szkoła Podstawowa w Morzycach|Morzyce| 27 |88-231 Bytoń;747;266;266;22;244;35.61;8.27
86236;041102;Publiczne Gimnazjum w Witowie|Witowo| 48 |88-231 Bytoń;681;240;240;28;212;35.24;11.67
86237;041102;Świetlica Wiejska w Niegibalicach|Niegibalice| 46 |88-231 Bytoń;468;158;158;5;153;33.76;3.16
86238;041103;Zespół Szkół w Dobrem|Dobre|ul.Szkolna 9 |88-210 Dobre;1219;522;522;27;495;42.82;5.17
86239;041103;Publiczna Szkoła Podstawowa|Byczyna| 47 |88-210 Dobre;532;207;207;7;200;38.91;3.38
86240;041103;Publiczna Szkoła Podstawowa|Krzywosądz| 52 |88-210 Dobre;1219;450;450;11;439;36.92;2.44
86241;041103;Świetlica Wiejska|Bronisław| 40A |88-210 Dobre;473;159;159;3;156;33.62;1.89
86242;041103;Remiza OSP|Bodzanowo| 3 |88-210 Dobre;194;57;57;1;56;29.38;1.75
86243;041103;Gminny Ośrodek Kultury|Dobre|ul.Fabryczna 26a |88-210 Dobre;860;230;230;8;222;26.74;3.48
86244;041104;Szkoła Podstawowa w Osięcinach|Osięciny|ul.Traugutta 1 |88-220 Osięciny;1472;580;580;20;560;39.40;3.45
86245;041104;Publiczne Gimnazjum w Osięcinach|Osięciny|ul.Traugutta 7 |88-220 Osięciny;929;313;313;12;301;33.69;3.83
86246;041104;Gminny Ośrodek Kultury w Osięcinach|Osięciny|ul. I Armii Wojska Polskiego 21 |88-220 Osięciny;1298;652;652;21;631;50.23;3.22
86247;041104;Szkoła Podstawowa w Kościelnej Wsi|Kościelna Wieś| 2 |88-220 Osięciny;743;283;283;11;272;38.09;3.89
86248;041104;Szkoła Podstawowa w Pocierzynie|Pocierzyn| 35 |88-220 Osięciny;762;248;248;14;234;32.55;5.65
86249;041104;Świetlica wiejska w Borucinie|Borucin| 1a |88-220 Osięciny;463;164;164;17;147;35.42;10.37
86250;041104;Świetlica wiejska w Konarach|Konary| 17/7 |88-220 Osięciny;439;131;131;4;127;29.84;3.05
86251;041104;Remiza OSP w Pilichowie|Pilichowo| 12a |88-220 Osięciny;373;106;106;10;96;28.42;9.43
86252;041105;Hala Widowiskowo-Sportowa ul. Włocławska Piotrków Kujawski|Piotrków Kujawski|ul.Włocławska 37 |88-230 Piotrków Kujawski;1535;633;633;32;601;41.24;5.06
86253;041105;Świetlica MGOPS ul. Słoneczna 32 Piotrków Kujawski|Piotrków Kujawski|ul.Słoneczna 32 |88-230 Piotrków Kujawski;1032;426;426;17;409;41.28;3.99
86254;041105;Biblioteka Publiczna ul. Rynek 20 Piotrków Kujawski|Piotrków Kujawski|Rynek 20 |88-230 ;1028;392;392;16;376;38.13;4.08
86255;041105;Świetlica Wiejska Zborowiec|Zborowiec| 47 |88-230 Piotrków Kujawski;403;132;132;8;124;32.75;6.06
86256;041105;Świetlica Wiejska Gradowo|Gradowo| |88-230 Piotrków Kujawski;478;174;174;5;169;36.40;2.87
86257;041105;Szkoła Podstawowa Bycz|Bycz| 3 |88-230 Piotrków Kujawski;514;161;161;15;146;31.32;9.32
86258;041105;Remiza OSP Połajewo|Połajewo| 25C |88-230 Piotrków Kujawski;485;182;182;5;177;37.53;2.75
86259;041105;Szkoła Podstawowa Dębołęka|Dębołęka| 7 |88-230 Piotrków Kujawski;555;205;205;12;193;36.94;5.85
86260;041105;Remiza OSP Świątniki|Świątniki| 9 |88-230 Piotrków Kujawski;482;171;171;6;165;35.48;3.51
86261;041105;Remiza OSP Jerzyce|Jerzyce| 7 |88-230 Piotrków Kujawski;545;161;161;10;151;29.54;6.21
86262;041105;Warsztaty Terapii Zajęciowej Nowa Wieś|Nowa Wieś| 28A |88-230 Piotrków Kujawski;547;173;173;11;162;31.63;6.36
86263;041105;Świetlica Domu Pomocy Społecznej w Piotrkowie Kujawskim|Piotrków Kujawski|Poznańska 98 |88-230 Piotrków Kujawski;63;23;23;1;22;36.51;4.35
86264;041106;Świetlica wiejska w Bieganowie|Bieganowo| 9 |88-200 Radziejów;795;287;287;9;278;36.10;3.14
86265;041106;Świetlica wiejska w Czołowie|Czołowo| 83a |88-200 Radziejów;367;191;191;7;184;52.04;3.66
86266;041106;Szkoła Podstawowa w Płowcach|Płowce| 94 |88-200 Radziejów;412;137;137;5;132;33.25;3.65
86267;041106;Remiza OSP w Broniewie|Broniewo| 8 |88-200 Radziejów;591;240;240;9;231;40.61;3.75
86268;041106;Świetlica wiejska w Opatowicach|Opatowice| 21 |88-200 Radziejów;628;225;225;4;221;35.83;1.78
86269;041106;Świetlica wiejska w Zagorzycach|Zagorzyce| 21a |88-200 Radziejów;373;122;122;6;116;32.71;4.92
86270;041106;Publiczne Gimnazjum w Skibinie|Skibin| 53 |88-200 Radziejów;466;128;128;7;121;27.47;5.47
86271;041107;Świetlica Wiejska w Kamieńcu|Kamieniec| |87-875 Topólka;468;135;135;4;131;28.85;2.96
86272;041107;Szkoła Podstawowa w Paniewie|Paniewo| |87-875 Topólka;817;265;265;19;246;32.44;7.17
86273;041107;Gminny Ośrodek Kultury w Topólce|Topólka| |87-875 Topólka;829;358;358;24;334;43.18;6.70
86274;041107;Budynek byłej Szkoły Podstawowej w Znaniewie|Znaniewo| |87-875 Topólka;556;212;212;9;203;38.13;4.25
86275;041107;Świetlica Wiejska w Sierakowach|Sierakowy| |87-875 Topólka;446;156;156;4;152;34.98;2.56
86276;041107;Remiza OSP w Orlu|Orle| |87-875 Topólka;327;145;145;8;137;44.34;5.52
86277;041107;Gimnazjum Publiczne w Topólce|Topólka| |87-875 Topólka;642;244;244;15;229;38.01;6.15
86278;041201;Zespół Szkół Nr 1|Rypin|ul.Kościuszki 51 |87-500 Rypin;891;371;371;8;363;41.64;2.16
86279;041201;Zespół Szkół Nr 1|Rypin|ul. Kościuszki 51 |87-500 Rypin;680;223;223;11;212;32.79;4.93
86280;041201;Rypiński Dom Kultury|Rypin|ul. Warszawska 8 |87-500 Rypin;794;326;326;9;317;41.06;2.76
86281;041201;Muzeum Ziemi Dobrzyńskiej|Rypin|ul. Warszawska 20 |87-500 Rypin;1007;434;434;18;416;43.10;4.15
86282;041201;Starostwo Powiatowe w Rypinie|Rypin|ul. Warszawska 38 |87-500 Rypin;1050;472;472;9;463;44.95;1.91
86283;041201;Urząd Miasta Rypin|Rypin|ul. Warszawska 40 |87-500 Rypin;802;383;383;9;374;47.76;2.35
86284;041201;Szkoła Podstawowa Nr 3|Rypin|ul.Młyńska 12 |87-500 Rypin;815;384;384;9;375;47.12;2.34
86285;041201;Szkoła Podstawowa Nr 3|Rypin|ul.Młyńska 12 |87-500 Rypin;946;453;453;7;446;47.89;1.55
86286;041201;Szkoła Podstawowa Nr 1|Rypin|ul. 3 Maja 3 |87-500 Rypin;981;453;453;16;437;46.18;3.53
86287;041201;Szkoła Podstawowa Nr 1|Rypin|ul. 3 Maja 3 |87-500 Rypin;780;442;442;5;437;56.67;1.13
86288;041201;Zespół Szkół Nr 2|Rypin|ul. Dworcowa 9 |87-500 Rypin;928;430;430;17;413;46.34;3.95
86289;041201;Zespół Szkół Nr 2|Rypin|ul. Dworcowa 9 |87-500 Rypin;800;338;338;18;320;42.25;5.33
86290;041201;Rypińskie Centrum Sportu|Rypin|ul. Dworcowa 11 |87-500 Rypin;850;444;444;19;425;52.24;4.28
86291;041201;Rypińskie Centrum Sportu|Rypin|ul. Dworcowa 11 |87-500 Rypin;846;230;230;14;216;27.19;6.09
86292;041201;Świetlica Spółdzielni Mieszkaniowej Lokatorsko - Własnościowej|Rypin|ul. Wojska Polskiego 9 |87-500 Rypin;874;416;416;11;405;47.60;2.64
86293;041201;Szpital Powiatowy w Rypinie|Rypin|3 Maja 2 |87-500 Rypin;69;32;32;1;31;46.38;3.12
86294;041202;Gimnazjum Ostrowite|Ostrowite| 63 |87-522 Ostrowite;1029;396;396;13;383;38.48;3.28
86295;041202;Szkoła Podstawowa w Trąbinie|Trąbin| 6 |87-522 Ostrowite;1076;350;350;7;343;32.53;2.00
86296;041202;Szkoła Podstawowa w Ugoszczu|Ugoszcz| 22 |87-517 Brzuze;1063;338;338;17;321;31.80;5.03
86297;041202;Świetlica wiejska w Żałem|Żałe| 17 |87-517 Brzuze;1078;392;392;24;368;36.36;6.12
86298;041202;Świetlica Domu Pomocy Społecznej „KOMBATANT” w Ugoszczu|Ugoszcz| 30 |87-517 Brzuze;42;22;22;1;21;52.38;4.55
86299;041203;Urząd Gminy w Rogowie|Rogowo| 51 |87-515 Rogowo;884;346;346;18;328;39.14;5.20
86300;041203;Szkoła Podstawowa w Rogowie|Rogowo| 31 |87-515 Rogowo;530;154;154;14;140;29.06;9.09
86301;041203;Szkoła Podstawowa w Nowym Kobrzyńcu|Nowy Kobrzyniec| 1 |87-515 Rogowo;602;159;159;8;151;26.41;5.03
86302;041203;Świetlica Wiejska w Pręczkach|Pręczki| 8 |87-515 Rogowo;396;138;138;10;128;34.85;7.25
86303;041203;Szkoła Podstawowa w Sosnowie|Sosnowo| 33 |87-515 Rogowo;954;287;287;13;274;30.08;4.53
86304;041203;Szkoła Podstawowa w Nadrożu|Nadróż| 56 |87-515 Rogowo;501;189;189;8;181;37.72;4.23
86305;041204;Szkoła Podstawowa w Starorypinie Rządowym|Starorypin Rządowy| 13 |87-500 Rypin;995;305;305;14;291;30.65;4.59
86306;041204;Urząd Gminy Rypin|Rypin|ul.Lipnowska 4 |87-500 Rypin;1510;570;570;22;548;37.75;3.86
86307;041204;Szkoła Podstawowa w Zakroczu|Zakrocz| 45 |87-500 Rypin;777;240;240;2;238;30.89;0.83
86308;041204;Szkoła Podstawowa w Sadłowie|Sadłowo| 23 |87-500 Rypin;868;260;260;9;251;29.95;3.46
86309;041204;Szkoła Podstawowa w Stępowie|Stępowo| 86 |87-500 Rypin;782;265;265;6;259;33.89;2.26
86310;041204;Szkoła Podstawowa w Borzyminie|Borzymin| 5 |87-500 Rypin;996;304;304;19;285;30.52;6.25
86311;041205;Zespół Szkół w Skrwilnie|Skrwilno|ul. Bieżuńska 16 |87-510 Skrwilno;1010;378;378;16;362;37.43;4.23
86312;041205;Urząd Gminy w Skrwilnie|Skrwilno|ul. Rypińska 7 |87-510 Skrwilno;955;435;435;18;417;45.55;4.14
86313;041205;Szkoła Podstawowa w Skudzawach|Skudzawy| 27 |87-510 Skrwilno;534;186;186;10;176;34.83;5.38
86314;041205;Szkoła Podstawowa w Okalewie|Okalewo| 62 |87-510 Skrwilno;794;327;327;12;315;41.18;3.67
86315;041205;Szkoła Podstawowa w Okalewie|Okalewo| 62 |87-510 Skrwilno;585;172;172;5;167;29.40;2.91
86316;041205;Zespół Szkół w Skrwilnie|Skrwilno|ul. Bieżuńska 16 |87-510 Skrwilno;969;334;334;6;328;34.47;1.80
86317;041206;Szkoła Podstawowa Radziki Duże|Radziki Duże| 96 |87-337 Wąpielsk;652;232;232;5;227;35.58;2.16
86318;041206;Szkoła Podstawowa Radziki Duże|Radziki Duże| 96 |87-337 Wąpielsk;366;94;94;1;93;25.68;1.06
86319;041206;Szkoła Podstawowa Wąpielsk|Wąpielsk| 114 |87-337 Wąpielsk;605;199;199;15;184;32.89;7.54
86320;041206;Szkoła Podstawowa Wąpielsk|Wąpielsk| 114 |87-337 Wąpielsk;658;185;185;9;176;28.12;4.86
86321;041206;Szkoła Podstawowa Półwiesk Mały|Półwiesk Mały| 37 |87-337 Wąpielsk;414;119;119;3;116;28.74;2.52
86322;041206;Szkoła Podstawowa Długie|Długie| 70 |87-337 Wąpielsk;604;200;200;9;191;33.11;4.50
86323;041301;MIEJSKO-GMINNY OŚRODEK KULTURY|KAMIEŃ KRAJEŃSKI|UL. SĘPOLEŃSKA 4 |89-430 KAMIEŃ KRAJEŃSKI;1049;468;468;19;449;44.61;4.06
86324;041301;MIEJSKO-GMINNY OŚRODEK KULTURY|KAMIEŃ KRAJEŃSKI|UL. SĘPOLEŃSKA 4 |89-430 KAMIEŃ KRAJEŃSKI;735;345;345;15;330;46.94;4.35
86325;041301;ZESPÓŁ SZKOLNO - PRZEDSZKOLNY SZKOŁY PODSTAWOWEJ I PRZEDSZKOLA SAMORZĄDOWEGO IM.I ARMII WOJSKA POLSKIEGO|KAMIEŃ KRAJEŃSKI|UL. SZKOLNA 3 |89-430 KAMIEŃ KRAJEŃSKI;794;253;253;24;229;31.86;9.49
86326;041301;SZKOŁA PODSTAWOWA IM. WŁADYSŁAWA BRONIEWSKIEGO|DUŻA CERKWICA| 32 |89-430 KAMIEŃ KRAJEŃSKI;799;276;276;11;265;34.54;3.99
86327;041301;SZKOŁA PODSTAWOWA|ZAMARTE|UL. KLASZTORNA 1 |89-430 KAMIEŃ KRAJEŃSKI;866;338;338;13;325;39.03;3.85
86328;041301;WIEJSKI DOM KULTURY|PŁOCICZ| 22 |89-430 PŁOCICZ;609;230;230;11;219;37.77;4.78
86329;041301;WIEJSKI DOM KULTURY|DĄBRÓWKA|GŁÓWNA 7 |89-430 KAMIEŃ KRAJEŃSKI;537;222;222;29;193;41.34;13.06
86330;041301;Dom Pomocy Społecznej|Kamień Krajeński|Podgórna 2 |89-430 Kamień Krajeński;64;37;37;3;34;57.81;8.11
86331;041302;CENTRUM AKTYWNOŚCI SPOŁECZNEJ|Sępólno Krajeńskie|UL. JEZIORNA 6 |89-400 SĘPÓLNO KRAJEŃSKIE;831;341;341;16;325;41.03;4.69
86332;041302;GMINNE PRZEDSZKOLE NR 1 Z ODDZIAŁAMI INTEGRACYJNYMI|SĘPÓLNO KRAJEŃSKIE|UL. NOWY RYNEK 2 |89-400 SĘPÓLNO KRAJEŃSKIE;903;358;358;19;339;39.65;5.31
86333;041302;ZESPÓŁ SZKÓŁ NR 1|Sępólno Krajeńskie|UL. WOJSKA POLSKIEGO 34 |89-400 SĘPÓLNO KRAJEŃSKIE;808;411;411;8;403;50.87;1.95
86334;041302;ZESPÓŁ SZKÓŁ NR 1|SĘPÓLNO KRAJEŃSKIE|UL. WOJSKA POLSKIEGO 34 |89-400 SĘPÓLNO KRAJEŃSKIE;1062;498;498;12;486;46.89;2.41
86335;041302;CENTRUM SPORTU I REKREACJI|SĘPÓLNO KRAJEŃSKIE|UL. CHOJNICKA 19 |89-400 SĘPÓLNO KRAJEŃSKIE;874;451;451;9;442;51.60;2.00
86336;041302;ZESPÓŁ SZKÓŁ NR 3|SĘPÓLNO KRAJEŃSKIE|UL. SZKOLNA 1 |89-400 SĘPÓLNO KRAJEŃSKIE;808;414;414;8;406;51.24;1.93
86337;041302;OŚRODEK POMOCY SPOŁECZNEJ|SĘPÓLNO KRAJEŃSKIE|UL. SZKOLNA 8 |89-400 SĘPÓLNO KRAJEŃSKIE;690;326;326;10;316;47.25;3.07
86338;041302;CENTRUM KULTURY I SZTUKI|SĘPÓLNO KRAJEŃSKIE|UL. TADEUSZA KOŚCIUSZKI 4 |89-400 SĘPÓLNO KRAJEŃSKIE;654;361;361;8;353;55.20;2.22
86339;041302;LICEUM OGÓLNOKSZTAŁCĄCE|SĘPÓLNO KRAJEŃSKIE|UL. MŁYŃSKA 42 |89-400 SĘPÓLNO KRAJEŃSKIE;695;341;341;7;334;49.06;2.05
86340;041302;ŚWIETLICA WIEJSKA|Świdwie| 10 |89-400 SĘPÓLNO KRAJEŃSKIE;991;277;277;9;268;27.95;3.25
86341;041302;ŚWIETLICA WIEJSKA|Radońsk| 14 |89-400 SĘPÓLNO KRAJEŃSKIE;796;262;262;10;252;32.91;3.82
86342;041302;WIEJSKI OŚRODEK KULTURY|Lutowo| 65 |89-406 LUTOWO;722;305;305;8;297;42.24;2.62
86343;041302;ŚWIETLICA WIEJSKA|Piaseczno| 32 |89-400 SĘPÓLNO KRAJEŃSKIE;780;314;314;10;304;40.26;3.18
86344;041302;ŚWIETLICA WIEJSKA|Skarpa| 4 |89-400 SĘPÓLNO KRAJEŃSKIE;984;341;341;14;327;34.65;4.11
86345;041302;WIEJSKI OŚRODEK KULTURY|Wałdowo| 20 |89-405 WAŁDOWO;952;354;354;20;334;37.18;5.65
86346;041303;SZKOŁA PODSTAWOWA PRZEPAŁKOWO|Przepałkowo| 7 |89-412 SOŚNO;740;215;215;13;202;29.05;6.05
86347;041303;SALA WIEJSKA WIELOWICZ|Wielowicz| 26 |89-412 SOŚNO;937;339;339;18;321;36.18;5.31
86348;041303;GMINNY DOM KULTURY SOŚNO|SOŚNO|ALEJA JANA PAWŁA II 1 |89-412 SOŚNO;693;314;314;18;296;45.31;5.73
86349;041303;ZESPÓŁ SZKÓŁ WĄWELNO|Wąwelno|SZKOLNA 1 |89-413 SOŚNO;1136;371;371;14;357;32.66;3.77
86350;041303;ŚWIETLICA WIEJSKA SITNO|Sitno| 11 |89-413 SOŚNO;494;128;128;9;119;25.91;7.03
86351;041304;PRZEDSZKOLE GMINNE Nr 1|Więcbork|UL.GDAŃSKA 13 |89-410 WIĘCBORK;1126;558;558;7;551;49.56;1.25
86352;041304;GIMNAZJUM IM. POLSKICH NOBLISTÓW|Więcbork|UL.ALEJA 600-LECIA 4 |89-410 WIĘCBORK;1205;469;469;10;459;38.92;2.13
86353;041304;SZKOŁA PODSTAWOWA IM. KORNELA MAKUSZYŃSKIEGO|Więcbork|UL. WYZWOLENIA 19 |89-410 WIĘCBORK;774;364;365;12;352;47.03;3.30
86354;041304;SZKOŁA PODSTAWOWA IM.KORNELA MAKUSZYŃSKIEGO|Więcbork|UL. WYZWOLENIA 19 |89-410 WIĘCBORK;788;346;346;9;337;43.91;2.60
86355;041304;GIMNAZJUM IM.POLSKICH NOBLISTÓW|Więcbork|UL.ALEJA 600-LECIA 4 |89-410 WIĘCBORK;775;293;293;7;286;37.81;2.39
86356;041304;ZESPÓŁ SZKÓŁ PĘPERZYN|Pęperzyn| 33 |89-410 WIĘCBORK;778;258;258;13;245;33.16;5.04
86357;041304;ZESPÓŁ SZKÓŁ Z ODDZIAŁAMI INTEGRACYJNYMI|Jastrzębiec| 17 |89-410 WIĘCBORK;591;218;218;7;211;36.89;3.21
86358;041304;SZKOŁA PODSTAWOWA IM. E.J.ORZELSKICH|Runowo Krajeńskie| 58 |89-421 RUNOWO KRAJEŃSKIE;1223;456;456;18;438;37.29;3.95
86359;041304;ŚWIETLICA WIEJSKA|Witunia|UL. WINCENTEGO WITOSA 13 |89-410 Więcbork;671;284;284;15;269;42.32;5.28
86360;041304;SZKOŁA PODSTAWOWA|Zakrzewek| 25 |89-410 Więcbork;668;179;179;4;175;26.80;2.23
86361;041304;ZESPÓŁ SZKÓŁ|Sypniewo|UL.SZKOLNA 1 |89-422 SYPNIEWO;806;293;293;12;281;36.35;4.10
86362;041304;OSP|Sypniewo|STRAŻACKA 6 |89-422 Sypniewo;914;406;406;6;400;44.42;1.48
86363;041304;DOM POMOCY SPOŁECZNEJ|SUCHORĄCZEK| 51 |89-410 WIĘCBORK;28;22;22;2;20;78.57;9.09
86364;041304;SZPITAL POWIATOWY DR.A.GACY I DR.J.ŁASKIEGO-NIEPUBLICZNY ZAKŁAD OPIEKI ZDROWOTNEJ|WIĘCBORK|MICKIEWICZA 26 |89-410 WIĘCBORK;42;28;28;1;27;66.67;3.57
86365;041401;SZKOŁA PODSTAWOWA w BUKOWCU|BUKOWIEC|DWORCOWA 26 |86-122 BUKOWIEC;856;421;421;19;402;49.18;4.51
86366;041401;SZKOŁA PODSTAWOWA w BUKOWCU|BUKOWIEC|DWORCOWA 26 |86-122 BUKOWIEC;579;268;268;19;249;46.29;7.09
86367;041401;ŚWIETLICA WIEJSKA w PLEWNIE|PLEWNO| 14 |86-122 BUKOWIEC;527;159;159;9;150;30.17;5.66
86368;041401;SZKOŁA PODSTAWOWA w PRZYSIERSKU|PRZYSIERSK|SZKOLNA 5 |86-122 BUKOWIEC;627;250;250;14;236;39.87;5.60
86369;041401;SZKOŁA PODSTAWOWA w RÓŻANNIE|RÓŻANNA| 32 |86-122 BUKOWIEC;800;222;222;18;204;27.75;8.11
86370;041401;GIMNAZJUM w KORYTOWIE|KORYTOWO| 1 |86-122 BUKOWIEC;605;220;220;15;205;36.36;6.82
86371;041402;ŚWIETLICA WIEJSKA BRATWIN|BRATWIN| |86-134 DRAGACZ;745;199;199;5;194;26.71;2.51
86372;041402;SALA POSIEDZEŃ URZĘDU GMINY DRAGACZ|DRAGACZ| 7A |86-134 DRAGACZ;974;396;396;13;383;40.66;3.28
86373;041402;ŚWIETLICA WIEJSKA WIELKI LUBIEŃ|WIELKI LUBIEŃ| |86-134 DRAGACZ;602;191;191;5;186;31.73;2.62
86374;041402;GMINNY OŚRODEK KULTURY SPORTU I REKREACJI GÓRNA GRUPA|GÓRNA GRUPA|ul. Świecka 8 |86-134 DRAGACZ;678;264;264;14;250;38.94;5.30
86375;041402;SZKOŁA PODSTAWOWA GRUPA|Grupa|ul. Szkolna 2 |86-134 DRAGACZ;814;276;276;11;265;33.91;3.99
86376;041402;SZKOŁA PODSTAWOWA GRUPA|Grupa|ul. Szkolna 2 |86-134 DRAGACZ;706;319;320;6;313;45.18;1.88
86377;041402;ŚWIETLICA WIEJSKA DOLNA GRUPA|Dolna Grupa|ul. Słoneczna |86-134 Dragacz;665;224;224;3;221;33.68;1.34
86378;041402;ŚWIETLICA WIEJSKA DOLNA GRUPA|Dolna Grupa|ul. Słoneczna |86-134 Dragacz;504;243;243;10;233;48.21;4.12
86379;041403;SZKOŁA PODSTAWOWA W DRZYCIMIU|DRZYCIM|BRONIEWSKIEGO 2 |86-140 DRZYCIM;703;313;313;15;298;44.52;4.79
86380;041403;ŚWIETLICA GMINNA W DRZYCIMIU|Drzycim|SZKOLNA 8 |86-140 DRZYCIM;807;291;291;11;280;36.06;3.78
86381;041403;PUBLICZNE GIMNAZJUM W GRÓDKU|Gródek|SZKOLNA 5 |86-140 DRZYCIM;490;171;171;5;166;34.90;2.92
86382;041403;ŚWIETLICA WIEJSKA W GRÓDKU|GRÓDEK|SŁONECZNA 1a |86-140 DRZYCIM;548;251;251;6;245;45.80;2.39
86383;041403;ŚWIETLICA WIEJSKA W DÓLSKU|DÓLSK| 8 |86-140 DRZYCIM;498;200;200;8;192;40.16;4.00
86384;041403;ŚWIETLICA WIEJSKA W JASTRZĘBIU|Jastrzębie| 34a |86-140 DRZYCIM;568;220;220;18;202;38.73;8.18
86385;041403;SZKOŁA PODSTAWOWA W SIEROSŁAWIU|Sierosław| 24 |86-140 DRZYCIM;370;161;161;10;151;43.51;6.21
86386;041404;DOM KULTURY|Jeżewo|UL. GŁÓWNA 2a |86-131 Jeżewo;1252;415;415;20;395;33.15;4.82
86387;041404;SZKOŁA PODSTAWOWA|Jeżewo|UL. GŁÓWNA 37 |86-131 Jeżewo;1230;602;602;21;581;48.94;3.49
86388;041404;GIMNAZJUM|Laskowice|UL. MICKIEWICZA 3a |86-131 Jeżewo;1139;487;487;18;469;42.76;3.70
86389;041404;SZKOŁA PODSTAWOWA|Laskowice|UL. SZKOLNA 6 |86-131 Jeżewo;1317;594;594;30;564;45.10;5.05
86390;041404;SZKOŁA PODSTAWOWA CZERSK ŚWIECKI|Czersk Świecki| 39 |86-131 Jeżewo;435;130;130;3;127;29.89;2.31
86391;041404;SZKOŁA PODSTAWOWA KRĄPLEWICE|Krąplewice| 30 |86-131 Jeżewo;875;278;278;16;262;31.77;5.76
86392;041405;SZKOŁA PODSTAWOWA|LNIANO|Szkolna 13 |86-141 LNIANO;643;240;240;11;229;37.33;4.58
86393;041405;SZKOŁA PODSTAWOWA|SIEMKOWO| 10 |86-141 LNIANO;727;329;329;14;315;45.25;4.26
86394;041405;SZKOŁA PODSTAWOWA|BŁĄDZIM| 54 |86-141 LNIANO;702;349;349;7;342;49.72;2.01
86395;041405;ŚWIETLICA WIEJSKA|BRZEMIONA| 20 |86-141 LNIANO;521;185;185;9;176;35.51;4.86
86396;041405;GIMNAZJUM PUBLICZNE|LNIANO|Szkolna 13 |86-141 LNIANO;718;362;362;13;349;50.42;3.59
86397;041406;KOTŁOWNIA PUM|Nowe|OSIEDLE NADWIŚLAŃSKIE |86-170 NOWE;1150;505;505;20;485;43.91;3.96
86398;041406;CENTRUM KULTURY "ZAMEK"|NOWE|PLAC ZAMKOWY 3 |86-170 NOWE;1359;500;500;27;473;36.79;5.40
86399;041406;REMIZA OSP|NOWE|ALEJA 3 MAJA 5 |86-170 NOWE;1370;521;521;15;506;38.03;2.88
86400;041406;SZKOŁA PODSTAWOWA nr 2|NOWE|UL. MYŚLIWSKA 2B |86-170 NOWE;925;472;472;5;467;51.03;1.06
86401;041406;DOM KULTURY|BOCHLIN| 63 |86-170 NOWE;712;202;202;11;191;28.37;5.45
86402;041406;DOM KULTURY|RYCHŁAWA| 47 |86-170 NOWE;790;275;275;7;268;34.81;2.55
86403;041406;SZKOŁA PODSTAWOWA|TRYL| 98 |86-170 NOWE;611;126;126;7;119;20.62;5.56
86404;041406;ŚWIETLICA WIEJSKA|MAŁY KOMORSK| 6 |86-170 NOWE;337;100;100;2;98;29.67;2.00
86405;041406;ŚWIETLICA WIEJSKA|ZDROJEWO| 28 |86-170 NOWE;555;133;133;4;129;23.96;3.01
86406;041406;ŚWIETLICA WIEJSKA|GÓRNE MORGI| 14 |86-170 NOWE;540;124;124;2;122;22.96;1.61
86407;041407;GMINNY OŚRODEK KULTURY|OSIE|UL. RYNEK 2 |86-150 OSIE;952;394;394;15;379;41.39;3.81
86408;041407;SZKOŁA PODSTAWOWA|BRZEZINY| 40A |86-150 OSIE;791;295;295;9;286;37.29;3.05
86409;041407;SZKOŁA PODSTAWOWA|WIERZCHY| 21 |86-150 OSIE;861;406;406;30;376;47.15;7.39
86410;041407;SZKOŁA PODSTAWOWA|OSIE|UL. KSIĘDZA SEMRAUA 44 |86-150 OSIE;928;411;411;18;393;44.29;4.38
86411;041407;ZESPOŁ SZKÓŁ|OSIE|UL. SZKOLNA 8 |86-150 OSIE;787;302;302;10;292;38.37;3.31
86412;041408;Szkoła Podstawowa|Pruszcz|Kościelna 4 |86-120 Pruszcz;1148;570;572;20;550;49.65;3.51
86413;041408;Gimnazjum nr 1|Pruszcz|Kościelna 4 |86-120 Pruszcz;1349;657;657;26;631;48.70;3.96
86414;041408;Świetlica wiejska|Parlin| 53A |86-120 Pruszcz;471;218;218;23;195;46.28;10.55
86415;041408;Dom Kultury|Serock|Aleje Mickiewicza 1 |86-120 Pruszcz;1089;559;559;15;544;51.33;2.68
86416;041408;Dom Kultury|Serock|Aleje Mickiewicza 1 |86-120 Pruszcz;618;287;287;12;275;46.44;4.18
86417;041408;Świetlica wiejska|Topolno| 8 |86-120 Pruszcz;1130;464;464;18;446;41.06;3.88
86418;041408;Szkoła Podstawowa|Niewieścin| 47 |86-120 Pruszcz;507;246;246;8;238;48.52;3.25
86419;041408;Remiza Strażacka|Pruszcz|Sportowa 10 |86-120 Pruszcz;1059;369;369;12;357;34.84;3.25
86420;041408;Dom Pomocy Społecznej|Gołuszyce| 26 |86-120 Pruszcz;88;35;35;7;28;39.77;20.00
86421;041408;Międzygminny Ośrodek Opiekuńczy|Pruszcz|Łowińska 9 |86-120 Pruszcz;41;32;32;6;26;78.05;18.75
86422;041409;Przedszkole Nr 4|Świecie|Kościuszki 16 |86-100 Świecie;1317;710;710;25;685;53.91;3.52
86423;041409;Gimnazjum Nr 1|Świecie|Chmielniki 5 |86-100 Świecie;1334;635;635;19;616;47.60;2.99
86424;041409;Szkoła Podstawowa Nr 7|Świecie|Mickiewicza 6 |86-100 Świecie;1030;303;303;7;296;29.42;2.31
86425;041409;Szkoła Podstawowa Nr 7|Świecie|Mickiewicza 6 |86-100 Świecie;1278;476;476;16;460;37.25;3.36
86426;041409;Gimnazjum Nr 2|Świecie|Ogrodowa 1C |86-100 Świecie;1365;508;508;20;488;37.22;3.94
86427;041409;Ośrodek Kultury Sportu i Rekreacji|Świecie|Wojska Polskiego 139 |86-100 Świecie;1279;664;664;13;651;51.92;1.96
86428;041409;Miejsko-Gminna Przychodnia|Świecie|Wojska Polskiego 80 |86-105 Świecie;1461;726;726;19;707;49.69;2.62
86429;041409;Towarzystwo Przyjaciół Dzieci|Świecie|Wojska Polskiego Barak Nr 1 |86-105 Świecie;1184;565;565;15;550;47.72;2.65
86430;041409;Szkoła Podstawowa Nr 8|Świecie|Aleja Jana Pawła II 8 |86-105 Świecie;1457;695;695;19;676;47.70;2.73
86431;041409;Przedszkole Nr 7|Świecie|Paderewskiego 4 |86-105 Świecie;1263;650;650;20;630;51.46;3.08
86432;041409;Gimnazjum Nr 3|Świecie|Aleja Jana Pawła II 8 |86-105 Świecie;1248;592;592;12;580;47.44;2.03
86433;041409;Przedszkole Nr 8|Świecie|Ks. Kardynała Stefana Wyszyńskiego 9 |86-105 Świecie;1207;621;621;17;604;51.45;2.74
86434;041409;Spółdzielnia Mieszkaniowa "Pomóż Sam Sobie"|Świecie|Marszałka Józefa Piłsudskiego 15 |86-105 Świecie;1347;726;726;6;720;53.90;0.83
86435;041409;Zespół Szkół Specjalnych Nr 1|Świecie|Paderewskiego 5A |86-105 Świecie;907;541;541;7;534;59.65;1.29
86436;041409;Ochotnicza Straż Pożarna w Przechowie|Świecie|Sportowa 16 |86-105 Świecie;1024;553;553;16;537;54.00;2.89
86437;041409;Szkoła Podstawowa Nr 5|Świecie|Wojska Polskiego 3 |86-105 Świecie;1088;348;348;19;329;31.99;5.46
86438;041409;Szkoła Podstawowa|Gruczno|Chełmińska 5 |86-105 Świecie;1145;498;498;18;480;43.49;3.61
86439;041409;Gimnazjum Nr 4|Gruczno|Chełmińska 5 |86-105 Świecie;952;314;314;14;300;32.98;4.46
86440;041409;Szkoła Podstawowa|Terespol Pomorski|Szkolna 10 |86-105 Świecie;1332;538;538;30;508;40.39;5.58
86441;041409;Szkoła Podstawowa|Wiąg| 86 |86-100 Świecie;1366;455;455;17;438;33.31;3.74
86442;041409;Świetlica Wiejska|Sulnowo| 51A |86-100 Świecie;1327;626;626;27;599;47.17;4.31
86443;041409;Wojewódzki Szpital dla Nerwowo i Psychicznie Chorych w Świeciu|Świecie|Sądowa 18 |86-100 Świecie;330;107;107;23;84;32.42;21.50
86444;041409;Niepubliczny Zakład Opieki Zdrowotnej "Nowy Szpital"|Świecie|Wojska Polskiego 126 |86-100 Świecie;113;41;41;4;37;36.28;9.76
86445;041409;Dom Pomocy Społecznej Prowadzony Przez Zgromadzenie Sióstr Miłosierdzia Św. Wincentego A' Paulo|Świecie|Wojska Polskiego 128 |86-100 Świecie;32;14;14;3;11;43.75;21.43
86446;041409;Niepubliczny Zakład Opieki Zdrowotnej "Florencja II"|Świecie|Św. Wincentego 1 |86-100 Świecie;56;4;4;0;4;7.14;0.00
86447;041410;SALA GIMNASTYCZNA|ŚWIEKATOWO|DWORCOWA 20A |86-182 ŚWIEKATOWO;560;315;315;8;307;56.25;2.54
86448;041410;SALA KONFERENCYJNA w ŚWIEKATOWIE|ŚWIEKATOWO|SPORTOWA 2 |86-182 ŚWIEKATOWO;536;225;225;10;215;41.98;4.44
86449;041410;ŚWIETLICA WIEJSKA w JANIEJ GÓRZE|JANIA GÓRA| 1 |86-182 ŚWIEKATOWO;487;188;188;15;173;38.60;7.98
86450;041410;ŚWIETLICA WIEJSKA W LUBANIA-LIPINY|LUBANIA-LIPINY| 44A |86-182 ŚWIEKATOWO;452;129;129;14;115;28.54;10.85
86451;041410;ŚWIETLICA WIEJSKA w TUSZYNACH|TUSZYNY| 32 |86-182 ŚWIEKATOWO;393;146;146;6;140;37.15;4.11
86452;041410;ŚWIETLICA WIEJSKA W ZALESIU KRÓLEWSKIM|ZALESIE KRÓLEWSKIE| 32 |86-182 ŚWIEKATOWO;398;173;173;4;169;43.47;2.31
86453;041411;Dom Strażaka w Warlubiu|Warlubie|Bąkowska 12 |86-160 WARLUBIE;1739;639;639;25;614;36.75;3.91
86454;041411;Świetlica Wiejska w Bąkowie|Bąkowo| |86-160 WARLUBIE;581;143;143;4;139;24.61;2.80
86455;041411;Świetlica Wiejska w Płochocinie|Płochocin| |86-160 WARLUBIE;473;136;136;11;125;28.75;8.09
86456;041411;Świetlica Wiejska w Bzowie|Bzowo| 90 |86-160 WARLUBIE;585;214;214;6;208;36.58;2.80
86457;041411;Świetlica Wiejska w Wielkim Komorsku|Wielki Komorsk|Nowska A 12 |86-160 WARLUBIE;1027;312;312;23;289;30.38;7.37
86458;041411;Wiejski Dom Kultury w Lipinkach|Lipinki| 6 |86-160 WARLUBIE;629;252;252;22;230;40.06;8.73
86459;041501;Pomieszczenia Urzędu Miasta|Chełmża|ul. Tumska 12 |87-140 Chełmża;2179;722;722;33;689;33.13;4.57
86460;041501;Szkoła Podstawowa Nr 3|Chełmża|ul. Gen. J. Hallera 21 |87-140 Chełmża;1497;487;487;16;471;32.53;3.29
86461;041501;Gimnazjum Nr 1|Chełmża|ul. Ks. Piotra Skargi 1 |87-140 Chełmża;1581;711;711;15;696;44.97;2.11
86462;041501;Zakład Gospodarki Komunalnej Sp. z o. o.|Chełmża|ul. Toruńska 1 |87-140 Chełmża;2237;933;933;33;900;41.71;3.54
86463;041501;Szkoła Podstawowa Nr 5|Chełmża|ul. Wyszyńskiego 5 |87-140 Chełmża;733;386;386;16;370;52.66;4.15
86464;041501;Zespół Szkół Specjalnych|Chełmża|ul. Wyszyńskiego 7 |87-140 Chełmża;1530;749;749;27;722;48.95;3.60
86465;041501;Przystań Chełmżyńskiego Towarzystwa Wioślarskiego 1927|Chełmża|ul. 3 Maja 14 |87-140 Chełmża;1606;707;707;26;681;44.02;3.68
86466;041501;Szpital Powiatowy Sp. z o.o.|Chełmża|ul. Szewska 23 |87-140 Chełmża;18;12;12;2;10;66.67;16.67
86467;041502;Gimnazjum|Głuchowo| 3A |87-140 Chełmża;824;310;310;19;291;37.62;6.13
86468;041502;Szkoła Podstawowa|Kończewice| 12A |87-140 Chełmża;1057;357;357;23;334;33.77;6.44
86469;041502;Szkoła Podstawowa|Grzywna| 110A |87-140 Chełmża;1629;648;648;9;639;39.78;1.39
86470;041502;Szkoła Podstawowa|Sławkowo| 4 |87-140 Chełmża;1076;344;344;11;333;31.97;3.20
86471;041502;Gimnazjum|Pluskowęsy| 71A |87-140 Chełmża;502;163;163;1;162;32.47;0.61
86472;041502;Szkoła Podstawowa|Zelgno| 12 |87-140 Chełmża;1343;466;466;19;447;34.70;4.08
86473;041502;Świetlica wiejska|Grzegorz| 35/1 |87-140 Chełmża;592;245;245;7;238;41.39;2.86
86474;041502;Świetlica wiejska|Skąpe| 18A |87-140 Chełmża;484;190;190;15;175;39.26;7.89
86475;041502;Dom Pomocy Społecznej|Browina| 56 |87-140 Chełmża;116;57;57;9;48;49.14;15.79
86476;041502;Zakład Opiekuńczo-Leczniczy|Browina| 62 |87-140 Chełmża;69;8;8;1;7;11.59;12.50
86477;041503;Zespół Szkół|Czernikowo|ul. Gimnazjalna 1 |87-640 Czernikowo;1376;568;568;21;547;41.28;3.70
86478;041503;Szkoła Podstawowa|Osówka| |87-632 Osówka;1129;353;353;21;332;31.27;5.95
86479;041503;Szkoła Podstawowa|Mazowsze| |87-640 Czernikowo;1020;308;308;15;293;30.20;4.87
86480;041503;Zespół Szkół|Czernikowo|ul. Gimnazjalna 1 |87-640 Czernikowo;1446;490;490;29;461;33.89;5.92
86481;041503;Zespół Szkół|Czernikowo|ul. Gimnazjalna 1 |87-640 Czernikowo;1139;538;538;14;524;47.23;2.60
86482;041503;Szkoła Podstawowa|Osówka| |87-632 Osówka;850;234;234;8;226;27.53;3.42
86483;041504;Zespół Szkół Nr 2|Grębocin|ul. Szkolna 4 |87-122 Grębocin;1031;588;588;9;579;57.03;1.53
86484;041504;Szkoła Podstawowa|Gronowo| |87-162 Lubicz;739;330;330;12;318;44.65;3.64
86485;041504;Zespół Szkół Nr 1|Lubicz Górny|ul. Piaskowa 23 |87-162 Lubicz;959;406;406;12;394;42.34;2.96
86486;041504;Szkoła Podstawowa|Lubicz Dolny|ul. Szkolna 7 |87-162 Lubicz;1143;518;518;10;508;45.32;1.93
86487;041504;Świetlica OSP|Rogówko|ul. Lubicka 29 |87-122 Grębocin;792;384;384;12;372;48.48;3.12
86488;041504;Świetlica wiejska|Brzeźno| |87-162 Lubicz;764;341;341;6;335;44.63;1.76
86489;041504;Szkoła Podstawowa|Młyniec Pierwszy|ul. Toruńska 10 |87-162 Lubicz;977;426;426;25;401;43.60;5.87
86490;041504;Przedszkole Publiczne|Lubicz Górny|ul. Piaskowa 2 |87-162 Lubicz;1031;513;513;21;492;49.76;4.09
86491;041504;Szkoła Podstawowa|Złotoria|ul. Pomorska 11 |87-124 Złotoria;1149;524;525;11;513;45.60;2.10
86492;041504;Sala Gimnastyczna Szkoły Podstawowej|Lubicz Dolny|ul. Toruńska 36a |87-162 Lubicz;1175;627;627;20;607;53.36;3.19
86493;041504;Szkoła Podstawowa|Złotoria|ul. Pomorska 11 |87-124 Złotoria;1641;939;939;16;923;57.22;1.70
86494;041504;Zespół Szkół Nr 2|Grębocin|ul. Szkolna 4 |87-122 Grębocin;993;569;569;6;563;57.30;1.05
86495;041504;Zespół Szkół Nr 1|Lubicz Górny|ul. Piaskowa 23 |87-162 Lubicz;916;472;472;10;462;51.53;2.12
86496;041504;Świetlica wiejska|Krobia|ul. Olimpijska 14 |87-162 Lubicz;1160;656;656;9;647;56.55;1.37
86497;041505;Szkoła Podstawowa|Warszewice|ul. Zawiszy Czarnego 2 |87-152 Łubianka;1440;672;672;35;637;46.67;5.21
86498;041505;Szkoła Podstawowa|Pigża|ul. Szkolna 14 |87-152 Łubianka;1002;425;425;18;407;42.42;4.24
86499;041505;Centrum Kultury|Łubianka|ul. Toruńska 4 |87-152 Łubianka;1146;657;657;17;640;57.33;2.59
86500;041505;Świetlica Wiejska|Bierzgłowo|ul. Ks. Z. Ziętarskiego 24 |87-152 Łubianka;772;358;358;6;352;46.37;1.68
86501;041505;Szkoła Podstawowa|Wybcz|ul. M. Konopnickiej 4 |87-152 Łubianka;779;288;288;4;284;36.97;1.39
86502;041506;Zespół Szkół Nr 2|Turzno|ul. Parkowa 4 |87-148 Łysomice;2065;883;883;21;862;42.76;2.38
86503;041506;Szkoła Podstawowa|Ostaszewo| |87-148 Łysomice;1624;602;602;20;582;37.07;3.32
86504;041506;Zespół Szkół Nr 1-Gimnazjum|Łysomice|ul. Warszawska 5 |87-148 Łysomice;1505;835;835;18;817;55.48;2.16
86505;041506;Filia Gminnej Biblioteki Publicznej|Lulkowo| |87-148 Łysomice;1012;439;439;10;429;43.38;2.28
86506;041506;Przedszkole Publiczne "Jelonek"|Papowo Toruńskie|ul. Warszawska 24 |87-148 Łysomice;1178;649;649;7;642;55.09;1.08
86507;041507;Zespół Szkół im. Janusza Korczaka|Brzozówka|ul. Szkolna 38 |87-123 Dobrzejewice;1448;813;813;29;784;56.15;3.57
86508;041507;Zespół Szkół im. Prymasa Stefana Kardynała Wyszyńskiego|Dobrzejewice| 57B |87-123 Dobrzejewice;1759;910;910;15;895;51.73;1.65
86509;041507;Szkoła Podstawowa im. Gen. J. H. Dąbrowskiego|Dobrzejewice| 57A |87-123 Dobrzejewice;1233;546;546;26;520;44.28;4.76
86510;041507;Szkoła Podstawowa im. Mikołaja Kopernika|Łążyn II| 43 |87-123 Dobrzejewice;2004;867;867;27;840;43.26;3.11
86511;041507;Świetlica Wiejska|Obrowo|ul. Aleja Lipowa 29 |87-126 Obrowo;1974;947;947;38;909;47.97;4.01
86512;041507;Zespół Szkół im.mjr H.Sucharskiego|Osiek nad Wisłą|ul. Leśna 1 |87-125 Osiek nad Wisłą;1854;975;975;32;943;52.59;3.28
86513;041507;Zespół Szkół im.mjr H.Sucharskiego|Osiek nad Wisłą|ul. Leśna 1 |87-125 Osiek nad Wisłą;1121;612;612;11;601;54.59;1.80
86514;041508;Szkoła Podstawowa|Mała Nieszawka|ul. Toruńska 64 |87-103 Toruń 5;944;553;553;10;543;58.58;1.81
86515;041508;Budynek byłego Gminnego Ośrodka Kultury|Mała Nieszawka|ul. Leśna 1 |87-103 Toruń 5;783;387;387;12;375;49.43;3.10
86516;041508;Szkoła Podstawowa|Cierpice|ul. Szkolna 9 |87-165 Cierpice;1006;491;491;14;477;48.81;2.85
86517;041508;Centrum Sportu i Rekreacji "Olender"|Wielka Nieszawka|ul. Toruńska 34/40 |87-165 Cierpice;719;397;397;11;386;55.22;2.77
86518;041508;Agroturystyka "Brzoza"|Brzoza|ul. Ciechocińska 23 |87-103 Toruń 5;134;53;53;0;53;39.55;0.00
86519;041508;Dom Pomocy Społecznej|Wielka Nieszawka|ul. Toruńska 18 |87-165 Cierpice;84;31;31;2;29;36.90;6.45
86520;041509;Zespół Szkół|Górsk|Szkolna 2 |87-134 Zławieś Wielka;2249;1005;1005;29;976;44.69;2.89
86521;041509;Szkoła Podstawowa|Łążyn| 16 |87-133 Zławieś Wielka;1329;537;537;34;503;40.41;6.33
86522;041509;Zespół Szkół|Rzęczkowo| 59 |87-133 Zławieś Wielka;972;362;362;17;345;37.24;4.70
86523;041509;Zespół Szkół|Zławieś Wielka|Szkolna 6 |87-134 Zławieś Wielka;2270;947;947;54;893;41.72;5.70
86524;041509;Szkoła Podstawowa|Przysiek|Leśna 1 |87-134 Zławieś Wielka;2117;1322;1322;14;1308;62.45;1.06
86525;041509;Szkoła|Czarnowo| 29 |87-134 Zławieś Wielka;1164;575;575;27;548;49.40;4.70
86526;041601;ŚWIETLICA WIEJSKA|ZDROJE| 89 |89-505 MAŁE GACNO;769;270;270;16;254;35.11;5.93
86527;041601;SZKOŁA PODSTAWOWA|IWIEC| 18 |89-512 IWIEC;904;314;314;9;305;34.73;2.87
86528;041601;SZKOŁA PODSTAWOWA|CEKCYN|SZKOLNA 8 |89-511 CEKCYN;906;287;287;9;278;31.68;3.14
86529;041601;SZKOŁA PODSTAWOWA|CEKCYN|SZKOLNA 8 |89-511 CEKCYN;652;268;268;11;257;41.10;4.10
86530;041601;GMINNY OŚRODEK KULTURY|Cekcyn|SZKOLNA 4 |89-511 CEKCYN;1024;515;515;20;495;50.29;3.88
86531;041601;REMIZA OSP|Cekcyn|OGRODOWA 17 |89-511 CEKCYN;1079;532;532;20;512;49.30;3.76
86532;041602;Zespół Szkół Szkoła Podstawowa im. Jana Pawła II w Gostycynie, Szkoła Filialna w Wielkim Mędromierzu|Wielki Mędromierz| 59 |89-520 GOSTYCYN;568;228;228;11;217;40.14;4.82
86533;041602;ŚWIETLICA WIEJSKA|Kamienica| 16 |89-520 GOSTYCYN;430;147;147;7;140;34.19;4.76
86534;041602;GMINNY OŚRODEK KULTURY|Gostycyn|UL. GŁÓWNA 35 |89-520 GOSTYCYN;631;249;249;7;242;39.46;2.81
86535;041602;ZESPÓŁ SZKÓŁ W GOSTYCYNIE|Gostycyn|UL. SĘPOLEŃSKA 12A |89-520 GOSTYCYN;870;385;385;14;371;44.25;3.64
86536;041602;SZKOŁA PODSTAWOWA|Pruszcz|DWORCOWA 33 |89-520 GOSTYCYN;904;436;436;12;424;48.23;2.75
86537;041602;WIEJSKI DOM KULTURY|Wielka Klonia| 13 |89-520 GOSTYCYN;730;235;235;10;225;32.19;4.26
86538;041603;ZESPÓŁ SZKÓŁ|KĘSOWO|UL. SZKOLNA 11 |89-506 KĘSOWO;694;296;296;20;276;42.65;6.76
86539;041603;ZESPÓŁ SZKÓŁ|KĘSOWO|UL.SZKOLNA 11 |89-506 KĘSOWO;449;160;160;10;150;35.63;6.25
86540;041603;SZKOŁA PODSTAWOWA|DROŻDZIENICA| 28 |89-506 KĘSOWO;744;255;255;13;242;34.27;5.10
86541;041603;ŚWIETLICA WIEJSKA|WIESZCZYCE| 20 |89-506 KĘSOWO;404;113;113;11;102;27.97;9.73
86542;041603;ZESPÓŁ SZKÓŁ|ŻALNO|UL. SZKOLNA 1 |89-506 KĘSOWO;755;361;361;20;341;47.81;5.54
86543;041603;ŚWIETLICA WIEJSKA|PIASTOSZYN|UL. GŁÓWNA 10 |89-506 KĘSOWO;469;179;179;14;165;38.17;7.82
86544;041604;Zespół Szkół w Lubiewie|Lubiewo|Wojska Polskiego 16 |89-526 Lubiewo;652;276;276;8;268;42.33;2.90
86545;041604;Zespół Szkół w Bysławiu|Bysław|Kwiatowa 9 |89-510 Bysław;639;293;293;13;280;45.85;4.44
86546;041604;Świetlica Wiejska|Bysławek| 51A |89-510 Bysław;822;363;363;9;354;44.16;2.48
86547;041604;Świetlica Wiejska|Sucha|Główna 19 |89-525 Sucha;580;250;250;21;229;43.10;8.40
86548;041604;Świetlica Wiejska|Klonowo| 21 |89-526 Lubiewo;486;166;166;15;151;34.16;9.04
86549;041604;Zespół Szkół w Lubiewie|Lubiewo|Wojska Polskiego 16 |89-526 Lubiewo;586;275;275;8;267;46.93;2.91
86550;041604;Zespół Szkół w Bysławiu|Bysław|Kwiatowa 9 |89-510 Bysław;862;337;337;21;316;39.10;6.23
86551;041605;ŚWIETLICA WIEJSKA|LUBOCIEŃ| 40 |89-530 ŚLIWICE;623;247;247;9;238;39.65;3.64
86552;041605;SZKOŁA PODSTAWOWA|LIŃSK| 37 |89-530 ŚLIWICE;867;338;338;29;309;38.99;8.58
86553;041605;SZKOŁA PODSTAWOWA|ŚLIWICZKI| 97 |89-530 ŚLIWICE;586;233;233;13;220;39.76;5.58
86554;041605;GMINNY OŚRODEK KULTURY|ŚLIWICE|DWORCOWA 39 |89-530 ŚLIWICE;894;406;406;18;388;45.41;4.43
86555;041605;SZKOŁA PODSTAWOWA|ŚLIWICE|SZKOLNA 9 |89-530 ŚLIWICE;727;365;365;13;352;50.21;3.56
86556;041605;GMINNY OŚRODEK KULTURY|ŚLIWICE|DWORCOWA 39 |89-530 ŚLIWICE;632;320;320;14;306;50.63;4.38
86557;041606;TUCHOLSKI OŚRODEK KULTURY|TUCHOLA|PLAC ZAMKOWY 8 |89-500 TUCHOLA;1175;541;541;16;525;46.04;2.96
86558;041606;SZKOŁA PODSTAWOWA NR 1|TUCHOLA|SZKOLNA 4 |89-500 TUCHOLA;1196;666;666;11;655;55.69;1.65
86559;041606;PRZEDSZKOLE NR1|TUCHOLA|BYDGOSKA 13B |89-500 TUCHOLA;921;492;492;14;478;53.42;2.85
86560;041606;ZESPÓŁ SZKÓŁ LICEALNYCH I TECHNICZNYCH|TUCHOLA|ŚWIECKA 89A |89-500 TUCHOLA;924;401;401;9;392;43.40;2.24
86561;041606;GIMNAZJUM NR 1|TUCHOLA|PIASTOWSKA 23 |89-500 TUCHOLA;1022;546;546;15;531;53.42;2.75
86562;041606;HALA WIDOWISKOWO-SPORTOWA|TUCHOLA|WARSZAWSKA 17 |89-500 TUCHOLA;1177;612;612;16;596;52.00;2.61
86563;041606;SZKOŁA PODSTAWOWA NR 3|TUCHOLA|POCZTOWA 10 |89-500 TUCHOLA;1210;552;552;10;542;45.62;1.81
86564;041606;ZESPÓŁ SZKÓŁ OGÓLNOKSZTAŁCĄCYCH|TUCHOLA|POCZTOWA 8A |89-500 TUCHOLA;1065;522;522;14;508;49.01;2.68
86565;041606;SZKOŁA PODSTAWOWA NR 5|TUCHOLA|ŚWIECKA 105 |89-500 TUCHOLA;1134;542;542;4;538;47.80;0.74
86566;041606;ŚWIETLICA WIEJSKA|BLADOWO| 5 |89-500 TUCHOLA;490;236;236;8;228;48.16;3.39
86567;041606;ŚWIETLICA WIEJSKA|MAŁY MĘDROMIERZ| 30 |89-500 TUCHOLA;445;172;172;13;159;38.65;7.56
86568;041606;SZKOŁA PODSTAWOWA|STOBNO| 33 |89-502 RACIĄŻ;757;229;229;15;214;30.25;6.55
86569;041606;DOM STRAŻAKA|KIEŁPIN| 57 |89-500 TUCHOLA;695;231;231;14;217;33.24;6.06
86570;041606;ŚWIETLICA WIEJSKA|WIELKA KOMORZA| 15 |89-500 TUCHOLA;296;96;96;6;90;32.43;6.25
86571;041606;ŚWIETLICA WIEJSKA|LEGBĄD|SZKOLNA 6 |89-504 LEGBĄD;1031;484;484;16;468;46.94;3.31
86572;041606;GIMNAZJUM NR 1|TUCHOLA|PIASTOWSKA 23 |89-500 TUCHOLA;1027;529;529;15;514;51.51;2.84
86573;041606;WIEJSKI DOM KULTURY|RACIĄŻ|WCZASOWA 1 |89-502 RACIĄŻ;1030;415;415;14;401;40.29;3.37
86574;041606;TUCHOLSKI OŚRODEK KULTURY|TUCHOLA|PLAC ZAMKOWY 8 |89-500 TUCHOLA;288;124;124;3;121;43.06;2.42
86575;041606;DOM POMOCY SPOŁECZNEJ|WYSOKA| 16 |89-502 RACIĄŻ;41;29;29;0;29;70.73;0.00
86576;041606;SZPITAL TUCHOLSKI SP. Z O.O.|TUCHOLA|NOWODWORSKIEGO 14-18 |89-500 TUCHOLA;86;37;37;3;34;43.02;8.11
86577;041701;Szkoła Podstawowa Nr 2|Wąbrzeźno|ul. Wolności 30 |87-200 Wąbrzeźno;753;271;271;11;260;35.99;4.06
86578;041701;Szkoła Podstawowa Nr 3|Wąbrzeźno|ul. Tysiąclecia 1 |87-200 Wąbrzeźno;1601;748;748;11;737;46.72;1.47
86579;041701;Przedszkole Miejskie "Bajka"|Wąbrzeźno|ul. Tysiąclecia 2a |87-200 Wąbrzeźno;659;376;376;8;368;57.06;2.13
86580;041701;Miejski Zakład Energetyki Cieplnej, Wodociągów i Kanalizacji Sp. z o.o.|Wąbrzeźno|ul. Tysiąclecia 8A |87-200 Wąbrzeźno;1487;672;672;19;653;45.19;2.83
86581;041701;Gimnazjum Nr 1 im. Ks. Kardynała Stefana Wyszyńskiego|Wąbrzeźno|ul. Wolności 11 |87-200 Wąbrzeźno;612;212;212;6;206;34.64;2.83
86582;041701;Wąbrzeski Dom Kultury|Wąbrzeźno|ul. Wolności 47 |87-200 Wąbrzeźno;1314;620;620;11;609;47.18;1.77
86583;041701;Zespół Szkół Zawodowych|Wąbrzeźno|ul. Królowej Jadwigi 9 |87-200 Wąbrzeźno;692;258;258;9;249;37.28;3.49
86584;041701;Centrum Kształcenia Praktycznego i Ustawicznego|Wąbrzeźno|ul. Staszica 2 |87-200 Wąbrzeźno;1505;570;570;26;544;37.87;4.56
86585;041701;Przedszkole Miejskie "Bajka"|Wąbrzeźno|ul. Żeromskiego 11 |87-200 Wąbrzeźno;1473;538;538;12;526;36.52;2.23
86586;041701;Komenda Powiatowa Państwowej Straży Pożarnej|Wąbrzeźno|ul. św. Floriana 6 |87-200 Wąbrzeźno;641;333;333;7;326;51.95;2.10
86587;041701;Niepubliczny Zakład Opieki Zdrowotnej Nowy Szpital Sp. z o.o.|Wąbrzeźno|ul. Wolności 27 |87-200 Wąbrzeźno;77;10;10;0;10;12.99;0.00
86588;041702;Zespół Szkół im. gen. J. Bema|Dębowa Łąka| |87-207 Dębowa Łąka;918;343;343;11;332;37.36;3.21
86589;041702;Szkoła Podstawowa|Łobdowo| |87-207 Dębowa Łąka;731;221;221;10;211;30.23;4.52
86590;041702;Szkoła Podstawowa|Wielkie Radowiska| |87-207 Dębowa Łąka;897;322;322;13;309;35.90;4.04
86591;041703;Gminny Ośrodek Kultury|Książki|Szkolna 4 |87-222 Książki;977;373;373;10;363;38.18;2.68
86592;041703;Szkoła Podstawowa|Książki|ul. Szkolna 6 |87-222 Książki;985;373;373;25;348;37.87;6.70
86593;041703;Świetlica Wiejska|Łopatki| 42 |87-222 Książki;756;248;248;15;233;32.80;6.05
86594;041703;Świetlica Wiejska|Osieczek| 187a |87-222 Książki;658;223;223;18;205;33.89;8.07
86595;041704;Szkoła Podstawowa|Płużnica| |87-214 Płużnica;782;339;339;11;328;43.35;3.24
86596;041704;Szkoła Podstawowa|Płużnica| |87-214 Płużnica;772;259;259;12;247;33.55;4.63
86597;041704;Gimnazjum Publiczne|Nowa Wieś Królewska| |87-214 Płużnica;1222;430;430;30;400;35.19;6.98
86598;041704;Remizo-świetlica|Błędowo| |87-214 Płużnica;1113;360;360;22;338;32.35;6.11
86599;041705;Szkoła Podstawowa|Jarantowice| 143 |87-200 Wąbrzeźno;843;304;304;13;291;36.06;4.28
86600;041705;Zespół Szkół|Ryńsk|ul. Szkolna 4 |87-213 Ryńsk;1747;668;668;31;637;38.24;4.64
86601;041705;Świetlica|Łabędź| 1 |87-200 Wąbrzeźno;1020;305;305;10;295;29.90;3.28
86602;041705;Świetlica|Wałycz|ul. Lecha Mączyńskiego 17 |87-200 Wąbrzeźno;799;326;326;17;309;40.80;5.21
86603;041705;Zespół Szkół|Zieleń| 56 |87-200 Wąbrzeźno;1193;410;410;20;390;34.37;4.88
86604;041705;Zespół Szkół|Myśliwiec| 3 |87-200 Wąbrzeźno;704;247;247;10;237;35.09;4.05
86605;041705;Świetlica|Czystochleb| 11 |87-200 Wąbrzeźno;506;171;171;10;161;33.79;5.85
86606;041801;Zespół Szkół CKR|Kowal|ul. K.Wielkiego 11 |87-820 Kowal;1031;429;429;16;413;41.61;3.73
86607;041801;Świetlica na dworcu autobusowym|Kowal|ul. K. Wielkiego 10 |87-820 Kowal;945;380;380;28;352;40.21;7.37
86608;041801;Remiza OSP|Kowal|Zamkowa 4 |87-820 Kowal;899;413;413;14;399;45.94;3.39
86609;041801;Świetlica Domu Pomocy Społecznej w Kowalu|Kowal|Kopernika 19 |87-820 Kowal;68;52;52;5;47;76.47;9.62
86610;041802;Świetlica Szkoły Podstawowej|Baruchowo| 19A |87-821 Baruchowo;709;312;312;17;295;44.01;5.45
86611;041802;Świetlica Gimnazjum|Baruchowo| 19A |87-821 Baruchowo;715;259;259;10;249;36.22;3.86
86612;041802;Gminny Ośrodek Kultury Sportu i Rekreacji|Baruchowo| 19B |87-821 Baruchowo;579;190;190;7;183;32.82;3.68
86613;041802;Środowiskowy Dom Samopomocy|Czarne| 11 |87-821 Baruchowo;845;274;274;11;263;32.43;4.01
86614;041802;Dom Pomocy Społecznej|Kurowo-Parcele|Kurowo-Parcele 44 |87-821 Baruchowo;40;28;28;0;28;70.00;0.00
86615;041803;Szkoła Podstawowa w Boniewie|Boniewo|ul.Szkolna 32 |87-851 Boniewo;777;278;278;13;265;35.78;4.68
86616;041803;Publiczne Gimnazjum w Boniewie|Boniewo|Szkolna 32 |87-851 Boniewo;635;230;230;9;221;36.22;3.91
86617;041803;Remiza OSP w Lubominie|Lubomin| 52 |87-851 Boniewo;464;189;189;8;181;40.73;4.23
86618;041803;Szkoła Podstawowa w Osieczu Małym|Osiecz Mały| 32 |87-851 Boniewo;578;204;204;8;196;35.29;3.92
86619;041803;Świetlica wiejska w Kaniewie|Kaniewo| 20 |87-890 Lubraniec;344;138;138;5;133;40.12;3.62
86620;041804;Szkoła Podstawowa Nr 1|Brześć Kujawski|ul.H.Sawickiej 21 |87-880 Brześć Kujawski;1159;528;528;5;523;45.56;0.95
86621;041804;Szkoła Podstawowa Nr 2|Brześć Kujawski|ul.Konarskiego 63 |87-880 Brześć Kujawski;1522;553;553;20;533;36.33;3.62
86622;041804;Brzeskie Centrum Kultury|Brześć Kujawski|ul.Narutowicza 15 |87-880 Brześć Kujawski;1053;400;400;11;389;37.99;2.75
86623;041804;Gimnazjum Nr 2|Wieniec|ul.Szkolna 1 |87-880 Brześć Kujawski;1749;757;757;34;723;43.28;4.49
86624;041804;Szkoła Podstawowa|Brzezie| 63 |87-880 Brześć Kujawski;815;266;266;11;255;32.64;4.14
86625;041804;Szkoła Podstawowa Nr 2|Brześć Kujawski|ul. Konarskiego 63 |87-880 Brześć Kujawski;639;184;184;7;177;28.79;3.80
86626;041804;Internat ZSR|Stary Brześć| 14 |87-880 Brześć Kujawski;714;263;263;9;254;36.83;3.42
86627;041804;Szkoła Podstawowa|Kąkowa Wola| 22 |87-880 Brześć Kujawski;508;202;202;3;199;39.76;1.49
86628;041804;Szkoła Podstawowa Nr 1|Brześć Kujawski|Hanki Sawickiej 21 |87-880 Brześć Kujawski;1125;386;386;13;373;34.31;3.37
86629;041805;Gimnazjum|Choceń|Sikorskiego 12 |87-850 Choceń;1455;538;538;28;510;36.98;5.20
86630;041805;Gimnazjum|Choceń|Sikorskiego 12 |87-850 Choceń;946;284;284;10;274;30.02;3.52
86631;041805;Szkoła Podstawowa|Śmiłowice| 98 |87-850 Choceń;863;304;304;12;292;35.23;3.95
86632;041805;Przedszkole|Czerniewice|Świętego Antoniego 14 |87-850 Choceń;1159;400;400;22;378;34.51;5.50
86633;041805;Budynek byłej szkoły|Lutobórz| 40 |87-850 Choceń;418;99;99;12;87;23.68;12.12
86634;041805;Budynek byłej szkoły|Szczytno| 32 |87-850 Choceń;411;97;97;17;80;23.60;17.53
86635;041805;Remiza OSP|Wichrowice| 57 |87-850 Choceń;444;129;129;3;126;29.05;2.33
86636;041805;Szkoła Podstawowa|Wilkowice| 35 |87-850 Choceń;803;249;249;18;231;31.01;7.23
86637;041805;Świetlica Domu Pomocy Społecznej w Wilkowiczkach|Wilkowiczki| 25 |87-850 Choceń;54;27;27;6;21;50.00;22.22
86638;041806;Szkoła Podstawowa|Chodecz|Waryńskiego 20 |87-860 Chodecz;974;441;441;22;419;45.28;4.99
86639;041806;Szkoła Podstawowa|Chodecz|Waryńskiego 20 |87-860 Chodecz;611;256;256;4;252;41.90;1.56
86640;041806;Zespół Szkół im. Władysława Reymonta|Chodecz|Kaliska 9-11 |87-860 Chodecz;690;198;198;15;183;28.70;7.58
86641;041806;Szkoła Podstawowa|Chodecz|Waryńskiego 20 |87-860 Chodecz;1070;286;286;10;276;26.73;3.50
86642;041806;Szkoła Podstawowa|Chodecz|Waryńskiego 20 |87-860 Chodecz;726;169;169;11;158;23.28;6.51
86643;041806;Szkoła Podstawowa|Cetty| 6A |87-860 Chodecz;731;198;198;8;190;27.09;4.04
86644;041806;Szkoła Podstawowa|Zalesie| 38 |87-860 Chodecz;316;88;88;5;83;27.85;5.68
86645;041807;Publiczna Szkoła Podstawowa|Szpetal Górny|ul. Szkolna 1 |87-811 Fabianki;1762;938;938;14;924;53.23;1.49
86646;041807;Publiczna Szkoła Podstawowa|Cyprianka| 107 |87-811 Fabianki;1688;539;539;19;520;31.93;3.53
86647;041807;Zespół Szkół Publicznych|Nasiegniewo| 68 |87-811 Fabianki;1373;546;546;15;531;39.77;2.75
86648;041807;Publiczna Szkoła Podstawowa|Fabianki| 1 |87-811 Fabianki;1468;505;505;27;478;34.40;5.35
86649;041807;Publiczne Gimnazjum|Fabianki| 1 |87-811 Fabianki;1385;560;560;16;544;40.43;2.86
86650;041808;Szkoła Podstawowa Nr 1|Izbica Kujawska|ul.Tymieniecka 1 |87-865 Izbica Kujawska;1299;512;512;20;492;39.41;3.91
86651;041808;Zespół Szkół|Izbica Kujawska|ul.Nowomiejska 5 |87-865 Izbica Kujawska;1345;441;441;25;416;32.79;5.67
86652;041808;Gimnazjum|Izbica Kujawska|ul.Nowomiejska 3 |87-865 Izbica Kujawska;734;242;242;16;226;32.97;6.61
86653;041808;Zespół Szkół w Błennie|Błenna| 2 |87-865 Izbica Kujawska;1109;355;355;23;332;32.01;6.48
86654;041808;Świetlica SM "Zgoda"|Izbica Kujawska|ul.Polna 1a |87-865 Izbica Kujawska;870;309;309;15;294;35.52;4.85
86655;041808;Gimnazjum|Izbica Kujawska|ul.Nowomiejska 3 |87-865 Izbica Kujawska;830;282;282;9;273;33.98;3.19
86656;041809;Urząd Gminy w Kowalu|Kowal|ul.Piwna 33 |87-820 Kowal;1256;481;481;32;449;38.30;6.65
86657;041809;Świetlica Wiejska w Grabkowie|Grabkowo| 61 |87-820 Kowal;704;256;256;16;240;36.36;6.25
86658;041809;Niepubliczna Szkoła Podstawowa Galileo Nr 1 w Nakonowie|Nakonowo| 31 |87-853 Kruszyn;447;171;171;9;162;38.26;5.26
86659;041809;Zespół Szkół w Grabkowie Szkoła Podstawowa im. Stanisława Staszica w Grabkowie Szkoła Filialna w Więsławicach|Więsławice| 17 |87-820 Kowal;811;265;265;7;258;32.68;2.64
86660;041810;Świetlica Wiejska w Gąbinku|Gąbinek| |87-732 Lubanie;636;201;201;7;194;31.60;3.48
86661;041810;Gminny Ośrodek Kultury w Lubaniu|Lubanie| 17 |87-732 Lubanie;983;444;444;18;426;45.17;4.05
86662;041810;Szkoła Podstawowa w Lubaniu|Lubanie| 13 |87-732 Lubanie;822;359;359;19;340;43.67;5.29
86663;041810;Szkoła Podstawowa w Przywieczerzynie|Przywieczerzyn| 27 |87-732 Lubanie;761;247;247;15;232;32.46;6.07
86664;041810;Świetlica Wiejska w Ustroniu|Ustronie| 8 |87-732 Lubanie;530;207;207;6;201;39.06;2.90
86665;041811;Ośrodek Kultury w Lubieniu Kujawskim|Lubień Kujawski|ul.Wojska Polskiego 22 |87-840 Lubień Kujawski;1137;560;560;15;545;49.25;2.68
86666;041811;Szkoła Podstawowa w Kaliskach|Gole| 7A |87-840 Lubień Kujawski;753;248;248;7;241;32.93;2.82
86667;041811;Ośrodek Kultury w Lubieniu Kujawskim|Lubień Kujawski|ul.Wojska Polskiego 22 |87-840 Lubień Kujawski;864;303;303;12;291;35.07;3.96
86668;041811;Remiza Ochotniczej Straży Pożarnej w Bilnie|Bilno| 9A |87-840 Lubień Kujawski;456;105;105;11;94;23.03;10.48
86669;041811;Remiza Ochotniczej Straży Pożarnej w Morzycach|Morzyce| 24 |87-840 Lubień Kujawski;419;101;101;5;96;24.11;4.95
86670;041811;Szkoła Podstawowa w Kanibrodzie|Kanibród| 27 |87-840 Lubień Kujawski;677;176;176;6;170;26.00;3.41
86671;041811;Zespół Szkół w Kłóbce|Kłóbka| 9 |87-840 Lubień Kujawski;491;184;184;15;169;37.47;8.15
86672;041811;Świetlica wiejska w Rzeżewie|Rzeżewo Małe| 65 |87-840 Lubień Kujawski;455;116;116;8;108;25.49;6.90
86673;041811;Świetlica w Kamiennej|Kamienna| 8A |87-840 Lubień Kujawski;777;251;251;14;237;32.30;5.58
86674;041811;Dom Pomocy Społecznej w Rzeżewie|Rzeżewo| 65a |87-840 Lubień Kujawski;21;15;15;2;13;71.43;13.33
86675;041812;Lubranieckie Centrum Dziedzictwa Kulturowego|Lubraniec|Brzeska 10 |87-890 Lubraniec;1492;668;668;39;629;44.77;5.84
86676;041812;Zespół Szkół|Lubraniec|ul.Nowa 6 |87-890 Lubraniec;1612;734;734;24;710;45.53;3.27
86677;041812;Zespół Szkół|Lubraniec|ul.Brzeska 51 |87-890 Lubraniec;1698;628;628;37;591;36.98;5.89
86678;041812;Świetlica Wiejska w Dąbiu Kujawskim|Dąbie Kujawskie| 41 |87-890 Lubraniec;597;196;196;15;181;32.83;7.65
86679;041812;Publiczna Szkoła Podstawowa w Zgłowiączce|Zgłowiączka| 30 |87-890 Lubraniec;1483;649;649;35;614;43.76;5.39
86680;041812;Publiczna Szkoła Podstawowa w Sarnowie|Sarnowo| 2 |87-865 Izbica Kujawska;561;240;240;10;230;42.78;4.17
86681;041812;Zespół Szkół w Kłobi|Kłobia| 29 |87-890 Lubraniec;608;277;277;12;265;45.56;4.33
86682;041813;Świetlica Wiejska w Dębie Polskim|Dąb Polski|Sasankowa 8 |87-815 Smólnik;291;125;125;1;124;42.96;0.80
86683;041813;Zespół Szkół z Oddziałami Integracyjnymi w Smólniku|Smólnik| 17 |87-815 Smólnik;908;292;292;24;268;32.16;8.22
86684;041813;Szkoła Podstawowa i Gimnazjum Stowarzyszenia Przyjaciół Szkół Katolickich w Modzerowie|Modzerowo| 53A |87-800 Włocławek;830;306;306;17;289;36.87;5.56
86685;041813;Szkoła Podstawowa Stowarzyszenia Przyjaciół Szkół Katolickich w Warząchewce Polskiej|Warząchewka Polska| 37 |87-809 Włocławek;582;253;253;12;241;43.47;4.74
86686;041813;Zespół Szkół z Oddziałami Integracyjnymi w Kruszynie|Kruszyn|Szkolna 15 |87-853 Kruszyn;1323;614;614;24;590;46.41;3.91
86687;041813;Zespół Szkół z Oddziałami Integracyjnymi w Kruszynie|Kruszyn|Szkolna 15 |87-853 Kruszyn;1706;774;774;37;737;45.37;4.78
86688;041901;SZKOŁA PODSTAWOWA NR 1|BARCIN|PLAC 1 MAJA 8 |88-190 BARCIN;1026;464;464;22;442;45.22;4.74
86689;041901;GIMNAZJUM NR 1|BARCIN|UL. POLNA 1 |88-190 BARCIN;892;438;438;16;422;49.10;3.65
86690;041901;MIEJSKI DOM KULTURY|BARCIN|UL. MOGILEŃSKA 3 |88-190 BARCIN;588;246;246;11;235;41.84;4.47
86691;041901;MIEJSKI DOM KULTURY|BARCIN|UL. MOGILEŃSKA 3 |88-190 BARCIN;738;323;323;12;311;43.77;3.72
86692;041901;GIMNAZJUM NR 1|BARCIN|UL. POLNA 1 |88-190 BARCIN;720;336;336;13;323;46.67;3.87
86693;041901;PRZEDSZKOLE NR 2|BARCIN|UL. ARTYLERZYSTÓW 3 |88-190 BARCIN;710;329;329;14;315;46.34;4.26
86694;041901;SZKOŁA PODSTAWOWA NR 2|BARCIN|UL. ARTYLERZYSTÓW 13 |88-190 BARCIN;642;310;310;11;299;48.29;3.55
86695;041901;SZKOŁA PODSTAWOWA NR 2|BARCIN|UL. ARTYLERZYSTÓW 13 |88-190 BARCIN;669;309;309;3;306;46.19;0.97
86696;041901;ZESPÓŁ PUBLICZNYCH SZKÓŁ|PIECHCIN|UL. 11 LISTOPADA 5 |88-192 PIECHCIN;730;284;284;7;277;38.90;2.46
86697;041901;ZESPÓŁ PUBLICZNYCH SZKÓŁ|PIECHCIN|UL. 11 LISTOPADA 5 |88-192 PIECHCIN;820;357;357;15;342;43.54;4.20
86698;041901;BIBLIOTEKA PUBLICZNA MIASTA I GMINY BARCIN FILIA W PIECHCINIE|PIECHCIN|UL. 11 LISTOPADA 1c |88-192 PIECHCIN;843;203;203;18;185;24.08;8.87
86699;041901;ŚWIETLICA WIEJSKA|KROTOSZYN| 61 |88-190 BARCIN;620;201;201;12;189;32.42;5.97
86700;041901;STANICA ŻEGLARSKA '"NEPTUN"|BARCIN|UL. WYZWOLENIA 16 |88-190 BARCIN;869;334;334;10;324;38.43;2.99
86701;041901;SZKOŁA PODSTAWOWA NR 1|BARCIN|UL. PLAC 1 MAJA 8 |88-190 BARCIN;965;360;360;13;347;37.31;3.61
86702;041901;SZKOŁA PODSTAWOWA|MAMLICZ| 72 |88-190 BARCIN;782;254;254;9;245;32.48;3.54
86703;041902;Zespół Publicznych Szkół|Gąsawa|ul. Leszka Białego 6 |88-410 Gąsawa;942;381;381;14;367;40.45;3.67
86704;041902;Gminny Ośrodek Kultury|Gąsawa|ul. Żnińska 19 |88-410 Gąsawa;844;391;391;9;382;46.33;2.30
86705;041902;Koło Łowieckie Nr 119 "Szarak"|Biskupin| 26a |88-410 Gąsawa;794;330;330;13;317;41.56;3.94
86706;041902;Świetlica Wiejska|Pniewy| 4A |88-410 Gąsawa;271;98;98;4;94;36.16;4.08
86707;041902;Szkoła Podstawowa|Laski Wielkie| 25 |88-410 Gąsawa;792;318;318;18;300;40.15;5.66
86708;041902;Oddział Zamiejscowy Szkoły Podstawowej w Gąsawie|Szelejewo| 19 |88-410 Gąsawa;613;258;258;20;238;42.09;7.75
86709;041903;Szkoła Podstawowa|Janowiec Wielkopolski|ul. Szkolna 8 |88-430 Janowiec Wielkopolski;895;419;419;12;407;46.82;2.86
86710;041903;Miejsko-Gminny Ośrodek Kultury|Janowiec Wielkopolski|ul. Powstańców Wielkopolskich 16 |88-430 Janowiec Wielkopolski;897;371;371;15;356;41.36;4.04
86711;041903;Miejsko-Gminny Ośrodek Kultury|Janowiec Wielkopolski|ul. Powstańców Wielkopolskich 16 |88-430 Janowiec Wielkopolski;523;266;266;12;254;50.86;4.51
86712;041903;Zespół Szkół Niepublicznych|Janowiec Wielkopolski|ul. 3 Maja 30 |88-430 Janowiec Wielkopolski;945;432;432;8;424;45.71;1.85
86713;041903;Budynek Gminy Janowiec Wielkopolski (Świetlica wiejska)|Juncewo| 27 |88-430 Janowiec Wielkopolski;479;182;182;13;169;38.00;7.14
86714;041903;Szkoła Podstawowa|Świątkowo| 59 |88-430 Janowiec Wielkopolski;426;177;177;11;166;41.55;6.21
86715;041903;Szkoła Podstawowa|Żerniki| 32 |88-430 Janowiec Wielkopolski;465;179;179;10;169;38.49;5.59
86716;041903;Szkoła Podstawowa|Żerniki| 32 |88-430 Janowiec Wielkopolski;238;66;66;2;64;27.73;3.03
86717;041903;Biblioteka Publiczna im. Stefanii Popiołek|Janowiec Wielkopolski|ul. Gnieźnieńska 3a |88-430 Janowiec Wielkopolski;270;99;99;3;96;36.67;3.03
86718;041903;Zespół Szkół Niepublicznych (sala gimnastyczna)|Janowiec Wielkopolski|ul. 3 Maja 30 |88-430 Janowiec Wielkopolski;534;149;149;10;139;27.90;6.71
86719;041903;Publiczne Gimnazjum|Janowiec Wielkopolski|ul. Szkolna 8 |88-430 Janowiec Wielkopolski;580;245;245;7;238;42.24;2.86
86720;041903;Budynek Gminy Janowiec Wielkopolski Niepubliczna Szkoła Postawowa|Sarbinowo Drugie| 11 |88-430 Janowiec Wielkopolski;518;162;162;13;149;31.27;8.02
86721;041903;Budynek Gminy Janowiec Wielkopolski Niepubliczna Szkoła Podstawowa|Laskowo| 26 |88-430 Janowiec Wielkopolski;475;167;167;10;157;35.16;5.99
86722;041903;Dom Pomocy Społecznej|Tonowo| 52 |88-430 Janowiec Wielkopolski;51;44;44;2;42;86.27;4.55
86723;041904;ZESPÓŁ SZKÓŁ - GIMNAZJUM PUBLICZNE|ŁABISZYN|UL. NADNOTECKA 2 |89-210 ŁABISZYN;1000;441;441;22;419;44.10;4.99
86724;041904;ZESPÓŁ SZKÓŁ - SZKOŁA PODSTAWOWA|ŁABISZYN|UL. POZNAŃSKA 12 |89-210 ŁABISZYN;1029;429;429;19;410;41.69;4.43
86725;041904;Zespół Szkół - Przedszkole Miejskie|Łabiszyn|Poznańska 9 |89-210 Łabiszyn;1057;463;463;19;444;43.80;4.10
86726;041904;Łabiszyński Dom Kultury|Łabiszyn|Parkowa 1 |89-210 Łabiszyn;517;216;216;6;210;41.78;2.78
86727;041904;ZESPÓŁ SZKÓŁ|LUBOSTROŃ| |89-210 ŁABISZYN;569;226;226;15;211;39.72;6.64
86728;041904;ŚWIETLICA ŚRODOWISKOWA|JABŁÓWKO| |89-210 ŁABISZYN;470;174;174;11;163;37.02;6.32
86729;041904;NIEPUBLICZNA SZKOŁA PODSTAWOWA|NOWE DĄBIE| |89-210 ŁABISZYN;650;267;267;21;246;41.08;7.87
86730;041904;ŚWIETLICA ŚRODOWISKOWA WŁADYSŁAWOWO|WŁADYSŁAWOWO| |89-210 ŁABISZYN;579;242;242;6;236;41.80;2.48
86731;041904;ŚWIETLICA ŚRODOWISKOWA|JEŻEWO| |89-210 ŁABISZYN;427;166;166;3;163;38.88;1.81
86732;041904;SZKOŁA PODSTAWOWA|Ojrzanowo| |89-210 ŁABISZYN;527;180;180;13;167;34.16;7.22
86733;041904;Świetlica Środowiskowa|Załachowo| |89-210 Łabiszyn;452;137;137;4;133;30.31;2.92
86734;041904;Zespół Szkół|Lubostroń| |89-210 Łabiszyn;142;44;44;3;41;30.99;6.82
86735;041904;Łabiszyński Dom Kultury|Łabiszyn|Parkowa 1 |89-210 Łabiszyn;344;125;125;4;121;36.34;3.20
86736;041905;Gminny Dom Kultury w Rogowie|Rogowo|ul. Kościelna 4a |88-420 Rogowo;1021;533;533;18;515;52.20;3.38
86737;041905;Zespół Publicznych Szkół w Rogowie|Rogowo|ul. Szkolna 7 |88-420 Rogowo;884;378;378;14;364;42.76;3.70
86738;041905;Świetlica Kółka Rolniczego w Czewujewie|Czewujewo| 44 |88-420 Rogowo;632;252;252;20;232;39.87;7.94
86739;041905;Szkoła Podstawowa w Lubczu|Lubcz| 22 |88-420 Rogowo;818;323;323;25;298;39.49;7.74
86740;041905;Zespół Publicznych Szkół w Gościeszynie|Gościeszyn| 20 |88-420 Rogowo;760;320;320;17;303;42.11;5.31
86741;041905;Świetlica Spółdzielni Lokatorsko-Własnościowej w Złotnikach|Złotniki| 14 |88-420 Rogowo;842;298;298;13;285;35.39;4.36
86742;041905;Świetlica wiejska w Skórkach|Skórki| 12 |88-420 Rogowo;600;204;204;14;190;34.00;6.86
86743;041906;Publiczne Gimnazjum Nr 1 ul. 1 Stycznia 17, Żnin|Żnin|ul. 1 Stycznia 17 |88-400 Żnin;838;401;401;10;391;47.85;2.49
86744;041906;Przedszkole Miejskie Nr 1, ul.Browarowa 16, Żnin|Żnin|ul. Browarowa 16 |88-400 Żnin;1082;560;560;13;547;51.76;2.32
86745;041906;Zespół Szkół Ponadgimnazjalnych, ul. Browarowa 14, Żnin|Żnin|ul. Browarowa 14 |88-400 Żnin;1039;551;551;13;538;53.03;2.36
86746;041906;Spółdzielnia Mieszkaniowa, ul. Kopernika 5a, Żnin|Żnin|ul. Kopernika 5a |88-400 Żnin;817;430;430;9;421;52.63;2.09
86747;041906;Szkoła Podstawowa Nr 2, ul. Wandy Pieniężnej 19, Żnin|Żnin|ul. Wandy Pieniężnej 19 |88-400 Żnin;834;393;393;9;384;47.12;2.29
86748;041906;Szkoła Podstawowa Nr 2, ul. Wandy Pieniężnej 19, Żnin|Żnin|ul. Wandy Pieniężnej 19 |88-400 Żnin;1097;546;546;16;530;49.77;2.93
86749;041906;Zespół Szkół Specjalnych, ul. Mickiewicza 32, Żnin|Żnin|ul. Mickiewicza 32 |88-400 Żnin;1112;548;548;19;529;49.28;3.47
86750;041906;Zespół Szkół Ekonomiczno-Handlowych, ul. Śniadeckich 18, Żnin|Żnin|ul. Śniadeckich 18 |88-400 Żnin;921;402;402;21;381;43.65;5.22
86751;041906;Zespół Publicznych Szkół Nr 1, ul. Szkolna 4, Żnin|Żnin|ul. Szkolna 4 |88-400 Żnin;910;437;437;12;425;48.02;2.75
86752;041906;Przedszkole Miejskie Nr 2, Budynek A, ul. Klemensa Janickiego 10, Żnin|Żnin|ul. Klemensa Janickiego 10 |88-400 Żnin;980;396;396;13;383;40.41;3.28
86753;041906;Przedszkole Miejskie Nr 2, Budynek B, ul. Jasna 5, Żnin|Żnin|ul. Jasna 5 |88-400 Żnin;911;461;461;22;439;50.60;4.77
86754;041906;Miejski Ośrodek Sportu, ul. Gnieźnieńska 7, Żnin|Żnin|ul. Gnieźnieńska 7 |88-400 Żnin;985;469;469;14;455;47.61;2.99
86755;041906;Budynek Gminy Żnin, Niepubliczna Szkoła Podstawowa Gorzyce 60|Gorzyce|Gorzyce 60 |88-400 Żnin;790;334;334;16;318;42.28;4.79
86756;041906;Przedsiębiorstwo Rolno-Przetwórcze "Brzysko-Rol", Brzyskorzystewko 1|Brzyskorzystewko|Brzyskorzystewko 1 |88-400 Żnin;1012;339;339;17;322;33.50;5.01
86757;041906;Miejska i Powiatowa Biblioteka Publiczna, ul. Sienkiewicza 4,Żnin|Żnin|ul. Sienkiewicza 4 |88-400 Żnin;643;266;266;9;257;41.37;3.38
86758;041906;Szkoła Podstawowa Januszkowo 20|Januszkowo|Januszkowo 20 |88-400 Żnin;1014;413;413;18;395;40.73;4.36
86759;041906;Budynek Gminy Żnin (świetlica wiejska) Jadowniki Rycerskie 18A|Jadowniki Rycerskie|Jadowniki Rycerskie 18A |88-400 Żnin;709;245;245;13;232;34.56;5.31
86760;041906;Budynek Gminy Żnin (świetlica wiejska) Podgórzyn 5|Podgórzyn|Podgórzyn 5 |88-400 Żnin;1047;513;513;16;497;49.00;3.12
86761;041906;I Liceum Ogólnokształcące, ul. Sienkiewicza 1, Żnin|Żnin|ul. Sienkiewicza 1 |88-400 Żnin;832;361;361;13;348;43.39;3.60
86762;041906;Szkoła Podstawowa Słębowo, Filia w Cerekwicy, Cerekwica 20|Cerekwica|Cerekwica 20 |88-400 Żnin;1002;325;325;19;306;32.44;5.85
86763;041906;Szkoła Podstawowa Słębowo 1|Słębowo|Słębowo 1 |88-400 Żnin;915;321;321;16;305;35.08;4.98
86764;041906;Pałuckie Centrum Zdrowia Sp z o.o. NZOZ w Żninie, ul. Szpitalna 30, Żnin|Żnin|Szpitalna 30 |88-400 Żnin;46;15;15;1;14;32.61;6.67
86765;041906;Dom Pomocy Społecznej w Podobowicach|Podobowicach| 49 |88-400 Żnin;69;33;33;2;31;47.83;6.06
86766;046101;Siedziba Rady Osiedla "Piaski"|Bydgoszcz|ul. Drzycimska 7 |85-555 Bydgoszcz;1933;1207;1207;12;1195;62.44;0.99
86767;046101;Gimnazjum Nr 28|Bydgoszcz|ul. Żeglarska 67 |85-529 Bydgoszcz;1030;595;595;16;579;57.77;2.69
86768;046101;Szkoła Podstawowa Nr 36|Bydgoszcz|ul. Średnia 98 |85-554 Bydgoszcz;2078;1189;1189;17;1172;57.22;1.43
86769;046101;Specjalny Ośrodek Szkolno- Wychowawczy Nr 3 im. Marii Grzegorzewskiej|Bydgoszcz|ul. Graniczna 12 |85-201 Bydgoszcz;1155;564;564;6;558;48.83;1.06
86770;046101;Szkoła Podstawowa Nr 10|Bydgoszcz|ul. Śląska 7 |85-235 Bydgoszcz;1002;383;383;11;372;38.22;2.87
86771;046101;Szkoła Podstawowa Nr 10|Bydgoszcz|ul. Śląska 7 |85-235 Bydgoszcz;1608;824;824;15;809;51.24;1.82
86772;046101;Zespół Szkół Nr 6|Bydgoszcz|ul. Staroszkolna 12 |85-209 Bydgoszcz;1666;607;607;16;591;36.43;2.64
86773;046101;Zespół Szkół Nr 6|Bydgoszcz|ul. Staroszkolna 12 |85-209 Bydgoszcz;1877;896;896;9;887;47.74;1.00
86774;046101;Zespół Szkół Ogólnokształcących Nr 3|Bydgoszcz|ul. Nowogrodzka 3 |85-208 Bydgoszcz;1020;393;393;10;383;38.53;2.54
86775;046101;Zespół Szkół Nr 16|Bydgoszcz|ul. Koronowska 74 |85-405 Bydgoszcz;2280;1288;1288;16;1272;56.49;1.24
86776;046101;Uniwersytet Kazimierza Wielkiego w Bydgoszczy|Bydgoszcz|ul. Mińska 15 |85-428 Bydgoszcz;955;540;540;4;536;56.54;0.74
86777;046101;Zespół Szkół Nr 16|Bydgoszcz|ul. Koronowska 74 |85-405 Bydgoszcz;1876;1100;1100;19;1081;58.64;1.73
86778;046101;Zespół Szkół Nr 16|Bydgoszcz|ul. Koronowska 74 |85-405 Bydgoszcz;2131;1301;1301;12;1289;61.05;0.92
86779;046101;Zespół Szkół Nr 22|Bydgoszcz|ul. Opławiec 157 |85-469 Bydgoszcz;1509;881;881;7;874;58.38;0.79
86780;046101;Zespół Szkół Nr 24|Bydgoszcz|Puszczykowa 11 |85-446 Bydgoszcz;2216;1364;1364;16;1348;61.55;1.17
86781;046101;Zespół Szkół Nr 27|Bydgoszcz|Sardynkowa 7 |85-435 Bydgoszcz;1896;1235;1235;33;1202;65.14;2.67
86782;046101;Zespół Szkół Nr 24|Bydgoszcz|Puszczykowa 11 |85-446 Bydgoszcz;1691;906;906;23;883;53.58;2.54
86783;046101;Zespół Szkół Nr 27|Bydgoszcz|Sardynkowa 7 |85-435 Bydgoszcz;1816;1200;1200;12;1188;66.08;1.00
86784;046101;Zespół Szkół Nr 27|Bydgoszcz|Sardynkowa 7 |85-435 Bydgoszcz;1262;824;824;6;818;65.29;0.73
86785;046101;Zespół Szkół Nr 27|Bydgoszcz|Sardynkowa 7 |85-435 Bydgoszcz;1749;1039;1039;19;1020;59.41;1.83
86786;046101;Zespół Szkół Nr 15 Mistrzostwa Sportowego|Bydgoszcz|Czerkaska 8 |85-641 Bydgoszcz;823;514;514;7;507;62.45;1.36
86787;046101;Zespół Szkół Ogólnokształcących Nr 7|Bydgoszcz|11 Listopada 4 |85-643 Bydgoszcz;1366;819;819;7;812;59.96;0.85
86788;046101;Zespół Szkół Ogólnokształcących Nr 7|Bydgoszcz|11 Listopada 4 |85-643 Bydgoszcz;1421;783;783;14;769;55.10;1.79
86789;046101;Zespół Szkół Nr 15 Mistrzostwa Sportowego|Bydgoszcz|Czerkaska 8 |85-641 Bydgoszcz;1911;1061;1061;14;1047;55.52;1.32
86790;046101;Zespół Szkół Handlowych|Bydgoszcz|Kaliska 10 |85-602 Bydgoszcz;1024;631;631;7;624;61.62;1.11
86791;046101;Zespół Szkół Handlowych|Bydgoszcz|Kaliska 10 |85-602 Bydgoszcz;1432;896;896;19;877;62.57;2.12
86792;046101;Szkoła Podstawowa Nr 20|Bydgoszcz|Grabowa 4 |85-601 Bydgoszcz;907;547;547;10;537;60.31;1.83
86793;046101;Zespół Szkół Ogólnokształcących Nr 7|Bydgoszcz|11 Listopada 4 |85-643 Bydgoszcz;1938;1101;1101;15;1086;56.81;1.36
86794;046101;Zespół Szkół Nr 10|Bydgoszcz|Mieczysława Karłowicza 2 |85-092 Bydgoszcz;1430;765;765;5;760;53.50;0.65
86795;046101;Zespół Szkół Budowlanych|Bydgoszcz|Jana Pestalozziego 18 |85-095 Bydgoszcz;813;535;535;10;525;65.81;1.87
86796;046101;Uniwersytet Kazimierza Wielkiego w Bydgoszczy|Bydgoszcz|Józefa Poniatowskiego 12 |85-671 Bydgoszcz;1164;706;706;7;699;60.65;0.99
86797;046101;Zespół Szkół Ekonomiczno-Administracyjnych|Bydgoszcz|Gajowa 98 |85-717 Bydgoszcz;1047;642;642;1;641;61.32;0.16
86798;046101;Zespół Szkół Nr 9|Bydgoszcz|Cicha 59 |85-650 Bydgoszcz;966;572;572;7;565;59.21;1.22
86799;046101;Zespół Szkół Nr 9|Bydgoszcz|Cicha 59 |85-650 Bydgoszcz;1879;1120;1120;8;1112;59.61;0.71
86800;046101;Zespoł Szkół Budowlanych|Bydgoszcz|Jana Pestalozziego 18 |85-095 Bydgoszcz;1351;775;775;20;755;57.36;2.58
86801;046101;Szkoła Podstawowa Nr 14|Bydgoszcz|Żmudzka 12 |85-028 Bydgoszcz;1783;1159;1159;12;1147;65.00;1.04
86802;046101;Zespół Szkół Samochodowych|Bydgoszcz|aleja Powstańców Wielkopolskich 63 |85-090 Bydgoszcz;1168;728;728;11;717;62.33;1.51
86803;046101;Szkoła Podstawowa Nr 14|Bydgoszcz|Żmudzka 12 |85-028 Bydgoszcz;1518;840;840;8;832;55.34;0.95
86804;046101;Zespół Szkół Medycznych|Bydgoszcz|Swarzewska 10 |85-731 Bydgoszcz;1037;700;700;9;691;67.50;1.29
86805;046101;Zespół Szkół Medycznych|Bydgoszcz|Swarzewska 10 |85-731 Bydgoszcz;1302;885;885;9;876;67.97;1.02
86806;046101;Zespół Szkół Rzemiosła i Przedsiębiorczości|Bydgoszcz|Kijowska 7 |85-703 Bydgoszcz;1334;1196;1196;15;1181;89.66;1.25
86807;046101;Zespół Szkół Nr 21|Bydgoszcz|Bałtycka 59 |85-707 Bydgoszcz;1167;718;718;10;708;61.53;1.39
86808;046101;Zespół Szkół Nr 21|Bydgoszcz|Bałtycka 59 |85-707 Bydgoszcz;1255;759;759;10;749;60.48;1.32
86809;046101;Zespół Szkół Nr 21|Bydgoszcz|Bałtycka 59 |85-707 Bydgoszcz;1471;938;938;7;931;63.77;0.75
86810;046101;Przedszkole Nr 59|Bydgoszcz|Braniewska 8 |85-708 Bydgoszcz;1945;1131;1131;12;1119;58.15;1.06
86811;046101;Gimnazjum Nr 9|Bydgoszcz|Gajowa 94 |85-717 Bydgoszcz;1551;935;935;14;921;60.28;1.50
86812;046101;Gimnazjum Nr 9|Bydgoszcz|Gajowa 94 |85-717 Bydgoszcz;1420;880;880;21;859;61.97;2.39
86813;046101;Zespół Szkół Ekonomiczno-Administracyjnych|Bydgoszcz|Gajowa 98 |85-717 Bydgoszcz;1504;914;914;6;908;60.77;0.66
86814;046101;Bydgoski Zakład Doskonalenia Zawodowego Stowarzyszenie Oświatowo-Techniczne|Bydgoszcz|Fordońska 120 |85-738 Bydgoszcz;763;399;399;7;392;52.29;1.75
86815;046101;Zespół Szkół Nr 17|Bydgoszcz|Kapliczna 7 |85-775 Bydgoszcz;1102;441;441;9;432;40.02;2.04
86816;046101;Szkoła Podstawowa Nr 43|Bydgoszcz|Łowicka 45 |85-776 Bydgoszcz;1153;517;517;9;508;44.84;1.74
86817;046101;Gimnazjum Nr 5|Bydgoszcz|gen. Zygmunta Berlinga 17 |85-796 Bydgoszcz;1055;596;596;10;586;56.49;1.68
86818;046101;Zespół Szkół Nr 5 Mistrzostwa Sportowego|Bydgoszcz|gen. Zygmunta Berlinga 13 |85-796 Bydgoszcz;1481;886;886;12;874;59.82;1.35
86819;046101;MDK Nr 5|Bydgoszcz|Felicji Krysiewiczowej 8 |85-796 Bydgoszcz;958;596;596;6;590;62.21;1.01
86820;046101;Zespół Szkół Nr 5 Mistrzostwa Sportowego|Bydgoszcz|gen. Zygmunta Berlinga 13 |85-796 Bydgoszcz;1006;607;607;4;603;60.34;0.66
86821;046101;Zespół Szkół Nr 5 Mistrzostwa Sportowego|Bydgoszcz|gen. Zygmunta Berlinga 13 |85-796 Bydgoszcz;1418;855;855;12;843;60.30;1.40
86822;046101;Gimnazjum Nr 5|Bydgoszcz|gen. Zygmunta Berlinga 17 |85-796 Bydgoszcz;680;461;461;5;456;67.79;1.08
86823;046101;Gimnazjum Nr 5|Bydgoszcz|gen. Zygmunta Berlinga 17 |85-796 Bydgoszcz;970;581;581;10;571;59.90;1.72
86824;046101;Szkoła Podstawowa Nr 66|Bydgoszcz|gen. Zygmunta Berlinga 3 |85-796 Bydgoszcz;1647;1060;1060;7;1053;64.36;0.66
86825;046101;Szkoła Podstawowa Nr 66|Bydgoszcz|gen. Zygmunta Berlinga 3 |85-796 Bydgoszcz;1630;993;993;14;979;60.92;1.41
86826;046101;Zespół Szkół Nr 5 Mistrzostwa Sportowego|Bydgoszcz|gen. Zygmunta Berlinga 13 |85-796 Bydgoszcz;2401;1390;1390;16;1374;57.89;1.15
86827;046101;Gimnazjum Nr 5|Bydgoszcz|gen. Zygmunta Berlinga 17 |85-796 Bydgoszcz;1360;778;778;5;773;57.21;0.64
86828;046101;Zespół Szkół Nr 35|Bydgoszcz|Gawędy 5 |85-792 Bydgoszcz;1243;737;737;5;732;59.29;0.68
86829;046101;Zespół Szkół Nr 35|Bydgoszcz|Gawędy 5 |85-792 Bydgoszcz;1436;863;863;15;848;60.10;1.74
86830;046101;Zespół Szkół Nr 35|Bydgoszcz|Gawędy 5 |85-792 Bydgoszcz;1471;835;835;12;823;56.76;1.44
86831;046101;Gimnazjum Nr 5|Bydgoszcz|gen. Zygmunta Berlinga 17 |85-796 Bydgoszcz;1053;615;615;9;606;58.40;1.46
86832;046101;Szkoła Podstawowa Nr 65|Bydgoszcz|Teodora Duracza 7 |85-791 Bydgoszcz;1564;901;901;17;884;57.61;1.89
86833;046101;Szkoła Podstawowa Nr 65|Bydgoszcz|Teodora Duracza 7 |85-791 Bydgoszcz;1286;721;721;17;704;56.07;2.36
86834;046101;Szkoła Podstawowa Nr 65|Bydgoszcz|Teodora Duracza 7 |85-796 Bydgoszcz;1402;843;843;7;836;60.13;0.83
86835;046101;Szkoła Podstawowa Nr 65|Bydgoszcz|Teodora Duracza 7 |85-791 Bydgoszcz;866;460;460;9;451;53.12;1.96
86836;046101;Zespół Szkół Nr 28|Bydgoszcz|Marcina Kromera 11 |85-790 Bydgoszcz;1765;920;920;21;899;52.12;2.28
86837;046101;Zespół Szkół Nr 28|Bydgoszcz|Marcina Kromera 11 |85-790 Bydgoszcz;1904;1075;1075;13;1062;56.46;1.21
86838;046101;Zespół Szkół Nr 28|Bydgoszcz|Marcina Kromera 11 |85-790 Bydgoszcz;780;428;428;7;421;54.87;1.64
86839;046101;Zespół Szkół Nr 28|Bydgoszcz|Marcina Kromera 11 |85-790 Bydgoszcz;1713;913;913;16;897;53.30;1.75
86840;046101;Szkoła Podstawowa Nr 9|Bydgoszcz|Tatrzańska 21 |85-790 Bydgoszcz;2025;1149;1149;14;1135;56.74;1.22
86841;046101;Zespół Szkół Nr 28|Bydgoszcz|ul. Marcina Kromera 11 |85-794 Bydgoszcz;1158;597;597;7;590;51.55;1.17
86842;046101;Szkoła Podstawowa Nr 65|Bydgoszcz|ul. Teodora Duracza 7 |85-791 Bydgoszcz;948;533;533;8;525;56.22;1.50
86843;046101;Zespół Szkół Nr 28|Bydgoszcz|ul. Marcina Kromera 11 |85-794 Bydgoszcz;1083;564;564;3;561;52.08;0.53
86844;046101;Zespół Szkół Nr 20|Bydgoszcz|ul. Sielska 34 |85-790 Bydgoszcz;965;621;621;12;609;64.35;1.93
86845;046101;Zespół Szkół Nr 20|Bydgoszcz|ul. Sielska 34 |85-790 Bydgoszcz;1230;668;668;7;661;54.31;1.05
86846;046101;Szkoła Podstawowa Nr 4|Bydgoszcz|ul. Wyzwolenia 4 |85-790 Bydgoszcz;2079;1228;1228;10;1218;59.07;0.81
86847;046101;Szkoła Podstawowa Nr 4|Bydgoszcz|ul. Wyzwolenia 4 |85-790 Bydgoszcz;2113;1202;1202;21;1181;56.89;1.75
86848;046101;Zespół Szkół Nr 28|Bydgoszcz|ul. Marcina Kromera 11 |85-790 Bydgoszcz;947;520;520;10;510;54.91;1.92
86849;046101;Szkoła Podstawowa Nr 4|Bydgoszcz|ul. Wyzwolenia 4 |85-790 Bydgoszcz;1290;667;667;13;654;51.71;1.95
86850;046101;Szkoła Podstawowa Nr 4|Bydgoszcz|ul. Wyzwolenia 4 |85-790 Bydgoszcz;1844;995;995;14;981;53.96;1.41
86851;046101;Szkoła Podstawowa Nr 4|Bydgoszcz|ul. Wyzwolenia 4 |85-790 Bydgoszcz;2147;1271;1271;5;1266;59.20;0.39
86852;046101;Szkoła Podstawowa Nr 4|Bydgoszcz|ul. Wyzwolenia 4 |85-790 Bydgoszcz;1835;935;935;9;926;50.95;0.96
86853;046101;Szkoła Podstawowa Nr 4|Bydgoszcz|ul. Wyzwolenia 4 |85-790 Bydgoszcz;1803;767;767;21;746;42.54;2.74
86854;046101;Zespół Szkół Nr 20|Bydgoszcz|ul. Sielska 34 |85-790 Bydgoszcz;1337;584;584;10;574;43.68;1.71
86855;046101;Zespół Szkół Nr 20|Bydgoszcz|ul. Sielska 34 |85-790 Bydgoszcz;413;150;150;3;147;36.32;2.00
86856;046101;Zespół Szkół Nr 7|Bydgoszcz|ul. Ludwika Waryńskiego 1 |85-320 Bydgoszcz;1797;1043;1043;8;1035;58.04;0.77
86857;046101;Zespół Szkół Ogólnokształcących Nr 4|Bydgoszcz|ul. Stawowa 39 |85-323 Bydgoszcz;1274;675;675;7;668;52.98;1.04
86858;046101;Zespół Szkół Ogólnokształcących Nr 4|Bydgoszcz|ul. Stawowa 39 |85-323 Bydgoszcz;812;508;508;6;502;62.56;1.18
86859;046101;Zespół Szkół Nr 7|Bydgoszcz|ul. Ludwika Waryńskiego 1 |85-320 Bydgoszcz;1033;605;605;11;594;58.57;1.82
86860;046101;Zespół Szkół Nr 12|Bydgoszcz|ul. Stawowa 41 |85-324 Bydgoszcz;1509;751;751;8;743;49.77;1.07
86861;046101;Zespół Szkół i Placówek Nr 1|Bydgoszcz|ul. Stawowa 53 |85-324 Bydgoszcz;1825;1076;1076;14;1062;58.96;1.30
86862;046101;Zespół Szkół i Placówek Nr 1|Bydgoszcz|ul. Stawowa 53 |85-324 Bydgoszcz;1797;993;993;8;985;55.26;0.81
86863;046101;KPEC Sp. z o.o.|Bydgoszcz|ul. ks. Józefa Schulza 5 |85-315 Bydgoszcz;1334;729;729;12;717;54.65;1.65
86864;046101;Zespół Szkół Nr 7|Bydgoszcz|ul. Ludwika Waryńskiego 1 |85-320 Bydgoszcz;1596;834;834;17;817;52.26;2.04
86865;046101;Zespół Szkół Nr 1|Bydgoszcz|ul. Nakielska 11 |85-219 Bydgoszcz;1432;596;596;11;585;41.62;1.85
86866;046101;Zespół Szkół Nr 1|Bydgoszcz|ul. Nakielska 11 |85-219 Bydgoszcz;1087;439;439;13;426;40.39;2.96
86867;046101;Zespół Szkół Nr 29|Bydgoszcz|ul. Słoneczna 26 |85-348 Bydgoszcz;1137;662;662;8;654;58.22;1.21
86868;046101;Zespół Szkół Mechanicznych Nr 2|Bydgoszcz|ul. Słoneczna 19 |85-348 Bydgoszcz;1970;1057;1057;10;1047;53.65;0.95
86869;046101;Zespół Szkół Mechanicznych Nr 2|Bydgoszcz|ul. Słoneczna 19 |85-348 Bydgoszcz;1234;693;693;16;677;56.16;2.31
86870;046101;K. S. "Gwiazda"|Bydgoszcz|ul. Józefa Bronikowskiego 45 |85-426 Bydgoszcz;1828;1084;1084;17;1067;59.30;1.57
86871;046101;Zespół Szkół Nr 8|Bydgoszcz|ul. Pijarów 4 |85-360 Bydgoszcz;1666;946;946;16;930;56.78;1.69
86872;046101;Zespół Szkół Nr 8|Bydgoszcz|ul. Pijarów 4 |85-360 Bydgoszcz;1880;1188;1188;14;1174;63.19;1.18
86873;046101;Zespół Szkół Nr 23|Bydgoszcz|ul. Nakielska 273 |85-391 Bydgoszcz;2196;1340;1340;16;1324;61.02;1.19
86874;046101;Zespół Szkół Nr 23|Bydgoszcz|ul. Nakielska 273 |85-391 Bydgoszcz;2254;1392;1392;14;1378;61.76;1.01
86875;046101;Szkoła Podstawowa Nr 41|Bydgoszcz|ul. Romualda Traugutta 12 |85-122 Bydgoszcz;1368;615;615;12;603;44.96;1.95
86876;046101;Szkoła Podstawowa Nr 41|Bydgoszcz|ul. Romualda Traugutta 12 |85-122 Bydgoszcz;886;538;538;10;528;60.72;1.86
86877;046101;Szkoła Podstawowa Nr 41|Bydgoszcz|ul. Romualda Traugutta 12 |85-122 Bydgoszcz;878;434;434;12;422;49.43;2.76
86878;046101;Zespół Szkół Ogólnokształcących Nr 2|Bydgoszcz|ul. Nowodworska 13 |85-120 Bydgoszcz;1589;876;876;15;861;55.13;1.71
86879;046101;Gimnazjum Nr 22|Bydgoszcz|ul. Jana Henryka Dąbrowskiego 8 |85-158 Bydgoszcz;1497;737;737;19;718;49.23;2.58
86880;046101;MDK Nr 2|Bydgoszcz|ul. Stanisława Leszczyńskiego 42 |85-137 Bydgoszcz;1841;931;931;18;913;50.57;1.93
86881;046101;Szkoła Podstawowa Nr 63|Bydgoszcz|ul. Seweryna Goszczyńskiego 3 |85-134 Bydgoszcz;2081;1159;1159;13;1146;55.69;1.12
86882;046101;Szkoła Podstawowa Nr 63|Bydgoszcz|ul. Seweryna Goszczyńskiego 3 |85-134 Bydgoszcz;2120;1306;1308;22;1284;61.60;1.68
86883;046101;Zespół Szkół Nr 30|Bydgoszcz|ul. Jesionowa 3a |85-149 Bydgoszcz;1539;921;921;17;904;59.84;1.85
86884;046101;Zespół Szkół Nr 30|Bydgoszcz|ul. Jesionowa 3a |85-149 Bydgoszcz;1361;729;729;5;724;53.56;0.69
86885;046101;Szkoła Podstawowa Nr 63|Bydgoszcz|ul. Seweryna Goszczyńskiego 3 |85-134 Bydgoszcz;830;520;520;11;509;62.65;2.12
86886;046101;Klub "ARKA" Bydgoskiej Spółdzielni Mieszkaniowej|Bydgoszcz|ul. Marii Konopnickiej 24a |85-124 Bydgoszcz;1520;895;895;12;883;58.88;1.34
86887;046101;MDK Nr 2|Bydgoszcz|ul. Stanisława Leszczyńskiego 42 |85-137 Bydgoszcz;2099;1232;1232;23;1209;58.69;1.87
86888;046101;Gimnazjum Nr 23|Bydgoszcz|ul. Tadeusza Czackiego 8 |85-138 Bydgoszcz;1193;710;710;10;700;59.51;1.41
86889;046101;Gimnazjum Nr 23|Bydgoszcz|ul. Tadeusza Czackiego 8 |85-138 Bydgoszcz;1189;776;776;17;759;65.26;2.19
86890;046101;Gimnazjum Nr 23|Bydgoszcz|ul. Tadeusza Czackiego 8 |85-138 Bydgoszcz;944;484;484;9;475;51.27;1.86
86891;046101;Gimnazjum Nr 23|Bydgoszcz|ul. Tadeusza Czackiego 8 |85-138 Bydgoszcz;1623;979;979;10;969;60.32;1.02
86892;046101;Zespół Szkół Nr 14|Bydgoszcz|ul. Kcyńska 49 |85-304 Bydgoszcz;1332;736;736;11;725;55.26;1.49
86893;046101;Zespół Szkół Nr 14|Bydgoszcz|ul. Kcyńska 49 |85-304 Bydgoszcz;2277;1438;1438;10;1428;63.15;0.70
86894;046101;Zespół Szkół Nr 32|Bydgoszcz|ul. Krucza 5a |85-308 Bydgoszcz;1238;862;862;5;857;69.63;0.58
86895;046101;Zespół Szkół Nr 32|Bydgoszcz|ul. Krucza 5a |85-308 Bydgoszcz;1809;1191;1191;15;1176;65.84;1.26
86896;046101;Gimnazjum Nr 20|Bydgoszcz|ul. Karpacka 30 |85-164 Bydgoszcz;696;448;448;1;447;64.37;0.22
86897;046101;Szkoła Podstawowa Nr 56|Bydgoszcz|ul. Bośniacka 3 |85-162 Bydgoszcz;1800;1027;1027;17;1010;57.06;1.66
86898;046101;Szkoła Podstawowa Nr 56|Bydgoszcz|ul. Bośniacka 3 |85-162 Bydgoszcz;1886;1085;1085;14;1071;57.53;1.29
86899;046101;Gimnazjum Nr 20|Bydgoszcz|ul. Karpacka 30 |85-164 Bydgoszcz;1537;972;972;13;959;63.24;1.34
86900;046101;Szkoła Podstawowa Nr 56|Bydgoszcz|ul. Bośniacka 3 |85-162 Bydgoszcz;1627;955;955;7;948;58.70;0.73
86901;046101;Gimnazjum Nr 20|Bydgoszcz|ul. Karpacka 30 |85-164 Bydgoszcz;1957;1152;1152;26;1126;58.87;2.26
86902;046101;Zespół Szkół Drzewnych|Bydgoszcz|ul. Toruńska 44 |85-023 Bydgoszcz;1190;456;456;7;449;38.32;1.54
86903;046101;Spółdzielnia Mieszkaniowa "BUDOWLANI"|Bydgoszcz|ul. Tadeusza Boya-Żeleńskiego 1 |85-858 Bydgoszcz;1865;1127;1127;7;1120;60.43;0.62
86904;046101;Zespół Szkół Nr 19|Bydgoszcz|ul. Adama Grzymały Siedleckiego 11 |85-868 Bydgoszcz;1694;1029;1029;23;1006;60.74;2.24
86905;046101;Dom Kultury "Modraczek"|Bydgoszcz|ul. Ogrody 15 |85-870 Bydgoszcz;1804;1115;1115;10;1105;61.81;0.90
86906;046101;Dom Kultury "Modraczek"|Bydgoszcz|ul. Ogrody 15 |85-870 Bydgoszcz;1436;881;881;10;871;61.35;1.14
86907;046101;Zespół Szkół Nr 4|Bydgoszcz|ul. Zofii Nałkowskiej 9 |85-866 Bydgoszcz;1441;835;835;9;826;57.95;1.08
86908;046101;Zespół Szkół Nr 4|Bydgoszcz|ul. Zofii Nałkowskiej 9 |85-866 Bydgoszcz;1372;853;853;11;842;62.17;1.29
86909;046101;Zespół Szkół Nr 4|Bydgoszcz|ul. Zofii Nałkowskiej 9 |85-866 Bydgoszcz;1602;994;994;9;985;62.05;0.91
86910;046101;Szkoła Podstawowa Nr 38|Bydgoszcz|ul. Węgierska 11 |85-858 Bydgoszcz;1316;807;807;15;792;61.32;1.86
86911;046101;Szkoła Podstawowa Nr 38|Bydgoszcz|ul. Węgierska 11 |85-858 Bydgoszcz;1891;1190;1190;13;1177;62.93;1.09
86912;046101;Szkoła Podstawowa Nr 38|Bydgoszcz|ul. Węgierska 11 |85-858 Bydgoszcz;1797;1048;1048;13;1035;58.32;1.24
86913;046101;Gimnazjum Nr 16|Bydgoszcz|ul. Bohaterów Kragujewca 10 |85-863 Bydgoszcz;1826;1114;1114;11;1103;61.01;0.99
86914;046101;Gimnazjum Nr 16|Bydgoszcz|ul. Bohaterów Kragujewca 10 |85-863 Bydgoszcz;1705;984;984;24;960;57.71;2.44
86915;046101;Gimnazjum Nr 16|Bydgoszcz|ul. Bohaterów Kragujewca 10 |85-863 Bydgoszcz;1838;1042;1042;25;1017;56.69;2.40
86916;046101;Zespół Szkół Nr 26|Bydgoszcz|ul. Glinki 117 |85-861 Bydgoszcz;1742;1039;1039;15;1024;59.64;1.44
86917;046101;Zespół Szkół Nr 26|Bydgoszcz|ul. Glinki 117 |85-861 Bydgoszcz;1469;920;920;13;907;62.63;1.41
86918;046101;BKS "CHEMIK"|Bydgoszcz|ul. Glinki 79 |85-061 Bydgoszcz;1606;1006;1006;11;995;62.64;1.09
86919;046101;Szkoła Podstawowa Nr 28|Bydgoszcz|ul. Krzysztofa Kamila Baczyńskiego 1 |85-805 Bydgoszcz;1385;704;704;15;689;50.83;2.13
86920;046101;Zespół Szkół Chemicznych|Bydgoszcz|ul. Ignacego Łukasiewicza 3 |85-821 Bydgoszcz;1583;757;757;17;740;47.82;2.25
86921;046101;Zespół Szkół Chemicznych|Bydgoszcz|ul. Ignacego Łukasiewicza 3 |85-821 Bydgoszcz;1395;667;667;11;656;47.81;1.65
86922;046101;Zespół Szkół Chemicznych|Bydgoszcz|ul. Ignacego Łukasiewicza 3 |85-805 Bydgoszcz;1609;869;869;11;858;54.01;1.27
86923;046101;Zespół Szkół Chemicznych|Bydgoszcz|ul. Ignacego Łukasiewicza 3 |85-805 Bydgoszcz;1743;1026;1026;6;1020;58.86;0.58
86924;046101;Szkoła Podstawowa Nr 46|Bydgoszcz|ul. Kombatantów 2 |85-729 Bydgoszcz;1602;927;927;15;912;57.87;1.62
86925;046101;Szkoła Podstawowa Nr 46|Bydgoszcz|ul. Kombatantów 2 |85-829 Bydgoszcz;1699;1070;1070;7;1063;62.98;0.65
86926;046101;Zespół Szkół Nr 26|Bydgoszcz|ul. Glinki 117 |85-861 Bydgoszcz;1115;471;471;4;467;42.24;0.85
86927;046101;Zespół Szkół Spożywczych|Bydgoszcz|ul. Toruńska 174 |85-844 Bydgoszcz;1861;1040;1040;12;1028;55.88;1.15
86928;046101;Zespół Szkół Ogólnokształcących Nr 5|Bydgoszcz|ul. Szarych Szeregów 4a |85-829 Bydgoszcz;1479;873;873;18;855;59.03;2.06
86929;046101;Zespół Szkół Ogólnokształcących Nr 5|Bydgoszcz|ul. Szarych Szeregów 4a |85-829 Bydgoszcz;1192;698;698;12;686;58.56;1.72
86930;046101;Zespół Szkół Nr 36|Bydgoszcz|ul. Bohaterów Westerplatte 2 |85-827 Bydgoszcz;1507;806;806;16;790;53.48;1.99
86931;046101;Zespół Szkół Nr 36|Bydgoszcz|ul. Bohaterów Westerplatte 2 |85-827 Bydgoszcz;1240;639;639;10;629;51.53;1.56
86932;046101;Centrum Integracji Społecznej im. Jacka Kuronia|Bydgoszcz|ul. Smoleńska 43 |85-833 Bydgoszcz;974;335;335;4;331;34.39;1.19
86933;046101;Zespół Szkół Nr 18|Bydgoszcz|ul. Hutnicza 89 |85-873 Bydgoszcz;1540;531;531;14;517;34.48;2.64
86934;046101;Świetlica Środowiskowa MOPS|Bydgoszcz|ul. Toruńska 185-187 |85-844 Bydgoszcz;713;315;315;6;309;44.18;1.90
86935;046101;Szkoła Podstawowa Nr 2|Bydgoszcz|ul. Hetmańska 34 |85-039 Bydgoszcz;1697;718;718;13;705;42.31;1.81
86936;046101;Gimnazjum Nr 25|Bydgoszcz|ul. Aleksandra Fredry 3 |85-057 Bydgoszcz;1652;664;664;19;645;40.19;2.86
86937;046101;Poradnia Psychologiczno- Pedagogiczna Nr 1|Bydgoszcz|ul. Jana III Sobieskiego 10 |85-060 Bydgoszcz;1131;442;442;13;429;39.08;2.94
86938;046101;Szkoła Podstawowa Nr 2|Bydgoszcz|ul. Hetmańska 34 |85-039 Bydgoszcz;1264;456;456;4;452;36.08;0.88
86939;046101;Szkoła Podstawowa Nr 2|Bydgoszcz|ul. Hetmańska 34 |85-039 Bydgoszcz;1235;472;472;7;465;38.22;1.48
86940;046101;Gimnazjum Nr 24|Bydgoszcz|ul. Tadeusza Kościuszki 37a |85-071 Bydgoszcz;825;276;276;4;272;33.45;1.45
86941;046101;Szkoła Podstawowa Nr 58|Bydgoszcz|ul. Gdańska 53a |85-005 Bydgoszcz;1431;560;560;17;543;39.13;3.04
86942;046101;Gimnazjum Nr 24|Bydgoszcz|ul. Tadeusza Kościuszki 37a |85-071 Bydgoszcz;1154;511;511;4;507;44.28;0.78
86943;046101;MDK Nr 4|Bydgoszcz|ul. Dworcowa 82 |85-010 Bydgoszcz;1077;434;434;5;429;40.30;1.15
86944;046101;Urząd Miasta Bydgoszczy - budynek administrowany przez ADM Sp. z o.o.|Bydgoszcz|ul. Obrońców Bydgoszczy 1 |85-054 Bydgoszcz;1276;556;556;10;546;43.57;1.80
86945;046101;ENEA Operator Sp. z o.o.|Bydgoszcz|ul. Dr. Emila Warmińskiego 6 |85-054 Bydgoszcz;1484;538;538;13;525;36.25;2.42
86946;046101;ADM Sp. z o.o. - ROM Nr 3|Bydgoszcz|ul. Gdańska 9 |85-006 Bydgoszcz;619;271;271;3;268;43.78;1.11
86947;046101;Zespół Szkół Ogólnokształcących Nr 6|Bydgoszcz|ul. Stanisława Staszica 4 |85-014 Bydgoszcz;1247;695;695;6;689;55.73;0.86
86948;046101;Uniwersytet Kazimierza Wielkiego|Bydgoszcz|ul. Jana Karola Chodkiewicza 30 |85-856 Bydgoszcz;1613;816;816;10;806;50.59;1.23
86949;046101;Zespół Szkół Ogólnokształcących Nr 6|Bydgoszcz|ul. Stanisława Staszica 4 |85-014 Bydgoszcz;1347;630;630;9;621;46.77;1.43
86950;046101;Zespół Szkół Ogólnokształcących Nr 1|Bydgoszcz|Plac Wolności 9 |85-004 Bydgoszcz;1157;544;544;10;534;47.02;1.84
86951;046101;Pałac Młodzieży|Bydgoszcz|ul. Jagiellońska 27 |85-097 Bydgoszcz;1134;617;617;9;608;54.41;1.46
86952;046101;Uniwersytet Kazimierza Wielkiego w Bydgoszczy|Bydgoszcz|ul. Pl. Kościeleckich 8 |85-033 Bydgoszcz;557;251;251;5;246;45.06;1.99
86953;046101;Zespół Szkół Nr 25 Mistrzostwa Sportowego|Bydgoszcz|ul. Adama Czartoryskiego 18 |85-222 Bydgoszcz;1625;744;744;6;738;45.78;0.81
86954;046101;Urząd Miasta Bydgoszczy|Bydgoszcz|ul. Jezuicka 2 |85-102 Bydgoszcz;1087;433;433;8;425;39.83;1.85
86955;046101;Dom Pomocy Społecznej "Promień Życia" w Bydgoszcz|Bydgoszcz|ul. Łomżyńska 54 |85-863 Bydgoszcz;136;50;50;0;50;36.76;0.00
86956;046101;Dom Pomocy Społecznej "Jesień Życia" w Bydgoszczy|Bydgoszcz|ul. Mińska 15a |85-442 Bydgoszcz;72;34;34;0;34;47.22;0.00
86957;046101;Wielospecjalistyczny Szpital Miejski - SPZOZ im. dr. E. Warmińskiego w Bydgoszczy|Bydgoszcz|ul. Szpitalna 19 |85-826 Bydgoszcz;170;48;48;1;47;28.24;2.08
86958;046101;Szpital Uniwersytecki Nr 1 im. dr. Antoniego Jurasza w Bydgoszczy|Bydgoszcz|ul. Marii Curie Skłodowskiej 9 |85-094 Bydgoszcz;621;138;138;8;130;22.22;5.80
86959;046101;Centrum Onkologii im. prof. Franciszka Łukaszczyka w Bydgoszczy|Bydgoszcz|ul. Izabeli Romanowskiej 2 |85-796 Bydgoszcz;320;118;118;1;117;36.88;0.85
86960;046101;Szpital Uniwersytecki Nr 2 im. dr. Jana Biziela w Bydgoszczy|Bydgoszcz|ul. Kornela Ujejskiego 75 |85-168 Bydgoszcz;424;97;97;1;96;22.88;1.03
86961;046101;Kujawsko-Pomorskie Centrum Pulmonologii w Bydgoszczy|Bydgoszcz|ul. Seminaryjna 1 |85-326 Bydgoszcz;76;26;26;4;22;34.21;15.38
86962;046101;Kujawsko-Pomorskie Centrum Pulmonologii w Bydgoszczy|Bydgoszcz|ul. dr Stanisława Meysnera 9 |85-472 Bydgoszcz;107;44;44;2;42;41.12;4.55
86963;046101;Wojewódzki Szpital Obeserwacyjno - Zakaźny im. Tadeusza Browicza w Bydgoszczy|Bydgoszcz|ul. Św. Floriana 12 |85-030 Bydgoszcz;66;28;28;0;28;42.42;0.00
86964;046101;10 Wojskowy Szpital Kliniczny z Polikliniką - Samodzielny Publiczny Zakład Opieki Zdrowotnej w Bydgoszczy|Bydgoszcz|ul. Powstańców Warszawy 5 |85-681 Bydgoszcz;425;74;74;2;72;17.41;2.70
86965;046101;Samodzielny Publiczny Wielospecjalistyczny Zakład Opieki Zdrowotnej Ministerstwa Spraw Wewnętrznych w Bydgoszczy|Bydgoszcz|ul. Ks. Ryszarda Markwarta 4-6 |85-015 Bydgoszcz;93;21;21;1;20;22.58;4.76
86966;046101;Zakład Pielęgnacyjno - Opiekuńczy w Bydgoszczy|Bydgoszcz|ul. Smukalska 251 |85-485 Bydgoszcz;39;12;12;2;10;30.77;16.67
86967;046101;Niepubliczny Zakład Opieki Zdrowotnej w Bydgoszczy - Dom Sue Ryder|Bydgoszcz|ul. Wilhelma Roentgena 3 |85-796 Bydgoszcz;23;5;5;0;5;21.74;0.00
86968;046101;Centrum Medyczne Gizińscy|Bydgoszcz|ul. Leśna 9 |85-676 Bydgoszcz;25;23;23;2;21;92.00;8.70
86969;046101;Areszt Śledczy w Bydgoszczy|Bydgoszcz|ul. Wały Jagiellońskie 4 |85-128 Bydgoszcz;480;188;188;15;173;39.17;7.98
86970;046101;Zakład Karny Bydgoszcz - Fordon w Bydgoszczy|Bydgoszcz|ul. Rynek 8 |85-790 Bydgoszcz;460;208;208;19;189;45.22;9.13
86971;046201;Szkoła Podstawowa Nr 4|Grudziądz|ul. Jaśminowa 2 |86-300 Grudziądz;1173;522;522;3;519;44.50;0.57
86972;046201;Zespół Szkół Rolniczych|Grudziądz|ul. Lipowa 33 |86-300 Grudziądz;1915;974;974;8;966;50.86;0.82
86973;046201;Gimnazjum Nr 9|Grudziądz|ul. Paderewskiego 10 |86-300 Grudziądz;1977;942;942;17;925;47.65;1.80
86974;046201;Przedszkole Miejskie "TARPNO"|Grudziądz|ul. Dąbrówki 6 |86-300 Grudziądz;1027;404;404;3;401;39.34;0.74
86975;046201;Szkoła Podstawowa Nr 18|Grudziądz|ul. Dąbrówki 7 |86-300 Grudziądz;1043;458;458;11;447;43.91;2.40
86976;046201;Miejski Ośrodek Rekreacji i Wypoczynku|Grudziądz|ul. Za Basenem 2 |86-300 Grudziądz;1670;781;781;10;771;46.77;1.28
86977;046201;Dom Dziennego Pobytu|Grudziądz|ul. Piłsudskiego 111 |86-300 Grudziądz;1030;461;461;12;449;44.76;2.60
86978;046201;Klub Centrum Szkolenia Logistyki|Grudziądz|ul. 6 Marca 1 |86-300 Grudziądz;1171;551;551;9;542;47.05;1.63
86979;046201;Biblioteka Miejska|Grudziądz|ul. Legionów 28 |86-300 Grudziądz;1625;639;639;18;621;39.32;2.82
86980;046201;Szkoła Podstawowa Nr 9|Grudziądz|ul. Forteczna 29 |86-300 Grudziądz;1879;676;676;14;662;35.98;2.07
86981;046201;Centrum Kształcenia Ustawicznego|Grudziądz|ul. Legionów 2 |86-300 Grudziądz;1274;455;455;22;433;35.71;4.84
86982;046201;I Liceum Ogólnokształcące|Grudziądz|ul. Sienkiewicza 27 |86-300 Grudziądz;586;236;236;5;231;40.27;2.12
86983;046201;Zespół Szkół Specjalnych|Grudziądz|ul. Sikorskiego 42 |86-300 Grudziądz;747;343;343;12;331;45.92;3.50
86984;046201;Szkoła Podstawowa Nr 16|Grudziądz|ul. Kochanowskiego 19 |86-300 Grudziądz;2081;1039;1039;9;1030;49.93;0.87
86985;046201;Zespół Szkół Budowlanych i Plastycznych Liceum Plastyczne|Grudziądz|ul. Waryńskiego 78 |86-300 Grudziądz;783;381;381;6;375;48.66;1.57
86986;046201;Gimnazjum Nr 7|Grudziądz|ul. Mikołaja z Ryńska 6 |86-300 Grudziądz;805;404;404;2;402;50.19;0.50
86987;046201;Szkoła Podstawowa Nr 12|Grudziądz|ul. Moniuszki 14 |86-300 Grudziądz;1917;904;904;24;880;47.16;2.65
86988;046201;Centrum Kultury TEATR|Grudziądz|ul. Teatralna 1 |86-300 Grudziądz;1760;665;665;22;643;37.78;3.31
86989;046201;Klub AKCENT|Grudziądz|ul. Wybickiego 38 |86-300 Grudziądz;1348;452;452;21;431;33.53;4.65
86990;046201;Zespół Szkół Gastronomiczno-Hotelarskich|Grudziądz|ul. Curie-Skłodowskiej 22/24 |86-300 Grudziądz;1030;335;335;8;327;32.52;2.39
86991;046201;Urząd Miejski|Grudziądz|ul. Ratuszowa 1 |86-300 Grudziądz;746;293;293;10;283;39.28;3.41
86992;046201;Gimnazjum Nr 6|Grudziądz|ul. Al. 23 Stycznia 30 |86-300 Grudziądz;696;233;233;9;224;33.48;3.86
86993;046201;II Liceum Ogólnokształcące|Grudziądz|ul. Marcinkowskiego 10 |86-300 Grudziądz;942;294;294;11;283;31.21;3.74
86994;046201;Szkoła Podstawowa Nr 3|Grudziądz|ul. Narutowicza 6 |86-300 Grudziądz;1065;381;381;13;368;35.77;3.41
86995;046201;Zespół Szkół Budowlanych i Plastycznych|Grudziądz|ul. Czarnieckiego 9 |86-300 Grudziądz;1549;717;717;13;704;46.29;1.81
86996;046201;Zespół Szkół Ekonomicznych|Grudziądz|ul. Konarskiego 39 |86-300 Grudziądz;1630;736;736;6;730;45.15;0.82
86997;046201;Ośrodek Szkolno-Wychowawczy Nr 1|Grudziądz|ul. Parkowa 25 |86-300 Grudziądz;1329;564;564;7;557;42.44;1.24
86998;046201;Zespół Szkół Ogólnokształcących Nr 5 Szkoła Podstawowa Nr 21|Grudziądz|ul. Nauczycielska 19 |86-300 Grudziądz;1427;721;721;11;710;50.53;1.53
86999;046201;Zespół Szkół Ogólnokształcących Nr 5 Gimnazjum Nr 5|Grudziądz|ul. Nauczycielska 19 |86-300 Grudziądz;1411;747;747;15;732;52.94;2.01
87000;046201;Zespół Szkół Ogólnokształcących Nr 5 BASEN|Grudziądz|ul. Nauczycielska 19 |86-300 Grudziądz;1956;1035;1035;11;1024;52.91;1.06
87001;046201;Dom Pomocy Społecznej|Grudziądz|ul. Dywizjonu 303 4 |86-300 Grudziądz;1982;1002;1002;24;978;50.55;2.40
87002;046201;Przedszkole Miejskie "LOTNISKO"|Grudziądz|ul. Ikara 8 |86-300 Grudziądz;1902;1036;1036;13;1023;54.47;1.25
87003;046201;Szkoła Podstawowa Nr 15|Grudziądz|ul. Bydgoska 24 |86-300 Grudziądz;2049;1087;1087;21;1066;53.05;1.93
87004;046201;Ognisko Pracy Pozaszkolnej|Grudziądz|ul. Chełmińska 104 |86-300 Grudziądz;711;231;231;11;220;32.49;4.76
87005;046201;Ośrodek Kultury Fizycznej "BASEN"|Grudziądz|ul. Kalinkowa 56 |86-300 Grudziądz;1971;977;977;20;957;49.57;2.05
87006;046201;Przedszkole Miejskie KOPERNIK|Grudziądz|ul. Kalinkowa 46 |86-300 Grudziądz;1475;608;608;16;592;41.22;2.63
87007;046201;Zespół Szkół Ogólnokształcących Nr 4|Grudziądz|ul. Żeromskiego 8 |86-300 Grudziądz;1030;465;465;9;456;45.15;1.94
87008;046201;Ośrodek Szkolno-Wychowawczy Nr 2|Grudziądz|ul. Kasprowicza 4 |86-300 Grudziądz;2022;1008;1008;17;991;49.85;1.69
87009;046201;Przedszkole Miejskie "STRZEMIĘCIN"|Grudziądz|ul. Jackowskiego 47 |86-300 Grudziądz;1837;998;998;21;977;54.33;2.10
87010;046201;Zespół Szkół Ogólnokształcących Nr 3|Grudziądz|ul. Korczaka 23 |86-300 Grudziądz;1274;681;681;13;668;53.45;1.91
87011;046201;Przedszkole Miejskie "STRZEMIĘCIN"|Grudziądz|ul. Korczaka 21 |86-300 Grudziądz;1620;856;856;13;843;52.84;1.52
87012;046201;Centrum Profilaktyki i Terapii|Grudziądz|ul. Śniadeckich 6A |86-300 Grudziądz;1781;877;877;15;862;49.24;1.71
87013;046201;Poradnia Psychologiczno-Pedagogiczna|Grudziądz|ul. Korczaka 23 |86-300 Grudziądz;2084;1035;1035;37;998;49.66;3.57
87014;046201;Przedszkole Miejskie "RZĄDZ"|Grudziądz|ul. Wł. Łęgi 17 |86-300 Grudziądz;1956;1076;1076;18;1058;55.01;1.67
87015;046201;Wydział Bezpieczeństwa i Zarządzania Kryzysowego Urzędu Miejskiego|Grudziądz|ul. Konstytucji 3 Maja |86-300 Grudziądz;1790;1019;1019;11;1008;56.93;1.08
87016;046201;Zespół Szkół Ogólnokształcących Nr 2|Grudziądz|ul. Sobieskiego 12 |86-300 Grudziądz;1575;869;869;11;858;55.17;1.27
87017;046201;Niepubliczne Przedszkole "TOM BOMBADIL"|Grudziądz|ul. Gąsiorowskiego 4 |86-300 Grudziądz;1855;940;940;31;909;50.67;3.30
87018;046201;Budynek po Warsztacie Terapii Zajęciowej|Grudziądz|Aleja Sportowców 1/3 |86-300 Grudziądz;1490;659;659;27;632;44.23;4.10
87019;046201;Zespół Szkół Ogólnokształcących Nr 1|Grudziądz|ul. Droga Mazurska 2 |86-300 Grudziądz;2085;1061;1061;8;1053;50.89;0.75
87020;046201;Dom Pomocy Społecznej|Grudziądz|ul. Nadgórna 30/32 |86-300 Grudziądz;117;45;45;7;38;38.46;15.56
87021;046201;Dom Pomocy Społecznej|Grudziądz|ul. Parkowa 12 |86-300 Grudziądz;82;40;40;5;35;48.78;12.50
87022;046201;Regionalny Szpital Specjalistyczny im. Dr Władysława Biegańskiego Budynek "A" łóżkowy, Sala konferencyjna|Grudziądz|ul. Rydygiera 15/17 |86-300 Grudziądz;348;181;181;6;175;52.01;3.31
87023;046201;Zakład Karny Nr 1|Grudziądz|ul. Wybickiego 10/22 |86-300 Grudziądz;760;220;220;59;161;28.95;26.82
87024;046201;Zakład Karny Nr 2|Grudziądz|ul. Sikorskiego 13/17 |86-300 Grudziądz;345;115;115;15;100;33.33;13.04
87025;046301;Przedszkole Miejskie Nr 14|Toruń|ul. Inowrocławska 44 |87-100 Toruń;1736;942;942;5;937;54.26;0.53
87026;046301;Zespół Szkół Nr 15|Toruń|ul. Paderewskiego 5/11 |87-100 Toruń;2022;975;975;18;957;48.22;1.85
87027;046301;Dom Muz - Filia Podgórz|Toruń|ul. Poznańska 52 |87-100 Toruń;759;364;364;6;358;47.96;1.65
87028;046301;Zespół Szkół nr 15|Toruń|ul. Paderewskiego 5/11 |87-100 Toruń;1914;1018;1018;13;1005;53.19;1.28
87029;046301;Zespół Szkół nr 14|Toruń|ul. Gen. Hallera 79 |87-100 Toruń;1953;930;930;20;910;47.62;2.15
87030;046301;Zespół Szkół Nr 14|Toruń|ul. Gen. Hallera 79 |87-100 Toruń;1977;971;971;9;962;49.11;0.93
87031;046301;Zespół Szkół Nr 14|Toruń|ul. Gen. Hallera 79 |87-100 Toruń;2198;1353;1353;13;1340;61.56;0.96
87032;046301;Dom Muz - Filia Rudak|Toruń|ul. Okólna 169 |87-100 Toruń;2064;1264;1264;12;1252;61.24;0.95
87033;046301;Szkoła Podstawowa nr 17|Toruń|ul. Rudacka 26-32 |87-100 Toruń;587;279;279;4;275;47.53;1.43
87034;046301;Zespół Szkół nr 34|Toruń|ul. Włocławska 237/239 |87-100 Toruń;1809;1041;1041;9;1032;57.55;0.86
87035;046301;Szkoła Podstawowa nr 27|Toruń|ul. Turystyczna 19 |87-100 Toruń;1901;1255;1255;12;1243;66.02;0.96
87036;046301;Zespół Szkół nr 5|Toruń|ul. Kard. Wyszyńskiego 1/5 |87-100 Toruń;1745;983;983;11;972;56.33;1.12
87037;046301;Zespół Szkół nr 5|Toruń|ul. Kard. Wyszyńskiego 1/5 |87-100 Toruń;1101;630;630;9;621;57.22;1.43
87038;046301;Zespół Szkół nr 28|Toruń|ul. Przy Skarpie 13 |87-100 Toruń;1058;550;550;11;539;51.98;2.00
87039;046301;Zespół Szkół nr 28|Toruń|ul. Przy Skarpie 13 |87-100 Toruń;1500;897;897;11;886;59.80;1.23
87040;046301;III Liceum Ogólnokształcące|Toruń|ul. Raszei 1 |87-100 Toruń;1987;1175;1175;20;1155;59.13;1.70
87041;046301;Zespół Szkół Nr 5|Toruń|ul. Kard. Wyszyńskiego 1/5 |87-100 Toruń;1805;1077;1077;16;1061;59.67;1.49
87042;046301;III Liceum Ogólnokształcące|Toruń|ul. Raszei 1 |87-100 Toruń;1630;1004;1004;10;994;61.60;1.00
87043;046301;Przedszkole Miejskie nr 2|Toruń|ul. Stawisińskiego 7 |87-100 Toruń;1752;979;979;26;953;55.88;2.66
87044;046301;Zespół Szkół Ogólnokształcących nr 2|Toruń|ul. Kosynierów Kościuszkowskich 6 |87-100 Toruń;1049;535;535;4;531;51.00;0.75
87045;046301;Szkoła Podstawowa nr 32|Toruń|ul. Kosynierów Kościuszkowskich 11 |87-100 Toruń;1360;828;828;10;818;60.88;1.21
87046;046301;Zespół Szkół Ogólnokształcących nr 2|Toruń|ul. Kosynierów Kościuszkowskich 6 |87-100 Toruń;1286;779;779;11;768;60.58;1.41
87047;046301;Zespół Szkół Ogólnokształcących nr 2|Toruń|ul. Kosynierów Kościuszkowskich 6 |87-100 Toruń;1128;668;668;4;664;59.22;0.60
87048;046301;Szkoła Podstawowa Nr 32|Toruń|ul. Kosynierów Kościuszkowskich 11 |87-100 Toruń;1225;708;708;14;694;57.80;1.98
87049;046301;Szkoła Podstawowa Nr 32|Toruń|ul. Kosynierów Kościuszkowskich 11 |87-100 Toruń;1102;663;663;9;654;60.16;1.36
87050;046301;SM "Zieleniec"|Toruń|ul. Adama Asnyka 6b |87-100 Toruń;1291;685;685;11;674;53.06;1.61
87051;046301;Toruńskie Centrum Caritas|Toruń|ul. Szosa Bydgoska 1 |87-100 Toruń;1655;788;788;3;785;47.61;0.38
87052;046301;Miejski Ośrodek Sportu i Rekreacji|Toruń|ul. Słowackiego 118 A |87-100 Toruń;2166;1210;1210;11;1199;55.86;0.91
87053;046301;Miejski Zakład Komunikacji (wejście od ul. Słowackiego)|Toruń|ul. Sienkiewicza 24/26 |87-100 Toruń;885;423;423;8;415;47.80;1.89
87054;046301;Zespół Szkół nr 26|Toruń|ul. Fałata 88/90 |87-100 Toruń;1578;843;843;11;832;53.42;1.30
87055;046301;Szkoła Podstawowa Nr 11|Toruń|ul. Gagarina 36 |87-100 Toruń;1185;660;660;9;651;55.70;1.36
87056;046301;Szkoła Podstawowa Nr 11|Toruń|ul. Gagarina 36 |87-100 Toruń;856;489;489;9;480;57.13;1.84
87057;046301;Przedszkole Miejskie Nr 9|Toruń|ul. Gagarina 130 |87-100 Toruń;1751;880;880;15;865;50.26;1.70
87058;046301;Zespół Szkół nr 26|Toruń|ul. Fałata 88/90 |87-100 Toruń;831;422;422;8;414;50.78;1.90
87059;046301;V Liceum Ogólnokształcące|Toruń|ul. Sienkiewicza 34 |87-100 Toruń;1846;1040;1040;29;1011;56.34;2.79
87060;046301;Szkoła Podstawowa Nr 13|Toruń|ul. Krasińskiego 45/47 |87-100 Toruń;954;381;381;4;377;39.94;1.05
87061;046301;Szkoła Podstawowa Nr 13|Toruń|ul. Krasińskiego 45/47 |87-100 Toruń;944;514;514;17;497;54.45;3.31
87062;046301;Urząd Stanu Cywilnego|Toruń|ul. Bydgoska 5 |87-100 Toruń;1163;640;640;6;634;55.03;0.94
87063;046301;Centrum Kształcenia Ustawicznego|Toruń|ul. Rybaki 57 |87-100 Toruń;1092;547;547;10;537;50.09;1.83
87064;046301;Regionalna Dyrekcja Lasów Państwowych|Toruń|ul. Mickiewicza 9 |87-100 Toruń;1069;586;586;12;574;54.82;2.05
87065;046301;Sala gimnastyczna I Liceum Ogólnokształcącego|Toruń|ul. Mickiewicza 15-17 |87-100 Toruń;1366;575;575;8;567;42.09;1.39
87066;046301;Szkoła Podstawowa Nr 7|Toruń|ul. Bema 66 |87-100 Toruń;1492;941;941;8;933;63.07;0.85
87067;046301;Gimnazjum Nr 21|Toruń|ul. G. Morcinka 13 |87-100 Toruń;1028;607;607;6;601;59.05;0.99
87068;046301;Gimnazjum Nr 21|Toruń|ul. G. Morcinka 13 |87-100 Toruń;897;512;512;6;506;57.08;1.17
87069;046301;Klub Kameleon|Toruń|ul. Tuwima 9 |87-100 Toruń;910;575;575;9;566;63.19;1.57
87070;046301;Zespół Szkół Ekonomicznych|Toruń|ul. Grunwaldzka 39 |87-100 Toruń;1844;1188;1188;7;1181;64.43;0.59
87071;046301;Przedszkole Niepubliczne "Calineczka"|Toruń|ul. Osiedlowa 53 |87-100 Toruń;576;431;431;1;430;74.83;0.23
87072;046301;Szkoła Podstawowa nr 5|Toruń|ul. Żwirki i Wigury 1 |87-100 Toruń;2223;1338;1338;11;1327;60.19;0.82
87073;046301;Szkoła Podstawowa nr 5|Toruń|ul. Żwirki i Wigury 1 |87-100 Toruń;1496;842;842;14;828;56.28;1.66
87074;046301;Muzeum Etnograficzne|Toruń|ul. Wały Gen. Sikorskiego 19 |87-100 Toruń;547;205;205;3;202;37.48;1.46
87075;046301;OPP "Dom Harcerza"|Toruń|Rynek Staromiejski 7 |87-100 Toruń;904;426;426;13;413;47.12;3.05
87076;046301;I Liceum Ogólnokształcące|Toruń|ul. Zaułek Prosowy 1 |87-100 Toruń;530;248;248;7;241;46.79;2.82
87077;046301;Medyczno-Społeczne Centrum Kształcenia Zawodowego i Ustawicznego|Toruń|ul. Św. Jana 1/3 |87-100 Toruń;699;294;294;11;283;42.06;3.74
87078;046301;I Liceum Ogólnokształcące|Toruń|ul. Zaułek Prosowy 1 |87-100 Toruń;1004;359;359;9;350;35.76;2.51
87079;046301;Centrum Kształcenia Ustawicznego|Toruń|Plac Św. Katarzyny 8 |87-100 Toruń;885;366;366;2;364;41.36;0.55
87080;046301;Zespół Szkół Ogólnokształcących nr 4|Toruń|ul. Warszawska 1/5 |87-100 Toruń;690;283;283;8;275;41.01;2.83
87081;046301;Zespół Szkół Technicznych|Toruń|ul. Legionów 19/25 |87-100 Toruń;2003;1177;1177;19;1158;58.76;1.61
87082;046301;Zespół Szkół Technicznych|Toruń|ul. Dekerta 4 |87-100 Toruń;1652;992;992;16;976;60.05;1.61
87083;046301;Prywatne Przedszkole "Krasnal"|Toruń|ul. Lelewela 5 |87-100 Toruń;1533;917;917;15;902;59.82;1.64
87084;046301;Przedszkole Niepubliczne "Raczek"|Toruń|ul. Przy Kaszowniku 7 |87-100 Toruń;958;516;516;15;501;53.86;2.91
87085;046301;Zespół Szkół Technicznych|Toruń|ul. Legionów 19/25 |87-100 Toruń;1174;673;673;7;666;57.33;1.04
87086;046301;Przedszkole Miejskie Nr 5|Toruń|ul. Dekerta 27/35 |87-100 Toruń;1673;963;963;11;952;57.56;1.14
87087;046301;Zespół Szkół Nr 24|Toruń|ul. Ogrodowa 3/5 |87-100 Toruń;1721;1046;1046;15;1031;60.78;1.43
87088;046301;Gimnazjum Nr 3|Toruń|ul. Żwirki i Wigury 49 |87-100 Toruń;1437;808;808;7;801;56.23;0.87
87089;046301;Szkoła Podstawowa nr 3|Toruń|ul. Legionów 210 |87-100 Toruń;1687;1027;1027;16;1011;60.88;1.56
87090;046301;Gimnazjum Nr 3|Toruń|ul. Żwirki i Wigury 49 |87-100 Toruń;2266;1388;1388;27;1361;61.25;1.95
87091;046301;Szkoła Podstawowa nr 3|Toruń|ul. Legionów 210 |87-100 Toruń;1914;1258;1258;11;1247;65.73;0.87
87092;046301;Urząd Miasta Torunia|Toruń|ul. Legionów 220 |87-100 Toruń;1642;1057;1057;14;1043;64.37;1.32
87093;046301;Przedszkole Miejskie Nr 6|Toruń|ul. Szosa Chełmińska 130 |87-100 Toruń;2230;1360;1360;10;1350;60.99;0.74
87094;046301;Zespół Szkół Muzycznych|Toruń|ul. Szosa Chełmińska 224/226 |87-100 Toruń;2228;1290;1290;29;1261;57.90;2.25
87095;046301;Zespół Szkół Nr 9|Toruń|ul. Rzepakowa 7/9 |87-100 Toruń;2232;1350;1350;14;1336;60.48;1.04
87096;046301;Zespół Szkół Nr 9|Toruń|ul. Rzepakowa 7/9 |87-100 Toruń;2090;1329;1329;20;1309;63.59;1.50
87097;046301;Przedszkole Miejskie Nr 8|Toruń|ul. Chabrowa 49 |87-100 Toruń;2305;1481;1481;10;1471;64.25;0.68
87098;046301;Miejski Zarząd Dróg|Toruń|ul. Grudziądzka 159 |87-100 Toruń;1731;884;884;13;871;51.07;1.47
87099;046301;Urząd Pocztowy Toruń 2|Toruń|ul. Polna 15 |87-100 Toruń;690;177;177;0;177;25.65;0.00
87100;046301;Geofizyka Toruń S.A.|Toruń|ul. Chrobrego 50 |87-100 Toruń;679;296;296;4;292;43.59;1.35
87101;046301;Zespół Szkół Inżynierii Środowiska|Toruń|ul. Batorego 43/49 |87-100 Toruń;432;138;138;4;134;31.94;2.90
87102;046301;Szkoła Podstawowa Nr 6|Toruń|ul. Łąkowa 13 |87-100 Toruń;1596;937;937;9;928;58.71;0.96
87103;046301;Szkoła Podstawowa Nr 6|Toruń|ul. Łąkowa 13 |87-100 Toruń;973;590;590;11;579;60.64;1.86
87104;046301;Przedszkole Miejskie Nr 7|Toruń|ul. Łąkowa 44 |87-100 Toruń;1646;954;954;19;935;57.96;1.99
87105;046301;Filia Przedszkola Miejskiego Nr 5|Toruń|ul. Czarnieckiego 8 |87-100 Toruń;836;349;349;6;343;41.75;1.72
87106;046301;Zespół Szkół Nr 1|Toruń|ul. Wojska Polskiego 47a |87-100 Toruń;1096;623;623;6;617;56.84;0.96
87107;046301;Zespół Szkół Nr 1|Toruń|ul. Wojska Polskiego 47a |87-100 Toruń;1465;831;831;19;812;56.72;2.29
87108;046301;Zespół Szkół Nr 7|Toruń|ul. Bażyńskich 30/36 |87-100 Toruń;1339;731;732;14;717;54.59;1.92
87109;046301;Przedszkole Miejskie Nr 15|Toruń|ul. Bażyńskich 22 |87-100 Toruń;958;543;543;8;535;56.68;1.47
87110;046301;Przedszkole Miejskie Nr 16|Toruń|ul. Mjr. Sucharskiego 2 |87-100 Toruń;816;480;480;4;476;58.82;0.83
87111;046301;Polski Związek Działkowców Okręgowy Zarząd Toruńsko-Włocławski|Toruń|ul. Lubicka 12a |87-100 Toruń;1890;1111;1111;5;1106;58.78;0.45
87112;046301;Szkoła Podstawowa Nr 2|Toruń|ul. Targowa 17 |87-100 Toruń;1651;812;812;13;799;49.18;1.60
87113;046301;Zespół Szkół Ogólnokształcących i Technicznych nr 13|Toruń|ul. Targowa 36/38 |87-100 Toruń;1323;848;848;13;835;64.10;1.53
87114;046301;Zespół Szkół Ogólnokształcących i Technicznych nr 13|Toruń|ul. Targowa 36/38 |87-100 Toruń;1518;740;740;21;719;48.75;2.84
87115;046301;Przedszkole Miejskie nr 3|Toruń|ul. Skłodowskiej-Curie 43/45 |87-100 Toruń;450;156;156;5;151;34.67;3.21
87116;046301;Szkoła Podstawowa Nr 23|Toruń|ul. Osikowa 11 |87-100 Toruń;1613;996;996;12;984;61.75;1.20
87117;046301;Warsztaty Terapii Zajęciowej "Bratanki"|Toruń|ul. Rydygiera 23 |87-100 Toruń;1533;893;893;23;870;58.25;2.58
87118;046301;Przedszkole Miejskie Nr 10|Toruń|ul. Rydygiera 12 |87-100 Toruń;1320;717;717;13;704;54.32;1.81
87119;046301;Placówka Opiekuńczo-Wychowawcza nr 4|Toruń|ul. Donimirskiego 4 |87-100 Toruń;1761;989;989;17;972;56.16;1.72
87120;046301;Przedszkole "Jaś i Małgosia"|Toruń|ul. Donimirskiego 4 |87-100 Toruń;790;477;477;8;469;60.38;1.68
87121;046301;Ośrodek Rehabilitacji Dziennej|Toruń|ul. Łyskowskiego 15 |87-100 Toruń;1537;861;861;10;851;56.02;1.16
87122;046301;IX Liceum Ogólnokształcące|Toruń|ul. Rydygiera 12a |87-100 Toruń;1143;696;696;13;683;60.89;1.87
87123;046301;IX Liceum Ogólnokształcące|Toruń|ul. Rydygiera 12a |87-100 Toruń;1352;734;734;10;724;54.29;1.36
87124;046301;Zespół Szkół nr 8|Toruń|ul. Łyskowskiego 28 |87-100 Toruń;745;453;453;4;449;60.81;0.88
87125;046301;Zespół Szkół Nr 8|Toruń|ul. Łyskowskiego 28 |87-100 Toruń;1422;834;834;17;817;58.65;2.04
87126;046301;Zespół Szkół Nr 16|Toruń|ul. Dziewulskiego 2 |87-100 Toruń;1300;676;676;15;661;52.00;2.22
87127;046301;Żłobek Miejski Nr 2|Toruń|ul. Piskorskiej 9 |87-100 Toruń;1301;738;738;8;730;56.73;1.08
87128;046301;Zespół Szkół Nr 16|Toruń|ul. Dziewulskiego 2 |87-100 Toruń;1947;1108;1108;16;1092;56.91;1.44
87129;046301;Klub "Jantar"|Toruń|ul. Dziewulskiego 12 |87-100 Toruń;1373;644;644;18;626;46.90;2.80
87130;046301;Przedszkole Miejskie Nr 11|Toruń|ul. Niesiołowskiego 4 |87-100 Toruń;1301;713;713;13;700;54.80;1.82
87131;046301;Społeczna Szkoła Podstawowa im. J. Słowackiego|Toruń|ul. Dziewulskiego 24a |87-100 Toruń;1237;669;669;12;657;54.08;1.79
87132;046301;EDF S.A.|Toruń|ul. Ceramiczna 6 |87-100 Toruń;1267;589;589;13;576;46.49;2.21
87133;046301;CEG-TOR|Toruń|ul. Olsztyńska 117 |87-100 Toruń;1996;943;944;9;934;47.24;0.95
87134;046301;Szkoła Podstawowa nr 35|Toruń|ul. Krynicka 8 |87-100 Toruń;1098;664;664;4;660;60.47;0.60
87135;046301;Szkoła Podstawowa nr 35|Toruń|ul. Krynicka 8 |87-100 Toruń;1369;794;794;20;774;58.00;2.52
87136;046301;Areszt Śledczy|Toruń|ul. Piekary 53 |87-100 Toruń;115;53;53;7;46;46.09;13.21
87137;046301;Specjalistyczny Szpital Miejski im. M. Kopernika|Toruń|ul. Batorego 17/19 |87-100 Toruń;182;84;84;4;80;46.15;4.76
87138;046301;Wojewódzki Szpital Zespolony- Szpital Wielospecjalistyczny|Toruń|ul. Św. Józefa 53-59 |87-100 Toruń;320;115;115;6;109;35.94;5.22
87139;046301;Wojewódzki Szpital Zespolony- Szpital Obserwacyjno-Zakaźny|Toruń|ul. Krasińskiego 4-4a |87-100 Toruń;59;35;35;7;28;59.32;20.00
87140;046301;Wojewódzki Szpital Zespolony- Szpital Psychiatryczny|Toruń|ul. Mickiewicza 24/26 |87-100 Toruń;49;14;14;1;13;28.57;7.14
87141;046301;Wojewódzki Szpital Zespolony- Szpital Psychiatryczny|Toruń|ul. Skłodowskiej Curie 27/29 |87-100 Toruń;64;18;18;2;16;28.12;11.11
87142;046301;Dom Pomocy Społecznej im. dr Leona Szumana|Toruń|ul. Szosa Chełmińska 220 |87-100 Toruń;102;51;51;4;47;50.00;7.84
87143;046301;Zakład Pielęgnacyjno-Opiekuńczy im. Ks. Jerzego Popiełuszki|Toruń|ul. Ligi Polskiej 8 |87-100 Toruń;38;11;11;0;11;28.95;0.00
87144;046301;Dom Pomocy Społecznej Fundacji im. Brata Alberta|Toruń|ul. Rydygiera 23 |87-100 Toruń;19;14;14;5;9;73.68;35.71
87145;046301;Wojewódzki Ośrodek Terapii Uzależnień i Współuzależnienia-Oddział Odwykowy Całodobowy|Toruń|ul. Włocławska 233-235 |87-100 Toruń;58;26;26;4;22;44.83;15.38
87146;046301;Wojewódzki Ośrodek Terapii Uzależnień i Współuzależnienia-Oddział Terapii Odwykowej Uzależnień|Toruń|ul. Tramwajowa 2/4 |87-100 Toruń;22;22;22;9;13;100.00;40.91
87147;046301;Dom Studencki nr 2 UMK|Toruń|ul. Mickiewicza 6/8 |87-100 Toruń;202;181;181;5;176;89.60;2.76
87148;046301;Dom Studencki nr 9 UMK|Toruń|ul. Gagarina 21 |87-100 Toruń;293;271;271;8;263;92.49;2.95
87149;046401;Gimnazjum Nr 9|Włocławek|ul.Wojska Polskiego 27 |87-800 Włocławek;1292;567;567;14;553;43.89;2.47
87150;046401;Szkoła Podstawowa Nr 3|Włocławek|ul.Cyganka 6/10 |87-800 Włocławek;1008;349;350;11;338;34.62;3.15
87151;046401;Szkoła Podstawowa Nr 3|Włocławek|ul.Cyganka 6/10 |87-800 Włocławek;1328;447;447;27;420;33.66;6.04
87152;046401;"Włocławskie Centrum Organizacji Pozarządowych i Wolontariatu"|Włocławek|ul.Żabia 12a |87-800 Włocławek;1385;350;350;25;325;25.27;7.14
87153;046401;Galeria Sztuki Współczesnej|Włocławek|ul.Miedziana 2/4 |87-800 Włocławek;986;363;363;8;355;36.82;2.20
87154;046401;Galeria Sztuki Współczesnej|Włocławek|ul.Miedziana 2/4 |87-800 Włocławek;990;407;407;11;396;41.11;2.70
87155;046401;Miejska Biblioteka Publiczna|Włocławek|ul.Warszawska 11/13 |87-800 Włocławek;1478;597;597;17;580;40.39;2.85
87156;046401;MOPR|Włocławek|ul. Ogniowa 8/10 |87-800 Włocławek;1499;555;555;16;539;37.02;2.88
87157;046401;Gimnazjum Nr 14|Włocławek|Plac Staszica 1 |87-800 Włocławek;1650;702;702;16;686;42.55;2.28
87158;046401;Zespół Szkół Ekonomicznych|Włocławek|ul.Bukowa 38/40 |87-800 Włocławek;1854;858;858;33;825;46.28;3.85
87159;046401;Zespół Szkół Ekonomicznych|Włocławek|ul.Bukowa 38/40 |87-800 Włocławek;1756;842;842;13;829;47.95;1.54
87160;046401;Szkoła Podstawowa Nr 14|Włocławek|ul.Bukowa 9 |87-800 Włocławek;1443;707;707;18;689;49.00;2.55
87161;046401;Szkoła Podstawowa Nr 14|Włocławek|ul.Bukowa 9 |87-800 Włocławek;1186;609;609;12;597;51.35;1.97
87162;046401;Zespół Szkół Nr 11|Włocławek|ul.Papieżka 89 |87-800 Włocławek;2028;863;863;21;842;42.55;2.43
87163;046401;Zespół Szkół Nr 11|Włocławek|ul.Papieżka 89 |87-800 Włocławek;1486;639;639;3;636;43.00;0.47
87164;046401;Budynek dawnego Gimnazjum nr 14|Włocławek|ul.Leśna 27 |87-800 Włocławek;1759;643;643;24;619;36.55;3.73
87165;046401;Szkoła Podstawowa Nr 2|Włocławek|ul.Żytnia 47 |87-800 Włocławek;1405;688;688;17;671;48.97;2.47
87166;046401;Szkoła Podstawowa Nr 2|Włocławek|ul.Żytnia 47 |87-800 Włocławek;1686;845;845;19;826;50.12;2.25
87167;046401;Gimnazjum Nr 2|Włocławek|ul.Żytnia 47 |87-800 Włoclawek;1498;649;649;25;624;43.32;3.85
87168;046401;Przychodnia Nr 5 Miejskiego Zespołu Opieki Zdrowotnej|Włocławek|ul.Żytnia 55 |87-800 Włocławek;1443;704;704;28;676;48.79;3.98
87169;046401;Zespół Szkół Samochodowych|Włocławek|ul.Leśna 1A |87-800 Włocławek;1065;510;510;10;500;47.89;1.96
87170;046401;Zespół Szkół Samochodowych|Włocławek|ul.Leśna 1A |87-800 Włocławek;1478;690;690;31;659;46.68;4.49
87171;046401;Zespół Szkół Samochodowych|Włocławek|ul.Leśna 1A |87-800 Włocławek;1216;535;535;11;524;44.00;2.06
87172;046401;Zespół Szkół Nr 8|Włocławek|ul.Willowa 8 |87-800 Włocławek;1435;869;869;7;862;60.56;0.81
87173;046401;Zespół Szkół Nr 8|Włocławek|ul.Willowa 8 |87-800 Włocławek;1335;658;658;10;648;49.29;1.52
87174;046401;Szkoła Podstawowa Nr 10|Włocławek|ul.Starodębska 21 |87-800 Włocławek;1058;402;402;18;384;38.00;4.48
87175;046401;Zespół Szkół nr 3|Włocławek|ul.Nowomiejska 21 |87-800 Włocławek;557;234;234;5;229;42.01;2.14
87176;046401;Zespół Szkół Muzycznych|Włocławek|ul.Wiejska 29 |87-800 Włocławek;1744;743;743;11;732;42.60;1.48
87177;046401;Zespół Szkół Muzycznych|Włocławek|ul.Wiejska 29 |87-800 Włocławek;1633;829;834;14;815;50.77;1.69
87178;046401;Zespół Szkół Nr 7|Włocławek|ul.Gniazdowskiego 7 |87-800 Włocławek;1704;780;780;17;763;45.77;2.18
87179;046401;Zespół Szkół Nr 7|Włocławek|ul.Gniazdowskiego 7 |87-800 Włocławek;1836;854;854;17;837;46.51;1.99
87180;046401;Szkoła Podstawowa Nr 12|Włocławek|ul.Wiejska 29 |87-800 Włocławek;1167;585;585;8;577;50.13;1.37
87181;046401;Szkoła Podstawowa Nr 12|Włocławek|ul.Wiejska 29 |87-800 Włocławek;1447;673;673;14;659;46.51;2.08
87182;046401;Szkoła Podstawowa Nr 12|Włocławek|ul.Wiejska 29 |87-800 Włocławek;1140;520;520;10;510;45.61;1.92
87183;046401;Miejska Biblioteka Publiczna Filia Nr 2|Włocławek|ul.Dziewińska 17 |87-800 Włocławek;1799;794;794;24;770;44.14;3.02
87184;046401;Spółdzielnia Mieszkaniowa "Południe"|Włocławek|ul.Broniewskiego 7 |87-800 Włocławek;1199;660;660;14;646;55.05;2.12
87185;046401;Spółdzielnia Mieszkaniowa "Południe"|Włocławek|ul.Broniewskiego 7 |87-800 Włocławek;1107;489;489;9;480;44.17;1.84
87186;046401;Szkoła Podstawowa Nr 20|Włocławek|ul.Gałczyńskiego 9a |87-800 Włocławek;1338;709;709;12;697;52.99;1.69
87187;046401;Szkoła Podstawowa Nr 20|Włocławek|ul.Gałczyńskiego 9a |87-800 Włocławek;1580;880;880;9;871;55.70;1.02
87188;046401;Szkoła Podstawowa Nr 20|Włocławek|ul.Gałczyńskiego 9a |87-800 Włocławek;1489;833;833;13;820;55.94;1.56
87189;046401;Szkoła Podstawowa Nr 23|Włocławek|ul.Wyspiańskiego 3 |87-800 Włocławek;1391;740;740;11;729;53.20;1.49
87190;046401;Gimnazjum Nr 4|Włocławek|ul.Wyspiańskiego 3 |87-800 Włocławek;1514;767;767;5;762;50.66;0.65
87191;046401;Przedszkole Publiczne Nr 36|Włocławek|ul.Wyspiańskiego 3 |87-800 Włocławek;1474;792;792;11;781;53.73;1.39
87192;046401;Zespół Szkół Nr 4|Włocławek|ul.Kaliska 108 |87-800 Włocławek;1100;583;583;14;569;53.00;2.40
87193;046401;Zespół Szkół Nr 4|Włocławek|ul.Kaliska 108 |87-800 Włocławek;1468;749;749;14;735;51.02;1.87
87194;046401;Zespół Szkół Nr 4|Włocławek|ul.Kaliska 108 |87-800 Włocławek;1318;709;709;7;702;53.79;0.99
87195;046401;Zespół Szkół Nr 10|Włocławek|ul.Szkolna 13 |87-800 Włocławek;1588;787;787;17;770;49.56;2.16
87196;046401;Zespół Szkół Nr 10|Włocławek|ul.Szkolna 13 |87-800 Włocławek;1598;912;912;22;890;57.07;2.41
87197;046401;Zespół Szkół Nr 10|Włocławek|ul.Szkolna 13 |87-800 Włocławek;1602;897;897;11;886;55.99;1.23
87198;046401;Zespół Szkół Nr 10|Włocławek|ul.Szkolna 13 |87-800 Włocławek;1637;873;873;14;859;53.33;1.60
87199;046401;Kujawska Szkoła Wyższa budynek Collegium Maius (dawne WSHE)|Włocławek|ul.Okrzei 94 |87-800 Włocławek;1135;413;413;3;410;36.39;0.73
87200;046401;Zespół Szkół Integracyjnych Nr 1|Włocławek|ul.Wieniecka 46 |87-800 Włocławek;1575;720;720;13;707;45.71;1.81
87201;046401;Zespół Szkół Integracyjnych Nr 1|Włocławek|ul.Wieniecka 46 |87-800 Włocławek;1732;823;823;12;811;47.52;1.46
87202;046401;Zespół Szkół Integracyjnych Nr 1|Włocławek|ul.Wieniecka 46 |87-800 Włocławek;1165;642;642;17;625;55.11;2.65
87203;046401;II Liceum Ogólnokształcące im.Mikołaja Kopernika|Włocławek|ul.Urocza 3 |87-800 Włocławek;1953;1006;1006;16;990;51.51;1.59
87204;046401;Zespół Szkół Nr 9|Włocławek|ul.Promienna 15 |87-800 Włocławek;1285;677;677;8;669;52.68;1.18
87205;046401;Zespół Szkół Nr 9|Włocławek|ul.Promienna 15 |87-800 Włocławek;1337;739;739;11;728;55.27;1.49
87206;046401;Zespół Szkół Nr 9|Włocławek|ul.Promienna 15 |87-800 Włocławek;1330;693;693;16;677;52.11;2.31
87207;046401;Szkoła Podstawowa Nr 18|Włocławek|ul.Hutnicza 5/7 |87-800 Włocławek;1674;889;889;29;860;53.11;3.26
87208;046401;Szkoła Podstawowa Nr 18|Włocławek|ul.Hutnicza 5/7 |87-800 Włocławek;1238;572;572;11;561;46.20;1.92
87209;046401;Centrum Kultury Browar B|Włocławek|ul.Toruńska 87 |87-800 Włocławek;1286;704;704;13;691;54.74;1.85
87210;046401;Zespół Placówek Nr 1 (Bursa Szkolna Nr 2)|Włocławek|ul.Mechaników 1 |87-800 Włocławek;1440;731;731;13;718;50.76;1.78
87211;046401;Ośrodek Szkolenia Zawodowego|Włocławek|ul.Inowrocławska 10 |87-800 Włocławek;934;216;216;5;211;23.13;2.31
87212;046401;Dom Pomocy Społecznej|Włocławek|Dobrzyńska 102 |87-800 Włocławek;48;21;21;7;14;43.75;33.33
87213;046401;Dom Pomocy Społecznej|Włocławek|Nowomiejska 19 |87-800 Włocławek;63;25;25;6;19;39.68;24.00
87214;046401;Miejski Zespół Opieki Zdrowotnej sp. z o.o. - Dom Pomocy Społecznej|Włocławek|Żeromskiego 28a |87-800 Włocławek;32;18;18;3;15;56.25;16.67
87215;046401;Szpital Wojewódzki|Włocławek|Wieniecka 49 |87-800 Włocławek;279;63;63;7;56;22.58;11.11
87216;046401;Zakład Karny|Włocławek|Bartnicka 10 |87-800 Włocławek;1034;406;406;68;338;39.26;16.75
87217;060101;Samorządowe Przedszkole Nr 2 w Międzyrzecu Podlaskim|Międzyrzec Podlaski|ul. Przedszkolna 2 |21-560 Międzyrzec Podlaski;1590;790;790;30;760;49.69;3.80
87218;060101;Liceum Ogólnokształcące w Międzyrzecu Podlaskim|Międzyrzec Podlaski|ul. Lubelska 57 |21-560 Międzyrzec Podlaski;714;332;332;11;321;46.50;3.31
87219;060101;Zespół Szkół Ponadgimnazjalnych w Międzyrzecu Podlaskim|Międzyrzec Podlaski|ul. Warszawska 30 |21-560 Międzyrzec Podlaski;789;413;413;9;404;52.34;2.18
87220;060101;Zespół Placówek Oświatowych Nr 1 w Międzyrzecu Podlaskim|Międzyrzec Podlaski|ul. Warszawska 40 |21-560 Międzyrzec Podlaski;909;494;494;12;482;54.35;2.43
87221;060101;Zespół Szkół Ekonomicznych w Międzyrzecu Podlaskim|Międzyrzec Podlaski|ul. 3-go Maja 40/42 |21-560 Międzyrzec Podlaski;1830;995;995;21;974;54.37;2.11
87222;060101;Zespół Placówek Oświatowych Nr 3 w Międzyrzecu Podlaskim|Międzyrzec Podlaski|ul. Leśna 2 |21-560 Międzyrzec Podlaski;1979;977;977;30;947;49.37;3.07
87223;060101;Strażnica OSP "Zawadki" w Międzyrzecu Podlaskim|Międzyrzec Podlaski|ul. Zawadki 8 |21-560 Międzyrzec Podlaski;972;530;530;10;520;54.53;1.89
87224;060101;Hala sportowa Zespołu Placówek Oświatowych Nr 2 w Międzyrzecu Podlaskim|Międzyrzec Podlaski|ul. Partyzantów 8 |21-560 Międzyrzec Podlaski;1884;1035;1035;22;1013;54.94;2.13
87225;060101;Świetlica Zespołu Placówek Oświatowych Nr 2 w Międzyrzecu Podlaskim|Międzyrzec Podlaski|ul.Partyzantów 8 |21-560 Międzyrzec Podlaski;862;444;444;14;430;51.51;3.15
87226;060101;Świetlica Spółdzielni Mieszkaniowej w Międzyrzecu Podlaskim|Międzyrzec Podlaski|ul. Prymasa Stefana Wyszyńskiego 7 |21-560 Międzyrzec Podlaski;2189;1192;1192;19;1173;54.45;1.59
87227;060101;Szpital Powiatowy w Międzyrzecu Podlaskim|Międzyrzec Podlaski|ul. Warszawska 2-4 |21-560 ;65;38;38;3;35;58.46;7.89
87228;060102;Zespół Szkół Publicznych Nr 1|Terespol|ul. H. Sienkiewicza 27 |21-550 Terespol;1752;874;874;43;831;49.89;4.92
87229;060102;Miejska Biblioteka Publiczna|Terespol|ul. Wojska Polskiego 132 |21-550 Terespol;1441;724;724;18;706;50.24;2.49
87230;060102;Zespół Szkół Ogólnokształcących|Terespol|ul. Wojska Polskiego 88 |21-550 Terespol;1430;730;730;18;712;51.05;2.47
87231;060103;Publiczne Gimnazjum w Ciciborze Dużym|Cicibór Duży| 1 |21-500 Biała Podlaska;595;285;285;6;279;47.90;2.11
87232;060103;Szkoła Podstawowa w Hrudzie|Hrud| 33 |21-500 Biała Podlaska;690;268;268;5;263;38.84;1.87
87233;060103;Świetlica wiejska w Rakowiskach|Rakowiska|ul. Wspólna 101 |21-500 Biała Podlaska;1098;670;670;17;653;61.02;2.54
87234;060103;Szkoła Podstawowa w Dokudowie Pierwszym|Dokudów Pierwszy| 37 |21-500 Biała Podlaska;403;140;140;5;135;34.74;3.57
87235;060103;Szkoła Podstawowa w Ortelu Książęcym Drugim|Ortel Książęcy Drugi| 33 |21-500 Biała Podlaska;483;235;235;1;234;48.65;0.43
87236;060103;Szkoła Podstawowa w Grabanowie|Grabanów| 49A |21-500 Biała Podlaska;911;472;472;11;461;51.81;2.33
87237;060103;Szkoła Podstawowa w Sitniku|Sitnik| 47 |21-500 Biała Podlaska;453;250;250;2;248;55.19;0.80
87238;060103;Świetlica wiejska w Terebeli|Terebela| 21 |21-500 Biała Podlaska;288;161;161;4;157;55.90;2.48
87239;060103;Szkoła Podstawowa w Sławacinku Starym|Sławacinek Stary| 72 A |21-500 Biała Podlaska;1589;735;735;15;720;46.26;2.04
87240;060103;Szkoła Podstawowa w Styrzyńcu|Styrzyniec|ul. Dworska 29A |21-500 Biała Podlaska;525;252;252;7;245;48.00;2.78
87241;060103;Szkoła Podstawowa w Sworach|Swory|ul. Szkolna 34 |21-500 Biała Podlaska;1289;661;661;14;647;51.28;2.12
87242;060103;Świetlica wiejska w Czosnówce|Czosnówka|ul. Topolowa 37 |21-500 Biała Podlaska;588;292;292;9;283;49.66;3.08
87243;060103;Szkoła Podstawowa w Janówce|Janówka| 8 |21-500 Biała Podlaska;638;309;309;14;295;48.43;4.53
87244;060103;Szkoła Podstawowa w Woskrzenicach Dużych|Woskrzenice Duże| 91 |21-500 Biała Podlaska;1020;493;493;18;475;48.33;3.65
87245;060103;Dom Pomocy Społecznej w Kozuli|Kozula| 1 |21-500 Biała Podlaska;129;57;57;5;52;44.19;8.77
87246;060104;Gimnazjum Nr 1 w Drelowie|Drelów|ul. Szkolna 11 |21-570 Drelów;1752;800;800;36;764;45.66;4.50
87247;060104;Zespół Szkół w Dołdze|Dołha| 1 |21-570 Drelów;795;337;337;22;315;42.39;6.53
87248;060104;Szkoła Podstawowa w Szóstce|Szóstka| 8 |21-570 Drelów;889;409;409;15;394;46.01;3.67
87249;060104;Szkoła Podstawowa w Żerocinie|Żerocin| 32 |21-570 Drelów;625;270;270;16;254;43.20;5.93
87250;060104;Szkoła Podstawowa w Witorożu|Witoroż| 2 |21-570 Drelów;335;150;150;6;144;44.78;4.00
87251;060105;Świetlica Wiejska w Werchlisiu|Werchliś| 75 |21-505 Janów Podlaski;547;208;208;6;202;38.03;2.88
87252;060105;Świetlica Wiejska w Bublu-Grannie|Bubel-Granna| 78 |21-505 Janów Podlaski;290;119;119;6;113;41.03;5.04
87253;060105;Szkoła Podstawowa w Janowie Podlaskim|Janów Podlaski|ul. 1-Maja 5 |21-505 Janów Podlaski;1498;755;755;25;730;50.40;3.31
87254;060105;Świetlica Wiejska w Nowym Pawłowie|Nowy Pawłów| 124 |21-505 Janów Podlaski;579;258;258;7;251;44.56;2.71
87255;060105;Gimnazjum Publiczne w Janowie Podlaskim|Janów Podlaski|ul. 1-Maja 3 |21-505 ulice:;1381;597;597;8;589;43.23;1.34
87256;060106;Gminne Centrum Kultury,Sportu i Turystyki w Kodniu|Kodeń, Kodeń Drugi|ul. Rynek 4 |21-509 Kodeń;1752;910;910;44;866;51.94;4.84
87257;060106;Kopytów - Świetlica Wiejska|Kopytów| 10 |21-509 Kodeń;396;123;123;3;120;31.06;2.44
87258;060106;Dobratycze - Świetlica Wiejska|Dobratycze| 38 |21-509 Kodeń;391;115;115;10;105;29.41;8.70
87259;060106;Kostomłoty I - Świetlica Wiejska|Kostomłoty I| |21-509 Kodeń;265;109;109;4;105;41.13;3.67
87260;060106;Zabłocie - Wiejski Dom Kultury|Zabłocie| 107 |21-509 Kodeń;302;133;133;5;128;44.04;3.76
87261;060106;Zakład Karny w Zabłociu|Zabłocie| 122 |21-509 Kodeń;119;37;37;9;28;31.09;24.32
87262;060107;Sala Widowiskowa Gminnego Centrum Kultury w Konstantynowie|Konstantynów|ul. Piłsudskiego 4 |21-543 Konstantynów;1100;547;547;16;531;49.73;2.93
87263;060107;Gimnazjum w Konstantynowie|Konstantynów|ul. Nowa 2 |21-543 Konstantynów;1133;452;452;12;440;39.89;2.65
87264;060107;Budynek Schroniska "Przystań" w Gnojnie|Gnojno| 48 |21-543 Konstantynów;196;100;100;3;97;51.02;3.00
87265;060107;Szkoła Podstawowa w Komarnie-Kolonii|Komarno-Kolonia| 13 |21-543 Konstantynów;767;293;293;14;279;38.20;4.78
87266;060107;Dom Pomocy Społecznej w Konstantynowie|Konstantynów|ul. Kardynała Wyszyńskiego 10 |21-543 Konstantynów;75;47;47;13;34;62.67;27.66
87267;060108;Szkoła Podstawowa w Leśnej Podlaskiej|Leśna Podlaska|ul. Bialska 25 |21-542 Leśna Podlaska;1701;807;807;19;788;47.44;2.35
87268;060108;Świetlica Wiejska w Witulinie|Witulin| 64A |21-542 Leśna Podlaska;633;240;240;9;231;37.91;3.75
87269;060108;Szkoła Podstawowa w Ossówce|Ossówka| 12A |21-542 Leśna Podlaska;0;0;0;0;0;-99;-99
87270;060108;Świetlica Wiejska w Starej Bordziłówce|Stara Bordziłówka| 32 |21-542 Leśna Podlaska;795;344;344;15;329;43.27;4.36
87271;060109;Szkoła Podstawowa w Dubowie|Dubów| 93 |21-532 Łomazy;568;272;272;6;266;47.89;2.21
87272;060109;Szkoła Podstawowa w Huszczy|Huszcza Pierwsza| 34 |21-532 Łomazy;452;189;189;3;186;41.81;1.59
87273;060109;Budynek poszkolny w Korczówce|Korczówka| 64 |21-532 Łomazy;381;153;153;8;145;40.16;5.23
87274;060109;Zespół Szkół w Łomazach|Łomazy|ul. Szkolna 18A |21-532 Łomazy;2140;1040;1040;15;1025;48.60;1.44
87275;060109;Budynek poszkolny w Burwinie|Burwin| 33 |21-532 Łomazy;211;91;91;6;85;43.13;6.59
87276;060109;Świetlica wiejska w Kopytniku|Kopytnik| 31A |21-532 Łomazy;243;124;124;1;123;51.03;0.81
87277;060109;Budynek poszkolny w Koszołach|Koszoły| 40 |21-532 Łomazy;200;72;72;1;71;36.00;1.39
87278;060110;Gimnazjum Publiczne w Jelnicy|Jelnica| 84 |21-560 Międzyrzec Podlaski;777;403;403;18;385;51.87;4.47
87279;060110;Szkoła Podstawowa w Tuliłowie|Tuliłów| 61A |21-560 Międzyrzec Podlaski;677;301;301;11;290;44.46;3.65
87280;060110;Szkoła Podstawowa w Rogoźnicy|Rogoźnica| 96 |21-560 Miedzyrzec Podlaski;734;387;387;13;374;52.72;3.36
87281;060110;Szkoła Podstawowa w Tłuśćcu|Tłuściec| 112 |21-560 Międzyrzec Podlaski;730;372;372;25;347;50.96;6.72
87282;060110;Szkoła Podstawowa w Kożuszkach|Kożuszki| 37 |21-560 Międzyrzec Podlaski;458;245;245;13;232;53.49;5.31
87283;060110;Gimnazjum Publiczne w Krzewicy|Krzewica| 44 |21-560 Międzyrzec Podlaski;381;193;193;3;190;50.66;1.55
87284;060110;Urząd Gminy w Międzyrzecu Podlaskim|Międzyrzec Podlaski|Warszawska 20 |21-560 Międzyrzec Podlaski;478;249;249;17;232;52.09;6.83
87285;060110;Szkoła Podstawowa w Halasach|Halasy| 41 |21-560 Międzyrzec Podlaski;681;283;283;15;268;41.56;5.30
87286;060110;Gminny Ośrodek Kultury w Maniach|Manie| 24 |21-560 Międzyrzec Podlaski;597;323;323;18;305;54.10;5.57
87287;060110;Szkoła Podstawowa w Misiach|Misie| 118 |21-560 Miedzyrzec Podlaski;1065;568;568;17;551;53.33;2.99
87288;060110;Szkoła Podstawowa w Rudnikach|Rudniki| 2 |21-560 Międzyrzec Podlaski;903;426;426;27;399;47.18;6.34
87289;060110;Szkoła Podstawowa w Rzeczycy|Rzeczyca|Gościniec 74 |21-560 Międzyrzec Podlaski;682;335;335;14;321;49.12;4.18
87290;060111;Zespół Placówek Oświatowych w Chotyłowie|Chotyłów|ul. Piszczacka 50 |21-530 Piszczac;757;350;350;12;338;46.24;3.43
87291;060111;Szkoła Podstawowa w Dobrynce|Dobrynka| 28 |21-530 Piszczac;537;193;193;13;180;35.94;6.74
87292;060111;Szkoła Podstawowa w Kościeniewiczach|Kościeniewicze| 10 |21-530 Piszczac;797;325;325;14;311;40.78;4.31
87293;060111;Budynek Starej Szkoły w Piszczacu (duża sala konferencyjna)|Piszczac|ul. Włodawska 4 |21-530 Piszczac;1749;843;843;28;815;48.20;3.32
87294;060111;Szkoła Podstawowa w Połoskach|Połoski| 45A |21-530 Piszczac;785;250;250;15;235;31.85;6.00
87295;060111;Budynek Starej Szkoły w Piszczacu (mała sala konferencyjna)|Piszczac|ul. Włodawska 4 |21-530 Piszczac;1284;401;401;15;386;31.23;3.74
87296;060112;Zespół Szkół w Rokitnie|Rokitno| 57A |21-504 Rokitno;1169;519;519;12;507;44.40;2.31
87297;060112;Świetlica w Cieleśnicy PGR|Cieleśnica PGR| 23 |21-504 Rokitno;383;161;161;8;153;42.04;4.97
87298;060112;Świetlica w Olszynie|Olszyn| 19 |21-504 Rokitno;335;139;139;5;134;41.49;3.60
87299;060112;Świetlica w Zaczopkach|Zaczopki| 35 |21-504 Rokitno;304;116;116;6;110;38.16;5.17
87300;060112;Świetlica w Klonownicy Dużej|Klonownica Duża| 53 |21-504 Rokitno;324;104;104;6;98;32.10;5.77
87301;060113;Hala Sportowa w Rossoszu|Rossosz|ul. Lubelska 37 |21-533 Rossosz;833;417;417;21;396;50.06;5.04
87302;060113;Gminny Ośrodek Kultury|Rossosz|Batalionów Chłopskich 53 |21-533 Rossosz;775;412;412;10;402;53.16;2.43
87303;060113;Publiczna Szkoła Podstawowa w Romaszkach|Romaszki| 25 |21-533 Rossosz;321;150;150;11;139;46.73;7.33
87304;060114;Gminny Ośrodek Kultury w Sławatyczach|Sławatycze|ul. Rynek 14 |21-515 Sławatycze;1283;609;609;29;580;47.47;4.76
87305;060114;Świetlica OSP w Jabłecznej|Jabłeczna| 53A |21-526 Jabłeczna;378;165;165;6;159;43.65;3.64
87306;060114;Świetlica wiejska w Krzywowólce|Krzywowólka| 8 |21-515 Sławatycze;355;131;131;1;130;36.90;0.76
87307;060115;Świetlica Wiejska w Motwicy|Motwica| 39 |21-518 Sosnówka;513;186;186;5;181;36.26;2.69
87308;060115;Gminny Ośrodek Kultury w Sosnówce|Sosnówka| 65 |21-518 Sosnówka;1025;366;366;16;350;35.71;4.37
87309;060115;Remizo-Świetlica w Przechodzie|Przechód| 11 |21-518 Sosnówka;629;277;277;7;270;44.04;2.53
87310;060116;Gminny Ośrodek Kultury w Koroszczynie|Koroszczyn|ul. Piłsudskiego 40 |21-550 Terespol;476;171;171;10;161;35.92;5.85
87311;060116;Zespół Szkół im. Orła Białego w Kobylanach|Kobylany|ul. Słoneczna 11 |21-540 Małaszewicze;770;368;368;11;357;47.79;2.99
87312;060116;Zespół Szkół im. Kornela Makuszyńskiego w Małaszewiczach|Małaszewicze|ul. Wiejska 7A |21-540 Małaszewicze;1434;678;678;24;654;47.28;3.54
87313;060116;Dom Strażaka w Neplach|Neple|ul. Terespolska 10 |21-550 Terespol;417;189;189;8;181;45.32;4.23
87314;060116;Świetlica Wiejska w Łobaczewie Dużym|Łobaczew Duży|ul. Spółdzielcza 1 |21-550 Terespol;739;381;381;14;367;51.56;3.67
87315;060116;Świetlica Wiejska w Lebiedziewie|Lebiedziew|ul. Kodeńska 113 |21-550 Terespol;675;231;231;8;223;34.22;3.46
87316;060116;Świetlica Wiejska w Bohukałach|Bohukały| 110 |21-550 Terespol;273;123;123;2;121;45.05;1.63
87317;060116;Świetlica Wiejska w Samowiczach|Samowicze| 67 |21-550 Terespol;215;105;105;3;102;48.84;2.86
87318;060116;Świetlica Wiejska w Małaszewiczach Dużych|Małaszewicze Duże|ul. Słoneczna 44 |21-540 Małaszewicze;387;180;180;6;174;46.51;3.33
87319;060117;Świetlica|Mazanówka| 51 |21-523 Tuczna;511;185;185;3;182;36.20;1.62
87320;060117;Urząd Gminy|Tuczna| 191A |21-523 Tuczna;1494;658;658;10;648;44.04;1.52
87321;060117;Środowiskowy Dom Samopomocy|Międzyleś| 29 |21-523 Tuczna;684;213;213;8;205;31.14;3.76
87322;060118;Szkoła Podstawowa w Dołholisce|Dołholiska| 1 |21-580 Wisznice;385;202;202;7;195;52.47;3.47
87323;060118;Szkoła Podstawowa w Horodyszczu|Horodyszcze|ul. Rynek 6 |21-580 Wisznice;639;265;265;8;257;41.47;3.02
87324;060118;Szkoła Podstawowa w Polubiczach|Polubicze Wiejskie Pierwsze| 100 |21-580 Wisznice;621;272;272;9;263;43.80;3.31
87325;060118;Szkoła Podstawowa w Wisznicach|Wisznice|ul. Warszawska 19 |21-580 Wisznice;1511;729;729;17;712;48.25;2.33
87326;060118;Liceum Ogólnokształcące w Wisznicach|Wisznice|ul. Warszawska 44 |21-580 Wisznice;1014;479;479;13;466;47.24;2.71
87327;060119;Szkoła Podstawowa w Berezówce|Berezówka| 26 |21-512 Zalesie;520;210;210;7;203;40.38;3.33
87328;060119;Szkoła Podstawowa w Dobryniu Dużym|Dobryń Duży| 66 |21-512 Zalesie;474;214;214;5;209;45.15;2.34
87329;060119;Szkoła Podstawowa w Kijowcu|Kijowiec| 34 |21-512 Zalesie;615;245;245;12;233;39.84;4.90
87330;060119;Zespół Szkół w Zalesiu|Zalesie|ul. Szkolna 10 |21-512 Zalesie;1514;633;633;20;613;41.81;3.16
87331;060119;Szkoła Podstawowa w Wólce Dobryńskiej|Wólka Dobryńska| 57 |21-512 Zalesie;442;196;196;5;191;44.34;2.55
87332;060201;Urząd Miasta|Biłgoraj|Plac Wolności 16 |23-400 Biłgoraj;1930;953;953;8;945;49.38;0.84
87333;060201;Zespół Szkół Zawodowych i Ogólnokształcących|Biłgoraj|ul. Przemysłowa 23 |23-400 Biłgoraj;1865;956;956;18;938;51.26;1.88
87334;060201;Nadleśnictwo Biłgoraj|Biłgoraj|ul. Zamojska 96 |23-400 Biłgoraj;804;381;381;7;374;47.39;1.84
87335;060201;Szkoła Podstawowa Nr 1|Biłgoraj|ul. 3 Maja 3 |23-400 Biłgoraj;1979;1057;1057;15;1042;53.41;1.42
87336;060201;Gimnazjum Nr 1|Biłgoraj|ul. Kościuszki 41 |23-400 Biłgoraj;1023;548;548;4;544;53.57;0.73
87337;060201;Szkoła Podstawowa Nr 5|Biłgoraj|ul. Nadstawna 62A |23-400 Biłgoraj;1953;968;968;15;953;49.56;1.55
87338;060201;Samorządowe Przedszkole Nr 2|Biłgoraj|Aleja 400-Lecia 54 |23-400 Biłgoraj;2231;1222;1222;13;1209;54.77;1.06
87339;060201;Zespół Szkół Budowlanych i Ogólnokształcących|Biłgoraj|ul. Cegielniana 24 |23-400 Biłgoraj;2028;1084;1084;17;1067;53.45;1.57
87340;060201;Dom Pomocy Społecznej dla Kombatantów|Biłgoraj|ul. Generała Komorowskiego 20 |23-400 Biłgoraj;1152;610;610;22;588;52.95;3.61
87341;060201;Szkoła Podstawowa Nr 4|Biłgoraj|ul. Polna 3 |23-400 Biłgoraj;2079;1108;1108;21;1087;53.29;1.90
87342;060201;Regionalne Centrum Edukacji Zawodowej|Biłgoraj|ul. Kościuszki 98 |23-400 Biłgoraj;1091;568;568;7;561;52.06;1.23
87343;060201;Miejski Zespół Szkół|Biłgoraj|ul. Sienkiewicza 6 |23-400 Biłgoraj;2132;1065;1065;16;1049;49.95;1.50
87344;060201;Medyczne Studium Zawodowe|Biłgoraj|ul. Kościuszki 127 |23-400 Biłgoraj;970;546;546;10;536;56.29;1.83
87345;060201;ARION Szpitale Sp. z o.o. Zespół Opieki Zdrowotnej w Biłgoraju|Biłgoraj|Dr. Stanisława Pojaska 5 |23-400 ;182;63;63;1;62;34.62;1.59
87346;060202;Szkoła Podstawowa im. Dzieci Zamojszczyzny|Aleksandrów Pierwszy| 104 |23-408 Aleksandrów;821;377;377;11;366;45.92;2.92
87347;060202;Remiza Ochotniczej Straży Pożarnej|Aleksandrów Drugi| 295 |23-408 Aleksandrów;623;301;301;2;299;48.31;0.66
87348;060202;Urząd Gminy Aleksandrów|Aleksandrów Drugi| 380 |23-408 Aleksandrów;561;256;256;8;248;45.63;3.12
87349;060202;Gimnazjum im. Kardynała Stefana Wyszyńskiego|Aleksandrów Trzeci| 554 |23-408 Aleksandrów;539;298;298;8;290;55.29;2.68
87350;060203;Szkoła Podstawowa w Bukowej|Bukowa| 98 |23-400 Biłgoraj;660;270;270;11;259;40.91;4.07
87351;060203;Szkoła Podstawowa w Korytkowie Dużym|Korytków Duży| 118 |23-400 Biłgoraj;716;370;370;3;367;51.68;0.81
87352;060203;Zespół Szkoły Podstawowej i Gimnazjum w Gromadzie|Gromada| 141 |23-400 Biłgoraj;1115;598;598;4;594;53.63;0.67
87353;060203;Zespół Szkoły Podstawowej i Gimnazjum w Dąbrowicy|Dąbrowica| 138a |23-400 Biłgoraj;996;431;431;4;427;43.27;0.93
87354;060203;Budynek szkoły w Ciosmach|Ciosmy| 77c |23-400 Biłgoraj;296;145;145;6;139;48.99;4.14
87355;060203;Szkoła Podstawowa w Smólsku Dużym|Smólsko Duże| 41 |23-400 Biłgoraj;648;357;357;10;347;55.09;2.80
87356;060203;Szkoła Podstawowa w Korczowie|Korczów| 1b |23-400 Biłgoraj;742;366;366;6;360;49.33;1.64
87357;060203;Zespół Szkoły Podstawowej i Gimnazjum w Dereźni|Dereźnia Solska| 1a |23-400 Biłgoraj;1226;635;635;12;623;51.79;1.89
87358;060203;Szkoła Podstawowa w Woli Dereźniańskiej|Wola Dereźniańska| 93 |23-400 Biłgoraj;619;274;274;8;266;44.26;2.92
87359;060203;Szkoła Podstawowa w Starym Bidaczowie|Stary Bidaczów| 42 |23-400 Biłgoraj;355;222;222;9;213;62.54;4.05
87360;060203;Remizo-świetlica OSP w Dylach|Dyle| 42 |23-400 Biłgoraj;418;161;161;6;155;38.52;3.73
87361;060203;Zespół Szkoły Podstawowej i Gimnazjum w Hedwiżynie|Hedwiżyn| 88b |23-400 Biłgoraj;825;379;379;12;367;45.94;3.17
87362;060203;Remizo-świetlica OSP w Soli|Sól| 87 |23-400 Biłgoraj;813;430;430;9;421;52.89;2.09
87363;060203;Zespół Szkół w Soli|Sól| 279 |23-400 Biłgoraj;861;455;455;9;446;52.85;1.98
87364;060203;Dom Pomocy Społecznej w Teodorówce|Teodorówka| 1 |23-400 Biłgoraj;125;56;56;6;50;44.80;10.71
87365;060204;Szkoła Podstawowa w Bukowinie|Bukowina| 60 |23-425 Biszcza;871;411;411;9;402;47.19;2.19
87366;060204;Gminny Ośrodek Kultury w Biszczy|Biszcza| 52 |23-425 Biszcza;896;432;432;8;424;48.21;1.85
87367;060204;Samorządowy Zespół Szkolny w Biszczy|Biszcza| 228 |23-425 Biszcza;815;342;342;14;328;41.96;4.09
87368;060204;Samorządowa Szkoła Podstawowa w Goździe Lipińskim|Gózd Lipiński| 81 |23-425 Biszcza;593;282;282;5;277;47.55;1.77
87369;060205;Hala Sportowa|Frampol|ul. Gorajska 16 |23-440 Frampol;1215;615;615;12;603;50.62;1.95
87370;060205;Remiza OSP|Komodzianka| 51b |23-440 Frampol;232;99;99;2;97;42.67;2.02
87371;060205;Szkoła Podstawowa|Korytków Mały| 49b |23-440 Frampol;633;284;284;7;277;44.87;2.46
87372;060205;Szkoła Podstawowa|Radzięcin| 82 |23-440 Frampol;576;249;249;6;243;43.23;2.41
87373;060205;Szkoła Podstawowa|Teodorówka| 64 |23-440 Frampol;809;330;330;6;324;40.79;1.82
87374;060205;Szkoła Podstawowa|Wola Radzięcka| 61 |23-440 Frampol;442;165;165;2;163;37.33;1.21
87375;060205;Remiza OSP|Kąty| 37 |23-440 Frampol;487;210;210;3;207;43.12;1.43
87376;060205;Remiza OSP|Chłopków| 63 |23-440 Frampol;272;138;138;1;137;50.74;0.72
87377;060205;Świetlica|Sokołówka| 54 |23-440 Frampol;498;185;185;3;182;37.15;1.62
87378;060206;Gminny Ośrodek Kultury|Goraj|ul. Frampolska 23 |23-450 Goraj;981;460;460;8;452;46.89;1.74
87379;060206;Urząd Gminy|Goraj|ul. Bednarska 1 |23-450 Goraj;961;507;507;15;492;52.76;2.96
87380;060206;Szkoła Podstawowa|Hosznia Ordynacka| 21 |23-450 Goraj;581;232;232;5;227;39.93;2.16
87381;060206;Remiza Ochotniczej Straży Pożarnej|Jędrzejówka| 60 |23-450 Goraj;542;190;190;10;180;35.06;5.26
87382;060206;Remiza Ochotniczej Straży Pożarnej|Wólka Abramowska| 80 |23-450 Goraj;419;181;181;8;173;43.20;4.42
87383;060207;Miejski Ośrodek Kultury w Józefowie|Józefów|ul. Krótka 9 |23-460 Józefów;1073;455;455;10;445;42.40;2.20
87384;060207;Środowiskowy Dom Samopomocy w Józefowie|Józefów|ul. Miszki Tatara 1 |23-460 Józefów;844;338;338;7;331;40.05;2.07
87385;060207;Szkoła Podstawowa w Józefowie|Józefów|ul. Górnicza 21 |23-460 Józefów;689;288;288;8;280;41.80;2.78
87386;060207;Szkoła Podstawowa w Majdanie Nepryskim|Majdan Nepryski| 18 |23-460 Józefów;845;341;342;11;330;40.36;3.23
87387;060207;Szkoła Podstawowa w Stanisławowie|Stanisławów| 64a |23-460 Józefów;505;178;178;14;164;35.25;7.87
87388;060207;Szkoła Podstawowa w Górecku Starym|Górecko Stare| 75 |23-460 Józefów;660;287;287;18;269;43.48;6.27
87389;060207;Remiza Ochotniczej Straży Pożarnej w Górnikach|Górniki| 85 |23-460 Józefów;347;124;125;6;118;35.73;4.84
87390;060207;Świetlica w Długim Kącie-Osada|Długi Kąt - Osada| 6 |23-460 Józefów;855;336;336;12;324;39.30;3.57
87391;060208;Szkoła Podstawowa|Korchów Pierwszy| 86b |23-415 Księżpol;1128;478;478;9;469;42.38;1.88
87392;060208;Szkoła Podstawowa|Księżpol|ul. Biłgorajska 11 |23-415 Księżpol;1808;822;822;25;797;45.46;3.04
87393;060208;Szkoła Podstawowa|Majdan Stary| 21 |23-414 Majdan Stary;1451;736;736;32;704;50.72;4.35
87394;060208;Szkoła Podstawowa|Rakówka| 12 |23-415 Księżpol;876;349;349;8;341;39.84;2.29
87395;060208;Szkoła Podstawowa|Stary Lipowiec| 47a |23-414 Majdan Stary;302;127;127;3;124;42.05;2.36
87396;060209;Szkoła Podstawowa w Chmielku|Chmielek| 81 |23-412 Łukowa;1209;527;527;18;509;43.59;3.42
87397;060209;Gimnazjum w Łukowej|Łukowa| 341 |23-412 Łukowa;1416;761;761;17;744;53.74;2.23
87398;060209;Gminny Ośrodek Kultury w Łukowej|Łukowa| 569A |23-412 Łukowa;891;421;421;9;412;47.25;2.14
87399;060210;Szkoła Podstawowa w Obszy|Obsza| 70A |23-413 Obsza;1144;464;464;17;447;40.56;3.66
87400;060210;Szkoła Podstawowa w Babicach|Babice| 108A |23-413 Obsza;745;361;361;15;346;48.46;4.16
87401;060210;Szkoła Podstawowa w Olchowcu|Olchowiec| 31 |23-413 Obsza;481;198;198;3;195;41.16;1.52
87402;060210;Szkoła Podstawowa w Zamchu|Zamch| 117 |23-413 Obsza;1098;539;539;19;520;49.09;3.53
87403;060211;Szkoła Podstawowa w Lipinach Dolnych|Lipiny Dolne| 152 |23-423 Potok Górny;1219;561;561;12;549;46.02;2.14
87404;060211;Szkoła Podstawowa w Lipinach Górnych-Borowina|Lipiny Górne| 1a |23-423 Potok Górny;694;320;320;9;311;46.11;2.81
87405;060211;Urząd Gminy w Potoku Górnym|Potok Górny| 116 |23-423 Potok Górny;1209;576;576;25;551;47.64;4.34
87406;060211;Szkoła Podstawowa w Szyszkowie|Szyszków| 27 |23-423 Potok Górny;1448;797;797;19;778;55.04;2.38
87407;060212;Świetlica Środowiskowa|Luchów Dolny| 28 |23-420 Tarnogród;474;223;223;13;210;47.05;5.83
87408;060212;Szkoła Podstawowa|Luchów Górny| 89A |23-420 Tarnogród;474;216;216;6;210;45.57;2.78
87409;060212;Szkoła Podstawowa|Różaniec, Różaniec Pierwszy| 44 |23-420 Tarnogród;633;288;288;8;280;45.50;2.78
87410;060212;Szkoła Podstawowa|Różaniec, Różaniec Drugi| 171 |23-420 Tarnogród;538;280;280;5;275;52.04;1.79
87411;060212;Przedszkole Miejskie|Tarnogród|ul. 1 Maja 7 |23-420 Tarnogród;827;441;441;11;430;53.33;2.49
87412;060212;Gimnazjum Publiczne|Tarnogród|ul. Kościelna 12 |23-420 Tarnogród;1051;500;500;7;493;47.57;1.40
87413;060212;Tarnogrodzki Ośrodek Kultury|Tarnogród|ul. Rynek 18 |23-420 Tarnogród;872;434;434;13;421;49.77;3.00
87414;060212;Szkoła Podstawowa|Wola Różaniecka| 158 |23-420 Tarnogród;591;318;318;13;305;53.81;4.09
87415;060212;Szpital w Tarnogrodzie|Tarnogród|Rynek 85 |23-420 Tarnogród;60;10;10;2;8;16.67;20.00
87416;060213;Szkoła Podstawowa w Lipowcu|Lipowiec| 100 |23-407 Tereszpol-Zaorenda;442;178;178;5;173;40.27;2.81
87417;060213;Zespół Szkół Samorządowych im. Jana Pawła II w Tereszpolu-Zaorendzie|Tereszpol-Zaorenda|ul. Szkolna 16 |23-407 Tereszpol-Zaorenda;1233;552;552;20;532;44.77;3.62
87418;060213;Świetlica wiejska w Tereszpolu-Zygmuntach|Tereszpol-Zygmunty| 96 |23-407 Tereszpol-Zaorenda;608;248;248;10;238;40.79;4.03
87419;060213;Zespół Szkół Samorządowych w Tereszpolu-Kukiełkach|Tereszpol-Kukiełki| 31 |23-407 Tereszpol-Zaorenda;913;379;379;22;357;41.51;5.80
87420;060214;Zespół Szkolno - Przedszkolny w Turobinie|Turobin|ul. Piłsudskiego 34 |23-465 Turobin;1098;609;609;9;600;55.46;1.48
87421;060214;Urząd Gminy|Turobin|ul. Rynek 4 |23-465 Turobin;811;401;401;9;392;49.45;2.24
87422;060214;Remiza OSP|Tarnawa Duża| 62A |23-465 Turobin;308;129;129;2;127;41.88;1.55
87423;060214;Remiza OSP|Guzówka-Kolonia| 81 |23-465 Turobin;385;195;195;10;185;50.65;5.13
87424;060214;Remiza OSP|Żabno| 44B |23-465 Turobin;497;218;218;8;210;43.86;3.67
87425;060214;Szkoła Podstawowa w Gródkach|Gródki Drugie| 100 |23-465 Turobin;441;227;227;9;218;51.47;3.96
87426;060214;Remiza OSP|Huta Turobińska| 35 |23-465 Turobin;494;228;228;5;223;46.15;2.19
87427;060214;Szkoła Podstawowa w Czernięcinie Głownym|Czernięcin Główny| 159 |23-465 Turobin;504;275;276;3;272;54.56;1.09
87428;060214;Remiza OSP|Gaj Czernięciński| 13 |23-465 Turobin;689;332;332;6;326;48.19;1.81
87429;060214;Remiza OSP|Nowa Wieś| 5 |23-465 Turobin;229;96;96;2;94;41.92;2.08
87430;060301;Budynek PKP|Rejowiec Fabryczny,|ul. Kolejowa 12 |22-170 Rejowiec Fabryczny;997;366;366;13;353;36.71;3.55
87431;060301;Zespół Szkół Samorządowych|Rejowiec Fabryczny|ul. Lubelska 18 |22-170 Rejowiec Fabryczny;1225;433;433;10;423;35.35;2.31
87432;060301;Centrum Aktywności Społeczno-Gospodarczej "Stara Kotłownia"|Rejowiec Fabryczny,|ul. Wschodnia 32 |22-170 Rejowiec Fabryczny;1486;655;655;17;638;44.08;2.60
87433;060302;Urząd Gminy|Białopole|ul. Chełmska 1 |22-135 Białopole;1381;499;499;24;475;36.13;4.81
87434;060302;Świetlica wiejska|Raciborowice| 31 |22-135 Białopole;534;186;186;7;179;34.83;3.76
87435;060302;Świetlica wiejska|Strzelce| 23B |22-135 Białopole;656;239;239;11;228;36.43;4.60
87436;060303;Świetlica w Srebrzyszczu|Srebrzyszcze|Sportowa 18 |22-100 Chełm;855;316;316;12;304;36.96;3.80
87437;060303;Zespół Szkół w Okszowie|Okszów|Chełmska 14 |22-105 Chełm;1383;656;656;16;640;47.43;2.44
87438;060303;Dom Pomocy Społecznej w Nowinach|Nowiny| 101 |22-105 Chełm;250;95;95;9;86;38.00;9.47
87439;060303;Świetlica w Wólce Czułczyckiej|Wólka Czułczycka| 46 |22-106 Chełm;216;71;71;0;71;32.87;0.00
87440;060303;Świetlica w Horodyszczu|Horodyszcze| 43b |22-151 Chełm;785;325;325;9;316;41.40;2.77
87441;060303;Zespół Szkół w Stawie|Staw| 72 |22-151 Chełm;844;292;292;8;284;34.60;2.74
87442;060303;Zespół Szkół w Stołpiu|Nowosiółki-Kolonia| 54 |22-151 Chełm;737;266;266;4;262;36.09;1.50
87443;060303;Multimedialne Centrum Informacyjno-Dydaktyczne Gminy Chełm w Janowie|Janów|Balladyny 5 |22-151 Chełm;442;231;231;1;230;52.26;0.43
87444;060303;Urząd Gminy Chełm|Pokrówka|Gminna 18 |22-100 Chełm;929;468;468;7;461;50.38;1.50
87445;060303;Świetlica Gospodarstwa Gruntów Marginalnych i Mieszkaniowych Zasobu Własności Rolnej Skarbu Państwa w Pokrówce|Pokrówka|Wiosenna 4 |22-100 Chełm;560;259;259;9;250;46.25;3.47
87446;060303;Ośrodek Kultury Gminy Chełm w Żółtańcach|Żółtańce| 44b |22-100 Chełm;230;107;107;4;103;46.52;3.74
87447;060303;Zespół Szkół w Żółtańcach|Żółtańce-Kolonia|Metalowa 89 |22-100 Chełm;474;266;266;5;261;56.12;1.88
87448;060303;Zespół Szkół w Strupinie Dużym|Strupin Duży| 122 |22-100 Chełm;844;367;367;10;357;43.48;2.72
87449;060303;Centrum Kulturalno-Sportowe Gminy Chełm w Rożdżałowie|Rożdżałów| 118a |22-100 Chełm;494;194;194;5;189;39.27;2.58
87450;060303;Świetlica w Depułtyczach Królewskich-Kolonii|Depułtycze Królewskie-Kolonia| 18 |22-100 Chełm;413;195;195;10;185;47.22;5.13
87451;060303;Remiza Ochotniczej Straży Pożarnej w Starych Depułtyczach|Stare Depułtycze| 10b |22-100 Chełm;359;141;141;1;140;39.28;0.71
87452;060303;Zespół Szkół w Uhrze|Uher| 32 |22-100 Chełm;704;312;312;13;299;44.32;4.17
87453;060303;Świetlica w Zawadówce|Zawadówka| 25c |22-100 Chełm;681;308;308;5;303;45.23;1.62
87454;060304;Wiejski Ośrodek Kultury w Brzeźnie|Brzeźno| 3 |22-174 Brzeźno;911;343;343;9;334;37.65;2.62
87455;060304;Wiejski Ośrodek Kultury w Wólce Okopskiej|Wólka Okopska| 67 |22-174 Brzeźno;639;289;289;15;274;45.23;5.19
87456;060304;Szkoła Podstawowa w Świerżach|Świerże|ul.Jana Pawła II 59 |22-175 Dorohusk;622;250;250;12;238;40.19;4.80
87457;060304;Środowiskowy Dom Samopomocy "Cytrynka" w Dorohusku|Dorohusk-Osada|ul.I Armii Wojska Polskiego 25 |22-175 Dorohusk;763;275;275;14;261;36.04;5.09
87458;060304;Zespół Szkół Ogólnokształcących w Dorohusku|Dorohusk-Osada|I Armii Wojska Polskiego 49 |22-175 Dorohusk;1182;557;557;16;541;47.12;2.87
87459;060304;Świetlica KGW w Turce|Turka| 2 |22-175 Dorohusk;636;228;228;12;216;35.85;5.26
87460;060304;Świetlica Wiejska w Michałówce|Michałówka| 78 |22-175 Dorohusk;649;241;241;17;224;37.13;7.05
87461;060305;Swietlica Wiejska Siedliszcze|Siedliszcze| 61 |22-145 Dubienka;526;171;171;8;163;32.51;4.68
87462;060305;Gminny Zespół Szkół|Dubienka|ul. 3 Maja 4 |22-145 Dubienka;1198;442;442;18;424;36.89;4.07
87463;060305;Remiza OSP|Skryhiczyn| 78 |22-145 Dubienka;373;132;132;7;125;35.39;5.30
87464;060306;Szkoła Podstawowa|Czerniejów| 8 |22-113 Kamień;371;115;115;5;110;31.00;4.35
87465;060306;Szkoła Podstawowa|Kamień - Kolonia| 55 |22-113 Kamień;1540;622;622;15;607;40.39;2.41
87466;060306;Świetlica Wiejska|Pławanice| 33C |22-113 Kamień;292;127;127;7;120;43.49;5.51
87467;060306;Świetlica Wiejska|Strachosław| 77A |22-113 Kamień;592;258;258;6;252;43.58;2.33
87468;060306;Świetlica Wiejska|Wolawce| 41 |22-113 Kamień;526;205;205;5;200;38.97;2.44
87469;060307;Świetlica Wiejska w Poniatówce|Wygnańce| 32 |22-122 Leśniowice;377;134;134;6;128;35.54;4.48
87470;060307;Szkoła Podstawowa w Leśniowicach|Leśniowice| 24B |22-122 Leśniowice;1036;315;315;7;308;30.41;2.22
87471;060307;Szkoła Podstawowa w Rakołupach|Rakołupy Duże| 5A |22-122 Leśniowice;656;250;250;9;241;38.11;3.60
87472;060307;Publiczne Gimnazjum w Sielcu|Sielec| 67A |22-122 Leśniowice;649;230;230;5;225;35.44;2.17
87473;060307;Budynek po byłej szkole w Kumowie Plebańskim|Kumów Plebański| 1 |22-122 Leśniowice;404;162;162;9;153;40.10;5.56
87474;060308;Świetlica Wiejska|Kanie| 119f |22-170 Rejowiec Fabryczny;968;363;363;11;352;37.50;3.03
87475;060308;Szkoła Podstawowa|Krasne| 31 |22-170 Rejowiec Fabryczny;557;161;161;8;153;28.90;4.97
87476;060308;Gminny Ośrodek Kultury|Pawłów|ul. Lubelska 23a |22-170 Rejowiec Fabryczny;810;257;257;4;253;31.73;1.56
87477;060308;Zespół Szkół w Lisznie|Liszno| 52 |22-170 Rejowiec Fabryczny;1239;517;517;23;494;41.73;4.45
87478;060309;Gminny Ośrodek Kultury|Ruda-Kolonia| 28a |22-110 Ruda-Huta;611;202;202;14;188;33.06;6.93
87479;060309;Zespół Szkół w Rudzie - Hucie|Ruda-Huta|ul. Stanisława Wójtowicza 9 |22-110 Ruda-Huta;1750;685;685;25;660;39.14;3.65
87480;060309;Świetlica|Leśniczówka| 20B |22-110 Ruda-Huta;609;224;224;11;213;36.78;4.91
87481;060309;Świetlica Wiejska|Żalin| 76A |22-110 Ruda-Huta;479;149;149;13;136;31.11;8.72
87482;060309;Centrum Kultury|Rudka| 58 |22-110 Ruda-Huta;267;67;67;2;65;25.09;2.99
87483;060310;Chutcze - świetlica|Chutcze| 36 |22-107 Sawin;277;107;107;3;104;38.63;2.80
87484;060310;Łowcza-Kolonia - świetlica|Łowcza-Kolonia| 39 |22-107 Sawin;701;252;252;6;246;35.95;2.38
87485;060310;Bukowa Wielka - Szkoła Podstawowa|Bukowa Wielka| 34 |22-107 Sawin;617;209;209;6;203;33.87;2.87
87486;060310;Łukowek - świetlica|Łukówek| 50 |22-107 Sawin;268;101;101;3;98;37.69;2.97
87487;060310;Czułczyce - Szkoła Podstawowa|Czułczyce| 71 |22-107 Sawin;1038;377;377;18;359;36.32;4.77
87488;060310;Sawin - lokal Urzędu Gminy Sawin|Sawin|Chutecka 12 |22-107 Sawin;1771;731;731;31;700;41.28;4.24
87489;060311;Szkoła Podstawowa|Chojno Nowe Pierwsze| 23 |22-130 Siedliszcze;862;185;185;12;173;21.46;6.49
87490;060311;Świetlica|Chojeniec| 26 |22-130 Siedliszcze;328;94;94;10;84;28.66;10.64
87491;060311;Świetlica|Anusin| 24 |22-130 Siedliszcze;466;158;158;11;147;33.91;6.96
87492;060311;Szkoła Podstawowa|Wola Korybutowa-Kolonia| 27A |22-130 Siedliszcze;393;153;153;8;145;38.93;5.23
87493;060311;Warsztat Terapii Zajęciowej|Majdan Zahorodyński| 1 1|22-130 Siedliszcze;438;134;134;8;126;30.59;5.97
87494;060311;Świetlica|Kulik| 66 |22-130 Siedliszcze;394;116;116;4;112;29.44;3.45
87495;060311;Świetlica|Mogilnica| 49 4|22-130 Siedliszcze;453;104;104;6;98;22.96;5.77
87496;060311;Szkoła Podstawowa|Bezek| 59 |22-130 Siedliszcze;541;173;173;4;169;31.98;2.31
87497;060311;Świetlica|Adolfin| 15 |22-130 Siedliszcze;259;86;86;1;85;33.20;1.16
87498;060311;Sala posiedzeń w Urzędzie Gminy|Siedliszcze|Szpitalna 15A |22-130 Siedliszcze;1433;569;569;13;556;39.71;2.28
87499;060312;Gminna Biblioteka Publiczna w Wierzbicy Filia w Ochoży|Ochoża| 50 |22-150 Wierzbica;235;83;83;2;81;35.32;2.41
87500;060312;Wiejskie Centrum Kulturalno-Rekreacyjne w Olchowcu|Olchowiec| 39a |22-150 Wierzbica;350;122;122;5;117;34.86;4.10
87501;060312;Świetlica Wiejska w Syczynie|Syczyn| 62 |22-150 Wierzbica;384;144;144;15;129;37.50;10.42
87502;060312;Urząd Gminy Wierzbica|Wierzbica-Osiedle|ul.Włodawska 1 |22-150 Wierzbica;2145;897;897;44;853;41.82;4.91
87503;060312;Wiejski Dom Kultury w Chylinie|Chylin| 31a |22-150 Wierzbica;287;120;120;4;116;41.81;3.33
87504;060312;Szkoła Filialna w Wólce Tarnowskiej|Wólka Tarnowska| 53b |22-150 Wierzbica;603;226;226;20;206;37.48;8.85
87505;060312;Szkoła Podstawowa w Święcicy|Święcica| 58 |22-150 Wierzbica;264;106;106;2;104;40.15;1.89
87506;060313;Turowiec 35 Remiza OSP|Turowiec| 35 |22-120 Wojsławice;652;223;223;12;211;34.20;5.38
87507;060313;Rozięcin 41 Remiza OSP|Rozięcin| 41 |22-120 Wojsławice;419;172;172;7;165;41.05;4.07
87508;060313;Wojsławice ul. Uchańska 9 Dom Kultury|Wojsławice|Uchańska 9 |22-120 Wojsławice;1386;599;599;19;580;43.22;3.17
87509;060313;Stary Majdan 40 Remiza OSP|Stary Majdan| 40 |22-120 Wojsławice;464;116;116;2;114;25.00;1.72
87510;060313;Majdan Ostrowski 100 Budynek komunalny|Majdan Ostrowski| 100 |22-120 Wojsławice;386;113;113;6;107;29.27;5.31
87511;060314;Świetlica wiejska|Roztoka| 14 |22-114 Żmudź;539;210;210;5;205;38.96;2.38
87512;060314;Szkoła Podstawowa|Żmudź-Kolonia| 10 |22-114 Żmudź;1313;480;480;16;464;36.56;3.33
87513;060314;Budynek po Szkole Podstawowej|Leszczany| 21 |22-114 Żmudź;827;256;256;5;251;30.96;1.95
87514;060315;Lokal po byłej Szkole Podstawowej|Niedziałowice Pierwsze| 29 8|22-360 Rejowiec;471;160;160;8;152;33.97;5.00
87515;060315;Budynek Gminnej Biblioteki Publicznej|Rejowiec|ul. Zwierzyńskiego 8C |22-360 Rejowiec;1516;636;636;19;617;41.95;2.99
87516;060315;Lokal po byłej Szkole Podstawowej|Marynin| 1 |22-360 Rejowiec;905;299;299;8;291;33.04;2.68
87517;060315;Świetlica wiejska|Leonów| 56 |22-360 Rejowiec;831;227;227;16;211;27.32;7.05
87518;060315;Szkoła Podstawowa|Zawadówka| 45 |22-360 Rejowiec;355;109;109;14;95;30.70;12.84
87519;060315;Dom przyjęć|Marysin| 3 |22-360 Rejowiec;450;129;129;2;127;28.67;1.55
87520;060315;Gminny Ośrodek Kultury|Rejowiec|ul. Fabryczna 13 |22-360 Rejowiec;810;276;276;10;266;34.07;3.62
87521;060401;Przedszkole nr 3|Hrubieszów|ul. Konopnickiej 4 |22-500 Hrubieszów;1051;505;505;10;495;48.05;1.98
87522;060401;Zespół Szkół Miejskich nr 2|Hrubieszów|ul. Żeromskiego 29 |22-500 Hrubieszów;2078;1029;1029;22;1007;49.52;2.14
87523;060401;Świetlica Osiedlowa Osiedla „Jagiellońskie”|Hrubieszów|ul. Unii Horodelskiej 19 |22-500 Hrubieszów;1036;474;474;12;462;45.75;2.53
87524;060401;Zespół Szkół Miejskich nr 3|Hrubieszów|ul. Zamojska 16 |22-500 Hrubieszów;1030;491;491;12;479;47.67;2.44
87525;060401;Powiatowy Zespół Placówek Szkolno - Wychowawczych|Hrubieszów|ul. Zamojska 16 A |22-500 Hrubieszów;998;453;453;9;444;45.39;1.99
87526;060401;Agencja Restrukturyzacji i Modernizacji Rolnictwa Biuro Powiatowe w Hrubieszowie|Hrubieszów|ul. Nowa 14 |22-500 Hrubieszów;1902;746;746;21;725;39.22;2.82
87527;060401;Dom Nauczyciela|Hrubieszów|ul. 3-go Maja. 37 |22-500 Hrubieszów;1019;419;419;7;412;41.12;1.67
87528;060401;Hrubieszowski Dom Kultury|Hrubieszów|ul. 3-go Maja 7 |22-500 Hrubieszów;1020;467;467;9;458;45.78;1.93
87529;060401;PGKiM Spółka z o.o.|Hrubieszów|ul. Krucza 20 |22-500 Hrubieszów;935;405;405;8;397;43.32;1.98
87530;060401;Hrubieszowska Spółdzielnia Mieszkaniowa|Hrubieszów|ul. Polna 19 |22-500 Hrubieszów;965;420;420;15;405;43.52;3.57
87531;060401;Przedszkole nr 5|Hrubieszów|ul. Listopadowa 6 |22-500 Hrubieszów;927;436;436;9;427;47.03;2.06
87532;060401;Przedszkole nr 1|Hrubieszów|ul. Listopadowa 13 |22-500 Hrubieszów;914;437;437;3;434;47.81;0.69
87533;060401;Zespół Szkół Miejskich nr 1|Hrubieszów|ul. Listopadowa 12 |22-500 Hrubieszów;1000;485;485;13;472;48.50;2.68
87534;060401;Samodzielny Publiczny Zespół Opieki Zdrowotnej|Hrubieszów|Józefa Piłsudskiego 11 |22-500 Hrubieszów;335;82;82;6;76;24.48;7.32
87535;060401;Zakład Karny|Hrubieszów|ul. Nowa 64 |22-500 Hrubieszów;371;165;165;33;132;44.47;20.00
87536;060402;Sala Konferencyjna Urzędu Gminy|Dołhobyczów|ul. Spółdzielcza 2a |22-540 Dołhobyczów;1272;542;542;21;521;42.61;3.87
87537;060402;Remiza Strażacka|Witków| 119 |22-540 Dołhobyczów;396;123;123;7;116;31.06;5.69
87538;060402;Świetlica wiejska|Gołębie| 38 /3|22-540 Dołhobyczów;292;104;104;5;99;35.62;4.81
87539;060402;Warsztaty Terapii Zajęciowej|Oszczów-Kolonia| 30 |22-540 Dołhobyczów;611;217;217;6;211;35.52;2.76
87540;060402;Zespół Szkół|Hulcze| 37 |22-540 Dołhobyczów;769;243;243;6;237;31.60;2.47
87541;060402;Remiza Strażacka|Chłopiatyn| 8 |22-540 Dolhobyczów;423;136;136;7;129;32.15;5.15
87542;060402;Dom Kultury|Przewodów| 24 |22-540 Dołhobyczów;815;191;191;10;181;23.44;5.24
87543;060402;Świetlica Wiejska|Horoszczyce| 117 |22-540 Dołhobyczów;239;78;78;6;72;32.64;7.69
87544;060403;Gminny Ośrodek Kultury w Horodle|Horodło|ul. Hrubieszowska 1 |22-523 Horodło;1415;480;480;19;461;33.92;3.96
87545;060403;Budynek Szkoły Podstawowej w Kopyłowie|Kopyłów| 14 |22-523 Horodło;350;86;86;6;80;24.57;6.98
87546;060403;Świetlica Wiejska w Bereżnicy|Bereżnica| 65 |22-523 Horodło;669;173;173;7;166;25.86;4.05
87547;060403;Świetlica Wiejska w Łuszkowie|Łuszków| 28 |22-523 Horodło;568;197;199;8;189;34.68;4.06
87548;060403;Świetlica Wiejska w Strzyżowie|Strzyżów|ul. Herbowa 13 |22-525 Strzyżów;1439;545;545;18;527;37.87;3.30
87549;060404;Świetlica|Czerniczyn| 125 |22-500 Hrubieszów;1173;447;447;11;436;38.11;2.46
87550;060404;Szkoła Podstawowa|Ślipcze| 55 |22-500 Hrubieszów;505;166;166;6;160;32.87;3.61
87551;060404;Szkoła Podstawowa|Kosmów| 72 |22-500 Hrubieszów;598;194;194;12;182;32.44;6.19
87552;060404;Szkoła Podstawowa|Mieniany| 50 |22-500 Hrubieszów;415;128;128;8;120;30.84;6.25
87553;060404;Gminne Gimnazjum|Kozodawy| 83 |22-500 Hrubieszów;504;190;190;2;188;37.70;1.05
87554;060404;Urząd Gminy Hrubieszów|Hrubieszów|ul. B.Prusa 8 |22-500 Hrubieszów;762;277;277;5;272;36.35;1.81
87555;060404;Szkoła Podstawowa|Husynne| 118 |22-500 Hrubieszów;663;240;240;10;230;36.20;4.17
87556;060404;Szkoła Podstawowa|Dziekanów| 55 |22-500 Hrubieszów;624;232;232;8;224;37.18;3.45
87557;060404;Szkoła Podstawowa|Szpikołosy| 34 |22-500 Hrubieszów;981;397;397;13;384;40.47;3.27
87558;060404;Świetlica|Moniatycze| 81 |22-500 Hrubieszów;1251;527;527;21;506;42.13;3.98
87559;060404;Szkoła Podstawowa|Stefankowice| 26 |22-500 Hrubieszów;623;212;212;6;206;34.03;2.83
87560;060404;Świetlica|Ubrodowice| 46 |22-500 Hrubieszów;332;138;138;9;129;41.57;6.52
87561;060405;Samorządowy Zespół Szkół w Mirczu|Mircze|ul. Kryłowska 27 |22-530 Mircze;1232;479;479;12;467;38.88;2.51
87562;060405;Świetlica Wiejska w Smoligowie|Smoligów| 75 |22-530 Mircze;372;134;134;2;132;36.02;1.49
87563;060405;Środowiskowy Dom Samopomocy w Modryniu|Modryń| 65 |22-530 Mircze;854;311;311;32;279;36.42;10.29
87564;060405;Szkoła Podstawowa w Szychowicach|Szychowice|ul. Parkowa 39 |22-530 Mircze;430;143;143;9;134;33.26;6.29
87565;060405;Budynek byłej Szkoły Podstawowej w Małkowie|Małków| 39 |22-530 Mircze;400;138;138;7;131;34.50;5.07
87566;060405;Zespół Szkół w Kryłowie|Kryłów|ul. Hrubieszowska 4 |22-530 Mircze;825;366;366;5;361;44.36;1.37
87567;060405;Szkoła Podstawowa w Wiszniowie|Wiszniów| 61 |22-530 Mircze;441;142;142;9;133;32.20;6.34
87568;060405;Świetlica Wiejska w Starej Wsi|Stara Wieś| 97 |22-530 Mircze;520;179;182;5;174;34.42;2.79
87569;060405;Świetlica Wiejska w Mołożowie|Mołożów| 77a |22-530 Mircze;508;175;175;8;167;34.45;4.57
87570;060405;Gminny Ośrodek Kultury w Mirczu|Mircze|Kryłowska 18 |22-530 Mircze;638;226;226;8;218;35.42;3.54
87571;060405;Niepubliczny Zakład Opiekuńczo-Leczniczy "Droga Życia" w Smoligowie|Smoligów| 71 |22-530 Mircze;208;34;34;1;33;16.35;2.94
87572;060406;Gminny Ośrodek Kultury w Trzeszczanach|Trzeszczany Pierwsze| 194 |22-554 Trzeszczany;1199;483;483;14;469;40.28;2.90
87573;060406;Szkoła Podstawowa w Mołodiatyczach|Mołodiatycze| 86 |22-554 Trzeszczany;669;239;239;5;234;35.72;2.09
87574;060406;Szkoła Podstawowa w Nieledwi|Nieledew| 32 |22-554 Trzeszczany;1739;699;699;29;670;40.20;4.15
87575;060407;Gminny Ośrodek Kultury w Uchaniach|Uchanie|ul. Partyzantów 1 |22-510 Uchanie;990;417;417;13;404;42.12;3.12
87576;060407;Świetlica w Rozkoszówce|Rozkoszówka| 48 |22-510 Uchanie;597;210;210;19;191;35.18;9.05
87577;060407;Gimnazjum w Jarosławcu|Jarosławiec| 113 |22-510 Uchanie;457;154;154;1;153;33.70;0.65
87578;060407;Świetlica w Drohiczanach|Drohiczany| 45A |22-510 Uchanie;913;331;331;6;325;36.25;1.81
87579;060407;Szkoła Podstawowa w Teratynie|Teratyn| 127 |22-510 Uchanie;1053;441;441;22;419;41.88;4.99
87580;060408;Gminny Ośrodek Kultury|Werbkowice|ul. Piłsudskiego Józefa 2 |22-550 Werbkowice;1252;545;545;27;518;43.53;4.95
87581;060408;Zespół Szkół|Werbkowice|ul. Jana Pawła II 17 |22-550 Werbkowice;1190;595;595;16;579;50.00;2.69
87582;060408;Szkoła Podstawowa|Podhorce| 110 |22-550 Werbkowice;600;244;244;14;230;40.67;5.74
87583;060408;Szkoła Podstawowa|Gozdów| 141 |22-550 Werbkowice;875;364;364;8;356;41.60;2.20
87584;060408;Szkoła Podstawowa|Hostynne-Kolonia| 30 |22-550 Werbkowice;967;386;386;22;364;39.92;5.70
87585;060408;Szkoła Podstawowa|Malice| 37 |22-550 Werbkowice;587;217;217;10;207;36.97;4.61
87586;060408;Szkoła Podstawowa|Terebiń| 75 |22-550 Werbkowice;872;309;309;4;305;35.44;1.29
87587;060408;Szkoła Podstawowa|Honiatycze| 104 |22-550 Werbkowice;472;166;166;10;156;35.17;6.02
87588;060408;Wiejski Dom Kultury|Turkowice| 78 |22-546 Turkowice;595;200;200;8;192;33.61;4.00
87589;060408;Zespół Szkół|Sahryń| 62 |22-546 Turkowice;602;184;184;8;176;30.56;4.35
87590;060501;Publiczna Szkoła Podstawowa w Aleksandrówce|Aleksandrówka| 28 |23-320 Batorz;418;294;294;4;290;70.33;1.36
87591;060501;Zespół Szkół w Batorzu|Batorz Pierwszy| 80 |23-320 Batorz;1039;566;566;5;561;54.48;0.88
87592;060501;Zespół Szkół w Błażku|Błażek| 196 |23-320 Batorz;770;380;380;7;373;49.35;1.84
87593;060501;Remiza Ochotniczej Straży Pożarnej w Stawcach|Stawce| 61 |23-320 Batorz;511;217;217;10;207;42.47;4.61
87594;060502;Publiczna Szkoła Podstawowa w Chrzanowie|Chrzanów Pierwszy| 81 |23-305 Chrzanów;749;475;475;2;473;63.42;0.42
87595;060502;Urząd Gminy Chrzanów (sala narad)|Chrzanów Trzeci| 112 |23-305 Chrzanów;570;360;360;12;348;63.16;3.33
87596;060502;Publiczna Szkoła Podstawowa w Ładzie|Łada| 118 |23-305 Chrzanów;690;366;366;6;360;53.04;1.64
87597;060502;Publiczna Szkoła Podstawowa w Otroczu|Otrocz| 32 |23-305 Chrzanów;451;255;255;7;248;56.54;2.75
87598;060503;Zespół Szkół w Dzwoli|Dzwola| 121B |23-304 Dzwola;1123;613;613;16;597;54.59;2.61
87599;060503;Zespół Szkół w Krzemieniu|Krzemień Pierwszy| 192 |23-304 Dzwola;1463;710;710;17;693;48.53;2.39
87600;060503;Publiczna Szkoła Podstawowa w Branwi|Branew Szlachecka| 19 |23-304 Dzwola;673;389;389;6;383;57.80;1.54
87601;060503;Zespół Szkół w Kocudzy|Kocudza Pierwsza| 29 |23-304 Dzwola;1633;869;869;13;856;53.21;1.50
87602;060503;Remiza OSP w Zdzisławicach|Zdzisławice| 51 |23-304 Dzwola;421;215;215;5;210;51.07;2.33
87603;060504;Gminne Centrum Kultury i Promocji w Godziszowie|Godziszów, Godziszów Trzeci| 124a |23-302 Godziszów;1670;1039;1039;21;1018;62.22;2.02
87604;060504;Publiczna Szkoła Podstawowa w Andrzejowie|Andrzejów| 163 |23-302 Godziszów;525;325;325;5;320;61.90;1.54
87605;060504;Publiczna Szkoła Podstawowa w Piłatce|Piłatka| 84 |23-302 Godziszów;260;177;177;3;174;68.08;1.69
87606;060504;Gminne Centrum Kultury i Promocji w Godziszowie oddział w Zdziłowicach|Zdziłowice, Zdziłowice Drugie| 109 |23-306 Zdziłowice;1215;824;824;15;809;67.82;1.82
87607;060504;Zespół Szkół w Wólce Ratajskiej|Wólka Ratajska| 146 |23-302 Godziszów;1164;804;804;8;796;69.07;1.00
87608;060505;Komenda Powiatowa Państwowej Straży Pożarnej|Janów Lubelski|ul. Piłsudskiego 56 |23-300 Janów Lubelski;1947;1063;1063;16;1047;54.60;1.51
87609;060505;Zespół Szkół Zawodowych|Janów Lubelski|ul. Ogrodowa 20 |23-300 Janów Lubelski;1570;755;755;19;736;48.09;2.52
87610;060505;Ośrodek Pomocy Społecznej|Janów Lubelski|ul. Bohaterów Porytowego Wzgórza 23 |23-300 Janów Lubelski;1788;1025;1025;6;1019;57.33;0.59
87611;060505;Dom Pomocy Społecznej|Janów Lubelski|ul. Wiejska 12 |23-300 Janów Lubelski;1557;764;764;18;746;49.07;2.36
87612;060505;Liceum Ogólnokształcące im. Bohaterów Porytowego Wzgórza|Janów Lubelski|ul. Jana Pawła II 1 |23-300 Janów Lubelski;1794;1051;1051;9;1042;58.58;0.86
87613;060505;Gminna Spółdzielnia "Samopomoc Chłopska"|Janów Lubelski|ul. Lubelska 1 |23-300 Janów Lubelski;1956;1030;1030;20;1010;52.66;1.94
87614;060505;Szkoła Podstawowa w Łążku Ordynackim|Łążek Ordynacki| 205 |23-300 Janów Lubelski;412;151;151;5;146;36.65;3.31
87615;060505;Zespół Szkół w Białej Drugiej|Biała Druga| 142 |23-300 Janów Lubelski;1185;686;686;3;683;57.89;0.44
87616;060505;Publiczna Szkoła Podstawowa w Momotach Górnych|Momoty Górne| 23 |23-300 Janów Lubelski;815;388;388;6;382;47.61;1.55
87617;060505;Samodzielny Publiczny Zespół Zakładów Opieki Zdrowotnej|Janów Lubelski|Zamoyskiego 149 |23-300 Janów Lubelski;250;63;63;7;56;25.20;11.11
87618;060505;Niepubliczny Zakład Pielęgnacyjno - Opiekuńczy|Janów Lubelski|Zamoyskiego 77 |23-300 Janów Lubelski;60;9;9;0;9;15.00;0.00
87619;060506;Zespół Szkół|Modliborzyce|ul. Ogrodowa 2 |23-310 Modliborzyce;1482;767;767;34;733;51.75;4.43
87620;060506;Gminny Ośrodek Kultury|Modliborzyce|ul. Zamkowa 1 |23-310 Modliborzyce;1232;583;583;19;564;47.32;3.26
87621;060506;Remiza OSP|Zarajec| 51 |23-310 Modliborzyce;380;182;182;8;174;47.89;4.40
87622;060506;Szkoła Podstawowa|Wolica Pierwsza| 32 |23-310 Modliborzyce;417;153;153;4;149;36.69;2.61
87623;060506;Zespół Placówek Oświatowych|Stojeszyn Pierwszy| 5 |23-310 Modliborzyce;882;390;390;11;379;44.22;2.82
87624;060506;Remiza OSP|Wierzchowiska Pierwsze| 153 |23-310 Modliborzyce;1414;625;625;19;606;44.20;3.04
87625;060507;Zespół Szkół w Potoku Wielkim|Potok Wielki| 104 |23-313 Potok Wielki;1518;625;625;21;604;41.17;3.36
87626;060507;Zespół Szkół w Potoku-Stanach|Potok-Stany| 63 |23-313 Potok Wielki;1328;613;613;25;588;46.16;4.08
87627;060507;Zespół Szkół w Potoczku|Potoczek| 42 |23-313 Potok Wielki;1038;420;420;14;406;40.46;3.33
87628;060601;Zespół Szkół nr 5|Krasnystaw|ul. Mostowa 14 |22-300 Krasnystaw;0;0;0;0;0;-99;-99
87629;060601;Zespół Szkół nr 5|Krasnystaw|ul. Mostowa 14 |22-300 Krasnystaw;1290;567;567;13;554;43.95;2.29
87630;060601;Strażnica OSP Zastawie|Krasnystaw|ul. Stokowa 74a |22-300 Krasnystaw;795;310;310;8;302;38.99;2.58
87631;060601;Specjalny Ośrodek Szkolno-Wychowawczy|Krasnystaw|ul. PCK 2 |22-300 Krasnystaw;839;366;366;6;360;43.62;1.64
87632;060601;Okręgowa Spółdzielnia Mleczarska|Krasnystaw|ul. Borowa 4 |22-300 Krasnystaw;1051;512;512;8;504;48.72;1.56
87633;060601;Zespół Szkół nr 4|Krasnystaw|ul. Marszałka Piłsudskiego 21 |22-300 Krasnystaw;930;460;460;8;452;49.46;1.74
87634;060601;Zespół Szkół Nr 1|Krasnystaw|ul. Poniatowskiego 37 |22-300 Krasnystaw;1097;536;536;7;529;48.86;1.31
87635;060601;Zespół Szkół Nr 1|Krasnystaw|ul. Poniatowskiego 37 |22-300 Krasnystaw;829;499;499;3;496;60.19;0.60
87636;060601;Krasnostawski Dom Kultury|Krasnystaw|ul. Okrzei 10 |22-300 Krasnystaw;1101;547;549;19;528;49.68;3.47
87637;060601;Krasnostawski Dom Kultury|Krasnystaw|ul. Okrzei 10 |22-300 Krasnystaw;976;422;422;9;413;43.24;2.13
87638;060601;Miejska Biblioteka Publiczna|Krasnystaw|ul. Okrzei 23 |22-300 Krasnystaw;1273;635;635;11;624;49.88;1.73
87639;060601;Miejska Biblioteka Publiczna|Krasnystaw|ul. Okrzei 23 |22-300 Krasnystaw;957;431;431;19;412;45.04;4.41
87640;060601;Przedszkole nr 8|Krasnystaw|ul. Tokarzewskiego 49 |22-300 Krasnystaw;1279;614;614;8;606;48.01;1.30
87641;060601;Zespół Szkół Społecznych|Krasnystaw|ul. Odrodzenia 45 |22-300 Krasnystaw;1321;702;702;7;695;53.14;1.00
87642;060601;Zespół Szkół nr 4|Krasnystaw|Marszałka Piłsudskiego 21 |22-300 Krasnystaw;934;446;446;12;434;47.75;2.69
87643;060601;Szpital SP ZOZ|Krasnystaw|Głowackiego 3 |22-300 Krasnystaw;168;77;77;4;73;45.83;5.19
87644;060601;Areszt Śledczy|Krasnystaw|Poniatowskiego 27 |22-300 Krasnystaw;239;82;82;11;71;34.31;13.41
87645;060601;Dom Pomocy Społecznej|Krasnystaw|Kwiatowa 1 |22-300 Krasnystaw;143;47;47;22;25;32.87;46.81
87646;060602;Świetlica wiejska|Fajsławice| 107 |21-060 Fajsławice;1162;531;531;17;514;45.70;3.20
87647;060602;Remiza OSP|Suchodoły| 105 |21-060 Fajsławice;760;349;349;4;345;45.92;1.15
87648;060602;Zespół Dworsko-Parkowy|Siedliska Pierwsze| 123 |21-060 Fajsławice;332;155;155;5;150;46.69;3.23
87649;060602;Zespół Szkół|Siedliska Drugie| 190 |21-060 Fajsławice;673;341;341;11;330;50.67;3.23
87650;060602;Publiczna Szkoła Podstawowa|Boniewo| 43 |21-060 Fajsławice;396;185;185;4;181;46.72;2.16
87651;060602;Remiza OSP|Wola Idzikowska| 42 |21-060 Fajsławice;572;291;291;8;283;50.87;2.75
87652;060603;Centrum Społeczno-Kulturalne|Gorzków-Osada|Nadrzeczna 4 |22-315 Gorzków;1009;419;419;10;409;41.53;2.39
87653;060603;Remiza OSP|Orchowiec| 180 |22-315 Gorzków;529;193;193;5;188;36.48;2.59
87654;060603;Budynek po byłej szkole|Wielkopole| 80 |22-315 Gorzków;463;195;195;9;186;42.12;4.62
87655;060603;Remiza OSP|Piaski Szlacheckie| 25A |22-315 Gorzków;275;95;95;5;90;34.55;5.26
87656;060603;Remiza OSP|Borów| 114 |22-315 Gorzków;459;189;189;7;182;41.18;3.70
87657;060603;Remiza OSP|Antoniówka| 38 |22-315 Gorzków;114;55;55;2;53;48.25;3.64
87658;060603;Budynek po byłej szkole|Baranica| 22 |22-315 Gorzków;95;44;44;0;44;46.32;0.00
87659;060603;Budynek po byłej szkole|Bobrowe| 81 |22-315 Gorzków;169;74;74;1;73;43.79;1.35
87660;060604;Izbica, Budynek Urzedu Gminy|Izbica-Wieś|Gminna 4 |22-375 Izbica;1539;607;607;22;585;39.44;3.62
87661;060604;Wólka Orłowska Wiejski Dom Kultury|Wólka Orłowska| 133 |22-375 Izbica;589;240;240;8;232;40.75;3.33
87662;060604;Orłów Drewniany Zespół Szkół|Orłów Drewniany| 60A |22-375 Izbica;683;248;248;13;235;36.31;5.24
87663;060604;Stryjów Strażnica OSP|Stryjów| 176 |22-375 Izbica;698;273;273;9;264;39.11;3.30
87664;060604;Tarnogóra Samorządowy Ośrodek Kultury i Sportu|Tarnogóra|Krakowskie Przedmieście 72 |22-375 Izbica;917;380;380;16;364;41.44;4.21
87665;060604;Tarnogóra-Kolonia Szkoła Podstawowa|Tarnogóra-Kolonia| 72 |22-375 Izbica;569;237;237;12;225;41.65;5.06
87666;060604;Tarzymiechy Pierwsze Szkoła Podstawowa|Tarzymiechy Pierwsze| 72 |22-375 Izbica;752;334;334;7;327;44.41;2.10
87667;060604;Wirkowice Drugie Szkoła Podstawowa|Wirkowice Drugie| 20 |22-375 ;814;294;294;15;279;36.12;5.10
87668;060604;Dworzyska Strażnica OSP|Dworzyska| 60 |22-375 Izbica;459;184;184;4;180;40.09;2.17
87669;060605;Zakład Handlowo- Produkcyjny Stado Ogierów Białka w Białce|Białka| 6 |22-300 Krasnystaw;353;116;116;6;110;32.86;5.17
87670;060605;Wiejski Dom Kultury w Niemienicach|Niemienice| 57 |22-300 Krasnystaw;298;133;133;4;129;44.63;3.01
87671;060605;Zespół Nr 3 Przedszkola, Szkoły Podstawowej i Gimnazjum w Krasnymstawie|Krasnystaw|Krakowskie Przedmieście 38 |22-300 Krasnystaw;350;136;136;2;134;38.86;1.47
87672;060605;Szkoła Podstawowa w Jaślikowie|Jaślików| 31 |22-300 Krasnystaw;449;208;208;11;197;46.33;5.29
87673;060605;Gimnazjum Nr 2 w Zakręciu|Zakręcie| 124D |22-300 Krasnystaw;394;172;172;2;170;43.65;1.16
87674;060605;Punkt Przedszkolny w Stężycy Kolonii|Stężyca Kolonia| 85 |22-300 Krasnystaw;565;213;213;9;204;37.70;4.23
87675;060605;Remiza OSP w Latyczowie|Latyczów| 143 |22-300 Krasnystaw;493;230;230;6;224;46.65;2.61
87676;060605;Zespół Nr 5 Gimnazjum i Szkoły Podstawowej w Krupem|Krupe| 89 |22-302 Siennica Nadolna;581;213;213;5;208;36.66;2.35
87677;060605;Remiza OSP w Czarnoziemi|Czarnoziem| 36 |22-302 Siennica Nadolna;256;110;110;5;105;42.97;4.55
87678;060605;Remiza OSP w Ostrowie Krupskim|Ostrów Krupski| 56 |22-302 Siennica Nadolna;234;79;79;1;78;33.76;1.27
87679;060605;Wiejski Dom Kultury w Bzitem|Bzite| 127A |22-302 Siennica Nadolna;404;152;152;6;146;37.62;3.95
87680;060605;Świetlica Wiejska w Wincentowie|Wincentów| 3 |22-302 Siennica Nadolna;216;93;93;0;93;43.06;0.00
87681;060605;Zespół Nr 1 Gimnazjum i Szkoły Podstawowej w Siennicy Nadolnej|Siennica Nadolna| 79a |22-302 Siennica Nadolna;652;269;269;4;265;41.26;1.49
87682;060605;Gminne Centrum Kultury w Krasnymstawie z siedzibą w Siennicy Nadolnej|Siennica Nadolna| 15D |22-302 Siennica Nadolna;580;280;280;4;276;48.28;1.43
87683;060605;Wiejski Dom Kultury w Siennicy Nadolnej|Siennica Nadolna| 217 |22-302 Siennica Nadolna;452;198;198;4;194;43.81;2.02
87684;060605;Zespół Nr 4 Gimnazjum i Szkoły Podstawowej w Małochwieju Dużym|Małochwiej Duży| 82 |22-300 Krasnystaw;505;220;220;6;214;43.56;2.73
87685;060605;Wiejski Dom Kultury w Małochwieju Małym|Małochwiej Mały| 32 |22-300 Krasnystaw;260;120;120;6;114;46.15;5.00
87686;060605;Dom Ludowy w Łanach|Łany| 4 |22-300 Krasnystaw;216;92;92;0;92;42.59;0.00
87687;060605;Dom Pomocy Społecznej w Krasnymstawie Filia w Stężycy Nadwieprzańskiej|Stężyca Nadwieprzańska| 10 |22-300 Krasnystaw;27;23;23;0;23;85.19;0.00
87688;060606;Bończa 85A - Remiza OSP|Bończa| 85A |22-310 Kraśniczyn;373;118;118;8;110;31.64;6.78
87689;060606;Kraśniczyn - Urząd Gminy|Kraśniczyn|Kościuszki 21 |22-310 Kraśniczyn;1121;405;405;17;388;36.13;4.20
87690;060606;Żułów 13 DPS|Żułów| 13 |22-310 Kraśniczyn;193;112;112;1;111;58.03;0.89
87691;060606;Drewniki 27 - Remiza OSP|Drewniki| 27 |22-310 Kraśniczyn;160;57;57;0;57;35.62;0.00
87692;060606;Olszanka 25A - Remiza OSP|Olszanka| 25A |22-310 Kraśniczyn;206;51;51;3;48;24.76;5.88
87693;060606;Czajki 53 - Remiza OSP|Czajki| 53 |22-310 Kraśniczyn;265;100;100;4;96;37.74;4.00
87694;060606;Surhów 1 - Szkoła Podstawowa|Surhów| 1 |22-310 Kraśniczyn;695;259;259;3;256;37.27;1.16
87695;060606;Chełmiec 50 - Remiza OSP|Chełmiec| 50 |22-310 Kraśniczyn;137;71;71;2;69;51.82;2.82
87696;060606;Łukaszówka 18 - Remiza OSP|Łukaszówka| 18 |22-310 Kraśniczyn;67;28;28;1;27;41.79;3.57
87697;060606;Bończa – Kolonia 71 DPS|Bończa – Kolonia| 71 |22-310 Kraśniczyn;70;54;54;4;50;77.14;7.41
87698;060606;Surhów – Kolonia 3 DPS|Surhów– Kolonia| 3 |22-310 Kraśniczyn;36;17;17;4;13;47.22;23.53
87699;060607;Budynek biblioteki|Łopiennik Górny| 1C |22-351 Łopiennik Górny;1457;608;608;18;590;41.73;2.96
87700;060607;Remiza OSP|Krzywe| 101 |22-351 Łopiennik Górny;533;186;186;7;179;34.90;3.76
87701;060607;Budynek szkoły|Łopiennik Dolny| 56 |22-351 Łopiennik Górny;762;340;340;12;328;44.62;3.53
87702;060607;Budynek szkoły|Żulin| 116 |22-351 Łopiennik Górny;660;181;181;12;169;27.42;6.63
87703;060609;Budynek świetlicy wiejskiej w Suszniu|Suszeń| 5A |22-330 Rudnik;380;136;136;0;136;35.79;0.00
87704;060609;Sala Gimnastyczna w Rudniku|Rudnik| 70 |22-330 Rudnik;881;332;332;8;324;37.68;2.41
87705;060609;Budynek byłej Szkoły Podstawowej|Wierzbica| 24 |22-330 Rudnik;627;204;204;6;198;32.54;2.94
87706;060609;Szkoła Podstawowa|Płonka| 70 |22-330 Rudnik;449;178;178;3;175;39.64;1.69
87707;060609;Dom Pomocy Społecznej|Bzowiec| 134 |22-335 Żółkiewka;366;159;159;5;154;43.44;3.14
87708;060610;Remiza OSP|Siennica Królewska Duża| 97 |22-304 Siennica Różana;593;284;284;4;280;47.89;1.41
87709;060610;Sala Gimnastyczna Zespolu Szkół|Siennica Różana| 257 |22-304 Siennica Różana;1215;558;558;15;543;45.93;2.69
87710;060610;Remiza OSP|Wola Siennicka| 75 |22-304 Siennica Różana;645;290;290;6;284;44.96;2.07
87711;060610;Biurowiec RSP Zagroda|Zagroda| 135 |22-304 Siennica Różana;686;286;286;14;272;41.69;4.90
87712;060610;Remiza OSP|Wierzchowiny| 61a |22-304 Siennica Różana;329;131;131;4;127;39.82;3.05
87713;060611;Budynek Szkoły|Olchowiec| 54 |22-335 Żółkiewka;675;237;237;5;232;35.11;2.11
87714;060611;Urząd Gminy|Żółkiewka|Hetmana Żółkiewskiego 2 |22-335 Żółkiewka;1153;522;522;20;502;45.27;3.83
87715;060611;Hala sportowa|Żółkiewka|Polna 24 |22-335 Żółkiewka;705;278;278;11;267;39.43;3.96
87716;060611;Remiza OSP|Dąbie| 43 |22-335 Żółkiewka;195;100;100;1;99;51.28;1.00
87717;060611;Remiza OSP|Rożki| 39 |22-335 Żółkiewka;614;181;181;6;175;29.48;3.31
87718;060611;Remiza OSP|Koszarsko| 31A |22-335 Żółkiewka;467;208;208;8;200;44.54;3.85
87719;060611;Remiza OSP|Wierzchowina| 162 |22-335 Żółkiewka;450;180;180;4;176;40.00;2.22
87720;060611;Remiza OSP|Chłaniów| 137 |22-335 Żółkiewka;553;276;276;6;270;49.91;2.17
87721;060701;Centrum Kultury i Promocji|Kraśnik|Niepodległości 44 |23-204 Kraśnik;749;337;337;10;327;44.99;2.97
87722;060701;Publiczna Szkoła Podstawowa Nr 5|Kraśnik|Niepodległości 54 |23-204 Kraśnik;1032;561;561;15;546;54.36;2.67
87723;060701;Zespół Szkół Nr 2|Kraśnik|Gen. Sikorskiego 25 |23-204 Kraśnik;1587;720;720;28;692;45.37;3.89
87724;060701;Filia Nr 1 Miejskiej Biblioteki Publicznej|Kraśnik|Ks. Zielińskiego 3 |23-204 Kraśnik;1843;1029;1029;27;1002;55.83;2.62
87725;060701;Publiczne Gimnazjum Nr 1|Kraśnik|Ks. Popiełuszki 1 |23-204 Kraśnik;1944;1062;1062;35;1027;54.63;3.30
87726;060701;Przedszkole Miejskie Nr 2|Kraśnik|Matejki 1 |23-204 Kraśnik;1159;501;501;27;474;43.23;5.39
87727;060701;Zespół Szkół Nr 3|Kraśnik|Słowackiego 7 |23-204 Kraśnik;1865;1133;1133;15;1118;60.75;1.32
87728;060701;Integracyjne Przedszkole Publiczne Nr 3|Kraśnik|Balladyny 8 |23-204 Kraśnik;1769;1010;1010;20;990;57.09;1.98
87729;060701;Społeczna Szkoła Podstawowa|Kraśnik|Szpitalna 1A |23-204 Kraśnik;1127;603;603;14;589;53.50;2.32
87730;060701;Publiczna Szkoła Podstawowa Nr 6|Kraśnik|Grunwaldzka 2 |23-204 Kraśnik;1693;899;899;37;862;53.10;4.12
87731;060701;Centrum Kultury i Promocji|Kraśnik|Niepodległości 44 |23-204 Kraśnik;1013;506;506;10;496;49.95;1.98
87732;060701;Szkoła Podstawowa Nr 3|Kraśnik|Urzędowska 435 |23-200 Kraśnik;1089;509;509;7;502;46.74;1.38
87733;060701;Filia Nr 2 Miejskiej Biblioteki Publicznej|Kraśnik|Piaskowa 20 |23-200 Kraśnik;1579;807;807;17;790;51.11;2.11
87734;060701;Urząd Stanu Cywilnego|Kraśnik|Urzędowska 34 |23-200 Kraśnik;1842;937;937;24;913;50.87;2.56
87735;060701;Przedszkole Miejskie Nr 5|Kraśnik|Koszarowa 10A |23-200 Kraśnik;1702;896;896;12;884;52.64;1.34
87736;060701;Publiczne Gimnazjum Nr 2|Kraśnik|Urzędowska 10 |23-204 Kraśnik;891;496;496;13;483;55.67;2.62
87737;060701;Publiczne Gimnazjum Nr 2|Kraśnik|Urzędowska 10 |23-204 Kraśnik;1563;767;767;24;743;49.07;3.13
87738;060701;Szkoła Podstawowa Nr 4|Kraśnik|Kolejowa 28 |23-200 Kraśnik;975;518;518;19;499;53.13;3.67
87739;060701;Ochotnicza Straż Pożarna|Kraśnik|Narutowicza 49 |23-200 Kraśnik;1208;598;598;14;584;49.50;2.34
87740;060701;Dom Pomocy Społecznej|Kraśnik|Oboźna 36 |23-200 Kraśnik;934;465;465;18;447;49.79;3.87
87741;060701;Publiczna Szkoła Podstawowa Nr 1|Kraśnik|Kościuszki 23 |23-200 Kraśnik;1066;526;526;14;512;49.34;2.66
87742;060701;Szpital Powiatowy w Kraśniku|Kraśnik|Chopina 13 |23-200 Kraśnik;214;41;41;5;36;19.16;12.20
87743;060701;Szpital Powiatowy w Kraśniku|Kraśnik|Aleja Niepodległości 25 |23-204 Kraśnik;65;25;25;0;25;38.46;0.00
87744;060702;Miejski Zespół Szkół w Annopolu|Annopol|ul. Kościuszki 8 |23-235 Annopol;1474;681;681;32;649;46.20;4.70
87745;060702;Remiza OSP Nowy Rachów|Nowy Rachów| 57 |23-235 Annopol;304;93;93;7;86;30.59;7.53
87746;060702;Publiczna Szkoła Podstawowa w Opoce Dużej|Opoka Duża| 5 |23-235 Annopol;867;320;320;20;300;36.91;6.25
87747;060702;Publiczna Szkoła Podstawowa w Grabówce|Grabówka| 67 |23-235 Annopol;778;274;274;22;252;35.22;8.03
87748;060702;Publiczna Szkoła Podstawowa w Świeciechowie Dużym|Świeciechów Duży| 204 |23-235 Annopol;1147;469;469;19;450;40.89;4.05
87749;060702;Publiczna Szkoła Podstawowa w Kosinie|Kosin| 22 |23-235 Annopol;501;196;196;15;181;39.12;7.65
87750;060702;Publiczna Szkoła Podstawowa w Janiszowie|Janiszów| 32 |23-235 Annopol;450;188;188;11;177;41.78;5.85
87751;060702;Publiczna Szkoła Podstawowa w Borowie|Borów| 32 |23-235 Annopol;379;178;178;6;172;46.97;3.37
87752;060702;Publiczna Szkoła Podstawowa w Dąbrowie|Dąbrowa| 91 |23-235 Annopol;400;175;175;10;165;43.75;5.71
87753;060702;Miejski Zespół Szkół w Annopolu|Annopol|ul. Kościuszki 8 |23-235 Annopol;962;394;394;19;375;40.96;4.82
87754;060703;Zespół Placówek Oświatowych w Terpentynie|Terpentyna| 182 |23-251 Dzierzkowice;1016;505;505;14;491;49.70;2.77
87755;060703;Filia Szkoły Podstawowej w Terpentynie|Dzierzkowice-Wola| 184B |23-251 Dzierzkowice;698;266;266;5;261;38.11;1.88
87756;060703;Publiczna Szkoła Podstawowa w Ludmiłówce|Ludmiłówka| 33 |23-251 Dzierzkowice;447;199;199;8;191;44.52;4.02
87757;060703;Szkoła Podstawowa w Wyżnicy|Wyżnica| 33 |23-251 Dzierzkowice;1232;570;570;19;551;46.27;3.33
87758;060703;Dom Ludowy|Dzierzkowice-Zastawie| 174 |23-251 Dzierzkowice;400;219;219;5;214;54.75;2.28
87759;060703;Klub Rolnika|Dzierzkowice-Podwody| 83 |23-251 Dzierzkowice;548;252;252;10;242;45.99;3.97
87760;060704;Zespół Placówek Oświatowych w Gościeradowie|Gościeradów-Folwark| 18 |23-275 Gościeradów Ukazowy;1682;714;714;31;683;42.45;4.34
87761;060704;Zespół Szkół w Księżomierzy|Księżomierz, Ulica Kościelna| 14 |23-275 Gościeradów Ukazowy;1230;503;503;19;484;40.89;3.78
87762;060704;Zespół Szkół w Liśniku Dużym|Liśnik Duży| 161 |23-275 Gościeradów Ukazowy;470;204;204;10;194;43.40;4.90
87763;060704;Publiczna Szkoła Podstawowa w Mniszku|Mniszek| 67 |23-275 Gościeradów Ukazowy;509;171;171;8;163;33.60;4.68
87764;060704;Publiczna Szkoła Podstawowa w Szczecynie|Szczecyn| 50 |23-275 Gościeradów Ukazowy;537;172;172;11;161;32.03;6.40
87765;060704;Budynek Zespołu Placówek Oświatowych w Gościeradowie|Salomin| 121 |23-275 Gościeradów Ukazowy;389;163;163;11;152;41.90;6.75
87766;060704;Zespół Szkół w Wólce Gościeradowskiej|Wólka Gościeradowska| 71 |23-275 Gościeradów Ukazowy;764;262;262;19;243;34.29;7.25
87767;060704;Budynek Zespołu Szkół w Liśniku Dużym|Suchodoły| 97 |23-275 Gościeradów Ukazowy;320;132;132;5;127;41.25;3.79
87768;060705;Urząd Gminy|Kraśnik|ul. Kościuszki 24 |23-200 Kraśnik;1534;720;720;21;699;46.94;2.92
87769;060705;Szkoła Podstawowa|Kowalin| 45 |23-200 Kraśnik;793;366;366;12;354;46.15;3.28
87770;060705;Przedszkole w Stróży|Stróża-Kolonia|ul. Akacjowa 4A |23-206 Kraśnik;1193;614;614;17;597;51.47;2.77
87771;060705;Szkoła Podstawowa w Stróży|Stróża-Kolonia|ul. Akacjowa 2A |23-206 Kraśnik;1245;607;607;11;596;48.76;1.81
87772;060705;Szkoła Podstawowa|Słodków Trzeci| 7 |23-206 Kraśnik;1046;523;523;13;510;50.00;2.49
87773;060706;Zespół Szkół|Szastarka Stacja| 104 |23-225 Szastarka;755;375;375;24;351;49.67;6.40
87774;060706;Zespół Szkół|Blinów Drugi| 111 |23-225 Szastarka;1140;520;520;15;505;45.61;2.88
87775;060706;Publiczna Szkoła Podstawowa|Polichna Druga| 26 |23-225 Szastarka;1295;642;642;17;625;49.58;2.65
87776;060706;Remiza Ochotniczej Straży Pożarnej|Majdan-Obleszcze| 109 |23-225 Szastarka;844;381;381;11;370;45.14;2.89
87777;060706;Gminne Centrum Kultury|Polichna Czwarta| 1 |23-225 Szastarka;759;379;379;14;365;49.93;3.69
87778;060707;Urząd Gminy w Trzydniku Dużym|Trzydnik Duży| 59A |23-230 Trzydnik Duży;949;402;402;15;387;42.36;3.73
87779;060707;Świetlica w Budkach|Budki| 25A |23-230 Trzydnik Duży;288;139;139;5;134;48.26;3.60
87780;060707;Świetlica w Dąbrowie|Dąbrowa| 91 |23-230 Trzydnik Duży;284;132;132;6;126;46.48;4.55
87781;060707;Remiza OSP w Liśniku Małym|Liśnik Mały| 52A |23-230 Trzydnik Duży;205;98;98;3;95;47.80;3.06
87782;060707;Szkoła Podstawowa w Łychowie Gościeradowskim|Łychów Gościeradowski| 76 |23-230 Trzydnik Duży;407;149;149;4;145;36.61;2.68
87783;060707;Szkoła Podstawowa w Olbięcinie|Olbięcin| 95 |23-230 Trzydnik Duży;711;310;310;4;306;43.60;1.29
87784;060707;Remiza OSP w Rzeczycy Księżej|Rzeczyca Księża| 187A |23-230 Trzydnik Duży;633;241;241;12;229;38.07;4.98
87785;060707;Szkoła Podstawowa w Rzeczycy Ziemiańskiej|Rzeczyca Ziemiańska| 79 |23-230 Trzydnik Duży;1068;398;398;10;388;37.27;2.51
87786;060707;Świetlica w Węglinie|Węglin| 57A |23-230 Trzydnik Duży;519;190;190;9;181;36.61;4.74
87787;060707;Szkoła Podstawowa w Woli Trzydnickiej|Wola Trzydnicka| 52A |23-230 Trzydnik Duży;298;154;154;2;152;51.68;1.30
87788;060708;lokal Szkoły Podstawowej|Boby-Kolonia| 75 |23-250 Urzędów;906;417;417;7;410;46.03;1.68
87789;060708;lokal Szkoły Podstawowej|Moniaki| 110 |23-250 Urzędów;966;385;385;10;375;39.86;2.60
87790;060708;lokal Szkoły Podstawowej|Bęczyn| 57 |23-250 Urzędów;678;373;373;14;359;55.01;3.75
87791;060708;lokal Zespołu Szkół Ogólnokształcących|Urzędów|ul. Wodna 24 |23-250 Urzędów;1289;692;692;29;663;53.69;4.19
87792;060708;lokal Szkoły Podstawowej|Rankowskie| 31 |23-250 Urzędów;1096;562;562;21;541;51.28;3.74
87793;060708;lokal Zespołu Szkół|Skorczyce| 52 |23-250 Urzędów;464;196;196;8;188;42.24;4.08
87794;060708;lokal Budynku Wielofunkcyjnego|Popkowice| 6 |23-250 Urzędów;1004;435;435;13;422;43.33;2.99
87795;060708;lokal Szkoły Podstawowej|Leszczyna| 94A |23-250 Urzędów;415;210;210;2;208;50.60;0.95
87796;060708;Dom Pomocy Społecznej|Popkowice| 1 |23-250 Urzędów;155;71;71;13;58;45.81;18.31
87797;060709;Szkoła Podstawowa w Rudniku Szlacheckim|Rudnik Szlachecki| 38 |23-212 Wilkołaz;973;565;565;15;550;58.07;2.65
87798;060709;Zespół Szkół w Wilkołazie Pierwszym|Wilkołaz Pierwszy| 7 |23-212 Wilkołaz;1198;684;684;14;670;57.10;2.05
87799;060709;Zespół Szkół w Wilkołazie Pierwszym|Wilkołaz Pierwszy| 7 |23-212 Wilkołaz;1466;806;806;19;787;54.98;2.36
87800;060709;Szkoła Podstawowa w Ostrowie|Ostrów| 9 |23-212 Wilkołaz;713;351;351;11;340;49.23;3.13
87801;060710;Szkoła Podstawowa|Bystrzyca| 137 |23-213 Zakrzówek;761;328;328;12;316;43.10;3.66
87802;060710;Szkoła Podstawowa|Majdan-Grabina| 145A |23-213 Zakrzówek;644;305;305;14;291;47.36;4.59
87803;060710;Szkoła Podstawowa|Rudnik Drugi| 86 |23-213 Zakrzówek;724;351;351;10;341;48.48;2.85
87804;060710;Zespół Szkół|Sulów| 75 |23-213 Zakrzówek;955;453;453;8;445;47.43;1.77
87805;060710;Szkoła Podstawowa|Studzianki| 63 |23-213 Zakrzówek;634;307;307;12;295;48.42;3.91
87806;060710;Zespół Szkół|Zakrzówek|ul. Sienkiewicza 1 |23-213 Zakrzówek;1757;846;846;12;834;48.15;1.42
87807;060801;Szkoła Podstawowa Nr 4 w Lubartowie|Lubartów|ul. Kosmonautów 11 |21-100 Lubartów;1710;982;982;12;970;57.43;1.22
87808;060801;Zespół Szkół Nr 2 w Lubartowie|Lubartów|ul. Chopina 6 |21-100 Lubartów;2275;1355;1355;19;1336;59.56;1.40
87809;060801;Przedszkole Miejskie Nr 1 w Lubartowie|Lubartów|ul. 3 Maja 24b |21-100 Lubartów;1600;829;829;18;811;51.81;2.17
87810;060801;Przedsiębiorstwo Gospodarki Komunalnej w Lubartowie Sp. z o.o. w Lubartowie|Lubartów|ul. Parkowa 6 |21-100 Lubartów;1518;862;862;22;840;56.79;2.55
87811;060801;Gimnazjum Nr 1 w Lubartowie|Lubartów|ul. Legionów 3 |21-100 Lubartów;1236;684;685;13;671;55.34;1.90
87812;060801;Przedszkole Miejskie Nr 2 w Lubartowie|Lubartów|ul. Kościuszki 1 |21-100 Lubartów;1895;1003;1003;24;979;52.93;2.39
87813;060801;Gimnazjum Nr 2 w Lubartowie|Lubartów|ul. Lubelska 68 |21-100 Lubartów;1618;894;894;8;886;55.25;0.89
87814;060801;Miejska Biblioteka Publiczna w Lubartowie|Lubartów|ul. Lubelska 36 |21-100 Lubartów;929;519;519;9;510;55.87;1.73
87815;060801;Regionalne Centrum Edukacji Zawodowej w Lubartowie|Lubartów|ul. 1 Maja 82 |21-100 Lubartów;1528;846;846;19;827;55.37;2.25
87816;060801;Szkoła Podstawowa Nr 3 w Lubartowie|Lubartów|ul. 1 Maja 66-74 |21-100 Lubartów;1697;1036;1036;15;1021;61.05;1.45
87817;060801;II Liceum Ogólnokształcące w Lubartowie|Lubartów|ul. 1 Maja 66-74 |21-100 Lubartów;1704;917;917;15;902;53.81;1.64
87818;060801;Samodzielny Publiczny Zakład Opieki Zdrowotnej|Lubartów|Cicha 14 |21-100 Lubartów;78;49;49;0;49;62.82;0.00
87819;060802;Zespół Szkolno-Przedszkolny, Abramów|Abramów|ul. 22 Lipca 31 |21-143 Abramów;1182;583;583;19;564;49.32;3.26
87820;060802;Lokal po Szkole Podstawowej|Ciotcza| 29A |21-143 Abramów;299;176;176;7;169;58.86;3.98
87821;060802;Remiza OSP|Dębiny| 114 |21-143 Abramów;242;108;108;2;106;44.63;1.85
87822;060802;Remiza OSP|Glinnik| 73 |21-143 Abramów;345;164;164;10;154;47.54;6.10
87823;060802;Szkoła Podstawowa|Wielkie| 66 |21-143 Abramów;463;218;218;8;210;47.08;3.67
87824;060802;Szkoła Podstawowa|Wielkolas| 27C |21-143 Abramów;485;208;208;6;202;42.89;2.88
87825;060802;Remiza OSP|Wolica| 66 |21-143 Abramów;395;227;227;3;224;57.47;1.32
87826;060803;Świetlica wiejska|Wola Skromowska| 56 |21-150 Kock;639;281;281;8;273;43.97;2.85
87827;060803;Lokal byłej Szkoły Podstawowej|Sułoszyn| 49 |21-150 Kock;384;164;164;11;153;42.71;6.71
87828;060803;Gminna Biblioteka Publiczna|Firlej|ul. Kościelna 4 |21-136 Firlej;1587;693;693;34;659;43.67;4.91
87829;060803;Remiza OSP|Serock| 89 |21-136 Firlej;396;170;170;5;165;42.93;2.94
87830;060803;Szkoła Podstawowa|Przypisówka| 18 |21-136 Firlej;395;138;138;5;133;34.94;3.62
87831;060803;Remiza OSP|Łukówiec| 50 |21-136 Firlej;523;198;198;5;193;37.86;2.53
87832;060803;Filia Biblioteki Publicznej|Sobolew-Kolonia| 18A |21-136 Firlej;399;152;152;16;136;38.10;10.53
87833;060803;Szkoła Podstawowa|Nowy Antonin| 72 |21-136 Firlej;440;140;140;17;123;31.82;12.14
87834;060804;Urząd Gminy|Jeziorzany|ul. Rynek 22 |21-146 Jeziorzany;757;292;292;10;282;38.57;3.42
87835;060804;Zespół Szkół|Przytoczno| 25 |21-146 Jeziorzany;1056;363;363;15;348;34.38;4.13
87836;060804;Remiza OSP|Krępa| 89 |21-146 Jeziorzany;530;258;258;7;251;48.68;2.71
87837;060805;lokal Szkoły Podstawowej|Samoklęski| 6A |21-132 Kamionka;690;256;256;6;250;37.10;2.34
87838;060805;lokal remizo-świetlicy|Syry| 53 |21-132 Kamionka;341;157;157;7;150;46.04;4.46
87839;060805;lokal Szkoły Podstawowej|Starościn| 73 |21-132 Kamionka;483;243;243;15;228;50.31;6.17
87840;060805;lokal remizo-świetlicy|Wólka Krasienińska| 21A |21-132 Kamionka;267;143;143;7;136;53.56;4.90
87841;060805;lokal byłej Szkoły Podstawowej|Kamionka|ul. Grobelna 1 |21-132 Kamionka;834;347;347;9;338;41.61;2.59
87842;060805;lokal Biblioteki Gminnej|Kamionka|ul. Grobelna 1 |21-132 Kamionka;873;387;387;19;368;44.33;4.91
87843;060805;lokal świetlicy wiejskiej|Kierzkówka| 12B |21-132 Kamionka;388;161;161;6;155;41.49;3.73
87844;060805;lokal świetlicy wiejskiej|Kozłówka| 46 |21-132 Kamionka;744;303;303;10;293;40.73;3.30
87845;060805;lokal świetlicy wiejskiej|Siedliska| 123 |21-132 Kamionka;498;203;203;14;189;40.76;6.90
87846;060806;Dom Kultury|Kock|ul. Apteczna 4 |21-150 Kock;1327;554;554;14;540;41.75;2.53
87847;060806;Zespół Szkół|Kock|ul. Przechodnia 11 |21-150 Kock;1496;721;721;18;703;48.20;2.50
87848;060806;Niepubliczna Szkoła Podstawowa|Górka| 22 |21-150 Kock;488;195;195;9;186;39.96;4.62
87849;060806;Szkoła Podstawowa im. H. Sienkiewicza|Talczyn| 160 |21-150 Kock;447;177;177;24;153;39.60;13.56
87850;060806;Świetlica Wiejska|Annopol| 16 A |21-150 Kock;259;103;103;5;98;39.77;4.85
87851;060806;Niepubliczna Szkoła Podstawowa|Białobrzegi| 90 |21-150 Kock;643;317;317;9;308;49.30;2.84
87852;060806;Zespół Szkół im. Jana Pawła II|Poizdów| 1 |21-150 Kock;570;268;268;13;255;47.02;4.85
87853;060806;Dom Pomocy Społecznej w Kocku|Kock|Tadeusza Kościuszki 1D |21-150 Kock;58;35;35;0;35;60.34;0.00
87854;060807;Dom Pomocy Społecznej|Łucka| 71 |21-100 Lubartów;323;177;177;6;171;54.80;3.39
87855;060807;Szkoła Podstawowa|Łucka-Kolonia| 125 |21-100 Lubartów;1226;660;660;19;641;53.83;2.88
87856;060807;Gimnazjum|Łucka-Kolonia| 125 |21-100 Lubartów;764;414;414;12;402;54.19;2.90
87857;060807;Gminna Biblioteka Publiczna|Skrobów-Kolonia| 104 |21-100 Lubartów;1311;641;641;10;631;48.89;1.56
87858;060807;Szkoła Podstawowa|Wólka Rokicka| 90 |21-100 Lubartów;970;416;416;11;405;42.89;2.64
87859;060807;Szkoła Podstawowa|Nowodwór| 60A |21-100 Lubartów;813;426;426;11;415;52.40;2.58
87860;060807;Gminna Biblioteka Publiczna|Lisów| 32B |21-100 Lubartów;752;394;394;4;390;52.39;1.02
87861;060807;Szkoła Podstawowa|Mieczysławka| 39 |21-100 Lubartów;569;272;272;8;264;47.80;2.94
87862;060807;Szkoła Podstawowa|Szczekarków| 124 |21-100 Lubartów;587;278;278;10;268;47.36;3.60
87863;060807;Szkoła Podstawowa|Annobór| 69 |21-100 Lubartów;530;258;258;9;249;48.68;3.49
87864;060807;Szkoła Podstawowa|Brzeziny| 168 |21-100 Lubartów;522;240;240;11;229;45.98;4.58
87865;060807;Świetlica wiejska|Chlewiska| 24A |21-100 Lubartów;287;147;147;3;144;51.22;2.04
87866;060808;Zespół Szkół Ogólnokształcących|Michów|ul. Szkolna II 2B |21-140 Michów;1356;720;720;11;709;53.10;1.53
87867;060808;Zespół Szkół Ogólnokształcących|Michów|ul. Szkolna II 2 B |21-140 Michów;1030;386;386;9;377;37.48;2.33
87868;060808;Szkoła Podstawowa|Katarzyn| 114 |21-140 Michów;730;279;279;11;268;38.22;3.94
87869;060808;Zespół Szkół|Rudno|ul. Spacerowa 110 |21-140 Michów;1166;450;450;10;440;38.59;2.22
87870;060808;Remiza OSP|Wypnicha| 54 |21-140 Michów;436;148;148;7;141;33.94;4.73
87871;060808;Remiza OSP|Giżyce| 63 |21-140 Michów;318;135;135;4;131;42.45;2.96
87872;060809;Szkoła Podstawowa|Niedźwiada-Kolonia| 42 |21-104 Niedźwiada;872;408;408;17;391;46.79;4.17
87873;060809;Szkoła Podstawowa|Brzeźnica Bychawska| 123 |21-104 Niedźwiada;1085;495;495;9;486;45.62;1.82
87874;060809;Szkoła Podstawowa|Tarło| 103 |21-104 Niedźwiada;801;342;342;10;332;42.70;2.92
87875;060809;Szkoła Podstawowa|Pałecznica| 81 |21-104 Niedźwiada;679;342;342;9;333;50.37;2.63
87876;060809;Szkoła Podstawowa|Brzeźnica Książęca| 24 |21-104 Niedźwiada;952;473;473;22;451;49.68;4.65
87877;060809;Szkoła Podstawowa|Górka Lubartowska| 66 |21-104 Niedźwiada;665;305;305;12;293;45.86;3.93
87878;060810;Gimnazjum|Ostrów Lubelski|ul. Partyzantów 26 |21-110 Ostrów Lubelski;1162;605;605;15;590;52.07;2.48
87879;060810;Szkoła Podstawowa|Ostrów Lubelski|ul. Partyzantów 26 |21-110 Ostrów Lubelski;887;500;500;13;487;56.37;2.60
87880;060810;Szkoła Podstawowa|Kaznów-Kolonia| 26 |21-110 Ostrów Lubelski;447;196;196;5;191;43.85;2.55
87881;060810;Szkoła Podstawowa|Kolechowice| 125 |21-110 Ostrów Lubelski;717;321;321;19;302;44.77;5.92
87882;060810;Szkoła Podstawowa|Rozkopaczew| 34 |21-110 Ostrów Lubelski;1140;500;500;14;486;43.86;2.80
87883;060811;Remiza Ochotniczej Straży Pożarnej w Dębicy|Dębica| 63 |21-102 Ostrówek;466;180;180;4;176;38.63;2.22
87884;060811;Świetlica wiejska w Tarkawicy|Tarkawica| 114A |21-102 Ostrówek;460;216;216;7;209;46.96;3.24
87885;060811;Świetlica wiejska w Luszawie|Luszawa| 76 |21-102 Ostrówek;441;159;159;4;155;36.05;2.52
87886;060811;Szkoła Podstawowa im. Bohaterów Monte Cassino w Ostrówku|Ostrówek-Kolonia| 3 |21-102 Ostrówek;772;348;348;9;339;45.08;2.59
87887;060811;Remiza Ochotniczej Straży Pożarnej w Kamienowoli|Kamienowola| 43A |21-102 Ostrówek;334;166;166;7;159;49.70;4.22
87888;060811;Szkoła Podstawowa im. Dywizjonu 301 w Leszkowicach|Leszkowice| 12A |21-102 Ostrówek;700;247;247;8;239;35.29;3.24
87889;060812;Szkoła Podstawowa im. Marii Konopnickiej w Woli Sernickiej|Wola Sernicka| 242 |21-107 Serniki;918;468;468;21;447;50.98;4.49
87890;060812;Szkoła Podstawowa im. Jana Kochanowskiego w Nowej Woli|Nowa Wola| 95 |21-107 Serniki;784;459;459;17;442;58.55;3.70
87891;060812;Szkoła Podstawowa im. Jana Pawła II w Brzostówce|Brzostówka| 88 |21-107 Serniki;872;400;400;14;386;45.87;3.50
87892;060812;Urząd Gminy Serniki|Serniki| 1A |21-107 Serniki;909;444;444;20;424;48.84;4.50
87893;060812;Publiczna Szkoła Podstawowa w Nowej Wsi|Nowa Wieś| 76 |21-107 Serniki;461;251;251;14;237;54.45;5.58
87894;060813;Zespół Szkół|Stary Uścimów| 43 |21-109 Uścimów;819;357;357;9;348;43.59;2.52
87895;060813;Zespół Szkół|Stary Uścimów| 43 |21-109 Uścimów;734;355;355;17;338;48.37;4.79
87896;060813;Szkoła Podstawowa|Nowa Jedlanka| 1 |21-109 Uścimów;711;280;280;8;272;39.38;2.86
87897;060813;Szkoła Podstawowa|Krasne| 118 |21-109 Uścimów;393;147;147;4;143;37.40;2.72
87898;060901;Zespół Szkół im. Mikołaja Kopernika|Bełżyce|ul. Bychawska 4 |24-200 Bełżyce;1295;666;666;13;653;51.43;1.95
87899;060901;Samorządowe Przedszkole Publiczne|Bełżyce|ul. Bychawska 15 |24-200 Bełżyce;1389;721;721;25;696;51.91;3.47
87900;060901;Miejski Dom Kultury|Bełżyce|ul. Tysiąclecia 26 |24-200 Bełżyce;1084;635;635;7;628;58.58;1.10
87901;060901;Urząd Miejski|Bełżyce|ul. Lubelska 3 |24-200 Bełżyce;1386;764;764;23;741;55.12;3.01
87902;060901;Zespół Szkół Nr 2 im. Królowej Jadwigi|Bełżyce, Wzgórze|ul. Kościuszki 148 |24-200 Bełżyce;967;452;452;16;436;46.74;3.54
87903;060901;Szkoła Podstawowa|Babin| 147 |24-200 Bełżyce;764;441;441;14;427;57.72;3.17
87904;060901;Szkoła Podstawowa|Matczyn| 9 |24-200 Bełżyce;679;316;316;12;304;46.54;3.80
87905;060901;Szkoła Podstawowa|Kierz| 89 |24-200 Bełżyce;827;307;307;17;290;37.12;5.54
87906;060901;Wiejski Ośrodek Zdrowia|Krężnica Okrągła| 38a |24-200 Bełżyce;830;316;316;5;311;38.07;1.58
87907;060901;Szkoła Podstawowa|Stare Wierzchowiska| 39 |24-200 Bełżyce;737;305;305;15;290;41.38;4.92
87908;060901;Remiza OSP|Zagórze|Zagórze 37 |24-200 Bełżyce;777;329;329;9;320;42.34;2.74
87909;060901;Szpital Powiatowy im. Dr Wojciecha Oczki|Bełżyce|Lubelska 90 |24-200 Bełżyce;106;17;17;1;16;16.04;5.88
87910;060902;Gimnazjum w Borzechowie Kolonii|Borzechów-Kolonia| 227 |24-224 Borzechów;947;606;606;25;581;63.99;4.13
87911;060902;Szkoła Podstawowa w Kłodnicy Dolnej|Kłodnica Dolna| 117 |24-224 Borzechów;861;503;503;5;498;58.42;0.99
87912;060902;Remiza OSP w Łopienniku|Łopiennik| 127 |24-224 Borzechów;550;254;254;12;242;46.18;4.72
87913;060902;Remiza OSP w Kępie|Kępa| 39 |24-224 Borzechów;435;172;172;8;164;39.54;4.65
87914;060902;Remiza OSP w Łączkach-Pawłówku|Łączki-Pawłówek| 40 |24-224 Borzechów;239;126;126;6;120;52.72;4.76
87915;060902;Remiza OSP w Dobrowoli|Dobrowola| 31 |24-224 Borzechów;142;82;82;2;80;57.75;2.44
87916;060903;Środowiskowy Dom Samopomocy|Bychawa|ul. Pileckiego 20 |23-100 Bychawa;660;244;244;11;233;36.97;4.51
87917;060903;Samorządowe Przedszkole Nr 1|Bychawa|ul. Partyzantów 3 |23-100 Bychawa;572;270;270;5;265;47.20;1.85
87918;060903;Szkoła Podstawowa|Bychawa|ul. Szkolna 8 |23-100 Bychawa;837;390;390;16;374;46.59;4.10
87919;060903;Urząd Miejski (sala konferencyjna)|Bychawa|ul. Marsz. J. Piłsudskiego 22 |23-100 Bychawa;765;398;398;11;387;52.03;2.76
87920;060903;Bychawskie Centrum Kultury|Bychawa|ul. Marsz. J. Piłsudskiego 34 |23-100 Bychawa;636;304;304;14;290;47.80;4.61
87921;060903;Zespół Szkół im. Ks. Antoniego Kwiatkowskiego|Bychawa|ul. Marsz. J. Piłsudskiego 81 |23-100 Bychawa;542;277;277;4;273;51.11;1.44
87922;060903;Bychawskie Przedsiębiorstwo Komunalne sp. z o.o.|Bychawa|ul. Rataja 6 |23-100 Bychawa;785;380;380;8;372;48.41;2.11
87923;060903;Centrum Kultury Wiejskiej|Bychawka Druga| 113 |23-100 Bychawa;815;333;333;12;321;40.86;3.60
87924;060903;Szkoła Podstawowa im. K. Koźmiana|Bychawka Druga-Kolonia| 75 |23-100 Bychawa;492;253;253;13;240;51.42;5.14
87925;060903;Budynek szkolny|Osowa| 61 |23-100 Bychawa;360;170;170;7;163;47.22;4.12
87926;060903;Remiza OSP|Olszowiec| 10 |23-100 Bychawa;601;259;259;6;253;43.09;2.32
87927;060903;Centrum Kultury Wiejskiej|Gałęzów| 24 |23-100 Bychawa;604;265;265;15;250;43.87;5.66
87928;060903;Szkoła Podstawowa|Wola Gałęzowska| 116a |23-100 Bychawa;645;282;282;13;269;43.72;4.61
87929;060903;Szkoła Podstawowa|Stara Wieś Druga| 55 |23-100 Bychawa;770;335;335;9;326;43.51;2.69
87930;060903;Budynek szkolny|Zaraszów| 64 |23-100 Bychawa;544;250;250;8;242;45.96;3.20
87931;060903;Szpital Powiatowy SP ZOZ|Bychawa|Marsz.J.Piłsudskiego 26/28/30 |23-100 Bychawa;52;5;5;1;4;9.62;20.00
87932;060904;lokal Gminnej Biblioteki Publicznej|Garbów| 29 |21-080 Garbów;1744;962;962;24;938;55.16;2.49
87933;060904;lokal Szkoły Podstawowej|Bogucin| 64 |21-080 Garbów;839;440;440;4;436;52.44;0.91
87934;060904;lokal Szkoły Podstawowej|Przybysławice| 1A |21-080 Garbów;1411;658;658;12;646;46.63;1.82
87935;060904;lokal w pałacu|Piotrowice Wielkie| 103 |21-080 Garbów;493;220;220;2;218;44.62;0.91
87936;060904;lokal Szkoły Podstawowej|Wola Przybysławska| 331 |21-080 Garbów;1136;512;512;25;487;45.07;4.88
87937;060904;lokal Klubu Wiejskiego|Gutanów| 13 |21-080 Garbów;383;162;162;6;156;42.30;3.70
87938;060904;lokal Szkoły Podstawowej|Borków| 13 |21-080 Garbów;230;128;128;3;125;55.65;2.34
87939;060904;lokal Szkoły Podstawowej|Leśce| 63 |21-080 Garbów;438;194;194;3;191;44.29;1.55
87940;060904;lokal remizy OSP|Janów| 29 |21-080 Garbów;188;124;124;11;113;65.96;8.87
87941;060904;lokal po byłej szkole|Karolin| 30a |21-080 Garbów;274;162;162;7;155;59.12;4.32
87942;060905;Szkoła Podstawowa|Prawiedniki| 165 |20-515 Lublin 51;1066;595;595;12;583;55.82;2.02
87943;060905;Zespół Szkół|Kalinówka| 78 |21-040 Świdnik;1925;1228;1228;16;1212;63.79;1.30
87944;060905;Urząd Gminy Głusk|Dominów|Rynek 1 |20-388 Lublin 6;1013;565;565;8;557;55.77;1.42
87945;060905;Gimnazjum|Mętów| 124A |20-388 Lublin 6;1054;559;559;9;550;53.04;1.61
87946;060905;Szkoła Podstawowa|Mętów| 124 |20-388 Lublin 6;1410;762;762;12;750;54.04;1.57
87947;060905;Zespół Szkół|Wilczopole-Kolonia| 97 |20-388 Lublin 6;1205;622;622;16;606;51.62;2.57
87948;060906;Remiza Ochotniczej Straży Pożarnej|Chmiel Pierwszy| 23 |23-114 Jabłonna;619;181;181;3;178;29.24;1.66
87949;060906;Szkoła Podstawowa w Czerniejowie|Czerniejów| 130 |23-114 Jabłonna;922;449;449;15;434;48.70;3.34
87950;060906;Gimnazjum Publiczne w Jabłonnie|Jabłonna Druga| 45 |23-114 Jabłonna;2034;966;966;14;952;47.49;1.45
87951;060906;Zespół Szkół w Piotrkowie|Piotrków Pierwszy| 105 |23-114 Jabłonna;1416;476;476;26;450;33.62;5.46
87952;060906;Szkoła Podstawowa w Skrzynicach|Skrzynice Pierwsze| 110 |23-114 Jabłonna;849;330;330;5;325;38.87;1.52
87953;060906;Szkoła Podstawowa w Tuszowie|Tuszów| 133 |23-114 Jabłonna;412;193;193;5;188;46.84;2.59
87954;060907;Szkoła Podstawowa|Panieńszczyzna|Aleja Warszawska 43 |21-002 Jastków;1527;832;832;29;803;54.49;3.49
87955;060907;Szkoła Podstawowa|Ożarów| 160 |24-150 Nałęczów;1182;497;497;20;477;42.05;4.02
87956;060907;Szkoła Podstawowa|Snopków| 50 |21-002 Jastków;1909;1158;1158;15;1143;60.66;1.30
87957;060907;Szkoła Podstawowa|Płouszowice-Kolonia| 17 |21-008 Tomaszowice;978;577;577;7;570;59.00;1.21
87958;060907;Szkoła Podstawowa|Tomaszowice-Kolonia| 40A |21-008 Tomaszowice;1612;818;818;26;792;50.74;3.18
87959;060907;Urząd Gminy Jastków|Panieńszczyzna|Chmielowa 3 |21-002 Jastków;980;540;540;9;531;55.10;1.67
87960;060907;Gminny Ośrodek Kultury i Sportu|Dąbrowica| 133 |21-008 Tomaszowice;1045;686;686;6;680;65.65;0.87
87961;060907;Szkoła Podstawowa|Panieńszczyzna|Aleja Warszawska 43 |21-002 Jastków;1347;757;757;15;742;56.20;1.98
87962;060908;Urząd Gminy|Kozubszczyzna| 127A |21-030 Motycz;1392;821;821;12;809;58.98;1.46
87963;060908;Szkoła Podstawowa|Konopnica| 40 |21-030 Motycz;1477;937;937;8;929;63.44;0.85
87964;060908;Szkoła Podstawowa|Motycz| 33 |21-030 Motycz;2094;1189;1189;23;1166;56.78;1.93
87965;060908;Budynek Ochotniczej Straży Pożarnej|Radawiec Duży| 154 |21-030 Motycz;1812;1021;1021;25;996;56.35;2.45
87966;060908;Budynek Ochotniczej Straży Pożarnej|Szerokie| 85 |20-050 Lublin;1515;961;961;9;952;63.43;0.94
87967;060908;Szkoła Podstawowa|Zemborzyce Tereszyńskie| 2 |20-515 Lublin;2051;1077;1077;14;1063;52.51;1.30
87968;060909;lokal Szkoły Podstawowej|Krzczonów|ul. Leśna 1 |23-110 Krzczonów;815;397;397;11;386;48.71;2.77
87969;060909;lokal Domu Kultury|Żuków Drugi| 5 |23-110 Krzczonów;526;205;205;8;197;38.97;3.90
87970;060909;lokal Remizy OSP|Krzczonów Trzeci| 88 |23-110 Krzczonów;523;229;229;6;223;43.79;2.62
87971;060909;Remiza OSP, Kosarzew Dolny|Kosarzew Dolny| 96 |23-110 Krzczonów;574;229;229;6;223;39.90;2.62
87972;060909;lokal Remizy OSP|Sobieska Wola Druga| 120 |23-110 Krzczonów;442;195;195;9;186;44.12;4.62
87973;060909;lokal Szkoły Podstawowej|Krzczonów|ul. Leśna 1 |23-110 Krzczonów;1042;470;470;13;457;45.11;2.77
87974;060910;Gminny Ośrodek Kultury, Sportu i Rekreacji|Niedrzwica Duża|Lubelska 10 |24-220 Niedrzwica Duża;1321;739;739;21;718;55.94;2.84
87975;060910;Szkoła Podstawowa|Niedrzwica Duża|Lubelska 21a |24-220 Niedrzwica Duża;2145;1117;1117;26;1091;52.07;2.33
87976;060910;Dom Ludowy|Niedrzwica Kościelna|Krakowska 83 |24-220 Niedrzwica Duża;1548;846;846;21;825;54.65;2.48
87977;060910;Szkoła Podstawowa|Sobieszczany| 35 |24-220 Niedrzwica Duża;752;364;364;13;351;48.40;3.57
87978;060910;Szkoła Podstawowa|Strzeszkowice Duże| 255A |24-220 Niedrzwica Duża;840;468;468;16;452;55.71;3.42
87979;060910;Szkoła Podstawowa|Radawczyk| 79 |24-220 Niedrzwica Duża;361;206;206;5;201;57.06;2.43
87980;060910;Zespół Szkół|Krężnica Jara| 321 |20-515 Lublin;1143;655;655;5;650;57.31;0.76
87981;060910;Szkoła Podstawowa|Marianka| 97 |24-220 Niedrzwica Duża;503;201;201;12;189;39.96;5.97
87982;060910;Szkoła Podstawowa|Czółna| 103 |24-220 Niedrzwica Duża;374;173;173;7;166;46.26;4.05
87983;060911;Lokal Szkoły Podstawowej w Ciecierzynie|Ciecierzyn| 121 |21-003 Ciecierzyn;1764;903;903;13;890;51.19;1.44
87984;060911;Lokal Szkoły Podstawowej w Dysie|Dys|Lotników Polskich 4 |21-003 Ciecierzyn;1810;1124;1124;25;1099;62.10;2.22
87985;060911;Lokal Szkoły Podstawowej w Jakubowicach Konińskich|Jakubowice Konińskie|Szkolna 69 |21-003 Ciecierzyn;1668;1135;1135;15;1120;68.05;1.32
87986;060911;Gminny Ośrodek Kultury w Niemcach|Niemce|ul. Różana 10 |21-025 Niemce;2107;1155;1155;33;1122;54.82;2.86
87987;060911;Lokal Świetlicy w Elizówce|Elizówka| 21A |21-003 Ciecierzyn;732;456;456;18;438;62.30;3.95
87988;060911;Lokal Remizy OSP w Nasutowie|Nasutów| 99D |21-025 Niemce;1069;577;577;11;566;53.98;1.91
87989;060911;Lokal Szkoły Podstawowej w Rudce Kozłowieckiej|Rudka Kozłowiecka| 30B |21-025 Niemce;1069;535;535;15;520;50.05;2.80
87990;060911;Lokal Szkoły Podstawowej w Krasieninie-Kolonii|Niemce| 39 |21-025 Niemce;1922;1035;1035;23;1012;53.85;2.22
87991;060911;Urząd Gminy w Niemcach|Niemce|ul. Lubelska 121 |21-025 Niemce;1180;611;611;10;601;51.78;1.64
87992;060911;Lokal Szkoły Podstawowej w Niemcach|Niemce|ul. Szkolna 23 |21-025 Niemce;989;556;556;8;548;56.22;1.44
87993;060911;Lokal Świetlicy w Dziuchowie|Dziuchów| 6A |21-025 Niemce;284;149;149;2;147;52.46;1.34
87994;060912;Publiczna Szkoła Podstawowa|Żabia Wola| 77 |23-107 Strzyżewice;1195;609;609;6;603;50.96;0.99
87995;060912;Publiczna Szkoła Podstawowa|Osmolice Pierwsze| 160 |23-107 Strzyżewice;905;375;375;14;361;41.44;3.73
87996;060912;Zespół Szkół Techniki Rolniczej|Piotrowice| 183 |23-107 Strzyżewice;1012;460;460;16;444;45.45;3.48
87997;060912;Zespół Szkół Publicznych|Bystrzyca Stara| 89 |23-107 Strzyżewice;821;423;423;8;415;51.52;1.89
87998;060912;Urząd Gminy|Strzyżewice| 109 |23-107 Strzyżewice;1098;455;455;13;442;41.44;2.86
87999;060912;Publiczna Szkoła Podstawowa w Strzyżewicach-Rechcie|Strzyżewice| 13 |23-107 Strzyżewice;389;177;177;8;169;45.50;4.52
88000;060912;Publiczna Szkoła Podstawowa|Kiełczewice Górne| 41 |23-107 Strzyżewice;696;322;322;2;320;46.26;0.62
88001;060912;Dom Pomocy Społecznej|Kiełczewice Maryjskie| 86 |23-107 Strzyżewice;51;45;45;0;45;88.24;0.00
88002;060913;Urząd Gminy Wojciechów|Wojciechów| 5 |24-204 Wojciechów;543;238;238;8;230;43.83;3.36
88003;060913;Zespół Szkół Wojciechów|Wojciechów| 8 |24-204 Wojciechów;989;412;412;5;407;41.66;1.21
88004;060913;Szkoła Podstawowa Palikije|Palikije Pierwsze| 85B |24-204 Wojciechów;1217;578;578;20;558;47.49;3.46
88005;060913;Szkoła Podstawowa Miłocin|Miłocin| 7 |24-150 Nałęczów;372;206;206;3;203;55.38;1.46
88006;060913;Publiczna Szkoła Podstawowa Maszki|Maszki| 75 |24-204 Wojciechów;610;279;279;18;261;45.74;6.45
88007;060913;Szkoła Podstawowa Łubki|Łubki| 58 |24-204 Wojciechów;1049;441;441;18;423;42.04;4.08
88008;060914;Szkoła Podstawowa|Łuszczów Drugi| 102 |20-258 Lublin;1217;633;633;26;607;52.01;4.11
88009;060914;Szkoła Podstawowa|Pliszczyn, Kolonia Pliszczyn| 100 |20-258 Lublin;948;502;502;39;463;52.95;7.77
88010;060914;Szkoła Podstawowa|Sobianowice| 32a |20-258 Lublin;340;158;158;3;155;46.47;1.90
88011;060914;Szkoła Podstawowa|Świdnik Mały| 39 |20-258 Lublin;1411;774;774;17;757;54.85;2.20
88012;060914;Urząd Gminy Wólka|Jakubowice Murowane| 8 |20-258 Lublin;868;519;519;12;507;59.79;2.31
88013;060914;budynek po Szkole Podstawowej|Rudnik| 27 |20-258 Lublin;379;231;231;5;226;60.95;2.16
88014;060914;Szkoła Podstawowa|Turka| 294 |20-258 Lublin;1127;592;592;22;570;52.53;3.72
88015;060914;Remiza OSP|Bystrzyca| 93 |20-258 Lublin;343;157;157;6;151;45.77;3.82
88016;060914;Gminna Biblioteka Publiczna - Filia Turka|Turka|ul. Konwaliowa 3 |20-258 Lublin;1855;1134;1134;9;1125;61.13;0.79
88017;060915;Remiza OSP|Antoniówka| 125 |23-145 Wysokie;262;104;104;2;102;39.69;1.92
88018;060915;Remiza OSP|Giełczew Pierwsza| 1 |23-145 Wysokie;954;398;398;8;390;41.72;2.01
88019;060915;Szkoła Podstawowa|Maciejów Stary| 54A |23-145 Wysokie;601;244;244;2;242;40.60;0.82
88020;060915;Remiza OSP|Biskupie| 58 |23-145 Wysokie;290;134;134;4;130;46.21;2.99
88021;060915;Remizo-Świetlica|Nowy Dwór| 23A |23-145 Wysokie;422;212;212;1;211;50.24;0.47
88022;060915;Biblioteka Gminna w Wysokiem|Wysokie|ul. Rynek Jabłonowskich 3 |23-145 Wysokie;1424;613;613;28;585;43.05;4.57
88023;060916;Szkoła Podstawowa w Dębinie, Dębina 20|Dębina| 20 |23-155 Zakrzew;737;359;359;14;345;48.71;3.90
88024;060916;Budynek komunalny nr 51 w Ponikwach|Ponikwy| 51 |23-155 Zakrzew;316;135;135;8;127;42.72;5.93
88025;060916;Gimnazjum w Tarnawce,Tarnawka Pierwsza 175|Tarnawka Pierwsza| 175 |23-155 Zakrzew;464;172;172;3;169;37.07;1.74
88026;060916;Urząd Gminy Zakrzew, Zakrzew 26, świetlica|Zakrzew| 26 |23-155 Zakrzew;1058;452;452;11;441;42.72;2.43
88027;061001;Remiza Ochotniczej Straży Pożarnej|Janowica| 17A |21-070 Cyców;341;146;146;6;140;42.82;4.11
88028;061001;Zespół Szkół w Cycowie|Cyców|ul. Chełmska 44 |21-070 Cyców;778;319;319;11;308;41.00;3.45
88029;061001;Świetlica Wiejska|Barki| 18 |21-070 Cyców;346;124;124;5;119;35.84;4.03
88030;061001;Szkoła Podstawowa|Malinówka| 62 |21-070 Cyców;249;93;93;3;90;37.35;3.23
88031;061001;Remiza Ochotniczej Straży Pożarnej|Nowy Stręczyn| 40A |21-070 Cyców;395;134;134;7;127;33.92;5.22
88032;061001;Szkoła Podstawowa|Bekiesza| 31 |21-070 Cyców;274;57;57;1;56;20.80;1.75
88033;061001;Szkoła Podstawowa|Głębokie| 4 |21-070 Cyców;605;308;308;7;301;50.91;2.27
88034;061001;Świetlica Wiejska|Garbatówka| 7 |21-070 Cyców;400;168;168;6;162;42.00;3.57
88035;061001;Świetlica Wiejska|Kopina| 60 |21-070 Cyców;346;140;140;4;136;40.46;2.86
88036;061001;Remiza Ochotniczej Straży Pożarnej|Świerszczów| 26 |21-070 Cyców;610;227;227;9;218;37.21;3.96
88037;061001;Zespół Szkół w Cycowie|Cyców|Chełmska 44 |21-070 Cyców;1417;710;710;30;680;50.11;4.23
88038;061001;Szkoła Podstawowa|Stawek| 5 |21-070 Cyców;418;167;167;15;152;39.95;8.98
88039;061002;Hala sportowo - widowiskowa|Ludwin-Kolonia| 20A |21-075 Ludwin;971;474;474;22;452;48.82;4.64
88040;061002;Szkoła Podstawowa w Zezulinie|Zezulin Niższy| 70 |21-075 Ludwin;845;419;419;18;401;49.59;4.30
88041;061002;Szkoła Podstawowa w Piasecznie|Piaseczno| 33 |21-075 Ludwin;777;303;303;10;293;39.00;3.30
88042;061002;Szkoła Podstawowa w Dratowie|Dratów| 84 |21-075 Ludwin;910;361;361;16;345;39.67;4.43
88043;061002;Remiza OSP w Kaniwoli|Kaniwola| 76 |21-075 Ludwin;677;273;273;26;247;40.32;9.52
88044;061003;Ośrodek Rewalidacyjno-Wychowawczy|Łęczna|Litewska 16 |21-010 Łęczna;1467;700;700;24;676;47.72;3.43
88045;061003;Szkoła Podstawowa|Zofiówka| 85 |21-010 Łęczna;831;436;436;13;423;52.47;2.98
88046;061003;Szkoła Podstawowa|Ciechanki Łęczyńskie| 13 |21-010 Łęczna;931;408;408;11;397;43.82;2.70
88047;061003;Sala konferencyjna Urzędu Miejskiego|Łęczna|Plac Kościuszki 22 |21-010 Łęczna;1144;559;559;23;536;48.86;4.11
88048;061003;Gimnazjum Nr 1|Łęczna|Marszałka Piłsudskiego 12 |21-010 Łęczna;909;573;573;2;571;63.04;0.35
88049;061003;Osiedlowy Dom Kultury|Łęczna|Górnicza 12 |21-010 Łęczna;1410;702;702;16;686;49.79;2.28
88050;061003;Szkoła Podstawowa Nr 2|Łęczna|Szkolna 3 |21-010 Łęczna;1255;687;687;17;670;54.74;2.47
88051;061003;Szkoła Podstawowa Nr 2|Łęczna|Szkolna 3 |21-010 Łęczna;1452;806;806;11;795;55.51;1.36
88052;061003;Szkoła Podstawowa Nr 2 - nauczanie zintegrowane|Łęczna|Staszica 17 |21-010 Łęczna;1350;679;679;16;663;50.30;2.36
88053;061003;Centrum Kultury|Łęczna|Obrońców Pokoju 1 |21-010 Łęczna;1127;611;611;11;600;54.21;1.80
88054;061003;Biblioteka|Łęczna|Obrońców Pokoju 1 |21-010 Łęczna;1649;911;911;17;894;55.25;1.87
88055;061003;Budynek szkoły|Łęczna|Bogdanowicza 9 |21-010 Łęczna;1474;843;843;16;827;57.19;1.90
88056;061003;Zespół Szkół nr 2|Łęczna|Jaśminowa 6 |21-010 Łęczna;1004;538;538;16;522;53.59;2.97
88057;061003;Zespół Szkół nr 2|Łęczna|Jaśminowa 6 |21-010 Łęczna;1308;717;717;27;690;54.82;3.77
88058;061003;Zespół Szkół nr 2|Łęczna|Jaśminowa 6 |21-010 Łęczna;1510;784;784;25;759;51.92;3.19
88059;061003;Szpital Powiatowy|Łęczna|Krasnystawska 52 |21-010 Łęczna;97;39;39;3;36;40.21;7.69
88060;061004;Szkoła Podstawowa|Łańcuchów| 20 |21-020 Milejów;568;241;241;12;229;42.43;4.98
88061;061004;Środowiskowy Dom Samopomocy|Antoniów| 48 |21-020 Milejów;667;232;232;9;223;34.78;3.88
88062;061004;Zespół Szkół Nr 2 Liceum Ogólnokształcące|Milejów-Osada|Partyzancka 62 |21-020 Milejów;1399;587;587;19;568;41.96;3.24
88063;061004;Urząd Gminy|Milejów-Osada|Partyzancka 13a |21-020 Milejów;1382;635;635;16;619;45.95;2.52
88064;061004;Zespół Szkół Nr 2 Szkoła Podstawowa|Jaszczów| 24 |21-020 Milejów;958;410;411;9;401;42.80;2.20
88065;061004;Szkoła Podstawowa|Białka| 122 |21-020 Milejów;542;182;182;16;166;33.58;8.79
88066;061004;Szkoła Podstawowa|Łysołaje| 120 |21-020 Milejów;900;366;366;15;351;40.67;4.10
88067;061004;Remiza OSP|Starościce| 31 |21-020 Milejów;379;134;134;9;125;35.36;6.72
88068;061004;Budynek po byłej szkole|Maryniów| 11a |21-020 Milejów;550;169;169;11;158;30.73;6.51
88069;061005;Szkoła Podstawowa|Ostrówek| 154 |21-013 Puchaczów;940;487;487;11;476;51.81;2.26
88070;061005;Szkoła Podstawowa|Zawadów| 158 |21-013 Puchaczów;552;259;259;3;256;46.92;1.16
88071;061005;Szkoła Podstawowa|Nadrybie-Dwór| 88 |21-013 Puchaczów;631;308;308;12;296;48.81;3.90
88072;061005;Szkoła Podstawowa|Puchaczów|Mickiewicza 19 |21-013 Puchaczów;876;462;462;6;456;52.74;1.30
88073;061005;Szkoła Podstawowa|Puchaczów|Mickiewicza 19 |21-013 Puchaczów;733;389;389;6;383;53.07;1.54
88074;061005;Szkoła Podstawowa|Albertów| 69 |21-013 Puchaczów;589;263;263;10;253;44.65;3.80
88075;061006;Gimnazjum|Spiczyn| 8 |21-077 Spiczyn;1258;649;649;15;634;51.59;2.31
88076;061006;Szkoła Podstawowa|Charlęż-Kolonia| 17 |21-077 Spiczyn;607;246;246;10;236;40.53;4.07
88077;061006;Szkoła Podstawowa|Jawidz| 109B |21-077 Spiczyn;1078;454;454;16;438;42.12;3.52
88078;061006;Szkoła Podstawowa|Zawieprzyce| 121 |21-077 Spiczyn;643;241;241;11;230;37.48;4.56
88079;061006;Szkoła Podstawowa|Januszówka| 33A |21-077 Spiczyn;755;318;318;7;311;42.12;2.20
88080;061101;Przedszkole Miejskie nr 2|Łuków|ul. Piłsudskiego 18 |21-400 Łuków;849;401;401;9;392;47.23;2.24
88081;061101;Gimnazjum nr 3|Łuków|ul. Konarskiego 3 |21-400 Łuków;1219;508;508;11;497;41.67;2.17
88082;061101;Szkoła Podstawowa nr 5|Łuków|ul. Siedlecka 56 |21-400 Łuków;1316;747;747;5;742;56.76;0.67
88083;061101;Szkoła Podstawowa nr 5|Łuków|ul. Siedlecka 56 |21-400 Łuków;1282;692;692;9;683;53.98;1.30
88084;061101;Przedszkole Integracyjne nr 1|Łuków|Al.T.Kościuszki 21B |21-400 Łuków;1022;586;586;18;568;57.34;3.07
88085;061101;Agencja Restrukturyzacji i Modernizacji Rolnictwa Biuro Powiatowe|Łuków|ul. Przemysłowa 15 |21-400 Łuków;954;535;535;9;526;56.08;1.68
88086;061101;Urząd Miasta Łuków|Łuków|ul. Piłsudskiego 17 |21-400 Łuków;1433;864;864;20;844;60.29;2.31
88087;061101;Zespół Szkół nr 1|Łuków|Al.T.Kościuszki 10 |21-400 Łuków;1300;704;704;15;689;54.15;2.13
88088;061101;Zespół Szkół nr 1 z oddziałami integracyjnymi|Łuków|ul. 11 Listopada 20 |21-400 Łuków;1395;746;746;22;724;53.48;2.95
88089;061101;Zespół Szkół nr 1 z oddziałami integracyjnymi|Łuków|ul. 11 Listopada 20 |21-400 Łuków;957;549;549;13;536;57.37;2.37
88090;061101;Łukowski Ośrodek Kultury|Łuków|ul. Kardynała Wyszyńskiego 20 |21-400 Łuków;1013;509;509;13;496;50.25;2.55
88091;061101;Powiatowy Urząd Pracy|Łuków|ul. Piłsudskiego 14 |21-400 Łuków;1026;477;477;18;459;46.49;3.77
88092;061101;Zespół Szkół nr 2|Łuków|ul. Warszawska 88 |21-400 Łuków;1218;580;580;18;562;47.62;3.10
88093;061101;Zakład Gospodarki Lokalowej|Łuków|ul. Warszawska 24 |21-400 Łuków;988;569;569;16;553;57.59;2.81
88094;061101;Medyczne Studium Zawodowe|Łuków|ul. Kryńskiego 10 |21-400 Łuków;926;519;519;9;510;56.05;1.73
88095;061101;Zespół Szkolno-Przedszkolny|Łuków|ul. Partyzantów 15 |21-400 Łuków;1092;644;644;1;643;58.97;0.16
88096;061101;Przedsiębiorstwo Usług i Inżynierii Komunalnej|Łuków|ul. Partyzantów 6b |21-400 Łuków;902;510;510;4;506;56.54;0.78
88097;061101;Gimnazjum nr 2|Łuków|ul. Cieszkowizna 13 |21-400 Łuków;1127;585;585;17;568;51.91;2.91
88098;061101;Przedsiębiorstwo Energetyki Cieplnej|Łuków|ul. Świderska 42 |21-400 Łuków;1338;738;738;11;727;55.16;1.49
88099;061101;Zespół Szkolno-Przedszkolny|Łuków|ul. Stasia i Nel 2 |21-400 Łuków;1195;692;692;10;682;57.91;1.45
88100;061101;Zespół Szkolno-Przedszkolny|Łuków|ul. Stasia i Nel 2 |21-400 Łuków;1274;680;680;21;659;53.38;3.09
88101;061101;Samodzielny Publiczny Zakład Opieki Zdrowotnej w Łukowie|Łuków|A. Rogalińskiego 3 |21-400 Łuków;116;56;56;6;50;48.28;10.71
88102;061102;Urząd Miasta|Stoczek Łukowski|Pl.T.Kościuszki 1 |21-450 Stoczek Łukowski;1306;653;653;26;627;50.00;3.98
88103;061102;Zespół Oświatowy w Stoczku Łukowskim|Stoczek Łukowski|Plac Wielgoska Stanisława 5 |21-450 Stoczek Łukowski;851;456;456;7;449;53.58;1.54
88104;061103;Szkoła Podstawowa w Adamowie|Adamów|Szkolna 4A |21-412 Adamów;1800;946;946;21;925;52.56;2.22
88105;061103;Dom Kultury w Woli Gułowskiej|Wola Gułowska| 68 |21-481 Wola Gułowska;1332;617;617;31;586;46.32;5.02
88106;061103;Świetlica wiejska w Gułowie|Gułów| 48A |21-412 Adamów;388;163;163;6;157;42.01;3.68
88107;061103;Szkoła Podstawowa w Zakępiu|Zakępie| 17A |21-412 Adamów;308;143;143;6;137;46.43;4.20
88108;061103;Świetlica wiejska w Lipinach|Lipiny| 44 |21-412 Adamów;211;95;95;6;89;45.02;6.32
88109;061103;Budynek komunalny Hordzieżka Nr 60|Hordzieżka| 60 |21-412 Adamów;307;131;131;13;118;42.67;9.92
88110;061103;Świetlica wiejska w Żurawcu|Żurawiec| 19 |21-412 Adamów;294;134;134;4;130;45.58;2.99
88111;061104;Zespół Szkół w Okrzei|Okrzeja|ul. Szkolna 2 |21-480 Okrzeja;1225;487;487;21;466;39.76;4.31
88112;061104;Zespół Szkół w Woli Okrzejskiej|Wola Okrzejska| 105A |21-480 Okrzeja;706;246;246;16;230;34.84;6.50
88113;061104;Zespół Szkół w Hucie Dąbrowie|Huta-Dąbrowa|ul. Hutnicza 30 |21-470 Krzywda;1682;672;672;15;657;39.95;2.23
88114;061104;Zespół Szkół w Radoryżu Smolanym|Radoryż Smolany| 26 |21-470 Krzywda;930;365;365;16;349;39.25;4.38
88115;061104;Zespół Szkół w Fiukówce|Fiukówka| 9 |21-470 Krzywda;781;295;295;18;277;37.77;6.10
88116;061104;Zespół Szkół w Krzywdzie|Krzywda|ul. Osiedlowa 5 |21-470 Krzywda;1747;759;759;26;733;43.45;3.43
88117;061104;Świetlica Wiejska w Szczałbie|Szczałb| 8 |21-470 Krzywda;535;213;213;10;203;39.81;4.69
88118;061104;Gimnazjum w Radoryżu Kościelnym|Radoryż Kościelny| 42 |21-470 Krzywda;623;214;214;5;209;34.35;2.34
88119;061105;Szkoła Podstawowa w Aleksandrowie|Aleksandrów| 54 |21-400 Łuków;507;241;241;9;232;47.53;3.73
88120;061105;Zespół Szkół w Dąbiu|Dąbie| 83C |21-400 Łuków;1017;439;439;21;418;43.17;4.78
88121;061105;Zespół Szkół w Gołąbkach|Gołąbki| 33 |21-400 Łuków;991;533;533;11;522;53.78;2.06
88122;061105;Zespół Szkół w Gręzówce|Gręzówka| 41 |21-400 Łuków;1796;848;848;32;816;47.22;3.77
88123;061105;Zespół Szkół w Krynce|Krynka| 250 |21-400 Łuków;1084;553;553;15;538;51.01;2.71
88124;061105;Zespół Szkół w Gołaszynie|Gołaszyn| 29 |21-400 Łuków;781;386;386;9;377;49.42;2.33
88125;061105;Przedszkole w Łazach|Łazy| 383 |21-400 Łuków;946;484;484;16;468;51.16;3.31
88126;061105;Szkoła Filialna w Turzych Rogach|Turze Rogi| 50 |21-400 Łuków;416;205;205;14;191;49.28;6.83
88127;061105;Zespół Szkół w Czerśli|Czerśl| 1 |21-400 Łuków;941;455;455;13;442;48.35;2.86
88128;061105;Zespół Szkół w Strzyżewie|Strzyżew| 128 |21-400 Łuków;587;241;241;18;223;41.06;7.47
88129;061105;Zespół Szkół w Świdrach|Świdry| 99 |21-400 Łuków;1007;528;528;32;496;52.43;6.06
88130;061105;Zespół Szkół w Rolach|Role| 114 |21-400 Łuków;814;333;333;12;321;40.91;3.60
88131;061105;Zespół Szkół w Zalesiu|Zalesie| 141 |21-400 Łuków;1476;748;748;32;716;50.68;4.28
88132;061105;Zespół Szkolno-Przedszkolny w Zarzeczu Łukowskim|Zarzecz Łukowski| 54 |21-400 Łuków;426;173;173;8;165;40.61;4.62
88133;061105;Świetlica w Sulejach|Suleje| 54 |21-400 Łuków;614;361;361;14;347;58.79;3.88
88134;061105;Dom Pomocy Społecznej w Ryżkach|Ryżki| 75 |21-400 Łuków;41;12;12;2;10;29.27;16.67
88135;061106;Świetlica w Charlejowie|Charlejów| 57 |21-413 Serokomla;409;182;182;6;176;44.50;3.30
88136;061106;Szkoła Podstawowa w Krzówce|Krzówka| 37 |21-413 Serokomla;377;166;166;5;161;44.03;3.01
88137;061106;Budynek byłej Szkoły Podstawowej|Wola Bukowska| 40 |21-413 Serokomla;424;143;143;9;134;33.73;6.29
88138;061106;Zespół Szkół w Serokomli|Serokomla|ul. Warszawska 28 |21-413 Serokomla;1215;566;566;22;544;46.58;3.89
88139;061106;Zespół Szkół w Serokomli|Serokomla|ul. Warszawska 28 |21-413 Serokomla;901;399;399;21;378;44.28;5.26
88140;061107;Centrum Spoleczno-Kulturalne w Staninie|Stanin| 105 |21-422 Stanin;1859;923;923;29;894;49.65;3.14
88141;061107;Centrum Społeczno-Kulturalne w Tuchowiczu|Tuchowicz| 47A |21-421 Tuchowicz;1421;694;694;28;666;48.84;4.03
88142;061107;Zespół Szkół w Zagoździu|Lipniak| 5 |21-421 Tuchowicz;866;430;430;19;411;49.65;4.42
88143;061107;Szkoła Podstawowa w Zastawiu|Zastawie| 9 |21-421 Tuchowicz;767;316;316;26;290;41.20;8.23
88144;061107;Zespół Szkół w Jeleńcu|Jeleniec| 45 |21-421 Tuchowicz;420;219;219;18;201;52.14;8.22
88145;061107;Budynek byłej Szkoły Podstawowej we Wnętrznem|Wnętrzne| 35A |21-421 Tuchowicz;316;125;125;2;123;39.56;1.60
88146;061107;Szkoła Podstawowa w Sarnowie|Sarnów| 19B |21-421 Tuchowicz;932;482;482;28;454;51.72;5.81
88147;061107;Budynek Wiejski w Kopinie|Kopina| 41A |21-421 Tuchowicz;517;234;234;13;221;45.26;5.56
88148;061107;Szkoła Podstawowa w Jonniku|Jonnik| 20 |21-421 Tuchowicz;561;215;215;8;207;38.32;3.72
88149;061108;Urząd Gminy w Stoczku Łukowskim|Stoczek Łukowski|Plac T. Kościuszki 1 |21-450 Stoczek Łukowski;679;313;313;10;303;46.10;3.19
88150;061108;Zespół Oświatowy w Jedlance|Jedlanka|ul. Warszawska 13 |21-450 Stoczek Łukowski;557;300;300;10;290;53.86;3.33
88151;061108;Szkoła Podstawowa w Kamionce|Kamionka| 24 |21-450 Stoczek Łukowski;471;204;204;5;199;43.31;2.45
88152;061108;Zespół Oświatowy w Kisielsku|Kisielsk| 84 |21-450 Stoczek Łukowski;705;316;316;4;312;44.82;1.27
88153;061108;Zespół Oświatowy w Starej Prawdzie|Stara Prawda| 1 |21-450 Stoczek Łukowski;1018;473;473;13;460;46.46;2.75
88154;061108;Szkoła Filialna w Toczyskach|Toczyska| 101 |21-450 Stoczek Łukowski;439;178;178;6;172;40.55;3.37
88155;061108;Zespół Oświatowy w Starej Róży|Stara Róża| 35 |21-450 Stoczek Łukowski;694;297;297;20;277;42.80;6.73
88156;061108;Zespół Oświatowy w Starych Kobiałkach|Stare Kobiałki| 18 |21-450 Stoczek Łukowski;1262;572;572;12;560;45.32;2.10
88157;061108;Remiza OSP w Jamielnem|Jamielne| 37 |21-450 Stoczek Łukowski;346;135;135;3;132;39.02;2.22
88158;061108;Zespół Oświatowy w Szyszkach|Szyszki| 66 |21-450 Stoczek Łukowski;368;146;146;8;138;39.67;5.48
88159;061109;Publiczne Gimnazjum w Trzebieszowie|Trzebieszów Drugi| 94A |21-404 Trzebieszów;1155;551;551;18;533;47.71;3.27
88160;061109;Szkoła Podstawowa w Mikłusach|Mikłusy| 37 |21-404 Trzebieszów;707;388;388;7;381;54.88;1.80
88161;061109;Szkoła Podstawowa w Celinach|Celiny| 86 |21-404 Trzebieszów;756;384;384;7;377;50.79;1.82
88162;061109;Szkoła Podstawowa w Dębowicy|Dębowica| 70 |21-404 Trzebieszów;726;387;387;12;375;53.31;3.10
88163;061109;Szkoła Podstawowa w Szaniawach|Szaniawy-Matysy| 4 |21-404 Trzebieszów;893;483;483;21;462;54.09;4.35
88164;061109;Gminny Ośrodek Kultury i Wypoczynku w Trzebieszowie|Trzebieszów Drugi| 31 |21-404 Trzebieszów;1162;618;618;12;606;53.18;1.94
88165;061109;Szkoła Podstawowa w Jakuszach|Jakusze| 56 |21-404 Trzebieszów;481;276;276;5;271;57.38;1.81
88166;061110;Szkoła Podstawowa w Wólce Domaszewskiej|Wólka Domaszewska| 17 |21-411 Wojcieszków;997;413;413;11;402;41.42;2.66
88167;061110;Świetlica w Burcu|Burzec| 125 |21-411 Wojcieszków;542;196;196;13;183;36.16;6.63
88168;061110;Szkoła Podstawowa w Woli Bystrzyckiej|Wola Bystrzycka| 84 |21-411 Wojcieszków;390;170;170;8;162;43.59;4.71
88169;061110;Szkoła Podstawowa w Oszczepalinie Drugim|Oszczepalin Drugi| 31 |21-411 Wojcieszków;585;200;200;13;187;34.19;6.50
88170;061110;Urząd Gminy Wojcieszków|Wojcieszków|ul. Kościelna 38 |21-411 Wojcieszków;1215;511;511;21;490;42.06;4.11
88171;061110;Świetlica w Wojcieszkowie|Wojcieszków|Kościelna 38 |21-411 Wojcieszków;1032;459;459;21;438;44.48;4.58
88172;061110;Szkoła Podstawowa w Siedliskach|Siedliska| 78 |21-411 Wojcieszków;408;153;153;2;151;37.50;1.31
88173;061110;Szkoła Podstawowa w Hermanowie|Hermanów| 12 |21-411 Wojcieszków;368;174;174;2;172;47.28;1.15
88174;061111;Szkoła Podstawowa w Jarczewie|Jarczew| 55 |21-426 Wola Mysłowska;836;413;413;14;399;49.40;3.39
88175;061111;Szkoła Podstawowa w Lisikierzu|Lisikierz| 22a |21-426 Wola Mysłowska;1142;478;478;19;459;41.86;3.97
88176;061111;Szkoła Podstawowa w Wandowie|Wandów| 75 |21-426 Wola Mysłowska;1120;452;452;20;432;40.36;4.42
88177;061111;Sala Konferencyjna Urzędu Gminy w Woli Mysłowskiej|Wola Mysłowska| 57 |21-426 Wola Mysłowska;906;340;340;10;330;37.53;2.94
88178;061201;Publiczne Gimnazjum im. Jana Pawła II Chodel|Chodel|ul. Józefa Piłsudskiego 1 |24-350 Chodel;1124;606;606;25;581;53.91;4.13
88179;061201;Osiny|Osiny| 14 |24-350 Chodel;404;169;169;5;164;41.83;2.96
88180;061201;Gminny Ośrodek Kultury Chodel|Chodel|ul. Rynek 45 |24-350 Chodel;1195;430;430;22;408;35.98;5.12
88181;061201;Godów|Godów| 106 |24-350 Chodel;1088;580;580;11;569;53.31;1.90
88182;061201;Zespół Szkół|Ratoszyn Drugi| 192 |24-350 Chodel;1480;576;576;27;549;38.92;4.69
88183;061202;Zespół Szkół Ogólnokształcących|Józefów nad Wisłą|Opolska 10a |24-340 Józefów nad Wisłą;2043;856;856;21;835;41.90;2.45
88184;061202;Szkoła Podstawowa|Chruślina| 108 |24-340 Józefów nad Wisłą;758;239;239;11;228;31.53;4.60
88185;061202;Szkoła Podstawowa|Stare Boiska| 33 |24-340 Józefów nad Wisłą;1195;489;489;34;455;40.92;6.95
88186;061202;Środowiskowy Dom Samopomocy w Prawnie|Prawno| 21 |24-340 Józefów nad Wisłą;771;257;257;44;213;33.33;17.12
88187;061202;Remiza OSP|Basonia| 97 |24-340 Józefów nad Wisłą;396;116;116;5;111;29.29;4.31
88188;061202;Remiza OSP|Kaliszany-Kolonia| 50a |24-340 Józefów nad Wisłą;362;121;121;0;121;33.43;0.00
88189;061203;Lokal Szkoły Podstawowej w Karczmiskach Pierwszych|Karczmiska Pierwsze|ul. Szkolna 1 |24-310 Karczmiska;1457;632;632;27;605;43.38;4.27
88190;061203;Lokal Urzędu Gminy w Karczmiskach|Karczmiska Pierwsze|Centralna 17 |24-310 Karczmiska;946;366;366;9;357;38.69;2.46
88191;061203;Lokal Szkoły Podstawowej w Głusku Dużym Kolonia|Głusko Duże-Kolonia| 54 |24-310 Karczmiska;1004;405;406;12;393;40.34;2.96
88192;061203;Lokal Szkoły Podstawowej w Słotwinach|Słotwiny| 125 |24-310 Karczmiska;406;153;153;3;150;37.68;1.96
88193;061203;Lokal Strażnicy OSP w Zaborzu|Zaborze| 25 |24-310 Karczmiska;417;149;149;10;139;35.73;6.71
88194;061203;Lokal Szkoły Podstawowej w Uściążu|Uściąż| 113 |24-120 Kazimierz Dolny;524;168;168;4;164;32.06;2.38
88195;061204;Szkoła Podstawowa Braciejowicach|Braciejowice| 137 |24-335 Łaziska;612;268;268;11;257;43.79;4.10
88196;061204;Gimnazjum im. Jana Kochanowskiego w Łaziskach|Łaziska| 79 |24-335 Łaziska;1100;443;443;26;417;40.27;5.87
88197;061204;Szkoła Podstawowa w Kamieniu|Piotrawin| 116 |24-335 Łaziska;837;290;290;8;282;34.65;2.76
88198;061204;Remiza Ochotniczej Straży Pożarnej w Niedźwiadzie Dużej|Niedźwiada Duża| 25A |24-335 Łaziska;643;238;238;12;226;37.01;5.04
88199;061204;Szkoła Podstawowa w Zakrzowie|Zakrzów| 25A |24-335 Łaziska;541;223;223;6;217;41.22;2.69
88200;061204;Remiza Ochotniczej Straży Pożarnej w Kępie Gosteckiej|Kępa Gostecka| 56 |24-335 Łaziska;329;116;116;6;110;35.26;5.17
88201;061205;lokal kina|Opole Lubelskie|ul. Lubelska 30 |24-300 Opole Lubelskie;1799;892;892;25;867;49.58;2.80
88202;061205;lokal Spółdzielni Mieszkaniowej|Opole Lubelskie|ul. 25-lecia PRL 3 |24-300 Opole Lubelskie;1878;947;947;22;925;50.43;2.32
88203;061205;lokal Zespołu Szkół Nr 2|Opole Lubelskie|ul. Fabryczna 28 |24-300 Opole Lubelskie;2041;905;905;15;890;44.34;1.66
88204;061205;lokal M-G Biblioteki Publicznej|Opole Lubelskie|ul. Stary Rynek 46 |24-300 Opole Lubelskie;1194;496;496;11;485;41.54;2.22
88205;061205;lokal Zespołu Szkół Nr 1|Opole Lubelskie|ul. Szkolna 5 |24-300 Opole Lubelskie;1051;442;442;10;432;42.06;2.26
88206;061205;lokal OSP|Wrzelowiec|ul. Długa 4 |24-300 Opole Lubelskie;885;342;342;18;324;38.64;5.26
88207;061205;lokal Szkoły Podstawowej|Wandalin| 71 |24-300 Opole Lubelskie;834;385;385;8;377;46.16;2.08
88208;061205;lokal świetlicy wiejskiej|Trzebiesza| 1 |24-320 Poniatowa;809;254;254;11;243;31.40;4.33
88209;061205;lokal Szkoły Podstawowej|Stare Komaszyce| 43 |24-300 Opole Lubelskie;480;190;190;4;186;39.58;2.11
88210;061205;lokal Zespołu Szkół|Kluczkowice| 128 |24-300 Opole Lubelskie;634;219;219;9;210;34.54;4.11
88211;061205;lokal Szkoły Podstawowej|Puszno Godowskie| 99 |24-300 Opole Lubelskie;436;194;194;12;182;44.50;6.19
88212;061205;lokal świetlicy wiejskiej|Emilcin| 1 |24-300 Opole Lubelskie;460;165;165;5;160;35.87;3.03
88213;061205;lokal Szkoły Podstawowej|Skoków| 84 |24-300 Opole Lubelskie;598;173;173;2;171;28.93;1.16
88214;061205;lokal Zespołu Szkół|Ćwiętalka| 2a |24-300 Opole Lubelskie;346;134;134;4;130;38.73;2.99
88215;061205;lokal Szkoły Podstawowej|Niezdów| 97 |24-300 Opole Lubelskie;487;195;195;8;187;40.04;4.10
88216;061205;lokal świetlicy wiejskiej|Elżbieta| 45 |24-300 Opole Lubelskie;350;137;137;6;131;39.14;4.38
88217;061205;Zakład Karny w Opolu Lubelskim - sala lekcyjna w budynku Zespołu Szkół|Opole Lubelskie|Owocowa 7 |24-300 Opole Lubelskie;538;241;241;48;193;44.80;19.92
88218;061205;Świetlica szpitalna|Opole Lubelskie|Szpitalna 9 |24-300 Opole Lubelskie;52;4;4;0;4;7.69;0.00
88219;061206;Gimnazjum|Poniatowa|ul. Szkolna 8 |24-320 Poniatowa;1640;814;814;13;801;49.63;1.60
88220;061206;Szkoła Podstawowa|Poniatowa|ul. Szkolna 9 |24-320 Poniatowa;1553;764;764;16;748;49.20;2.09
88221;061206;Świetlica PSM|Poniatowa|ul. 1 Maja 15 |24-320 Poniatowa;983;469;469;19;450;47.71;4.05
88222;061206;Przedsiębiorstwo Gospodarki Komunalnej|Poniatowa|ul. Młodzieżowa 4 |24-320 Poniatowa;1229;565;565;11;554;45.97;1.95
88223;061206;Centrum Kultury Promocji i Turystyki|Poniatowa|ul. Fabryczna 1 |24-320 Poniatowa;1088;457;457;12;445;42.00;2.63
88224;061206;Świetlica PSM Nasz Dom|Poniatowa|ul. Sosnowa 4 |24-320 Poniatowa;1257;585;585;15;570;46.54;2.56
88225;061206;Szkoła Podstawowa|Niezabitów| 46 |24-320 Poniatowa;945;417;417;18;399;44.13;4.32
88226;061206;Szkoła Podstawowa|Kowala Druga| 29 |24-320 Poniatowa;875;383;383;12;371;43.77;3.13
88227;061206;Szkoła Podstawowa|Kraczewice Prywatne| 78 |24-320 Poniatowa;1016;497;497;19;478;48.92;3.82
88228;061206;Szkoła Podstawowa|Poniatowa-Kolonia| 13 |24-320 Poniatowa;775;308;308;8;300;39.74;2.60
88229;061206;Społeczna Szkoła Podstawowa|Dąbrowa Wronowska| 41 |24-320 Poniatowa;507;227;227;11;216;44.77;4.85
88230;061206;Powiatowe Centrum Zdrowia Sp. z o.o. w Opolu Lubelskim|Poniatowa|Fabryczna 18 |24-320 Poniatowa;89;27;27;2;25;30.34;7.41
88231;061206;Samodzielne Publiczne Sanatorium Gruźlicy i Chorób Płuc w Poniatowej|Poniatowa|Fabryczna 6 |24-320 Poniatowa;46;12;12;3;9;26.09;25.00
88232;061207;Lokal Zespołu Szkół Publicznych w Wilkowie|Wilków| 66A |24-313 Wilków;1034;414;414;23;391;40.04;5.56
88233;061207;Lokal byłej Szkoły Podstawowej|Dobre| 13 |24-313 Wilków;289;130;130;3;127;44.98;2.31
88234;061207;Lokal Szkoły Podstawowej w Rogowie|Rogów| 92 |24-313 Wilków;415;181;181;6;175;43.61;3.31
88235;061207;Lokal Szkoły Podstawowej w Zagłobie|Zagłoba| 21 |24-313 Wilków;695;263;263;17;246;37.84;6.46
88236;061207;Świetlica Wiejska w Kępie Choteckiej|Kępa Chotecka| 7A |24-313 Wilków;196;84;84;1;83;42.86;1.19
88237;061207;Świetlica Wiejska w Zastowie Polanowskim|Zastów Polanowski| 60 |24-313 Wilków;476;170;170;6;164;35.71;3.53
88238;061207;Remiza Ochotniczej Straży Pożarnej w Kosiorowie|Kosiorów| 36 |24-313 Wilków;396;158;158;7;151;39.90;4.43
88239;061207;Remiza Ochotniczej Straży Pożarnej w Wólce Polanowskiej|Wólka Polanowska| 86 |24-313 Wilków;306;153;153;1;152;50.00;0.65
88240;061301;Gminny Ośrodek Kultury w Dębowej Kłodzie|Dębowa Kłoda| 116A |21-211 Dębowa Kłoda;1298;519;519;19;500;39.98;3.66
88241;061301;Szkoła Podstawowa w Kodeńcu|Kodeniec| 71 |21-211 Dębowa Kłoda;1027;328;328;12;316;31.94;3.66
88242;061301;Świetlica Wiejska w Plebaniej Woli|Plebania Wola| 50 |21-211 Dębowa Kłoda;614;224;224;7;217;36.48;3.12
88243;061301;Świetlica Wiejska w Chmielowie|Chmielów| 61 |21-211 Dębowa Kłoda;353;164;164;5;159;46.46;3.05
88244;061302;Gminna Biblioteka Publiczna w Jabłoniu|Jabłoń|ul. Jadwigi Tokarskiej 2 3|21-205 Jabłoń;1101;541;541;17;524;49.14;3.14
88245;061302;Szkoła Podstawowa w Gęsi|Gęś| 165 |21-205 Jabłoń;572;302;302;8;294;52.80;2.65
88246;061302;Szkoła Podstawowa im. Amelii hr. Łubieńskiej w Kolanie|Kolano-Kolonia| 44 |21-205 Jabłoń;438;222;222;5;217;50.68;2.25
88247;061302;Szkoła Podstawowa w Paszenkach|Paszenki| 78 |21-205 Jabłoń;393;194;194;5;189;49.36;2.58
88248;061302;Dom Pomocy Społecznej w Kalince|Kalinka| 12-13 |21-205 Jabłoń;282;78;78;5;73;27.66;6.41
88249;061302;Szkoła Podstawowa w Dawidach|Dawidy| 56 |21-205 Jabłoń;337;242;242;6;236;71.81;2.48
88250;061303;Gminny Ośrodek Kultury w Milanowie|Milanów|ul. Kościelna 3 |21-210 Milanów;1159;488;488;21;467;42.11;4.30
88251;061303;Szkoła Podstawowa w Rudnie|Rudno II| 129 B |21-210 Milanów;631;297;297;13;284;47.07;4.38
88252;061303;Szkoła Podstawowa w Kostrach|Kostry| 1 |21-210 Milanów;588;244;244;6;238;41.50;2.46
88253;061303;Publiczna "Mała Szkoła Podstawowa" w Radczu|Radcze| 88 |21-210 Milanów;483;252;252;11;241;52.17;4.37
88254;061303;Świetlica Wiejska w Cichostowie|Cichostów Kolonia|Cichostów Kolonia 19A |21-210 Milanów;350;140;140;4;136;40.00;2.86
88255;061304;Szkoła Podstawowa Nr 1 w Parczewie|Parczew|ul. 11 Listopada 90 |21-200 Parczew;1911;980;980;20;960;51.28;2.04
88256;061304;Publiczne Gimnazjum w Parczewie|Parczew|ul. Spółdzielcza 7 |21-200 Parczew;1728;884;884;14;870;51.16;1.58
88257;061304;Publiczne Przedszkole Nr 2 w Parczewie|Parczew|ul. Spółdzielcza 5 |21-200 Parczew;755;297;297;14;283;39.34;4.71
88258;061304;Urząd Miejski w Parczewie|Parczew|ul. Warszawska 24 |21-200 Parczew;737;323;323;13;310;43.83;4.02
88259;061304;Zespół Szkół Ponadgimnazjalnych w Parczewie|Parczew|ul. Wojska Polskiego 1 |21-200 Parczew;1767;836;836;21;815;47.31;2.51
88260;061304;Publiczne Przedszkole Nr 1 w Parczewie|Parczew|ul. Wojska Polskiego 8a |21-200 Parczew;598;241;241;6;235;40.30;2.49
88261;061304;Zakład Doskonalenia Zawodowego w Parczewie|Parczew|ul. Harcerska 8 |21-200 Parczew;1752;844;844;20;824;48.17;2.37
88262;061304;Szkoła Podstawowa Nr 2 w Parczewie|Parczew|ul. Polna 34 |21-200 Parczew;973;498;498;5;493;51.18;1.00
88263;061304;Remiza Strażacka w Koczergach|Koczergi| 97 |21-200 Parczew;675;271;271;9;262;40.15;3.32
88264;061304;Publiczna Szkoła Podstawowa w Tyśmienicy|Tyśmienica| 115 |21-200 Parczew;616;224;224;8;216;36.36;3.57
88265;061304;Zespół Placówek Szkolnych w Przewłoce|Przewłoka| 98 |21-200 Parczew;622;256;256;3;253;41.16;1.17
88266;061304;Samodzielny Publiczny Zakład Opieki Zdrowotnej w Parczewie|Parczew|KOŚCIELNA 136 |21-200 Parczew;157;47;47;0;47;29.94;0.00
88267;061305;Zespół Placówek Oświatowych w Podedwórzu|Podedwórze| 96 |21-222 Podedwórze;514;242;242;7;235;47.08;2.89
88268;061305;Świetlica wiejska w Podedwórzu|Podedwórze| 46A |21-222 Podedwórze;475;228;228;4;224;48.00;1.75
88269;061305;Remiza OSP w Bojarach|Bojary| 33 |21-222 Podedwórze;477;168;168;8;160;35.22;4.76
88270;061306;Sala Gimnastyczna w Siemieniu|Siemień|ul. Kościelna 1 |21-220 Siemień;1347;638;638;18;620;47.36;2.82
88271;061306;Świetlica Wiejska w Żminnem|Żminne| 30 |21-220 Siemień;968;344;344;8;336;35.54;2.33
88272;061306;Remiza OSP w Działyniu|Działyń| 4 |21-220 Siemień;828;373;373;10;363;45.05;2.68
88273;061306;Szkoła Podstawowa w Gródku Szlacheckim|Gródek Szlachecki| 140 |21-220 Siemień;745;287;287;10;277;38.52;3.48
88274;061307;Świetlica w Nowym Orzechowie|Nowy Orzechów| 42 |21-230 Sosnowica;554;257;257;14;243;46.39;5.45
88275;061307;Szkoła Podstawowa w Sosnowicy|Sosnowica|ul. Wojska Polskiego 27 |21-230 Sosnowica;675;326;326;14;312;48.30;4.29
88276;061307;Gimnazjum w Sosnowicy|Sosnowica|ul. Wojska Polskiego 27 |21-230 Sosnowica;561;184;184;11;173;32.80;5.98
88277;061307;Świetlica Klubu w Zienkach|Zienki| 4A |21-230 Sosnowica;435;115;115;12;103;26.44;10.43
88278;061401;Nauczycielskie Kolegium Języków Obcych|Puławy|ul. Hugona Kołłątaja 64 |24-100 Puławy;1871;925;925;20;905;49.44;2.16
88279;061401;Szkoła Podstawowa Nr 10|Puławy|ul. 6 Sierpnia 30 |24-100 Puławy;1834;1186;1186;12;1174;64.67;1.01
88280;061401;Zespół Szkół Katolickich|Puławy|ul. Stanisława Eustachiewicza 1 |24-100 Puławy;1880;1006;1006;19;987;53.51;1.89
88281;061401;Szkoła Podstawowa Nr 2|Puławy|aleja Mała 10 |24-100 Puławy;1675;994;994;10;984;59.34;1.01
88282;061401;Szkoła Podstawowa Nr 11|Puławy|ul. Legionu Puławskiego 8 |24-100 Puławy;1731;994;994;11;983;57.42;1.11
88283;061401;Starostwo Powiatowe|Puławy|aleja Królewska 19 |24-100 Puławy;1724;1024;1024;15;1009;59.40;1.46
88284;061401;Zespół Szkół Nr 3|Puławy|ul. marsz. Józefa Piłsudskiego 74 |24-100 Puławy;718;425;425;3;422;59.19;0.71
88285;061401;Szkoła Podstawowa Nr 11|Puławy|ul. Legionu Puławskiego 8 |24-100 Puławy;2011;1216;1216;17;1199;60.47;1.40
88286;061401;Szkoła Podstawowa Nr 4|Puławy|ul. Franciszka Zabłockiego 8 |24-100 Puławy;1908;1080;1080;17;1063;56.60;1.57
88287;061401;Szkoła Podstawowa Nr 4|Puławy|ul. Franciszka Zabłockiego 8 |24-100 Puławy;1677;854;858;6;848;50.92;0.70
88288;061401;Szkoła Podstawowa Nr 11|Puławy|ul. Legionu Puławskiego 8 |24-100 Puławy;2280;1407;1407;18;1389;61.71;1.28
88289;061401;Zespół Szkół Ogólnokształcących Nr 1 im. Komisji Edukacji Narodowej|Puławy|ul. Kaniowczyków 9 |24-100 Puławy;2044;1192;1193;18;1174;58.32;1.51
88290;061401;Zespół Szkół Technicznych|Puławy|ul. Wojska Polskiego 7 |24-100 Puławy;1418;837;837;11;826;59.03;1.31
88291;061401;Szkoła Podstawowa Nr 1|Puławy|ul. Kaniowczyków 1 |24-100 Puławy;2054;1152;1152;12;1140;56.09;1.04
88292;061401;Państwowa Szkoła Muzyczna I Stopnia|Puławy|aleja Partyzantów 46 |24-100 Puławy;1345;766;766;13;753;56.95;1.70
88293;061401;Środowiskowy Dom Samopomocy|Puławy|ul. Adama Mickiewicza 2a |24-100 Puławy;1905;1182;1182;13;1169;62.05;1.10
88294;061401;Środowiskowy Dom Samopomocy|Puławy|ul. Adama Mickiewicza 2a |24-100 Puławy;1708;826;826;24;802;48.36;2.91
88295;061401;POK "Dom Chemika"|Puławy|ul. Wojska Polskiego 4 |24-100 Puławy;1740;952;952;21;931;54.71;2.21
88296;061401;Zespół Szkół Nr 1|Puławy|ul. Polna 18 |24-100 Puławy;1433;771;771;15;756;53.80;1.95
88297;061401;Zespół Szkół Ogólnokształcących Nr 2|Puławy|ul. Zygmunta Wróblewskiego 11 |24-100 Puławy;2006;1061;1061;10;1051;52.89;0.94
88298;061401;Szkoła Podstawowa Nr 6|Puławy|ul. Juliana Ursyna Niemcewicza 4 |24-100 Puławy;1697;828;828;17;811;48.79;2.05
88299;061401;Szkoła Podstawowa Nr 3|Puławy|ul. Jaworowa 5 |24-100 Puławy;1237;678;678;19;659;54.81;2.80
88300;061401;Zespół Szkół Nr 2|Puławy|ul. Jaworowa 1 |24-100 Puławy;1381;787;787;7;780;56.99;0.89
88301;061401;Szpital Specjalistyczny|Puławy|ul. Józefa Bema 1 |24-100 Puławy;116;55;55;4;51;47.41;7.27
88302;061402;Urząd Gminy|Baranów|ul. Rynek 14 |24-105 Baranów;932;462;462;20;442;49.57;4.33
88303;061402;Zespół Szkolno-Przedszkolny|Baranów|ul. Szkolna 2 |24-105 Baranów;853;413;413;15;398;48.42;3.63
88304;061402;Świetlica wiejska|Zagóźdź| 25 |24-105 Baranów;246;112;112;9;103;45.53;8.04
88305;061402;Świetlica wiejska|Łukawka| 26B |24-105 Baranów;350;120;120;6;114;34.29;5.00
88306;061402;Świetlica wiejska|Kozioł| 40B |24-105 Baranów;541;220;220;7;213;40.67;3.18
88307;061402;Świetlica wiejska|Śniadówka| 48 |24-105 Baranów;433;213;213;7;206;49.19;3.29
88308;061403;Gminny Ośrodek Kultury, sala widowiskowa|Janowiec|Plac Wolności 1 |24-123 Janowiec;1063;462;462;7;455;43.46;1.52
88309;061403;Gminny Ośrodek Kultury, świetlica|Janowiec|Plac Wolności 1 |24-123 Janowiec;950;515;515;15;500;54.21;2.91
88310;061403;Strażnica OSP|Wojszyn| 49 |24-123 Janowiec;1083;508;509;14;494;46.91;2.76
88311;061404;Zespół Szkół|Kazimierz Dolny|ul. Nadwiślańska 9 |24-120 Kazimierz Dolny;1740;960;960;13;947;55.17;1.35
88312;061404;Gminny Zespół Szkół|Kazimierz Dolny|ul. Szkolna 1 |24-120 Kazimierz Dolny;1592;789;789;23;766;49.56;2.92
88313;061404;Szkoła Podstawowa|Bochotnica|Zamłynie 1 |24-120 Kazimierz Dolny;1087;447;447;13;434;41.12;2.91
88314;061404;Szkoła Podstawowa|Rzeczyca| 69 |24-120 Kazimierz Dolny;719;219;219;9;210;30.46;4.11
88315;061404;Budynek byłej szkoły podstawowej|Parchatka| 83 |24-120 Kazimierz Dolny;652;294;294;11;283;45.09;3.74
88316;061405;Gminny Ośrodek Kultury|Końskowola|ul. Lubelska 93 |24-130 Końskowola;1088;679;679;15;664;62.41;2.21
88317;061405;Zespół Szkół w Końskowoli budynek Szkoły Podstawowej|Końskowola|ul. Lubelska 81 |24-130 Końskowola;1019;651;651;15;636;63.89;2.30
88318;061405;Zespół Szkół w Końskowoli budynek Gimnazjum|Końskowola|ul. Lubelska 81 |24-130 Końskowola;629;398;398;22;376;63.28;5.53
88319;061405;Urząd Gminy Końskowola|Końskowola|ul. Pożowska 3A |24-130 Końskowola;580;309;309;14;295;53.28;4.53
88320;061405;Zespół Placówek Oświatowych w Pożogu|Stary Pożóg| 57 |24-130 Końskowola;892;507;507;22;485;56.84;4.34
88321;061405;Remiza OSP|Witowice| 42B |24-130 Końskowola;691;461;461;6;455;66.71;1.30
88322;061405;Szkoła Podstawowa Skowieszyn|Skowieszyn| 45 |24-130 Końskowola;597;323;323;10;313;54.10;3.10
88323;061405;Remiza OSP|Stok| 85A |24-130 Końskowola;526;213;213;4;209;40.49;1.88
88324;061405;Szkoła Podstawowa|Chrząchów| 11A |24-130 Końskowola;918;488;488;12;476;53.16;2.46
88325;061405;Budynek Szkoły Podstawowej|Sielce| 66 |24-130 Końskowola;490;304;304;16;288;62.04;5.26
88326;061406;Gminny Ośrodek Kultury|Kurów|ul. Kilińskiego 2a |24-170 Kurów;1287;706;706;25;681;54.86;3.54
88327;061406;Lokal|Kurów|ul. I Armii WP 1 |24-170 Kurów;1247;750;750;18;732;60.14;2.40
88328;061406;Świetlica wiejska|Brzozowa Gać| 3 |24-170 Kurów;608;295;295;8;287;48.52;2.71
88329;061406;Remiza OSP|Płonki| 41A |24-170 Kurów;600;225;225;8;217;37.50;3.56
88330;061406;Świetlica wiejska|Kłoda| 12a |24-170 Kurów;599;301;301;9;292;50.25;2.99
88331;061406;Świetlica wiejska|Dęba| 21 |24-170 Kurów;650;243;243;9;234;37.38;3.70
88332;061406;Zespół Placówek Oświatowych|Klementowice| 230 |24-170 Kurów;1267;590;590;14;576;46.57;2.37
88333;061407;Szkoła Podstawowa|Markuszów|ul. Lubelska 80 |24-173 Markuszów;987;586;586;15;571;59.37;2.56
88334;061407;Gminny Dom Kultury|Markuszów|ul. M. Sobieskiego 1 |24-173 Markuszów;667;313;313;7;306;46.93;2.24
88335;061407;Dom Ludowy|Bobowiska| 35a |24-173 Markuszów;266;131;131;7;124;49.25;5.34
88336;061407;Dom Ludowy|Łany| 69a |24-173 Markuszów;533;265;265;10;255;49.72;3.77
88337;061408;SP ZOZ w Nałęczowie|Nałęczów|ul. Kolejowa 7 |24-150 Nałęczów;1591;910;910;8;902;57.20;0.88
88338;061408;Liceum Plastyczne w Nałęczowie|Nałęczów|ul. Lipowa 30 |24-150 Nałęczów;907;449;449;11;438;49.50;2.45
88339;061408;CSW "Energetyk" w Nałęczowie|Nałęczów|ul. Paderewskiego 10 |24-150 Nałęczów;741;375;375;6;369;50.61;1.60
88340;061408;Nałęczowski Ośrodek Kultury w Nałęczowie|Nałęczów|ul. Lipowa 6 |24-150 Nałęczów;893;518;518;4;514;58.01;0.77
88341;061408;Szkoła Podstawowa w Drzewcach|Drzewce-Kolonia| 82A |24-150 Nałęczów;597;307;307;5;302;51.42;1.63
88342;061408;Remiza OSP w Drzewcach|Drzewce| 60 |24-150 Nałęczów;469;236;236;3;233;50.32;1.27
88343;061408;Szkoła Podstawowa w Sadurkach|Sadurki| 106 |24-150 Nałęczów;714;325;325;7;318;45.52;2.15
88344;061408;Szkoła Podstawowa w Czesławicach|Czesławice| 13 |24-150 Nałęczów;589;218;218;17;201;37.01;7.80
88345;061408;Szkoła Podstawowa w Piotrowicach|Piotrowice| 107 |24-150 Nałęczów;633;290;290;5;285;45.81;1.72
88346;061408;Remiza OSP w Bronicach|Bronice| 12 |24-150 Nałęczów;327;153;153;7;146;46.79;4.58
88347;061408;Kardiologiczny Szpital Uzdrowiskowy w Nałęczowie|Nałęczów|Michała Górskiego 5 |24-150 Nałęczów;398;350;350;10;340;87.94;2.86
88348;061408;Kolejowy Szpital Uzdrowiskowy SP ZOZ w Nałęczowie|Nałęczów|Michała Górskiego 6 |24-150 Nałęczów;166;143;143;2;141;86.14;1.40
88349;061408;Sanatorium Uzdrowiskowe „Rolnik” w Nałęczowie|Nałęczów|Michała Górskiego 14 |24-150 Nałęczów;139;130;130;4;126;93.53;3.08
88350;061408;Sanatorium Uzdrowiskowe „Ciche Wąwozy” NZOZ w Nałęczowie|Nałęczów|Bartosza Głowackiego 12 |24-150 Nałęczów;120;106;106;7;99;88.33;6.60
88351;061408;Zakład Opiekuńczo-Leczniczy Oddział IV Nałęczów|Nałęczów|Lipowa 37 |24-150 Nałęczów;28;28;28;5;23;100.00;17.86
88352;061409;Szkoła Podstawowa sala Nr 1|Góra Puławska|Ogrodowa 18 |24-100 Puławy;1789;991;991;21;970;55.39;2.12
88353;061409;Szkoła Podstawowa sala Nr 2|Góra Puławska|Ogrodowa 18 |24-100 Puławy;1360;598;598;20;578;43.97;3.34
88354;061409;Gminny Ośrodek Kultury sala Nr 1|Gołąb|Folwarki 1 |24-100 Puławy;1954;871;871;28;843;44.58;3.21
88355;061409;Gminny Ośrodek Kultury sala Nr 2|Gołąb|Folwarki 1 |24-100 Puławy;595;228;228;11;217;38.32;4.82
88356;061409;Szkoła Podstawowa|Borowa| 9A |24-100 Puławy;674;301;301;12;289;44.66;3.99
88357;061409;Szkoła Podstawowa|Bronowice| 148 |24-100 Puławy;709;402;402;12;390;56.70;2.99
88358;061409;Szkoła Podstawowa|Opatkowice| 43 |24-100 Puławy;597;244;244;15;229;40.87;6.15
88359;061409;Szkoła Podstawowa|Leokadiów| 40 |24-100 Puławy;764;361;361;10;351;47.25;2.77
88360;061409;Szkoła Podstawowa|Zarzecze| 1A |24-100 Puławy;1183;516;516;15;501;43.62;2.91
88361;061410;Szkoła Podstawowa w Wąwolnicy|Wąwolnica|ul. Zamkowa 4 |24-160 Wąwolnica;1423;746;746;15;731;52.42;2.01
88362;061410;Gimnazjum Publiczne w Wąwolnicy|Wąwolnica|ul. Rynek 24A |24-160 Wąwolnica;746;328;328;4;324;43.97;1.22
88363;061410;Szkoła Podstawowa w Karmanowicach|Karmanowice| 85 |24-160 Wąwolnica;1079;468;468;12;456;43.37;2.56
88364;061410;Szkoła Podstawowa w Rąblowie|Rąblów| 65 |24-160 Wąwolnica;464;152;152;8;144;32.76;5.26
88365;061410;Samodzielny Publiczny Psychiatryczny Zakład Opiekuńczo-Leczniczy w Celejowie|Celejów| 68 |24-120 Kazimierz Dolny;161;39;39;9;30;24.22;23.08
88366;061411;Budynek komunalny|Bałtów| 29 |24-103 Żyrzyn;388;198;198;4;194;51.03;2.02
88367;061411;Szkoła Podstawowa|Żyrzyn|ul. Tysiąclecia 143 |24-103 Żyrzyn;1576;862;862;28;834;54.70;3.25
88368;061411;Szkoła Podstawowa|Osiny| 235 |24-103 Żyrzyn;846;459;459;13;446;54.26;2.83
88369;061411;Szkoła Podstawowa|Skrudki| 5A |24-103 Żyrzyn;668;324;324;12;312;48.50;3.70
88370;061411;Budynek po Szkole Podstawowej|Kośmin| 7 |24-103 Żyrzyn;557;251;251;13;238;45.06;5.18
88371;061411;Budynek komunalny|Borysów| 53 |24-103 Żyrzyn;323;160;160;7;153;49.54;4.38
88372;061411;Świetlica wiejska|Żerdź| 91A |24-103 Żyrzyn;441;206;206;12;194;46.71;5.83
88373;061411;Świetlica wiejska|Kotliny| 105 |24-103 Żyrzyn;248;111;111;2;109;44.76;1.80
88374;061411;Budynek komunalny|Wola Osińska| 80 |24-103 Żyrzyn;330;176;176;5;171;53.33;2.84
88375;061501;Przedszkole Miejskie Radzyń Podlaski|Radzyń Podlaski|ul. Brata Alberta Chmielowskiego 8 |21-300 Radzyń Podlaski;1903;1101;1101;17;1084;57.86;1.54
88376;061501;Szkoła Podstawowa Nr 2 Radzyń Podlaski|Radzyń Podlaski|ul. Sitkowskiego 3 |21-300 Radzyń Podlaski;1883;1012;1012;17;995;53.74;1.68
88377;061501;Gimnazjum Nr 2 Radzyń Podlaski|Radzyń Podlaski|ul. Sitkowskiego 3 |21-300 Radzyń Podlaski;917;473;473;5;468;51.58;1.06
88378;061501;Filia Miejskiej Biblioteki Radzyń Podlaski|Radzyń Podlaski|ul. Spółdzielcza 8 |21-300 Radzyń Podlaski;1682;846;846;10;836;50.30;1.18
88379;061501;Szkoła Podstawowa Nr 2 Radzyń Podlaski|Radzyń Podlaski|ul. Chmielowskiego 5 |21-300 Radzyń Podlaski;1538;756;756;19;737;49.15;2.51
88380;061501;Urząd Miasta Radzyń Podlaski|Radzyń Podlaski|ul. Warszawska 32 |21-300 Radzyń Podlaski;1646;818;818;22;796;49.70;2.69
88381;061501;Dzienny Środowiskowy Dom Samopomocy Radzyń Podlaski|Radzyń Podlaski|os. Bulwary 12 |21-300 Radzyń Podlaski;919;479;479;16;463;52.12;3.34
88382;061501;Punkt Pośrednictwa Pracy OHP Radzyń Podlaski|Radzyń Podlaski|ul. Armii Krajowej 2 |21-300 Radzyń Podlaski;764;406;406;10;396;53.14;2.46
88383;061501;Szkoła Podstawowa Nr 1 Radzyń Podlaski|Radzyń Podlaski|ul. Jana Pawła II 25 |21-300 Radzyń Podlaski;1514;712;712;26;686;47.03;3.65
88384;061501;Samodzielny Publiczny Zakład Opieki Zdrowotnej Radzyń Podlaski|Radzyń Podlaski|ul. Wisznicka 111 |21-300 Radzyń Podlaski;209;103;103;4;99;49.28;3.88
88385;061502;Szkoła Podstawowa w Borkach|Borki|ul. II Armii Wojska Polskiego 26 |21-345 Borki;1232;529;529;10;519;42.94;1.89
88386;061502;Szkoła Podstawowa w Krasewie|Krasew| 84 |21-345 Borki;963;426;426;2;424;44.24;0.47
88387;061502;Szkoła Podstawowa w Tchórzewie-Kolonii|Tchórzew-Kolonia| 186 |21-345 Borki;396;151;151;2;149;38.13;1.32
88388;061502;Gminny Ośrodek Kultury w Woli Osowińskiej|Wola Osowińska|ul. Wesoła 29 |21-345 Borki;1282;501;501;23;478;39.08;4.59
88389;061502;Remiza OSP w Starej Wsi|Stara Wieś| 33A |21-345 Borki;977;371;371;14;357;37.97;3.77
88390;061503;Remiza Ochotniczej Straży Pożarnej w Czemiernikach|Czemierniki|ul. Zamkowa 11 |21-306 Czemierniki;1424;762;762;19;743;53.51;2.49
88391;061503;Remiza Ochotniczej Straży Pożarnej w Bełczącu|Bełcząc| 187 |21-306 Czemierniki;600;325;325;6;319;54.17;1.85
88392;061503;Świetlica wiejska w Niewęgłoszu|Niewęgłosz| 44 |21-306 Czemierniki;597;336;336;9;327;56.28;2.68
88393;061503;Dom spotkań w Stoczku|Stoczek| 133 |21-306 Czemierniki;372;198;198;5;193;53.23;2.53
88394;061503;Świetlica wiejska w Wygnanowie|Wygnanów| 92 |21-306 Czemierniki;649;286;286;5;281;44.07;1.75
88395;061504;Zespół Oświatowy w Brzozowicy Dużej|Brzozowica Duża| 83 |21-302 Kąkolewnica;1232;562;562;21;541;45.62;3.74
88396;061504;Zespół Oświatowy w Kąkolewnicy|Kąkolewnica|Szkolna 4 |21-302 Kąkolewnica;969;430;430;14;416;44.38;3.26
88397;061504;Gminny Ośrodek Kultury w Kąkolewnicy|Kąkolewnica|Lubelska 16 |21-302 Kąkolewnica;1374;687;687;17;670;50.00;2.47
88398;061504;Zespół Oświatowyw Polskowoli|Polskowola| 131A |21-302 Kąkolewnica;610;270;270;14;256;44.26;5.19
88399;061504;Publiczne Gimnazjum w Olszewnicy|Olszewnica| 170 |21-302 Kąkolewnica;614;221;221;11;210;35.99;4.98
88400;061504;Szkoła Podstawowa w Turowie|Turów| 76 |21-302 Kąkolewnica;892;397;397;29;368;44.51;7.30
88401;061504;Szkoła Podstawowa w Żakowoli Poprzecznej|Żakowola Poprzeczna| 43 |21-302 Kąkolewnica;511;233;233;4;229;45.60;1.72
88402;061504;Szkoła Podstawowa w Grabowcu|Grabowiec| 36 |21-302 Kąkolewnica;413;184;184;14;170;44.55;7.61
88403;061505;Szkoła Podstawowa w Komarówce Podlaskiej|Komarówka Podlaska|ul. I Armii Wojska Polskiego 7 |21-311 Komarówka Podlaska;1236;656;656;23;633;53.07;3.51
88404;061505;Publiczna Szkoła Podstawowa w Derewicznie|Derewiczna| 88 |21-311 Komarówka Podlaska;416;190;190;2;188;45.67;1.05
88405;061505;Warsztat Terapii Zajęciowej w Kolembrodach|Kolembrody| 60A |21-311 Komarówka Podlaska;641;224;224;3;221;34.95;1.34
88406;061505;Remiza OSP w Przegalinach Dużych|Przegaliny Duże| 125 |21-311 Komarówka Podlaska;564;268;268;9;259;47.52;3.36
88407;061505;Remiza OSP w Wiskach|Wiski| 15 |21-311 Komarówka Podlaska;899;448;448;15;433;49.83;3.35
88408;061506;Remiza OSP w Branicy Radzyńskiej-Kolonii|Branica Radzyńska-Kolonia| 49A |21-300 Radzyń Podlaski;747;320;320;12;308;42.84;3.75
88409;061506;Remiza OSP w Ustrzeszy|Ustrzesz| 34A |21-300 Radzyń Podlaski;818;361;361;9;352;44.13;2.49
88410;061506;Zespół Szkół w Białce|Białka| 49A |21-300 Radzyń Podlaski;1155;598;598;7;591;51.77;1.17
88411;061506;Remiza OSP w Płudach|Płudy| 16 |21-300 Radzyń Podlaski;455;242;242;8;234;53.19;3.31
88412;061506;Szkoła Podstawowa w Brzostówcu|Brzostówiec| 72 |21-300 Radzyń Podlaski;614;245;245;8;237;39.90;3.27
88413;061506;Sala gimnastyczna przy Szkole Podstawowej w Żabikowie|Żabików| 65A |21-300 Radzyń Podlaski;641;297;297;13;284;46.33;4.38
88414;061506;Zespół Szkół w Białej|Biała| 30 |21-300 Radzyń Podlaski;1052;465;465;13;452;44.20;2.80
88415;061506;Zespół Szkół w Zabielu|Zabiele| 8B |21-300 Radzyń Podlaski;457;244;244;11;233;53.39;4.51
88416;061506;Remiza OSP w Paszkach Dużych|Paszki Duże| 64 |21-300 Radzyń Podlaski;530;245;245;7;238;46.23;2.86
88417;061507;Szkoła Podstawowa w Domaszewnicy|Kolonia Domaszewska| 8 |21-307 Ulan-Majorat;799;344;344;14;330;43.05;4.07
88418;061507;Szkoła Podstawowa w Sobolach|Sobole| 69c |21-307 Ulan-Majorat;533;227;227;14;213;42.59;6.17
88419;061507;Zespół Szkół im. Jana Pawła II w Ulanie-Majoracie|Ulan-Majorat| 53 |21-307 Ulan-Majorat;1661;796;796;18;778;47.92;2.26
88420;061507;Dom Ludowy w Gąsiorach|Gąsiory| 25a |21-307 Ulan-Majorat;711;369;369;6;363;51.90;1.63
88421;061507;Szkoła Podstawowa w Kępkach|Kępki| 26a |21-307 Ulan-Majorat;435;212;212;12;200;48.74;5.66
88422;061507;Remiza OSP w Ulanie Dużym|Ulan Duży| 43a |21-307 Ulan-Majorat;663;364;364;14;350;54.90;3.85
88423;061508;Zespół Szkół w Wohyniu|Wohyń|ul. Piłsudskiego 25 |21-310 Wohyń;1854;800;800;27;773;43.15;3.38
88424;061508;Młodzieżowe Centrum Kultury w Suchowoli|Suchowola| 133A |21-310 Wohyń;1105;462;462;18;444;41.81;3.90
88425;061508;Szkoła Podstawowa w Bezwoli|Bezwola|ul. Grabówka 1 |21-310 Wohyń;1454;617;617;28;589;42.43;4.54
88426;061508;Szkoła Podstawowa w Ostrówkach|Ostrówki| 66b |21-310 Wohyń;511;206;206;5;201;40.31;2.43
88427;061508;Szkoła Podstawowa w Ossowie|Ossowa| 91a |21-310 Wohyń;322;155;155;2;153;48.14;1.29
88428;061508;Dom Ludowy w Branicy Suchowolskiej|Branica Suchowolska| 60 |21-310 Wohyń;376;151;151;4;147;40.16;2.65
88429;061508;Budynek Szpitala w Suchowoli|Kuraszew| 48 |21-310 Wohyń;111;28;28;4;24;25.23;14.29
88430;061601;Specjalny Ośrodek Szkolno-Wychowawczy|Dęblin|ul. Niepodległości 8 |08-530 Dęblin;728;317;317;16;301;43.54;5.05
88431;061601;Szkoła Podstawowa Nr 2|Dęblin|ul. 1 Maja 3 |08-530 Dęblin;1023;481;481;10;471;47.02;2.08
88432;061601;Świetlica Środowiskowa|Dęblin|ul. 1 Maja 160 |08-530 Dęblin;775;422;422;7;415;54.45;1.66
88433;061601;Szkoła Podstawowa Nr 6|Dęblin|ul. Stawska 322 |08-530 Dęblin;259;120;120;3;117;46.33;2.50
88434;061601;Świetlica Środowiskowa|Dęblin|ul. 1 Maja 160 |08-530 Dęblin;892;434;434;7;427;48.65;1.61
88435;061601;Szkoła Podstawowa Nr 2|Dęblin|ul. 1 Maja 3 |08-530 Dęblin;833;407;407;8;399;48.86;1.97
88436;061601;Przedszkole Miejskie Nr 3|Dęblin|ul. Michalinowska 1a |08-530 Dęblin;1116;579;579;19;560;51.88;3.28
88437;061601;Zespół Szkół Zawodowych Nr 2|Dęblin|ul. Wiślana 3b |08-530 Dęblin;1134;625;625;11;614;55.11;1.76
88438;061601;Zespół Szkół Zawodowych Nr 2|Dęblin|ul. Wiślana 3b |08-530 Dęblin;951;444;444;17;427;46.69;3.83
88439;061601;Zespół Szkół Zawodowych Nr 2|Dęblin|ul. Wiślana 3b |08-530 Dęblin;866;407;407;17;390;47.00;4.18
88440;061601;Internat Wojskowej Agencji Mieszkaniowej|Dęblin|ul. 15 Pułku Piechoty Wilków 34a |08-530 Dęblin;972;498;498;11;487;51.23;2.21
88441;061601;Liceum Ogólnokształcące|Dęblin|ul. 15 Pułku Piechoty Wilków 6 |08-530 Dęblin;950;515;515;8;507;54.21;1.55
88442;061601;Remiza OSP|Dęblin|ul. Krasickiego 146 |08-530 Dęblin;459;229;229;10;219;49.89;4.37
88443;061601;Szkoła Podstawowa Nr 2|Dęblin|ul. 1 Maja 3 |08-530 Dęblin;299;111;111;3;108;37.12;2.70
88444;061601;Szkoła Podstawowa Nr 4|Dęblin|ul. Generała Kowalskiego 20 |08-530 Dęblin;863;455;455;13;442;52.72;2.86
88445;061601;Gimnazjum Nr 2|Dęblin|ul. Generała Kowalskiego 20 |08-530 Dęblin;877;528;528;14;514;60.21;2.65
88446;061601;Gimnazjum Nr 2|Dęblin|ul. Generała Kowalskiego 20 |08-530 Dęblin;546;349;349;5;344;63.92;1.43
88447;061601;6 Szpital Wojskowy z Przychodnią SPZOZ|Dęblin|Szpitalna 2 |08-530 Dęblin;28;18;18;4;14;64.29;22.22
88448;061602;Gminny Ośrodek Kultury ul. Klonowa 2 08-550 Kłoczew|Kłoczew|ul. Klonowa 2 |08-550 Kłoczew;1414;762;762;17;745;53.89;2.23
88449;061602;Szkoła Podstawowa Stare Zadybie 118 08-550 Kłoczew|Stare Zadybie| 118 |08-550 Kłoczew;736;386;386;7;379;52.45;1.81
88450;061602;Świetlica OSP Stryj 33a 08-550 Kłoczew|Stryj| 27A |08-550 Kłoczew;355;155;155;2;153;43.66;1.29
88451;061602;Zespół Szkół Gózd 109A 08-550 Kłoczew|Gózd| 109A |08-550 Kłoczew;874;365;365;11;354;41.76;3.01
88452;061602;była Szkoła Podstawowa Bramka 40 08-550 Kłoczew|Bramka| 40 |08-550 Kłoczew;323;140;140;8;132;43.34;5.71
88453;061602;Zespół Szkół Czernic 95 08-550 Kłoczew|Czernic| 95 |08-550 Kłoczew;1217;569;569;36;533;46.75;6.33
88454;061602;Świetlica OSP Wylezin 41A 08-550 Kłoczew|Wylezin| 41A |08-550 Kłoczew;415;209;209;5;204;50.36;2.39
88455;061602;Szkoła Podstawowa Wola Zadybska 82 08-550 Kłoczew|Wola Zadybska| 82 |08-550 Kłoczew;522;255;255;6;249;48.85;2.35
88456;061603;Zespół Szkół Ogólnokształcących im. Wacława Nałkowskiego|Nowodwór| 73 |08-503 Nowodwór;886;437;437;16;421;49.32;3.66
88457;061603;Zespół Szkół Ogólnokształcących im. Wacława Nałkowskiego w Nowodworze - Filia Szkoły Podstawowej|Trzcianki| 64 |08-503 Nowodwór;297;166;166;14;152;55.89;8.43
88458;061603;Szkoła Podstawowa|Niedźwiedź| 62 |08-503 Nowodwór;460;211;211;5;206;45.87;2.37
88459;061603;Zespół Szkół Ogólnokształcących im. Henryka Sienkiewicza|Grabów Szlachecki| 61 |08-503 Nowodwór;805;370;370;15;355;45.96;4.05
88460;061603;Szkoła Podstawowa|Jakubówka| 65 |08-503 Nowodwór;203;88;88;3;85;43.35;3.41
88461;061603;Świetlica|Grabów Rycki| 20a |08-503 Nowodwór;266;138;138;7;131;51.88;5.07
88462;061603;Remiza OSP|Zawitała| 23d |08-503 Nowodwór;427;166;166;10;156;38.88;6.02
88463;061604;Przedszkole Samorządowe Nr 1|Ryki|ul. Szkolna 18 |08-500 Ryki;823;398;398;3;395;48.36;0.75
88464;061604;Świetlica osiedlowa, Ryki|Ryki|ul. Kościuszki 19 |08-500 Ryki;834;431;431;9;422;51.68;2.09
88465;061604;ZSZ Nr 2 im. L. Wyczółkowskiego|Ryki|ul. Wyczółkowskiego 10 |08-500 Ryki;778;475;475;5;470;61.05;1.05
88466;061604;Przedszkole Samorządowe Nr 2|Ryki|ul. Żytnia 28A |08-500 Ryki;830;490;490;19;471;59.04;3.88
88467;061604;Zespół Szkół Ogólnokształcących Nr 1|Ryki|ul. Słowackiego 2 |08-500 Ryki;795;381;381;11;370;47.92;2.89
88468;061604;ZSZ Nr 2 im. L. Wyczółkowskiego|Ryki|ul. Wyczółkowskiego 10 |08-500 Ryki;809;383;383;6;377;47.34;1.57
88469;061604;ZSZ im. Wł. Korżyka|Ryki|ul. Żytnia 5 |08-500 Ryki;759;424;424;8;416;55.86;1.89
88470;061604;Przedszkole Samorządowe Nr 5|Ryki|ul. Kochanowskiego 21 |08-500 Ryki;955;517;517;12;505;54.14;2.32
88471;061604;Przedszkole Samorządowe Nr 5|Ryki|ul. Kochanowskiego 21 |08-500 Ryki;746;436;436;5;431;58.45;1.15
88472;061604;ZSZ im. Wł. Korżyka|Ryki|ul. Żytnia 5 |08-500 Ryki;693;321;321;8;313;46.32;2.49
88473;061604;Zespół Placówek Oświatowych w Bobrownikach|Bobrowniki|ul. Rynek 1 |08-500 Ryki;868;390;390;15;375;44.93;3.85
88474;061604;Świetlica wiejska w Podwierzbiu|Podwierzbie| 20a |08-500 Ryki;484;249;249;16;233;51.45;6.43
88475;061604;Publiczna Szkoła Podstawowa w Moszczance|Moszczanka| 14 |08-500 Ryki;637;303;303;10;293;47.57;3.30
88476;061604;Strażnica OSP w Sierskowoli|Sierskowola| 66c |08-500 Ryki;359;172;172;4;168;47.91;2.33
88477;061604;Publiczna Szkoła Podstawowa w Oszczywilku|Oszczywilk| 11a |08-500 Ryki;652;266;266;8;258;40.80;3.01
88478;061604;Strażnica OSP w Chrustnym|Chrustne| 29A |08-500 Ryki;237;130;130;6;124;54.85;4.62
88479;061604;Publiczna Szkoła Podstawowa w Starym Bazanowie|Stary Bazanów| 136 |08-500 Ryki;726;354;354;8;346;48.76;2.26
88480;061604;Publiczna Szkoła Podstawowa w Swatach|Swaty| 192A |08-500 Ryki;787;324;324;16;308;41.17;4.94
88481;061604;Strażnica OSP w Niwie Babickiej|Niwa Babicka| 23b |08-500 Ryki;394;194;194;4;190;49.24;2.06
88482;061604;Publiczna Szkoła Podstawowa w Starej Dąbi|Stara Dąbia| 4 |08-500 Ryki;605;291;291;11;280;48.10;3.78
88483;061604;Publiczna Szkoła Podstawowa w Owni|Ownia| 101 |08-500 Ryki;543;262;262;5;257;48.25;1.91
88484;061604;Strażnica OSP w Zalesiu-Kolonii|Zalesie-Kolonia| 12a |08-500 Ryki;542;278;278;5;273;51.29;1.80
88485;061604;Zespół Placówek Oświatowych w Rososzy|Rososz| 144 |08-500 Ryki;773;385;385;19;366;49.81;4.94
88486;061604;Zespół Szkół Ogólnokształcących Nr 3 w Leopoldowie|Leopoldów|ul. Zielona 1 |08-500 Ryki;468;204;204;12;192;43.59;5.88
88487;061604;Strażnica OSP w Leopoldowie|Leopoldów|ul. Księdza Drozdowskiego 8 |08-500 Ryki;589;274;274;10;264;46.52;3.65
88488;061604;Dom Pomocy Społecznej w Leopoldowie|Leopoldów|Księdza Drozdowskiego 37 |08-500 Ryki;29;16;16;0;16;55.17;0.00
88489;061604;Szpital Powiatowy w Rykach|Ryki|Żytnia 23 |08-500 Ryki;20;9;9;0;9;45.00;0.00
88490;061605;Gminny Ośrodek Kultury w Stężycy|Stężyca|ul. Królewska 4 |08-540 Stężyca;1679;869;869;35;834;51.76;4.03
88491;061605;Świetlica wiejska w Prażmowie|Prażmów| 3 |08-540 Stężyca;429;190;190;9;181;44.29;4.74
88492;061605;Zespół Placówek Oświatowych|Pawłowice| 90 |08-540 Stężyca;616;283;283;3;280;45.94;1.06
88493;061605;Świetlica wiejska w Paprotni|Paprotnia| 95 |08-540 Stężyca;368;171;171;10;161;46.47;5.85
88494;061605;Szkoła Podstawowa w Nowej Rokitni ( sala nr 4)|Nowa Rokitnia| 81 |08-540 Stężyca;495;220;220;10;210;44.44;4.55
88495;061605;Dom Strażaka w Brzezinach|Brzeziny| 34 |08-540 Stężyca;444;225;225;6;219;50.68;2.67
88496;061605;Szkoła Podstawowa w Nowej Rokitni (sala nr 9)|Nowa Rokitnia| 81 |08-540 Stężyca;374;138;138;7;131;36.90;5.07
88497;061606;Lokal GOK|Ułęż| 173 |08-504 Ułęż;620;298;298;15;283;48.06;5.03
88498;061606;Szkoła Podstawowa|Białki Dolne| 24 |08-504 Ułęż;370;155;155;3;152;41.89;1.94
88499;061606;Świetlica wiejska|Sobieszyn| 95B |08-504 Ułęż;546;223;223;9;214;40.84;4.04
88500;061606;OSP Lendo Ruskie|Lendo Ruskie| 44 |08-504 Ułęż;300;107;107;4;103;35.67;3.74
88501;061606;Świetlica wiejska|Sarny| 20 |08-504 Ułęż;222;111;111;3;108;50.00;2.70
88502;061606;Internat LO|Sobieszyn| 3B |08-504 Ułęż;324;147;147;1;146;45.37;0.68
88503;061606;OSP Korzeniów|Korzeniów| 71 |08-504 Ułęż;367;184;184;12;172;50.14;6.52
88504;061701;Zespół Szkół Ogólnokształcących Nr 1|Świdnik|Al. Wojska Polskiego 27 |21-040 Świdnik;1557;892;892;13;879;57.29;1.46
88505;061701;Miejskie Centrum Profilaktyki|Świdnik|ul. Cypriana Kamila Norwida 2 |21-040 Świdnik;1166;607;607;9;598;52.06;1.48
88506;061701;Miejskie Centrum Usług Socjalnych|Świdnik|ul. Kardynała Stefana Wyszyńskiego 5 |21-040 Świdnik;1647;901;901;7;894;54.71;0.78
88507;061701;Przedsiębiorstwo Komunalne PEGIMEK|Świdnik|ul. Marii Konopnickiej 3 |21-040 Świdnik;1451;830;830;10;820;57.20;1.20
88508;061701;Przedszkole Nr 5|Świdnik|ul. Gen. J. Hallera 11 |21-040 Świdnik;1383;780;780;14;766;56.40;1.79
88509;061701;Przedszkole nr 5|Świdnik|ul. Gen. J. Hallera 11 |21-040 Świdnik;1784;1032;1032;14;1018;57.85;1.36
88510;061701;Gimnazjum nr 1|Świdnik|ul. Mikołaja Kopernika 9 |21-040 Świdnik;1566;766;766;19;747;48.91;2.48
88511;061701;Przedszkole Nr 3|Świdnik|ul. Hotelowa 7 |21-040 Świdnik;1569;778;778;13;765;49.59;1.67
88512;061701;Miejsko-Powiatowa Biblioteka Publiczna|Świdnik|ul. Niepodległości 13 |21-040 Świdnik;1517;881;881;15;866;58.08;1.70
88513;061701;Zespół Szkół Ogólnokształcących nr 1|Świdnik|Al. Wojska Polskiego 27 |21-040 Świdnik;1864;1141;1141;15;1126;61.21;1.31
88514;061701;Miejski Ośrodek Kultury|Świdnik|ul. Leona Kruczkowskiego 1 |21-040 Świdnik;1493;914;914;14;900;61.22;1.53
88515;061701;Przedszkole Nr 4|Świdnik|ul. Leona Kruczkowskiego 1 |21-040 Świdnik;1331;769;769;12;757;57.78;1.56
88516;061701;Szkoła Podstawowa Nr 3|Świdnik|ul. Mikołaja Kopernika 9A |21-040 Świdnik;1629;888;888;15;873;54.51;1.69
88517;061701;Szkoła Podstawowa nr 7|Świdnik|Aleja Armii Krajowej 3 |21-040 Świdnik;1579;815;815;14;801;51.61;1.72
88518;061701;Szkoła Podstawowa Nr 7|Świdnik|Aleja Armii Krajowej 3 |21-040 Świdnik;1247;701;701;5;696;56.21;0.71
88519;061701;Zespół Szkół nr 2|Świdnik|ul. Jarzębinowa 6 |21-040 Świdnik;1393;799;799;10;789;57.36;1.25
88520;061701;Zespół Szkół Nr 2|Świdnik|ul. Jarzębinowa 6 |21-040 Świdnik;1906;1138;1138;18;1120;59.71;1.58
88521;061701;Zespół Szkół Nr 2|Świdnik|ul. Jarzębinowa 6 |21-040 Świdnik;1779;1106;1106;8;1098;62.17;0.72
88522;061701;Zespół Szkół nr 2|Świdnik|Jarzębinowa 6 |21-040 Świdnik;1246;727;727;14;713;58.35;1.93
88523;061701;Przedszkole nr 7|Świdnik|ul. Ks. Kanonika Jana Hryniewicza 7 |21-040 Świdnik;1570;861;861;9;852;54.84;1.05
88524;061701;Szkoła Podstawowa nr 7|Świdnik|Aleja Armii Krajowej 3 |21-040 Świdnik;1271;786;786;9;777;61.84;1.15
88525;061701;Szpital w Świdniku|Świdnik|Aleja Lotników Polskich 18 |21-040 Świdnik;168;71;71;3;68;42.26;4.23
88526;061701;Dom Pomocy Społecznej w Świdniku|Świdnik|Piasecka 240 |21-040 Świdnik;108;48;48;6;42;44.44;12.50
88527;061702;Szkoła Podstawowa w Dominowie|Dominów| 78 |21-007 Mełgiew;707;301;301;7;294;42.57;2.33
88528;061702;Remiza OSP w Janowicach|Janowice| 137 |21-007 Mełgiew;661;287;287;6;281;43.42;2.09
88529;061702;Szkoła Podstawowa w Krępcu|Krępiec|ul. Szkolna 3 |21-007 Mełgiew;1746;976;976;12;964;55.90;1.23
88530;061702;Szkoła Podstawowa w Krzesimowie|Krzesimów| 116 |21-007 Mełgiew;837;383;383;9;374;45.76;2.35
88531;061702;Budynek Urzędu Gminy w Mełgwi|Mełgiew|ul. Partyzancka 2 |21-007 Mełgiew;1579;795;795;16;779;50.35;2.01
88532;061702;Szkoła Podstawowa w Podzamczu|Podzamcze| 22 |21-007 Mełgiew;889;351;351;9;342;39.48;2.56
88533;061702;Budynek byłej Szkoły Podstawowej we Franciszkowie|Franciszków|ul. Szkolna 47 |21-007 Mełgiew;865;561;561;6;555;64.86;1.07
88534;061703;Świetlica wiejska kulturalno-oświatowa w Siedliszczkach|Siedliszczki| 90A |21-050 Piaski;622;247;247;6;241;39.71;2.43
88535;061703;Zespół Szkół im. H. Babisz|Bystrzejowice Pierwsze| 90 |21-050 Piaski;677;358;358;12;346;52.88;3.35
88536;061703;Remiza Ochotniczej Straży Pożarnej w Wierzchowiskach|Wierzchowiska Pierwsze| 79 |21-050 Piaski;1074;500;500;28;472;46.55;5.60
88537;061703;Świetlica w Kawęczynie|Kawęczyn| 59 |21-050 Piaski;724;325;325;5;320;44.89;1.54
88538;061703;Specjalny Ośrodek Szkolno-Wychowawczy|Kozice Dolne-Kolonia| 33 |21-050 Piaski;590;206;206;12;194;34.92;5.83
88539;061703;Remiza Ochotniczej Straży Pożarnej w Kębłowie|Kębłów| 23 |21-050 Piaski;554;304;304;5;299;54.87;1.64
88540;061703;Budynek byłej Szkoły Podstawowej|Józefów| 23 |21-050 Piaski;489;187;187;6;181;38.24;3.21
88541;061703;Świetlica kulturalno-oświatowa|Gardzienice Pierwsze| 102A |21-050 Piaski;674;254;254;5;249;37.69;1.97
88542;061703;Zakład Pielęgnacyjno-Opiekuńczy "Pod Złotym Liściem"|Klimusin| 24 |21-050 Piaski;557;208;208;4;204;37.34;1.92
88543;061703;Miejskie Centrum Kultury w Piaskach|Piaski|ul. Lubelska 22 |21-050 Piaski;1060;523;523;22;501;49.34;4.21
88544;061703;Szkoła Podstawowa w Piaskach|Piaski|ul. A. Mickiewicza 2 |21-050 Piaski;1065;578;578;19;559;54.27;3.29
88545;061703;Szkoła Podstawowa|Majdan Kozic Górnych| 43 |21-050 Piaski;518;182;182;6;176;35.14;3.30
88546;061704;Urząd Gminy|Rybczewice Drugie| 119 |21-065 Rybczewice;697;322;322;8;314;46.20;2.48
88547;061704;Remiza OSP|Częstoborowice| 149 A |21-065 Rybczewice;369;137;137;3;134;37.13;2.19
88548;061704;Remiza Ochotniczej Straży Pożarnej|Bazar| 32 |21-065 Rybczewice;629;257;257;12;245;40.86;4.67
88549;061704;Była Szkoła Podstawowa|Izdebno| 118 |21-065 Rybczewice;418;148;148;2;146;35.41;1.35
88550;061704;Była Szkoła Podstawowa|Stryjno-Kolonia| 1 |21-065 Rybczewice;900;375;375;15;360;41.67;4.00
88551;061705;Zespół Placówek Oświatowych|Biskupice|ul. Józefa Piłsudskiego 15 |21-044 Trawniki;1417;550;550;15;535;38.81;2.73
88552;061705;Szkoła Podstawowa|Dorohucza| 119 |21-044 Trawniki;690;171;171;7;164;24.78;4.09
88553;061705;Szkoła Podstawowa|Oleśniki| 185 |21-044 Trawniki;955;433;433;17;416;45.34;3.93
88554;061705;Szkoła Podstawowa|Siostrzytów| 97a |21-044 Trawniki;1323;469;469;18;451;35.45;3.84
88555;061705;Gimnazjum Publiczne|Trawniki| 606 |21-044 Trawniki;2221;960;960;22;938;43.22;2.29
88556;061705;Gimnazjum Publiczne|Trawniki| 606 |21-044 Trawniki;627;227;227;7;220;36.20;3.08
88557;061801;Szkoła Podstawowa Nr 2|Tomaszów Lubelski|Żołnierzy Września 1 |22-600 Tomaszów Lubelski;1489;748;748;7;741;50.24;0.94
88558;061801;Przedszkole Nr 1|Tomaszów Lubelski|Chocimska 17 |22-600 Tomaszów Lubelski;1545;807;807;14;793;52.23;1.73
88559;061801;Przedszkole Nr 1|Tomaszów Lubelski|Chocimska 19 |22-600 Tomaszów Lubelski;842;448;448;6;442;53.21;1.34
88560;061801;Państwowa Szkoła Muzyczna|Tomaszów Lubelski|Rynek 5 |22-600 Tomaszów Lubelski;1484;713;713;23;690;48.05;3.23
88561;061801;Szkoła Podstawowa Nr 3|Tomaszów Lubelski|Matejki 5 |22-600 Tomaszów Lubelski;1536;745;745;23;722;48.50;3.09
88562;061801;Przedszkole Nr 2|Tomaszów Lubelski|Tomasza Zamojskiego 14 |22-600 Tomaszów Lubelski;1454;722;722;10;712;49.66;1.39
88563;061801;Gimnazjum Nr 1|Tomaszów Lubelski|Kopernika 4 |22-600 Tomaszów Lubelski;1519;753;753;23;730;49.57;3.05
88564;061801;Przedsiębiorstwo Gospodarki Komunalnej i Mieszkaniowej sp. z o.o.|Tomaszów Lubelski|Lwowska 37A |22-600 Tomaszów Lubelski;871;433;433;11;422;49.71;2.54
88565;061801;Komenda Powiatowa Państwowej Straży Pożarnej|Tomaszów Lubelski|Petera 7 |22-600 Tomaszów Lubelski;1603;860;860;10;850;53.65;1.16
88566;061801;Zespół Szkół Nr 3|Tomaszów Lubelski|Hallera 5 |22-600 Tomaszów Lubelski;1452;769;769;9;760;52.96;1.17
88567;061801;Przedszkole Nr 5|Tomaszów Lubelski|Moniuszki 51 |22-600 Tomaszów Lubelski;2300;1224;1224;17;1207;53.22;1.39
88568;061801;Samodzielny Publiczny Zespół Opieki Zdrowotnej|Tomaszów Lubelski|Aleje Grunwaldzkie 1 |22-600 Tomaszów Lubelski;202;57;57;6;51;28.22;10.53
88569;061802;Urząd Gminy|Bełżec|ul. Lwowska 5 |22-670 Bełżec;1450;600;600;33;567;41.38;5.50
88570;061802;Publiczne Gimnazjum|Bełżec|ul. Świerczewskiego 75 |22-670 Bełżec;760;268;268;5;263;35.26;1.87
88571;061802;Remizo - świetlica|Chyże| 46 |22-670 Bełżec;294;141;141;9;132;47.96;6.38
88572;061802;Remizo - świetlica|Brzeziny| 32 |22-670 Bełżec;243;108;108;4;104;44.44;3.70
88573;061803;Samorządowy Ośrodek Kultury w Jarczowie|Jarczów|ul. Piłsudskiego 2A |22-664 Jarczów;919;399;399;17;382;43.42;4.26
88574;061803;Szkoła Podstawowa w Wierszczycy|Wierszczyca| 54 |22-664 Jarczów;912;430;430;10;420;47.15;2.33
88575;061803;Szkoła Podstawowa w Gródku|Gródek| 35 |22-664 Jarczów;519;183;183;14;169;35.26;7.65
88576;061803;Szkoła Podstawowa w Chodywańcach|Chodywańce| 15 |22-664 Jarczów;604;232;232;12;220;38.41;5.17
88577;061804;Urząd Gminy w Krynicach|Krynice| 1 |22-610 Krynice;1129;496;496;18;478;43.93;3.63
88578;061804;Świetlica wiejska w Budach|Budy| 48A |22-610 Krynice;507;224;224;16;208;44.18;7.14
88579;061804;Niepubliczna Szkoła Podstawowa w Hucie Dzierążyńskiej|Huta Dzierążyńska| 17 |22-610 Krynice;487;237;237;14;223;48.67;5.91
88580;061804;Niepubliczna Szkoła Podstawowa w Zwiartowie|Zwiartów| 40 |22-610 Krynice;339;140;140;3;137;41.30;2.14
88581;061804;Świetlica wiejska w Dąbrowie|Dąbrowa| 34A |22-610 Krynice;353;151;151;12;139;42.78;7.95
88582;061805;Świetlica wiejska|Hrebenne| 86B |22-680 Lubycza Królewska;638;181;181;6;175;28.37;3.31
88583;061805;Zespół Szkół|Lubycza Królewska|ul. J. III Sobieskiego 5 |22-680 Lubycza Królewska;1663;658;658;31;627;39.57;4.71
88584;061805;Hala sportowa Zespołu Szkół|Lubycza Królewska|ul. Jana III Sobieskiego 5 |22-680 Lubycza Królewska;730;209;209;9;200;28.63;4.31
88585;061805;Świetlica RSP|Łazowa| 17A |22-680 Lubycza Królewska;283;91;91;6;85;32.16;6.59
88586;061805;Wiejski Dom Kultury|Żurawce|ul. Szkolna 7 |22-680 Lubycza Królewska;617;205;205;6;199;33.23;2.93
88587;061805;Stołówka Szkoły Podstawowej|Machnów Nowy|ul. 22 Lipca 4 |22-680 Lubycza Królewska;1359;357;357;31;326;26.27;8.68
88588;061806;Gminny Ośrodek Kultury|Łaszczów|ul. Partyzantów 12 |22-650 Łaszczów;988;433;433;26;407;43.83;6.00
88589;061806;Szkoła Podstawowa|Łaszczów|ul. Chopina 11 |22-650 Łaszczów;1074;505;505;24;481;47.02;4.75
88590;061806;Warsztat Terapii Zajęciowej|Muratyn| 49 |22-650 Łaszczów;279;124;124;5;119;44.44;4.03
88591;061806;Świetlica Wiejska|Dobużek-Kolonia| 4 |22-650 Łaszczów;428;164;164;13;151;38.32;7.93
88592;061806;Zespół Szkół Podstawowo-Gimnazjalnych|Nabróż-Kolonia| 19 |22-650 Łaszczów;373;167;167;3;164;44.77;1.80
88593;061806;Szkoła Podstawowa|Zimno| 1 |22-650 Łaszczów;457;142;142;4;138;31.07;2.82
88594;061806;Szkoła Filialna|Podlodów| 56 |22-650 Łaszczów;397;128;128;4;124;32.24;3.12
88595;061806;Szkoła Podstawowa|Pukarzów| 106 |22-650 Łaszczów;454;158;158;6;152;34.80;3.80
88596;061806;Świetlica Wiejska|Wólka Pukarzowska| 63 |22-650 Łaszczów;226;77;77;6;71;34.07;7.79
88597;061806;Szkoła Podstawowa|Steniatyn| 71 |22-650 Łaszczów;340;149;149;10;139;43.82;6.71
88598;061806;Świetlica Wiejska|Hopkie| 59 |22-650 Łaszczów;210;96;96;4;92;45.71;4.17
88599;061807;Gminny Ośrodek Kultury|Rachanie|ul. Partyzantów 60 |22-640 Rachanie;1048;515;515;5;510;49.14;0.97
88600;061807;Remizo - Świetlica|Pawłówka| |22-640 Rachanie;261;104;104;7;97;39.85;6.73
88601;061807;Szkoła Podstawowa|Grodysławice| 119 |22-640 Rachanie;376;162;162;7;155;43.09;4.32
88602;061807;Szkoła Podstawowa|Michalów| 117 |22-640 Rachanie;266;87;87;6;81;32.71;6.90
88603;061807;Remizo - Świetlica|Wożuczyn| 78A |22-640 Rachanie;875;314;314;12;302;35.89;3.82
88604;061807;Remizo - Świetlica|Siemierz| 65A |22-640 Rachanie;241;134;134;5;129;55.60;3.73
88605;061807;Dom Kultury|Wożuczyn-Cukrownia| |22-640 Rachanie;765;350;350;6;344;45.75;1.71
88606;061807;Remizo - Świetlica|Werechanie| 43 |22-640 Rachanie;355;152;152;5;147;42.82;3.29
88607;061807;Szkoła Podstawowa|Siemnice| 1 |22-640 Rachanie;274;127;127;3;124;46.35;2.36
88608;061808;Szkoła Podstawowa|Ciotusza Stara| 1B |22-672 Susiec;616;290;290;7;283;47.08;2.41
88609;061808;Szkoła Podstawowa|Grabowica| 72B |22-672 Susiec;832;427;427;14;413;51.32;3.28
88610;061808;Szkoła Podstawowa|Łosiniec| 23A |22-672 Susiec;1009;488;488;16;472;48.36;3.28
88611;061808;Zespół Szkół|Majdan Sopocki Pierwszy| 113 |22-672 Susiec;1118;464;464;21;443;41.50;4.53
88612;061808;Szkoła Podstawowa|Paary| 130 |22-672 Susiec;595;257;257;8;249;43.19;3.11
88613;061808;Gminny Ośrodek Kultury|Susiec|ul. Tomaszowska 100 |22-672 Susiec;1681;690;690;20;670;41.05;2.90
88614;061808;Szkoła Podstawowa|Łuszczacz| 1 |22-672 Susiec;472;222;222;7;215;47.03;3.15
88615;061809;Publiczne Gimnazjum w Tarnawatce|Tarnawatka|ul. Lubelska 62 |22-604 Tarnawatka;978;431;431;19;412;44.07;4.41
88616;061809;Przedszkole w Tarnawatce-Tartaku|Tarnawatka - Tartak|ul. Tomaszowska 13 1|22-604 Tarnawatka;897;408;408;11;397;45.48;2.70
88617;061809;Szkoła Podstawowa w Wieprzowie|Wieprzów Ordynacki| 13 |22-600 Tomaszów Lubelski;402;170;170;5;165;42.29;2.94
88618;061809;Szkoła Podstawowa w Hucie Tarnawackiej|Huta Tarnawacka| 30A |22-604 Tarnawatka;503;191;191;14;177;37.97;7.33
88619;061809;Świetlica wiejska w Niemirówku-Kolonii|Niemirówek-Kolonia| 41a |22-604 Tarnawatka;424;190;190;5;185;44.81;2.63
88620;061810;Szkoła Podstawowa im. Kardynała Stefana Wyszyńskiego w Telatynie|Telatyn|Kardynała Stefana Wyszyńskiego 22 |22-652 Telatyn;1045;526;526;16;510;50.33;3.04
88621;061810;Szkoła Podstawowa im. Fryderyka Chopina w Poturzynie|Poturzyn| 105 1|22-652 Telatyn;614;196;196;11;185;31.92;5.61
88622;061810;Świetlica Wiejska|Kryszyn| 20 |22-652 Telatyn;427;188;188;7;181;44.03;3.72
88623;061810;Świetlica Wiejska|Nowosiółki| 16a |22-652 Telatyn;871;326;326;13;313;37.43;3.99
88624;061810;Niepubliczna Szkoła Podstawowa|Żulice| 18 |22-652 Telatyn;499;217;217;7;210;43.49;3.23
88625;061811;Dom Strażaka|Łaszczówka|ul. Spółdzielcza 2 |22-600 Tomaszów Lubelski;836;368;368;12;356;44.02;3.26
88626;061811;Szkoła Podstawowa|Ulów| 93 |22-600 Tomaszów Lubelski;254;98;98;8;90;38.58;8.16
88627;061811;Zespół Szkół Publicznych|Sabaudia| 47 |22-600 Tomaszów Lubelski;997;367;367;11;356;36.81;3.00
88628;061811;Szkoła Podstawowa|Pasieki| 1 |22-600 Tomaszów Lubelski;500;212;212;4;208;42.40;1.89
88629;061811;Budynek po byłej Szkole Podstawowej|Ruda Wołoska|ul. Szkolna 11 |22-600 Tomaszów Lubelski;377;156;156;3;153;41.38;1.92
88630;061811;Wiejski Dom Kultury|Majdan Górny|ul. Długa 136 |22-600 Tomaszów Lubelski;930;408;408;10;398;43.87;2.45
88631;061811;Szkoła Podstawowa|Jeziernia| 110 |22-600 Tomaszów Lubelski;882;371;371;18;353;42.06;4.85
88632;061811;Gminny Ośrodek Kultury|Podhorce| 130 |22-600 Tomaszów Lubelski;826;400;400;16;384;48.43;4.00
88633;061811;Szkoła Podstawowa|Typin| 101 |22-600 Tomaszów Lubelski;312;138;138;4;134;44.23;2.90
88634;061811;Zespół Szkół Publicznych|Szarowola| 126 |22-600 Tomaszów Lubelski;575;311;311;14;297;54.09;4.50
88635;061811;Szkoła Podstawowa|Przeorsk| 113 |22-600 Tomaszów Lubelski;420;154;154;8;146;36.67;5.19
88636;061811;Świetlica Wiejska|Rogóźno|ul. Wyzwolenia 100 |22-600 Tomaszów Lubelski;1831;906;906;14;892;49.48;1.55
88637;061811;Świetlica Wiejska|Rabinówka| 112 |22-600 Tomaszów Lubelski;350;166;166;5;161;47.43;3.01
88638;061812;Szkoła Podstawowa|Tyszowce|ul. Kościelna 25 |22-630 Tyszowce;1426;616;616;16;600;43.20;2.60
88639;061812;Dom Pomocy Społecznej|Tyszowce|ul. Wielka 101 |22-630 Tyszowce;317;119;119;9;110;37.54;7.56
88640;061812;Szkoła Podstawowa|Tyszowce|ul. Kościelna 25 |22-630 Tyszowce;998;359;359;15;344;35.97;4.18
88641;061812;Szkoła Podstawowa|Przewale| 41A |22-630 Tyszowce;526;220;220;13;207;41.83;5.91
88642;061812;Szkoła Podstawowa|Czartowczyk| 43A |22-630 Tyszowce;343;184;184;5;179;53.64;2.72
88643;061812;Szkoła Podstawowa|Kazimierówka| 36 |22-630 Tyszowce;586;202;202;7;195;34.47;3.47
88644;061812;Szkoła Podstawowa|Perespa| 5 |22-630 Tyszowce;304;102;102;1;101;33.55;0.98
88645;061812;Budynek po byłej Szkole Podstawowej w Czartowcu|Czartowiec| 6 |22-630 Tyszowce;311;133;133;2;131;42.77;1.50
88646;061813;Budynek byłej Szkoły Podstawowej w Ulhówku|Ulhówek|ul. Tomaszowska 81 |22-678 Ulhówek;407;125;125;2;123;30.71;1.60
88647;061813;Zespół Szkół Publicznych w Ulhówku|Ulhówek|ul. Sadowa 3 |22-678 Ulhówek;971;369;369;13;356;38.00;3.52
88648;061813;Szkoła Podstawowa w Tarnoszynie|Tarnoszyn| 40 |22-678 Ulhówek;761;218;218;12;206;28.65;5.50
88649;061813;Świetlica Wiejska w Wasylowie Wielkim|Wasylów Wielki| 15 |22-678 Ulhówek;340;89;89;7;82;26.18;7.87
88650;061813;Świetlica Wiejska w Budyninie|Budynin| 50 |22-678 Ulhówek;232;39;39;1;38;16.81;2.56
88651;061813;Szkoła Podstawowa im. Artura Grottgera w Hubinku|Hubinek| 19 |22-678 Ulhówek;525;201;201;2;199;38.29;1.00
88652;061813;Remizo - Świetlica w Żernikach|Żerniki| 82 |22-678 Ulhówek;296;123;123;2;121;41.55;1.63
88653;061813;Świetlica Wiejska w Rzeplinie|Rzeplin| 60 |22-678 Ulhówek;295;122;122;4;118;41.36;3.28
88654;061813;Remizo - Świetlica w Korczminie|Korczmin| 39 |22-678 Ulhówek;358;128;128;7;121;35.75;5.47
88655;061901;Sala gimnastyczna Zespołu Szkół Zawodowych i II LO we Włodawie|Włodawa|ul. Modrzewskiego 24 |22-200 Włodawa;2261;1064;1064;19;1045;47.06;1.79
88656;061901;Sala konferencyjna Urzędu Miejskiego|Włodawa|Al. Józefa Piłsudskiego 41 |22-200 Włodawa;2138;961;961;29;932;44.95;3.02
88657;061901;Lokal świetlicy Szkoły Podstawowej nr 2|Włodawa|ul. Kopernika 3 |22-200 Włodawa;2340;1146;1146;13;1133;48.97;1.13
88658;061901;Lokal holu Miejska Biblioteka Publiczna|Włodawa|Przechodnia 13 |22-200 Włodawa;1995;881;881;11;870;44.16;1.25
88659;061901;Lokal holu Szkoły Podstawowej Nr 3|Włodawa|ul. Prof. Zbigniewa Sierpińskiego 4 |22-200 Włodawa;2270;1054;1055;16;1038;46.43;1.52
88660;061901;Świetlica Zakład Karny|Włodawa|Żołnierzy WiN 19 |22-200 Włodawa;431;164;164;12;152;38.05;7.32
88661;061901;Świetlica Szpitala we Włodawie|Włodawa|Piłsudskiego 64 |22-200 Włodawa;111;55;55;4;51;49.55;7.27
88662;061902;Gminny Ośrodek Kultury i Sportu w Hannie|Hanna| 42|22-220 Hanna;920;406;406;22;384;44.13;5.42
88663;061902;Wiejski Dom Kultury w Dołhobrodach|Dołhobrody| 83|22-220 Hanna;550;241;241;19;222;43.82;7.88
88664;061902;Szkoła Podstawowa w Dańcach|Dańce| 100|22-220 Hanna;648;225;225;13;212;34.72;5.78
88665;061902;Szkoła Podstawowa w Zaświatyczach|Zaświatycze| 46|22-220 Hanna;487;181;181;6;175;37.17;3.31
88666;061903;Dom Kultury w Dubecznie|Dubeczno|Szkolna 5 |22-235 Hańsk Pierwszy;826;282;282;14;268;34.14;4.96
88667;061903;Świetlica OSP w Osowie|Osowa| 55 |22-235 Hańsk Pierwszy;306;125;125;11;114;40.85;8.80
88668;061903;Gminny Ośrodek Kultury w Hańsku|Hańsk Pierwszy|Osiedlowa 6 |22-235 Hańsk Pierwszy;1488;633;633;27;606;42.54;4.27
88669;061903;Świetlica Wiejska w Kulczynie|Kulczyn| 68 |22-235 Hańsk Pierwszy;421;153;153;9;144;36.34;5.88
88670;061904;Centrum Kultury, Sportu i Rekreacji|Stary Brus| 34 |22-244 Stary Brus;897;399;399;11;388;44.48;2.76
88671;061904;OSP w Wołoskowoli|Wołoskowola| 60 |22-244 Stary Brus;363;156;156;7;149;42.98;4.49
88672;061904;Remiza OSP|Hola| 24 |22-244 Stary Brus;204;71;71;2;69;34.80;2.82
88673;061904;Świetlica wiejska|Dominiczyn| 40 |22-244 Stary Brus;311;113;113;4;109;36.33;3.54
88674;061905;Szkoła Podstawowa w Wytycznie|Wytyczno| 143 |22-234 Urszulin;513;226;226;7;219;44.05;3.10
88675;061905;Zespół Szkół w Urszulinie (Gimnazjum)|Urszulin|ul. Szkolna 23 |22-234 Urszulin;852;442;442;17;425;51.88;3.85
88676;061905;Świetlica OSP w Wereszczynie|Wereszczyn| 40 |22-234 Urszulin;442;183;183;11;172;41.40;6.01
88677;061905;Szkoła Podstawowa w Woli Wereszczyńskiej|Wola Wereszczyńska| 2 |22-234 Urszulin;483;190;190;15;175;39.34;7.89
88678;061905;Zespół Szkół w Urszulinie (Przedszkole)|Urszulin|Szkolna 23 |22-234 Urszulin;1135;529;529;18;511;46.61;3.40
88679;061906;Świetlica wiejska w Żłobku|Żłobek| 27 |22-200 Włodawa;102;41;41;1;40;40.20;2.44
88680;061906;Świetlica wiejska w Okunince|Okuninka| XIII-1 |22-200 Włodawa;375;166;166;3;163;44.27;1.81
88681;061906;Urząd Gminy Włodawa|Włodawa|Al. Jana Pawła II 22 |22-200 Włodawa;896;449;449;6;443;50.11;1.34
88682;061906;Świetlica wiejska w Żukowie|Żuków| 27 |22-200 Włodawa;440;195;195;10;185;44.32;5.13
88683;061906;Szkoła Podstawowa w Różance|Różanka| 213 |22-200 Włodawa;621;263;263;5;258;42.35;1.90
88684;061906;Dom Pomocy Społecznej w Różance|Różanka| 117B |22-200 Włodawa;410;129;129;16;113;31.46;12.40
88685;061906;Świetlica wiejska w Korolówce-Osada|Korolówka-Osada| 12 |22-200 Włodawa;311;105;105;4;101;33.76;3.81
88686;061906;Świetlica wiejska w Sobiborze|Sobibór| 39 A |22-200 Włodawa;311;97;97;1;96;31.19;1.03
88687;061906;Szkoła Podstawowa w Orchówku|Orchówek|Szkolna 35 |22-200 Włodawa;850;360;360;22;338;42.35;6.11
88688;061906;świetlica wiejska w Sobiborze Stacji|Sobibór| 103 |22-200 Włodawa;76;37;37;0;37;48.68;0.00
88689;061906;świetlica wiejska w Szumince|Szuminka| 36A |22-200 Włodawa;190;95;95;4;91;50.00;4.21
88690;061906;świetlica wiejska w Korolówce|Korolówka| 84a |22-200 Włodawa;337;131;131;6;125;38.87;4.58
88691;061907;Uhrusk 46 - świetlica|Uhrusk| 46 |22-230 Wola Uhruska;669;268;268;8;260;40.06;2.99
88692;061907;Wola Uhruska, ul. Parkowa 5 - Urząd Gminy Wola Uhruska|Wola Uhruska|ul. Parkowa 5 |22-230 Wola Uhruska;551;230;230;4;226;41.74;1.74
88693;061907;Wola Uhruska, ul. Gimnazjalna 34 - Gimnazjum im. Jana Pawła II|Wola Uhruska|ul. Gimnazjalna 34 |22-230 Wola Uhruska;486;192;192;10;182;39.51;5.21
88694;061907;Wola Uhruska, ul. Szkolna 2 - Szkoła Podstawowa im. J.I. Kraszewskiego|Wola Uhruska|ul. Szkolna 2 |22-230 Wola Uhruska;714;303;303;5;298;42.44;1.65
88695;061907;Stulno 89 - świetlica|Stulno| 89 |22-230 Wola Uhruska;527;186;186;8;178;35.29;4.30
88696;061907;Piaski 27 - świetlica|Piaski| 27 |22-230 Wola Uhruska;398;150;150;8;142;37.69;5.33
88697;061908;Urząd Gminy w Wyrykach|Wyryki-Połód| 154 |22-205 Wyryki;860;388;388;13;375;45.12;3.35
88698;061908;Świetlica wiejska w Suchawie|Suchawa| 8B |22-200 Włodawa;250;65;65;1;64;26.00;1.54
88699;061908;Świetlica wiejska w Lubieniu|Lubień| 99A |22-205 Wyryki;189;69;69;2;67;36.51;2.90
88700;061908;Filia Gminnej Biblioteki Publicznej w Horostycie|Horostyta| 51 |22-205 Wyryki;333;113;113;3;110;33.93;2.65
88701;061908;Szkoła Podstawowa w Kaplonosach|Kaplonosy| 73 |22-205 Wyryki;342;132;132;6;126;38.60;4.55
88702;061908;Świetlica OSP w Zahajkach|Zahajki| 11 |22-205 Wyryki;264;80;80;2;78;30.30;2.50
88703;061908;Samodzielny Publiczny Zakład Opieki Zdrowotnej Gruźlicy i Chorób Płuc w Adampolu|Adampol| 37 |22-200 Włodawa;55;23;23;3;20;41.82;13.04
88704;062001;Urząd Gminy|Adamów| 11b |22-442 Adamów;1104;493;493;25;468;44.66;5.07
88705;062001;Budynek byłej Szkoły Podstawowej|Rachodoszcze| 105 |22-442 Adamów;627;322;322;8;314;51.36;2.48
88706;062001;Zespół Szkół|Szewnia Górna| 21A |22-442 Adamów;500;218;218;14;204;43.60;6.42
88707;062001;Budynek byłej Szkoły Podstawowej|Bondyrz| 77A |22-442 Adamów;663;302;302;14;288;45.55;4.64
88708;062001;Zespół Szkół|Suchowola| 239 |22-442 Adamów;1103;484;484;18;466;43.88;3.72
88709;062002;Zespół Szkół|Grabowiec|ul. Wojsławska 1 |22-425 Grabowiec;1140;455;455;15;440;39.91;3.30
88710;062002;Gminny Ośrodek Kultury|Grabowiec|ul. Rynek 6 |22-425 Grabowiec;1200;420;420;18;402;35.00;4.29
88711;062002;była Szkoła Podstawowa|Ornatowice| 45 |22-425 Grabowiec;563;224;224;13;211;39.79;5.80
88712;062002;Remiza OSP|Tuczępy| |22-425 Grabowiec;755;253;253;10;243;33.51;3.95
88713;062003;Szkoła Podstawowa w Antoniówce|Antoniówka| 78 |22-435 Komarów-Osada;457;198;198;7;191;43.33;3.54
88714;062003;Świetlica wiejska w Zubowicach|Zubowice| 20 |22-435 Komarów-Osada;539;267;267;5;262;49.54;1.87
88715;062003;Szkoła Podstawowa w Komarowie-Osadzie|Komarów-Osada|ul. Kościuszki 2 |22-435 Komarów-Osada;742;366;366;4;362;49.33;1.09
88716;062003;Samorządowy Ośrodek Kultury w Komarowie-Osadzie|Komarów-Osada|Rynek 15 |22-435 Komarów-Osada;889;462;462;21;441;51.97;4.55
88717;062003;Świetlica wiejska w Komarowie-Wsi|Komarów-Wieś| 62 |22-435 Komarów-Osada;479;241;241;3;238;50.31;1.24
88718;062003;Centrum Integracji Społecznej w Janówce Zachodniej|Janówka Zachodnia| 23 |22-435 Komarów-Osada;376;178;178;8;170;47.34;4.49
88719;062003;Świetlica wiejska w Dubie|Dub| 50 |22-435 Komarów-Osada;482;196;196;12;184;40.66;6.12
88720;062003;Świetlica wiejska w Śniatyczach|Śniatycze| 44 |22-435 Komarów-Osada;406;184;184;8;176;45.32;4.35
88721;062004;Krasnobrodzki Dom Kultury|Krasnobród|ul. 3 Maja 26 |22-440 Krasnobród;1690;939;939;20;919;55.56;2.13
88722;062004;Dom Pomocy Społecznej w Krasnobrodzie|Krasnobród|ul. Sanatoryjna 34 |22-440 Krasnobród;402;238;238;14;224;59.20;5.88
88723;062004;Informacja Turystyczna w Krasnobrodzie|Krasnobród|ul. Tomaszowska 25 |22-440 Krasnobród;753;411;411;10;401;54.58;2.43
88724;062004;Warsztat Terapii Zajęciowej w Dominikanówce|Dominikanówka| 92 |22-440 Krasnobród;240;123;123;7;116;51.25;5.69
88725;062004;Budynek po byłej Szkole Podstawowej w Hutkowie|Hutków| |22-440 Krasnobród;330;150;150;2;148;45.45;1.33
88726;062004;Szkoła Podstawowa w Kaczórkach|Kaczórki| 92 |22-440 Krasnobród;439;225;225;3;222;51.25;1.33
88727;062004;Remiza OSP w Starej Hucie|Stara Huta| |22-440 Krasnobród;474;165;165;12;153;34.81;7.27
88728;062004;Remiza OSP w Wólce Husińskiej|Wólka Husińska| |22-440 Krasnobród;323;162;162;9;153;50.15;5.56
88729;062004;Szkoła w Zielonem|Zielone| |22-440 Krasnobród;327;157;157;12;145;48.01;7.64
88730;062004;Szkoła Podstawowa w Majdanie Wielkim|Majdan Wielki| |22-440 Krasnobród;816;381;381;15;366;46.69;3.94
88731;062004;Dom Pomocy Społecznej w Majdanie Wielkim|Majdan Wielki| |22-440 Krasnobród;43;32;32;8;24;74.42;25.00
88732;062005;Świetlica Wiejska|Barchaczów| 31 |22-437 Łabunie;618;306;306;12;294;49.51;3.92
88733;062005;Szkoła Podstawowa|Łabuńki Pierwsze| 178 |22-437 Łabunie;1284;701;701;13;688;54.60;1.85
88734;062005;Dom Kultury|Łabunie|ul. Parkowa 9 |22-437 Łabunie;1374;714;714;19;695;51.97;2.66
88735;062005;Świetlica Wiejska|Wólka Łabuńska| 118 |22-437 Łabunie;678;347;347;10;337;51.18;2.88
88736;062005;Szkoła Podstawowa|Ruszów| 79a |22-437 Łabunie;531;245;245;9;236;46.14;3.67
88737;062005;Remiza Strażacka|Majdan Ruszowski| 44 |22-437 Łabunie;238;135;135;2;133;56.72;1.48
88738;062005;Świetlica Wiejska|Wierzbie| 35 |22-437 Łabunie;293;150;150;2;148;51.19;1.33
88739;062006;Remiza Ochotniczej Straży Pożarnej w Świdnikach|Świdniki| 72 |22-455 Miączyn;674;200;200;10;190;29.67;5.00
88740;062006;Gimnazjum im. Jana Pawła II w Miączynie|Miączyn| 50A |22-455 Miączyn;1237;510;510;19;491;41.23;3.73
88741;062006;Szkoła Podstawowa w Niewirkowie|Niewirków| 157 |22-455 Miączyn;544;206;206;16;190;37.87;7.77
88742;062006;Szkoła Podstawowa w Kotlicach|Kotlice| 190 |22-455 Miączyn;574;192;192;10;182;33.45;5.21
88743;062006;Szkoła Podstawowa w Zawalowie|Zawalów| 144 |22-455 Miączyn;673;237;237;6;231;35.22;2.53
88744;062006;Remiza Ochotniczej Straży Pożarnej w Koniuchach|Koniuchy| 39 |22-455 Miączyn;428;171;171;5;166;39.95;2.92
88745;062006;Szkoła Podstawowa im. Bohaterów Wojska Polskiego w Horyszowie|Horyszów| 6 |22-455 Miączyn;440;170;170;8;162;38.64;4.71
88746;062006;Publiczna Szkoła Podstawowa im. Bł. ks. Zygmunta Pisarskiego w Gdeszynie-Kolonii|Gdeszyn-Kolonia| 139 |22-455 Miączyn;362;111;111;4;107;30.66;3.60
88747;062007;Szkoła Podstawowa w Nieliszu|Nielisz| 278 |22-413 Nielisz;1051;438;438;20;418;41.67;4.57
88748;062007;Gminny Ośrodek Pomocy Społecznej w Nieliszu z siedzibą w Krzaku|Krzak| 91 |22-413 Nielisz;592;245;245;15;230;41.39;6.12
88749;062007;Klub Kultury w Stawie Noakowskim|Staw Noakowski| 101 |22-413 Nielisz;1011;416;416;21;395;41.15;5.05
88750;062007;Dom Ludowy w Złojcu|Złojec| 138 |22-413 Nielisz;1064;428;428;25;403;40.23;5.84
88751;062007;Remiza OSP w Gruszce Dużej|Gruszka Duża| 2 |22-413 Nielisz;362;127;127;3;124;35.08;2.36
88752;062007;Wiejski Dom Kultury w Ruskich Piaskach|Ruskie Piaski| 115 |22-413 Nielisz;415;147;147;14;133;35.42;9.52
88753;062007;Remiza OSP w Ujazdowie|Ujazdów| 105 |22-413 Nielisz;288;70;70;6;64;24.31;8.57
88754;062008;Publiczne Gimnazjum|Radecznica|ul. Gwarna 4 |22-463 Radecznica;555;249;249;3;246;44.86;1.20
88755;062008;Szkoła Podstawowa|Zaburze| 100 |22-463 Radecznica;721;305;305;8;297;42.30;2.62
88756;062008;Urząd Gminy|Radecznica|ul. B.Prusa 21 |22-463 Radecznica;1084;445;445;15;430;41.05;3.37
88757;062008;Szkoła Podstawowa|Radecznica|ul. B.Prusa 65a |22-463 Radecznica;549;229;229;4;225;41.71;1.75
88758;062008;Szkoła Podstawowa|Gorajec-Stara Wieś| 114 |22-463 Radecznica;1234;566;566;16;550;45.87;2.83
88759;062008;Szkoła Podstawowa|Czarnystok| 129a |22-463 Radecznica;712;366;366;3;363;51.40;0.82
88760;062008;Samodzielny Publiczny Wojewódzki Szpital Psychiatryczny|Radecznica|Klasztorna 4 |22-463 Radecznica;278;40;40;8;32;14.39;20.00
88761;062009;Centrum Kultury w Sitnie|Sitno| 72 |22-424 Sitno;1381;663;664;21;642;48.01;3.17
88762;062009;Świetlica środowiskowa w Stanisławce|Stanisławka| 75 |22-424 Sitno;354;122;122;5;117;34.46;4.10
88763;062009;Szkoła Podstawowa w Kolonii Sitno|Kolonia Sitno| 51 |22-424 Sitno;848;326;326;6;320;38.44;1.84
88764;062009;Szkoła Podstawowa w Horyszowie Polskim|Horyszów Polski| 85 |22-424 Sitno;827;393;393;15;378;47.52;3.82
88765;062009;Szkoła Podstawowa w Jarosławcu|Jarosławiec| 190 |22-424 Sitno;1227;590;590;18;572;48.08;3.05
88766;062009;Szkoła Podstawowa w Cześnikach|Cześniki| 125 |22-242 Sitno;841;407;407;18;389;48.39;4.42
88767;062010;Gminny Ośrodek Kultury|Skierbieszów|ul. Zielona 3 |22-420 Skierbieszów;2131;984;984;29;955;46.18;2.95
88768;062010;Warsztat Terapii Zajęciowej|Lipina Stara| 48 |22-420 Skierbieszów;347;150;150;7;143;43.23;4.67
88769;062010;Dom Strażaka|Majdan Skierbieszowski| |22-420 Skierbieszów;306;124;124;3;121;40.52;2.42
88770;062010;Szkoła Podstawowa|Sulmice| 12 |22-420 Skierbieszów;573;254;254;13;241;44.33;5.12
88771;062010;Szkoła Podstawowa|Dębowiec| 178 |22-420 Skierbieszów;747;286;286;10;276;38.29;3.50
88772;062010;Dom Strażaka|Łaziska| |22-420 Skierbieszów;299;118;118;6;112;39.46;5.08
88773;062011;Szkoła Podstawowa Krasne|Krasne| 145 |22-417 Stary Zamość;460;231;231;8;223;50.22;3.46
88774;062011;Gimnazjum - Stary Zamość|Wierzba| 20a |22-417 Stary Zamość;1079;513;513;14;499;47.54;2.73
88775;062011;Garaż OSP Wierzba|Wierzba| 115 |22-417 Stary Zamość;834;398;398;13;385;47.72;3.27
88776;062011;Remiza OSP Chomęciska Małe|Chomęciska Małe| 20A |22-417 Stary Zamość;650;322;322;15;307;49.54;4.66
88777;062011;Szkoła Filialna Udrycze|Udrycze-Koniec| 12a |22-417 Stary Zamość;869;340;340;15;325;39.13;4.41
88778;062011;Dom Ludowy Chomęciska Duże Drugie|Chomęciska Duże| 140 |22-417 Stary Zamość;514;270;270;6;264;52.53;2.22
88779;062012;Zespół Szkół w Sułowie|Sułów| 64 |22-448 Sułów;605;231;231;7;224;38.18;3.03
88780;062012;Budynek Świetlicy GS"SCH" w Sułowie z/s w Deszkowicach Pierwszych|Deszkowice Pierwsze| 148 |22-448 Sułów;802;301;301;11;290;37.53;3.65
88781;062012;Budynek poszkolny w Sąsiadce|Sąsiadka| 203 |22-448 Sułów;540;198;198;5;193;36.67;2.53
88782;062012;Szkoła Podstawowa w Tworyczowie|Tworyczów| 124 |22-448 Sułów;943;339;339;3;336;35.95;0.88
88783;062012;Zespół Szkół w Michalowie|Michalów|ul. Osiedlowa 11 |22-448 Sułów;1012;383;383;10;373;37.85;2.61
88784;062013;Urząd Miejski|Szczebrzeszyn|Plac Kościuszki 1 |22-460 Szczebrzeszyn;1286;592;592;12;580;46.03;2.03
88785;062013;Miejski Dom Kultury|Szczebrzeszyn|Sądowa 3 |22-460 Szczebrzeszyn;984;385;385;13;372;39.13;3.38
88786;062013;Zespół Szkół nr 2 im. dr Z. Klukowskiego|Szczebrzeszyn|Zamojska 70 |22-460 Szczebrzeszyn;679;283;283;7;276;41.68;2.47
88787;062013;Szkoła Podstawowa Nr 3|Szczebrzeszyn|Zamojska 189 |22-460 Szczebrzeszyn;908;358;358;9;349;39.43;2.51
88788;062013;Remiza OSP|Szczebrzeszyn|Błonie 69 |22-460 Szczebrzeszyn;762;361;361;18;343;47.38;4.99
88789;062013;Szkoła Podstawowa|Bodaczów| 501 |22-460 Szczebrzeszyn;1738;647;647;16;631;37.23;2.47
88790;062013;Remiza OSP|Brody Małe| 25 |22-460 Szczebrzeszyn;469;199;199;1;198;42.43;0.50
88791;062013;Remiza OSP|Brody Duże| 56 |22-460 Szczebrzeszyn;477;200;200;5;195;41.93;2.50
88792;062013;Szkoła Podstawowa|Niedzieliska| 111 |22-460 Szczebrzeszyn;1067;408;408;20;388;38.24;4.90
88793;062013;Szkoła Podstawowa|Wielącza Poduchowna| 53 |22-460 Szczebrzeszyn;1180;510;510;14;496;43.22;2.75
88794;062013;Samodzielny Publiczny Zespół Opieki Zdrowotnej|Szczebrzeszyn|Doktora Klukowskiego 3 |22-460 Szczebrzeszyn;40;12;12;0;12;30.00;0.00
88795;062013;Dom Pomocy Społecznej "Pod Modrzewiami"|Szczebrzeszyn|Błonie 117 |22-460 Szczebrzeszyn;47;14;14;2;12;29.79;14.29
88796;062014;Szkoła Podstawowa|Mokre| 303 |22-400 Zamość;982;515;515;20;495;52.44;3.88
88797;062014;Zespół Szkół|Żdanów| 124 |22-400 Zamość;955;443;443;9;434;46.39;2.03
88798;062014;Zespół Szkół|Płoskie| 139 |22-400 Zamość;1728;832;832;16;816;48.15;1.92
88799;062014;Szkoła Podstawowa|Wólka Wieprzecka| 57 |22-470 Zwierzyniec;593;263;263;5;258;44.35;1.90
88800;062014;Szkoła Podstawowa|Białowola| 20 |22-400 Zamość;586;300;300;9;291;51.19;3.00
88801;062014;Szkoła Podstawowa|Lipsko| 126 |22-400 Zamość;688;293;293;17;276;42.59;5.80
88802;062014;Zespół Szkoły Podstawowej i Przedszkola|Kalinowice| 148A |22-400 Zamość;1463;833;833;2;831;56.94;0.24
88803;062014;Świetlica Wiejska|Białobrzegi| 19A |22-400 Zamość;934;351;351;9;342;37.58;2.56
88804;062014;Zespół Szkół|Wysokie| 133 |22-400 Zamość;1062;501;501;3;498;47.18;0.60
88805;062014;Szkoła Podstawowa|Borowina Sitaniecka| 49 |22-400 Zamość;813;364;364;12;352;44.77;3.30
88806;062014;Zespół Szkół|Sitaniec| 422 |22-400 Zamość;1675;814;814;17;797;48.60;2.09
88807;062014;Szkoła Podstawowa|Zawada| 46 |22-400 Zamość;1536;703;703;19;684;45.77;2.70
88808;062014;Świetlica Wiejska|Szopinek| 65 |22-400 Zamość;667;343;343;9;334;51.42;2.62
88809;062014;Budynek byłej Szkoły Podstawowej Wychody|Wieprzec| 8 |22-400 Zamość;468;219;219;0;219;46.79;0.00
88810;062014;Świetlica Wiejska|Jatutów| 118 |22-400 Zamość;563;277;277;12;265;49.20;4.33
88811;062014;Szkoła Podstawowa|Pniówek| 133 |22-400 Zamość;735;352;352;9;343;47.89;2.56
88812;062014;Budynek byłej Szkoły Podstawowej|Siedliska| 47 |22-400 Zamość;417;185;185;1;184;44.36;0.54
88813;062014;Budynek byłej Szkoły Podstawowej|Lipsko-Polesie| 19 |22-400 Zamość;309;88;88;6;82;28.48;6.82
88814;062014;Świetlica Wiejska|Skokówka|ul. Targowa 32 |22-400 Zamość;801;482;482;10;472;60.17;2.07
88815;062014;Zespół Szkół|Sitaniec| 422 |22-400 Zamość;596;299;299;7;292;50.17;2.34
88816;062014;Zespół Szkoły Podstawowej i Przedszkola|Kalinowice| 148A |22-400 Zamość;498;274;274;4;270;55.02;1.46
88817;062015;Zespół Szkół Drzewnych i Ochrony Środowiska|Zwierzyniec|ul. Browarna 1 |22-470 Zwierzyniec;1649;754;754;20;734;45.72;2.65
88818;062015;Gimnazjum Publiczne|Zwierzyniec|ul. Armii Krajowej 36 |22-470 Zwierzyniec;1430;605;605;15;590;42.31;2.48
88819;062015;Szkoła Filialna|Wywłoczka| 153 |22-470 Zwierzyniec;1217;404;404;9;395;33.20;2.23
88820;062015;Szkoła Filialna|Obrocz| 73 |22-470 Zwierzyniec;809;277;277;16;261;34.24;5.78
88821;062015;Szkoła Filialna|Żurawnica| 85 |22-470 Zwierzyniec;644;255;255;6;249;39.60;2.35
88822;066101;Przedszkole Samorządowe nr 11|Biała Podlaska|ul. Sidorska 20 |21-500 Biała Podlaska;1636;866;866;15;851;52.93;1.73
88823;066101;Szkoła Podstawowa nr 5|Biała Podlaska|ul. Sidorska 30 |21-500 Biała Podlaska;1554;713;713;10;703;45.88;1.40
88824;066101;Lubelskie Samorządowe Centrum Doskonalenia Nauczycieli|Biała Podlaska|ul. Kolejowa 8 |21-500 Biała Podlaska;1477;702;702;9;693;47.53;1.28
88825;066101;Przedszkole Samorządowe nr 7|Biała Podlaska|ul. Ludwika Waryńskiego 1 |21-500 Biała Podlaska;1359;739;739;12;727;54.38;1.62
88826;066101;Przedszkole Samorządowe nr 14|Biała Podlaska|ul. Łukaszyńska 34 |21-500 Biała Podlaska;1617;882;882;11;871;54.55;1.25
88827;066101;Zespół Szkół Ogólnokształcących nr 2|Biała Podlaska|ul. Leszczynowa 16 |21-500 Biała Podlaska;1838;1009;1009;23;986;54.90;2.28
88828;066101;Klub Kultury "EUREKA"|Biała Podlaska|ul. Orzechowa 34 |21-500 Biała Podlaska;1578;831;831;28;803;52.66;3.37
88829;066101;Państwowa Szkoła Wyższa|Biała Podlaska|ul. Sidorska 95/97 |21-500 Biała Podlaska;944;449;449;8;441;47.56;1.78
88830;066101;Społeczna Szkoła Podstawowa|Biała Podlaska|ul. Mariana Langiewicza 44 |21-500 Biała Podlaska;1036;453;453;6;447;43.73;1.32
88831;066101;Zespół Szkół Zawodowych nr 1|Biała Podlaska|ul. marsz. Józefa Piłsudskiego 36 |21-500 Biała Podlaska;1104;554;554;13;541;50.18;2.35
88832;066101;Zespół Szkół Ogólnokształcących nr 3|Biała Podlaska|ul. Gabriela Narutowicza 39 |21-500 Biała Podlaska;827;420;420;4;416;50.79;0.95
88833;066101;Szkoła Podstawowa nr 4|Biała Podlaska|ul. Stanisława Moniuszki 36 |21-500 Biała Podlaska;2037;986;986;14;972;48.40;1.42
88834;066101;Zespół Szkół Zawodowych nr 2|Biała Podlaska|ul. Brzeska 71 |21-500 Biała Podlaska;2404;1380;1380;19;1361;57.40;1.38
88835;066101;Centrum Profilaktyki i Terapii "Arka"|Biała Podlaska|ul. Stacyjna 6 |21-500 Biała Podlaska;1820;957;957;19;938;52.58;1.99
88836;066101;Przychodnia Lekarska|Biała Podlaska|ul. Jana Czerwińskiego 25 |21-500 Biała Podlaska;1572;855;855;11;844;54.39;1.29
88837;066101;PPHU "TRANSBET"|Biała Podlaska|ul. Grzybowa 52A |21-500 Biała Podlaska;2284;1221;1221;34;1187;53.46;2.78
88838;066101;Szkoła Podstawowa nr 3|Biała Podlaska|ul. Sportowa 7 |21-500 Biała Podlaska;2040;1126;1126;9;1117;55.20;0.80
88839;066101;Przedszkole Samorządowe nr 3|Biała Podlaska|ul. Warszawska 19c |21-500 Biała Podlaska;1932;1063;1063;17;1046;55.02;1.60
88840;066101;Klub Kultury "PIAST"|Biała Podlaska|ul. Spółdzielcza 4 |21-500 Biała Podlaska;1899;1098;1098;16;1082;57.82;1.46
88841;066101;Szkoła Podstawowa nr 2|Biała Podlaska|ul. Akademicka 8 |21-500 Biała Podlaska;2242;1407;1407;11;1396;62.76;0.78
88842;066101;Przedszkole Samorządowe nr 13|Biała Podlaska|ul. Kazimierza Jagiellończyka 17 |21-500 Biała Podlaska;2151;1192;1192;7;1185;55.42;0.59
88843;066101;Szkoła Podstawowa nr 9|Biała Podlaska|ul. Zygmunta Augusta 2 |21-500 Biała Podlaska;2184;1164;1164;13;1151;53.30;1.12
88844;066101;Przedszkole Samorządowe nr 17|Biała Podlaska|ul. Zygmunta Starego 4 |21-500 Biała Podlaska;2028;1084;1084;9;1075;53.45;0.83
88845;066101;Medyczne Studium Zawodowe|Biała Podlaska|ul. Okopowa 3 |21-500 Biała Podlaska;1716;946;946;24;922;55.13;2.54
88846;066101;Katolickie Liceum Ogólnokształcące|Biała Podlaska|ul. Janowska 55 |21-500 Biała Podlaska;1714;919;919;7;912;53.62;0.76
88847;066101;Samorządowe Przedszkole Integracyjne nr 16|Biała Podlaska|ul. Wesoła 21-23 |21-500 Biała Podlaska;634;363;363;2;361;57.26;0.55
88848;066101;Pol - Kres Edwood|Biała Podlaska|ul. Łomaska 86 |21-500 Biała Podlaska;1553;614;614;16;598;39.54;2.61
88849;066101;Wojewódzki Szpital Specjalistyczny|Biała Podlaska|ul. Terebelska 57-65 |21-500 Biała Podlaska;273;116;116;5;111;42.49;4.31
88850;066101;Zakład Karny|Biała Podlaska|ul. Prosta 33 |21-500 Biała Podlaska;207;128;128;34;94;61.84;26.56
88851;066201;P.H.U. Majami (lokal obok stacji CPN)|Chełm|ul. Włodawska 5 |22-100 Chełm;1231;840;840;15;825;68.24;1.79
88852;066201;Budynek Zepołu Szkół Ogólnokształcących Nr 7|Chełm|ul. Synów Pułku 15 |22-100 Chełm;2022;1052;1052;25;1027;52.03;2.38
88853;066201;Budynek Przedszkola Miejskiego nr 10|Chełm|ul. Zachodnia 49 |22-100 Chełm;2058;1068;1068;21;1047;51.90;1.97
88854;066201;Budynek Zespołu Szkolno-Przeszkolnego nr 3 z Oddziałami Integracyjnymi|Chełm|ul. Rejowiecka 76 |22-100 Chełm;1550;739;739;15;724;47.68;2.03
88855;066201;Budynek Medycznego Studium Zawodowego|Chełm|ul. Szpitalna 50 |22-100 Chełm;1698;775;775;7;768;45.64;0.90
88856;066201;Budynek II Liceum Ogólnokształcącego|Chełm|ul. Szpitalna 14 |22-100 Chełm;614;326;326;2;324;53.09;0.61
88857;066201;Budynek Zespołu Wychowania i Pomocy Psychologiczno-Pedagogicznej nr 1|Chełm|ul. Trubakowska 59 |22-100 Chełm;1461;638;638;15;623;43.67;2.35
88858;066201;Budynek Przedszkola Miejskiego nr 11|Chełm|al. Marszałka Józefa Piłsudskiego 25a |22-100 Chełm;2046;1017;1017;24;993;49.71;2.36
88859;066201;Budynek Zespołu Szkół Ogólnokształcących nr 1 z Oddziałami Integracyjnymi|Chełm|ul. Wołyńska 1 |22-100 Chełm;1384;718;718;15;703;51.88;2.09
88860;066201;Budynek Miejskiego Samodzielnego Publicznego Zakładu Opieki Zdrowotnej Przychodnia Rejonowa nr 1|Chełm|ul. Wołyńska 11 |22-100 Chełm;1614;781;781;12;769;48.39;1.54
88861;066201;Budynek Chełmskiego Domu Kultury|Chełm|Plac Tysiąclecia Państwa Polskiego 1 |22-100 Chełm;2050;969;969;18;951;47.27;1.86
88862;066201;Budynek, Klub "CHAESEMUS" Chełmskiej Spółdzielni Mieszkaniowej|Chełm|ul. Starościńska 4a |22-100 Chełm;1455;759;759;9;750;52.16;1.19
88863;066201;Budynek Językowego Przedszkola Integracyjnego "W Kasztanowym Parku"|Chełm|ul. Lubelska 4 |22-100 Chełm;1538;629;629;7;622;40.90;1.11
88864;066201;Budynek Szkoły Podstawowej nr 10|Chełm|ul. Reformacka 13 |22-100 Chełm;1516;676;676;13;663;44.59;1.92
88865;066201;Budynek Przedszkola Miejskiego nr 5|Chełm|ul. Kwiatowa 1 |22-100 Chełm;1564;695;695;10;685;44.44;1.44
88866;066201;Budynek Szkoły Podstawowej nr 2|Chełm|ul. Obłońska 51 |22-100 Chełm;1612;721;721;17;704;44.73;2.36
88867;066201;Budynek I Liceum Ogólnokształcącego|Chełm|ul. Stefana Czarnieckiego 8 |22-100 Chełm;938;392;393;5;387;41.79;1.28
88868;066201;Budynek Zespołu Szkół Budowlanych i Geodezyjnych|Chełm|ul. Stefana Batorego 1 |22-100 Chełm;1069;476;476;9;467;44.53;1.89
88869;066201;Budynek Miejskiego Przedsiębiorstwa Gospodarki Komunalnej Sp. z o.o.|Chełm|ul. Wołyńska 57 |22-100 Chełm;2004;933;941;14;919;46.56;1.50
88870;066201;Budynek Zespołu Szkół Zawodowych nr 5|Chełm|ul. Jagielońska 29 |22-100 Chełm;461;228;228;4;224;49.46;1.75
88871;066201;Budynek Przedszkola Niepublicznego z Oddziałami Integracyjnymi "Razem"|Chełm|ul. Botaniczna 16 |22-100 Chełm;1809;1029;1029;9;1020;56.88;0.87
88872;066201;Budynek Szkoły Podstawowej nr 4|Chełm|ul. Prymasa Stefana Wyszyńskiego 15 |22-100 Chełm;979;493;493;8;485;50.36;1.62
88873;066201;Budynek Centrum handlowego "Wschód" S.A.|Chełm|ul. Hrubieszowska 102 |22-100 Chełm;1583;835;835;5;830;52.75;0.60
88874;066201;Budynek Państwowej Wyższej Szkoły Zawodowej|Chełm|ul. Wojsławicka 8b |22-100 Chełm;1310;649;649;11;638;49.54;1.69
88875;066201;Budynek Zespołu Szkół Ogólnokształcących nr 6|Chełm|ul. Powstańców Warszawy 10 |22-100 Chełm;1768;908;908;11;897;51.36;1.21
88876;066201;Budynek Przedszkola Miejskiego nr 14|Chełm|ul. Generała Stefana Grota-Roweckiego 4b |22-100 Chełm;1946;1047;1047;13;1034;53.80;1.24
88877;066201;Budynek Przedszkola Miejskiego nr 15|Chełm|ul. Henryka Wieniawskiego 3 |22-100 Chełm;1585;799;799;18;781;50.41;2.25
88878;066201;Budynek Biblioteki Pedagogicznej|Chełm|ul. Henryka Wieniawskiego 15 |22-100 Chełm;2107;1138;1138;12;1126;54.01;1.05
88879;066201;Budynek Lokalu HSM Sp. z o.o. Zawadówka (była kaplica Parafii pw. Świętej Rodziny)|Chełm|ul. Karola Szymanowskiego 6 |22-100 Chełm;1591;808;808;11;797;50.79;1.36
88880;066201;Budynek Przedszkola Miejskiego Nr 13 z Oddziałami Integracyjnymi|Chełm|ul. Połaniecka 5 |22-100 Chełm;1662;835;835;25;810;50.24;2.99
88881;066201;Budynek Szkoły Podstawowej Nr 11|Chełm|ul. Wolności 20 |22-100 Chełm;1754;904;904;8;896;51.54;0.88
88882;066201;Budynek Zespołu Szkół Ogólnokształcących Nr 8 z Oddziałami Sportowymi|Chełm|ul. Połaniecka 10 |22-100 Chełm;1496;782;782;13;769;52.27;1.66
88883;066201;Budynek Spółdzielni Mieszkaniowej "Bazylany"|Chełm|Aleja 3 Maja 6 |22-100 Chełm;1658;882;882;13;869;53.20;1.47
88884;066201;Budynek Przedszkola Miejskiego Nr 8|Chełm|ul. Mkołaja Reja 54 |22-100 Chełm;765;258;258;4;254;33.73;1.55
88885;066201;Zakład karny|Chełm|Kolejowa 112 |22-100 chełm;639;223;223;55;168;34.90;24.66
88886;066201;Samodzielny Publiczny Wojewódzki Szpital Specjalistyczny|Chełm|Ceramiczna 1 |22-100 Chełm;546;146;146;2;144;26.74;1.37
88887;066301;Przedszkole nr 43|Lublin|ul. Skautów 11a |20-055 Lublin;1255;764;764;8;756;60.88;1.05
88888;066301;Gimnazjum nr 18 im. Macieja Rataja|Lublin|al. Jana Długosza 8 |20-054 Lublin;1496;965;965;11;954;64.51;1.14
88889;066301;Szkoła Podstawowa nr 21 im. Królowej Jadwigi|Lublin|ul. Zuchów 1 |20-047 Lublin;2106;1284;1284;12;1272;60.97;0.93
88890;066301;Bursa Szkolna nr 1|Lublin|ul. Księdza Jerzego Popiełuszki 7 |20-052 Lublin;2058;1291;1291;7;1284;62.73;0.54
88891;066301;Przedszkole nr 65|Lublin|ul. Mariana Langiewicza 3a |20-032 Lublin;1644;957;957;4;953;58.21;0.42
88892;066301;I Liceum Ogólnokształcące im. Stanisława Staszica|Lublin|Al. Racławickie 26 |20-043 Lublin;736;434;434;7;427;58.97;1.61
88893;066301;Szkoła Podstawowa nr 6 im. Romualda Traugutta|Lublin|ul. Czwartaków 11 |20-045 Lublin;783;545;545;2;543;69.60;0.37
88894;066301;Bursa Szkolna nr 3|Lublin|ul. Weteranów 3 |20-038 Lublin;563;365;365;0;365;64.83;0.00
88895;066301;Szkoła Podstawowa nr 25 im. Władysława Broniewskiego|Lublin|ul. Sieroca 17 |20-089 Lublin;1772;1089;1089;4;1085;61.46;0.37
88896;066301;IV Liceum Ogólnokształcące im. Stefanii Sempołowskiej|Lublin|ul. Szkolna 4 |20-124 Lublin;1465;627;627;12;615;42.80;1.91
88897;066301;Polski Związek Motorowy|Lublin|ul. Bolesława Prusa 8 |20-064 Lublin;1275;630;630;5;625;49.41;0.79
88898;066301;Gimnazjum nr 19 im. Józefa Czechowicza|Lublin|ul. Szkolna 6 |20-124 Lublin;826;279;279;5;274;33.78;1.79
88899;066301;Urząd Miasta Lublin|Lublin|ul. Wieniawska 14 |20-071 Lublin;748;380;380;1;379;50.80;0.26
88900;066301;II Liceum Ogólnokształcące im. Hetmana Jana Zamoyskiego|Lublin|ul. Ogrodowa 16 |20-075 Lublin;1036;602;602;16;586;58.11;2.66
88901;066301;Szkoła Podstawowa nr 24 im. Partyzantów Lubelszczyzny|Lublin|ul. Niecała 1 |20-080 Lublin;1088;547;547;5;542;50.28;0.91
88902;066301;Instytut Informatyki UMCS|Lublin|ul. Akademicka 9 |20-033 Lublin;672;451;451;2;449;67.11;0.44
88903;066301;V Liceum Ogólnokształcące im. Marii Skłodowskiej-Curie|Lublin|ul. Lipowa 7 |20-020 Lublin;667;330;330;3;327;49.48;0.91
88904;066301;Centrum Kultury w Lublinie|Lublin|ul. Peowiaków 12 |20-007 Lublin;1408;748;748;13;735;53.12;1.74
88905;066301;Zespół Szkół Ekonomicznych im. Augusta i Juliusza Vetterów|Lublin|ul. Bernardyńska 14 |20-109 Lublin;817;378;378;10;368;46.27;2.65
88906;066301;Gimnazjum nr 9 im. cc majora Hieronima Dekutowskiego ps. "Zapora"|Lublin|ul. Lipowa 25 |20-020 Lublin;1308;758;758;7;751;57.95;0.92
88907;066301;Wojewódzki Ośrodek Kultury|Lublin|ul. Dolna Panny Marii 3 |20-010 Lublin;832;370;370;4;366;44.47;1.08
88908;066301;III Liceum Ogólnokształcące im. Unii Lubelskiej|Lublin|Plac Wolności 4 |20-005 Lublin;721;321;321;1;320;44.52;0.31
88909;066301;Szkoła Muzyczna I i II st. im. Tadeusza Szeligowskiego|Lublin|ul. Prezydenta Gabriela Narutowicza 32a |20-016 Lublin;857;503;503;6;497;58.69;1.19
88910;066301;DOM Spółka z o.o. Administrowanie i Zarządzanie Nieruchomościami|Lublin|ul. Głęboka 17 |20-612 Lublin;749;430;430;9;421;57.41;2.09
88911;066301;Szkoła Podstawowa nr 7 im. ks. Jana Twardowskiego|Lublin|ul. Plażowa 9 |20-620 Lublin;1108;659;659;6;653;59.48;0.91
88912;066301;"ADE-EM" Centrum Sp. z o.o.|Lublin|ul. Lubartowska 27-29 |20-116 Lublin;841;297;297;6;291;35.32;2.02
88913;066301;Zarząd Nieruchomości Komunalnych|Lublin|ul. Grodzka 12 |20-112 Lublin;646;233;233;4;229;36.07;1.72
88914;066301;Zespół Szkół nr 1 im. Władysława Grabskiego|Lublin|ul. Podwale 11 |20-117 Lublin;463;260;260;0;260;56.16;0.00
88915;066301;Zespół Szkół nr 4 im. Janusza Korczaka|Lublin|ul. Bronowicka 21 |20-301 Lublin;1760;716;716;14;702;40.68;1.96
88916;066301;Szkoła Podstawowa nr 31 im. Lotników Polskich|Lublin|ul. Lotnicza 1 |20-322 Lublin;812;336;336;7;329;41.38;2.08
88917;066301;Szkoła Podstawowa nr 31 im. Lotników Polskich|Lublin|ul. Lotnicza 1 |20-322 Lublin;1576;872;872;13;859;55.33;1.49
88918;066301;Dzielnicowy Dom Kultury BRONOWICE|Lublin|ul. Krańcowa 106 |20-320 Lublin;1939;1019;1019;12;1007;52.55;1.18
88919;066301;Administracja Osiedla "POGODNA"|Lublin|ul. Zimowa 5 |20-337 Lublin;1827;1079;1079;14;1065;59.06;1.30
88920;066301;Gimnazjum nr 14 im. 27. Wołyńskiej Dywizji Piechoty Armii Krajowej|Lublin|ul. Pogodna 19 |20-337 Lublin;1994;1038;1038;13;1025;52.06;1.25
88921;066301;Gimnazjum nr 14 im. 27. Wołyńskiej Dywizji Piechoty Armii Krajowej|Lublin|ul. Pogodna 19 |20-337 Lublin;1241;606;606;1;605;48.83;0.17
88922;066301;VIII Liceum Ogólnokształcące im. Zofii Nałkowskiej|Lublin|ul. Słowicza 5 |20-336 Lublin;936;603;603;4;599;64.42;0.66
88923;066301;Dom Pomocy Społecznej "Betania"|Lublin|al. Kraśnicka 223 |20-718 Lublin;633;466;466;4;462;73.62;0.86
88924;066301;Dzielnicowy Dom Kultury "Węglin"|Lublin|ul. Judyma 2a |20-716 Lublin;750;529;529;3;526;70.53;0.57
88925;066301;Dzielnicowy Dom Kultury "Węglin"|Lublin|ul. Judyma 2a |20-716 Lublin;1487;895;895;5;890;60.19;0.56
88926;066301;Siedziba Rady i Zarządu Dzielnicy SZEROKIE|Lublin|ul. Nałęczowska 94 |20-831 Lublin;1153;769;769;7;762;66.70;0.91
88927;066301;Lubelskie Hospicjum dla Dzieci im. "Małego Księcia"|Lublin|ul. Lędzian 49 |20-828 Lublin;1236;842;842;6;836;68.12;0.71
88928;066301;Zespół Szkół Elektronicznych|Lublin|ul. Wojciechowska 38 |20-704 Lublin;948;668;668;1;667;70.46;0.15
88929;066301;Zespół Szkół Elektronicznych|Lublin|ul. Wojciechowska 38 |20-704 Lublin;1737;1087;1087;7;1080;62.58;0.64
88930;066301;Gimnazjum nr 7 im. Jana Kochanowskiego|Lublin|ul. Zygmunta Krasińskiego 7 |20-709 Lublin;2045;1378;1378;9;1369;67.38;0.65
88931;066301;Wojewódzki Szpital Specjalistyczny im. Stefana Kardynała Wyszyńskiego SP ZOZ|Lublin|al. Kraśnicka 100 |20-718 Lublin;2128;1326;1326;8;1318;62.31;0.60
88932;066301;Szkoła Podstawowa nr 3 im. Juliusza Słowackiego|Lublin|ul. Balladyny 22 |20-601 Lublin;1881;1137;1137;10;1127;60.45;0.88
88933;066301;Przedszkole Integracyjne nr 39 w Lublinie|Lublin|ul. Balladyny 14 |20-601 Lublin;1022;627;627;9;618;61.35;1.44
88934;066301;Szkoła Podstawowa nr 29 im. Adama Mickiewicza|Lublin|ul. Wajdeloty 1 |20-604 Lublin;895;596;596;0;596;66.59;0.00
88935;066301;Gimnazjum nr 10 im. księdza Jana Twardowskiego|Lublin|ul. Wajdeloty 12 |20-604 Lublin;1028;718;718;7;711;69.84;0.97
88936;066301;LSM DOM KULTURY|Lublin|ul. Konrada Wallenroda 4a |20-607 Lublin;1280;822;822;7;815;64.22;0.85
88937;066301;Przedszkole nr 33 im. Kubusia Puchatka|Lublin|ul. Grażyny 10 |20-605 Lublin;1027;688;688;4;684;66.99;0.58
88938;066301;Przedszkole nr 47|Lublin|ul. Mieszka I nr 3 |20-610 Lublin;1263;809;809;5;804;64.05;0.62
88939;066301;Młodzieżowy Dom Kultury "Pod Akacją"|Lublin|ul. Bolesława Chrobrego 18 |20-611 Lublin;1660;1046;1046;11;1035;63.01;1.05
88940;066301;Zespół Przedszkolny nr 1|Lublin|ul. Zachodnia 7 |20-620 Lublin;1518;890;890;6;884;58.63;0.67
88941;066301;Spółdzielnia Mieszkaniowa "SPÓŁDZIELCA"|Lublin|ul. Nadbystrzycka 25 |20-618 Lublin;1448;812;812;14;798;56.08;1.72
88942;066301;Przedszkole nr 48|Lublin|ul. Leonarda 15 |20-625 Lublin;1014;608;608;18;590;59.96;2.96
88943;066301;Szkoła Podstawowa nr 38 im. Henryka Sienkiewicza|Lublin|ul. Pana Wołodyjowskiego 13 |20-627 Lublin;1157;740;740;9;731;63.96;1.22
88944;066301;Przedszkole nr 46|Lublin|ul. Pana Wołodyjowskiego 1 |20-627 Lublin;1240;788;788;6;782;63.55;0.76
88945;066301;Administracja Osiedla im. M. Konopnickiej|Lublin|ul. Jana Sawy 3 |20-632 Lublin;2053;1339;1339;5;1334;65.22;0.37
88946;066301;Przedszkole nr 49|Lublin|ul. Pana Balcera 11 |20-631 Lublin;1774;1141;1141;7;1134;64.32;0.61
88947;066301;Przedszkole nr 57|Lublin|ul. Ignacego Rzeckiego 12 |20-637 Lublin;1892;1226;1226;4;1222;64.80;0.33
88948;066301;Zespół Szkół Ogólnokształcących nr 5|Lublin|ul. Ignacego Rzeckiego 10 |20-637 Lublin;1884;1145;1145;9;1136;60.77;0.79
88949;066301;POLITECHNIKA LUBELSKA Wydział Mechaniczny|Lublin|ul. Nadbystrzycka 36 |20-618 Lublin;1941;1109;1109;11;1098;57.14;0.99
88950;066301;Zespół Szkół Ogólnokształcących nr 6|Lublin|ul. Krochmalna 29 |20-401 Lublin;705;329;329;7;322;46.67;2.13
88951;066301;Zespół Szkół Ogólnokształcących nr 6|Lublin|ul. Krochmalna 29 |20-401 Lublin;681;252;252;7;245;37.00;2.78
88952;066301;Szkoła Podstawowa nr 20 im. Jarosława Dąbrowskiego|Lublin|al. Józefa Piłsudskiego 26 |20-407 Lublin;692;276;276;12;264;39.88;4.35
88953;066301;"AD-BUD" Sp. z o.o.|Lublin|ul. Gazowa 7/9 |20-406 Lublin;821;294;294;8;286;35.81;2.72
88954;066301;Przedszkole nr 85|Lublin|ul. Onyksowa 8 |20-582 Lublin;1151;779;779;1;778;67.68;0.13
88955;066301;Szkoła Języka Angielskiego FIVE|Lublin|ul. Gęsia 23 |20-719 Lublin;1557;1007;1007;7;1000;64.68;0.70
88956;066301;Zespół Szkół nr 7|Lublin|ul. Roztocze 14 |20-722 Lublin;977;707;707;7;700;72.36;0.99
88957;066301;Zespół Szkół nr 7|Lublin|ul. Roztocze 14 |20-722 Lublin;1791;1298;1298;5;1293;72.47;0.39
88958;066301;Administracja Osiedla "BŁONIE"|Lublin|ul. Dragonów 2 |20-554 Lublin;1720;1083;1083;3;1080;62.97;0.28
88959;066301;Biuro Obsługi Mieszkańców|Lublin|ul. Szaserów 13-15 |20-553 Lublin;2192;1337;1337;18;1319;60.99;1.35
88960;066301;Szkoła Podstawowa nr 42 im. K. Ildefonsa Gałczyńskiego|Lublin|ul. Rycerska 9 |20-552 Lublin;1814;1114;1114;15;1099;61.41;1.35
88961;066301;Przedszkole nr 69|Lublin|ul. Dziewanny 19 |20-539 Lublin;2142;1379;1379;14;1365;64.38;1.02
88962;066301;Szkoła Podstawowa nr 46 im. Króla Jana III Sobieskiego|Lublin|ul. Biedronki 13 |20-543 Lublin;889;606;606;4;602;68.17;0.66
88963;066301;Zespół Szkół Nr 10|Lublin|ul. Biedronki 13 |20-543 Lublin;1695;1045;1045;10;1035;61.65;0.96
88964;066301;Przedszkole nr 31|Lublin|ul. Tymiankowa 60 |20-542 Lublin;1835;1128;1128;13;1115;61.47;1.15
88965;066301;Przedszkole nr 72|Lublin|ul. Różana 9 |20-538 Lublin;2040;1192;1192;7;1185;58.43;0.59
88966;066301;Dom Kultury "Ruta"|Lublin|ul. Różana 8 |20-538 Lublin;1009;614;614;5;609;60.85;0.81
88967;066301;Spółdzielnia Mieszkaniowa "CZUBY"|Lublin|ul. Watykańska 6 |20-538 Lublin;1576;1029;1029;8;1021;65.29;0.78
88968;066301;Szkoła Podstawowa nr 28 z Oddziałami Integracyjnymi im. Synów Pułku Ziemi Lubelskiej|Lublin|ul. Radości 13 |20-530 Lublin;1955;1132;1132;13;1119;57.90;1.15
88969;066301;Przedszkole nr 77|Lublin|ul. Radości 8 |20-530 Lublin;2027;1186;1186;8;1178;58.51;0.67
88970;066301;Przedszkole nr 73|Lublin|ul. Uśmiechu 5 |20-534 Lublin;1807;1132;1132;13;1119;62.65;1.15
88971;066301;Szkoła Podstawowa nr 51 im. Jana Pawła II|Lublin|ul. Bursztynowa 22 |20-576 Lublin;1361;962;962;0;962;70.68;0.00
88972;066301;Niepubliczne Przedszkole Językowe "BURSZTYNEK"|Lublin|ul. Bursztynowa 3a |20-576 Lublin;1140;710;710;5;705;62.28;0.70
88973;066301;Administracja Osiedla "PORĘBA"|Lublin|ul. Perłowa 8/70 |20-574 Lublin;1783;1177;1177;10;1167;66.01;0.85
88974;066301;Dom Pomocy Społecznej im. Św. Jana Pawła II|Lublin|ul. Ametystowa 22 |20-577 Lublin;875;556;556;0;556;63.54;0.00
88975;066301;Przedszkole nr 63|Lublin|ul. Szmaragdowa 22 |20-570 Lublin;1905;1194;1194;14;1180;62.68;1.17
88976;066301;Centrum Językowe BEST|Lublin|ul. Bursztynowa 15 |20-576 Lublin;996;673;673;7;666;67.57;1.04
88977;066301;Szkoła Podstawowa nr 51 im. Jana Pawła II|Lublin|ul. Bursztynowa 22 |20-576 Lublin;1397;944;944;8;936;67.57;0.85
88978;066301;Przedszkole Nr 81|Lublin|ul. Wyżynna 10 |20-560 Lublin;1999;1152;1152;9;1143;57.63;0.78
88979;066301;Administracja SM "WĘGLINEK"|Lublin|ul. Wyżynna 19/1 |20-560 Lublin;1343;797;797;8;789;59.34;1.00
88980;066301;Spółdzielnia Mieszkaniowa "Nasz Dom"|Lublin|ul. Szczytowa 11 |20-562 Lublin;1141;764;764;7;757;66.96;0.92
88981;066301;Społeczna Szkoła Podstawowa i Społeczne Gimnazjum im. Sebastiana Fabiana Klonowica|Lublin|al. Warszawska 94 |20-824 Lublin;2306;1455;1455;7;1448;63.10;0.48
88982;066301;Ośrodek Wsparcia dla Osób z Niepełnosprawnością "Benjamin"|Lublin|ul. Zbożowa 22a |20-827 Lublin;2253;1480;1480;5;1475;65.69;0.34
88983;066301;Przedszkole Prywatne "CHATKA PUCHATKA 2"|Lublin|ul. Bogdanówka 9 |20-810 Lublin;1939;1239;1239;5;1234;63.90;0.40
88984;066301;Przedszkole Prywatne "CHATKA PUCHATKA"|Lublin|ul. Kaskadowa 11 |20-819 Lublin;2160;1373;1373;15;1358;63.56;1.09
88985;066301;Przedszkole nr 15|Lublin|ul. Bohaterów Monte Cassino 7 |20-808 Lublin;1704;1136;1136;3;1133;66.67;0.26
88986;066301;Prywatne Dwujęzyczne Przedszkole "Motylek"|Lublin|al. Warszawska 43 |20-803 Lublin;2138;1386;1386;7;1379;64.83;0.51
88987;066301;Spółdzielnia Mieszkaniowa "Transportowiec"|Lublin|ul. Kolorowa 3 |20-802 Lublin;1922;1327;1327;7;1320;69.04;0.53
88988;066301;Administracja Osiedla im. Karola Szymanowskiego|Lublin|ul. Harnasie 11 |20-857 Lublin;1830;1097;1097;8;1089;59.95;0.73
88989;066301;Spółdzielnia Budowlano-Mieszkaniowa "CHOINY"|Lublin|ul. Gorczańska 2 |20-868 Lublin;1981;1377;1377;7;1370;69.51;0.51
88990;066301;Przedszkole nr 37|Lublin|ul. Zakopiańska 3 |20-858 Lublin;1654;955;955;11;944;57.74;1.15
88991;066301;Przedszkole nr 76|Lublin|ul. Ignacego Jana Paderewskiego 12 |20-860 Lublin;1555;914;914;11;903;58.78;1.20
88992;066301;Szkoła Podstawowa nr 43 im. Ignacego Jana Paderewskiego|Lublin|ul. Józefa Śliwińskiego 5 |20-861 Lublin;1511;914;914;5;909;60.49;0.55
88993;066301;Szkoła Podstawowa nr 43 im. Ignacego Jana Paderewskiego|Lublin|ul. Józefa Śliwińskiego 5 |20-861 Lublin;1491;869;869;7;862;58.28;0.81
88994;066301;Gimnazjum nr 16 im. Fryderyka Chopina|Lublin|ul. Poturzyńska 2 |20-853 Lublin;1821;1103;1103;5;1098;60.57;0.45
88995;066301;Przedszkole nr 75|Lublin|ul. Żelazowej Woli 24 |20-853 Lublin;1877;1185;1185;9;1176;63.13;0.76
88996;066301;Szkoła Podstawowa nr 34 im. Kornela Makuszyńskiego|Lublin|ul. Ireny Kosmowskiej 3 |20-815 Lublin;2155;1341;1341;13;1328;62.23;0.97
88997;066301;Gimnazjum nr 5 im. Króla Władysława Łokietka|Lublin|ul. Smyczkowa 3 |20-844 Lublin;2026;1269;1269;8;1261;62.64;0.63
88998;066301;Przedszkole z Oddziałem Integracyjnym nr 70 w Lublinie|Lublin|ul. Smyczkowa 2 |20-844 Lublin;1800;1122;1122;16;1106;62.33;1.43
88999;066301;Przedszkole nr 2|Lublin|ul. Lawinowa 7 |20-864 Lublin;1629;985;985;11;974;60.47;1.12
89000;066301;Przedszkole Specjalne nr 11|Lublin|ul. Młodej Polski 30 |20-863 Lublin;1963;1291;1291;6;1285;65.77;0.46
89001;066301;Dzielnicowy Dom Kultury SM "CZECHÓW"|Lublin|ul. Jana Kiepury 5a |20-838 Lublin;1511;869;869;8;861;57.51;0.92
89002;066301;Przedszkole nr 56|Lublin|ul. Kurantowa 3 |20-836 Lublin;1492;912;912;18;894;61.13;1.97
89003;066301;Przedszkole nr 58|Lublin|ul. Radzyńska 16 |20-850 Lublin;1697;1006;1006;11;995;59.28;1.09
89004;066301;Zespół Szkół Ogólnokształcących nr 1 im. Zbigniewa Herberta|Lublin|ul. Radzyńska 5 |20-850 Lublin;1554;949;949;12;937;61.07;1.26
89005;066301;Zespół Szkół Ogólnokształcących nr 1 im. Zbigniewa Herberta|Lublin|ul. Radzyńska 5 |20-850 Lublin;1696;1033;1033;7;1026;60.91;0.68
89006;066301;Specjalistyka Czechów Sp. z o.o.|Lublin|al. Kompozytorów Polskich 8a |20-848 Lublin;1331;835;835;4;831;62.73;0.48
89007;066301;Miejski Ośrodek Pomocy Rodzinie Filia Nr 4|Lublin|al. Kompozytorów Polskich 8 |20-848 Lublin;1375;902;902;6;896;65.60;0.67
89008;066301;Specjalny Ośrodek Szkolno-Wychowawczy nr 1|Lublin|al. Spółdzielczości Pracy 65 |20-147 Lublin;1352;825;825;1;824;61.02;0.12
89009;066301;Gminna Spółdzielnia "Samopomoc Chłopska" w Wólce|Lublin|ul. Turystyczna 132 |20-230 Lublin;517;242;242;4;238;46.81;1.65
89010;066301;Specjalny Ośrodek Szkolno-Wychowawczy nr 1|Lublin|al. Spółdzielczości Pracy 65 |20-147 Lublin;1842;1265;1265;8;1257;68.68;0.63
89011;066301;Budynek parafii rzymsko-katolickiej p.w. św. Antoniego Padewskiego|Lublin|ul. Kasztanowa 1 |20-138 Lublin;1123;667;667;6;661;59.39;0.90
89012;066301;Urząd Miasta Lublin Miejski Zespół do Spraw Orzekania o Niepełnosprawności w Lublinie|Lublin|ul. Magnoliowa 2 |20-143 Lublin;1433;843;843;11;832;58.83;1.30
89013;066301;Szkoła Podstawowa nr 4 im. Adama Mickiewicza|Lublin|ul. Hiacyntowa 69 |20-143 Lublin;1810;1166;1166;4;1162;64.42;0.34
89014;066301;Niepubliczne Przedszkole "Krasnal 2"|Lublin|ul. Owocowa 6 |20-140 Lublin;1896;1178;1178;13;1165;62.13;1.10
89015;066301;Zakład Obsługi Nieruchomości "ADMINA" Sp. z o.o.|Lublin|ul. Marii Koryznowej 2c |20-137 Lublin;1075;564;564;10;554;52.47;1.77
89016;066301;Zespół Szkół Ogólnokształcących nr 4 im. Orląt Lwowskich|Lublin|ul. Kazimierza Tumidajskiego 6a |20-247 Lublin;1457;867;867;5;862;59.51;0.58
89017;066301;Przedszkole nr 59|Lublin|ul. Niepodległości 12a |20-246 Lublin;1483;845;845;10;835;56.98;1.18
89018;066301;Administracja Osiedla "NIEPODLEGŁOŚCI"|Lublin|ul. Kazimierza Tumidajskiego 24 |20-247 Lublin;1323;855;855;15;840;64.63;1.75
89019;066301;NZOZ "MELISA"|Lublin|ul. Niepodległości 9 |20-246 Lublin;2186;1366;1366;8;1358;62.49;0.59
89020;066301;RSM MOTOR|Lublin|ul. Ignacego Daszyńskiego 4 |20-250 Lublin;1820;1132;1132;16;1116;62.20;1.41
89021;066301;Zespół Ośrodków Wsparcia w Lublinie|Lublin|ul. Lwowska 28 |20-128 Lublin;1825;963;963;7;956;52.77;0.73
89022;066301;Przedszkole nr 13|Lublin|ul. Stefana Okrzei 9 |20-128 Lublin;1513;841;841;7;834;55.58;0.83
89023;066301;Siedziba Rady i Zarządu Dzielnicy KALINOWSZCZYZNA|Lublin|ul. Franciszka Kleeberga 12a |20-243 Lublin;1724;1040;1040;12;1028;60.32;1.15
89024;066301;Przedszkole nr 50|Lublin|ul. Podzamcze 7a |20-126 Lublin;1579;744;744;17;727;47.12;2.28
89025;066301;Gimnazjum nr 2 im. Komisji Edukacji Narodowej|Lublin|ul. Lwowska 11 |20-128 Lublin;1453;843;843;6;837;58.02;0.71
89026;066301;Przedszkole nr 52|Lublin|ul. Józefa Kustronia 10 |20-241 Lublin;1151;672;672;8;664;58.38;1.19
89027;066301;Szkoła Podstawowa nr 10 im. Henryka Sienkiewicza|Lublin|ul. Kalinowszczyzna 70 |20-201 Lublin;901;534;534;7;527;59.27;1.31
89028;066301;Szkoła Podstawowa nr 27 im. Marii Montessori|Lublin|ul. Kresowa 1 |20-215 Lublin;1191;449;449;10;439;37.70;2.23
89029;066301;Zespół Szkół Ogólnokształcących nr 2|Lublin|ul. Przyjaźni 12 |20-314 Lublin;1071;540;540;8;532;50.42;1.48
89030;066301;Klub Osiedlowy "PRZYJAŹNI"|Lublin|ul. Przyjaźni 13 |20-314 Lublin;1106;622;622;9;613;56.24;1.45
89031;066301;Szkoła Podstawowa nr 27 im. Marii Montessori|Lublin|ul. Kresowa 1 |20-215 Lublin;1197;544;544;11;533;45.45;2.02
89032;066301;Siedziba Rady i Zarządu Dzielnicy TATARY|Lublin|ul. Gospodarcza 32 |20-213 Lublin;1109;521;521;10;511;46.98;1.92
89033;066301;Publiczne Przedszkole Integracyjne nr 40 w Lublinie|Lublin|ul. Gospodarcza 18 |20-213 Lublin;929;434;434;13;421;46.72;3.00
89034;066301;Przedszkole nr 44|Lublin|ul. Maszynowa 6 |20-218 Lublin;1222;514;514;16;498;42.06;3.11
89035;066301;Gimnazjum nr 17|Lublin|ul. Maszynowa 2 |20-218 Lublin;988;428;428;5;423;43.32;1.17
89036;066301;Filia DDK "Bronowice"|Lublin|ul. Hutnicza 28a |20-218 Lublin;837;368;368;13;355;43.97;3.53
89037;066301;Ośrodek Medyczny DMP Sp. z o.o.|Lublin|ul. Projektowa 5 |20-209 Lublin;576;290;290;7;283;50.35;2.41
89038;066301;REFLEKS Sp. k. Oddział Lublin|Lublin|ul. Turystyczna 32 |20-207 Lublin;359;158;158;4;154;44.01;2.53
89039;066301;AGRAM S.A.|Lublin|ul. Mełgiewska 104 |20-234 Lublin;1039;501;501;10;491;48.22;2.00
89040;066301;Miejski Ośrodek Pomocy Rodzinie Centrum Aktywności Środowiskowej|Lublin|ul. Grygowej 4b |20-260 Lublin;817;251;251;1;250;30.72;0.40
89041;066301;Szkoła Podstawowa nr 52 im. Marii Konopnickiej|Lublin|ul. Władysława Jagiełły 11 |20-281 Lublin;1934;1075;1075;14;1061;55.58;1.30
89042;066301;Szkoła Podstawowa nr 52 im. Marii Konopnickiej|Lublin|ul. Władysława Jagiełły 11 |20-281 Lublin;951;574;574;14;560;60.36;2.44
89043;066301;Miejska Biblioteka Publiczna im. Hieronima Łopacińskiego Filia nr 36|Lublin|ul. Zygmunta Augusta 15 |20-283 Lublin;1597;807;807;17;790;50.53;2.11
89044;066301;Rodzinny Ogród Działkowy "Słonecznik"|Lublin|ul. Rąblowska 13 |20-509 Lublin;677;348;348;3;345;51.40;0.86
89045;066301;Zespół Szkół nr 8|Lublin|ul. Krężnicka 156 |20-518 Lublin;1683;871;871;12;859;51.75;1.38
89046;066301;Żłobek nr 8|Lublin|ul. Nałkowskich 102 |20-470 Lublin;2208;1289;1289;18;1271;58.38;1.40
89047;066301;Szkoła Podstawowa nr 30 im. Króla Kazimierza Wielkiego|Lublin|ul. Nałkowskich 110 |20-470 Lublin;1851;1015;1015;16;999;54.84;1.58
89048;066301;Przedszkole nr 78|Lublin|ul. Jana Samsonowicza 9 |20-485 Lublin;2013;1258;1258;7;1251;62.49;0.56
89049;066301;Gimnazjum nr 3 im. prof. Mieczysława A. Krąpca OP|Lublin|ul. Nałkowskich 110 |20-470 Lublin;1941;1094;1094;13;1081;56.36;1.19
89050;066301;Przedszkole nr 66|Lublin|ul. Jana Samsonowicza 33a |20-485 Lublin;1566;820;820;8;812;52.36;0.98
89051;066301;Szkoła Podstawowa nr 30 im. Króla Kazimierza Wielkiego|Lublin|ul. Nałkowskich 110 |20-470 Lublin;664;404;404;1;403;60.84;0.25
89052;066301;Przedszkole nr 87|Lublin|ul. Jacka Woronieckiego 11 |20-492 Lublin;1346;914;914;10;904;67.90;1.09
89053;066301;PKP Zakład Linii Kolejowych w Lublinie Sekcja Eksploatacji|Lublin|ul. Nowy Świat 31a |20-418 Lublin;1321;720;720;9;711;54.50;1.25
89054;066301;DOM KULTURY KOLEJARZA|Lublin|ul. Władysława Kunickiego 35 |20-417 Lublin;1757;742;742;22;720;42.23;2.96
89055;066301;Zespół Szkół nr 3|Lublin|ul. Wyścigowa 31 |20-425 Lublin;920;486;486;2;484;52.83;0.41
89056;066301;Gimnazjum nr 1 im. ks. Stanisława Konarskiego|Lublin|ul. Władysława Kunickiego 116 |20-436 Lublin;2239;1321;1321;17;1304;59.00;1.29
89057;066301;VI Liceum Ogólnokształcące im. Hugona Kołłątaja|Lublin|ul. Adama Mickiewicza 36 |20-466 Lublin;2228;1430;1430;12;1418;64.18;0.84
89058;066301;Szkoła Podstawowa nr 40 im. Leona Kruczkowskiego|Lublin|ul. Róży Wiatrów 9 |20-468 Lublin;1714;996;996;5;991;58.11;0.50
89059;066301;Żłobek nr 6|Lublin|ul. Leona Kruczkowskiego 12 |20-468 Lublin;1386;755;755;6;749;54.47;0.79
89060;066301;Szkoła Podstawowa nr 2 im. Jana Kochanowskiego|Lublin|ul. Adama Mickiewicza 24 |20-433 Lublin;1563;919;919;7;912;58.80;0.76
89061;066301;VI Liceum Ogólnokształcące im. Hugona Kołłątaja|Lublin|ul. Adama Mickiewicza 36 |20-466 Lublin;1043;659;659;14;645;63.18;2.12
89062;066301;POCZTA POLSKA S.A. CENTRUM LOGISTYKI Oddział Regionalny w Lublinie|Lublin|ul. Seweryna Sierpińskiego 26 |20-448 Lublin;2060;1191;1191;4;1187;57.82;0.34
89063;066301;Zespół Szkół Transportowo-Komunikacyjnych im. Tadeusza Kościuszki|Lublin|ul. Zemborzycka 82 |20-445 Lublin;385;195;195;3;192;50.65;1.54
89064;066301;Wojewódzki Ośrodek Terapii Uzależnienia od Alkoholu i Współuzależnienia|Lublin|ul. Abramowicka 4b |20-442 Lublin;1343;845;845;2;843;62.92;0.24
89065;066301;Zespół Szkół Energetycznych im. prof. Kazimierza Drewnowskiego|Lublin|ul. Długa 6 |20-346 Lublin;1335;745;745;10;735;55.81;1.34
89066;066301;Przedszkole nr 7|Lublin|ul. Elektryczna 12 |20-349 Lublin;1565;635;635;11;624;40.58;1.73
89067;066301;Gimnazjum nr 15 im. Jana Pawła II|Lublin|ul. Elektryczna 51 |20-349 Lublin;1511;1000;1000;4;996;66.18;0.40
89068;066301;Gimnazjum nr 15 im. Jana Pawła II|Lublin|ul. Elektryczna 51 |20-349 Lublin;1486;820;820;10;810;55.18;1.22
89069;066301;Szkoła Podstawowa nr 32 z Oddziałami Integracyjnymi im. Pamięci Majdanka|Lublin|ul. Kazimierza Przerwy-Tetmajera 2 |20-362 Lublin;1706;1043;1043;11;1032;61.14;1.05
89070;066301;Kolegium Pracowników Służb Społecznych|Lublin|ul. Sulisławicka 7 |20-360 Lublin;1883;1034;1034;11;1023;54.91;1.06
89071;066301;Szkoła Podstawowa nr 2 im. Jana Kochanowskiego|Lublin|ul. Adama Mickiewicza 24 |20-433 Lublin;1047;603;603;11;592;57.59;1.82
89072;066301;Siedziba Rady i Zarządu Dzielnicy ABRAMOWICE|Lublin|ul. Abramowicka 122 |20-391 Lublin;1349;705;705;10;695;52.26;1.42
89073;066301;Zespół Szkół nr 9|Lublin|ul. Zdrowa 1 |20-383 Lublin;1648;984;984;9;975;59.71;0.91
89074;066301;SP Szpital Kliniczny Nr 1 w Lublinie:Klinika Okulistyki Ogólnej, Klinika Chirurgii Siatkówki i Ciała Szklistego, Klinika Diagnostyki i Mikrochirurgii Jaskry|Lublin|ul. Chmielna 1 |20-079 Lublin;55;13;13;0;13;23.64;0.00
89075;066301;SP Szpital Kliniczny Nr 1 w Lublinie|Lublin|ul. Stanisława Staszica 11 |20-081 Lublin;333;53;53;1;52;15.92;1.89
89076;066301;SP Szpital Kliniczny Nr 1 w Lublinie: Klinika Dermatologii, Wenerologii i Dermatologii Dziecięcej|Lublin|ul. Radziwiłłowska 13 |20-080 Lublin;43;20;20;1;19;46.51;5.00
89077;066301;SP Szpital Kliniczny Nr 1 w Lublinie: I Klinika Psychiatrii, Psychoterapii i Wczesnej Interwencji, II Klinika Psychiatrii i Rehabilitacji Psychiatrycznej|Lublin|ul. Głuska 1 |20-439 Lublin;84;24;24;3;21;28.57;12.50
89078;066301;SP Szpital Wojewódzki im. Jana Bożego w Lublinie|Lublin|ul. Mieczysława Biernackiego 9 |20-089 Lublin;133;50;50;1;49;37.59;2.00
89079;066301;SP Szpital Wojewódzki im. Jana Bożego w Lublinie|Lublin|ul. Leona Kruczkowskiego 21 |20-468 Lublin;145;54;54;1;53;37.24;1.85
89080;066301;SP Szpital Wojewódzki im. Jana Bożego w Lublinie|Lublin|ul. Lubartowska 81 |20-123 Lublin;82;25;25;0;25;30.49;0.00
89081;066301;SP Szpital Kliniczny Nr 4 w Lublinie|Lublin|ul. Kazimierza Jaczewskiego 8 |20-090 Lublin;692;245;245;9;236;35.40;3.67
89082;066301;Centrum Onkologii Ziemi Lubelskiej im. św. Jana z Dukli|Lublin|ul. Kazimierza Jaczewskiego 7 |20-090 Lublin;243;82;82;5;77;33.74;6.10
89083;066301;Instytut Medycyny Wsi im. Witolda Chodźki|Lublin|ul. Kazimierza Jaczewskiego 2 |20-090 Lublin;68;42;42;1;41;61.76;2.38
89084;066301;1 Wojskowy Szpital Kliniczny z Polikliniką SP ZOZ w Lublinie|Lublin|Al. Racławickie 23 |20-049 Lublin;131;60;60;3;57;45.80;5.00
89085;066301;Wojewódzki Szpital Specjalistyczny im. Stefana Kardynała Wyszyńskiego SP ZOZ|Lublin|al. Kraśnicka 100 |20-718 Lublin;407;190;190;7;183;46.68;3.68
89086;066301;SP Zakład Opieki Zdrowotnej Ministerstwa Spraw Wewnętrznych w Lublinie|Lublin|ul. Grenadierów 3 |20-331 Lublin;109;60;60;3;57;55.05;5.00
89087;066301;Szpital Neuropsychiatryczny im. Prof. Mieczysława Kaczyńskiego SP ZOZ w Lublinie|Lublin|ul. Abramowicka 2 |20-442 Lublin;691;154;154;12;142;22.29;7.79
89088;066301;Dom Pomocy Społecznej im. Św. Jana Pawła II|Lublin|ul. Ametystowa 22 |20-577 Lublin;67;47;47;2;45;70.15;4.26
89089;066301;Dom Pomocy Społecznej dla Osób Niepełnosprawnych Fizycznie|Lublin|ul. Kosmonautów 78 |20-358 Lublin;87;37;37;3;34;42.53;8.11
89090;066301;Dom Pomocy Społecznej „Kalina”|Lublin|ul. Kalinowszczyzna 84 |20-201 Lublin;113;75;75;3;72;66.37;4.00
89091;066301;Dom Pomocy Społecznej „Betania”|Lublin|al. Kraśnicka 223 |20-718 Lublin;129;60;60;8;52;46.51;13.33
89092;066301;Dom Pomocy Społecznej im. Matki Teresy z Kalkuty|Lublin|ul. Bartosza Głowackiego 26 |20-060 Lublin;97;43;43;4;39;44.33;9.30
89093;066301;Dom Pomocy Społecznej im. Wiktorii Michelisowej|Lublin|ul. Archidiakońska 7 |20-113 Lublin;59;35;35;5;30;59.32;14.29
89094;066301;Areszt Śledczy w Lublinie|Lublin|ul. Południowa 5 |20-482 Lublin;872;420;420;87;333;48.17;20.71
89095;066401;Zespół Szkół Ponadgimnazjalnych Nr 1 w Zamościu|Zamość|ul. Łukasińskiego 8 |22-400 Zamość;1520;600;600;16;584;39.47;2.67
89096;066401;Zespół Szkół Ponadgimnazjalnych Nr 2 im. Tadeusza Kościuszki w Zamościu|Zamość|ul. Szczebrzeska 41 |22-400 Zamość;1438;725;725;11;714;50.42;1.52
89097;066401;Przedszkole Miejskie Nr 6 w Zamościu|Zamość|ul. Dolna 4 |22-400 Zamość;1805;967;967;11;956;53.57;1.14
89098;066401;Przedszkole Miejskie Nr 9 w Zamościu|Zamość|ul. Oboźna 10 |22-400 Zamość;1821;920;920;4;916;50.52;0.43
89099;066401;Świetlica Spółdzielni Mieszkaniowej|Zamość|ul. Orzeszkowej 28 |22-400 Zamość;1544;791;791;10;781;51.23;1.26
89100;066401;Zespół Szkół Nr 3 w Zamościu Gimnazjum Nr 3 im. Papieża Jana Pawła II|Zamość|ul. Orzeszkowej 43 |22-400 Zamość;1785;905;905;10;895;50.70;1.10
89101;066401;Zespół Szkół Ponadgimnazjalnych Nr 4 z Oddziałami Integracyjnymi im. Dzieci Zamojszczyzny w Zamościu|Zamość|ul. Marszałka J. Piłsudskiego 65 |22-400 Zamość;1827;925;925;9;916;50.63;0.97
89102;066401;Hotel Junior w Zamościu|Zamość|ul. Sikorskiego 6 |22-400 Zamość;1532;755;755;11;744;49.28;1.46
89103;066401;Zespół Szkół Nr 6 w Zamościu Szkoła Podstawowa Nr 9 im. Tadeusza Kościuszki|Zamość|ul. Kalinowa 5a |22-400 Zamość;1971;903;903;11;892;45.81;1.22
89104;066401;Zespół Szkół Nr 6 w Zamościu Gimnazjum Nr 6 im. Kr. Św. Jadwigi|Zamość|ul. Kalinowa 5a |22-400 Zamość;1402;763;763;14;749;54.42;1.83
89105;066401;Przedszkole Miejskie Nr 14 w Zamościu|Zamość|ul. Olchowa 11 |22-400 Zamość;2117;1090;1090;17;1073;51.49;1.56
89106;066401;Świetlica Szkół Katolickich im. Ojca Pio w Zamościu|Zamość|ul. Sikorskiego 11 |22-400 Zamość;1885;963;963;14;949;51.09;1.45
89107;066401;III Liceum Ogólnokształcące im. Cypriana Kamila Norwida w Zamościu|Zamość|ul. Kilińskiego 15 |22-400 Zamość;2165;1099;1099;16;1083;50.76;1.46
89108;066401;Komenda Miejska Państwowej Straży Pożarnej (Świetlica) w Zamościu|Zamość|ul. Kilińskiego 62 |22-400 Zamość;1849;944;944;16;928;51.05;1.69
89109;066401;Zespół Szkół Nr 1 z Oddziałami Integracyjnymi w Zamościu Szkoła Podstawowa Nr 10 im. Waleriana Łukasińskiego|Zamość|ul. Peowiaków 30A |22-400 Zamość;1543;646;646;19;627;41.87;2.94
89110;066401;Przedszkole Miejskie Nr 5 w Zamościu|Zamość|ul. Peowiaków 76A |22-400 Zamość;1001;504;504;8;496;50.35;1.59
89111;066401;Przedszkole Miejskie Nr 15 w Zamościu|Zamość|ul. J. Zamoyskiego 4a |22-400 Zamość;2223;1075;1075;15;1060;48.36;1.40
89112;066401;Zespół Szkół Nr 4 w Zamościu Szkoła Podstawowa Nr 4 im. Stefana Batorego|Zamość|ul. J. Zamoyskiego 4 |22-400 Zamość;2073;1108;1108;13;1095;53.45;1.17
89113;066401;Zespół Szkół Ponadgimnazjalnych Nr 3 im. Armii Krajowej w Zamościu|Zamość|ul. J. Zamoyskiego 62 |22-400 Zamość;2108;1095;1095;10;1085;51.94;0.91
89114;066401;Przedszkole Miejskie Nr 12 w Zamościu|Zamość|ul. Pr. Stefana Wyszyńskiego 32 |22-400 Zamość;1573;780;780;14;766;49.59;1.79
89115;066401;Zamojski Dom Kultury|Zamość|ul. Partyzantów 13 |22-400 Zamość;931;472;472;10;462;50.70;2.12
89116;066401;Zespół Szkół Nr 2 w Zamościu Szkoła Podstawowa Nr 7 z Oddziałami Integracyjnymi|Zamość|ul. H. Sienkiewicza 5 |22-400 Zamość;1762;921;921;9;912;52.27;0.98
89117;066401;Spółdzielnia Mieszkaniowa im. J. Zamoyskiego w Zamościu|Zamość|ul. Pr. Stefana Wyszyńskiego 50B |22-400 Zamość;1291;609;609;4;605;47.17;0.66
89118;066401;Państwowa Wyższa Szkoła Zawodowa im. Szymona Szymonowica w Zamościu|Zamość|ul. Hrubieszowska 24 |22-400 Zamość;2211;1096;1096;18;1078;49.57;1.64
89119;066401;Przedszkole Miejskie Nr 2 w Zamościu|Zamość|ul. Gminna 32 |22-400 Zamość;1840;861;861;12;849;46.79;1.39
89120;066401;Szkoła Podstawowa Nr 2 im. Henryka Sienkiewicza w Zamościu|Zamość|ul. Lwowska 15 |22-400 Zamość;2200;1009;1009;22;987;45.86;2.18
89121;066401;Szkoła Podstawowa Nr 6 w Zamościu im. Szymona Szymonowica|Zamość|ul. Orla 5 |22-400 Zamość;1969;1076;1076;11;1065;54.65;1.02
89122;066401;Gimnazjum Nr 2 im. Jana Zamoyskiego XVI Ordynata w Zamościu|Zamość|ul. Lwowska 15 |22-400 Zamość;2151;1079;1079;15;1064;50.16;1.39
89123;066401;I Prywatne Liceum Ogółnokształcące w Zamościu|Zamość|ul. Krasnobrodzka 22A |22-400 Zamość;1269;624;624;16;608;49.17;2.56
89124;066401;Świetlica Osiedlowa|Zamość|ul. Obronna 13 |22-400 Zamość;747;400;400;6;394;53.55;1.50
89125;066401;Zakład Karny w Zamościu|Zamość|Okrzei 14 |22-400 Zamość;225;96;96;16;80;42.67;16.67
89126;066401;Oddział Zewnętrzny Zakładu Karnego w Zamościu|Zamość|Hrubieszowska 40 |22-400 Zamość;303;130;130;17;113;42.90;13.08
89127;066401;Zamojski Szpital Niepubliczny Sp. z o.o. w Zamościu|Zamość|Peowiaków 1 |22-400 Zamość;190;68;68;0;68;35.79;0.00
89128;066401;Samodzielny Publiczny Szpital Wojewódzki im. Papieża Jana Pawła II w Zamościu|Zamość|ul. Aleje Jana Pawła II 10 |22-400 Zamość;317;118;118;9;109;37.22;7.63
89129;080101;Regionalne Centrum Edukacji Ponadgimnazjalnej - Zespół Szkół im. Marii Skłodowskiej-Curie|Kostrzyn nad Odrą|ul. Komisji Edukacji Narodowej 2 |66-470 Kostrzyn nad Odrą;854;412;412;5;407;48.24;1.21
89130;080101;Szkoła Podstawowa Nr 4|Kostrzyn nad Odrą|ul. Henryka Sienkiewicza 6 |66-470 Kostrzyn nad Odrą;956;413;413;13;400;43.20;3.15
89131;080101;Szkoła Podstawowa Nr 4|Kostrzyn nad Odrą|ul. Henryka Sienkiewicza 6 |66-470 Kostrzyn nad Odrą;819;370;370;17;353;45.18;4.59
89132;080101;Szkoła Podstawowa Nr 4|Kostrzyn nad Odrą|ul. Henryka Sienkiewicza 6 |66-470 Kostrzyn nad Odrą;857;367;367;15;352;42.82;4.09
89133;080101;Szkoła Podstawowa Nr 4|Kostrzyn nad Odrą|ul. Henryka Sienkiewicza 6 |66-470 Kostrzyn nad Odrą;991;487;487;19;468;49.14;3.90
89134;080101;Gimnazjum nr 1|Kostrzyn nad Odrą|ul. Tadeusza Kościuszki 7 |66-470 Kostrzyn nad Odrą;972;417;417;9;408;42.90;2.16
89135;080101;Gimnazjum nr 1|Kostrzyn nad Odrą|ul. Tadeusza Kościuszki 7 |66-470 Kostrzyn nad Odrą;1011;393;393;11;382;38.87;2.80
89136;080101;Kostrzyńskie Centrum Kultury - Klub Osiedlowy|Kostrzyn nad Odrą|Osiedle Leśne 5 |66-470 Kostrzyn nad Odrą;867;357;357;21;336;41.18;5.88
89137;080101;Szkoła Podstawowa Nr 2|Kostrzyn nad Odrą|ul. Ludwika Banaszaka 1 |66-470 Kostrzyn nad Odrą;1004;416;416;9;407;41.43;2.16
89138;080101;Biblioteka Miejska|Kostrzyn nad Odrą|ul. Dworcowa 7 |66-470 Kostrzyn nad Odrą;1049;504;504;11;493;48.05;2.18
89139;080101;Szkoła Podstawowa Nr 2|Kostrzyn nad Odrą|Ludwika Banaszaka 1 |66-470 Kostrzyn nad Odrą;864;409;409;12;397;47.34;2.93
89140;080101;Przedszkole Miejskie Nr 2|Kostrzyn nad Odrą|ul. Czereśniowa 1 |66-470 Kostrzyn nad Odrą;771;379;379;3;376;49.16;0.79
89141;080101;Przedszkole Miejskie Nr 2|Kostrzyn nad Odrą|ul. Czereśniowa 1 |66-470 Kostrzyn nad Odrą;819;354;354;8;346;43.22;2.26
89142;080101;Gimnazjum Nr 2|Kostrzyn nad Odrą|ul. Mikołaja Reja 32 a |66-470 Kostrzyn nad Odrą;799;372;372;9;363;46.56;2.42
89143;080101;Gimnazjum Nr 2|Kostrzyn nad Odrą|ul. Mikołaja Reja 32 a |66-470 Kostrzyn nad Odrą;972;457;457;10;447;47.02;2.19
89144;080101;Niepubliczny Zakład Opieki Zdrowotnej Nowy Szpital|Kostrzyn nad Odrą|Gabriela Narutowicza 6 |66-470 Kostrzyn nad Odrą;31;17;17;0;17;54.84;0.00
89145;080101;Dom Pomocy Społecznej "Dom Seniora"|Kostrzyn nad Odrą|Gabriela Narutowicza 4a |66-470 Kostrzyn nad Odrą;55;35;35;5;30;63.64;14.29
89146;080102;Zespół Szkół|Bogdaniec|Pocztowa 7 |66-450 Bogdaniec;1926;877;877;14;863;45.53;1.60
89147;080102;Szkoła Podstawowa|Jeniniec| 8a |66-450 Bogdaniec;765;272;272;16;256;35.56;5.88
89148;080102;Szkoła Podstawowa|Lubczyno| 55 |66-450 Bogdaniec;640;226;226;4;222;35.31;1.77
89149;080102;Szkoła Podstawowa|Jenin|Lipowa 1 |66-450 Bogdaniec;1794;887;887;28;859;49.44;3.16
89150;080102;Świetlica wiejska - Jeżyki|Jeżyki| 32 |66-450 Bogdaniec;369;149;149;4;145;40.38;2.68
89151;080103;Sala Zespołu Szkół w Deszcznie|Deszczno|Lubuska 61 |66-446 Deszczno;2184;1017;1017;35;982;46.57;3.44
89152;080103;Sala Szkoły Podstawowej w Ciecierzycach|Ciecierzyce|Borkowska 2 |66-446 Deszczno;1427;708;708;17;691;49.61;2.40
89153;080103;Sala Szkoły Podstawowej w Ulimiu|Ulim|Rubinowa 5 |66-446 Deszczno;1435;603;603;13;590;42.02;2.16
89154;080103;Sala Szkoły Podstawowej w Boleminie|Bolemin| 102 |66-446 Deszczno;1228;400;400;13;387;32.57;3.25
89155;080103;Sala Szkoły Podstawowej w Brzozowcu|Brzozowiec|ul. Szkolna 13 |66-446 Deszczno;824;334;334;12;322;40.53;3.59
89156;080104;Urząd Gminy Kłodawa (sala posiedzeń)|Kłodawa|ul. Gorzowska 40 |66-415 Kłodawa;1310;743;743;17;726;56.72;2.29
89157;080104;Zespół Szkół w Różankach|Różanki|ul. Dębowa 3 |66-415 Kłodawa;1199;657;657;13;644;54.80;1.98
89158;080104;Zespół Szkół w Kłodawie|Kłodawa|ul. Szkolna 1 |66-415 Kłodawa;856;565;565;11;554;66.00;1.95
89159;080104;Gminny Ośrodek Kultury|Wojcieszyce|ul. Wspólna 45 |66-415 Kłodawa;753;291;291;17;274;38.65;5.84
89160;080104;Świetlica wiejska|Łośno| 48B |66-415 Kłodawa;373;131;131;5;126;35.12;3.82
89161;080104;Sala wiejska|Santocko|ul. Wiejska 66 |66-415 Kłodawa;577;305;305;8;297;52.86;2.62
89162;080104;Warsztaty Terapii Zajęciowej|Chwalęcice|ul. Lipowa 38 |66-415 Kłodawa;813;466;466;9;457;57.32;1.93
89163;080104;Sala wiejska|Rybakowo|ul. Lipowa 26 |66-415 Kłodawa;425;162;162;8;154;38.12;4.94
89164;080105;Centrum Działań kulturalnych i Społecznych w Stawie|Staw| 14 |66-433 Lubiszyn;645;248;248;11;237;38.45;4.44
89165;080105;Szkoła Podstawowa w Ściechowie|Ściechów| 84 |66-433 Lubiszyn;841;235;235;14;221;27.94;5.96
89166;080105;Sala Konferencyjna w Lubiszynie|Lubiszyn|ul.Plac Jedności Robotniczej 7 |66-433 Lubiszyn;883;350;350;19;331;39.64;5.43
89167;080105;Szkoła Podstawowa w Wysokiej|Wysoka| 16 |66-433 Lubiszyn;473;191;191;9;182;40.38;4.71
89168;080105;Szkoła Podstawowa w Lubnie|Lubno|ul.Plac Wyzwolenia 8 |66-450 Bogdaniec;609;197;197;10;187;32.35;5.08
89169;080105;Szkoła Podstawowa w Baczynie|Baczyna|ul.Szkolna 1 |66-432 Baczyna;1425;633;633;13;620;44.42;2.05
89170;080105;Sala wiejska w Brzeźnie|Brzeźno| 7 |66-433 Lubiszyn;517;146;146;8;138;28.24;5.48
89171;080106;Sala Wiejska w Czechowie|Czechów|Czechów 16A |66-431 Santok;456;248;248;9;239;54.39;3.63
89172;080106;Sala Gimnastyczna w Wawrowie|Wawrów| 46E |66-400 Gorzów Wielkopolski;1197;548;548;18;530;45.78;3.28
89173;080106;Szkoła Podstawowa w Janczewie|Janczewo| 27 |66-431 Santok;1101;512;512;22;490;46.50;4.30
89174;080106;Sala Wiejska w Gralewie|Gralewo| 48A |66-431 Santok;797;317;317;22;295;39.77;6.94
89175;080106;Gminna Biblioteka Publiczna w Santoku|Santok|Gorzowska 35 |66-431 Santok;660;267;267;14;253;40.45;5.24
89176;080106;Sala Wiejska w Starym Polichnie|Stare Polichno|Szkolna 9 |66-431 Santok;580;202;202;12;190;34.83;5.94
89177;080106;Sala Wiejska w Ludzisławicach|Ludzisławice| 26A |66-431 Santok;302;91;91;5;86;30.13;5.49
89178;080106;Sala Wiejska w Lipkach Wielkich|Lipki Wielkie|Szosowa 72 |66-431 Santok;1387;516;516;23;493;37.20;4.46
89179;080107;Zespół Szkolno-Przedszkolny w Witnicy|Witnica|ul. Wiosny Ludów 14 |66-460 Witnica;1261;475;475;15;460;37.67;3.16
89180;080107;Miejski Dom Kultury w Witnicy|Witnica|ul. Gorzowska 22 |66-460 Witnica;2080;766;766;31;735;36.83;4.05
89181;080107;Regionalne Centrum Ratownictwa w Witnicy|Witnica|ul. Żwirowa 2c |66-460 Witnica;2035;842;842;32;810;41.38;3.80
89182;080107;Świetlica Wiejska w Pyrzanach|Pyrzany| 51 |66-460 Witnica;573;204;204;6;198;35.60;2.94
89183;080107;Świetlica Wiejska w Starych Dzieduszycach|Stare Dzieduszyce| 16 |66-460 Witnica;643;214;214;8;206;33.28;3.74
89184;080107;Świetlica Wiejska w Kamieniu Małym|Kamień Mały| 91 |66-460 Witnica;711;208;208;5;203;29.25;2.40
89185;080107;Szkoła Podstawowa w Dąbroszynie, filia w Kamieniu Wielkim|Kamień Wielki|ul. Kościelna 1 |66-460 Witnica;488;175;175;7;168;35.86;4.00
89186;080107;Świetlica Wiejska w Dąbroszynie|Dąbroszyn| 22a |66-460 Witnica;627;263;263;12;251;41.95;4.56
89187;080107;Zespół Edukacyjny w Nowinach Wielkich|Nowiny Wielkie|ul. Wiejska 26 |66-460 Witnica;997;413;413;19;394;41.42;4.60
89188;080107;Świetlica Wiejska w Białczu|Białcz|ul. Gorzowska 18 |66-460 Witnica;657;250;250;8;242;38.05;3.20
89189;080107;Dom Pomocy Społecznej w Kamieniu Wielkim|Kamień Wielki|Stawna 40 |66-460 Witnica;45;11;11;1;10;24.44;9.09
89190;080201;Zespół Szkół Ogólnokształcących|Gubin|ul. Piastowska 26 |66-620 Gubin;1832;706;706;20;686;38.54;2.83
89191;080201;Przedszkole Miejskie nr 3|Gubin|ul. Wojska Polskiego 16 |66-620 Gubin;2156;1020;1020;26;994;47.31;2.55
89192;080201;Przedsiębiorstwo Oczyszczania Ścieków|Gubin|ul. Spokojna 1 |66-620 Gubin;890;333;333;7;326;37.42;2.10
89193;080201;Szkoła Podstawowa nr 2|Gubin|ul. Generała Świerczewskiego 1 |66-620 Gubin;1393;557;557;18;539;39.99;3.23
89194;080201;Szkoła Podstawowa nr 3 z Oddziałami Integracyjnymi|Gubin|ul. Kresowa 48 |66-620 Gubin;2305;987;987;27;960;42.82;2.74
89195;080201;Gubiński Dom Kultury|Gubin|ul. Westerplatte 14 |66-620 Gubin;1664;694;694;20;674;41.71;2.88
89196;080201;Miejski Ośrodek Sportu Kryta Pływalnia|Gubin|ul. II Armii Wojska Polskiego 5 |66-620 Gubin;948;309;309;9;300;32.59;2.91
89197;080201;Zespół Szkół im. M. Kopernika|Gubin|ul. Racławicka 2 |66-620 Gubin;1012;381;381;17;364;37.65;4.46
89198;080201;Szkoła Podstawowa nr 3 z Oddziałami Integracyjnymi|Gubin|ul. Kresowa 48 |66-620 Gubin;965;444;444;10;434;46.01;2.25
89199;080201;Szpital|Gubin|Śląska 35 |66-620 Gubin;32;9;9;0;9;28.12;0.00
89200;080202;Szkoła Podstawowa|Bobrowice| 36 |66-627 Bobrowice;1094;417;417;18;399;38.12;4.32
89201;080202;Szkoła Podstawowa|Dychów| 39 |66-627 Bobrowice;970;438;438;19;419;45.15;4.34
89202;080202;Sala Wiejska|Janiszowice| |66-627 Bobrowice;541;174;174;6;168;32.16;3.45
89203;080203;Gminne Centrum Kultury|Bytnica| 52d |66-630 Bytnica;1256;428;428;16;412;34.08;3.74
89204;080203;Centrum Oświatowo-Kulturalne|Budachów| 109 |66-630 Budachów;783;230;230;12;218;29.37;5.22
89205;080204;Świetlica wiejska w Połupinie|Połupin|ul. Szkolna 4 |66-600 Krosno Odrzańskie;830;336;336;11;325;40.48;3.27
89206;080204;Świetlica Wiejska|Dąbie|ul. Szeroka 6b |66-615 Dąbie;353;171;171;11;160;48.44;6.43
89207;080204;Szkoła Podstawowa|Szczawno|ul. Szkolna 3 |66-615 Dąbie;721;213;213;10;203;29.54;4.69
89208;080204;Szkoła Podstawowa|Gronów|ul. Główna 1 |66-615 Dąbie;1081;370;370;25;345;34.23;6.76
89209;080204;Szkoła Podstawowa|Kosierz| 40 |66-627 Bobrowice;516;188;188;17;171;36.43;9.04
89210;080204;Świetlica Wiejska|Brzeźnica|ul. Główna 5a |66-615 Dąbie;402;128;128;6;122;31.84;4.69
89211;080204;Dom Pomocy Społecznej|Szczawno|ul. Parkowa 2 |66-615 Dąbie;54;24;24;8;16;44.44;33.33
89212;080205;Publiczna Szkoła Podstawowa w Bieżycach|Bieżyce| 50 |66-620 Gubin;393;133;133;8;125;33.84;6.02
89213;080205;Biblioteka w Wałowicach|Wałowice| 51 |66-620 Gubin;355;144;144;4;140;40.56;2.78
89214;080205;Wiejski Ośrodek Zdrowia w Polu|Pole| 1 |66-620 Gubin;412;133;133;8;125;32.28;6.02
89215;080205;Publiczne Gimnazjum w Czarnowicach|Czarnowice| 20 |66-620 Gubin;396;114;114;4;110;28.79;3.51
89216;080205;Zespół Szkół w Grabicach|Grabice| 59 |66-620 Gubin;1060;300;300;20;280;28.30;6.67
89217;080205;Zespół Szkół w Chlebowie|Chlebowo| 123 |66-620 Gubin;768;241;241;9;232;31.38;3.73
89218;080205;Publiczna Szkoła Podstawowa w Strzegowie|Strzegów| 79 |66-620 Gubin;391;127;127;4;123;32.48;3.15
89219;080205;Publiczna Szkoła Podstawowa w Starosiedlu|Starosiedle| 22 |66-620 Gubin;424;133;133;10;123;31.37;7.52
89220;080205;Świetlica w Sękowicach|Sękowice| 64 |66-620 Gubin;454;114;114;11;103;25.11;9.65
89221;080205;Nadleśnictwo Gubin|Komorów|ul. Dolna 19 |66-620 Gubin;738;271;271;12;259;36.72;4.43
89222;080205;Wiejski Ośrodek Zdrowia w Stargardzie Gubińskim|Stargard Gubiński| 1A |66-620 Gubin;391;118;118;5;113;30.18;4.24
89223;080205;Areszt Śledczy w Lubsku Oddział Zewnętrzny w Wałowicach|Wałowice| 74|66-620 Gubin;90;49;49;3;46;54.44;6.12
89224;080206;CAK "Zamek"|Krosno Odrzańskie|ul. Szkolna 1 |66-600 Krosno Odrzańskie;1027;366;366;24;342;35.64;6.56
89225;080206;Przedszkole nr 4|Krosno Odrzańskie|ul. Bolesława Chrobrego 33 |66-600 Krosno Odrzańskie;921;377;377;12;365;40.93;3.18
89226;080206;Gimnazjum|Krosno Odrzańskie|ul. Pułaskiego 3 |66-600 Krosno Odrzańskie;1799;923;923;20;903;51.31;2.17
89227;080206;Szkoła Podstawowa Nr 3|Krosno Odrzańskie|ul. Pułaskiego 3 |66-600 Krosno Odrzańskie;1673;740;740;21;719;44.23;2.84
89228;080206;Przedszkole Nr 3|Krosno Odrzańskie|ul. Piastów 6d |66-600 Krosno Odrzańskie;881;373;373;20;353;42.34;5.36
89229;080206;Przedszkole Nr 1|Krosno Odrzańskie|ul. Srebrna Góra 1 |66-600 Krosno Odrzańskie;1027;464;464;21;443;45.18;4.53
89230;080206;Przedszkole Nr 2|Krosno Odrzańskie|ul. Bolesława Krzywoustego 2 |66-600 Krosno Odrzańskie;918;488;488;3;485;53.16;0.61
89231;080206;Szkoła Podstawowa Nr 2|Krosno Odrzańskie|ul. Moniuszki 30 |66-600 Krosno Odrzańskie;1102;543;543;14;529;49.27;2.58
89232;080206;Świetlica wiejska|Kamień| 1 |66-600 Krosno Odrzańskie;862;368;368;29;339;42.69;7.88
89233;080206;Przedszkole|Stary Raduszec| 47 |66-600 Krosno Odrzańskie;1077;346;346;32;314;32.13;9.25
89234;080206;Szkoła Podstawowa|Radnica| 146 |66-600 Krosno Odrzańskie;760;234;234;13;221;30.79;5.56
89235;080206;Zespół Edukacyjny|Osiecznica|ul. Szkolna 15 |66-600 Krosno Odrzańskie;1432;639;639;7;632;44.62;1.10
89236;080206;Zespół Szkół|Wężyska| 162 |66-600 Krosno Odrzańskie;1075;347;347;28;319;32.28;8.07
89237;080206;Nowy Szpital Powiatu Krośnieńskiego|Krosno Odrzańskie|Piastów 3 |66-600 Krosno Odrzańskie;17;3;3;0;3;17.65;0.00
89238;080207;Zespół Szkół|Maszewo| 114 |66-614 Maszewo;1304;411;411;22;389;31.52;5.35
89239;080207;Szkoła Podstawowa|Gęstowice| 32 |66-614 Maszewo;1031;292;292;19;273;28.32;6.51
89240;080301;Sala Wiejska w Bledzewie|Bledzew|ul. Rynek 3 |66-350 Bledzew;922;421;421;18;403;45.66;4.28
89241;080301;Sala Wiejska w Zemsku|Zemsko| 28 |66-350 Bledzew;787;248;248;21;227;31.51;8.47
89242;080301;Sala Wiejska w Goruńsku|Goruńsko| 80 |66-350 Bledzew;360;136;136;5;131;37.78;3.68
89243;080301;Sala Wiejska Templewo|Templewo| 28 |66-350 Bledzew;595;181;181;17;164;30.42;9.39
89244;080301;Sala Wiejska Nowa Wieś|Nowa Wieś| 24a |66-350 Bledzew;416;159;159;4;155;38.22;2.52
89245;080301;Sala Wiejska Osiecko|Osiecko| 4a |66-350 Bledzew;523;151;151;14;137;28.87;9.27
89246;080302;Starostwo Powiatowe w Międzyrzeczu|Międzyrzecz|ul. Przemysłowa 2 |66-300 Międzyrzecz;844;341;341;15;326;40.40;4.40
89247;080302;Przedszkole Nr 1 w Międzyrzeczu|Międzyrzecz|ul. Dr Tadeusza Podbielskiego 5 |66-300 Międzyrzecz;969;363;363;8;355;37.46;2.20
89248;080302;Gimnazjum Nr 2 w Międzyrzeczu|Międzyrzecz|ul. Komisji Edukacji Narodowej 1 |66-300 Międzyrzecz;1158;627;627;16;611;54.15;2.55
89249;080302;Szkoła Podstawowa Nr 3 w Międzyrzeczu|Międzyrzecz|ul. Mickiewicza 5 |66-300 Międzyrzecz;1036;536;536;14;522;51.74;2.61
89250;080302;Przedszkole Nr 6 w Międzyrzeczu|Międzyrzecz|ul. Mickiewicza 25 |66-300 Międzyrzecz;1789;861;861;21;840;48.13;2.44
89251;080302;Międzyrzecki Ośrodek Kultury w Międzyrzeczu|Międzyrzecz|ul. Konstytucji 3 Maja 30 |66-300 Międzyrzecz;1890;826;826;35;791;43.70;4.24
89252;080302;Gimnazjum Nr 1 w Międzyrzeczu|Międzyrzecz|ul. Staszica 22A |66-300 Międzyrzecz;1058;464;464;11;453;43.86;2.37
89253;080302;Biblioteka Publiczna w Międzyrzeczu|Międzyrzecz|Osiedle Centrum 8 |66-300 Międzyrzecz;960;501;501;13;488;52.19;2.59
89254;080302;Zespół Szkół Budowlanych w Międzyrzeczu|Międzyrzecz|Marcinkowskiego 26 |66-300 Międzyrzecz;904;502;502;15;487;55.53;2.99
89255;080302;Samodzielny Publiczny Szpital dla Nerwowo i Psychicznie Chorych w Międzyrzeczu|Międzyrzecz|ul. Poznańska 109 Pawilon IV - Klub Chorych|66-300 Międzyrzecz;960;488;488;12;476;50.83;2.46
89256;080302;Szkoła Podstawowa w Kaławie|Kaława| 92 |66-300 Międzyrzecz;798;317;317;9;308;39.72;2.84
89257;080302;Szkoła Podstawowa w Bukowcu|Bukowiec| 61 |66-300 Międzyrzecz;861;337;337;26;311;39.14;7.72
89258;080302;Zespół Szkół Centrum Kształcenia Rolniczego w Bobowicku|Bobowicko|ul. Międzyrzecka 7a |66-300 Międzyrzecz;1170;628;628;16;612;53.68;2.55
89259;080302;Zespół Szkół Ekonomicznych w Międzyrzeczu|Międzyrzecz|ul. Libelta 4 |66-300 Międzyrzecz;1008;356;356;9;347;35.32;2.53
89260;080302;Remiza Ochotniczej Straży Pożarnej w Kęszycy Leśnej|Kęszyca Leśna| 56 |66-300 Międzyrzecz;754;296;296;8;288;39.26;2.70
89261;080302;Centrum Rekreacyjno-Sportowe w Gorzycy|Gorzyca| 36 |66-300 Międzyrzecz;688;238;238;5;233;34.59;2.10
89262;080302;Ośrodek Szkolenia i Wychowania Ochotnicze Hufce Pracy w Międzyrzeczu|Międzyrzecz|Piastowska 18 |66-300 Międzyrzecz;1019;508;508;11;497;49.85;2.17
89263;080302;Przedszkole Nr 4 w Międzyrzeczu|Międzyrzecz|Zachodnia 8 |66-300 Międzyrzecz;1002;450;450;19;431;44.91;4.22
89264;080302;Nadleśnictwo Międzyrzecz w Międzyrzeczu|Międzyrzecz|Poznańska 38 |66-300 Międzyrzecz;772;367;367;6;361;47.54;1.63
89265;080302;Szpital Międzyrzecki Sp. z o.o. w Międzyrzeczu|Międzyrzecz|Konstytucji 3 Maja 35 |66-300 Międzyrzecz;32;9;9;0;9;28.12;0.00
89266;080302;Areszt Śledczy w Międzyrzeczu|Międzyrzecz|Młyńska 21 |66-300 Międzyrzecz;341;188;188;33;155;55.13;17.55
89267;080302;Samodzielny Publiczny Szpital dla Nerwowo i Psychicznie Chorych w Międzyrzeczu, Pawilon IV - Klub Chorych (wejście główne)|Międzyrzecz|Poznańska 109 |66-300 Międzyrzecz;387;85;85;3;82;21.96;3.53
89268;080303;Wiejski Dom Kultury w Chełmsku|Chełmsko| 15 |66-340 Przytoczna;388;111;111;12;99;28.61;10.81
89269;080303;Świetlica Wiejska w Goraju|Goraj| 24 |66-340 Przytoczna;960;262;262;12;250;27.29;4.58
89270;080303;Urząd Gminy Przytoczna|Przytoczna|ul.Rokitniańska 4 |66-340 Przytoczna;2098;939;939;46;893;44.76;4.90
89271;080303;Dom Strażaka w Rokitnie|Rokitno| 12B |66-340 Przytoczna;386;186;186;6;180;48.19;3.23
89272;080303;Szkoła Podstawowa w Wierzbnie|Wierzbno| 31 |66-340 Przytoczna;270;107;107;6;101;39.63;5.61
89273;080303;Świetlica Wiejska w Nowej Niedrzwicy|Nowa Niedrzwica| 6 |66-340 Przytoczna;391;137;137;4;133;35.04;2.92
89274;080303;Dom Pomocy Społecznej Rokitno 58|Rokitno| 58 |66-340 Przytoczna;48;19;19;3;16;39.58;15.79
89275;080303;Dom Pomocy Społecznej Rokitno 38|Rokitno| 38 |66-340 Przytoczna;56;19;19;3;16;33.93;15.79
89276;080304;Szkoła Podstawowa im. M. Kopernika w Pszczewie|Pszczew|ul. Władysława Sikorskiego 23 |66-330 Pszczew;1645;743;743;39;704;45.17;5.25
89277;080304;Sala Wiejska w Policku|Policko| 30a |66-330 Pszczew;343;132;132;7;125;38.48;5.30
89278;080304;Sala Wiejska w Stołuniu|Stołuń| 23a |66-330 Pszczew;445;135;135;10;125;30.34;7.41
89279;080304;Sala Wiejska w Nowym Gorzycku|Nowe Gorzycko| 14 |66-330 Pszczew;405;137;137;7;130;33.83;5.11
89280;080304;Sala Wiejska w Silnej|Silna| 24b |66-330 Pszczew;278;121;121;3;118;43.53;2.48
89281;080304;Sala wiejska w Stokach|Stoki| 37A |66-330 Pszczew;258;108;108;7;101;41.86;6.48
89282;080304;Dom Pomocy Społecznej w Szarczu|Szarcz| 30 |66-330 Pszczew;50;45;45;0;45;90.00;0.00
89283;080305;Ośrodek Sportu i Rekreacji w Skwierzynie (kawiarnia)|Skwierzyna|ul. Sportowa 1 |66-440 Skwierzyna;1218;568;568;15;553;46.63;2.64
89284;080305;Ośrodek Sportu i Rekreacji w Skwierzynie (świetlica)|Skwierzyna|ul. Sportowa 1 |66-440 Skwierzyna;1333;590;590;18;572;44.26;3.05
89285;080305;Centrum Kształcenia Praktycznego w Skwierzynie|Skwierzyna|ul. Mickiewicza 3 |66-440 Skwierzyna;1397;682;682;15;667;48.82;2.20
89286;080305;Skwierzyński Ośrodek Kultury w Skwierzynie|Skwierzyna|ul. Teatralna 5 |66-440 Skwierzyna;1338;587;587;22;565;43.87;3.75
89287;080305;Gimnazjum im. Władysława Jagiełły w Skwierzynie|Skwierzyna|ul. Batorego 14 |66-440 Skwierzyna;1258;463;463;16;447;36.80;3.46
89288;080305;Ośrodek Pomocy Społecznej w Skwierzynie|Skwierzyna|ul. Batorego 15 |66-440 Skwierzyna;1215;518;518;15;503;42.63;2.90
89289;080305;Świetlica Wiejska w Trzebiszewie|Trzebiszewo|ul. Główna 39a |66-440 Skwierzyna;535;229;229;10;219;42.80;4.37
89290;080305;Szkoła Podstawowa w Murzynowie|Murzynowo|Kościelna 7 |66-440 Skwierzyna;689;217;217;27;190;31.49;12.44
89291;080305;Świetlica Wiejska w Świniarach|Świniary| 41 |66-440 Skwierzyna;366;140;140;7;133;38.25;5.00
89292;080305;Świetlica Wiejska w Krobielewku|Krobielewko| 5a |66-440 Skwierzyna;193;59;59;2;57;30.57;3.39
89293;080305;Świetlica Wiejska w Gościnowie|Gościnowo| 28 |66-440 Skwierzyna;350;102;102;9;93;29.14;8.82
89294;080305;NZOZ Szpital im. dr n. med. Radzimira Śmigielskiego Sp. z o.o. w Skwierzynie|Skwierzyna|Szpitalna 5 |66-440 Skwierzyna;46;8;8;0;8;17.39;0.00
89295;080306;Gminny Ośrodek Kultury i Sportu w Trzcielu|Trzciel|ul. Poznańska 9 |66-320 Trzciel;1984;875;875;43;832;44.10;4.91
89296;080306;Dom Pomocy Społecznej|Jasieniec| 69 |66-320 Trzciel;1158;454;454;10;444;39.21;2.20
89297;080306;Biblioteka Publiczna w Trzcielu Filia|Lutol Suchy| 73 |66-304 Brójce;987;366;366;24;342;37.08;6.56
89298;080306;Zespół Edukacyjny w Brójcach|Brójce|ul. Polna 1 |66-304 Brójce;1060;374;374;26;348;35.28;6.95
89299;080401;Publiczne Gimnazjum Nr 3|Nowa Sól|ul. Kasprowicza 8 |67-100 Nowa Sól;1767;866;867;23;843;49.01;2.66
89300;080401;Publiczne Gimnazjum Nr 3|Nowa Sól|ul. Kasprowicza 8 |67-100 Nowa Sól;1284;724;724;15;709;56.39;2.07
89301;080401;Publiczne Gimnazjum nr 3|Nowa Sól|Kasprowicza 8 |67-100 Nowa Sól;1162;615;615;18;597;52.93;2.93
89302;080401;Publiczna Szkoła Podstawowa Nr 8|Nowa Sól|ul. Matejki 29 |67-100 Nowa Sól;1787;971;971;11;960;54.34;1.13
89303;080401;Publiczne Przedszkole nr 12|Nowa Sól|Osiedle Konstytucji 3 Maja |67-100 Nowa Sól;1737;976;976;17;959;56.19;1.74
89304;080401;Publiczna Szkoła Podstawowa Nr 3|Nowa Sól|ul. Botaniczna 22 |67-100 Nowa Sól;2140;1107;1107;25;1082;51.73;2.26
89305;080401;Publiczna Szkoła Podstawowa Nr 3|Nowa Sól|ul. Botaniczna 22 |67-100 Nowa Sól;996;472;472;20;452;47.39;4.24
89306;080401;Hala Sportowa "CKZiU" Elektryk|Nowa Sól|ul. Marszałka Józefa Piłsudskiego 61 |67-100 Nowa Sól;2033;790;790;21;769;38.86;2.66
89307;080401;Publiczne Przedszkole Nr 11|Nowa Sól|Osiedle XXX-lecia PRL |67-100 Nowa Sól;1637;914;914;22;892;55.83;2.41
89308;080401;Publiczna Szkoła Podstawowa Nr 8|Nowa Sól|ul. Matejki 29 |67-100 Nowa Sól;2015;1085;1085;25;1060;53.85;2.30
89309;080401;Publiczna Szkoła Podstawowa Nr 5|Nowa Sól|ul. Walki Młodych 2 |67-100 Nowa Sól;1122;562;562;18;544;50.09;3.20
89310;080401;Publiczna Szkoła Podstawowa nr 5|Nowa Sól|Walki Młodych 2 |67-100 Nowa Sól;1204;646;646;19;627;53.65;2.94
89311;080401;Publiczne Przedszkole Nr 9|Nowa Sól|ul. Wrocławska 37A |67-100 Nowa Sól;1834;787;787;22;765;42.91;2.80
89312;080401;Publiczna Szkoła Podstawowa Nr 6|Nowa Sól|ul. Kościuszki 26 |67-100 Nowa Sól;1042;509;509;15;494;48.85;2.95
89313;080401;Publiczne Gimnazjum Nr 2|Nowa Sól|ul. Gimnazjalna 11 |67-100 Nowa Sól;1680;626;626;13;613;37.26;2.08
89314;080401;Publiczne Gimnazjum Nr 1|Nowa Sól|ul. Parafialna 6 |67-100 Nowa Sól;1940;694;694;29;665;35.77;4.18
89315;080401;Publiczna Szkoła Podstawowa Nr 1|Nowa Sól|ul. Szkolna 1 |67-100 Nowa Sól;1823;712;712;23;689;39.06;3.23
89316;080401;Miejski Ośrodek Sportu i Rekreacji|Nowa Sól|ul. Św. Barbary 2 |67-100 Nowa Sól;1737;829;829;16;813;47.73;1.93
89317;080401;Publiczne Przedszkole Nr 6|Nowa Sól|ul. Kasprzaka 3 |67-100 Nowa Sól;1776;807;807;31;776;45.44;3.84
89318;080401;Szpital|Nowa Sól|Chałubińskiego 7 |67-100 67-100;189;94;94;2;92;49.74;2.13
89319;080401;Areszt Śledczy|Nowa Sól|Żeromskiego 2 |67-100 67-100;99;73;73;11;62;73.74;15.07
89320;080402;Zespół Szkół|Bytom Odrzański|ul. Kościelna 9 |67-115 Bytom Odrzański;2124;978;978;36;942;46.05;3.68
89321;080402;Zespół Szkół|Bytom Odrzański|ul. Kożuchowska 15 |67-115 Bytom Odrzański;2196;840;840;36;804;38.25;4.29
89322;080403;Sala Posiedzeń Urzędu Gminy Kolsko|Kolsko|ul.Piastowska 12 |67-415 Kolsko;1570;614;614;51;563;39.11;8.31
89323;080403;Zespól Edukacyjny Konotop|Konotop|Plac Powstańców Wlkp. 7 |67-416 Konotop;1067;375;375;12;363;35.15;3.20
89324;080404;Szkoła Podstawowa Nr 2|Kożuchów|ul. 22 Lipca 12 |67-120 Kożuchów;799;350;350;11;339;43.80;3.14
89325;080404;Zespół Szkół Ponadgimnazjalnych Nr 5|Kożuchów|ul. 22 Lipca 5 |67-120 Kożuchów;1726;851;851;30;821;49.30;3.53
89326;080404;Szkoła Podstawowa Nr 1|Kożuchów|ul. Szprotawska 2 |67-120 Kożuchów;1797;703;703;30;673;39.12;4.27
89327;080404;Kożuchowski Ośrodek Kultury i Sportu "ZAMEK"|Kożuchów|ul. Klasztorna 14 |67-120 Kożuchów;1594;627;627;21;606;39.34;3.35
89328;080404;Samorządowe Gimnazjum|Kożuchów|ul. Anny Haller 1 |67-120 Kożuchów;2356;1119;1119;46;1073;47.50;4.11
89329;080404;Dom Pomocy Społecznej|Kożuchów|ul.Szprotawska 19 |67-120 Kożuchów;89;25;25;8;17;28.09;32.00
89330;080404;Świetlica Wiejska|Stypułów| |67-120 Kożuchów;823;269;269;8;261;32.69;2.97
89331;080404;Dom Aktywności Wiejskiej|Broniszów| |67-120 Kożuchów;661;272;272;10;262;41.15;3.68
89332;080404;Budynek po byłej Szkole|Studzieniec| |67-120 Kożuchów;876;281;281;20;261;32.08;7.12
89333;080404;Szkoła Podstawowa|Mirocin Dolny| 28 |67-120 Kożuchów;988;353;353;19;334;35.73;5.38
89334;080404;Świetlica Wiejska|Czciradz| 34 |67-120 Kożuchów;1041;297;297;15;282;28.53;5.05
89335;080405;budynek sali wiejskiej|Kiełcz|ul. Odrzańska 12 |67-100 Nowa Sól;1119;471;471;10;461;42.09;2.12
89336;080405;Publiczna Szkoła Podstawowa|Przyborów|ul. Szkolna 16 |67-100 Nowa Sól;1037;403;403;9;394;38.86;2.23
89337;080405;Publiczna Szkoła Podstawowa|Lubieszów| 53 |67-100 Nowa Sól;1440;657;657;13;644;45.62;1.98
89338;080405;budynek sali wiejskiej|Lipiny| 77 |67-108 Lubięcin;599;216;216;9;207;36.06;4.17
89339;080405;Zespół Szkół|Lubięcin| 82 |67-108 Lubięcin;1279;553;553;14;539;43.24;2.53
89340;080406;Świetlica szkolna Zespół Szkół nr 1|Nowe Miasteczko|Szkolna |67-124 Nowe Miasteczko;1214;546;546;16;530;44.98;2.93
89341;080406;Urząd Miejski|Nowe Miasteczko|Rynek 2 |67-124 Nowe Miasteczko;1090;422;422;27;395;38.72;6.40
89342;080406;Dom Kultury|Nowe Miasteczko|Kościuszki 2 |67-124 Nowe Miasteczko;808;264;264;18;246;32.67;6.82
89343;080406;Dom Strażaka w Borowie Wielkim|Borów Wielki| |67-124 Nowe Miasteczko;496;165;165;7;158;33.27;4.24
89344;080406;Dom Gościa w Miłakowie|Miłaków| |67-124 Nowe Miasteczko;255;81;81;9;72;31.76;11.11
89345;080406;Świetlica ANR w Popęszycach|Popęszyce| |67-124 Nowe Miasteczko;291;81;81;6;75;27.84;7.41
89346;080406;Świetlica wiejska w Żukowie|Żuków| |67-124 Nowe Miasteczko;208;89;89;7;82;42.79;7.87
89347;080407;Zespół Szkół|Otyń|ul. Żeromskiego 3 |67-106 Otyń;1785;712;712;29;683;39.89;4.07
89348;080407;Oddział Przedszkolny|Modrzyca|ul. Janiny Kowalskiej 2 |67-106 Otyń;1412;683;683;21;662;48.37;3.07
89349;080407;Świetlica Wiejska|Zakęcie| 52 |67-106 Otyń;917;373;373;15;358;40.68;4.02
89350;080407;Zespół Szkół|Niedoradz|ul. Markiewiczowej 7 |67-106 Otyń;1175;466;466;28;438;39.66;6.01
89351;080408;Szkoła Podstawowa|Bielawy| 17 |67-112 Siedlisko;924;269;269;16;253;29.11;5.95
89352;080408;Publiczne Przedszkole|Siedlisko|Głogowska 37 |67-112 Siedlisko;1830;737;737;33;704;40.27;4.48
89353;080501;Zespół Szkół w Cybince|Cybinka|ul. Szkolna 15 |69-108 Cybinka;2241;861;861;46;815;38.42;5.34
89354;080501;Zespół Szkół w Cybince|Cybinka|ul. Szkolna 15 |69-108 Cybinka;1205;298;298;13;285;24.73;4.36
89355;080501;Świetlica Środowiskowa w Uradzie|Urad|ul. Odrzańska 11 |69-108 Cybinka;480;146;146;14;132;30.42;9.59
89356;080501;Świetlica Środowiskowa w Rąpicach|Rąpice|ul. Młyńska 1 |69-108 Cybinka;444;120;120;8;112;27.03;6.67
89357;080501;Szkoła Podstawowa w Białkowie|Białków| 72 |69-108 Cybinka;963;310;310;15;295;32.19;4.84
89358;080502;Centrum Spotkań Polsko - Niemieckich w Górzycy|Górzyca|Polna 8 1|69-113 Górzyca;1469;624;624;45;579;42.48;7.21
89359;080502;Szkoła Podstawowa im. Kresowian w Czarnowie|Czarnów|Pl. Wolności 17 |69-113 Górzyca;676;258;258;12;246;38.17;4.65
89360;080502;Niepubliczna Szkoła Podstawowa w Pamięcinie - Szkoła Filialna w Żabicach|Żabice|Kostrzyńska 5 |69-113 Górzyca;489;151;151;8;143;30.88;5.30
89361;080502;Niepubliczna Szkoła Podstawowa w Pamięcinie ze Szkołą Filialną w Żabicach,Pamięcin|Pamięcin| 29 |69-113 Górzyca;670;178;178;10;168;26.57;5.62
89362;080503;Środowiskowy Dom Samopomocy w Ośnie Lubuskim|Ośno Lubuskie|ul. Rybacka 3E |69-220 Ośno Lubuskie;1191;510;510;19;491;42.82;3.73
89363;080503;Sala Widowiskowa Miejskiego Domu Kultury w Ośnie Lubuskim|Ośno Lubuskie|ul. Bolesława Chrobrego 1 |69-220 Ośno Lubuskie;1194;522;522;23;499;43.72;4.41
89364;080503;Agencja Nieruchomości Rolnych - Sekcja Zamiejscowa Gospodarowania Zasobem WRSP w Ośnie Lubuskim|Ośno Lubuskie|ul. 3 Maja 24 |69-220 Ośno Lubuskie;1857;638;638;32;606;34.36;5.02
89365;080503;Szkoła Podstawowa w Smogórach|Smogóry| 10 |69-220 Ośno Lubuskie;879;243;243;31;212;27.65;12.76
89366;080504;Szkoła Podstawowa Nr 1 w Rzepinie|Rzepin|ul. Wojska Polskiego 28 |69-110 Rzepin;1574;616;616;27;589;39.14;4.38
89367;080504;Zespół Szkół Ogólnokształcących w Rzepinie|Rzepin|ul. Woj. Polskiego 30 |69-110 Rzepin;1569;591;591;14;577;37.67;2.37
89368;080504;Świetlica Remizy Ochotniczej Straży Pożarnej w Rzepinie|Rzepin|ul. Ośniańska 4 |69-110 Rzepin;1585;636;636;25;611;40.13;3.93
89369;080504;Miejski Dom Kultury w Rzepinie|Rzepin|ul. Słubicka 3 |69-110 Rzepin;1616;694;694;13;681;42.95;1.87
89370;080504;Zespół Szkół w Kowalowie|Kowalów|ul. Rzepińska 10 |69-110 Rzepin;1446;465;465;21;444;32.16;4.52
89371;080505;Zespół Szkół Ekonomiczno-Rolniczych w Słubicach|Słubice|Aleja Niepodległości 23 |69-100 Słubice;1060;529;529;8;521;49.91;1.51
89372;080505;Szkoła Podstawowa nr 3 w Słubicach|Słubice|Kilińskiego 8 |69-100 Słubice;971;464;464;14;450;47.79;3.02
89373;080505;Słubicki Miejski Ośrodek Kultury w Słubicach|Słubice|ul. 1 Maja 1 |69-100 Słubice;928;387;387;8;379;41.70;2.07
89374;080505;Przedszkole Samorządowe nr 1 w Słubicach|Słubice|ul. Kopernika 62 |69-100 Słubice;1035;453;453;18;435;43.77;3.97
89375;080505;Szkoła Podstawowa nr 1 w Słubicach|Słubice|Wojska Polskiego 1 |69-100 Słubice;1095;513;513;21;492;46.85;4.09
89376;080505;Biblioteka Publiczna Miasta i Gminy w Słubicach|Słubice|ul. Jedności Robotniczej 18 |69-100 Słubice;894;423;423;14;409;47.32;3.31
89377;080505;Przedszkole Samorządowe nr 3 w Słubicach|Słubice|ul. Podchorążych 3 |69-100 Słubice;862;394;394;8;386;45.71;2.03
89378;080505;Zespół Szkół Technicznych w Słubicach|Słubice|Aleja Niepodległości 13 |69-100 Słubice;1005;415;415;9;406;41.29;2.17
89379;080505;Przedszkole Samorządowe nr 2|Słubice|Narutowicza 17 |69-100 Słubice;821;338;338;8;330;41.17;2.37
89380;080505;Gimnazjum nr 1 w Słubicach|Słubice|ul. Wojska Polskiego 1 |69-100 Słubice;1120;498;498;7;491;44.46;1.41
89381;080505;Przedszkole Samorządowe nr 4|Słubice|Bohaterów Warszawy 8 |69-100 Słubice;1006;512;512;18;494;50.89;3.52
89382;080505;Gimnazjum nr 2 w Słubicach|Słubice|ul. Wojska Polskiego 38 |69-100 Słubice;1070;456;456;7;449;42.62;1.54
89383;080505;Szkoła Podstawowa nr 2 w Słubicach|Słubice|ul. Wojska Polskiego 38 |69-100 Słubice;1139;510;510;12;498;44.78;2.35
89384;080505;Świetlica Wiejska w Drzecinie|Drzecin| 30b |69-100 Słubice;1162;368;368;19;349;31.67;5.16
89385;080505;Świetlica Wiejska w Rybocicach|Rybocice| 20 |69-100 Słubice;388;148;148;5;143;38.14;3.38
89386;080505;Szkoła Podstawowa w Kunowicach|Kunowice|ul. Słubicka 18 |69-100 Słubice;805;418;418;14;404;51.93;3.35
89387;080505;Niepubliczny Zakład Opieki Zdrowotnej "Szpital Powiatowy" w Słubicach|Słubice|Nadodrzańska 6 |69-100 Słubice;40;25;25;0;25;62.50;0.00
89388;080601;Szkoła Podstawowa|Dobiegniew|Gdańska 8 |66-520 Dobiegniew;2186;852;852;53;799;38.98;6.22
89389;080601;Zespół Szkół|Dobiegniew|Poznańska 5 |66-520 Dobiegniew;2116;859;859;21;838;40.60;2.44
89390;080601;Budynek sportowy|Mierzęcin| 60 |66-520 Dobiegniew;413;157;157;8;149;38.01;5.10
89391;080601;Świetlica wiejska|Radęcin| 72A |66-520 Dobiegniew;479;142;142;10;132;29.65;7.04
89392;080601;Nadleśnictwo Głusko|Głusko| 19 |66-520 Dobiegniew;259;105;105;3;102;40.54;2.86
89393;080601;Dom Pomocy Społecznej w Dobiegniewie|Dobiegniew|Gdańska 17 |66-520 Dobiegniew;46;37;37;3;34;80.43;8.11
89394;080602;Zespół Szkół im.Henryka Sienkiewicza w Drezdenku|Drezdenko|ul. Portowa 1 |66-530 Drezdenko;1066;484;484;18;466;45.40;3.72
89395;080602;Gimnazjum nr 1 w Drezdenku|Drezdenko|ul. Plac Wolności 8 |66-530 Drezdenko;1491;583;583;31;552;39.10;5.32
89396;080602;Szkoła Podstawowa nr 1 w Drezdenku|Drezdenko|ul. Szkolna 11 |66-530 Drezdenko;1736;751;751;25;726;43.26;3.33
89397;080602;Publiczne Przedszkole w Drezdenku|Drezdenko|ul. Kopernika 16 |66-530 Drezdenko;1266;636;636;12;624;50.24;1.89
89398;080602;Hala Sportowo-Rehabilitacyjna w Drezdenku|Drezdenko|ul. Konopnickiej 4 |66-530 Drezdenko;1906;837;837;20;817;43.91;2.39
89399;080602;Hala Sportowo-Rehabliitacyjna w Drezdenku|Drezdenko|Konopnickiej 4 |66-530 Drezdenko;839;406;406;9;397;48.39;2.22
89400;080602;Zespół Szkół im. Henryka Sienkiewicza w Drezdenku|Drezdenko|Portowa 1 |66-530 Drezdenko;398;128;128;3;125;32.16;2.34
89401;080602;Szkoła Podstawowa w Drawinach|Drawiny| 62 |66-530 Drezdenko;437;137;137;6;131;31.35;4.38
89402;080602;Szkoła Podstawowa w Gościmiu|Gościm| 141 |66-530 Drezdenko;1129;380;380;15;365;33.66;3.95
89403;080602;Szkoła Podstawowa w Trzebiczu|Trzebicz|Szkolna 1 |66-530 Drezdenko;1122;447;447;23;424;39.84;5.15
89404;080602;Szkoła Podstawowa w Grotowie|Grotów| 88 |66-530 Drezdenko;767;245;245;10;235;31.94;4.08
89405;080602;Szkoła Podstawowa w Niegosławiu|Niegosław| 69 |66-530 Drezdenko;968;358;358;33;325;36.98;9.22
89406;080602;Sala Wiejska w miejscowości Lipno|Lipno| 18a |66-530 Drezdenko;665;213;213;11;202;32.03;5.16
89407;080602;Budynek B na parterze Powiatowego Centrum Zdrowia Sp.z.o.o.Szpital Powiatowy|Drezdenko|Piłsudskiego 8 |66-530 Drezdenko;29;16;16;2;14;55.17;12.50
89408;080603;Gminny Ośrodek Kultury|Stare Kurowo|ul. Żymierskiego 8 |66-540 Stare Kurowo;1709;697;697;26;671;40.78;3.73
89409;080603;Sala wiejska w Przynotecku|Przynotecko| 40 |66-540 Stare Kurowo;668;194;194;11;183;29.04;5.67
89410;080603;Szkoła Podstawowa w Nowym Kurowie|Nowe Kurowo| 35 |66-540 Stare Kurowo;390;122;122;7;115;31.28;5.74
89411;080603;Sala Wiejska w Łącznicy|Łącznica| 66 |66-540 Stare Kurowo;565;197;197;7;190;34.87;3.55
89412;080604;Urząd Miejski w Strzelcach Krajeńskich|Strzelce Krajeńskie|ul. Al.Wolności 48 |66-500 Strzelce Krajeńskie;1643;753;753;38;715;45.83;5.05
89413;080604;Specjalny Ośrodek Szkolno-Wychowawczy w Strzelcach Krajeńskich|Strzelce Krajeńskie|ul. Tadeusza Kościuszki 28 |66-500 Strzelce Krajeńskie;1942;800;800;22;778;41.19;2.75
89414;080604;Publiczna Szkoła Podstawowa w Strzelcach Krajeńskich|Strzelce Krajeńskie|ul. Ks. Jerzego Popiełuszki 31 |66-500 Strzelce Krajeńskie;1743;814;814;18;796;46.70;2.21
89415;080604;Strzelecki Ośrodek Kultury w Strzelcach Krajeńskich|Strzelce Krajeńskie|ul. Wojska Polskiego 7 |66-500 Strzelce Krajeńskie;1674;571;571;21;550;34.11;3.68
89416;080604;Publiczne Gimnazjum w Strzelcach Krajeńskich|Strzelce Krajeńskie|ul. Juliusza Słowackiego 14 |66-500 Strzelce Krajeńskie;1890;869;869;32;837;45.98;3.68
89417;080604;Świetlica Wiejska w Brzozie|Brzoza| 35a 2|66-500 Strzelce Krajeńskie;968;316;316;8;308;32.64;2.53
89418;080604;Świetlica Wiejska w Buszowie|Buszów| 47a |66-500 Bobrówko;968;302;302;11;291;31.20;3.64
89419;080604;Publiczna Szkoła Podstawowa w Tucznie|Tuczno|ul. Szkolna 1 |66-510 Bobrówko;1010;239;239;16;223;23.66;6.69
89420;080604;Publiczna Szkoła Podstawowa w Bobrówku|Bobrówko|ul. Choszczańska 7 |66-510 Bobrówko;1024;317;317;22;295;30.96;6.94
89421;080604;Świetlica Wiejska w Lipich Górach|Lipie Góry|ul. Gen. Karola Świerczewskiego 13 |66-510 Bobrówko;907;257;257;9;248;28.34;3.50
89422;080605;Sala wiejska w Gościmcu|Gościmiec| 94 |66-542 Zwierzyn;782;228;228;17;211;29.16;7.46
89423;080605;Remiza Ochotniczej Straży Pożarnej w Górecku|Górecko| 19A |66-542 Zwierzyn;291;91;91;12;79;31.27;13.19
89424;080605;Gminna Biblioteka Publiczna w Zwierzynie- Filia w Górkach Noteckich|Górki Noteckie|Cmentarna 2 |66-542 Zwierzyn;1065;398;398;31;367;37.37;7.79
89425;080605;Gminny Ośrodek Kultury w Zwierzynie|Zwierzyn|ul.Wojska Polskiego 6 |66-542 Zwierzyn;1354;558;558;24;534;41.21;4.30
89426;080701;Publiczne Gimnazjum w Krzeszycach|Krzeszyce|ul. Skwierzyńska 4 |66-435 Krzeszyce;1865;812;812;40;772;43.54;4.93
89427;080701;Świetlica wiejska w Malcie|Malta| 30 |66-435 Krzeszyce;777;253;253;5;248;32.56;1.98
89428;080701;Szkoła Podstawowa w Kołczynie|Kołczyn|ul. Sulęcińska 29 |66-435 Krzeszyce;1128;390;390;15;375;34.57;3.85
89429;080702;Urząd Miejski Lubniewice|Lubniewice|ul. Jana Pawła II 51 |69-210 Lubniewice;1581;698;698;33;665;44.15;4.73
89430;080702;Świetlica-Lubniewice|Lubniewice|Osiedle Świerczów 3B |69-210 Lubniewice;152;34;34;4;30;22.37;11.76
89431;080702;Świetlica Wiejska Jarnatów|Jarnatów| 39A |69-210 Lubniewice;237;71;71;1;70;29.96;1.41
89432;080702;Świetlica Glisno|Glisno| 23 |69-210 Lubniewice;623;242;242;11;231;38.84;4.55
89433;080703;Sala wiejska w Słońsku|Słońsk|ul. Parkowa 2 |66-436 Słońsk;1336;535;535;25;510;40.04;4.67
89434;080703;Zespół Szkół w Słońsku|Słońsk|ul. Lipowa 9 |66-436 Słońsk;1280;495;495;36;459;38.67;7.27
89435;080703;Sala wiejska w Lemierzycach|Lemierzyce|ul. Kościuszki 27 |66-436 Słońsk;719;254;254;17;237;35.33;6.69
89436;080703;Sala wiejska w Głuchowie|Głuchowo|ul. Lemierzycka 4b |66-436 Słońsk;479;113;113;9;104;23.59;7.96
89437;080703;Zakład Karny Gorzów Wielkopolski - Oddział Zewnętrzyny w Słońsku|Słońsk|Winna 2 |66-436 Słońsk;295;102;102;18;84;34.58;17.65
89438;080704;Zespół Szkół Licealnych i Zawodowych im. Unii Europejskiej|Sulęcin|ul. Witosa 49 |69-200 Sulęcin;967;487;487;8;479;50.36;1.64
89439;080704;Przedszkole im. Małego Przyrodnika|Sulęcin|ul. Dudka 15a |69-200 Sulęcin;885;409;409;7;402;46.21;1.71
89440;080704;Gimnazjum im. Jana Pawła II|Sulęcin|Park Bankowy 7 |69-200 Sulęcin;868;396;396;5;391;45.62;1.26
89441;080704;Szkoła Podstawowa im. Polskich Olimpijczyków|Sulęcin|Osiedle Kopernika 7 |69-200 Sulęcin;881;451;451;14;437;51.19;3.10
89442;080704;Przedszkole Nr 2 im. Małych Odkrywców|Sulęcin|Os. Kopernika 7 |69-200 Sulęcin;964;485;485;14;471;50.31;2.89
89443;080704;Spółdzielnia Mieszkaniowa|Sulęcin|Park Bankowy 1 |69-200 Sulęcin;847;401;401;12;389;47.34;2.99
89444;080704;Środowiskowy Dom Samopomocy|Sulęcin|ul. Żeromskiego 71 |69-200 Sulęcin;873;312;312;11;301;35.74;3.53
89445;080704;Sulęciński Ośrodek Kultury|Sulęcin|ul. Moniuszki 1 |69-200 Sulęcin;879;299;299;7;292;34.02;2.34
89446;080704;Centrum Współpracy Polsko-Niemieckiej Dom Joannitów|Sulęcin|ul. Młynarska 1 |69-200 Sulęcin;923;397;397;11;386;43.01;2.77
89447;080704;Klub Wiejski w Ostrowie|Ostrów| 33 |69-200 Sulęcin;646;252;252;6;246;39.01;2.38
89448;080704;Wiejskie Centrum Społeczno-Kulturalne w Długoszynie|Długoszyn| 11 b |69-200 Sulęcin;948;295;295;18;277;31.12;6.10
89449;080704;Budynek byłej Szkoły Podstawowej w Żubrowie|Żubrów| 16 a |69-200 Sulęcin;676;238;238;7;231;35.21;2.94
89450;080704;Szkoła Podstawowa im. Żołnierza Polskiego w Wędrzynie|Wędrzyn|Wędrzyn 1 |69-211 Wędrzyn;660;312;312;9;303;47.27;2.88
89451;080704;Szkoła Podstawowa im. Polskich Strażaków w Trzemesznie Lubuskim|Trzemeszno Lubuskie|ul. Poznańska 63 |69-200 Sulęcin;813;309;309;24;285;38.01;7.77
89452;080704;Świetlica Wiejska w Wielowsi|Wielowieś| 12 |69-200 Sulęcin;455;136;136;6;130;29.89;4.41
89453;080704;Samodzielny Publiczny Zakład Opieki Zdrowotnej w Sulęcinie, ul. Witosa 7 (szpital)|Sulęcin|Witosa 7 |69-200 Sulęcin;38;35;35;1;34;92.11;2.86
89454;080704;Dom Pomocy Społecznej w Tursku|Tursk| 28 |69-200 Sulęcin;183;48;48;5;43;26.23;10.42
89455;080705;Szkoła Podstawowa w Torzymiu|Torzym|ul. Mickiewicza 11 |66-235 Torzym;1337;641;641;22;619;47.94;3.43
89456;080705;Przedszkole w Torzymiu|Torzym|ul. Saperska 10 |66-235 Torzym;939;360;360;13;347;38.34;3.61
89457;080705;Szkoła Podstawowa w Walewicach|Walewice| 25 |66-235 Torzym;678;191;191;12;179;28.17;6.28
89458;080705;Szkoła Podstawowa w Boczowie|Boczów|ul. Generała Sikorskiego 4 |66-235 Torzym;1227;347;347;16;331;28.28;4.61
89459;080705;Świetlica wiejska w Bielicach|Bielice| 15 |66-235 Torzym;392;106;106;12;94;27.04;11.32
89460;080705;Szkoła Podstawowa w Gądkowie Wielkim|Gądków Wielki|ul. Kościuszki 47 |66-235 Torzym;774;269;269;18;251;34.75;6.69
89461;080705;Oddział V Sala Rehabilitacyjna|Torzym|Wojska Polskiego 52 |66-235 Torzym;196;81;81;10;71;41.33;12.35
89462;080801;Urząd Gminy|Lubrza|ul. Świebodzińska 68 |66-218 Lubrza;1909;774;774;31;743;40.54;4.01
89463;080801;Niepubliczna Szkoła Podstawowa|Mostki| 81 |66-218 Lubrza;906;307;307;19;288;33.89;6.19
89464;080802;Sala Posiedzeń Urzędu Gminy|Łagów|1 Lutego 12 |66-220 Łagów;2084;987;987;33;954;47.36;3.34
89465;080802;Samorządowa Szkoła Podstawowa|Toporów|Szkolna 11 |66-220 Łagów;1144;378;378;27;351;33.04;7.14
89466;080802;Samorządowa Szkoła Podstawowa|Sieniawa| 8a |66-220 Łagów;1052;354;354;29;325;33.65;8.19
89467;080803;Klub Zakładowy Eskulap|Cibórz| 37 |66-213 Skąpe;1154;431;431;16;415;37.35;3.71
89468;080803;Gminna Biblioteka Publiczna|Ołobok|ul. Wojciechowskiego 25 |66-213 Skąpe;1369;517;517;11;506;37.76;2.13
89469;080803;Sala Posiedzeń Urzędu Gminy Skąpe|Skąpe| 65 |66-213 Skąpe;1455;532;532;18;514;36.56;3.38
89470;080803;Przychodnia Zakładowa w Cborzu|Cibórz| 7 |66-213 Skąpe;96;60;60;5;55;62.50;8.33
89471;080804;Sala Posiedzeń Urzędu Gminy|Szczaniec| 73 |66-225 Szczaniec;1567;638;638;39;599;40.71;6.11
89472;080804;Sala Wiejska|Myszęcin| |66-225 Szczaniec;591;197;197;11;186;33.33;5.58
89473;080804;Sala Wiejska|Smardzewo| |66-225 Szczaniec;967;385;385;20;365;39.81;5.19
89474;080805;Specjalny Ośrodek Szkolno-Wychowawczy|Świebodzin|ul. Żaków 1 |66-200 Świebodzin;2318;1189;1189;23;1166;51.29;1.93
89475;080805;Publiczne Przedszkole nr 7|Świebodzin|Osiedle Widok 24 |66-200 Świebodzin;1256;602;602;16;586;47.93;2.66
89476;080805;Publiczna Szkoła Podstawowa nr 7|Świebodzin|ul. Generała Świerczewskiego 74A |66-200 Świebodzin;0;0;0;0;0;-99;-99
89477;080805;Publiczne Gimnazjum nr 1|Świebodzin|ul. Gen. Sikorskiego 11 |66-200 Świebodzin;2315;996;996;20;976;43.02;2.01
89478;080805;Publiczna Szkoła Podstawowa nr 2|Świebodzin|ul. Park Chopina 1 |66-200 Świebodzin;2271;950;950;28;922;41.83;2.95
89479;080805;Świebodziński Dom Kultury|Świebodzin|ul. J. Piłsudskiego 39/41 |66-200 Świebodzin;1123;554;554;17;537;49.33;3.07
89480;080805;Publiczne Przedszkole nr 5|Świebodzin|Osiedle Łużyckiem 30 |66-200 Świebodzin;1058;517;518;17;500;48.87;3.29
89481;080805;Publiczne Gimnazjum nr 3|Świebodzin|ul. Łużycka 33 |66-200 Świebodzin;2302;1175;1175;29;1146;51.04;2.47
89482;080805;Publiczna Szkoła Podstawowa nr 6|Świebodzin|Osiedle Łużyckie 28 |66-200 Świebodzin;1412;782;782;8;774;55.38;1.02
89483;080805;Państwowa Szkoła Muzyczna|Świebodzin|ul. Sulechowska 15 |66-200 Świebodzin;1847;1050;1050;22;1028;56.85;2.10
89484;080805;Publiczna Szkoła Podstawowa w Gościkowie|Gościkowo| 9 |66-200 Świebodzin;979;400;400;18;382;40.86;4.50
89485;080805;Świetlica Wiejska|Rusinów| 39 |66-200 Świebodzin;560;179;179;9;170;31.96;5.03
89486;080805;Świetlica Wiejska|Lubinicko| 63 |66-200 Świebodzin;719;263;263;7;256;36.58;2.66
89487;080805;Świetlica Wiejska|Glińsk| 80a |66-200 Świebodzin;375;136;136;7;129;36.27;5.15
89488;080805;Świetlica Wiejska|Rzeczyca| 44 |66-200 Świebodzin;586;237;237;11;226;40.44;4.64
89489;080805;Świetlica Wiejska|Jeziory| 34 |66-200 Świebodzin;407;135;135;7;128;33.17;5.19
89490;080805;Świetlica Wiejska|Rosin| 17 |66-200 Świebodzin;535;183;183;13;170;34.21;7.10
89491;080805;Świetlica Wiejska|Chociule| 22 |66-200 Świebodzin;729;265;265;5;260;36.35;1.89
89492;080805;Świetlica Wiejska|Wilkowo| 19 |66-200 Świebodzin;1376;545;545;31;514;39.61;5.69
89493;080805;Nowy Szpital w Świebodzinie Sp. z o.o.|Świebodzin|Młyńska 6 |66-200 Świebodzin;16;2;2;0;2;12.50;0.00
89494;080806;Ośrodek Pomocy Społecznej|Zbąszynek|ul. Długa |66-210 Zbąszynek;1359;691;691;25;666;50.85;3.62
89495;080806;Gimnazjum|Zbąszynek|Plac Wolności |66-210 Zbąszynek;1355;697;697;21;676;51.44;3.01
89496;080806;Szkoła Podstawowa|Zbąszynek|ul. Sportowa |66-210 Zbąszynek;1416;753;753;21;732;53.18;2.79
89497;080806;Centrum Kultury i Folkloru|Dąbrówka Wielkopolska|ul. Piastowska |66-210 ;1375;616;616;29;587;44.80;4.71
89498;080806;Sala Wiejska|Kosieczyn|ul. Główna |66-210 ;1132;407;407;24;383;35.95;5.90
89499;080901;Gminny Ośrodek Kultury w Babimoście|Babimost|ul. Gagarina 21 |66-110 Babimost;1579;779;779;39;740;49.34;5.01
89500;080901;Gminny Ośrodek Kultury w Babimoście|Babimost|ul. Gagarina (wejście od ulicy Konstytucji 3 Maja) 21 |66-110 Babimost;1582;740;740;18;722;46.78;2.43
89501;080901;Sala Wiejska w Nowym Kramsku|Nowe Kramsko|ul. Gromadzka 4 |66-111 Babimost;1121;461;461;10;451;41.12;2.17
89502;080901;Sala Wiejska w Podmoklach Małych|Podmokle Małe| 82 |66-110 Babimost;694;304;304;18;286;43.80;5.92
89503;080902;Gminny Ośrodek Kultury|Bojadła|ul. Boczna 1a |66-130 Bojadła;1474;529;529;29;500;35.89;5.48
89504;080902;Szkoła Podstawowa|Klenica|ul. Bolesława Chrobrego 68 |66-133 ;906;331;331;27;304;36.53;8.16
89505;080902;Dom Pomocy Społecznej|Bełcze| 19 |66-130 ;293;97;97;12;85;33.11;12.37
89506;080903;Miejsko Gminny Ośrodek Kultury|Czerwieńsk|ul. B. Chrobrego 5 |66-016 Czerwieńsk;1810;897;897;17;880;49.56;1.90
89507;080903;Publiczna Szkoła Podstawowa|Czerwieńsk|ul. Graniczna 5A |66-016 Czerwieńsk;1606;699;699;25;674;43.52;3.58
89508;080903;Szkoła Podstawowa Nietków|Nietków|ul. J. Kasprowicza 76 |66-016 Czerwieńsk;1055;394;394;29;365;37.35;7.36
89509;080903;Szkoła Podstawowa|Leśniów Wielki| |66-016 Czerwieńsk;790;276;276;12;264;34.94;4.35
89510;080903;Wiejski Dom Kultury|Nietkowice| |66-100 Sulechów 1;1000;276;276;10;266;27.60;3.62
89511;080903;Wiejski Dom Kultury|Płoty|ul. Szkolna |66-016 Czerwieńsk;1027;516;516;11;505;50.24;2.13
89512;080903;Wiejski Dom Kultury|Laski| |66-016 Czerwieńsk;412;187;187;3;184;45.39;1.60
89513;080904;Zespół Szkolno- Przedszkolny|Kargowa|ul. Marchlewskiego 45 |66-120 Kargowa;1894;817;817;32;785;43.14;3.92
89514;080904;Gminne Centrum Kultury Biblioteka Publiczna im. Eugeniusza Paukszty|Kargowa|ul. Słodowa 2 |66-120 Kargowa;2037;826;826;30;796;40.55;3.63
89515;080904;Świetlica Wiejska|Smolno Wielkie| 106 |66-120 Kargowa;697;281;281;17;264;40.32;6.05
89516;080905;Urząd Miejski w Nowogrodzie Bobrzańskim|Nowogród Bobrzański|ul.Słowackiego 11 |66-010 ;2277;961;961;26;935;42.20;2.71
89517;080905;Miejsko Gminny Ośrodek Kultury Sportu i Rekreacji w Nowogrodzie Bobrzańskim|Nowogród Bobrzański|ul.Pocztowa 7 |66-010 ;1865;826;826;24;802;44.29;2.91
89518;080905;Szkoła Podstawowa w Nowogrodzie Bobrzańskim|Nowogród Bobrzański|ul. Marcinkowskiego 2 |66-010 ;682;288;288;11;277;42.23;3.82
89519;080905;Szkoła Podstawowa w Bogaczowie|Bogaczów|ul.Szkolna 4 |66-010 Nowogród Bobrzański;596;238;238;13;225;39.93;5.46
89520;080905;Szkoła Podstawowa w Drągowinie|Drągowina|ul. Lipowa 24 |66-010 Nowogród Bobrzański;711;221;221;13;208;31.08;5.88
89521;080905;Szkoła Podstawowa w Niwiskach|Niwiska|ul. Akacjowa 1 |66-010 Nowogród Bobrzański;1303;373;373;22;351;28.63;5.90
89522;080905;Zakład Karny w Krzywańcu|Krzywaniec| |66-010 Nowogród Bobrzański;693;289;289;45;244;41.70;15.57
89523;080906;Zespół Szkół Ponadgimnazjalnych|Sulechów|ul. Piaskowa 53 |66-100 Sulechów;2053;1047;1047;31;1016;51.00;2.96
89524;080906;Ośrodek Pomocy Społecznej Centrum Usług Socjalnych|Kruszyna| 53a |66-100 Sulechów;1810;848;848;19;829;46.85;2.24
89525;080906;Gimnazjum nr 2 im. Jana Pawła II|Sulechów|ul. 1-go Maja 7 |66-100 Sulechów;1843;907;907;37;870;49.21;4.08
89526;080906;Przedszkole nr 6|Sulechów|ul. Kościuszki 16 |66-100 Sulechów;1750;892;892;17;875;50.97;1.91
89527;080906;Biblioteka Publiczna Gminy Sulechów|Sulechów|ul. Jana Pawła II 52 |66-100 Sulechów;954;422;422;12;410;44.23;2.84
89528;080906;Przedszkole nr 7|Sulechów|Osiedle Zacisze 3 |66-100 Sulechów;1308;686;686;14;672;52.45;2.04
89529;080906;Szkoła Podstawowa nr 1 im. gen. Józefa Bema|Sulechów|ul. 31-go Stycznia 23 |66-100 Sulechów;1714;858;858;38;820;50.06;4.43
89530;080906;Zespół Szkół|Sulechów|ul. Piaskowa 52 |66-100 Sulechów;2046;968;968;21;947;47.31;2.17
89531;080906;Sala Wiejska|Klępsk| 33 |66-111 Babimost;608;222;222;11;211;36.51;4.95
89532;080906;Szkoła Podstawowa im. Leona Kruczkowskiego|Cigacice|Plac Szkolny 10 |66-131 Sulechów;1171;500;500;27;473;42.70;5.40
89533;080906;Szkoła Podstawowa|Buków| 53 |66-100 Sulechów;691;248;248;28;220;35.89;11.29
89534;080906;Szkoła Podstawowa|Kije| 141A |66-100 Sulechów;1070;382;382;14;368;35.70;3.66
89535;080906;Urząd Miejski Sulechów|Sulechów|Plac Ratuszowy 6 |66-100 Sulechów;1186;640;640;18;622;53.96;2.81
89536;080906;Szkoła Podstawowa|Kalsk| 65 |66-100 Sulechów;1353;643;643;26;617;47.52;4.04
89537;080906;Gimnazjum w Pomorsku|Pomorsko|ul. Bolesława Chrobrego 51 |66-105 Sulechów;1082;336;336;12;324;31.05;3.57
89538;080906;Samodzielny Publiczny Zakład Opieki Zdrowotnej w Sulechowie|Sulechów|Zwycięstwa 1 |66-100 Sulechów;94;57;57;1;56;60.64;1.75
89539;080907;Gminny Ośrodek Kultury|Świdnica|ul. Ogrodowa 37 |66-008 Świdnica;1667;850;850;25;825;50.99;2.94
89540;080907;Sala Wiejska Słone|Słone|ul. Słoneczna 42 |66-008 Świdnica;1202;643;643;17;626;53.49;2.64
89541;080907;Sala Wiejska Letnica|Letnica| 10 |66-008 Świdnica;1277;528;528;25;503;41.35;4.73
89542;080907;Sala Wiejska Wilkanowo|Wilkanowo|Szkolna 3 |66-008 Świdnica;955;564;564;8;556;59.06;1.42
89543;080908;Sala gimnastyczna w Trzebiechowie|Trzebiechów|ul. Parkowa 3 |66-132 Trzebiechów;1177;438;438;32;406;37.21;7.31
89544;080908;Dom Pomocy Społecznej w Trzebiechowie|Trzebiechów|ul.Sulechowska 1 |66-132 Trzebiechów;35;16;16;1;15;45.71;6.25
89545;080908;Świetlica wiejska w Głuchowie|Głuchów| |66-132 Trzebiechów;480;145;145;16;129;30.21;11.03
89546;080908;Świetlica wiejska w Podlegórzu|Podlegórz| |66-132 Trzebiechów;451;168;168;10;158;37.25;5.95
89547;080908;Świetlica wiejska w Swarzynicach|Swarzynice| |66-132 Trzebiechów;469;142;142;6;136;30.28;4.23
89548;080909;Urząd Gminy Zabór|Zabór|ul. Lipowa 15 |66-003 Zabór;1750;692;692;42;650;39.54;6.07
89549;080909;Świetlica wiejska|Przytok|Kisielińska 12 |66-003 Zabór;594;305;305;12;293;51.35;3.93
89550;080909;Budynek Centrum Kultury Wiejskiej|Droszków|ul. Dębowa 6 |66-003 Zabór;822;459;459;14;445;55.84;3.05
89551;081001;Gimnazjum Publiczne|Gozdnica|ul. Wojska Polskiego 5 |68-130 Gozdnica;906;260;260;16;244;28.70;6.15
89552;081001;Urząd Miejski|Gozdnica|ul. Świerczewskiego 2 |68-130 Gozdnica;899;276;276;10;266;30.70;3.62
89553;081001;Dom Kultury|Gozdnica|ul. Świerczewskiego 25 |68-130 Gozdnica;852;252;252;12;240;29.58;4.76
89554;081002;Ośrodek Pomocy Społecznej|Żagań|Pstrowskiego 3 |68-100 Żagań;2296;970;970;43;927;42.25;4.43
89555;081002;Zespół Szkół Nr 1 - sala lekcyjna nr 01|Żagań|Żarska 1 |68-100 Żagań;1205;587;587;16;571;48.71;2.73
89556;081002;Zespół Szkół Nr 1 - stołówka|Żagań|Żarska 1 |68-100 Żagań;1995;852;852;16;836;42.71;1.88
89557;081002;Zespół Szkół Nr 1 - sala nr 27|Żagań|Żarska 1 |68-100 Żagań;1736;858;858;16;842;49.42;1.86
89558;081002;Liceum Ogólnokształcące|Żagań|Pl. Orląt Lwowskich 4 |68-100 Żagań;1651;719;719;19;700;43.55;2.64
89559;081002;Publiczna Szkoła Podstawowa nr 4|Żagań|Wesoła 38 |68-100 Żagań;709;292;292;9;283;41.18;3.08
89560;081002;Zakład Gospodarki Mieszkaniowej -świetlica|Żagań|Miodowa 23 |68-100 Żagań;2122;1023;1023;18;1005;48.21;1.76
89561;081002;Centrum Kultury|Żagań|Jana Pawła II 7 |68-100 Żagań;1284;572;572;8;564;44.55;1.40
89562;081002;Miejskie Przedszkole Nr 3|Żagań|X lecia PL 24 |68-100 Żagań;838;367;367;14;353;43.79;3.81
89563;081002;Zespół Szkół Nr 2 - sala nr 112|Żagań|Nocznickiego 18 |68-100 Żagań;2228;1134;1134;23;1111;50.90;2.03
89564;081002;Miejska Biblioteka Publiczna - sala nr 176 (Oddział dla Dzieci i Młodzieży)|Żagań|Szprotawska 4 |68-100 Żagań;1765;731;731;23;708;41.42;3.15
89565;081002;Pałac Książęcy - sala nr 171|Żagań|Szprotawska 4 |68-100 Żagań;1600;746;746;15;731;46.62;2.01
89566;081002;Publiczna Szkoła Podstawowa Nr 3|Żagań|Szkolna 42 |68-100 Żagań;1210;526;526;12;514;43.47;2.28
89567;081002;105 Kresowy Szpital Wojskowy SP ZOZ|Żagań|Żelazna 1A |68-100 Żagań;75;37;37;0;37;49.33;0.00
89568;081003;Zespół Szkół|Brzeźnica|ul.Zielonogórska 26 |68-113 Brzeźnica;1061;453;453;36;417;42.70;7.95
89569;081003;Szkoła Podstawowa|Chotków|ul.Kożuchowska 68 |68-113 Brzeźnica;855;289;289;10;279;33.80;3.46
89570;081003;Szkoła Podstawowa|Wichów| 24 |68-113 Brzeźnica;578;223;223;7;216;38.58;3.14
89571;081003;Świetlica Wiejska|Jabłonów|ul.Żagańska 19 |68-113 Brzeźnica;498;192;192;10;182;38.55;5.21
89572;081004;Hala Sportowa|Iłowa|ul.Piaskowa 2b |68-120 Iłowa;1057;441;441;10;431;41.72;2.27
89573;081004;Gminne Centrum Kultury i Sportu|Iłowa|ul. Żagańska 15 |68-120 Iłowa;1079;424;424;20;404;39.30;4.72
89574;081004;Zespół Szkół Ponadgimnazjalnych|Iłowa|ul.Pałacowa 1 |68-120 Iłowa;1097;448;448;14;434;40.84;3.12
89575;081004;Szkoła Podstawowa im. Lotników Alianckich|Iłowa|ul. Kolejowa 11 |68-120 Iłowa;1198;323;323;21;302;26.96;6.50
89576;081004;Świetlica wiejska|Konin Żagański| 29a |68-120 Iłowa;553;193;193;19;174;34.90;9.84
89577;081004;Szkoła Podstawowa|Szczepanów| 39a |68-120 Iłowa;685;205;205;15;190;29.93;7.32
89578;081005;Małomicki Ośrodek Kultury|Małomice|Szkolna 1 |67-320 Małomice;1909;620;620;42;578;32.48;6.77
89579;081005;Publiczna Szkoła Podstawowa w Małomicach|Małomice|Plac Tysiąclecia 3 |67-320 Małomice;1501;583;583;29;554;38.84;4.97
89580;081005;Publiczna Szkoła Podstawowa w Chichach|Chichy| 52 |67-320 Małomice;944;415;415;24;391;43.96;5.78
89581;081006;Sala w Urzędzie Gminy|Niegosławice| 55 |67-312 Niegosławice;1209;473;473;28;445;39.12;5.92
89582;081006;Szkoła Podstawowa|Gościeszowice| 82 |67-312 Niegosławice;982;310;310;14;296;31.57;4.52
89583;081006;Gimnazjum|Przecław| 83 |67-312 Niegosławice;1417;532;532;43;489;37.54;8.08
89584;081007;Zespół Szkół w Szprotawie|Szprotawa|ul. Sobieskiego 58 |67-300 Szprotawa;1982;765;765;28;737;38.60;3.66
89585;081007;Spółdzielnia Mieszkaniowa w Szprotawie|Szprotawa|Osiedle Słoneczne 16 |67-300 Szprotawa;1582;733;733;19;714;46.33;2.59
89586;081007;Szprotawski Dom Kultury|Szprotawa|Mickiewicza 1 |67-300 Szprotawa;1611;633;633;19;614;39.29;3.00
89587;081007;Przedszkole Komunalne nr 2 w Szprotawie|Szprotawa|ul. Parkowa 4a |67-300 Szprotawa;1988;878;878;22;856;44.16;2.51
89588;081007;Przedszkole Komunalne Nr 3 w Szprotawie|Szprotawa|ul. Waszyngtona 5 |67-300 Szprotawa;1634;643;643;43;600;39.35;6.69
89589;081007;Szprotawskie Wodociągi i Kanalizacja w Szprotawie|Szprotawa|ul. Chrobrego 1 |67-300 Szprotawa;1477;616;616;30;586;41.71;4.87
89590;081007;Zespół Szkół w Wiechlicach Filia w Siecieborzycach|Siecieborzyce| |67-320 Małomice;729;245;245;13;232;33.61;5.31
89591;081007;Zespół Szkół w Wiechlicach Filia w Długiem|Długie| |67-312 Niegosławice;724;239;239;9;230;33.01;3.77
89592;081007;Sala wiejska w Witkowie|Witków| |67-320 Małomice;630;219;219;9;210;34.76;4.11
89593;081007;Zespół Szkół nr 1 w Szprotawie|Szprotawa|ul. Kopernika 22 |67-300 Szprotawa;1155;364;364;7;357;31.52;1.92
89594;081007;Zespół Szkół w Wiechlicach|Wiechlice|ul. Brzozowa 17 |67-300 Szprotawa;1759;627;627;30;597;35.65;4.78
89595;081007;Zespół Szkół w Wiechlicach Filia w Lesznie Górnym|Leszno Górne|Szkolna 2a |67-321 Leszno Górne;1594;577;577;24;553;36.20;4.16
89596;081007;Nowy Szpital w Szprotawie Sp. z o.o.|Szprotawa|ul. Henrykowska 1 |67-300 Szprotawa;38;5;5;1;4;13.16;20.00
89597;081008;Gminny Ośrodek Kultury i Biblioteki|Wymiarki|Księcia Witolda 7 |68-131 Wymiarki;1185;402;402;21;381;33.92;5.22
89598;081008;Świetlica wiejska|Witoszyn|II Armii WP 8 |68-131 Witoszyn;708;224;224;9;215;31.64;4.02
89599;081009;Szkoła Podstawowa|Bożnów| 69 |68-100 Żagań;746;304;304;8;296;40.75;2.63
89600;081009;Szkoła Podstawowa|Bukowina Bobrzańska| 45 |68-100 Żagań;576;208;208;8;200;36.11;3.85
89601;081009;Szkoła Podstawowa|Dzietrzychowice| 75 |68-111 Miodnica;1063;377;377;10;367;35.47;2.65
89602;081009;Szkoła Podstawowa|Jelenin| 69a |68-114 Tomaszowo;544;172;172;12;160;31.62;6.98
89603;081009;Szkoła Podstawowa|Miodnica| 54 |68-111 Miodnica;697;240;240;12;228;34.43;5.00
89604;081009;Szkoła Podstawowa|Trzebów| 28 |67-320 Małomice;787;246;246;5;241;31.26;2.03
89605;081009;Szkoła Podstawowa|Tomaszowo|ul. Leśna 1 |68-114 Tomaszowo;1240;499;499;22;477;40.24;4.41
89606;081101;Gimnazjum|Łęknica|ul. Wojska Polskiego 19 |68-208 Łęknica;1047;394;394;10;384;37.63;2.54
89607;081101;Urząd Miejski|Łęknica|ul.Żurawska 1 |68-208 Łęknica;920;325;325;11;314;35.33;3.38
89608;081102;Gimnazjum nr 1|Żary|ul. Staszica 16 |68-200 Żary;1799;927;927;26;901;51.53;2.80
89609;081102;Środowiskowy Dom Samopomocy|Żary|ul. Bohaterów Getta 19 |68-200 Żary;1681;725;725;17;708;43.13;2.34
89610;081102;Miejskie Przedszkole nr 7|Żary|ul. Szymanowskiego 2 |68-200 Żary;1397;670;670;9;661;47.96;1.34
89611;081102;Szkoła Podstawowa nr 1 wejście od ul. Chopina|Żary|ul. Karola Szymanowskiego 8 |68-200 Żary;1248;554;554;18;536;44.39;3.25
89612;081102;Świetlica Spółdzielni Mieszkaniowej|Żary|ul. Henryka Wieniawskiego 1 |68-200 Żary;1851;955;955;26;929;51.59;2.72
89613;081102;Szkoła Podstawowa nr 1 wejście od ul. Szymanowskiego|Żary|ul. Karola Szymanowskiego 8 |68-200 Żary;1844;751;751;15;736;40.73;2.00
89614;081102;Gimnazjum nr 2|Żary|ul.Broni Pancernej 8 |68-200 Żary;1576;623;623;23;600;39.53;3.69
89615;081102;Liceum Ogólnokształcące|Żary|ul.Podwale 16 |68-200 Żary;1401;622;622;14;608;44.40;2.25
89616;081102;Miejskie Przedszkole nr 3|Żary|ul.11 Listopada 22 |68-200 Żary;1181;576;576;10;566;48.77;1.74
89617;081102;Szkoła Podstawowa nr 8|Żary|ul.Partyzantów 9 |68-200 Żary;1318;667;667;7;660;50.61;1.05
89618;081102;Lokal gastronomiczny|Żary|ul. Zawiszy Czarnego 19 |68-200 Żary;1168;679;679;25;654;58.13;3.68
89619;081102;Miejskie Przedszkole nr 8|Żary|ul.Górnośląska 28 |68-200 Żary;1032;423;423;14;409;40.99;3.31
89620;081102;Szkoła Podstawowa nr 5 budynek A|Żary|ul. Częstochowska 3 |68-200 Żary;1424;719;719;15;704;50.49;2.09
89621;081102;Zespół Szkół Budowlanych|Żary|ul.Górnośląska 2 |68-200 Żary;1463;600;600;19;581;41.01;3.17
89622;081102;Szkoła Podstawowa nr 5 budynek B|Żary|ul. Częstochowska 3 |68-200 Żary;1493;720;720;21;699;48.23;2.92
89623;081102;Gimnazjum nr 3|Żary|ul. Okrzei 19 |68-200 Żary;1598;609;609;17;592;38.11;2.79
89624;081102;Szkoła Podstawowa nr 2|Żary|ul.Witosa 25 |68-200 Żary;1513;614;614;16;598;40.58;2.61
89625;081102;Świetlica POD "Związkowiec"|Żary|ul. Tatrzańska 11A |68-200 Żary;1185;621;621;11;610;52.41;1.77
89626;081102;Szkoła Podstawowa nr 8|Żary|ul. Partyzantów 9 |68-200 Żary;1473;803;803;13;790;54.51;1.62
89627;081102;Zespół Szkół|Żary|ul.Gen. Pułaskiego 4 |68-200 Żary;1223;564;564;11;553;46.12;1.95
89628;081102;Filia Żarskiego Domu Kultury|Żary|ul. Grunwaldzka 3 |68-200 Żary;1278;493;493;18;475;38.58;3.65
89629;081102;105 Szpital Wojskowy- Samodzileny Publiczny Zakład Opieki Zdrowotnej z Przychodnią|Żary|Domańskiego 2 |68-200 Żary;35;35;35;2;33;100.00;5.71
89630;081102;Niepubliczny Zakład Opieki Zdrowotnej " Szpital na Wyspie"|Żary|Pszenna 2 |68-200 Żary;27;27;27;1;26;100.00;3.70
89631;081103;Urząd Gminy Brody|Brody|Rynek 2 |68-343 Brody;1040;336;336;22;314;32.31;6.55
89632;081103;Gminna Biblioteka Publiczna w Brodach|Brody|Kilińskiego 9 |68-343 Brody;1018;276;276;24;252;27.11;8.70
89633;081103;Filia Gminnej Biblioteki Publicznej w Bieczu|Biecz| 82 |68-343 Brody;658;171;171;10;161;25.99;5.85
89634;081104;Miejsko Gminny Ośrodek Kultury|Jasień|Plac Armii Krajowej 1 |68-320 Jasień;2124;859;859;41;818;40.44;4.77
89635;081104;Dzienny Dom Pobytu Seniora,|Jasień|ul. Okrzei 9 |68-320 Jasień;1857;637;637;19;618;34.30;2.98
89636;081104;Szkoła Podstawowa Wicina|Wicina| 15 |68-320 Jasień;761;230;230;13;217;30.22;5.65
89637;081104;Szkoła Podstawowa Golin|Golin| 1 |68-320 Jasień;951;283;283;18;265;29.76;6.36
89638;081105;Zespół Szkolno-Przedszkolny|Lipinki Łużyckie|ul. Szkolna 7 |68-213 Lipinki Łużyckie;1146;449;449;12;437;39.18;2.67
89639;081105;lokal świetlicy wiejskiej|Lipinki Łużyckie| |68-213 Lipinki Łużyckie;721;283;283;8;275;39.25;2.83
89640;081105;Świetlica Wiejska|Grotów| |68-213 Lipinki Łużyckie;312;96;96;4;92;30.77;4.17
89641;081105;Świetlica wiejska|Pietrzyków| |68-213 Lipinki Łużyckie;400;110;110;11;99;27.50;10.00
89642;081106;Urząd Miejski w Lubsku (Ratusz)|Lubsko|ul. Plac Wolności 1 |68-300 Lubsko;2042;743;743;32;711;36.39;4.31
89643;081106;Szkoła Podstawowa Nr 2|Lubsko|ul. Aleja Niepodległości 2 |68-300 Lubsko;1159;386;386;13;373;33.30;3.37
89644;081106;Przedszkole Nr 1|Lubsko|ul. Kolejowa 2 |68-300 Lubsko;2076;884;884;29;855;42.58;3.28
89645;081106;Zespół Szkół Technicznych|Lubsko|ul. Powstańców Wielkopolskich 2 |68-300 Lubsko;1153;429;429;19;410;37.21;4.43
89646;081106;Szkoła Podstawowa Nr 1|Lubsko|ul. Strzelecka 1 |68-300 Lubsko;1233;532;532;11;521;43.15;2.07
89647;081106;Gimnazjum Nr 1|Lubsko|ul. Bohaterów 6 |68-300 Lubsko;1781;740;740;23;717;41.55;3.11
89648;081106;Lubski Dom Kultury|Lubsko|ul. Plac Jana Pawła II 1 |68-300 Lubsko;1832;778;778;22;756;42.47;2.83
89649;081106;Świetlica wiejska|Mierków| 49 |68-300 Lubsko;945;328;328;16;312;34.71;4.88
89650;081106;Szkoła Podstawowa|Górzyn| 1 |68-300 Lubsko;1733;496;496;28;468;28.62;5.65
89651;081106;OSP|Stara Woda| 29 |68-300 Lubsko;977;368;368;16;352;37.67;4.35
89652;081106;Dom Pomocy Społecznej|Lubsko|ul. Zamkowa 27 |68-300 Lubsko;122;24;24;5;19;19.67;20.83
89653;081106;Areszt Śledczy w Lubsku|Lubsko|Nowa 2 |68-300 Lubsko;73;58;58;6;52;79.45;10.34
89654;081106;Zakład Pielęgnacyjno-Opiekuńczy|Lubsko|Poznańska 2 |68-300 Lubsko;21;0;0;0;0;0.00;-99
89655;081107;Szkoła Podstawowa|Lipna| 103 |68-132 Przewóz;675;312;312;14;298;46.22;4.49
89656;081107;Sala Sportowa|Przewóz|ul. Świerczewskiego 5 |68-132 Przewóz;1039;387;387;21;366;37.25;5.43
89657;081107;Świetlica Wiejska|Piotrów| 49A |68-132 Przewóz;840;260;260;7;253;30.95;2.69
89658;081108;Zespół Szkół|Trzebiel|ul. Szkolna 5 |68-212 Trzebiel;1708;635;635;21;614;37.18;3.31
89659;081108;Świetlica wiejska|Dębinka| |68-212 Trzebiel;377;117;117;8;109;31.03;6.84
89660;081108;Szkoła Podstawowa|Niwica| 17 |68-210 Nowe Czaple;949;269;269;22;247;28.35;8.18
89661;081108;Szkoła Podstawowa|Nowe Czaple|ul. Kopalniana |68-210 Nowe Czaple;938;328;328;20;308;34.97;6.10
89662;081108;Szkoła Podstawowa|Żarki Wielkie|ul. Kościelna 25 |68-210 Nowe Czaple;617;262;262;12;250;42.46;4.58
89663;081109;Szkoła|Tuplice|Daszyńskiego 1 |68-219 Tuplice;1947;681;681;17;664;34.98;2.50
89664;081109;Budynek po byłej szkole|Drzeniów| 22 |68-300 Lubsko;658;179;179;17;162;27.20;9.50
89665;081110;Remiza Strażacka|Bieniów|Górna 2B |68-200 Żary;1112;393;393;20;373;35.34;5.09
89666;081110;Szkoła Podstawowa|Lubanice| 20 |68-200 Żary;1116;428;428;19;409;38.35;4.44
89667;081110;Świetlica Wiejska|Mirostowice Dolne|Plac Kościelny 19 |68-206 Żary;1485;551;551;17;534;37.10;3.09
89668;081110;Szkoła Podstawowa|Olbrachtów| 40 |68-200 Żary;1846;636;636;15;621;34.45;2.36
89669;081110;Szkoła Podstawowa|Sieniawa Żarska| 40 |68-213 Lipinki Łużyckie;893;340;340;12;328;38.07;3.53
89670;081110;Szkoła Podstawowa|Złotnik| 14 |68-200 Żary;1453;493;493;11;482;33.93;2.23
89671;081110;Świetlica Wiejska|Marszów| 35 |68-200 Żary;898;323;323;11;312;35.97;3.41
89672;081110;Zespół Szkół|Grabik| 102 |68-200 Żary;780;360;360;12;348;46.15;3.33
89673;081201;Gimnazjum im. Ludwika Stępczaka w Sławie|Sława|ul. Odrodzonego Wojska Polskiego 16 |67-410 Sława;2159;1107;1108;31;1076;51.27;2.80
89674;081201;Dom Kultury w Sławie|Sława|ul. Głogowska 5 |67-410 Sława;1267;561;561;21;540;44.28;3.74
89675;081201;Świetlica Wiejska w Lubogoszczy|Lubogoszcz| 6 |67-410 Sława;514;225;225;3;222;43.77;1.33
89676;081201;Sala Wiejska Starym Strączu|Stare Strącze| 191 |67-410 Sława;1185;327;327;30;297;27.59;9.17
89677;081201;Wiejski Dom Kultury w Krzepielowie|Krzepielów| 139 |67-410 Sława;562;209;209;9;200;37.19;4.31
89678;081201;Dom Kultury w Ciosańcu|Ciosaniec| 19 |67-410 Sława;795;304;304;13;291;38.24;4.28
89679;081201;Świetlica Wiejska w Łupicach|Łupice|Szkolna 10 |67-410 Sława;747;221;221;8;213;29.59;3.62
89680;081201;Sala Wiejska w Lipinkach|Lipinki| 53 |67-410 Sława;510;172;172;6;166;33.73;3.49
89681;081201;Wiejski Dom Kultury w Śmieszkowie|Śmieszkowo| 20 |67-410 Sława;695;289;289;16;273;41.58;5.54
89682;081201;Świetlica Wiejska w Krążkowie|Krążkowo| 94 |67-410 Sława;389;123;123;3;120;31.62;2.44
89683;081201;Świetlica Wiejska w Przybyszowie|Przybyszów| 65a |67-410 Sława;337;113;113;9;104;33.53;7.96
89684;081201;Sala Wiejska w Kuźnicy Głogowskiej|Kuźnica Głogowska| 1B |67-410 Sława;709;342;342;11;331;48.24;3.22
89685;081202;Świetlica Miejska|Szlichtyngowa|Głogowska 1 |67-407 Szlichtyngowa;1052;522;522;30;492;49.62;5.75
89686;081202;Szkoła Podstawowa Stare Drzewce|Stare Drzewce| 55 |67-407 Szlichtyngowa;1136;415;415;18;397;36.53;4.34
89687;081202;Szkoła Podstawowa Jędrzychowice|Jędrzychowice| |67-407 Szlichtyngowa;730;233;233;23;210;31.92;9.87
89688;081202;Szkoła Podstawowa im. Jana Pawła II|Szlichtyngowa|Daszyńskiego 16 |67-407 Szlichtyngowa;1067;413;413;24;389;38.71;5.81
89689;081203;Szkoła Podstawowa Nr 1|Wschowa|ul. K. Wielkiego 10 |67-400 Wschowa;1645;687;687;13;674;41.76;1.89
89690;081203;Klub Seniora|Wschowa|ul. Łazienna 6 |67-400 Wschowa;1758;705;705;34;671;40.10;4.82
89691;081203;Budynek po Gimnazjum Nr 1|Wschowa|ul. Kopernika 7 |67-400 Wschowa;1477;616;616;23;593;41.71;3.73
89692;081203;Centrum Kultury i Rekreacji|Wschowa|ul. Niepodległości 1 |67-400 Wschowa;1853;829;829;29;800;44.74;3.50
89693;081203;Szkoła Podstawowa Nr 2|Wschowa|ul. Wolsztyńska 4 |67-400 Wschowa;1742;801;801;19;782;45.98;2.37
89694;081203;Przedszkole Samorządowe Nr 5|Wschowa|ul. Targowa 8 |67-400 Wschowa;951;475;475;12;463;49.95;2.53
89695;081203;Gimnazjum Nr 2|Wschowa|ul. Zacisze Nr 1 |67-400 Wschowa;1619;769;769;24;745;47.50;3.12
89696;081203;Sala Wiejska|Przyczyna Górna| |67-400 Wschowa;633;253;253;8;245;39.97;3.16
89697;081203;Szkoła Podstawowa|Łysiny| 2 |67-400 Wschowa;816;323;323;10;313;39.58;3.10
89698;081203;Sala Wiejska|Hetmanice| |67-400 Wschowa;815;309;309;12;297;37.91;3.88
89699;081203;Szkoła Podstawowa|Osowa Sień| 45 f |67-400 Wschowa;842;298;298;20;278;35.39;6.71
89700;081203;Centrum Animacji Kultury|Dębowa Łęka| 18 |67-400 Wschowa;502;208;208;9;199;41.43;4.33
89701;081203;Sala Wiejska|Olbrachcice| |67-400 Wschowa;739;301;301;8;293;40.73;2.66
89702;081203;Szkoła Podstawowa|Siedlnica| 133 |67-400 Wschowa;662;261;261;8;253;39.43;3.07
89703;081203;Sala Wiejska|Konradowo| |67-400 Wschowa;836;254;254;15;239;30.38;5.91
89704;081203;Szpital Miejski Wschowa|Wschowa|Księdza Kostki 33 |67-400 Wschowa;82;24;24;3;21;29.27;12.50
89705;086101;Dom Strażaka|Gorzów Wielkopolski|ul.Strażacka 36 |66-400 Gorzów Wielkopolski;1232;624;624;14;610;50.65;2.24
89706;086101;Zespół Szkół Ogrodniczych|Gorzów Wielkopolski|ul.Poznańska 23 |66-400 Gorzów Wielkopolski;1437;765;765;26;739;53.24;3.40
89707;086101;Szkoła Podstawowa Nr 4|Gorzów Wielkopolski|ul. Kobylogórska 110 |66-400 Gorzów Wielkopolski;1228;638;638;14;624;51.95;2.19
89708;086101;Przedszkole Miejskie nr 4|Gorzów Wielkopolski|ul. Kobylogórska 107 |66-400 Gorzów Wielkopolski;1371;596;596;16;580;43.47;2.68
89709;086101;Miejskie Centrum Kultury "Zawarcie"|Gorzów Wielkopolski|ul. Wawrzyniaka 66A |66-400 Gorzów Wielkopolski;1328;586;586;9;577;44.13;1.54
89710;086101;Gimnazjum nr 4|Gorzów Wielkopolski|ul. Grobla 68a |66-400 Gorzów Wielkopolski;957;337;337;15;322;35.21;4.45
89711;086101;Zespół Szkół Nr 12|Gorzów Wielkopolski|ul. Śląska 20 |66-400 Gorzów Wielkopolski;2196;950;950;22;928;43.26;2.32
89712;086101;Szkoła Podstawowa nr 10|Gorzów Wielkopolski|ul.Towarowa 21 |66-400 Gorzów Wielkopolski;1938;800;800;41;759;41.28;5.12
89713;086101;Szkoła Podstawowa Nr 12|Gorzów Wielkopolski|ul. Dobra 16 |66-400 Gorzów Wielkopolski;1532;891;891;15;876;58.16;1.68
89714;086101;Stowarzyszenie na Rzecz Osób z Autyzmem|Gorzów Wielkopolski|ul. Małyszyńska 8 |66-400 Gorzów Wielkopolski;898;349;349;10;339;38.86;2.87
89715;086101;Przedszkole Miejskie Nr 12|Gorzów Wielkopolski|ul. Sportowa 2 |66-400 Gorzów Wielkopolski;1088;564;564;19;545;51.84;3.37
89716;086101;Miejskie Centrum Kultury, Klub "Zodiak"|Gorzów Wielkopolski|ul. Słoneczna 63 |66-400 Gorzów Wielkopolski;1535;640;640;14;626;41.69;2.19
89717;086101;Zespół Szkół Nr 6|Gorzów Wielkopolski|ul. Gwiaździsta 14 |66-400 Gorzów Wielkopolski;1910;953;953;21;932;49.90;2.20
89718;086101;Specjalistyczny Ośrodek Diagnozy i Rehabilitacji Echo Sp. z o.o.|Gorzów Wielkopolski|ul. Gwiaździsta 4 |66-400 Gorzów Wielkopolski;1538;768;768;14;754;49.93;1.82
89719;086101;Szkoła Podstawowa Nr 5|Gorzów Wielkopolski|Aleja Konstytucji 3 Maja 44 |66-400 Gorzów Wielkopolski;2178;1031;1031;17;1014;47.34;1.65
89720;086101;Zespół Szkół Ogólnokształcących nr 16|Gorzów Wielkopolski|ul. Dunikowskiego 5 |66-400 Gorzów Wielkopolski;2182;1181;1191;26;1155;54.12;2.20
89721;086101;Zespół Szkół Ogólnokształcących nr 16|Gorzów Wielkopolski|ul. Dunikowskiego 5 |66-400 Gorzów Wielkopolski;1408;713;713;15;698;50.64;2.10
89722;086101;Szkoła Podstawowa Nr 15|Gorzów Wielkopolski|ul. Kotsisa 1 |66-400 Gorzów Wielkopolski;1880;940;940;33;907;50.00;3.51
89723;086101;Przedszkole Miejskie Nr 10|Gorzów Wielkopolski|ul. Lelewela 1 |66-400 Gorzów Wielkopolski;1630;918;918;23;895;56.32;2.51
89724;086101;Uniwersytet Szczeciński Zamiejscowy Wydział Społeczno-Ekonomiczny w Gorzowie Wlkp.|Gorzów Wielkopolski|ul. Myśliborska 30 |66-400 Gorzów Wielkopolski;1347;733;733;8;725;54.42;1.09
89725;086101;Zespół Szkół Mistrzostwa Sportowego|Gorzów Wielkopolski|ul. Stanisławskiego 2 |66-400 Gorzów Wielkopolski;1954;1052;1052;18;1034;53.84;1.71
89726;086101;Zespół Szkół Nr 14|Gorzów Wielkopolski|ul. Mościckiego 3 |66-400 Gorzów Wielkopolski;1375;688;688;13;675;50.04;1.89
89727;086101;Zespół Szkół Nr 14|Gorzów Wielkopolski|ul. Mościckiego 5 |66-400 Gorzów Wielkopolski;1672;881;881;9;872;52.69;1.02
89728;086101;Miejskie Przedszkole Integracyjne Nr 14|Gorzów Wielkopolski|ul. Kasprowicza 10 |66-400 Gorzów Wielkopolski;980;535;535;11;524;54.59;2.06
89729;086101;Zamiejscowy Wydział Kultury Fizycznej AWF w Poznaniu z siedzibą w Gorzowie Wlkp.|Gorzów Wielkopolski|ul. Estkowskiego 13 |66-400 Gorzów Wielkopolski;701;383;383;10;373;54.64;2.61
89730;086101;Gimnazjum Nr 7|Gorzów Wielkopolski|ul. Estkowskiego 3 |66-400 Gorzów Wielkopolski;925;419;419;4;415;45.30;0.95
89731;086101;Świetlica - ENEA S.A. Oddział Gorzów Wlkp.|Gorzów Wielkopolski|ul. Sikorskiego 37 |66-400 Gorzów Wielkopolski;907;344;344;9;335;37.93;2.62
89732;086101;Zespół Szkół Elektrycznych|Gorzów Wielkopolski|ul. Dąbrowskiego 33 |66-400 Gorzów Wielkopolski;1355;661;661;16;645;48.78;2.42
89733;086101;Żłobek Miejski Nr 2|Gorzów Wielkopolski|ul. Obotrycka 1/1 |66-400 Gorzów Wielkopolski;833;409;409;23;386;49.10;5.62
89734;086101;Zespół Szkół Ekonomicznych|Gorzów Wielkopolski|ul. 30 Stycznia 29 |66-400 Gorzów Wielkopolski;860;360;360;11;349;41.86;3.06
89735;086101;Szkoła Muzyczna I i II stopnia|Gorzów Wielkopolski|ul. Chrobrego 3 |66-400 Gorzów Wielkopolski;1514;673;673;11;662;44.45;1.63
89736;086101;IV Liceum Ogólnokształcące|Gorzów Wielkopolski|ul. Kosynierów Gdyńskich 8 |66-400 Gorzów Wielkopolski;1147;439;439;14;425;38.27;3.19
89737;086101;Przedszkole Miejskie nr 1|Gorzów Wielkopolski|ul. Kosynierów Gdyńskich 29 |66-400 Gorzów Wielkopolski;1482;538;538;7;531;36.30;1.30
89738;086101;Miejskie Centrum Kultury, Klub "Jedynka"|Gorzów Wielkopolski|ul. Mieszka I 50 |66-400 Gorzów Wielkopolski;1803;825;825;17;808;45.76;2.06
89739;086101;Zespół Szkół Budowlanych|Gorzów Wielkopolski|ul. Okrzei 42 |66-400 Gorzów Wielkopolski;1679;930;930;13;917;55.39;1.40
89740;086101;Zespół Szkół Ogólnokształcących Nr 1|Gorzów Wielkopolski|ul. Puszkina 31 |66-400 Gorzów Wielkopolski;2271;1222;1222;21;1201;53.81;1.72
89741;086101;Zespół Szkół nr 21|Gorzów Wielkopolski|ul. Taczaka 1 |66-400 Gorzów Wielkopolski;1671;965;965;8;957;57.75;0.83
89742;086101;Prywatna Szkoła Podstawowa i Gimnazjum o Profilu Artystycznym|Gorzów Wielkopolski|ul. Cegielskiego 1 |66-400 Gorzów Wielkopolski;1721;997;997;8;989;57.93;0.80
89743;086101;Miejskie Centrum Kultury|Gorzów Wielkopolski|ul. Drzymały 26 |66-400 Gorzów Wielkopolski;669;328;329;5;323;49.03;1.52
89744;086101;Zespół Szkół Technicznych i Ogólnokształcących|Gorzów Wielkopolski|ul. Czereśniowa 4e |66-400 Gorzów Wielkopolski;1982;1105;1105;14;1091;55.75;1.27
89745;086101;Przedszkole Miejskie Nr 29|Gorzów Wielkopolski|ul. Wróblewskiego 48 |66-400 Gorzów Wielkopolski;1794;927;927;23;904;51.67;2.48
89746;086101;Zespół Szkół Nr 13|Gorzów Wielkopolski|ul. Szwoleżerów 2 |66-400 Gorzów Wielkopolski;1713;955;955;8;947;55.75;0.84
89747;086101;Parterowy budynek naprzeciw głównego wejścia do Szpitala|Gorzów Wielkopolski|ul. Dekerta 1 |66-400 Gorzów Wielkopolski;1510;842;842;9;833;55.76;1.07
89748;086101;Zespół Szkół Nr 13|Gorzów Wielkopolski|ul. Paderewskiego 5 |66-400 Gorzów Wielkopolski;1329;746;746;17;729;56.13;2.28
89749;086101;Zespół Szkół Nr 13|Gorzów Wielkopolski|ul. Paderewskiego 5 |66-400 Gorzów Wielkopolski;1758;1059;1059;17;1042;60.24;1.61
89750;086101;Żłobek Miejski Nr 1|Gorzów Wielkopolski|ul. Wróblewskiego 50 |66-400 Gorzów Wielkopolski;1056;523;523;9;514;49.53;1.72
89751;086101;Zespół Szkół Nr 13|Gorzów Wielkopolski|ul. Szwoleżerów 2 |66-400 Gorzów Wielkopolski;1481;831;831;21;810;56.11;2.53
89752;086101;Zespół Szkół Technicznych i Ogółnokształcących - Internat|Gorzów Wielkopolski|ul. Czereśniowa 4i |66-400 Gorzów Wielkopolski;1979;1091;1091;24;1067;55.13;2.20
89753;086101;Katolicka Szkoła Podstawowa Świętego Piusa X|Gorzów Wielkopolski|ul. Kućki 1 |66-400 Gorzów Wielkopolski;1829;991;991;25;966;54.18;2.52
89754;086101;Zespół Szkół Nr 20|Gorzów Wielkopolski|ul. Szarych Szeregów 7 |66-400 Gorzów Wielkopolski;2068;1174;1174;24;1150;56.77;2.04
89755;086101;Zespół Szkół Nr 20|Gorzów Wielkopolski|ul.Szarych Szeregów 7 |66-400 Gorzów Wielkopolski;2044;1122;1123;16;1106;54.89;1.43
89756;086101;Przedszkole Miejskie Nr 22|Gorzów Wielkopolski|ul. Szarych Szeregów 2 |66-400 Gorzów Wielkopolski;1336;796;796;6;790;59.58;0.75
89757;086101;Przedszkole Miejskie nr 20|Gorzów Wielkopolski|ul. Walczaka 47 |66-400 Gorzów Wielkopolski;1235;579;579;6;573;46.88;1.04
89758;086101;Zespół Szkół nr 20|Gorzów Wielkopolski|ul. Szarych Szeregów 7 |66-400 Gorzów Wielkopolski;2131;1161;1161;20;1141;54.48;1.72
89759;086101;Centrum Handlowe "Watral"|Gorzów Wielkopolski|ul.Kombatantów 34 |66-400 Gorzów Wielkopolski;1834;1059;1059;22;1037;57.74;2.08
89760;086101;Dom Studenta PWSZ Nr 1|Gorzów Wielkopolski|ul. Piłsudskiego 9 |66-400 Gorzów Wielkopolski;1379;672;672;11;661;48.73;1.64
89761;086101;Spóldzielnia Mieszkaniowa "Dolinki"|Gorzów Wielkopolski|ul. Okólna 25 |66-400 Gorzów Wielkopolski;1849;1033;1033;17;1016;55.87;1.65
89762;086101;Gimnazjum nr 9|Gorzów Wielkopolski|ul. Zamenhofa 2a |66-400 Gorzów Wielkopolski;1157;558;558;12;546;48.23;2.15
89763;086101;Zespół Szkół Gastronomicznych|Gorzów Wielkopolski|ul. Okólna 35 |66-400 Gorzów Wielkopolski;1486;856;856;15;841;57.60;1.75
89764;086101;Szkoła Podstawowa Nr 9|Gorzów Wielkopolski|ul. Nowa 7 |66-400 Gorzów Wielkopolski;774;405;405;8;397;52.33;1.98
89765;086101;Miejskie Przedszkole Integracyjne Nr 9|Gorzów Wielkopolski|ul. Widok 25 |66-400 Gorzów Wielkopolski;1736;806;806;11;795;46.43;1.36
89766;086101;Zespół Szkół Ogólnokształcących Nr 3|Gorzów Wielkopolski|ul. Warszawska 19 |66-400 Gorzów Wielkopolski;1904;1056;1056;11;1045;55.46;1.04
89767;086101;Zespół Szkół Ogólnokształcących Nr 3|Gorzów Wielkopolski|ul. Warszawska 19 |66-400 Gorzów Wielkopolski;1736;752;752;23;729;43.32;3.06
89768;086101;Wielospecjalistyczny Szpital Wojewódzki w Gorzowie Wlkp. Sp. z o.o. Zespół Szpitalny przy ulicy Walczaka|Gorzów Wielkopolski|Walczaka 42 |66-400 Gorzów Wlkp.;333;91;91;13;78;27.33;14.29
89769;086101;Wielospecjalistyczny Szpital Wojewódzki w Gorzowie Wlkp. Sp. z o.o. Zespół Szpitalny przy ulicy Dekerta|Gorzów Wielkopolski|Dekerta 1 |66-400 Gorzów Wlkp.;273;104;104;7;97;38.10;6.73
89770;086101;Zakład Karny|Gorzów Wielkopolski|Podmiejska 17 |66-400 Gorzów Wielkopolski;439;193;193;30;163;43.96;15.54
89771;086101;Dom Pomocy Społecznej nr 1|Gorzów Wielkopolski|Podmiejska Boczna 10 |66-400 Gorzów Wielkopolski;198;60;60;7;53;30.30;11.67
89772;086101;Dom Pomocy Społecznej nr 2|Gorzów Wielkopolski|Walczaka 42 |66-400 Gorzów Wielkopolski;64;10;10;1;9;15.62;10.00
89773;086201;Szkoła Podstawowa nr 11|Zielona Góra|ul. Spawaczy 3d |65-119 Zielona Góra;1740;852;852;13;839;48.97;1.53
89774;086201;Uniwersytet Zielonogórski Budynek dydaktyczny A-22|Zielona Góra|ul. Energetyków 2 |65-729 Zielona Góra;1313;713;713;7;706;54.30;0.98
89775;086201;Uniwersytet Zielonogórski Budynek dydaktyczny A-22|Zielona Góra|ul. Energetyków 2 |65-729 Zielona Góra;1149;586;586;6;580;51.00;1.02
89776;086201;Miejskie Przedszkole nr 22|Zielona Góra|ul. Porzeczkowa 34 |65-790 Zielona Góra;1132;686;686;15;671;60.60;2.19
89777;086201;Uniwersytet Zielonogórski Hala Sportowa|Zielona Góra|ul. Prosta 39 |65-783 Zielona Góra;1590;993;993;13;980;62.45;1.31
89778;086201;Uniwersytet Zielonogórski Hala Sportowa|Zielona Góra|ul. Prosta 39 |65-783 Zielona Góra;1516;1062;1062;6;1056;70.05;0.56
89779;086201;Zespół Szkół Ekologicznych|Zielona Góra|ul. Francuska 25a |65-943 Zielona Góra;1365;909;909;11;898;66.59;1.21
89780;086201;Zespół Szkół Ekologicznych|Zielona Góra|ul. Francuska 25a |65-943 Zielona Góra;1194;759;759;8;751;63.57;1.05
89781;086201;Szkoła Podstawowa nr 18|Zielona Góra|ul. Francuska 10 |65-941 Zielona Góra;1705;981;981;14;967;57.54;1.43
89782;086201;Szkoła Podstawowa nr 18|Zielona Góra|ul. Francuska 10 |65-641 Zielona Góra;1512;1045;1045;3;1042;69.11;0.29
89783;086201;Miejskie Przedszkole nr 37|Zielona Góra|ul. Węgierska 9 |65-941 Zielona Góra;1703;998;998;21;977;58.60;2.10
89784;086201;Miejskie Przedszkole nr 21|Zielona Góra|ul. Rydza-Śmigłego 5 |65-510 Zielona Góra;1817;1039;1039;25;1014;57.18;2.41
89785;086201;Gimnazjum nr 1|Zielona Góra|ul. Stefana Wyszyńskiego 101 |65-536 Zielona Góra;1377;775;775;5;770;56.28;0.65
89786;086201;Gimnazjum nr 1|Zielona Góra|ul. Stefana Wyszyńskiego 101 |65-536 Zielona Góra;1383;870;870;9;861;62.91;1.03
89787;086201;Zielonogórska Spółdzielnia Mieszkaniowa Administracja Osiedla Łużyckie|Zielona Góra|ul. Krośnieńska 17c |65-625 Zielona Góra;1368;809;809;15;794;59.14;1.85
89788;086201;Zespół Szkół Ekonomicznych|Zielona Góra|ul. Długa 5 |65-401 Zielona Góra;1690;932;933;19;913;55.15;2.04
89789;086201;Miejskie Przedszkole nr 20|Zielona Góra|ul. Studzianki 8 |65-807 Zielona Góra;1302;804;804;6;798;61.75;0.75
89790;086201;Miejskie Przedszkole nr 10|Zielona Góra|ul. Monte Cassino 21a |65-561 Zielona Góra;1473;857;857;7;850;58.18;0.82
89791;086201;Szkoła Podstawowa nr 1|Zielona Góra|ul. Stefana Wyszyńskiego 17 |65-536 Zielona Góra;1479;755;755;17;738;51.05;2.25
89792;086201;Szkoła Podstawowa nr 1|Zielona Góra|ul. Stefana Wyszyńskiego 17 |65-536 Zielona Góra;1360;798;798;10;788;58.68;1.25
89793;086201;Gimnazjum nr 2|Zielona Góra|ul. Świętych Cyryla i Metodego 9 |65-533 Zielona Góra;1703;939;939;10;929;55.14;1.06
89794;086201;Gimnazjum nr 2|Zielona Góra|ul. Świętych Cyryla i Metodego 9 |65-533 Zielona Góra;1600;854;854;10;844;53.37;1.17
89795;086201;Miejskie Przedszkole nr 8|Zielona Góra|ul. Witebska 1 |65-634 Zielona Góra;1775;1075;1075;17;1058;60.56;1.58
89796;086201;Gimnazjum nr 7|Zielona Góra|ul. Zachodnia 63 |65-552 Zielona Góra;1553;1019;1019;2;1017;65.61;0.20
89797;086201;Zespół Szkół Specjalnych Nr 1|Zielona Góra|ul. Piastowska 9 |65-515 Zielona Góra;1489;795;795;18;777;53.39;2.26
89798;086201;Zespół Szkół Specjalnych Nr 1|Zielona Góra|ul. Piastowska 9 |65-515 Zielona Góra;1336;709;709;9;700;53.07;1.27
89799;086201;I Liceum Ogólnokształcące|Zielona Góra|ul. Jana Kilińskiego 7 |65-508 Zielona Góra;1417;802;802;12;790;56.60;1.50
89800;086201;Zespół Rehabilitacji Dzieci i Młodzieży Niepełnosprawnej "Promyk"|Zielona Góra|ul. Bartosza Głowackiego 8a |65-301 Zielona Góra;1691;986;986;9;977;58.31;0.91
89801;086201;Zespół Szkół Budowlanych|Zielona Góra|ul. Botaniczna 50 |65-392 Zielona Góra;1258;786;786;12;774;62.48;1.53
89802;086201;Szkoła Podstawowa nr 8|Zielona Góra|ul. Kąpielowa 7 |65-383 Zielona Góra;1339;815;815;6;809;60.87;0.74
89803;086201;Szkoła Podstawowa nr 8|Zielona Góra|ul. Kąpielowa 7 |65-383 Zielona Góra;1184;822;822;0;822;69.43;0.00
89804;086201;Szkoła Podstawowa nr 8|Zielona Góra|ul. Kąpielowa 7 |65-383 Zielona Góra;1204;801;801;9;792;66.53;1.12
89805;086201;Publiczna Szkoła Podstawowa w Zawadzie|Zielona Góra|ul. Zawada-Szkolna 24 |66-001 Zielona Góra;2232;1057;1057;19;1038;47.36;1.80
89806;086201;Publiczna Szkoła Podstawowa w Przylepie|Zielona Góra|ul. Przylep-9 Maja 6 |66-015 Zielona Góra;1210;706;706;6;700;58.35;0.85
89807;086201;Publiczne Gimnazjum w Przylepie|Zielona Góra|ul. Przylep-9 Maja 6 |66-015 Zielona Góra;1216;653;653;13;640;53.70;1.99
89808;086201;Świetlica wiejska|Zielona Góra|ul. Nowy Kisielin-Odrzańska 64 |66-002 Zielona Góra;978;532;532;19;513;54.40;3.57
89809;086201;Publiczna Szkoła Podstawowa w Starym Kisielinie|Zielona Góra|ul. Stary Kisielin-Szkolna 14 |66-002 Zielona Góra;1387;782;782;14;768;56.38;1.79
89810;086201;Publiczna Szkoła Podstawowa w Drzonkowie|Zielona Góra|ul. Drzonków-Szkolna 2 |66-004 Zielona Góra;1265;825;825;13;812;65.22;1.58
89811;086201;Gimnazjum Publiczne w Drzonkowie|Zielona Góra|ul. Drzonków-Szkolna 2 |66-004 Zielona Góra;1156;487;487;3;484;42.13;0.62
89812;086201;Publiczna Szkoła Podstawowa w Ochli|Zielona Góra|ul. Ochla-Szkolna 1 |66-006 Zielona Góra;2139;1103;1103;17;1086;51.57;1.54
89813;086201;Świetlica wiejska|Zielona Góra|ul. Racula-Głogowska 64 |66-004 Zielona Góra;1947;1160;1160;27;1133;59.58;2.33
89814;086201;Świetlica wiejska|Zielona Góra|ul. Łężyca-Odrzańska 16 |66-016 Zielona Góra;1644;986;986;15;971;59.98;1.52
89815;086201;Szkoła Podstawowa nr 11|Zielona Góra|ul. Spawaczy 3d |65-119 Zielona Góra;1573;916;916;8;908;58.23;0.87
89816;086201;Szkoła Podstawowa nr 11|Zielona Góra|ul. Spawaczy 3d |65-119 Zielona Góra;1892;1183;1183;25;1158;62.53;2.11
89817;086201;Zespół Szkół Plastycznych|Zielona Góra|ul. Stefana Batorego 70a |65-735 Zielona Góra;1583;898;899;12;886;56.73;1.34
89818;086201;Zespół Edukacyjny Nr 1 Szkoła Podstawowa Nr 5|Zielona Góra|ul. Truskawkowa 12 |65-129 Zielona Góra;1860;1144;1169;19;1125;61.51;1.66
89819;086201;Miejski Ośrodek Sportu i Rekreacji Hala Akrobatyczna|Zielona Góra|ul. Urszuli 22 |65-147 Zielona Góra;1730;988;988;12;976;57.11;1.21
89820;086201;Miejski Ośrodek Sportu i Rekreacji Hala Akrobatyczna|Zielona Góra|ul. Urszuli 22 |65-147 Zielona Góra;1601;1032;1032;14;1018;64.46;1.36
89821;086201;Zespół Szkół Ogólnokształcących i Sportowych Szkoła Podstawowa nr 10|Zielona Góra|ul. Stanisława Wyspiańskiego 23 |65-036 Zielona Góra;1464;766;766;10;756;52.32;1.31
89822;086201;Młodzieżowe Centrum Kultury i Edukacji "Dom Harcerza"|Zielona Góra|ul. Dzika 6 |65-181 Zielona Góra;1528;920;920;6;914;60.21;0.65
89823;086201;Lubuska Wojewódzka Komenda Ochotniczych Hufców Pracy|Zielona Góra|ul. Ludwika Zamenhofa 1 |65-186 Zielona Góra;1507;748;748;11;737;49.64;1.47
89824;086201;Uniwersytet Zielonogórski Budynek Dydaktyczny A-2|Zielona Góra|ul. Profesora Zygmunta Szafrana 2 |65-516 Zielona Góra;1257;780;780;7;773;62.05;0.90
89825;086201;Zespół Edukacyjny Nr 3 Szkoła Podstawowa nr 21|Zielona Góra|ul. Osiedle Pomorskie 13 |65-547 Zielona Góra;1448;810;810;8;802;55.94;0.99
89826;086201;Zespół Edukacyjny Nr 3 Szkoła Podstawowa nr 21|Zielona Góra|ul. Osiedle Pomorskie 13 |65-547 Zielona Góra;1288;720;720;19;701;55.90;2.64
89827;086201;Zespół Edukacyjny Nr 3 Szkoła Podstawowa nr 21|Zielona Góra|ul. Osiedle Pomorskie 13 |65-547 Zielona Góra;1399;854;854;9;845;61.04;1.05
89828;086201;Dom Dziennego Pobytu "Nestoria"|Zielona Góra|ul. Osiedle Pomorskie 28 |65-548 Zielona Góra;1536;989;989;19;970;64.39;1.92
89829;086201;Społeczna Szkoła Podstawowa|Zielona Góra|ul. Władysława IV 1 |65-229 Zielona Góra;1224;687;687;12;675;56.13;1.75
89830;086201;Publiczna Szkoła Podstawowa nr 7|Zielona Góra|ul. Zielonogórska 5 |65-256 Zielona Góra;1596;908;908;13;895;56.89;1.43
89831;086201;Gimnazjum nr 3|Zielona Góra|ul. Św. Kingi 1 |65-215 Zielona Góra;1108;712;712;7;705;64.26;0.98
89832;086201;Gimnazjum nr 3|Zielona Góra|ul. Św. Kingi 1 |65-215 Zielona Góra;1064;592;592;10;582;55.64;1.69
89833;086201;Miejskie Przedszkole nr 6|Zielona Góra|ul. Stanisława Wyspiańskiego 16 |65-036 Zielona Góra;1669;867;867;10;857;51.95;1.15
89834;086201;Miejskie Przedszkole nr 34|Zielona Góra|ul. Bohaterów Westerplatte 11a |65-034 Zielona Góra;1582;862;862;9;853;54.49;1.04
89835;086201;Szkoła Podstawowa nr 15|Zielona Góra|ul. Lisia 37 |65-093 Zielona Góra;1222;682;682;10;672;55.81;1.47
89836;086201;Szkoła Podstawowa nr 15|Zielona Góra|ul. Lisia 37 |65-093 Zielona Góra;1030;430;430;4;426;41.75;0.93
89837;086201;Miejskie Przedszkole nr 17|Zielona Góra|ul. Doktora Pieniężnego 22 |65-054 Zielona Góra;1261;589;589;8;581;46.71;1.36
89838;086201;Uniwersytet Zielonogórski Rektorat|Zielona Góra|ul. Licealna 9 |65-417 Zielona Góra;1215;549;549;10;539;45.19;1.82
89839;086201;Zespół Szkół Ekonomicznych|Zielona Góra|ul. Długa 5 |65-401 Zielona Góra;1080;474;474;11;463;43.89;2.32
89840;086201;"Szkoła Myślenia Twórczego" Społeczne Gimnazjum Liceum Ogólnokształcące|Zielona Góra|ul. Generała Józefa Sowińskiego 27 |65-452 Zielona Góra;1463;565;565;10;555;38.62;1.77
89841;086201;Zespół Edukacyjny Nr 2 Szkoła Podstawowa nr 17|Zielona Góra|ul. Leopolda Staffa 10 |65-436 Zielona Góra;1604;885;885;18;867;55.17;2.03
89842;086201;Zespół Edukacyjny Nr 2 Szkoła Podstawowa nr 17|Zielona Góra|ul. Leopolda Staffa 10 |65-436 Zielona Góra;1593;917;917;13;904;57.56;1.42
89843;086201;III Liceum Ogólnokształcące|Zielona Góra|ul. Strzelecka 9 |65-452 Zielona Góra;1797;1112;1112;12;1100;61.88;1.08
89844;086201;Miejskie Przedszkole nr 13|Zielona Góra|ul. Jęczmienna 1 |65-012 Zielona Góra;1637;995;995;15;980;60.78;1.51
89845;086201;Dom Pomocy Społecznej|Zielona Góra|ul. Aleja Juliusza Słowackiego 29 |65-326 Zielona Góra;65;30;30;1;29;46.15;3.33
89846;086201;Dom Pomocy Społecznej dla Kombatantów im. Jana Lembasa|Zielona Góra|ul. Lubuska 11 |65-265 Zielona Góra;169;64;64;6;58;37.87;9.38
89847;086201;Szpital Wojewódzki SPZOZ im. Karola Marcinkowskiego|Zielona Góra|ul. Zyty 26 |65-046 Zielona Góra;646;175;175;9;166;27.09;5.14
89848;086201;Areszt Śledczy|Zielona Góra|ul. Łużycka 2 |65-601 Zielona Góra;238;98;98;10;88;41.18;10.20
89849;100101;Szkoła Podstawowa Nr 3|Bełchatów|ul. Sienkiewicza 25 |97-400 Bełchatów;2141;1152;1152;28;1124;53.81;2.43
89850;100101;Szkoła Podstawowa Nr 3|Bełchatów|ul. Sienkiewicza 25 |97-400 Bełchatów;2209;1402;1402;26;1376;63.47;1.85
89851;100101;Budynek PGM|Bełchatów|ul. Czyżewskiego 7 |97-400 Bełchatów;2059;1156;1156;17;1139;56.14;1.47
89852;100101;Przedszkole Samorządowe Nr 4|Bełchatów|Osiedle 1 Maja 8 |97-400 Bełchatów;2131;1131;1131;28;1103;53.07;2.48
89853;100101;Szkoła Podstawowa Nr 12|Bełchatów|ul. W. Budryka 7 |97-400 Bełchatów;2324;1448;1448;34;1414;62.31;2.35
89854;100101;Szkoła Podstawowa Nr 12|Bełchatów|ul. W. Budryka 7 |97-400 Bełchatów;2170;1343;1343;16;1327;61.89;1.19
89855;100101;Przedszkole Samorządowe nr 6|Bełchatów|ul. W. Budryka 12 |97-400 Bełchatów;566;299;299;7;292;52.83;2.34
89856;100101;Szkoła Podstawowa Nr 5|Bełchatów|ul. Szkolna 10 |97-400 Bełchatów;1749;1113;1113;19;1094;63.64;1.71
89857;100101;Szkoła Podstawowa Nr 13|Bełchatów|ul. Słowackiego 8 |97-400 Bełchatów;2147;1357;1357;24;1333;63.20;1.77
89858;100101;Przedszkole Samorządowe Nr 2|Bełchatów|ul. Paderewskiego 3 |97-400 Bełchatów;1809;917;917;26;891;50.69;2.84
89859;100101;Szkoła Podstawowa Nr 13|Bełchatów|ul. Słowackiego 8 |97-400 Bełchatów;1135;683;683;8;675;60.18;1.17
89860;100101;Zespół Szkolno-Przedszkolny Nr 9|Bełchatów|Os. Dolnośląskie 204A |97-400 Bełchatów;980;567;567;14;553;57.86;2.47
89861;100101;Publiczne Gimnazjum Nr 3|Bełchatów|ul. Edwardów 5 |97-400 Bełchatów;2126;1219;1219;17;1202;57.34;1.39
89862;100101;Zespół Szkolno-Przedszkolny Nr 9|Bełchatów|Os. Dolnośląskie 204A |97-400 Bełchatów;1936;1026;1026;32;994;53.00;3.12
89863;100101;Szkoła Podstawowa Nr 4|Bełchatów|ul. Lipowa 11 |97-400 Bełchatów;2016;1093;1093;9;1084;54.22;0.82
89864;100101;Szkoła Podstawowa Nr 8|Bełchatów|Os. Dolnośląskie 112A |97-400 Bełchatów;2230;1305;1305;20;1285;58.52;1.53
89865;100101;Przedszkole Samorządowe Nr 5|Bełchatów|Os. Dolnośląskie 222a |97-400 Bełchatów;1818;1010;1010;15;995;55.56;1.49
89866;100101;Zespół Szkolno-Przedszkolny Nr 9|Bełchatów|Os. Dolnośląskie 204A |97-400 Bełchatów;1735;955;955;13;942;55.04;1.36
89867;100101;Publiczne Gimnazjum Nr 3|Bełchatów|ul. Edwardów 5 |97-400 Bełchatów;2041;1173;1173;21;1152;57.47;1.79
89868;100101;II Liceum Ogólnokształcące|Bełchatów|ul. Czapliniecka 72 |97-400 Bełchatów;1962;917;917;31;886;46.74;3.38
89869;100101;II Liceum Ogólnokształcące|Bełchatów|ul. Czapliniecka 72 |97-400 Bełchatów;1259;846;846;9;837;67.20;1.06
89870;100101;Miejska i Powiatowa Biblioteka Publiczna|Bełchatów|ul. Kościuszki 9 |97-400 Bełchatów;732;367;367;8;359;50.14;2.18
89871;100101;Miejskie Centrum Kultury|Bełchatów|Pl. Narutowicza 1a |97-400 Bełchatów;2031;1069;1069;18;1051;52.63;1.68
89872;100101;Szkoła Podstawowa Nr 1|Bełchatów|ul. Dąbrowskiego 11 |97-400 Bełchatów;2257;1267;1267;29;1238;56.14;2.29
89873;100101;Szkoła Podstawowa Nr 1|Bełchatów|ul. Dąbrowskiego 11 |97-400 Bełchatów;2015;1108;1108;28;1080;54.99;2.53
89874;100101;Publiczne Gimnazjum Nr 1|Bełchatów|ul. Dąbrowskiego 11 |97-400 Bełchatów;1714;994;994;18;976;57.99;1.81
89875;100101;Szpital Wojewódzki im. Jana Pawła II|Bełchatów|Czapliniecka 123 |97-400 Bełchatów;423;187;187;17;170;44.21;9.09
89876;100101;Dom Pomocy Społecznej|Bełchatów|Dąbrowskiego 2 |97-400 Bełchatów;74;40;40;10;30;54.05;25.00
89877;100102;Szkoła Podstawowa|Dobrzelów|ul. Górna 7 |97-400 Bełchatów;1095;648;648;15;633;59.18;2.31
89878;100102;Szkoła Podstawowa|Korczew| 37 |97-400 Bełchatów;1030;489;489;22;467;47.48;4.50
89879;100102;Szkoła Podstawowa w Janowie|Janów| 1 |97-400 Bełchatów;1481;860;860;19;841;58.07;2.21
89880;100102;Szkoła Podstawowa|Łękawa| 4 |97-400 Bełchatów;944;513;513;23;490;54.34;4.48
89881;100102;Strażnica OSP|Oleśnik| 59 |97-400 Bełchatów;1179;691;691;14;677;58.61;2.03
89882;100102;Szkoła Podstawowa|Domiechowice|ul. Grabowa 80 |97-400 Bełchatów;1237;654;654;16;638;52.87;2.45
89883;100102;Strażnica OSP|Podwody| 30 |97-400 Bełchatów;385;160;160;5;155;41.56;3.12
89884;100102;Szkoła Podstawowa w Kurnosie Drugim|Kurnos Drugi| 175 |97-400 Bełchatów;631;379;379;5;374;60.06;1.32
89885;100102;Szkoła Podstawowa|Dobrzelów|ul. Górna 7 |97-400 Bełchatów;752;443;443;15;428;58.91;3.39
89886;100103;Szkoła Podstawowa w Wadlewie|Wadlew| 59 |97-403 Drużbice;613;320;320;10;310;52.20;3.12
89887;100103;Szkoła Podstawowa w Wadlewie|Wadlew| 59 |97-403 Drużbice;565;241;241;14;227;42.65;5.81
89888;100103;Zespół Szkolno-Przedszkolny w Drużbicach|Drużbice| 15 |97-403 Drużbice;672;377;377;14;363;56.10;3.71
89889;100103;Zespół Szkolno-Przedszkolny w Drużbicach|Drużbice| 15 |97-403 Drużbice;775;384;384;20;364;49.55;5.21
89890;100103;Budynek byłej Szkoły Podstawowej w Suchcicach|Suchcice| 61 |97-403 Drużbice;759;333;333;13;320;43.87;3.90
89891;100103;Gimnazjum w Rasach|Rasy| 27 |97-403 Drużbice;828;441;441;19;422;53.26;4.31
89892;100104;Dom Kultury w Żłobnicy|Żłobnica| 25 |97-410 Kleszczów;686;315;315;13;302;45.92;4.13
89893;100104;Szkoła Podstawowa w Kleszczowie|Kleszczów|ul. Szkolna 4 |97-410 Kleszczów;1448;821;821;35;786;56.70;4.26
89894;100104;Szkoła Podstawowa w Łękińsku|Łękińsko|ul. Szkolna 20 |97-410 Kleszczów;1186;648;648;31;617;54.64;4.78
89895;100104;Publiczne Przedszkole Samorządowe w Łuszczanowicach|Łuszczanowice| 104B |97-410 Kleszczów;887;506;506;15;491;57.05;2.96
89896;100105;Zespół Szkół|Kluki|ul. Szkolna 4 |97-415 Kluki;1511;738;738;32;706;48.84;4.34
89897;100105;Szkoła Podstawowa|Kaszewice| 48 |97-415 Kluki;1152;549;549;24;525;47.66;4.37
89898;100105;Szkoła Podstawowa|Parzno| 33 |97-415 Kluki;799;399;399;7;392;49.94;1.75
89899;100106;Urząd Gminy w Ruścu|Rusiec|ul. Wieluńska 35 |97-438 Rusiec;987;561;561;46;515;56.84;8.20
89900;100106;Gminny Ośrodek Kultury w Ruścu|Rusiec|ul. Koniecpolskiego 5 |97-438 Rusiec;1076;631;631;21;610;58.64;3.33
89901;100106;Zespół Szkolno-Przedszkolny w Woli Wiązowej|Wola Wiązowa| 42 |97-438 Rusiec;1065;618;618;31;587;58.03;5.02
89902;100106;Dom Dziecka w Dąbrowie Rusieckiej|Dąbrowa Rusiecka| 51 |97-438 Rusiec;489;270;270;19;251;55.21;7.04
89903;100106;Budynek byłej Szkoły Podstawowej w Dąbrówkach Kobylańskich|Dąbrówki Kobylańskie| 28 |97-438 Rusiec;662;359;359;15;344;54.23;4.18
89904;100107;Świetlica Wiejska w Lubcu|Lubiec| 61b |97-420 Szczerców;451;214;214;18;196;47.45;8.41
89905;100107;Zespół Szkół Ponadgimnazjalnych w Szczercowie|Szczerców|ul. J. Piłsudskiego 66 |97-420 Szczerców;905;382;382;13;369;42.21;3.40
89906;100107;Zespół Szkolno-Przedszkolny w Szczercowie|Szczerców|ul. Łaska 8 |97-420 Szczerców;1188;738;738;23;715;62.12;3.12
89907;100107;Urząd Gminy w Szczercowie|Szczerców|ul. Pułaskiego 8 |97-420 Szczerców;1236;737;737;26;711;59.63;3.53
89908;100107;Publiczne Gimnazjum im. Jana Pawła II w Szczercowie|Szczerców|ul. Rzeczna 7 |97-420 Szczerców;1322;680;680;35;645;51.44;5.15
89909;100107;Szkoła Podstawowa w Chabielicach|Chabielice-Kolonia| 5 |97-420 Szczerców;877;478;478;18;460;54.50;3.77
89910;100107;Szkoła Podstawowa w Osinach|Osiny| 13 |97-420 Szczerców;486;246;246;10;236;50.62;4.07
89911;100108;Szkoła Podstawowa|Kociszew| 32 |97-425 Zelów;843;419;419;7;412;49.70;1.67
89912;100108;Gimnazjum|Łobudzice| 54 |97-425 Zelów;1748;841;841;25;816;48.11;2.97
89913;100108;Szkoła Podstawowa|Wygiełzów| 17 |97-425 Zelów;1617;703;703;27;676;43.48;3.84
89914;100108;Ochotnicza Straż Pożarna|Pożdżenice| 140 |97-425 Zelów;936;403;403;15;388;43.06;3.72
89915;100108;Zespół Szkół Ogólnokształcących|Zelów|ul.Kilińskiego 40 |97-425 Zelów;1532;777;777;30;747;50.72;3.86
89916;100108;Miejsko-Gminny Ośrodek Pomocy Społecznej|Zelów|ul. Piotrkowska 12 |97-425 Zelów;1491;822;822;21;801;55.13;2.55
89917;100108;Szkoła Podstawowa Nr 2|Zelów|ul. Kościuszki 40/42 |97-425 Zelów;732;328;328;12;316;44.81;3.66
89918;100108;Szkoła Podstawowa Nr 2|Zelów|ul. Kościuszki 40/42 |97-425 Zelów;1476;771;771;25;746;52.24;3.24
89919;100108;Szkoła Podstawowa Nr 4|Zelów|ul. Żeromskiego 51 |97-425 Zelów;1678;910;910;20;890;54.23;2.20
89920;100108;Dom Pomocy Społecznej|Zabłoty| 19 |97-425 Zelów;56;35;35;12;23;62.50;34.29
89921;100201;Muzeum Regionalne w Kutnie|Kutno|Plac Marszałka Józefa Piłsudskiego 20 |99-300 Kutno;1898;911;911;16;895;48.00;1.76
89922;100201;Zespół Szkół Nr 1 im. St. Staszica w Kutnie|Kutno|ul. Oporowska 7 |99-300 Kutno;1590;810;811;16;794;50.94;1.98
89923;100201;Świetlica RSM "Pionier" w Kutnie|Kutno|ul. Staszica 21 |99-300 Kutno;1869;975;975;14;961;52.17;1.44
89924;100201;Zespół Szkół Nr 3 im. Władysława Grabskiego w Kutnie|Kutno|ul. Kościuszki 24 |99-300 Kutno;1605;845;845;15;830;52.65;1.78
89925;100201;I Liceum Ogólnokształcące im. Gen. J.H.Dąbrowskiego w Kutnie|Kutno|ul. Generała Dąbrowskiego 1 |99-300 Kutno;1582;799;799;8;791;50.51;1.00
89926;100201;Gimnazjum Nr 2 im. Marszałka Józefa Piłsudskiego w Kutnie|Kutno|ul. Staszica 6 |99-300 Kutno;1678;856;856;12;844;51.01;1.40
89927;100201;Przedszkole Miejskie Nr 17 "NIEZAPOMINAJKA" w Kutnie|Kutno|ul. Józefa Wybickiego 1 |99-300 Kutno;1783;929;929;21;908;52.10;2.26
89928;100201;Przedszkole Miejskie Nr 17 "NIEZAPOMINAJKA" w Kutnie|Kutno|ul. Józefa Wybickiego 1 |99-300 Kutno;1932;893;893;26;867;46.22;2.91
89929;100201;Szkoła Podstawowa Nr 1 im. Tadeusza Kościuszki w Kutnie|Kutno|ul. Kanclerza Andrzeja Zamoyskiego 1 |99-300 Kutno;1714;897;897;18;879;52.33;2.01
89930;100201;Szkoła Podstawowa Nr 4 im. Mikołaja Kopernika w Kutnie|Kutno|ul. Narutowicza 22 |99-300 Kutno;1816;672;674;24;648;37.00;3.57
89931;100201;Budynek Parafii pw. Matki Bożej Wspomożenia Wiernych w Kutnie|Kutno|ul. Jesienna 2 |99-300 Kutno;1772;897;897;12;885;50.62;1.34
89932;100201;Gimnazjum Nr 3 im. Henryka Sienkiewicza w Kutnie|Kutno|ul. Łęczycka 11 |99-300 Kutno;1806;897;897;17;880;49.67;1.90
89933;100201;P.W. "AUTO-MOTO-KUTNO" E. Z. Kwiatkowscy w Kutnie|Kutno|ul. Sienkiewicza 28 |99-300 Kutno;1932;898;898;25;873;46.48;2.78
89934;100201;Szkoła Podstawowa Nr 6 im. Marii Skłodowskiej-Curie w Kutnie|Kutno|ul. Łąkoszyńska 9 |99-300 Kutno;1966;957;957;22;935;48.68;2.30
89935;100201;Szkoła Podstawowa Nr 6 im. Marii Skłodowskiej-Curie w Kutnie|Kutno|ul. Łąkoszyńska 9 |99-300 Kutno;1714;934;934;14;920;54.49;1.50
89936;100201;Przedszkole Miejskie Nr 15 "Bajka" w Kutnie|Kutno|ul. Władysława Jagiełły 4a |99-300 Kutno;1589;950;950;11;939;59.79;1.16
89937;100201;Przedszkole Miejskie Nr 8 "Promyczek" w Kutnie|Kutno|ul. Dr. Antoniego Troczewskiego 2a |99-300 Kutno;1804;898;898;23;875;49.78;2.56
89938;100201;Gimnazjum Nr 1 im. Adama Mickiewicza w Kutnie|Kutno|ul. Dr. Antoniego Troczewskiego 2 |99-300 Kutno;1804;880;880;22;858;48.78;2.50
89939;100201;Przedszkole Miejskie Nr 15 "Bajka" w Kutnie|Kutno|ul. Władysława Jagiełły 4a |99-300 Kutno;1794;951;951;15;936;53.01;1.58
89940;100201;Szkoła Podstawowa Nr 9 im. Wł. Jagiełły w Kutnie|Kutno|ul. Władysława Jagiełły 6 |99-300 Kutno;1647;887;887;9;878;53.86;1.01
89941;100201;Szkoła Podstawowa Nr 9 im. Wł. Jagiełły w Kutnie|Kutno|ul. Władysława Jagiełły 6 |99-300 Kutno;1669;801;801;20;781;47.99;2.50
89942;100201;Dom Pomocy Społecznej w Kutnie|Kutno|ul. Oporowska 27 |99-300 Kutno;83;24;24;6;18;28.92;25.00
89943;100201;Dom Pomocy Społecznej w Kutnie|Kutno|ul. Bolesława Krzywoustego 11 |99-300 Kutno;59;29;29;10;19;49.15;34.48
89944;100201;Dom Pomocy Społecznej prow. Przez Zgrom. SS Albertynek w Kutnie|Kutno|ul. Jana III Sobieskiego 49 |99-300 Kutno;71;43;43;1;42;60.56;2.33
89945;100201;"Kutnowski Szpital Samorządowy" Spółka z o.o. NZOZ "Kutnowski Szpital Samorządowy im. dr Antoniego Troczewskiego"|Kutno|ul. Kościuszki 52 |99-300 Kutno;173;41;41;2;39;23.70;4.88
89946;100202;Gminny Ośrodek Kultury w Bedlnie|Bedlno| 28A |99-311 Bedlno;1234;472;472;33;439;38.25;6.99
89947;100202;Szkoła Podstawowa im. 37 Łęczyckiego Pułku Piechoty im. ks. J. Poniatowskiego w Pleckiej Dąbrowie|Plecka Dąbrowa| 6 |99-311 Bedlno;1310;495;495;16;479;37.79;3.23
89948;100202;Szkoła Podstawowa im. Bohaterów Walk nad Bzurą w Szewcach Nadolnych|Szewce Nadolne| 14 |99-311 Bedlno;559;236;236;10;226;42.22;4.24
89949;100202;Szkoła Podstawowa im. Marii Konopnickiej w Żeronicach|Żeronice| 37A |99-311 Bedlno;893;369;369;17;352;41.32;4.61
89950;100202;Szkoła Podstawowa im. Kornela Makuszyńskiego w Pniewie|Pniewo| 21 |99-311 Bedlno;591;238;238;11;227;40.27;4.62
89951;100202;Dom Pomocy Społecznej w Pniewie|Pniewo| 91 |99-311 Bedlno;61;15;15;2;13;24.59;13.33
89952;100202;Dom Pomocy Społecznej w Wojszycach|Wojszyce| 47 |99-311 Bedlno;67;37;37;6;31;55.22;16.22
89953;100203;Zespół Szkół w Dąbrowicach|Dąbrowice|ul. Kłodawska 1 |99-352 Dąbrowice;905;374;374;8;366;41.33;2.14
89954;100203;Świetlica w Remizie OSP Augustopol|Augustopol| 76 |99-352 Dąbrowice;199;78;78;2;76;39.20;2.56
89955;100203;Świetlica w Remizie OSP Baby|Baby| 17 |99-352 Dąbrowice;286;121;121;11;110;42.31;9.09
89956;100203;Świetlica w Remizie OSP Ostrówki|Ostrówki| 35A |99-352 Dąbrowice;235;95;95;11;84;40.43;11.58
89957;100204;Gminne Centrum Kultury, Sportu i Rekreacji w Krośniewicach Ośrodek Kultury|Krośniewice|ul. Kolejowa 21 |99-340 Krośniewice;1562;724;724;31;693;46.35;4.28
89958;100204;Świetlica osiedlowa w Krośniewicach|Krośniewice|ul. Błonie (Andersówka) 9 |99-340 Krośniewice;319;142;142;18;124;44.51;12.68
89959;100204;Szkoła Podstawowa Nr 1 w Krośniewicach|Krośniewice|ul. Poznańska 15 |99-340 Krośniewice;937;307;307;18;289;32.76;5.86
89960;100204;Zespół Szkół Nr 1 w Krośniewicach|Krośniewice|ul. Łęczycka 17 |99-340 Krośniewice;971;369;369;23;346;38.00;6.23
89961;100204;Budynek po Liceum Ogólnokształcącym w Krośniewicach|Krośniewice|ul. Łęczycka 19a |99-340 Krośniewice;816;378;378;13;365;46.32;3.44
89962;100204;Katolicka Szkoła Podstawowa z Oddziałami Przedszkolnymi im. św. Jana Pawła II w Zalesiu|Zalesie| |99-340 Krośniewice;567;229;229;14;215;40.39;6.11
89963;100204;Szkoła Podstawowa Fundacji "Elementarz" z Oddziałem Przedszkolnym w Jankowicach|Jankowice| |99-340 Krośniewice;502;162;162;17;145;32.27;10.49
89964;100204;Szkoła Podstawowa im. gen. Władysława Andersa w Nowem|Nowe| |99-340 Krośniewice;983;335;335;28;307;34.08;8.36
89965;100204;Świetlica wiejska|Szubsk Duży| 18 |99-340 Krośniewice;479;171;171;5;166;35.70;2.92
89966;100205;Urząd Gminy|Krzyżanów| 10 |99-314 Krzyżanów;1265;428;428;31;397;33.83;7.24
89967;100205;Szkoła Podstawowa|Kaszewy Dworne| 19 |99-314 Krzyżanów;547;223;223;7;216;40.77;3.14
89968;100205;Szkoła Podstawowa|Ktery| 34 |99-314 Krzyżanów;990;348;348;5;343;35.15;1.44
89969;100205;Remiza Ochotniczej Straży Pożarnej|Wały B| 27a |99-314 Krzyżanów;768;335;335;3;332;43.62;0.90
89970;100206;Szkoła Podstawowa w Strzegocinie|Strzegocin| 4 |99-300 Kutno;912;313;313;13;300;34.32;4.15
89971;100206;Ośrodek Kultury Gminy Kutno|Leszczynek| 49A |99-300 Kutno;1459;661;661;12;649;45.31;1.82
89972;100206;Szkoła Podstawowa we Wroczynach|Wroczyny| 59a |99-300 Kutno;489;204;204;6;198;41.72;2.94
89973;100206;Zespół Szkół w Gołębiewku|Gołębiewek Nowy| 54 |99-300 Kutno;781;359;359;6;353;45.97;1.67
89974;100206;Budynek po byłej Szkole Podstawowej|Gołębiew Stary| 1 |99-300 Kutno;1400;615;615;13;602;43.93;2.11
89975;100206;Katolicka Szkoła Podstawowa SPSK|Wierzbie| 34 |99-300 Kutno;549;270;270;5;265;49.18;1.85
89976;100206;Świetlica Wiejska|Woźniaków| 55 |99-300 Kutno;815;408;408;15;393;50.06;3.68
89977;100206;ZDZ w Warszawie Centrum Kształcenia w Kutnie|Bielawki| 31 |99-300 Kutno;641;280;280;14;266;43.68;5.00
89978;100207;Świetlica wiejska w Łaniętach|Łanięta| 15g |99-306 Łanięta;1168;400;400;18;382;34.25;4.50
89979;100207;Remiza Ochotniczej Straży Pożarnej w Suchodębiu|Suchodębie| 50 |99-306 Łanięta;720;264;264;14;250;36.67;5.30
89980;100207;DPS w Woli Chruścińskiej|Wola Chruścińska| 4 |99-306 Łanięta;55;37;37;0;37;67.27;0.00
89981;100208;Szkoła Podstawowa w Ostrowach|Ostrowy| 8 |99-350 Ostrowy;1174;423;423;14;409;36.03;3.31
89982;100208;Urząd Gminy w Nowych Ostrowach|Nowe Ostrowy| 80 |99-350 Ostrowy;953;347;347;13;334;36.41;3.75
89983;100208;Ochotnicza Straż Pożarna|Grochów| 25 |99-350 Ostrowy;480;178;178;6;172;37.08;3.37
89984;100208;Budynek po Szkole Podstawowej|Wola Pierowa| 28 |99-350 Ostrowy;370;125;125;10;115;33.78;8.00
89985;100209;Zespół Szkół w Oporowie|Oporów| 57 |99-322 Oporów;1220;518;518;37;481;42.46;7.14
89986;100209;Zespół Szkół w Szczycie|Szczyt| 6A |99-311 Bedlno;990;383;383;19;364;38.69;4.96
89987;100210;Gminny Ośrodek Kultury w Strzelcach|Strzelce|ul. Główna 10 |99-307 Strzelce;1624;681;681;32;649;41.93;4.70
89988;100210;Ochotnicza Straż Pożarna w Klonowcu Starym|Klonowiec Stary| 33 |99-306 Łanięta;627;253;253;10;243;40.35;3.95
89989;100210;Budynek byłej Szkoły Podstawowej w Muchnicach Nowych|Muchnice Nowe| 32 |99-307 Strzelce;627;269;269;14;255;42.90;5.20
89990;100210;Świetlica wiejska w Muchnowie|Muchnów| 38 |99-307 Strzelce;439;173;173;4;169;39.41;2.31
89991;100211;Szkoła Podstawowa|Grabów|ul. Szkolna 4 |99-319 Dobrzelin;1665;577;577;24;553;34.65;4.16
89992;100211;Świetlica w budynku Ochotniczej Straży Pożarnej|Śleszyn|ul. Górna 3 |99-321 Śleszyn;679;269;269;16;253;39.62;5.95
89993;100211;Społeczna Szkoła Podstawowa|Orątki Dolne| 1 |99-320 Żychlin;442;144;144;5;139;32.58;3.47
89994;100211;Zespół Szkół Nr 1|Żychlin|ul. Łukasińskiego 21 |99-320 Żychlin;1422;604;604;16;588;42.48;2.65
89995;100211;Zespół Szkół Nr 1|Żychlin|ul. Łukasińskiego 21 |99-320 Żychlin;1296;587;587;16;571;45.29;2.73
89996;100211;Szkoła Podstawowa Nr 1 (stołówka)|Żychlin|ul. 1 Maja 23 |99-320 Żychlin;1354;486;486;27;459;35.89;5.56
89997;100211;Żychliński Dom Kultury|Żychlin|ul. Fabryczna 3 |99-320 Żychlin;766;223;223;13;210;29.11;5.83
89998;100211;Zespół Szkolno-Przedszkolny (stołówka)|Żychlin|ul. Żeromskiego 8 |99-320 Żychlin;1422;636;636;23;613;44.73;3.62
89999;100211;Zespół Szkolno-Przedszkolny (sala gimnastyczna)|Żychlin|ul. Żeromskiego 8 |99-320 Żychlin;1184;551;551;11;540;46.54;2.00
90000;100301;Zespół Szkoły Podstawowej i Gimnazjum Publicznego w Buczku|Buczek|Szkolna 3 |98-113 Buczek;1939;907;907;23;884;46.78;2.54
90001;100301;budynek OSP w Brodni Górnej|Brodnia Górna| 45 |98-113 Buczek;546;242;242;8;234;44.32;3.31
90002;100301;Szkoła Filialna w Czestkowie|Czestków B| 10c |98-113 Buczek;666;328;328;10;318;49.25;3.05
90003;100301;Szkoła Podstawowa w Maleni|Malenia| 1 |98-113 Buczek;436;207;207;2;205;47.48;0.97
90004;100301;budynek OSP w Luciejowie|Luciejów| 50 a |98-113 Buczek;481;197;197;3;194;40.96;1.52
90005;100302;Publiczne Gimnazjum Nr 1|Łask|Narutowicza 28 |98-100 Łask;1162;687;687;16;671;59.12;2.33
90006;100302;Publiczne Gimnazjum Nr 1|Łask|Narutowicza 28 |98-100 Łask;1031;458;458;9;449;44.42;1.97
90007;100302;Łaski Dom Kultury|Łask|Narutowicza 11 |98-100 Łask;1422;786;786;20;766;55.27;2.54
90008;100302;Szkoła Podstawowa Nr 1|Łask|9 Maja 12 |98-100 Łask;1798;868;868;19;849;48.28;2.19
90009;100302;Specjalny Ośrodek Szkolno-Wychowawczy|Łask|Mickiewicza 6 |98-100 Łask;1208;749;749;17;732;62.00;2.27
90010;100302;Publiczne Gimnazjum Nr 2|Łask|Berlinga 1 |98-100 Łask;1262;691;691;22;669;54.75;3.18
90011;100302;Publiczne Gimnazjum Nr 2|Łask|Berlinga 1 |98-100 Łask;1155;617;617;19;598;53.42;3.08
90012;100302;Szkoła Podstawowa Nr 5|Łask|Szkolna 1 |98-100 Łask;1767;1001;1001;18;983;56.65;1.80
90013;100302;Zespół Szkół Ogólnokształcących|Łask|Toruńska 1 |98-100 Łask;1264;615;615;15;600;48.66;2.44
90014;100302;Przedszkole Publiczne Nr 4|Łask|Łączna 1 |98-100 Łask;1205;581;582;13;568;48.22;2.24
90015;100302;Przedszkole Publiczne Nr 4|Łask|Łączna 1 |98-100 Łask;1203;652;652;8;644;54.20;1.23
90016;100302;Niepubliczna Szkoła Podstawowa w Teodorach|Teodory| 62 |98-100 Łask;1300;745;745;14;731;57.31;1.88
90017;100302;Szkoła Podstawowa Nr 1|Łask|9 Maja 12 |98-100 Łask;816;425;425;8;417;52.08;1.88
90018;100302;Niepubliczna Szkoła Podstawowa w Łopatkach|Łopatki| 24 |98-100 Łask;741;320;320;20;300;43.18;6.25
90019;100302;Szkoła Podstawowa w Okupie|Okup Mały|Akacjowa 4 |98-100 Łask;1154;508;508;11;497;44.02;2.17
90020;100302;Szkoła Podstawowa w Bałuczu|Bałucz| 32 |98-100 Łask;1089;477;477;10;467;43.80;2.10
90021;100302;Niepubliczna Szkoła Podstawowa we Wrzeszewicach|Wrzeszczewice| 14 |98-100 Łask;705;245;245;6;239;34.75;2.45
90022;100302;Szkoła Podstawowa w Wiewiórczynie|Wiewiórczyn|Szkolna 1 |98-100 Łask;1173;559;559;21;538;47.66;3.76
90023;100302;Szkoła Podstawowa w Wiewiórczynie|Wiewiórczyn|Szkolna 1 |98-100 Łask;1197;492;492;15;477;41.10;3.05
90024;100302;Centrum Dializa Sp. z o.o. Szpital w Łasku|Łask|Warszawska 62A |98-100 Łask;79;37;37;3;34;46.84;8.11
90025;100303;Zespół Szkół Ogólnokształcących Nr 1 w Sędziejowicach|Sędziejowice|Powstańców 1863 roku 6 |98-160 Sędziejowice;931;466;466;9;457;50.05;1.93
90026;100303;Świetlica Wiejska w Osinach|Osiny| 17A |98-160 Sędziejowice;428;177;177;10;167;41.36;5.65
90027;100303;Zespół Szkół w Marzeninie|Marzenin|Łaska 7 |98-160 Sędziejowice;1247;626;626;21;605;50.20;3.35
90028;100303;Remiza OSP w Pruszkowie|Pruszków|Główna 16 |98-160 Sędziejowice;583;256;256;12;244;43.91;4.69
90029;100303;Remiza OSP w Grabi|Grabia| 23 |98-160 Sędziejowice;374;169;169;4;165;45.19;2.37
90030;100303;Remiza OSP w Grabnie|Grabno| 2 |98-160 Sędziejowice;810;375;375;13;362;46.30;3.47
90031;100303;Gminny Ośrodek Kultury w Sędziejowicach|Sędziejowice|Wieluńska 7 |98-160 Sędziejowice;856;421;421;21;400;49.18;4.99
90032;100304;Gminny Ośrodek Kultury w Widawie|Widawa|Mickiewicza 3 |98-170 Widawa;1251;472;472;26;446;37.73;5.51
90033;100304;Budynek byłej Szkoły Podstawowej w Brzykowie|Brzyków| 24 |98-170 Widawa;797;335;335;15;320;42.03;4.48
90034;100304;Zespół Szkół w Chociwiu|Chociw| 191 |98-170 Widawa;1133;528;528;19;509;46.60;3.60
90035;100304;Budynek wiejski w Zborowie|Zborów| 18 |98-170 Widawa;736;328;328;13;315;44.57;3.96
90036;100304;Szkoła Podstawowa w Ochlach|Ochle| 2A |98-170 Widawa;466;196;196;14;182;42.06;7.14
90037;100304;Społeczna Szkoła Podstawowa w Restarzewie Cmentarnym|Restarzew Cmentarny| 11 |98-170 Widawa;588;224;224;11;213;38.10;4.91
90038;100304;Zespół Szkół w Widawie|Widawa|Wieluńska 17 |98-170 Widawa;1418;796;796;22;774;56.14;2.76
90039;100305;Urząd Gminy w Wodzieradach|Wodzierady| 24 |98-105 Wodzierady;1547;768;768;35;733;49.64;4.56
90040;100305;Publiczne Gimnazjum w Kwiatkowicach|Wodzierady|Szkolna 17A |98-105 Wodzierady;1212;604;604;22;582;49.83;3.64
90041;100401;Przedsiębiorstwo Gospodarki Komunalnej i Mieszkaniowej Sp. z o.o.|Łęczyca|ul. Tumska 2 |99-100 Łęczyca;691;402;402;13;389;58.18;3.23
90042;100401;Szkoła Podstawowa Nr 4|Łęczyca|ul. Ozorkowskie Przedmieście 6C |99-100 Łęczyca;1539;762;762;20;742;49.51;2.62
90043;100401;Urząd Miejski|Łęczyca|ul. Marii Konopnickiej 14 |99-100 Łęczyca;1577;615;615;30;585;39.00;4.88
90044;100401;Stowarzyszenie Abstynentów i Rodzin Abstynenckich Klubu " Przebudzenie "|Łęczyca|ul. Belwederska 38 |99-100 Łęczyca;742;409;409;12;397;55.12;2.93
90045;100401;Przedszkole Nr 4|Łęczyca|ul. Bitwy nad Bzurą 26A |99-100 Łęczyca;1567;789;789;17;772;50.35;2.15
90046;100401;Szkoła Podstawowa Nr 3|Łęczyca|ul. Zachodnia 23 |99-100 Łęczyca;1591;840;840;28;812;52.80;3.33
90047;100401;Liceum Ogólnokształcące|Łęczyca|ul. Marii Konopnickiej 13 |99-100 Łęczyca;1568;771;773;27;744;49.17;3.50
90048;100401;Bursa Szkolna|Łęczyca|ul. Kaliska 13 |99-100 Łęczyca;1669;765;765;27;738;45.84;3.53
90049;100401;Dom Kultury|Łęczyca|Aleje Jana Pawła II 11 |99-100 Łęczyca;827;269;269;21;248;32.53;7.81
90050;100401;Zespół Opieki Zdrowotnej|Łęczyca|ul. Zachodnia 6 |99-100 Łęczyca;175;26;26;2;24;14.86;7.69
90051;100401;Dom Pomocy Społecznej|Łęczyca|Jana Kilińskiego 2 |99-100 Łęczyca;52;25;25;2;23;48.08;8.00
90052;100401;Zakład Opiekuńczo Leczniczy|Łęczyca|Lotnicza 2A |99-100 Łęczyca;28;3;3;0;3;10.71;0.00
90053;100402;Urząd Gminy w Daszynie|Daszyna| 34a |99-107 Daszyna;1707;584;584;38;546;34.21;6.51
90054;100402;Szkoła Podstawowa w Mazewie|Mazew| 68 |99-107 Daszyna;1641;514;514;23;491;31.32;4.47
90055;100403;Budynek po byłej szkole w Tumie|Tum| 69 |99-100 Łęczyca;660;315;315;7;308;47.73;2.22
90056;100403;Świetlica wiejska w Witaszewicach|Witaszewice| |99-122 Góra Św. Małgorzaty;644;220;220;10;210;34.16;4.55
90057;100403;Szkoła Podstawowa w Sługach|Sługi| 44 |99-122 Góra Św.Małgorzaty;263;101;101;3;98;38.40;2.97
90058;100403;Gimnazjum w Nowym Gaju|Nowy Gaj| 23 |99-122 Góra Św. Małgorzaty;617;224;224;4;220;36.30;1.79
90059;100403;Szkoła Podstawowa w Górze Św. Małgorzaty|Góra Świętej Małgorzaty| 42 |99-122 Góra Św.Małgorzaty;1408;518;518;31;487;36.79;5.98
90060;100403;DPS w Karsznicach|Karsznice| 62 |99-122 Góra Św. Małgorzaty;35;20;20;2;18;57.14;10.00
90061;100404;Szkoła Podstawowa|Chorki| 8 |99-150 Grabów;770;314;314;25;289;40.78;7.96
90062;100404;Szkoła Podstawowa|Stara Sobótka| 32 |99-150 Grabów;1006;337;337;14;323;33.50;4.15
90063;100404;Szkoła Podstawowa|Kadzidłowa| 22 |99-150 Grabów;400;111;111;3;108;27.75;2.70
90064;100404;Remiza OSP|Besiekiery| 14 |99-150 Grabów;750;245;245;10;235;32.67;4.08
90065;100404;Remiza OSP|Byszew| 36 |99-150 Grabów;358;150;150;8;142;41.90;5.33
90066;100404;Gimnazjum|Grabów|ul. Kochanowskiego 2 |99-150 Grabów;962;433;433;15;418;45.01;3.46
90067;100404;Gimnazjum|Grabów|ul. Kochanowskiego 2 |99-150 Grabów;886;313;313;10;303;35.33;3.19
90068;100405;Gimnazjum|Topola Królewska| 66 |99-100 Łęczyca;1426;556;557;11;545;38.99;1.98
90069;100405;Szkoła Podstawowa|Siedlec| 16a |99-100 Łęczyca;874;352;352;24;328;40.27;6.82
90070;100405;Szkoła Podstawowa|Błonie| 33a |99-100 Łęczyca;934;308;308;9;299;32.98;2.92
90071;100405;Szkoła Podstawowa|Leźnica Mała| 36 |99-100 Łęczyca;965;374;374;29;345;38.76;7.75
90072;100405;Budynek po byłej szkole podstawowej|Janków| 8 |99-100 Łęczyca;419;135;135;11;124;32.22;8.15
90073;100405;Szkoła Podstawowa|Wilczkowice Górne| 35 |99-100 Łęczyca;961;438;440;37;401;45.58;8.45
90074;100405;Remiza Ochotniczej Straży Pożarnej|Topola Katowa| 21 |99-100 Łęczyca;416;174;174;5;169;41.83;2.87
90075;100405;Remiza Ochotniczej Straży Pożarnej|Dzierzbiętów Duży| 9 |99-100 Łęczyca;1005;427;427;20;407;42.49;4.68
90076;100405;Zakład Karny w Garbalinie|Garbalin| 18 |99-100 Łęczyca;844;246;246;43;203;29.15;17.48
90077;100406;Zespół Szkół Mechanizacji Rolnictwa w Piątku|Piątek|ul. Kutnowska 19 |99-120 Piątek;1659;799;799;26;773;48.16;3.25
90078;100406;Hala sportowa w Piątku|Piątek|ul. Szkolna 1 |99-120 Piątek;1352;607;607;11;596;44.90;1.81
90079;100406;Szkoła Podstawowa w Czernikowie|Czerników| 11 |99-120 Piątek;996;387;387;9;378;38.86;2.33
90080;100406;Remiza Ochotniczej Straży Pożarnej w Goślubiu|Goślub| 15 |99-120 Piątek;741;288;288;12;276;38.87;4.17
90081;100406;Remiza Ochotniczej Straży Pożarnej w Jankowie|Janków| 2 |99-120 Piątek;350;154;154;4;150;44.00;2.60
90082;100407;Sala OSP|Chwalborzyce| 10a |99-140 Świnice Warckie;547;205;205;18;187;37.48;8.78
90083;100407;Szkoła Podstawowa w Świnicach Warckich|Świnice Warckie|ul. Szkolna 5 |99-140 Świnice Warckie;1221;545;545;22;523;44.64;4.04
90084;100407;Szkoła Podstawowa|Piaski| 23 |99-140 Świnice Warckie;920;327;327;13;314;35.54;3.98
90085;100407;Sala OSP|Grodzisko| 14 |99-140 Świnice Warckie;610;252;252;11;241;41.31;4.37
90086;100408;Budynek byłej Szkoły Podstawowej w Kucharach|Kuchary| 51 |99-335 Witonia;518;172;172;14;158;33.20;8.14
90087;100408;Szkoła Podstawowa w Witoni|Witonia|ul. Szkolna 4 |99-335 Witonia;1318;512;512;13;499;38.85;2.54
90088;100408;Świetlica OSP w Anusinie|Anusin| 29 |99-335 Witonia;406;179;179;13;166;44.09;7.26
90089;100408;Świetlica wiejska|Gozdków| 2 |99-335 Witonia;532;179;179;10;169;33.65;5.59
90090;100501;Zespół Szkół|Łowicz|ul. Grunwaldzka 9 |99-400 Łowicz;1303;706;706;16;690;54.18;2.27
90091;100501;Zespół Szkół|Łowicz|ul. Grunwaldzka 9 |99-400 Łowicz;1202;475;475;15;460;39.52;3.16
90092;100501;Przedszkole nr 5|Łowicz|ul. Chełmońskiego 4 |99-400 Łowicz;1354;734;734;14;720;54.21;1.91
90093;100501;Świetlica Rodzinnego Ogrodu Działkowego|Łowicz|ul.Bolimowska 29/31 |99-400 Łowicz;1344;823;823;19;804;61.24;2.31
90094;100501;Budynek zaplecza boiska Ośrodka Sportu i Rekreacji|Łowicz|ul. Bolimowska 15/19 |99-400 Łowicz;1323;731;731;20;711;55.25;2.74
90095;100501;Szkoła Podstawowa nr 1|Łowicz|ul. Kaliska 12 |99-400 Łowicz;927;440;440;6;434;47.46;1.36
90096;100501;Szkoła Podstawowa nr 1|Łowicz|ul. Kaliska 12 |99-400 Łowicz;958;527;527;10;517;55.01;1.90
90097;100501;I Liceum Ogólnokształcące|Łowicz|ul. Bonifraterska 3 |99-400 Łowicz;1038;452;452;12;440;43.55;2.65
90098;100501;Przedszkole nr 4|Łowicz|ul. Generała Sikorskiego 2 |99-400 Łowicz;1164;605;605;10;595;51.98;1.65
90099;100501;Gimnazjum nr 1|Łowicz|ul. Aleje Sienkiewicza 62 |99-400 Łowicz;904;516;516;8;508;57.08;1.55
90100;100501;Przedszkole nr 2|Łowicz|ul. Starzyńskiego 5a |99-400 Łowicz;841;462;462;9;453;54.93;1.95
90101;100501;Przedszkole nr 1|Łowicz|ul. Ułańska 1 |99-400 Łowicz;1036;590;590;13;577;56.95;2.20
90102;100501;Szkoła Podstawowa nr 4|Łowicz|ul. Stanisławskiego 31 |99-400 Łowicz;1075;615;615;8;607;57.21;1.30
90103;100501;Szkoła Policealna Samorządu Województwa Łódzkiego|Łowicz|ul. Ułańska 2 |99-400 Łowicz;1328;626;626;20;606;47.14;3.19
90104;100501;Specjalny Ośrodek Szkolno-Wychowawczy|Łowicz|ul. Powstańców 1863 r. 12 |99-400 Łowicz;1235;657;657;16;641;53.20;2.44
90105;100501;Przedszkole nr 10|Łowicz|ul. Księżacka 26 |99-400 Łowicz;1294;719;719;13;706;55.56;1.81
90106;100501;Hala Sportowa Ośrodka Sportu i Rekreacji nr 2|Łowicz|ul. Topolowa 2 |99-400 Łowicz;1121;605;605;12;593;53.97;1.98
90107;100501;Zespół Szkół z Oddziałami Integracyjnymi|Łowicz|ul. Młodzieżowa 15 |99-400 Łowicz;1072;621;621;22;599;57.93;3.54
90108;100501;Zespół Szkół z Oddziałami Integracyjnymi|Łowicz|ul. Młodzieżowa 15 |99-400 Łowicz;1074;602;602;12;590;56.05;1.99
90109;100501;Przedszkole nr 7|Łowicz|ul. Wiosenna 2 |99-400 Łowicz;955;493;493;10;483;51.62;2.03
90110;100501;Przedszkole nr 7|Łowicz|ul. Wiosenna 2 |99-400 Łowicz;937;480;480;15;465;51.23;3.12
90111;100501;Szpital Zespołu Opieki Zdrowotnej|Łowicz|ul.Ułańska 28 |99-400 Łowicz;50;19;19;0;19;38.00;0.00
90112;100501;Zakład Karny|Łowicz|ul. Wiejska 3 |99-400 Łowicz;600;221;221;33;188;36.83;14.93
90113;100502;Szkoła Podstawowa w Bielawach|Bielawy|ul.Parzew 20A |99-423 Bielawy;1307;548;550;16;532;41.93;2.92
90114;100502;Zespół Szkolno-Przedszkolny w Sobocie|Sobota|ul.Warszawska 22 |99-423 Bielawy;772;292;292;14;278;37.82;4.79
90115;100502;Dom Ludowy w Chruślinie|Chruślin| 47A |99-423 Bielawy;662;249;249;10;239;37.61;4.02
90116;100502;Zespół Szkół Stowarzyszenia Rozwoju Wsi Waliszew i Okolic im.Jana Pawła II w Starym Waliszewie|Stary Waliszew| 20A |99-423 Bielawy;697;390;390;13;377;55.95;3.33
90117;100502;Świetlica Wiejska w Łazinie|Łazin| 15A |99-423 Bielawy;629;239;239;12;227;38.00;5.02
90118;100502;Szkoła Podstawowa w Oszkowicach|Oszkowice| 29 |99-423 Bielawy;561;236;236;10;226;42.07;4.24
90119;100502;Dom Pomocy Społecznej w Borówku|Borówek| 56 |99-423 Bielawy;70;22;22;6;16;31.43;27.27
90120;100502;Oddział Fizjoterapii i Rehabilitacji w Stanisławowie Szpitala Zespołu Opieki Zdrowotnej w Łowiczu|Rulice| 31 |99-423 Bielawy;31;30;30;4;26;96.77;13.33
90121;100503;Zespół Szkół Publicznych w Błędowie|Błędów| 20 |99-413 Chąśno;744;372;372;7;365;50.00;1.88
90122;100503;Urząd Gminy Chąśno|Chąśno| 55 |99-413 Chąśno;983;460;460;16;444;46.80;3.48
90123;100503;Szkoła Podstawowa w Mastkach|Mastki| 1 |99-413 Chąśno;726;318;318;19;299;43.80;5.97
90124;100504;Gminny Ośrodek Kultury w Domaniewicach|Domaniewice|ul. Główna 3 |99-434 Domaniewice;1487;780;780;29;751;52.45;3.72
90125;100504;Świetlica Wiejska w Krępie|Krępa| 25B |99-434 Domaniewice;1296;541;541;14;527;41.74;2.59
90126;100504;Szkoła Podstawowa w Skaratkach|Skaratki| 44a |99-434 Domaniewice;952;411;411;16;395;43.17;3.89
90127;100505;Gminny Ośrodek Kultury w Kiernozi|Kiernozia|ul. Sobocka 1a |99-412 Kiernozia;1637;701;701;22;679;42.82;3.14
90128;100505;Budynek byłej Szkoły Podstawowej w Brodnym-Józefowie|Brodne-Józefów| 13 |99-412 Kiernozia;700;303;303;10;293;43.29;3.30
90129;100505;Świetlica wiejska w Woli Stępowskiej|Wola Stępowska| 56 |99-412 Kiernozia;532;202;202;12;190;37.97;5.94
90130;100506;Szkoła Podstawowa w Kocierzewie Południowym|Kocierzew Południowy| 103 |99-414 Kocierzew;1897;902;902;17;885;47.55;1.88
90131;100506;Szkoła Podstawowa w Gągolinie Południowym|Gągolin Południowy| 82 |99-414 Kocierzew;635;261;261;5;256;41.10;1.92
90132;100506;Filia w Boczkach Gminnej Biblioteki Publicznej w Kocierzewie Południowym|Boczki| 84 |99-414 Kocierzew;998;586;586;17;569;58.72;2.90
90133;100507;Szkoła Podstawowa w Popowie|Popów|ul. Poznańska 4 |99-400 Łowicz;1104;591;591;21;570;53.53;3.55
90134;100507;Szkoła Podstawowa w Zielkowicach|Zielkowice| 145 |99-400 Łowicz;897;409;409;18;391;45.60;4.40
90135;100507;Szkoła Podstawowa w Jamnie|Jamno| 112 |99-400 Łowicz;377;170;170;2;168;45.09;1.18
90136;100507;Gminna Biblioteka Publiczna w Bocheniu|Bocheń| 57a |99-400 Łowicz;906;459;459;15;444;50.66;3.27
90137;100507;Izba Pamięci ZNP w Pilaszkowie|Pilaszków| 24 |99-400 Łowicz;956;414;414;14;400;43.31;3.38
90138;100507;Szkoła Podstawowa w Niedźwiadzie|Niedźwiada| 43 |99-400 Łowicz;924;439;439;4;435;47.51;0.91
90139;100507;Szkoła Podstawowa w Wygodzie|Wygoda| 78 |99-400 Łowicz;606;260;260;12;248;42.90;4.62
90140;100507;Stowarzyszenie Osób Niepełnosprawnych"Tacy Sami" - Warsztaty Terapii Zajęciowej|Parma| 36 |99-400 Łowicz;370;189;189;9;180;51.08;4.76
90141;100508;Przedszkole w Łyszkowicach|Łyszkowice|ul.Gminna 5A |99-420 Łyszkowice;1584;660;660;33;627;41.67;5.00
90142;100508;Szkoła Podstawowa w Seligowie|Seligów| 41 |99-420 Łyszkowice;444;141;141;11;130;31.76;7.80
90143;100508;Szkoła Podstawowa w Stachlewie|Stachlew| 57 |99-418 Bełchów;666;294;294;13;281;44.14;4.42
90144;100508;Szkoła Podstawowa w Kalenicach|Kalenice| 119 |99-420 Łyszkowice;760;250;250;3;247;32.89;1.20
90145;100508;Strażnica OSP w Czatolinie|Czatolin| 207A |99-420 Łyszkowice;479;181;181;8;173;37.79;4.42
90146;100508;Strażnica OSP w Łagowie|Łagów| 62A |99-420 Łyszkowice;391;158;158;13;145;40.41;8.23
90147;100508;Strażnica OSP w Gzince|Gzinka| 21B |99-420 Łyszkowice;518;232;232;4;228;44.79;1.72
90148;100508;Strażnica OSP w Polesiu|Polesie| 66A |99-418 Bełchów;548;253;253;17;236;46.17;6.72
90149;100509;Gimnazjum Nr 1 w Kompinie|Kompina|Aleja Legionów Polskich 8 |99-416 Nieborów;435;235;235;7;228;54.02;2.98
90150;100509;Szkoła Podstawowa w Bednarach|Bednary|Aleja Legionów Polskich 61 |99-416 Nieborów;1239;646;646;15;631;52.14;2.32
90151;100509;Zespół Placówek Oświatowych w Nieborowie|Nieborów|Aleja Legionów Polskich 92 |99-416 Nieborów;1317;612;612;25;587;46.47;4.08
90152;100509;Szkoła Podstawowa w Mysłakowie|Mysłaków| 55 A |99-416 Nieborów;1078;522;522;11;511;48.42;2.11
90153;100509;Szkoła Podstawowa w Bobrownikach|Bobrowniki| 126 |99-418 Bełchów;1017;555;555;21;534;54.57;3.78
90154;100509;Szkoła Podstawowa w Bełchowie|Bełchów| 85 |99-418 Bełchów;990;402;402;22;380;40.61;5.47
90155;100509;Filia Gminnego Ośrodka Kultury w Bełchowie|Bełchów|1 Maja 9 |99-418 Bełchów;1268;700;700;29;671;55.21;4.14
90156;100509;Gimnazjum Nr 2 w Dzierzgówku|Dzierzgówek| 15 |99-418 Bełchów;359;175;175;11;164;48.75;6.29
90157;100510;Biblioteka Publiczna i Dom Kultury Gminy Zduny w Zdunach|Zduny| 1F |99-440 Zduny;1505;677;677;19;658;44.98;2.81
90158;100510;Szkoła Podstawowa w Strugienicach|Strugienice| 38a |99-440 Zduny;843;385;385;13;372;45.67;3.38
90159;100510;Szkoła Podstawowa w Bąkowie|Bąków Górny| 123 |99-440 Zduny;1409;621;621;20;601;44.07;3.22
90160;100510;Dom Ludowy w Złakowie Kościelnym|Złaków Kościelny| 96 |99-440 Zduny;1100;539;539;10;529;49.00;1.86
90161;100602;Ochotnicza Straż Pożarna w Andrespolu|Andrespol|ul. Ceramiczna 1 |95-020 Andrespol;699;384;384;10;374;54.94;2.60
90162;100602;Ochotnicza Straż Pożarna w Andrespolu|Andrespol|ul. Ceramiczna 1 |95-020 Andrespol;698;444;444;4;440;63.61;0.90
90163;100602;Urząd Gminy w Andrespolu|Andrespol|ul. Rokicińska 126 |95-020 Andrespol;705;451;451;7;444;63.97;1.55
90164;100602;Urząd Gminy w Andrespolu|Andrespol|ul. Rokicińska 126 |95-020 Andrespol;692;382;382;8;374;55.20;2.09
90165;100602;Dom Parafialny w Bedoniu Przykościelnym|Bedoń Przykościelny|ul. Kościelna 25 |95-020 Andrespol;1133;650;650;16;634;57.37;2.46
90166;100602;Ochotnicza Straż Pożarna w Bedoniu Wsi|Bedoń Wieś|ul. Słowiańska 9 B |95-020 Andrespol;724;444;444;6;438;61.33;1.35
90167;100602;Rada Sołecka w Janówce|Janówka|ul. Główna 53 |95-020 Andrespol;767;442;442;4;438;57.63;0.90
90168;100602;Szkoła Podstawowa w Justynowie|Justynów|ul. Łódzka 17 |95-020 Andrespol;648;379;379;4;375;58.49;1.06
90169;100602;Szkoła Podstawowa w Justynowie|Justynów|ul. Łódzka 17 |95-020 Andrespol;649;383;383;2;381;59.01;0.52
90170;100602;Szkoła Podstawowa w Justynowie|Justynów|ul. Łódzka 17 |95-020 Andrespol;671;381;381;2;379;56.78;0.52
90171;100602;Świetlica Środowiskowa w Stróży|Stróża|ul. Tuszyńska 148 |95-020 Andrespol;814;509;509;10;499;62.53;1.96
90172;100602;Gimnazjum w Wiśniowej Górze|Wiśniowa Góra|ul. Tuszyńska 32 |95-020 Andrespol;922;510;510;11;499;55.31;2.16
90173;100602;Gminny Ośrodek Kultury w Wiśniowej Górze|Wiśniowa Góra|ul. Tuszyńska 64 |95-020 Andrespol;644;304;304;12;292;47.20;3.95
90174;100602;Hala Sportowa "GOSiR" w Wiśniowej Górze|Wiśniowa Góra|ul. Tuszyńska 113 |95-020 Andrespol;667;384;384;8;376;57.57;2.08
90175;100602;Dom Pomocy Społecznej w Wiśniowej Górze|Wiśniowa Góra|Tuszyńska 56 |95-020 Andrespol;71;39;39;2;37;54.93;5.13
90176;100603;Zespół Szkół w Kurowicach Filia Szkoły Podstawowej w Kurowicach z/s w Woli Rakowej|Wola Rakowa|Szkolna 3 |95-006 Brójce;1038;608;608;13;595;58.57;2.14
90177;100603;Zespół Szkół w Kurowicach Filia Szkoły Podstawowej w Kurowicach z/s w Woli Rakowej|Wola Rakowa|Szkolna 3 |95-006 Brójce;949;488;488;12;476;51.42;2.46
90178;100603;Zespół Szkół w Kurowicach Szkoła Podstawowa im.Orła Białego w Kurowicach|Kurowice|Szkolna 1 |95-006 Brójce;1377;758;758;22;736;55.05;2.90
90179;100603;Zespół Szkolno-Przedszkolny w Bukowcu|Bukowiec|Szkolna 3 |95-006 Brójce;674;374;374;4;370;55.49;1.07
90180;100603;Zespół Szkolno-Przedszkolny w Bukowcu|Bukowiec|Szkolna 3 |95-006 Brójce;1005;662;662;8;654;65.87;1.21
90181;100603;Ośrodek Rehabilitacyjno-Leczniczy Sosnowa Aleja Sp. z o.o. w Wardzynie|Wardzyn| 97 |95-006 Brójce;78;21;21;3;18;26.92;14.29
90182;100607;Przedszkole Nr 1 w Koluszkach|Koluszki|ul. Budowlanych 4A |95-040 Koluszki;1699;827;827;25;802;48.68;3.02
90183;100607;Szkoła Podstawowa Nr 2 im. Marii Konopnickiej w Koluszkach|Koluszki|ul. Kościuszki 16 |95-040 Koluszki;1671;1011;1011;23;988;60.50;2.27
90184;100607;Miejska Biblioteka Publiczna im. W. Strzemińskiego w Koluszkach|Koluszki|ul. 11 Listopada 33 |95-040 Koluszki;864;541;541;5;536;62.62;0.92
90185;100607;Ochotnicza Straż Pożarna w Koluszkach|Koluszki|ul. 11 Listopada 39 |95-040 Koluszki;1078;623;623;17;606;57.79;2.73
90186;100607;Przedszkole Nr 2 w Koluszkach|Koluszki|ul. Reja 5 |95-040 Koluszki;993;483;483;11;472;48.64;2.28
90187;100607;Gimnazjum Nr 2 im. Prymasa Tysiąclecia Stefana Kardynała Wyszyńskiego w Koluszkach|Koluszki|ul. Mickiewicza 8 |95-040 Koluszki;1122;655;655;15;640;58.38;2.29
90188;100607;Miejsko-Gminny Ośrodek Pomocy Społecznej w Koluszkach ( stara siedziba Urzędu Miejskiego) wejście od ul. Wigury|Koluszki|ul. Brzezińska 32 |95-040 Koluszki;1194;621;621;18;603;52.01;2.90
90189;100607;Szkoła Podstawowa Nr 1 im. Tadeusza Kościuszki w Koluszkach|Koluszki|ul. Zagajnikowa 12 |95-040 Koluszki;861;497;497;8;489;57.72;1.61
90190;100607;Szkoła Podstawowa nr 1 im. Tadeusza Kościuszki w Koluszkach|Koluszki|ul. Zagajnikowa 12 |95-040 Koluszki;1016;545;545;6;539;53.64;1.10
90191;100607;Gimnazjum nr 2 im. Prymasa Tysiąclecia Stefana Kardynała Wyszyńskiego w Koluszkach|Koluszki|ul. Mickiewicza 8 |95-040 Koluszki;231;147;147;2;145;63.64;1.36
90192;100607;Przedszkole w Różycy|Różyca|ul. Piotrkowska 11A |95-040 Koluszki;718;388;388;6;382;54.04;1.55
90193;100607;Szkoła Podstawowa im. Juliana Tuwima w Różycy|Różyca|ul. Piotrkowska 11 |95-040 Koluszki;970;565;565;12;553;58.25;2.12
90194;100607;Zespół Szkół w Gałkowie Dużym|Gałków Duży|ul. Dzieci Polskich 14 |95-041 Gałków Duży;802;456;456;9;447;56.86;1.97
90195;100607;Zespół Szkół w Gałkowie Dużym|Gałków Duży|ul. Dzieci Polskich 14 |95-041 Gałków Duży;825;460;460;10;450;55.76;2.17
90196;100607;Zespół Szkół w Gałkowie Dużym|Gałków Duży|ul. Dzieci Polskich 14 |95-041 Gałków Duży;673;418;418;12;406;62.11;2.87
90197;100607;Ochotnicza Straż Pożarna w Borowej|Borowa|ul. Długa 166 |95-041 Gałków Duży;772;408;408;1;407;52.85;0.25
90198;100607;Szkoła Podstawowa im. Jana Brzechwy w Będzelinie|Będzelin|ul. Szkolna 10 |95-040 Koluszki;320;148;148;8;140;46.25;5.41
90199;100607;Szkoła Podstawowa im. Juliana Tuwima w Różycy|Różyca|ul. Piotrkowska 11 |95-040 Koluszki;446;237;237;6;231;53.14;2.53
90200;100607;PKP Energetyka S.A.w Słotwinach|Słotwiny| |95-040 Koluszki;803;350;350;14;336;43.59;4.00
90201;100607;Świetlica w Regnach|Regny|ul. Główna 22 |95-040 Koluszki;307;168;168;3;165;54.72;1.79
90202;100607;Szkoła Podstawowa im. Kornela Makuszyńskiego w Długiem|Długie| 4 |95-040 Koluszki;440;221;221;3;218;50.23;1.36
90203;100607;Ochotnicza Straż Pożarna w Wierzchach|Wierzchy| 53 |95-040 Koluszki;259;133;133;10;123;51.35;7.52
90204;100607;Świetlica w Felicjanowie|Felicjanów| 1A |95-040 Koluszki;822;415;415;16;399;50.49;3.86
90205;100607;Dom Pomocy Społecznej w Lisowicach (odrębny obwód głosowania)|Lisowice| 13 |95-040 Koluszki;37;31;31;1;30;83.78;3.23
90206;100608;świetlica wiejska|Kalonka| 47 |92-701 Łódź;718;507;507;9;498;70.61;1.78
90207;100608;świetlica środowiskowa|Kalonka| 47 |92-701 Łódź;654;460;460;8;452;70.34;1.74
90208;100608;Gminno-Parkowe Centrum Kultury i Ekologii|Plichtów| 21 |92-701 Łódź;1010;565;565;10;555;55.94;1.77
90209;100608;Szkoła Podstawowa|Lipiny| 14 |92-701 Łódź;561;341;341;11;330;60.78;3.23
90210;100608;Szkoła Podstawowa|Stare Skoszewy| 19 |92-701 Łódź;438;277;277;7;270;63.24;2.53
90211;100608;Gimnazjum Gminne|Wiączyń Dolny| 18A |92-701 Łódź;314;170;170;2;168;54.14;1.18
90212;100610;Gimnazjum im. Kazimierza Jagiellończyka w Rzgowie|Rzgów|ul. Szkolna 3 |95-030 Rzgów;1764;1019;1019;30;989;57.77;2.94
90213;100610;Gimnazjum im. Kazimierza Jagiellończyka w Rzgowie|Rzgów|ul. Szkolna 3 |95-030 Rzgów;979;607;607;11;596;62.00;1.81
90214;100610;Ochotnicza Straż Pożarna w Starej Gadce|Stara Gadka|ul. Lucerniana 41 a |95-030 Rzgów;595;371;371;11;360;62.35;2.96
90215;100610;Ochotnicza Straż Pożarna w Starowej Górze|Starowa Góra|ul. Kuchenna 2 |95-030 Rzgów;1786;1111;1111;11;1100;62.21;0.99
90216;100610;Szkoła Podstawowa im. Kornela Makuszyńskiego w Guzewie|Guzew|ul. Edukacyjna 6 |95-030 Rzgów;1068;633;633;15;618;59.27;2.37
90217;100610;Szkoła Podstawowa im. Św. Królowej Jadwigi w Kalinie|Tadzin| 24 |95-030 Rzgów;1130;617;617;22;595;54.60;3.57
90218;100610;Ochotnicza Straż Pożarna|Grodzisko| 47 a |95-030 Rzgów;460;269;269;6;263;58.48;2.23
90219;100611;Gimnazjum Nr 1 w Tuszynie|Tuszyn|ul.Piotrkowska 13 |95-080 Tuszyn;432;243;243;4;239;56.25;1.65
90220;100611;Oddział Przedszkola Miejskiego Nr 1 w Tuszynie|Tuszyn|ul. Szpitalna 4 |95-080 Tuszyn;412;209;209;8;201;50.73;3.83
90221;100611;Miejski Ośrodek Kultury w Tuszynie|Tuszyn|ul.Noworzgowska 20A |95-080 Tuszyn;789;415;415;13;402;52.60;3.13
90222;100611;Miejski Ośrodek Kultury w Tuszynie|Tuszyn|ul. Noworzgowska 20A |95-080 Tuszyn;717;367;367;6;361;51.19;1.63
90223;100611;Szkoła Podstawowa Nr 1 w Tuszynie|Tuszyn|ul. Piotrkowska 15 |95-080 Tuszyn;686;366;366;8;358;53.35;2.19
90224;100611;Przedszkole Miejskie Nr 2 w Tuszynie|Tuszyn|ul. Sienkiewicza 8 |95-080 Tuszyn;773;344;344;12;332;44.50;3.49
90225;100611;Gimnazjum Nr 2 w Tuszynie|Tuszyn|ul. Poniatowskiego 11 |95-080 Tuszyn;733;369;369;9;360;50.34;2.44
90226;100611;Filia Miejskiego Ośrodka Kultury w Tuszynie|Tuszyn|ul. Prusa 7 |95-080 Tuszyn;720;359;359;4;355;49.86;1.11
90227;100611;Szkoła Podstawowa Nr 2 w Tuszynie|Tuszyn|ul. Poniatowskiego 11 |95-080 Tuszyn;675;338;338;8;330;50.07;2.37
90228;100611;Przedszkole Miejskie Nr 1 w Tuszynie|Tuszyn|ul. Tysiąclecia 4 |95-080 Tuszyn;537;226;226;4;222;42.09;1.77
90229;100611;Hala Widowiskowo-Sportowa w Tuszynie|Tuszyn|ul. Tysiąclecia 8 |95-080 Tuszyn;452;253;253;6;247;55.97;2.37
90230;100611;Oddział Przedszkola Miejskiego Nr 2 w Garbowie|Garbów|ul. Kruszowska 13 |95-080 Tuszyn;344;163;163;5;158;47.38;3.07
90231;100611;Oddział Przedszkola Miejskiego Nr 2 w Garbowie|Garbów|ul. Kruszowska 13 |95-080 Tuszyn;671;266;266;4;262;39.64;1.50
90232;100611;Szkoła Podstawowa w Wodzinie Prywatnym|Wodzin Prywatny|ul. Szkolna 1 |95-080 Tuszyn;630;281;281;6;275;44.60;2.14
90233;100611;Szkoła Podstawowa w Górkach Dużych|Górki Duże|ul. Jutroszewska 17 |95-080 Tuszyn;585;271;271;1;270;46.32;0.37
90234;100611;Oddział Przedszkola Miejskiego Nr 1 w Tuszynie|Tuszyn|ul. Szpitalna 4 |95-080 Tuszyn;750;412;412;5;407;54.93;1.21
90235;100611;Pawilon "D" szpitala Tuszyn|Tuszyn|Szpitalna 5 |95-080 Tuszyn;188;84;84;1;83;44.68;1.19
90236;100701;Świetlica Wiejska|Białaczów|ul. Piotrkowska 6 |26-307 Białaczów;969;423;423;14;409;43.65;3.31
90237;100701;Szkoła Podstawowa|Białaczów|ul. Szkolna 36 |26-307 Białaczów;666;227;227;7;220;34.08;3.08
90238;100701;Szkoła Podstawowa|Petrykozy| 1 |26-307 Białaczów;913;428;428;16;412;46.88;3.74
90239;100701;Szkoła Podstawowa|Skronina| 156 |26-307 Białaczów;960;354;354;18;336;36.88;5.08
90240;100701;Szkoła Podstawowa|Miedzna Drewniana| 259 |26-307 Białaczów;1235;606;606;16;590;49.07;2.64
90241;100702;Szkoła Podstawowa w Drzewicy|Drzewica|ul. Stanisława Staszica 7 |26-340 Drzewica;1185;583;583;18;565;49.20;3.09
90242;100702;Przedszkole Samorządowe w Drzewicy|Drzewica|ul. Stawowa 58 |26-340 Drzewica;725;389;389;6;383;53.66;1.54
90243;100702;Remiza OSP w Drzewicy|Drzewica|Plac Gabriela Narutowicza 17 |26-340 Drzewica;1292;684;684;23;661;52.94;3.36
90244;100702;Szkoła Podstawowa w Domasznie|Domaszno| 31 |26-340 Drzewica;449;238;238;8;230;53.01;3.36
90245;100702;Świetlica Wiejska w Zakościelu|Zakościele| 86A |26-340 Drzewica;706;362;362;14;348;51.27;3.87
90246;100702;Szkoła Podstawowa w Brzustowcu|Brzustowiec| 152 |26-340 Drzewica;618;305;305;5;300;49.35;1.64
90247;100702;Szkoła Podstawowa w Idzikowicach|Idzikowice| 30b |26-340 Drzewica;519;249;249;10;239;47.98;4.02
90248;100702;Świetlica Wiejska w Strzyżowie|Strzyżów| 61 |26-340 Drzewica;578;327;327;11;316;56.57;3.36
90249;100702;Szkoła Podstawowa w Radzicach Dużych|Radzice Duże| 169 |26-340 Drzewica;1048;472;472;20;452;45.04;4.24
90250;100702;Świetlica Wiejska w Dąbrówce|Dąbrówka| 68 |26-340 Drzewica;679;333;333;8;325;49.04;2.40
90251;100702;Szkoła Filialna w Jelni|Jelnia| 98 |26-340 Drzewica;525;259;259;4;255;49.33;1.54
90252;100702;Remiza OSP w Krzczonowie|Krzczonów| 13a |26-340 Drzewica;450;270;270;24;246;60.00;8.89
90253;100702;Dom Pomocy Społecznej w Drzewicy|Drzewica|Stawowa 21/25 |26-340 Drzewica;68;44;44;2;42;64.71;4.55
90254;100703;Gimnazjum Publiczne|Mniszków|ul. Piotrkowska 72 |26-341 Mniszków;1506;774;774;22;752;51.39;2.84
90255;100703;Świetlica Wiejska|Strzelce| 42 |26-341 Mniszków;475;228;228;7;221;48.00;3.07
90256;100703;Szkoła Podstawowa|Błogie Rządowe| 39 |26-341 Mniszków;1078;514;514;29;485;47.68;5.64
90257;100703;Szkoła Podstawowa|Bukowiec nad Pilicą| 34 |26-341 Mniszków;739;305;305;20;285;41.27;6.56
90258;100704;Szkoła Podstawowa w Kraśnicy|Kraśnica| 58 |26-300 Opoczno;973;433;433;14;419;44.50;3.23
90259;100704;Szkoła Podstawowa w Kruszewcu|Kruszewiec| 7 |26-300 Opoczno;464;247;247;12;235;53.23;4.86
90260;100704;Szkoła Podstawowa w Libiszowie|Libiszów| 64 |26-300 Opoczno;981;466;466;27;439;47.50;5.79
90261;100704;Szkoła Podstawowa w Januszewicach|Januszewice| 67 |26-300 Opoczno;593;343;343;6;337;57.84;1.75
90262;100704;Zespół Szkół w Bukowcu Opoczyńskim|Bukowiec Opoczyński| 74 |26-300 Opoczno;874;419;419;15;404;47.94;3.58
90263;100704;Szkoła Podstawowa w Woli Załężnej|Wola Załężna| 75 |26-300 Opoczno;801;454;454;17;437;56.68;3.74
90264;100704;Szkoła Podstawowa w Dzielnej|Dzielna| 64a |26-300 Opoczno;777;429;429;11;418;55.21;2.56
90265;100704;Gimnazjum w Wygnanowie|Wygnanów| 57 |26-300 Opoczno;455;206;206;7;199;45.27;3.40
90266;100704;Szkoła Podstawowa w Bielowicach|Bielowice| 56 |26-300 Opoczno;797;414;414;15;399;51.94;3.62
90267;100704;Zespół Szkół w Mroczkowie Gościnnym|Mroczków Gościnny| 50 |26-300 Opoczno;1030;512;512;12;500;49.71;2.34
90268;100704;Zespół Szkół w Ogonowicach|Ogonowice| 207A |26-300 Opoczno;1549;905;905;26;879;58.42;2.87
90269;100704;Szkoła Podstawowa w Sielcu|Sielec| 40 |26-300 Opoczno;922;425;425;12;413;46.10;2.82
90270;100704;Zespół Szkół Samorządowych Nr 3 w Opocznie|Opoczno|ul. Armii Krajowej 1 |26-300 Opoczno;1287;673;673;15;658;52.29;2.23
90271;100704;Przedszkole Nr 2 w Opocznie|Opoczno|ul. Szkolna 11 |26-300 Opoczno;1380;771;771;22;749;55.87;2.85
90272;100704;Zespół Szkół Ponadgimnazjalnych Nr 1 w Opocznie|Opoczno|ul. Kossaka 1 |26-300 Opoczno;1480;818;818;15;803;55.27;1.83
90273;100704;Zespół Szkół Samorządowych Nr 3 w Opocznie|Opoczno|ul. Armii Krajowej 1 |26-300 Opoczno;1287;753;753;11;742;58.51;1.46
90274;100704;Przedszkole Nr 8 w Opocznie|Opoczno|ul. Kopernika 10a |26-300 Opoczno;1409;761;761;16;745;54.01;2.10
90275;100704;Przedszkole Nr 6 w Opocznie|Opoczno|ul. M. Kopernika 3 |26-300 Opoczno;1385;759;759;25;734;54.80;3.29
90276;100704;Państwowa Straż Pożarna w Opocznie|Opoczno|ul. Rolna 1 |26-300 Opoczno;1407;831;831;22;809;59.06;2.65
90277;100704;Przedszkole Nr 5 w Opocznie|Opoczno|ul. Partyzantów 36 |26-300 Opoczno;1392;778;778;20;758;55.89;2.57
90278;100704;Zespół Szkół Samorządowych Nr 1 w Opocznie|Opoczno|ul. Skłodowskiej-Curie 5 |26-300 Opoczno;1277;663;663;24;639;51.92;3.62
90279;100704;Zespół Szkół Samorządowych Nr 2 w Opocznie|Opoczno|ul. Inowłodzka 3 |26-300 Opoczno;1571;835;835;20;815;53.15;2.40
90280;100704;Przedszkole Nr 4 w Opocznie|Opoczno|ul. C. K. Norwida 2 |26-300 Opoczno;1388;668;668;20;648;48.13;2.99
90281;100704;Ochotnicza Straż Pożarna w Opocznie|Opoczno|Pl. Strażacki 1 |26-300 Opoczno;1205;481;481;19;462;39.92;3.95
90282;100704;OPTEX S.A. w Opocznie|Opoczno|ul. Kolberga 2 |26-300 Opoczno;1210;678;678;18;660;56.03;2.65
90283;100704;Szpital Powiatowy w Opocznie|Opoczno|ul. Partyzantów 30 |26-300 Opoczno;72;18;18;0;18;25.00;0.00
90284;100705;Szkoła Podstawowa w Wójcinie|Wójcin A| 16 |26-333 Paradyż;900;475;475;15;460;52.78;3.16
90285;100705;Urząd Gminy w Paradyżu|Paradyż|Konecka 4 |26-333 Paradyż;1098;621;621;22;599;56.56;3.54
90286;100705;Budynek Zespołu Szkół Samorządowych w Paradyżu|Paradyż|Przedborska 29 |26-333 Paradyż;953;511;511;23;488;53.62;4.50
90287;100705;Budynek świetlicy wiejskiej w Stawowicach|Stawowice| 39 |26-333 Paradyż;586;291;291;21;270;49.66;7.22
90288;100706;Zespół Szkół Samorządowych w Poświętnem|Poświętne|ul. Szkolna 2a |26-315 Poświętne;1110;538;538;19;519;48.47;3.53
90289;100706;Świetlica wiejska w Dębie|Dęba| 143 |26-315 Poświętne;721;417;417;13;404;57.84;3.12
90290;100706;Szkoła Podstawowa w Brudzewicach|Brudzewice-Kolonia| 59 |26-315 Poświętne;640;297;297;5;292;46.41;1.68
90291;100706;Remiza OSP Gapinin|Gapinin-Kolonia| 24a |26-315 Poświętne;329;156;156;6;150;47.42;3.85
90292;100707;Urząd Gminy w Sławnie|Sławno|ul. Marszałka Józefa Piłsudskiego 31 |26-332 Sławno;890;393;393;9;384;44.16;2.29
90293;100707;Publiczna Szkoła Podstawowa w Celestynowie|Celestynów| 24 |26-332 Sławno;345;163;163;5;158;47.25;3.07
90294;100707;Publiczna Szkoła Podstawowa im. ks. Jana Twardowskiego w Kamieniu|Kamień| 64 |26-332 Sławno;850;361;361;11;350;42.47;3.05
90295;100707;Publiczne Gimnazjum im. Kazimierza Wielkiego w Szadkowicach|Szadkowice| 38A |26-332 Sławno;793;403;403;13;390;50.82;3.23
90296;100707;Publiczna Szkoła Podstawowa im. Wandy i Henryka Ossowskich w Kunicach|Kunice| 62A |26-332 Sławno;837;434;434;13;421;51.85;3.00
90297;100707;Publiczna Szkoła Podstawowa w Zachorzowie|Zachorzów| 62 |26-332 Sławno;744;393;393;10;383;52.82;2.54
90298;100707;Zespół Szkół Samorządowych w Prymusowej Woli|Prymusowa Wola| 6 |26-332 Sławno;711;386;386;12;374;54.29;3.11
90299;100707;Ochotnicza Straż Pożarna w Sławnie|Sławno|Marszałka Józefa Piłsudskiego 1 |26-332 Sławno;778;397;397;14;383;51.03;3.53
90300;100708;Szkoła Podstawowa im. Juliana Bartoszewicza w Żarnowie|Żarnów|ul. Przedborska 10 |26-330 Żarnów;659;314;314;9;305;47.65;2.87
90301;100708;Gimnazjum im. 25 pułku piechoty Armii Krajowej w Żarnowie|Żarnów|ul. Polna 1 |26-330 Żarnów;652;340;340;13;327;52.15;3.82
90302;100708;Dom Kultury w Żarnowie|Żarnów|ul. Opoczyńska 5 |26-330 Żarnów;640;326;326;4;322;50.94;1.23
90303;100708;Remiza Ochotniczej Straży Pożarnej w Chełstach|Chełsty| 39 |26-330 Żarnów;366;154;154;3;151;42.08;1.95
90304;100708;Gminna Biblioteka Publiczna w Żarnowie Filia w Skórkowicach|Skórkowice|ul. Przedborska 26 |26-330 Żarnów;773;321;321;15;306;41.53;4.67
90305;100708;Dom Ludowy w Soczówkach|Soczówki| 71A |26-330 Żarnów;560;218;218;14;204;38.93;6.42
90306;100708;Wiejski Dom Kultury w Miedznej Murowanej|Miedzna Murowana|ul. Główna 2 |26-330 Żarnów;777;340;340;9;331;43.76;2.65
90307;100708;Remiza Ochotniczej Straży Pożarnej w Zdyszewicach|Zdyszewice| 43A |26-330 Żarnów;598;243;243;10;233;40.64;4.12
90308;100708;Dom Pomocy Społecznej w Niemojowicach|Niemojowice| 68 |26-330 Żarnów;83;61;61;4;57;73.49;6.56
90309;100801;Szkoła Podstawowa nr 1 w Konstantynowie Łódzkim|Konstantynów Łódzki|ul. Łódzka 117 |95-050 Konstantynów Łódzki;1020;649;649;13;636;63.63;2.00
90310;100801;Liceum Ogólnokształcące w Konstantynowie Łódzkim|Konstantynów Łódzki|ul. Jana Kilińskiego 75 |95-050 Konstantynów Łódzki;920;523;523;14;509;56.85;2.68
90311;100801;Gimnazjum nr 1 w Konstantynowie Łódzkim|Konstantynów Łódzki|ul. Łódzka 5/7 |95-050 Konstantynów Łódzki;1991;1058;1058;17;1041;53.14;1.61
90312;100801;Szkoła Podstawowa nr 5 w Konstantynowie Łódzkim|Konstantynów Łódzki|ul. Sadowa 5/7 |95-050 Konstantynów Łódzki;1870;1031;1031;25;1006;55.13;2.42
90313;100801;Miejski Ośrodek Kultury w Konstantynowie Łódzkim|Konstantynów Łódzki|ul. Łódzka 28 |95-050 Konstantynów Łódzki;942;518;518;14;504;54.99;2.70
90314;100801;Konstantynowskie Centrum Pomocy Rodzinie w Konstantynowie Łódzkim|Konstantynów Łódzki|ul. Juliusza Słowackiego 11 |95-050 Konstantynów Łódzki;1958;1118;1118;29;1089;57.10;2.59
90315;100801;Przedszkole nr 1 w Konstantynowie Łódzkim|Konstantynów Łódzki|ul. Ignacego Daszyńskiego 3/5 |95-050 Konstantynów Łódzki;1857;857;857;31;826;46.15;3.62
90316;100801;Konstantynowskie Stowarzyszenie Śpiewaczo-Muzyczne im. Fryderyka Chopina w Konstantynowie Łódzkim|Konstantynów Łódzki|ul. Zgierska 14 |95-050 Konstantynów Łódzki;1900;1029;1030;24;1005;54.16;2.33
90317;100801;Ochotnicza Straż Pożarna Niesięcin w Konstantynowie Łódzkim|Konstantynów Łódzki|ul. Niesięcin 3 |95-050 Konstantynów Łódzki;507;263;263;2;261;51.87;0.76
90318;100801;Szkoła Podstawowa nr 2 w Konstantynowie Łódzkim|Konstantynów Łódzki|ul. Lutomierska 4 |95-050 Konstantynów Łódzki;398;255;255;4;251;64.07;1.57
90319;100801;Szkoła Podstawowa Nr 2 w Konstantynowie Łódzkim|Konstantynów Łódzki|ul. Lutomierska 4 |95-050 Konstantynów Łódzki;1012;560;560;7;553;55.34;1.25
90320;100801;Dom Pomocy Społecznej w Konstantynowie Łódzkim|Konstantynów Łódzki|ul. Bechcice 3 |95-050 Konstantynów Łódzki;91;20;20;0;20;21.98;0.00
90321;100801;Zakład Opieki Zdrowotnej MEDIPLAN w Konstantynowie Łódzkim|Konstantynów Łódzki|ul. Lutomierska 26-30A |95-050 Konstantynów Łódzki;58;10;10;1;9;17.24;10.00
90322;100801;Dom Seniora "Wśród Swoich" w Konstantynowie Łódzkim|Konstantynów Łódzki|ul. Łódzka 27/29 |95-050 Konstantynów Łódzki;16;13;13;1;12;81.25;7.69
90323;100802;Gminna Spółdzielnia "Samopomoc Chłopska"|Pabianice|ul. Torowa 25 |95-200 Pabianice;1292;801;801;16;785;62.00;2.00
90324;100802;Gminna Spółdzielnia "Samopomoc Chłopska"|Pabianice|ul. Torowa 25 |95-200 Pabianice;1194;723;723;8;715;60.55;1.11
90325;100802;Szkoła Podstawowa nr 5 im. Grzegorza Piramowicza|Pabianice|ul. Zamkowa (wejście od ul. Poniatowskiego 4) 65 |95-200 Pabianice;1273;678;679;15;663;53.26;2.21
90326;100802;Ośrodek Profilaktyki i Integracji Społecznej|Pabianice|ul. Partyzancka 31 |95-200 Pabianice;1056;466;466;15;451;44.13;3.22
90327;100802;Młodzieżowy Dom Kultury|Pabianice|ul. Pułaskiego 38 |95-200 Pabianice;1161;512;512;15;497;44.10;2.93
90328;100802;Zespół Szkół nr 2 im. prof. Janusza Groszkowskiego|Pabianice|ul. Świętego Jana 27 |95-200 Pabianice;1136;476;476;9;467;41.90;1.89
90329;100802;Zespół Szkół nr 3 im. Legionistów Miasta Pabianic|Pabianice|ul. Gdańska 5 |95-200 Pabianice;1318;588;588;9;579;44.61;1.53
90330;100802;Przedszkole Miejskie nr 6|Pabianice|ul. Warszawska 53 |95-200 Pabianice;1011;588;588;15;573;58.16;2.55
90331;100802;Dom Pomocy Społecznej|Pabianice|ul. Łaska 86 |95-200 Pabianice;1342;772;772;19;753;57.53;2.46
90332;100802;Dom Pomocy Społecznej|Pabianice|ul. Wiejska 55/61 |95-200 Pabianice;996;631;631;13;618;63.35;2.06
90333;100802;Przedszkole Miejskie Nr 14|Pabianice|ul. Odrodzenia 10 |95-200 Pabianice;1349;730;730;13;717;54.11;1.78
90334;100802;I Liceum Ogólnokształcące im. Jędrzeja Śniadeckiego|Pabianice|ul. Moniuszki 132 |95-200 Pabianice;994;550;550;10;540;55.33;1.82
90335;100802;Szkoła Podstawowa nr 14 im. Stanisława Staszica|Pabianice|ul. Ostatnia 15a |95-200 Pabianice;965;578;578;11;567;59.90;1.90
90336;100802;Gimnazjum nr 1 im. Jana Pawła II|Pabianice|ul. Tkacka 15 |95-200 Pabianice;1356;819;819;9;810;60.40;1.10
90337;100802;Szkoła Podstawowa nr 5 im. Grzegorza Piramowicza|Pabianice|ul. Zamkowa 65 |95-200 Pabianice;990;478;478;11;467;48.28;2.30
90338;100802;Przedszkole Miejskie nr 5|Pabianice|ul. Zamkowa 48 |95-200 Pabianice;1333;686;686;20;666;51.46;2.92
90339;100802;Gimnazjum nr 2 im. Armii Krajowej|Pabianice|ul. Skłodowskiej-Curie 5 |95-200 Pabianice;1374;753;753;18;735;54.80;2.39
90340;100802;Gimnazjum nr 2 im. Armii Krajowej|Pabianice|ul. Skłodowskiej-Curie 5 |95-200 Pabianice;1025;498;498;15;483;48.59;3.01
90341;100802;Miejski Ośrodek Kultury im. Zbigniewa Herberta|Pabianice|ul. Kościuszki 14 |95-200 Pabianice;1074;362;362;11;351;33.71;3.04
90342;100802;Lokal Związku Nauczycielstwa Polskiego|Pabianice|ul. Kilińskiego 8a |95-200 Pabianice;1233;544;544;10;534;44.12;1.84
90343;100802;Żłobek Miejski - Oddział I|Pabianice|ul. Piotra Skargi 70 |95-200 Pabianice;1331;643;643;17;626;48.31;2.64
90344;100802;Szkoła Podstawowa nr 17|Pabianice|ul. Warszawska 65 |95-200 Pabianice;983;596;596;3;593;60.63;0.50
90345;100802;Szkoła Podstawowa nr 17|Pabianice|ul. Warszawska 65 |95-200 Pabianice;1024;554;556;8;546;54.10;1.44
90346;100802;Szkoła Podstawowa nr 3 im. Mikołaja Kopernika|Pabianice|ul. Mokra 28/34 |95-200 Pabianice;1331;758;758;9;749;56.95;1.19
90347;100802;Poradnia Lekarza POZ|Pabianice|ul. Wileńska 61 |95-200 Pabianice;1394;879;879;24;855;63.06;2.73
90348;100802;Przedszkole Miejskie nr 12|Pabianice|ul. Śniadeckiego 6a |95-200 Pabianice;977;564;564;13;551;57.73;2.30
90349;100802;Osiedlowy Dom Kultury Pabianickiej Spółdzielni Mieszkaniowej|Pabianice|ul. Orla 45 |95-200 Pabianice;1313;676;676;21;655;51.49;3.11
90350;100802;Przedszkole Miejskie nr 2|Pabianice|ul. Cicha 26 |95-200 Pabianice;1021;505;505;12;493;49.46;2.38
90351;100802;Szkoła Podstawowa nr 13 im. Stefanii Sempołowskiej|Pabianice|ul. Jana Pawła II 16 |95-200 Pabianice;1401;818;818;13;805;58.39;1.59
90352;100802;Szkoła Podstawowa nr 13 im. Stefanii Sempołowskiej|Pabianice|ul. Jana Pawła II 16 |95-200 Pabianice;902;384;384;11;373;42.57;2.86
90353;100802;Hala Sportowa Gimnazjum nr 2|Pabianice|ul. Orla 1 |95-200 Pabianice;838;512;512;9;503;61.10;1.76
90354;100802;Szkoła Podstawowa nr 3 im. Mikołaja Kopernika|Pabianice|ul. Mokra 28/34 |95-200 Pabianice;1578;905;906;13;892;57.35;1.44
90355;100802;Przedszkole Miejskie nr 16|Pabianice|ul. Bugaj 58 |95-200 Pabianice;1084;639;639;16;623;58.95;2.50
90356;100802;Przedszkole Miejskie nr 16|Pabianice|ul. Bugaj 58 |92-200 Pabianice;1218;693;693;9;684;56.90;1.30
90357;100802;Gimnazjum nr 3 im. Tadeusza Kościuszki|Pabianice|ul. 20 Stycznia 9/13 |95-200 Pabianice;922;535;536;8;527;58.03;1.50
90358;100802;Gimnazjum nr 3 im. Tadeusza Kościuszki|Pabianice|ul. 20 Stycznia 9/13 |95-200 Pabianice;1444;850;850;10;840;58.86;1.18
90359;100802;Gimnazjum nr 3 im. Tadeusza Kościuszki|Pabianice|ul. 20 Stycznia 9/13 |95-200 Pabianice;1373;744;744;13;731;54.19;1.75
90360;100802;Gimnazjum nr 3 im. Tadeusza Kościuszki|Pabianice|ul. 20 Stycznia 9/13 |95-200 Pabianice;987;596;596;9;587;60.39;1.51
90361;100802;Poradnia Lekarza POZ|Pabianice|ul. Nawrockiego 24a |95-200 Pabianice;1359;737;737;12;725;54.23;1.63
90362;100802;Szkoła Podstawowa nr 3 im. Mikołaja Kopernika|Pabianice|ul. Mokra 28/34 |95-200 Pabianice;1051;629;629;16;613;59.85;2.54
90363;100802;Przedszkole Miejskie nr 4|Pabianice|ul. Żytnia 13/17 |95-200 Pabianice;1242;720;720;8;712;57.97;1.11
90364;100802;Osiedlowy Dom Kultury BARAK Pabianickiej Spółdzielni Mieszkaniowej|Pabianice|ul. Stefana Grota Roweckiego 18a |95-200 Pabianice;1058;627;627;11;616;59.26;1.75
90365;100802;Szkoła Podstawowa nr 3 im. Mikołaja Kopernika|Pabianice|ul. Mokra 28/34 |95-200 Pabianice;1315;735;735;17;718;55.89;2.31
90366;100802;Szkoła Podstawowa nr 3 im. Mikołaja Kopernika|Pabianice|ul. Mokra 28/34 |95-200 Pabianice;1070;604;604;13;591;56.45;2.15
90367;100802;Przedszkole Miejskie nr 13|Pabianice|ul. Mokra 19/23 |95-200 Pabianice;1234;772;772;14;758;62.56;1.81
90368;100802;Przedszkole Miejskie nr 13|Pabianice|ul. Mokra 19/23 |95-200 Pabianice;1051;620;620;11;609;58.99;1.77
90369;100802;Pabianickie Centrum Medyczne|Pabianice|Jana Pawła II 68 |95-200 Pabianice;384;96;96;3;93;25.00;3.12
90370;100802;Dom Pomocy Społecznej|Pabianice|Wiejska 55/61 |95-200 Pabianice;109;32;32;6;26;29.36;18.75
90371;100802;Dom Pomocy Społecznej|Pabianice|Łaska 86 |95-200 Pabianice;60;8;8;0;8;13.33;0.00
90372;100803;Szkoła Podstawowa w Dłutowie|Dłutów|ul. Główna 9 |95-081 Dłutów;897;487;487;12;475;54.29;2.46
90373;100803;Szkoła Podstawowa w Dłutowie|Dłutów|ul. Główna 9 |95-081 Dłutów;824;393;393;12;381;47.69;3.05
90374;100803;Szkoła Podstawowa w Dłutowie|Dłutów|ul. Główna 9 |95-081 Dłutów;1069;609;609;18;591;56.97;2.96
90375;100803;Gimnazjum w Dłutowie|Dłutów|ul. Główna nr 9 |95-081 Dłutów;772;349;350;13;336;45.21;3.72
90376;100804;Szkoła Podstawowa w Chechle|Chechło Drugie|ul. Lipowa 1 |95-082 Dobroń;1595;944;944;15;929;59.18;1.59
90377;100804;Publiczne Gimnazjum im. ks. Jana Długosza|Dobroń|ul. W.Witosa 1a |95-082 Dobroń;859;446;446;18;428;51.92;4.04
90378;100804;Szkoła Podstawowa w Dobroniu|Dobroń|ul. Sienkiewicza 39 |95-082 Dobroń;818;478;478;14;464;58.44;2.93
90379;100804;Szkoła Podstawowa w Dobroniu|Dobroń|ul. Sienkiewicza 39 |95-082 Dobroń;1042;471;471;16;455;45.20;3.40
90380;100804;Strażnica OSP w Orpelowie|Orpelów| 20 |95-082 Dobroń;491;237;237;5;232;48.27;2.11
90381;100804;Szkoła Podstawowa w Mogilnie Dużym|Mogilno Duże| 21 |95-082 Dobroń;1158;649;649;17;632;56.04;2.62
90382;100805;Zespół Szkół Centrum Kształcenia Rolniczego w Widzewie|Widzew|ul. Szkolna 12 |95-054 Ksawerów;993;507;507;11;496;51.06;2.17
90383;100805;Gminny Dom Kultury z Biblioteką w Ksawerowie|Ksawerów|ul. Jana Pawła II 1 |95-054 Ksawerów;1310;776;776;11;765;59.24;1.42
90384;100805;Gimnazjum w Ksawerowie|Ksawerów|ul. Zachodnia 33 |95-054 Ksawerów;1437;808;808;19;789;56.23;2.35
90385;100805;Urząd Gminy Ksawerów|Ksawerów|ul. Kościuszki 3h |95-054 Ksawerów;922;535;535;6;529;58.03;1.12
90386;100805;Szkoła Podstawowa w Woli Zaradzyńskiej|Wola Zaradzyńska|ul. majora Hubala 55 |95-054 Ksawerów;882;535;535;6;529;60.66;1.12
90387;100805;Szkoła Powstawowa w Woli Zaradzyńskiej|Wola Zaradzyńska|ul. majora Hubala 55 |95-054 Ksawerów;583;315;315;8;307;54.03;2.54
90388;100805;JOVIMED Ośrodek Opiekuńczo-Rehabilitacyjny Sp. z o.o. w Ksawerowie|Ksawerów|Zachodnia 37 |95-054 ;29;11;11;0;11;37.93;0.00
90389;100806;Gminny Ośrodek Kultury w Lutomiersku|Lutomiersk|Pl. Jana Pawła II nr 13 |95-083 Lutomiersk;1262;705;705;36;669;55.86;5.11
90390;100806;Gimnazjum we Wrzącej|Wrząca|ul. Piłsudskiego nr 1 |95-083 Lutomiersk;1110;632;632;14;618;56.94;2.22
90391;100806;Gimnazjum we Wrzącej|Wrząca|ul. Piłsudskiego nr 1 |95-083 Lutomiersk;1178;610;610;16;594;51.78;2.62
90392;100806;Szkoła Podstawowa w Kazimierzu|Kazimierz|ul. Sienkiewicza nr 25 |95-083 Lutomiersk;659;329;329;10;319;49.92;3.04
90393;100806;Szkoła Podstawowa w Kazimierzu|Kazimierz|ul. Sienkiewicza nr 25 |95-083 Lutomiersk;846;405;405;5;400;47.87;1.23
90394;100806;Szkoła Podstawowa w Szydłowie|Szydłów| nr 1 |95-083 Lutomiersk;696;279;279;11;268;40.09;3.94
90395;100806;Ochotnicza Straż Pożarna w Puczniewie|Puczniew| nr 20 |95-083 Lutomiersk;635;218;218;11;207;34.33;5.05
90396;100806;Dom Pomocy Społecznej "Nad Strumykiem" w Legendzinie|Legendzin| nr 2 |95-083 Lutomiersk;38;6;6;0;6;15.79;0.00
90397;100807;Szkoła Podstawowa w Bychlewie|Bychlew| 13 |95-200 Pabianice;1290;808;808;14;794;62.64;1.73
90398;100807;Szkoła Podstawowa w Pawlikowicach|Pawlikowice| 103 |95-200 Pabianice;944;531;531;9;522;56.25;1.69
90399;100807;Szkoła Podstawowa w Petrykozach|Petrykozy| 52 |95-200 Pabianice;1311;726;726;18;708;55.38;2.48
90400;100807;Gimnazjum w Piątkowisku|Piątkowisko| 107 |95-200 Pabianice;1081;612;612;12;600;56.61;1.96
90401;100807;Zespół Szkolno-Przedszkolny Oddział w Żytowicach|Żytowice| 34 |95-200 Pabianice;648;339;339;10;329;52.31;2.95
90402;100901;Zespół Szkolno-Przedszkolny z siedzibą ul. Zamkowa 1|Działoszyn|ul. Zamkowa 1 |98-355 Działoszyn;2061;999;999;35;964;48.47;3.50
90403;100901;Szkoła Filialna w Szczytach z siedzibą w Szczytach|Szczyty|ul. Szkolna 2 |98-355 Działoszyn;658;326;326;7;319;49.54;2.15
90404;100901;Zespół Szkolno-Przedszkolny w Raciszynie z siedzibą w Raciszynie|Raciszyn|ul. Działoszyńska 65 |98-355 Działoszyn;1058;409;409;24;385;38.66;5.87
90405;100901;Zespół Szkół w Trębaczewie z siedzibą w Trębaczewie|Trębaczew|ul. Szkolna 5 |98-355 Działoszyn;2270;1001;1001;34;967;44.10;3.40
90406;100901;Szkoła Filialna w Kolonii Lisowice z siedzibą w Kolonii Lisowice|Kolonia Lisowice| 85 |98-355 Działoszyn;786;317;317;16;301;40.33;5.05
90407;100901;Zespół Szkolno-Przedszkolny w Działoszynie z siedzibą ul. Szkolna 4|Działoszyn|ul. Szkolna 4 |98-355 Działoszyn;1511;836;837;16;820;55.33;1.91
90408;100901;Zespół Szkolno-Przedszkolny w Działoszynie z siedzibą ul. Szkolna 4|Działoszyn|ul. Szkolna 4 |98-355 Działoszyn;1875;868;868;28;840;46.29;3.23
90409;100901;Dom Pomocy Społecznej w Bobrownikach|Bobrowniki| 50 |98-355 Działoszyn;24;20;20;1;19;83.33;5.00
90410;100902;Szkoła Podstawowa w Kiełczygłowie|Kiełczygłów|Tysiąclecia 8 |98-358 Kiełczygłów;2032;946;946;21;925;46.56;2.22
90411;100902;Budynek OSP|Huta| 1a |98-358 Kiełczygłów;584;242;242;4;238;41.44;1.65
90412;100902;Szkoła Podstawowa w Chorzewie|Chorzew| 4 |98-358 Kiełczygłów;864;419;419;21;398;48.50;5.01
90413;100903;Gimnazjum|Nowa Brzeźnica|Kościuszki 100 |98-331 Nowa Brzeźnica;1496;694;694;23;671;46.39;3.31
90414;100903;Szkoła Podstawowa Nowa Brzeźnica Filia Dworszowice Kościelne Kolonia|Dworszowice Kościelne Kolonia| 74 |98-331 Nowa Brzeźnica;684;295;295;17;278;43.13;5.76
90415;100903;Szkoła Podstawowa Nowa Brzeźnica Filia Prusicko|Prusicko| 101 |98-331 Nowa Brzeźnica;957;308;308;11;297;32.18;3.57
90416;100903;Szkoła Podstawowa Nowa Brzeźnica Filia Dubidze|Dubidze|Szkolna 16 |98-331 Nowa Brzeźnica;758;363;363;27;336;47.89;7.44
90417;100904;Szkoła Podstawowa w Pajęcznie|Pajęczno|Wiśniowa 7 |98-330 Pajęczno;1399;670;670;19;651;47.89;2.84
90418;100904;Urząd Gminy i Miasta w Pajęcznie|Pajęczno|Parkowa 8/12 |98-330 Pajęczno;2007;937;937;27;910;46.69;2.88
90419;100904;Szkoła Podstawowa w Makowiskach|Makowiska|Szkolna 1 |98-330 Pajęczno;2059;815;815;48;767;39.58;5.89
90420;100904;Publiczne Gimnazjum w Pajęcznie|Pajęczno|Sienkiewicza 7 11|98-330 Pajęczno;2100;993;993;18;975;47.29;1.81
90421;100904;Biblioteka Publiczna w Pajęcznie|Pajęczno|Wiśniowa 5 |98-330 Pajęczno;2022;974;974;25;949;48.17;2.57
90422;100904;Szpital Rejonowy w Pajęcznie|Pajęczno|1 Maja 13/15 |98-330 Pajęczno;52;10;10;1;9;19.23;10.00
90423;100905;Urząd Gminy w Rząśni|Rząśnia|Kościuszki 16 |98-332 Rząśnia;1554;778;778;31;747;50.06;3.98
90424;100905;Szkoła Podstawowa w Białej|Biała| 63 |98-332 Rząśnia;750;329;329;10;319;43.87;3.04
90425;100905;Remiza Strażacka w Broszęcinie|Broszęcin| 22A |98-332 Rząśnia;371;196;196;8;188;52.83;4.08
90426;100905;Szkoła Podstawowa w Stróży|Stróża| 41 |98-332 Rząśnia;350;203;203;2;201;58.00;0.99
90427;100905;Remiza Ochotniczej Straży Pożarnej w Suchowoli|Suchowola| 32 |98-332 Rząśnia;877;362;362;13;349;41.28;3.59
90428;100906;Szkoła Podstawowa w Siemkowicach|Siemkowice|Nowa 1 |98-354 Siemkowice;1030;495;495;28;467;48.06;5.66
90429;100906;Szkoła Podstawowa w Radoszewicach|Radoszewice|Niemojewskich 1b |98-354 Siemkowice;1199;537;537;30;507;44.79;5.59
90430;100906;Szkoła Podstawowa w Lipniku|Kolonia Lipnik| 11 |98-354 Siemkowice;1010;485;485;24;461;48.02;4.95
90431;100906;Szkoła Podstawowa w Ożegowie|Ożegów|Szkolna 19 |98-354 Siemkowice;750;306;306;12;294;40.80;3.92
90432;100907;Sala Posiedzeń Urzędu Gminy|Strzelce Wielkie|Częstochowska 14 |98-337 Strzelce Wielkie;1812;850;850;28;822;46.91;3.29
90433;100907;Wiewiec Szkoła Podstawowa|Wiewiec| 26 |98-337 Strzelce Wielkie;1270;475;475;23;452;37.40;4.84
90434;100907;Wistka budynek Ochotniczej Straży Pożarnej|Wistka| 126 |98-337 Strzelce Wielkie;777;363;363;8;355;46.72;2.20
90435;100908;Zespół Szkolno-Przedszkolny w Bogumiłowicach|Bogumiłowice| 85 |98-338 Sulmierzyce;832;408;408;12;396;49.04;2.94
90436;100908;Szkoła Podstawowa w Dworszowicach Pakoszowych|Dworszowice Pakoszowe| 5 |98-338 Sulmierzyce;496;225;225;10;215;45.36;4.44
90437;100908;Urząd Gminy w Sulmierzycach|Sulmierzyce|Urzędowa 1 |98-338 Sulmierzyce;878;468;468;18;450;53.30;3.85
90438;100908;Gminna Biblioteka Publiczna im. Filipa Sulimierskiego w Sulmierzycach|Sulmierzyce|Słoneczna 5 |98-338 Sulmierzyce;958;590;590;25;565;61.59;4.24
90439;100908;Świetlica Wiejska w Chorzenicach|Chorzenice| 107 |98-338 Sulmierzyce;536;270;270;14;256;50.37;5.19
90440;101001;Szkoła Podstawowa w Aleksandrowie|Aleksandrów| 40 |26-337 Aleksandrów;1106;483;483;20;463;43.67;4.14
90441;101001;Szkoła Podstawowa w Dąbrowie nad Czarną|Dąbrowa nad Czarną| 60 |26-337 Aleksandrów;992;457;457;9;448;46.07;1.97
90442;101001;Budynek po byłej Szkole Podstawowej w Dąbrówce|Dąbrówka| 59 |26-337 Aleksandrów;507;260;260;8;252;51.28;3.08
90443;101001;Świetlica Wiejska w Ciechominie|Ciechomin| 46A |26-337 Aleksandrów;527;229;229;8;221;43.45;3.49
90444;101001;Szkoła Podstawowa w Skotnikach|Skotniki| 4 |26-337 Aleksandrów;610;311;311;10;301;50.98;3.22
90445;101002;Zespół Szkolno-Gimnazjalny w Czarnocinie|Czarnocin|ul. Główna 134 |97-318 Czarnocin;970;553;553;14;539;57.01;2.53
90446;101002;Zespół Szkolno-Gimnazjalny w Czarnocinie|Czarnocin|Główna 134 |97-318 Czarnocin;974;502;502;12;490;51.54;2.39
90447;101002;Szkoła Podstawowa w Szynczycach|Szynczyce| 8 |97-318 Czarnocin;838;352;352;11;341;42.00;3.12
90448;101002;Budynek Ochotniczej Straży Pożarnej w Dalkowie|Dalków| 145 |97-318 Czarnocin;492;247;247;4;243;50.20;1.62
90449;101003;OSP Sobakówek|Sobakówek| 44A |97-350 Gorzkowice;396;211;211;17;194;53.28;8.06
90450;101003;OSP Gorzkowiczki|Gorzkowiczki| 112A |97-350 Gorzkowice;405;228;228;8;220;56.30;3.51
90451;101003;Szkoła Podstawowa w Gorzkowicach|Gorzkowice|ul. Kościelna 26 |97-350 Gorzkowice;754;384;384;22;362;50.93;5.73
90452;101003;Szkoła Podstawowa w Gorzkowicach|Gorzkowice|ul. Kościelna 26 |97-350 Gorzkowice;1090;611;611;29;582;56.06;4.75
90453;101003;Gimnazjum w Gorzkowicach|Gorzkowice|ul. Szkolna 8 |97-350 Gorzkowice;1345;771;771;28;743;57.32;3.63
90454;101003;Szkoła Podstawowa w Gościnnej|Gościnna| 29B |97-350 Gorzkowice;511;239;239;18;221;46.77;7.53
90455;101003;OSP Szczepanowice|Szczepanowice| 54 |97-350 Gorzkowice;628;345;345;15;330;54.94;4.35
90456;101003;Szkoła Podstawowa w Krzemieniewicach|Krzemieniewice| 59 |97-350 Gorzkowice;905;421;421;12;409;46.52;2.85
90457;101003;Przedszkole Samorządowe w Gorzkowicach|Gorzkowice|ul. Kwiatowa 7a |97-350 Gorzkowice;829;395;395;26;369;47.65;6.58
90458;101004;Urząd Gminy|Grabica| 66 |97-306 Grabica;951;422;422;8;414;44.37;1.90
90459;101004;Budynek byłej Szkoły Podstawowej|Krzepczów, Krzepczów Stary| 23 |97-306 Grabica;1313;604;604;31;573;46.00;5.13
90460;101004;Gimnazjum|Szydłów-Kolonia| 58 |97-306 Grabica;1290;624;624;22;602;48.37;3.53
90461;101004;Strażnica OSP|Żeronie| 7 |97-306 Grabica;359;154;154;6;148;42.90;3.90
90462;101004;Budynek byłej Szkoły Podstawowej|Kamocin| 47 |97-306 Grabica;916;443;443;18;425;48.36;4.06
90463;101005;Publiczna Szkoła Podstawowa w Łękach Szlacheckich|Łęki Szlacheckie| 60 |97-352 Łęki Szlacheckie;694;321;321;12;309;46.25;3.74
90464;101005;Publiczna Szkoła Podstawowa w Łękach Szlacheckich|Łęki Szlacheckie| 60 |97-352 Łęki Szlacheckie;815;262;262;13;249;32.15;4.96
90465;101005;Publiczna Szkoła Podstawowa w Trzepnicy|Trzepnica-Kolonia| 8 |97-352 Łęki Szlacheckie;872;356;356;19;337;40.83;5.34
90466;101005;Publiczne Gimnazjum w Tomawie|Tomawa| 26 |97-352 Łęki Szlacheckie;571;234;234;7;227;40.98;2.99
90467;101006;Ochotnicza Straż Pożarna w Moszczenicy|Moszczenica|Piotrkowska 4 |97-310 Moszczenica;1476;747;748;15;732;50.61;2.01
90468;101006;Szkoła Podstawowa|Moszczenica|ul. Dworcowa 9 |97-310 Moszczenica;1345;648;648;17;631;48.18;2.62
90469;101006;Gimnazjum|Moszczenica|ul. Piotrkowska 13 |97-310 Moszczenica;1314;692;692;12;680;52.66;1.73
90470;101006;Gimnazjum|Moszczenica|ul. Piotrkowska 13 |97-310 Moszczenica;821;442;442;11;431;53.84;2.49
90471;101006;Szkoła Podstawowa|Baby|ul. Piotrkowska 20 |97-310 Moszczenica;1368;705;705;7;698;51.54;0.99
90472;101006;Zespół Szkół|Srock|ul. Łódzka 5 |97-310 Moszczenica;1292;660;660;17;643;51.08;2.58
90473;101006;Gminny Ośrodek Pomocy Społecznej|Kosów|ul. Główna 23 |97-310 Moszczenica;1290;613;613;19;594;47.52;3.10
90474;101006;Szkoła Podstawowa|Jarosty|ul. Leśna 14 |97-310 Moszczenica;1248;681;681;53;628;54.57;7.78
90475;101006;HELP-MED Sp. z o.o. Zakład Opiekuńczo-Leczniczy i Rehabilitacyjny|Raciborowice| 66 |97-310 Moszczenica;93;48;48;3;45;51.61;6.25
90476;101007;Budynek po byłej Szkole Podstawowej w Bąkowej Górze|Bąkowa Góra| 43 |97-510 Ręczno;666;290;290;16;274;43.54;5.52
90477;101007;Urząd Gminy Ręczno "Sala Wspólny Dom"|Ręczno|ul. Piotrkowska 5 |97-510 Ręczno;759;327;327;14;313;43.08;4.28
90478;101007;Publiczny Zespół Szkolno-Gimnazjalny w Ręcznie|Ręczno|ul. Główna 21 |97-510 Ręczno;847;389;389;13;376;45.93;3.34
90479;101007;Szkoła Podstawowa w Stobnicy|Stobnica| 51A |97-510 Ręczno;738;310;310;15;295;42.01;4.84
90480;101008;Zespół Szkolno-Gimnazjalny|Niechcice|ul. Częstochowska 27 |97-340 Rozprza;1391;674;674;36;638;48.45;5.34
90481;101008;Sala zebrań|Truszczanek| 21A |97-340 Rozprza;688;282;282;11;271;40.99;3.90
90482;101008;Szkoła Podstawowa|Nowa Wieś| 84 |97-340 Rozprza;1174;576;576;25;551;49.06;4.34
90483;101008;Szkoła Podstawowa|Rozprza|ul. Szkolna 1 |97-340 Rozprza;1334;737;737;19;718;55.25;2.58
90484;101008;Gimnazjum|Rozprza|ul. Sportowa 12A |97-340 Rozprza;1498;599;599;21;578;39.99;3.51
90485;101008;Szkoła Podstawowa|Milejów|ul. Szkolna 12 |97-340 Rozprza;1338;651;651;20;631;48.65;3.07
90486;101008;Szkoła Podstawowa|Straszów| 70 |97-340 Rozprza;1578;634;634;27;607;40.18;4.26
90487;101008;Szkoła Podstawowa|Mierzyn| 134 |97-340 Rozprza;550;259;259;19;240;47.09;7.34
90488;101008;Dom Pomocy Społecznej w Łochyńsku|Łochyńsko| |97-340 Rozprza;71;43;43;3;40;60.56;6.98
90489;101009;Zespół Szkół Ponadgimnazjalnych w Sulejowie|Sulejów|ul. Milejowska 21 |97-330 Sulejów;1464;780;781;22;758;53.28;2.82
90490;101009;Szkoła Podstawowa Nr 1 w Sulejowie|Sulejów|ul. Konecka 45 |97-330 Sulejów;1707;879;879;27;852;51.49;3.07
90491;101009;Szkoła Podstawowa w Klementynowie|Klementynów| 1 |97-330 Sulejów;845;265;265;13;252;31.36;4.91
90492;101009;Szkoła Podstawowa w Łęcznie|Łęczno| 12 |97-330 Sulejów;992;390;390;19;371;39.31;4.87
90493;101009;Remiza Ochotniczej Straży Pożarnej w Przygłowie|Przygłów|Sulejowska 33 |97-330 Sulejów;859;424;424;22;402;49.36;5.19
90494;101009;Remiza Ochotniczej Straży Pożarnej w Barkowicach|Barkowice|ul. Widok 94 |97-330 Sulejów;874;452;452;20;432;51.72;4.42
90495;101009;Szkoła Podstawowa w Witowie|Witów-Kolonia| 47 |97-330 Sulejów;1631;795;795;20;775;48.74;2.52
90496;101009;Szkoła Podstawowa w Uszczynie|Uszczyn|ul. Szkolna 12 |97-330 Sulejów;1208;683;683;8;675;56.54;1.17
90497;101009;Szkoła Podstawowa Nr 2 w Sulejowie|Sulejów|ul. Rycerska 10 |97-330 Sulejów;1037;540;540;14;526;52.07;2.59
90498;101009;Przedszkole Samorządowe w Sulejowie|Sulejów|ul. Konecka 29 |97-330 Sulejów;972;462;462;13;449;47.53;2.81
90499;101009;Szkoła Podstawowa w Przygłowie z siedzibą we Włodzimierzowie|Włodzimierzów|ul. Łęczyńska 8 |97-330 Sulejów;1428;787;787;30;757;55.11;3.81
90500;101010;Budynek Urzędu Gminy|Wola Krzysztoporska|ul. Kościuszki 5 |97-371 Wola Krzysztoporska;1191;698;698;17;681;58.61;2.44
90501;101010;Budynek Gminnego Ośrodka Kultury|Wola Krzysztoporska|ul. Południowa 2 |97-371 Wola Krzysztoporska;1102;590;590;26;564;53.54;4.41
90502;101010;Szkoła Podstawowa|Parzniewice| 31 |97-371 Wola Krzysztoporska;1216;505;505;32;473;41.53;6.34
90503;101010;Szkoła Podstawowa|Krzyżanów| 55 |97-371 Wola Krzysztoporska;1351;638;638;29;609;47.22;4.55
90504;101010;Szkoła Podstawowa|Bogdanów|ul. Ks. Kanonika Mieczysława Kozakowskiego 3 |97-371 Wola Krzysztoporska;790;367;367;11;356;46.46;3.00
90505;101010;Budynek Ochotniczej Straży Pożarnej|Woźniki| 37 |97-371 Wola Krzysztoporska;1231;634;634;29;605;51.50;4.57
90506;101010;Szkoła Podstawowa|Bujny|ul. Piotrkowska 104 |97-371 Wola Krzysztoporska;1247;649;649;20;629;52.04;3.08
90507;101010;Szkoła Podstawowa|Gomulin|ul. Szkolna 2 |97-371 Wola Krzysztoporska;1195;691;691;12;679;57.82;1.74
90508;101011;Publiczne Gimnazjum w Wolborzu|Wolbórz|ul. Modrzewskiego 105 |97-320 Wolbórz;942;587;587;9;578;62.31;1.53
90509;101011;Miejski Ośrodek Kultury w Wolborzu|Wolbórz|ul. Modrzewskiego 15 |97-320 Wolbórz;1286;700;700;19;681;54.43;2.71
90510;101011;Szkoła Podstawowa w Komornikach|Komorniki| 99 |97-320 Wolbórz;749;328;328;17;311;43.79;5.18
90511;101011;Sala OSP w Kuznocinie|Kuznocin| 33 |97-320 Wolbórz;862;464;464;21;443;53.83;4.53
90512;101011;Sala OSP w Polichnie|Polichno| 66 |97-320 Wolbórz;1035;542;542;15;527;52.37;2.77
90513;101011;Szkoła Podstawowa w Goleszach Dużych|Golesze Duże| 27 |97-320 Wolbórz;1334;714;714;21;693;53.52;2.94
90514;101101;Zespół Szkół w Dalikowie|Dalików|Łęczycka 3 |99-205 Dalików;1259;587;587;22;565;46.62;3.75
90515;101101;Zespół Szkół w Domaniewie|Domaniew| 42 |99-205 Dalików;546;249;249;13;236;45.60;5.22
90516;101101;Remiza Ochotniczej Straży Pożarnej w Kucinach|Kuciny| 23 |99-205 Dalików;536;249;249;11;238;46.46;4.42
90517;101101;Remiza Ochotniczej Straży Pożarnej w Budzynku|Budzynek| 25 |99-205 Dalików;403;171;171;2;169;42.43;1.17
90518;101101;Budynek po byłej Szkole Podstawowej w Wilczycy|Wilczyca| 23 |99-205 Dalików;403;178;178;9;169;44.17;5.06
90519;101102;Gimnazjum Nr 1 w Pęczniewie|Pęczniew|Główna 17 |99-235 Pęczniew;1322;619;619;34;585;46.82;5.49
90520;101102;Remiza OSP w Luboli|Lubola| 76a |99-235 Pęczniew;394;185;185;10;175;46.95;5.41
90521;101102;Remiza OSP w Księżej Wólce|Księża Wólka| 28 |99-235 Pęczniew;371;175;175;5;170;47.17;2.86
90522;101102;Remiza OSP w Drużbinie|Drużbin| 53 |99-235 Pęczniew;479;210;210;8;202;43.84;3.81
90523;101102;Centrum Kulturalno-Oświatowe we wsi Brzeg przy szkole podstawowej|Brzeg| 118 |99-235 Pęczniew;394;207;207;11;196;52.54;5.31
90524;101103;Szkoła Podstawowa Nr 1 im. Lotników Polskich w Poddębicach|Poddębice|Łęczycka 13 |99-200 Poddębice;970;538;538;16;522;55.46;2.97
90525;101103;Szkoła Podstawowa Nr 1 im. Lotników Polskich w Poddębicach|Poddębice|Łeczycka 13 |99-200 Poddębice;968;481;481;13;468;49.69;2.70
90526;101103;Szkoła Podstawowa Nr 1 im. Lotników Polskich w Poddębicach|Poddębice|Łęczycka 13 |99-200 Poddębice;768;374;374;16;358;48.70;4.28
90527;101103;Szkoła Podstawowa Nr 1 im. Lotników Polskich w Poddębicach|Poddębice|Łęczycka 13 |99-200 Poddębice;598;346;346;5;341;57.86;1.45
90528;101103;Miejska i Gminna Biblioteka Publiczna im. Ziemowita Skibińskiego w Poddębicach|Poddębice|Łódzka 31 |99-200 Poddębice;802;423;423;20;403;52.74;4.73
90529;101103;Gimnazjum w Poddębicach|Poddębice|Polna 36 |99-200 Poddębice;1097;530;530;16;514;48.31;3.02
90530;101103;Gimnazjum w Poddębicach|Poddębice|Polna 36 |99-200 Poddębice;943;507;507;16;491;53.76;3.16
90531;101103;Sala OSP w Sworawie|Sworawa| 28 |99-200 Poddębice;454;190;190;5;185;41.85;2.63
90532;101103;Sala OSP w Panaszewie|Panaszew| 24A |99-200 Poddębice;422;175;175;12;163;41.47;6.86
90533;101103;Sala OSP w Kałowie|Kałów| 13 |99-200 Poddębice;764;302;302;11;291;39.53;3.64
90534;101103;Sala OSP w Niewieszu|Niewiesz-Kolonia| 39 |99-200 Poddębice;764;322;322;17;305;42.15;5.28
90535;101103;Sala OSP w Klementowie|Klementów| 1D |99-200 Poddębice;874;434;434;13;421;49.66;3.00
90536;101103;Szkoła Podstawowa im. Tadeusza Kościuszki w Niemysłowie|Niemysłów| 32A |99-200 Poddębice;823;317;317;21;296;38.52;6.62
90537;101103;Budynek byłej Szkoły Podstawowej w Lipnicy|Lipnica| 22A |99-200 Poddębice;697;229;229;14;215;32.86;6.11
90538;101103;Szkoła Podstawowa w Bałdrzychowie|Bałdrzychów| 13A |99-200 Poddębice;877;377;377;13;364;42.99;3.45
90539;101103;Sala OSP w Nowym Pudłowie|Nowy Pudłów| 42 |99-200 Poddębice;354;135;135;8;127;38.14;5.93
90540;101103;Centrum Turystyki i Rekreacji w Byczynie|Byczyna| 45 |99-200 Poddębice;554;265;265;12;253;47.83;4.53
90541;101103;Poddębickie Centrum Zdrowia Sp. z o.o|Poddębice|Mickiewicza 16 |99-200 Poddębice;119;29;29;3;26;24.37;10.34
90542;101103;NZOZ "MOŻ-MED"|Poddębice|Miła 27 |99-200 Poddębice;48;18;18;0;18;37.50;0.00
90543;101104;Szkoła Podstawowa w Wilamowie|Wilamów| 50 |99-210 Uniejów;1071;462;462;17;445;43.14;3.68
90544;101104;Szkoła Podstawowa w Wieleninie|Wielenin| 30a |99-210 Uniejów;845;322;322;12;310;38.11;3.73
90545;101104;Szkoła Podstawowa w Spycimierzu|Spycimierz| 7 |99-210 Uniejów;661;325;325;10;315;49.17;3.08
90546;101104;Miejsko-Gminny Ośrodek Kultury w Uniejowie|Uniejów|Targowa 21 |99-210 Uniejów;900;404;404;12;392;44.89;2.97
90547;101104;Zespół Szkół w Uniejowie|Uniejów|Kościelnicka 26-28 |99-210 Uniejów;1229;666;666;19;647;54.19;2.85
90548;101104;Miejskie Przedszkole w Uniejowie|Uniejów|Wiśniowa 9 |99-210 Uniejów;1342;743;743;15;728;55.37;2.02
90549;101105;Zespół Szkół w Wartkowicach|Wartkowice|Legionów Polskich 5 |99-220 Wartkowice;1376;532;532;29;503;38.66;5.45
90550;101105;Muzeum Oświatowe w Bronowie|Bronów| 6 |99-220 Wartkowice;426;126;126;3;123;29.58;2.38
90551;101105;Obiekt komunalny w Białej Górze|Biała Góra| 39 |99-220 Wartkowice;664;295;295;10;285;44.43;3.39
90552;101105;Szkoła Podstawowa w Kłódnej|Jadwisin| 3 |99-220 Wartkowice;420;128;128;4;124;30.48;3.12
90553;101105;Obiekt komunalny w Parądzicach|Parądzice| 25 |99-220 Wartkowice;405;187;187;4;183;46.17;2.14
90554;101105;Obiekt komunalny w Pełczyskach|Pełczyska| 4 |99-220 Wartkowice;504;165;165;10;155;32.74;6.06
90555;101105;Obiekt komunalny w Sakowie|Saków| 7 |99-220 Wartkowice;343;126;126;7;119;36.73;5.56
90556;101105;Obiekt komunalny w Turze|Wilkowice| 8 |99-220 Wartkowice;626;251;251;12;239;40.10;4.78
90557;101105;Ochotnicza Straż Pożarna w Zelgoszczy|Zelgoszcz| 26 |99-220 Wartkowice;292;76;76;3;73;26.03;3.95
90558;101105;Dom Pomocy Społecznej w Gostkowie|Stary Gostków| 41 |99-220 Wartkowice;63;21;21;6;15;33.33;28.57
90559;101106;Zespół Szkół w Zadzimiu|Kazimierzew| 38 |99-232 Zadzim;1043;543;543;14;529;52.06;2.58
90560;101106;Sala OSP w Ralewicach|Ralewice| 5a |99-232 Zadzim;605;261;261;6;255;43.14;2.30
90561;101106;Zespół Szkół w Zygrach|Zygry| 71 |99-232 Zadzim;720;296;296;11;285;41.11;3.72
90562;101106;Budynek Szkoły w Małyniu|Kłoniszew| 57 |99-232 Zadzim;680;261;261;25;236;38.38;9.58
90563;101106;Sala OSP w Wierzchach|Wierzchy| 56 |99-232 Zadzim;739;297;297;19;278;40.19;6.40
90564;101106;Sala OSP w Charchowie Pańskim|Charchów Pański| 20 |99-232 Zadzim;521;242;242;5;237;46.45;2.07
90565;101201;Zespół Szkół Elektryczno-Elektronicznych|Radomsko|ul.Narutowicza 12 |97-500 Radomsko;1662;763;763;12;751;45.91;1.57
90566;101201;Zespół Szkolno-Gimnazjalny Nr 3|Radomsko|ul. Szkolna 4 |97-500 Radomsko;1888;874;874;21;853;46.29;2.40
90567;101201;II Liceum Ogólnokształcące|Radomsko|ul. Bugaj 3 |97-500 Radomsko;1613;810;810;9;801;50.22;1.11
90568;101201;Zespół Szkolno-Gimnazjalny Nr 5|Radomsko|ul. Rolna 65 |97-500 Radomsko;1759;875;875;21;854;49.74;2.40
90569;101201;Specjalny Ośrodek Szkolno-Wychowawczy|Radomsko|ul. Piastowska 12 |97-500 Radomsko;2130;954;954;18;936;44.79;1.89
90570;101201;Zespół Szkolno-Gimnazjalny Nr 1|Radomsko|ul. Piastowska 17 |97-500 Radomsko;1851;1149;1149;29;1120;62.07;2.52
90571;101201;Bursa Szkolna Nr 1|Radomsko|ul. Piastowska 21 |97-500 Radomsko;2076;1113;1113;26;1087;53.61;2.34
90572;101201;I Liceum Ogólnokształcące|Radomsko|ul. Armii Krajowej 30 |97-500 Radomsko;2231;1186;1189;31;1155;53.16;2.61
90573;101201;Zespół Szkolno-Gimnazjalny Nr 4|Radomsko|ul. Świętej Jadwigi Królowej 20 |97-500 Radomsko;1795;942;942;45;897;52.48;4.78
90574;101201;Zespół Szkolno-Gimnazjalny Nr 4|Radomsko|ul. Świętej Jadwigi Królowej 20 |97-500 Radomsko;1308;711;711;11;700;54.36;1.55
90575;101201;Publiczna Szkoła Podstawowa Nr 3|Radomsko|ul. Marii Dąbrowskiej 27 |97-500 Radomsko;1203;594;594;18;576;49.38;3.03
90576;101201;Miejski Dom Kultury|Radomsko|ul. Brzeźnicka 5 |97-500 Radomsko;1701;968;968;12;956;56.91;1.24
90577;101201;Muzeum Regionalne|Radomsko|ul. Narutowicza 1 |97-500 Radomsko;1934;719;719;7;712;37.18;0.97
90578;101201;Zespół Szkolno-Gimnazjalny Nr 2|Radomsko|ul. Piłsudskiego 22 |97-500 Radomsko;2063;1037;1037;13;1024;50.27;1.25
90579;101201;Publiczne Przedszkole Nr 1|Radomsko|ul. Miła 13 |97-500 Radomsko;1604;891;891;15;876;55.55;1.68
90580;101201;Zespół Szkól Ponadgimnazjalnych Nr 1|Radomsko|ul. Brzeźnicka 20 |97-500 Radomsko;1877;830;830;29;801;44.22;3.49
90581;101201;Zespół Szkół Drzewnych i Ochrony Środowiska|Radomsko|ul. Brzeźnicka 22 |97-500 Radomsko;1823;898;898;17;881;49.26;1.89
90582;101201;Zespół Szkolno-Gimnazjalny Nr 6|Radomsko|ul. Makuszyńskiego 25 |97-500 Radomsko;1813;873;873;26;847;48.15;2.98
90583;101201;Zespół Szkolno-Gimnazjalny Nr 7|Radomsko|ul. 11 Listopada 16 |97-500 Radomsko;2216;1025;1025;26;999;46.25;2.54
90584;101201;Publiczna Szkoła Podstawowa Nr 8|Radomsko|ul. Reja 81 |97-500 Radomsko;1375;618;618;29;589;44.95;4.69
90585;101201;Publiczna Szkoła Podstawowa Nr 5|Radomsko|ul. Narutowicza 207 |97-500 Radomsko;1722;890;890;58;832;51.68;6.52
90586;101201;Świetlica Środowiskowa|Radomsko|ul. Strażacka 13 |97-500 Radomsko;519;186;186;10;176;35.84;5.38
90587;101201;Dom Pomocy Społecznej|Radomsko|ul. Ignacego Krasickiego 138 |97-500 Radomsko;58;28;28;0;28;48.28;0.00
90588;101201;Szpital Powiatowy|Radomsko|Jagiellońska 36 |97-500 Radomsko;180;72;72;6;66;40.00;8.33
90589;101202;Zespół Szkolno-Przedszkolny|Dobryszyce|ul. Leśna 1 |97-505 Dobryszyce;1037;474;474;18;456;45.71;3.80
90590;101202;Urząd Gminy|Dobryszyce|ul. Wolności 8 |97-505 Dobryszyce;1197;553;553;31;522;46.20;5.61
90591;101202;Szkoła Podstawowa|Blok Dobryszyce|ul. Kolejowa 24 |97-505 Dobryszyce;1171;548;548;17;531;46.80;3.10
90592;101203;Fabryka Drutów Specjalnych|Borowa| 75A |97-540 Gidle;528;187;187;15;172;35.42;8.02
90593;101203;Publiczna Szkoła Podstawowa|Ciężkowice| 36 |97-540 Gidle;703;249;249;10;239;35.42;4.02
90594;101203;Publiczne Gimnazjum w Gidlach|Gidle|ul. Szkolna 7 |97-540 Gidle;1225;578;578;9;569;47.18;1.56
90595;101203;Zespół Szkolno-Gimnazjalny|Pławno|Przedborska 4 |97-540 Gidle;842;343;343;11;332;40.74;3.21
90596;101203;Publiczna Szkoła Podstawowa|Gidle|ul. Szkolna 7 |97-540 Gidle;1124;404;404;15;389;35.94;3.71
90597;101203;Zespół Szkolno-Gimnazjalny|Pławno|Przedborska 4 |97-540 Gidle;824;378;378;6;372;45.87;1.59
90598;101204;Zespół Szkolno-Przedszkolny w Gomunicach|Gomunice|ul. Słowackiego 12 |97-545 Gomunice;1290;649;649;20;629;50.31;3.08
90599;101204;Urząd Gminy w Gomunicach|Gomunice|ul. Armii Krajowej 30 |97-545 Gomunice;1035;556;556;13;543;53.72;2.34
90600;101204;Strażnica OSP w Kletni|Kletnia|ul. Główna 33 |97-545 Gomunice;974;499;499;13;486;51.23;2.61
90601;101204;Pasieka Zarodowa w Kocierzowach|Kocierzowy| 4 |97-545 Gomunice;614;245;245;11;234;39.90;4.49
90602;101204;Zespół Szkolno-Przedszkolny w Chrzanowicach|Chrzanowice|ul. Włodzimierza Łuckiego 18 |97-545 Gomunice;908;464;464;28;436;51.10;6.03
90603;101205;Zespół Szkół Ponadgimnazjalnych (sala gimnastyczna)|Kamieńsk|ul. Szkolna 4 |97-360 Kamieńsk;1034;592;592;19;573;57.25;3.21
90604;101205;Zespół Szkół Ponadgimnazjalnych (wejście główne)|Kamieńsk|ul. Szkolna 4 |97-360 Kamieńsk;1292;780;780;32;748;60.37;4.10
90605;101205;Dom Ludowy im. K.Tazbira|Kamieńsk|ul. Konopnickiej 6 |97-360 Kamieńsk;1228;550;550;30;520;44.79;5.45
90606;101205;Świetlica Wiejska|Gałkowice Stare| 58 |97-360 Kamieńsk;659;232;232;19;213;35.20;8.19
90607;101205;Zespół Szkolno-Przedszkolny|Gorzędów|ul. Adamowskiego 7 |97-360 Kamieńsk;689;418;418;23;395;60.67;5.50
90608;101206;Świetlica Wiejska w Zrąbcu|Zrąbiec| 34A |97-524 Kobiele Wielkie;1070;416;416;7;409;38.88;1.68
90609;101206;Gminny Ośrodek Kultury i Sportu w Kobielach Wielkich|Kobiele Wielkie|Reymonta 75 |97-524 Kobiele Wielkie;1104;440;440;16;424;39.86;3.64
90610;101206;Strażnica Ochotniczej Straży Pożarnej w Przybyszowie|Przybyszów| 42 |97-524 Kobiele Wielkie;652;262;262;7;255;40.18;2.67
90611;101206;Publiczna Szkoła Podstawowa w Orzechowie|Orzechów| 2 |97-524 Kobiele Wielkie;771;301;301;11;290;39.04;3.65
90612;101207;Zespół Szkolno-Gimnazjalny w Kodrębie|Kodrąb|ul. Leśna 2 |97-512 Kodrąb;787;286;286;9;277;36.34;3.15
90613;101207;Zespół Szkolno-Gimnazjalny w Kodrębie|Kodrąb|ul. Leśna 2 |97-512 Kodrąb;789;354;354;15;339;44.87;4.24
90614;101207;Publiczna Szkoła Podstawowa w Rzejowicach|Rzejowice| 91 |97-512 Kodrąb;639;232;232;15;217;36.31;6.47
90615;101207;Świetlica wiejska w Woli Malowanej|Wola Malowana| 22 |97-512 Kodrąb;544;222;222;12;210;40.81;5.41
90616;101207;Gminne Centrum Informacji w Dmeninie|Dmenin| 124 |97-512 Kodrąb;481;170;170;6;164;35.34;3.53
90617;101207;Gminne Centrum Informacji w Dmeninie|Dmenin| 124 |97-512 Kodrąb;604;281;281;8;273;46.52;2.85
90618;101208;Urząd Gminy w Lgocie Wielkiej|Lgota Wielka|ul. Radomszczańska 60 |97-565 Lgota Wielka;1450;688;688;42;646;47.45;6.10
90619;101208;Publiczna Szkoła Podstawowa w Woli Blakowej|Wola Blakowa| 39 |97-565 Lgota Wielka;1048;394;394;27;367;37.60;6.85
90620;101208;Świetlica Wiejska w Brudzicach|Brudzice|ul. Radomszczańska 1A |97-565 Lgota Wielka;598;290;290;21;269;48.49;7.24
90621;101208;Wiejski Dom Kultury|Krzywanice| 142A |97-565 Lgota Wielka;436;257;257;14;243;58.94;5.45
90622;101209;Publiczna Szkoła Podstawowa|Jedlno Pierwsze| 33A |97-561 Ładzice;1399;528;528;16;512;37.74;3.03
90623;101209;Zespół Szkolno-Przedszkolny|Stobiecko Szlacheckie| 24A |97-561 Ładzice;1204;473;473;19;454;39.29;4.02
90624;101209;Publiczne Gimnazjum|Radziechowice Drugie| 170 |97-561 Ładzice;849;330;330;14;316;38.87;4.24
90625;101209;Urząd Gminy Ładzice|Ładzice|ul. Wyzwolenia 36 |97-561 Ładzice;383;184;184;7;177;48.04;3.80
90626;101209;Dom Pomocy Społecznej|Radziechowice Pierwsze| 2 |97-561 Ładzice;87;31;31;14;17;35.63;45.16
90627;101210;Szkoła Podstawowa w Strzelcach Małych|Strzelce Małe| 33 |97-515 Masłowice;936;365;365;12;353;39.00;3.29
90628;101210;Sala OSP w Chełmie|Chełmo| 51 |97-515 Masłowice;1146;480;480;22;458;41.88;4.58
90629;101210;Szkoła Podstawowa w Przerębie|Przerąb| 61 |97-515 Masłowice;707;279;279;11;268;39.46;3.94
90630;101210;Budynek po byłej Szkole Podstawowej w Ochotniku|Ochotnik| 99 |97-515 Masłowice;753;291;291;11;280;38.65;3.78
90631;101211;Zespół Szkolno - Gimnazjalny|Przedbórz|ul.Mostowa 37 A |97-570 Przedbórz;1441;593;593;41;552;41.15;6.91
90632;101211;Zespół Szkół Ponadgimnazjalnych|Przedbórz|ul.Piotrkowska 1 |97-570 Przedbórz;1474;726;726;22;704;49.25;3.03
90633;101211;Szkoła Podstawowa|Góry Mokre| 94a |97-570 Przedbórz;1179;419;419;44;375;35.54;10.50
90634;101211;Budynek po byłej Szkole Podstawowej|Nosalewice| 1a |97-570 Przedbórz;815;294;294;18;276;36.07;6.12
90635;101211;Przedszkole Samorządowe|Przedbórz|ul.Mostowa 39 |97-570 Przedbórz;1106;583;583;26;557;52.71;4.46
90636;101211;Samodzielny Zakład Opieki Zdrowotnej - Zakład Pielęgnacyjno-Opiekuńczy|Przedbórz|ul. Częstochowska 25 |97-570 Przedbórz;19;3;3;0;3;15.79;0.00
90637;101211;Niepubliczny Zakład Pielęgnacyjno-Opiekuńczy "Family"|Taras| 46A |97-570 Przedbórz;58;4;4;0;4;6.90;0.00
90638;101212;Publiczny Zespół Szkolno-Gimnazjalny|Dziepółć| 97 |97-500 Radomsko;586;252;252;6;246;43.00;2.38
90639;101212;Publiczny Zespół Szkolno-Gimnazjalny|Kietlin|ul.Radomszczańska 61 |97-500 Radomsko;679;342;342;16;326;50.37;4.68
90640;101212;Publiczny Zespół Szkolno-Gimnazjalny|Płoszów|ul.Radomszczańska 41 |97-500 Radomsko;677;282;282;14;268;41.65;4.96
90641;101212;Publiczny Zespół Szkolno-Gimnazjalny|Strzałków|ul. Kolumba 2 |97-500 Radomsko;932;360;360;15;345;38.63;4.17
90642;101212;Publiczny Zespół Szkolno-Gimnazjalny|Strzałków|ul.Kolumba 2 |97-500 Radomsko;676;310;310;14;296;45.86;4.52
90643;101212;Publiczny Zespół Szkolno-Gimnazjalny|Szczepocice Rządowe| 19C |97-500 Radomsko;976;470;470;14;456;48.16;2.98
90644;101213;Publiczna Szkoła Podstawowa|Krzętów|ul.Stodolna 22 |97-525 Wielgomłyny;802;298;298;8;290;37.16;2.68
90645;101213;Remiza OSP|Sokola Góra| 47 |97-525 Wielgomłyny;574;242;242;6;236;42.16;2.48
90646;101213;Gminny Ośrodek Kultury w Wielgomłynach(parter)|Wielgomłyny|ul.Rynek 1 |97-525 Wielgomłyny;432;129;129;2;127;29.86;1.55
90647;101213;Sala Obrad w Urzędzie Gminy w Wielgomłynach(I piętro)|Wielgomłyny|ul.Rynek 1 |97-525 Wielgomłyny;892;344;344;13;331;38.57;3.78
90648;101213;Publiczna Szkoła Podstawowa|Zagórze| 30 |97-525 Wielgomłyny;688;278;278;15;263;40.41;5.40
90649;101213;Publiczna Szkoła Podstawowa|Niedośpielin| 97 |97-525 Wielgomłyny;529;190;190;5;185;35.92;2.63
90650;101214;Publiczna Szkoła Podstawowa|Żytno|ul. Ogrodowa 16 |97-532 Żytno;1340;523;523;39;484;39.03;7.46
90651;101214;Gminny Ośrodek Kultury|Silnica| 77 |97-532 Żytno;891;356;356;23;333;39.96;6.46
90652;101214;Przedszkole Publiczne|Maluszyn|ul. Wolności 5 |97-532 Żytno;1178;437;437;19;418;37.10;4.35
90653;101214;Publiczna Szkoła Podstawowa|Borzykowa|ul. Szkolna 12 |97-532 Żytno;1080;446;446;25;421;41.30;5.61
90654;101301;Szkoła Podstawowa nr 2 im. Marii Konopnickiej|Rawa Mazowiecka|ul. Miła 2 |96-200 Rawa Mazowiecka;1871;858;858;21;837;45.86;2.45
90655;101301;Zakład Gospodarki Odpadami Sp. z o.o. Aquarium|Rawa Mazowiecka|ul.Katowicka 20 |96-200 Rawa Mazowiecka;1882;1075;1075;24;1051;57.12;2.23
90656;101301;Szkoła Podstawowa nr 1 im. Tadeusza Kościuszki|Rawa Mazowiecka|ul. Kościuszki 19 |96-200 Rawa Mazowiecka;1892;881;881;35;846;46.56;3.97
90657;101301;Przedszkole Miejskie nr 3 "Bajkowy Zakątek"|Rawa Mazowiecka|ul. Solidarności 3b |96-200 Rawa Mazowiecka;1927;1063;1063;27;1036;55.16;2.54
90658;101301;Gimnazjum nr 1 im. Polskich Noblistów|Rawa Mazowiecka|ul. Kościuszki 19 |96-200 Rawa Mazowiecka;1914;986;986;22;964;51.52;2.23
90659;101301;Miejski Dom Kultury|Rawa Mazowiecka|ul.Krakowska 6c |96-200 Rawa Mazowiecka;1001;613;613;12;601;61.24;1.96
90660;101301;Gimnazjum Nr 2 im. Haliny Konopackiej|Rawa Mazowiecka|ul. Kazimierza Wielkiego 28 |96-200 Rawa Mazowiecka;1885;953;953;20;933;50.56;2.10
90661;101301;Ośrodek Sportu i Rekreacji Hala "Milenium"|Rawa Mazowiecka|ul. Kazimierza Wielkiego 28 |96-200 Rawa Mazowiecka;1909;1095;1095;36;1059;57.36;3.29
90662;101301;AMG Centrum Medyczne Sp. z o.o. Szpital im. Św. Ducha|Rawa Mazowiecka|Warszawska 14 |96-200 Rawa Mazowiecka;40;13;13;0;13;32.50;0.00
90663;101302;Szkoła Podstawowa w Babsku|Babsk|Aleja Lipowa 12 |96-200 Rawa Mazowiecka;1050;488;488;22;466;46.48;4.51
90664;101302;Szkoła Podstawowa w Białej Rawskiej|Biała Rawska|ul.Mickiewicza 22 |96-230 Biała Rawska;1301;584;584;22;562;44.89;3.77
90665;101302;Zespół Szkół Ponadgimnazjalnych w Białej Rawskiej|Biała Rawska|ul.15 Grudnia 9 |96-230 Biała Rawska;1792;577;577;34;543;32.20;5.89
90666;101302;Ochotnicza Straż Pożarna w Dańkowie|Dańków| 6 |96-230 Biała Rawska;1865;640;640;18;622;34.32;2.81
90667;101302;Ochotnicza Straż Pożarna w Szczukach|Szczuki| 4 |96-230 Biała Rawska;764;298;298;10;288;39.01;3.36
90668;101302;Szkoła Podstawowa w Lesiewie|Wólka Lesiewska| 21 |96-230 Biała Rawska;636;261;261;8;253;41.04;3.07
90669;101302;Urząd Stanu Cywilnego|Biała Rawska|ul. Jana Pawła II 57 |96-230 Biała Rawska;1900;746;746;40;706;39.26;5.36
90670;101303;Szkoła Podstawowa w Cielądzu|Cielądz| 38 |96-214 Cielądz;2106;869;869;51;818;41.26;5.87
90671;101303;Szkoła Podstawowa w Sierzchowach|Sierzchowy| 59 |96-214 Cielądz;864;356;356;18;338;41.20;5.06
90672;101303;Budynek byłej Szkoły Podstawowej w Grabicach|Grabice| 41A |96-214 Cielądz;318;141;141;8;133;44.34;5.67
90673;101304;Urząd Gminy Rawa Mazowiecka|Rawa Mazowiecka|al. Konstytucji 3 Maja 32 |96-200 Rawa Mazowiecka;1779;767;767;20;747;43.11;2.61
90674;101304;Szkoła Podstawowa w Boguszycach|Garłów| 12 |96-200 Rawa Mazowiecka;1848;804;804;35;769;43.51;4.35
90675;101304;Szkoła Podstawowa w Starej Wojskiej|Stara Wojska| 30B |96-200 Rawa Mazowiecka;887;363;363;17;346;40.92;4.68
90676;101304;Szkoła Podstawowa w Kurzeszynie|Nowy Kurzeszyn| 12 |96-200 Rawa Mazowiecka;1383;598;598;8;590;43.24;1.34
90677;101304;Szkoła Podstawowa w Konopnicy|Konopnica| 76 |96-200 Rawa Mazowiecka;1020;468;468;24;444;45.88;5.13
90678;101305;Gminna Biblioteka Publiczna w Regnowie|Regnów| 96 |96-232 Regnów;1497;650;650;31;619;43.42;4.77
90679;101306;Urząd Gminy w Sadkowicach|Sadkowice| 129A |96-206 Sadkowice;1893;620;620;36;584;32.75;5.81
90680;101306;Gimnazjum w Lubani|Lubania| 30 |96-208 Lubania;1503;514;514;22;492;34.20;4.28
90681;101306;Szkoła Podstawowa w Kłopoczynie|Kłopoczyn| 17 |96-208 Lubania;846;338;338;10;328;39.95;2.96
90682;101306;Świetlica środowiskowa w Lewinie|Lewin| 50 |96-206 Sadkowice;296;99;99;4;95;33.45;4.04
90683;101401;Przedszkole Nr 5 im. Misia Uszatka|Sieradz|Jana Pawła II 41 |98-200 Sieradz;1344;778;778;16;762;57.89;2.06
90684;101401;Wyższa Szkoła Humanistyczno-Ekonomiczna|Sieradz|Mickiewicza 6 |98-200 sieradz;1060;516;516;16;500;48.68;3.10
90685;101401;I Liceum Ogólnokształcące im. Kazimierza Jagiellończyka|Sieradz|Żwirki i Wigury 3 |98-200 Sieradz;1604;845;845;10;835;52.68;1.18
90686;101401;Szkoła Podstawowa Integracyjna Nr 8|Sieradz|Szlachecka 11 |98-200 Sieradz;1099;607;607;4;603;55.23;0.66
90687;101401;Państwowa Szkoła Muzyczna I stopnia|Sieradz|Jana Pawła II 48 |98-200 Sieradz;1940;1120;1120;18;1102;57.73;1.61
90688;101401;Przedszkole Nr 3 im. Jana Brzechwy|Sieradz|Władysława Łokietka 27A |98-200 Sieradz;1981;1101;1101;14;1087;55.58;1.27
90689;101401;Szkoła Podstawowa Nr 9 im. Władysława Łokietka|Sieradz|Władysława Łokietka 55 |98-200 Sieradz;1953;1061;1061;23;1038;54.33;2.17
90690;101401;Szkoła Podstawowa Nr 9 im. Władysława Łokietka|Sieradz|Władysława Łokietka 55 |98-200 Sieradz;2096;1131;1131;21;1110;53.96;1.86
90691;101401;Szkoła Podstawowa Nr 10 im. Bolesława Zwolińskiego|Sieradz|Aleja Grunwaldzka 10 |98-200 Sieradz;1650;908;908;18;890;55.03;1.98
90692;101401;Dom Pomocy Społecznej|Sieradz|Armii Krajowej 34 |98-200 Sieradz;1711;898;898;66;832;52.48;7.35
90693;101401;Przedszkole Nr 15|Sieradz|Stacheckiego-Koliby 3 |98-200 Sieradz;1822;1008;1008;23;985;55.32;2.28
90694;101401;Przedszkole Nr 15|Sieradz|Stacheckiego-Koliby 3 |98-200 Sieradz;1806;997;997;17;980;55.20;1.71
90695;101401;Komenda Powiatowa Państwowej Straży Pożarnej w Sieradzu|Sieradz|T. Grzesika i R. Piwnika 1 |98-200 Sieradz;1126;690;690;6;684;61.28;0.87
90696;101401;Zespół Szkół Katolickich przy parafii Św. Urszuli Ledóchowskiej w Sieradzu|Sieradz|Krakowskie Przedmieście 123a |98-200 Sieradz;664;348;348;13;335;52.41;3.74
90697;101401;Gimnazjum Nr 3 im. Unii Europejskiej|Sieradz|Broniewskiego 30 |98-200 Sieradz;1176;680;680;11;669;57.82;1.62
90698;101401;II Liceum Ogólnokształcące im. Stefana Żeromskiego|Sieradz|Stefana Żeromskiego 8 |98-200 Sieradz;1527;1016;1016;13;1003;66.54;1.28
90699;101401;Specjalny Ośrodek Szkolno-Wychowawczy im. Janusza Korczaka|Sieradz|Krakowskie Przedmieście 58 |98-200 Sieradz;1856;1131;1131;21;1110;60.94;1.86
90700;101401;Szkoła Podstawowa Nr 4 im. Marii Konopnickiej|Sieradz|23 Stycznia 18 |98-200 Sieradz;1547;693;693;36;657;44.80;5.19
90701;101401;Zespół Szkół Ponadgimnazjalnych Nr 1|Sieradz|Józefa Piłsudskiego 5 |98-200 Sieradz;1907;971;971;22;949;50.92;2.27
90702;101401;Gimnazjum Nr 2 im. Królowej Jadwigi|Sieradz|Rycerska 4 |98-200 Sieradz;1017;497;497;10;487;48.87;2.01
90703;101401;Dom Ludowo Strażacki|Sieradz|Nadwarciańska 2 |98-200 Sieradz;844;427;427;16;411;50.59;3.75
90704;101401;Zespół Placówek Wychowania Pozaszkolnego|Sieradz|Tysiąclecia 3 |98-200 Sieradz;1189;604;604;23;581;50.80;3.81
90705;101401;Szkoła Podstawowa Nr 6 im. Janiny Majkowskiej|Sieradz|Uniejowska 199 |98-200 Sieradz;1438;727;727;18;709;50.56;2.48
90706;101401;Szpital Wojewódzki im. Prymasa Kardynała Stefana Wyszyńskiego w Sieradzu|Sieradz|Armii Krajowej 7 |98-200 Sieradz;470;90;90;6;84;19.15;6.67
90707;101401;Szpital Wojewódzki im. Prymasa Kardynała Stefana Wyszyńskiego w Sieradzu|Sieradz|Nenckiego 2 |98-200 Sieradz;135;52;52;8;44;38.52;15.38
90708;101401;Zakład Karny Sieradz|Sieradz|Orzechowa 5 |98-200 Sieradz;672;284;284;40;244;42.26;14.08
90709;101401;Zakład Karny Sieradz|Sieradz|Torowa 2 |98-200 Sieradz;120;59;59;15;44;49.17;25.42
90710;101402;Szkoła Podstawowa w Błaszkach|Błaszki|Szkolna 1 |98-235 Błaszki;1879;869;869;24;845;46.25;2.76
90711;101402;Szkoła Podstawowa w Łubnej-Jakusy|Łubna-Jakusy| 30 a|98-235 Błaszki;817;281;281;19;262;34.39;6.76
90712;101402;Miejsko-Gminna Biblioteka Publiczna w Błaszkach|Błaszki|Sulwińskiego 35 |98-235 Błaszki;1547;662;662;27;635;42.79;4.08
90713;101402;Dom Parafialny "Albertówka" w Wojkowie|Wojków| 41 |98-235 Błaszki;1530;531;531;38;493;34.71;7.16
90714;101402;Świetlica Wiejska w Brończynie|Brończyn| 49 |98-235 Błaszki;712;281;281;8;273;39.47;2.85
90715;101402;Szkoła Podstawowa w Kwaskowie|Kwasków| 5 |98-235 Błaszki;681;303;303;10;293;44.49;3.30
90716;101402;Wiejska Świetlica Środowiskowo-Rekreacyjna w Sędzimirowicach|Sędzimirowice| 10 |98-235 Błaszki;814;262;262;17;245;32.19;6.49
90717;101402;Szkoła Podstawowa w Kalinowej|Kalinowa| 86 |98-235 Błaszki;930;364;364;16;348;39.14;4.40
90718;101402;Publiczne Gimnazjum w Błaszkach|Błaszki|Pomorska 6 |98-235 Błaszki;701;319;319;9;310;45.51;2.82
90719;101402;Szkoła Podstawowa w Gruszczycach|Gruszczyce| 45 |98-235 Błaszki;1484;627;627;22;605;42.25;3.51
90720;101402;Szkoła Podstawowa w Domaniewie|Domaniew| 53 |98-235 Błaszki;919;302;302;14;288;32.86;4.64
90721;101403;Szkoła Podstawowa w Brąszewicach|Brąszewice|Sieradzka 98 |98-277 Brąszewice;1475;695;695;32;663;47.12;4.60
90722;101403;Publiczna Szkoła Podstawowa SPSK w Chajewie|Chajew| 44 |98-277 Brąszewice;450;204;204;14;190;45.33;6.86
90723;101403;Szkoła Podstawowa w Godynicach|Godynice| 17 |98-277 Brąszewice;1031;445;445;20;425;43.16;4.49
90724;101403;Szkoła Podstawowa w Żurawiu|Żuraw| 18 |98-277 Brąszewice;576;232;232;5;227;40.28;2.16
90725;101404;Szkoła Podstawowa w Brzeźniu|Brzeźnio|Bronisławów ul.Szkolna 2 |98-275 Brzeźnio;1183;610;610;13;597;51.56;2.13
90726;101404;Szkoła Podstawowa w Brzeźniu|Brzeźnio|Bronisławów ul.Szkolna 2 |98-275 Brzeźnio;1143;483;483;23;460;42.26;4.76
90727;101404;Szkoła Podstawowa w Barczewie|Barczew| 3 |98-275 Brzeźnio;1018;461;461;30;431;45.28;6.51
90728;101404;Szkoła Podstawowa w Kliczkowie Wielkim|Kliczków Wielki| 45a |98-275 Brzeźnio;939;422;422;22;400;44.94;5.21
90729;101404;Szkoła Podstawowa w Ostrowie|Ostrów| 21 |98-275 Brzeźnio;783;310;310;11;299;39.59;3.55
90730;101405;Zespół Szkół w Burzeninie|Burzenin|Sieradzka 11 |98-260 Burzenin;1442;689;689;35;654;47.78;5.08
90731;101405;Remiza OSP w Grabówce|Grabówka| 30A |98-260 Burzenin;591;250;250;11;239;42.30;4.40
90732;101405;Świetlica Wiejska w Niechmirowie|Niechmirów| 47 |98-260 Burzenin;763;289;289;10;279;37.88;3.46
90733;101405;Remiza OSP w Szczawnie|Szczawno| 8a |98-260 Burzenin;386;165;165;10;155;42.75;6.06
90734;101405;Remiza OSP w Woli Będkowskiej|Wola Będkowska| 40 |98-260 Burzenin;548;170;170;10;160;31.02;5.88
90735;101405;Świetlica Wiejska w Witowie|Witów|Wspólna 84 |98-260 Burzenin;766;306;306;14;292;39.95;4.58
90736;101405;Dom Pomocy Społecznej w Sieradzu Filia w Witowie|Witów|Wspólna 74 |98-260 Burzenin;21;9;9;0;9;42.86;0.00
90737;101406;Publiczne Gimnazjum im. Jana Pawła II w Goszczanowie|Goszczanów|Kaliska 13 |98-215 Goszczanów;1147;489;489;11;478;42.63;2.25
90738;101406;Remiza OSP w Woli Tłomakowej|Wola Tłomakowa| 74 |98-215 Goszczanów;624;217;217;5;212;34.78;2.30
90739;101406;Zespół Szkół w Chlewie|Chlewo| 51A |98-215 Goszczanów;903;319;319;26;293;35.33;8.15
90740;101406;Szkoła Podstawowa w Lipiczu|Lipicze| 44 |98-215 Goszczanów;531;165;165;10;155;31.07;6.06
90741;101406;Świetlica Wiejska w Poniatowie|Poniatów| 8 |98-215 Goszczanów;657;238;238;11;227;36.23;4.62
90742;101406;Szkoła Podstawowa w Kaszewie|Kaszew| 29 |98-215 Goszczanów;611;171;171;9;162;27.99;5.26
90743;101407;Zespół Szkół w Klonowej|Klonowa|ul. Złoczewska 4 |98-273 Klonowa;813;369;369;15;354;45.39;4.07
90744;101407;Gminny Ośrodek Kultury w Klonowej|Klonowa|ul. Czajkowska 1b |98-273 Klonowa;633;282;282;17;265;44.55;6.03
90745;101407;Szkoła Podstawowa w Kuźnicy Błońskiej|Kuźnica Błońska| 9 |98-273 Klonowa;347;125;125;6;119;36.02;4.80
90746;101407;Strażnica OSP w Owieczkach|Owieczki| 35 |98-273 Klonowa;562;199;199;7;192;35.41;3.52
90747;101408;Szkoła Podstawowa w Dąbrowie Wielkiej|Dąbrowa Wielka| 19 |98-200 Sieradz;921;444;444;29;415;48.21;6.53
90748;101408;Szkoła Podstawowa w Charłupi Małej|Charłupia Mała|Szkolna 15 |98-200 Sieradz;1770;927;927;25;902;52.37;2.70
90749;101408;Szkoła Podstawowa w Chojnem|Chojne|Główna 1 |98-200 Sieradz;1929;948;948;43;905;49.14;4.54
90750;101408;Szkoła Podstawowa w Kłocku|Kłocko| 11 |98-200 Sieradz;1124;555;555;24;531;49.38;4.32
90751;101408;Remiza OSP w Rudzie|Ruda| 106D |98-200 Sieradz;1100;479;479;23;456;43.55;4.80
90752;101408;Szkoła Podstawowa Rzechcie|Rzechta| 84 |98-200 Sieradz;1274;642;642;28;614;50.39;4.36
90753;101408;Dom Pomocy Społecznej w Biskupicach|Biskupice| 72 |98-200 Sieradz;48;19;19;5;14;39.58;26.32
90754;101409;Publiczne Gimnazjum w Warcie|Warta|Świętojańska 5 /sala A/|98-290 Warta;1342;653;653;39;614;48.66;5.97
90755;101409;Publiczne Gimnazjum w Warcie|Warta|Świętojańska 5 /sala B/|98-290 Warta;1339;731;731;23;708;54.59;3.15
90756;101409;Dom Ludowy w Małkowie|Małków| 75 |98-290 Warta;749;310;310;6;304;41.39;1.94
90757;101409;Szkoła Podstawowa w Jakubicach|Jakubice| 15 |98-290 Warta;698;262;262;9;253;37.54;3.44
90758;101409;Szkoła Podstawowa w Cielcach|Cielce| 16 |98-290 Warta;1157;435;435;16;419;37.60;3.68
90759;101409;Szkoła Podstawowa w Jeziorsku|Jeziorsko| 46 |98-290 Warta;772;297;297;10;287;38.47;3.37
90760;101409;Szkoła Podstawowa w Ustkowie|Ustków| 26 |98-290 Warta;681;245;245;19;226;35.98;7.76
90761;101409;OSP w Proboszczowicach|Proboszczowice| 35A |98-290 Warta;688;327;327;17;310;47.53;5.20
90762;101409;Zespół Szkół Publicznych w Rossoszycy(sala gimnastyczna)|Rossoszyca|ul. Sieradzka 7 |98-290 Warta;1446;659;659;20;639;45.57;3.03
90763;101409;Szkoła Podstawowa we Włyniu|Włyń| 10 |98-290 Warta;862;367;367;15;352;42.58;4.09
90764;101409;Szkoła Podstawowa w Raczkowie|Raczków| 23B |98-290 Warta;657;263;263;13;250;40.03;4.94
90765;101409;Centrum Psychiatryczne w Warcie|Warta|Sieradzka 3 |98-290 Warta;75;59;59;12;47;78.67;20.34
90766;101410;Publiczne Przedszkole im. Wróbelka Elemelka we Wróblewie|Wróblew| 55b |98-285 Wróblew;1784;851;851;33;818;47.70;3.88
90767;101410;Szkoła Podstawowa w Słomkowie Mokrym|Słomków Mokry| 23 |98-285 WRÓBLEW;1246;509;509;12;497;40.85;2.36
90768;101410;Szkoła Podstawowa w Charłupi Wielkiej|Charłupia Wielka| 116 |98-285 Wróblew;1277;495;495;18;477;38.76;3.64
90769;101410;Szkoła Podstawowa w Wągłczewie|Wągłczew| 4 |98-285 Wróblew;650;327;327;7;320;50.31;2.14
90770;101411;Szkoła Podstawowa w Złoczewie|Złoczew|Burzenińska 4/6 |98-270 Złoczew;1518;715;715;29;686;47.10;4.06
90771;101411;Publiczne Gminazjum w Złoczewie|Złoczew|Szkolna 18 |98-270 Złoczew;1232;576;576;28;548;46.75;4.86
90772;101411;Szkoła Podstawowa w Broszkach|Broszki| 4 |98-270 Złoczew;385;168;168;7;161;43.64;4.17
90773;101411;Szkoła Podstawowa w Złoczewie|Złoczew|Burzenińska 4/6 |98-270 Złoczew;747;330;330;14;316;44.18;4.24
90774;101411;Środowiskowy Dom Samopomocy w Grójcu Wielkim|Grójec Wielki| 24 |98-270 Złoczew;428;136;136;12;124;31.78;8.82
90775;101411;Szkoła Podstawowa w Unikowie|Uników| 4 |98-270 Złoczew;867;320;320;8;312;36.91;2.50
90776;101411;Szkoła Podstawowa w Stolcu|Stolec| 35 |98-270 Złoczew;683;326;326;26;300;47.73;7.98
90777;101501;Szkoła Podstawowa w Bolimowie|Bolimów|Sokołowska 24 |99-417 Bolimów;943;457;457;14;443;48.46;3.06
90778;101501;Szkoła Podstawowa w Huminie|Humin| 44A |99-417 Bolimów;460;174;174;7;167;37.83;4.02
90779;101501;Budynek byłej Szkoły Podstawowej w Kurabce|Kurabka| 23 |99-417 Bolimów;467;178;178;8;170;38.12;4.49
90780;101501;Szkoła Podstawowa w Kęszycach-Wsi|Kęszyce-Wieś| 50 |99-417 Bolimów;504;228;228;8;220;45.24;3.51
90781;101501;Szkoła Podstawowa w Bolimowie|Bolimów|Sokołowska 24 |99-417 Bolimów;846;388;388;12;376;45.86;3.09
90782;101502;Szkoła Podstawowa w Białyninie|Białynin| 50 |96-130 Głuchów;669;400;400;11;389;59.79;2.75
90783;101502;Urząd Gminy w Głuchowie|Głuchów|Aleja Klonowa 5 |96-130 Głuchów;1616;930;930;29;901;57.55;3.12
90784;101502;Świetlica Wiejska w Janisławicach|Janisławice| 49 |96-130 Głuchów;547;307;307;8;299;56.12;2.61
90785;101502;Szkoła Podstawowa w Wysokienicach|Wysokienice| 32 |96-130 Głuchów;1840;1079;1079;31;1048;58.64;2.87
90786;101503;Urząd Gminy w Godzianowie|Godzianów|ul. Klonowa 5 |96-126 Godzianów;1466;728;728;25;703;49.66;3.43
90787;101503;Strażnica OSP w Byczkach|Byczki| 108 |96-126 Godzianów;614;332;332;10;322;54.07;3.01
90788;101504;Urząd Gminy Kowiesy|Kowiesy| 85 |96-111 Kowiesy;501;223;223;6;217;44.51;2.69
90789;101504;Publiczne Gimnazjum w Jeruzalu|Jeruzal| 18 |96-111 Kowiesy;525;214;214;10;204;40.76;4.67
90790;101504;Świetlica wiejska w Woli Pękoszewskiej|Wola Pękoszewska| 72a |96-111 Kowiesy;460;197;197;12;185;42.83;6.09
90791;101504;Niepubliczna Szkoła Podstawowa w Turowej Woli|Turowa Wola| 20 |96-111 Kowiesy;451;182;182;6;176;40.35;3.30
90792;101504;Świetlica wiejska w Starym Wylezinie|Stary Wylezin| 12 |96-111 Kowiesy;511;215;215;13;202;42.07;6.05
90793;101505;Gminny Ośrodek Kultury, Sportu i Rekreacji w Lipcach Reymontowskich|Lipce Reymontowskie|ul. Reymonta 24 |96-127 Lipce Reymontowskie;1658;817;817;18;799;49.28;2.20
90794;101505;Szkoła Podstawowa w Mszadli|Mszadla| 98 |96-127 Lipce Reymontowskie;542;223;223;12;211;41.14;5.38
90795;101505;Szkoła Podstawowa w Drzewcach|Drzewce| 165 |96-127 Lipce Reymontowskie;466;226;226;5;221;48.50;2.21
90796;101506;Gimnazjum Świętego Wojciecha w Makowie|Maków|ul. Akacjowa 2 |96-124 Maków;1645;908;908;24;884;55.20;2.64
90797;101506;Szkoła Podstawowa w Dąbrowicach|Dąbrowice| 86 |96-124 Maków;883;428;428;10;418;48.47;2.34
90798;101506;Szkoła Podstawowa w Woli Makowskiej|Wola Makowska| 25B |96-124 Maków;751;359;359;8;351;47.80;2.23
90799;101506;Szkoła Podstawowa w Słomkowie|Słomków|ul.Główna 68 |96-124 Maków;502;226;226;4;222;45.02;1.77
90800;101506;Szkoła Podstawowa w Pszczonowie|Pszczonów| 53 |99-420 Łyszkowice;570;233;233;8;225;40.88;3.43
90801;101506;Szkoła Podstawowa w Świętych Laskach|Święte Laski| 63 |96-124 Maków;502;213;213;12;201;42.43;5.63
90802;101507;Szkoła Podstawowa im . Jana Antoniego Grabowskiego|Nowy Dwór| 60 |96-115 Nowy Kawęczyn;671;272;272;12;260;40.54;4.41
90803;101507;Gminna Biblioteka Publiczna w Nowym Kawęczynie|Nowy Kawęczyn| 31A |96-115 Nowy Kawęczyn;822;358;358;16;342;43.55;4.47
90804;101507;Gimnazjum im. Józefa Wybickiego|Strzyboga| 29 |96-115 Nowy Kawęczyn;755;407;407;11;396;53.91;2.70
90805;101507;Szkoła Podstawowa im. Armii Krajowej|Trzcianna| 14 |96-115 Nowy Kawęczyn;520;255;255;14;241;49.04;5.49
90806;101508;Szkoła Podstawowa w Dębowej Górze|Dębowa Góra| 42A |96-116 Dębowa Góra;772;395;395;6;389;51.17;1.52
90807;101508;Świetlica w Strobowie|Strobów| 19 |96-100 Skierniewice;442;164;164;7;157;37.10;4.27
90808;101508;Szkoła Podstawowa w Miedniewicach|Miedniewice| 88 |96-100 Skierniewice;1325;545;583;24;521;41.13;4.40
90809;101508;Szkoła Podstawowa w Mokrej Prawej|Mokra Prawa| 82A |96-100 Skierniewice;779;378;378;12;366;48.52;3.17
90810;101508;Szkoła Podstawowa w Sierakowicach Prawych|Sierakowice Prawe| 69A |96-100 Skierniewice;614;277;277;7;270;45.11;2.53
90811;101508;Gimnazjum w Żelaznej|Żelazna| 5 |96-116 Dębowa Góra;653;287;287;13;274;43.95;4.53
90812;101508;Szkoła Podstawowa w Mokrej Lewej|Mokra Lewa| 75A |96-100 Skierniewice;558;283;283;8;275;50.72;2.83
90813;101508;Strażnica OSP w Sierakowicach Lewych|Sierakowice Lewe| 38C |96-100 Skierniewice;674;326;326;8;318;48.37;2.45
90814;101509;Urząd Gminy w Słupi|Słupia| 136 |96-128 Słupia;1350;668;668;29;639;49.48;4.34
90815;101509;Zespół Szkół Ogólnokształcących w Winnej Górze|Winna Góra| 40 |96-128 Słupia;791;365;365;20;345;46.14;5.48
90816;101601;Zespół Szkół Nr 4|Tomaszów Mazowiecki|ul. Tomasza Ostrowskiego 14 |97-200 Tomaszów Mazowiecki;2198;1114;1114;17;1097;50.68;1.53
90817;101601;Urząd Miasta (dawna Fundacja Rozwoju Gminy Zelów)|Tomaszów Mazowiecki|ul. Warszawska 119 |97-200 Tomaszów Mazowiecki;1979;866;866;28;838;43.76;3.23
90818;101601;Zespół Przedszkolny, Przedszkole Nr 12|Tomaszów Mazowiecki|ul. Kombatantów 1/3 |97-200 Tomaszów Mazowiecki;2191;1140;1140;19;1121;52.03;1.67
90819;101601;Zespół Szkolno-Przedszkolny Nr 1|Tomaszów Mazowiecki|ul. J.U. Niemcewicza 50/56 |97-200 Tomaszów Mazowiecki;2054;894;894;38;856;43.52;4.25
90820;101601;Zespół Szkół Ponadgimnazjalnych Nr 8|Tomaszów Mazowiecki|ul. Nadrzeczna 17/25 |97-200 Tomaszów Mazowiecki;2310;1034;1034;24;1010;44.76;2.32
90821;101601;Zespół Przedszkolny, Przedszkole Nr 3|Tomaszów Mazowiecki|ul. Kombatantów 5 |97-200 Tomaszów Mazowiecki;2102;1109;1109;30;1079;52.76;2.71
90822;101601;Zespół Placówek Wychowania Pozaszkolnego|Tomaszów Mazowiecki|ul. Farbiarska 20 |97-200 Tomaszów Mazowiecki;2121;986;986;16;970;46.49;1.62
90823;101601;ZHP Chorągiew Łódzka Komenda Hufca|Tomaszów Mazowiecki|ul. Niebrowska 14 |97-200 Tomaszów Mazowiecki;2177;1038;1038;7;1031;47.68;0.67
90824;101601;Specjalny Ośrodek Szkolno-Wychowawczy|Tomaszów Mazowiecki|ul. Majowa 1/13 |97-200 Tomaszów Mazowiecki;2120;1090;1090;26;1064;51.42;2.39
90825;101601;Zespół Szkół Nr 8|Tomaszów Mazowiecki|ul. Gminna 5/9 |97-200 Tomaszów Mazowiecki;2189;1123;1123;27;1096;51.30;2.40
90826;101601;Miejska Biblioteka Publiczna Oddział dla Dzieci i Młodzieży|Tomaszów Mazowiecki|ul. Plac Kościuszki 18 |97-200 Tomaszów Mazowiecki;2168;792;792;31;761;36.53;3.91
90827;101601;Zespół Szkół Ponadgimnazjalnych Nr 1|Tomaszów Mazowiecki|ul. Św. Antoniego 29 |97-200 Tomaszów Mazowiecki;2215;1038;1038;24;1014;46.86;2.31
90828;101601;Zespół Szkolno-Przedszkolny Nr 6, Przedszkole Nr 2|Tomaszów Mazowiecki|ul. Stefana Czarnieckiego 12/14 |97-200 Tomaszów Mazowiecki;2096;1154;1154;21;1133;55.06;1.82
90829;101601;Zespół Szkolno-Przedszkolny Nr 5, Szkoła Podstawowa Nr 8|Tomaszów Mazowiecki|ul. Stolarska 21/27 |97-200 Tomaszów Mazowiecki;2307;1164;1164;12;1152;50.46;1.03
90830;101601;Gimnazjum Nr 7|Tomaszów Mazowiecki|ul. Św. Antoniego 43/45 |97-200 Tomaszów Mazowiecki;2415;1203;1203;29;1174;49.81;2.41
90831;101601;Zespół Szkolno-Przedszkolny Nr 2, Szkoła Podstawowa Nr 12|Tomaszów Mazowiecki|ul. Wiejska 29/31 |97-200 Tomaszów Mazowiecki;2285;1275;1275;19;1256;55.80;1.49
90832;101601;Gimnazjum Nr 6|Tomaszów Mazowiecki|ul. Jałowcowa 8 |97-200 Tomaszów Mazowiecki;2278;1136;1136;21;1115;49.87;1.85
90833;101601;Zespół Szkolno-Przedszkolny Nr 6, Szkoła Podstawowa Nr 14|Tomaszów Mazowiecki|ul. J. Słowackiego 32/42 |97-200 Tomaszów Mazowiecki;2346;1255;1255;22;1233;53.50;1.75
90834;101601;Zespół Szkolno-Przedszkolmy Nr 4, Szkoła Podstawowa Nr 1|Tomaszów Mazowiecki|ul. Leona Witolda May'a 11/13 |97-200 Tomaszów Mazowiecki;2055;1201;1201;18;1183;58.44;1.50
90835;101601;Zespół Szkolno-Przedszkolny Nr 4, Przedszkole Nr 20|Tomaszów Mazowiecki|ul. Gen. Władysława Sikorskiego 6A |97-200 Tomaszów Mazowiecki;2322;1366;1366;25;1341;58.83;1.83
90836;101601;Ośrodek Sportu i Rekreacji - Kręgielnia|Tomaszów Mazowiecki|ul. Strzelecka 24/26 |97-200 Tomaszów Mazowiecki;2191;1200;1200;25;1175;54.77;2.08
90837;101601;Zespół Szkolno-Przedszkolny Nr 3, Szkoła Podstawowa Nr 7|Tomaszów Mazowiecki|ul. Ludwikowska 113/115 |97-200 Tomaszów Mazowiecki;2262;1126;1126;24;1102;49.78;2.13
90838;101601;Ośrodek Rehabilitacji Dzieci Niepełnosprawnych|Tomaszów Mazowiecki|ul. Jana Pawła II 64/66 |97-200 Tomaszów Mazowiecki;2216;1253;1253;24;1229;56.54;1.92
90839;101601;Tomaszowskie Centrum Zdrowia Spółka z o.o.|Tomaszów Mazowiecki|Jana Pawła II 35 |97-200 Tomaszów Mazowiecki;278;68;68;3;65;24.46;4.41
90840;101601;Dom Pomocy Społecznej Nr 1|Tomaszów Mazowiecki|Polna 56 |97-200 Tomaszów Mazowiecki;70;36;36;12;24;51.43;33.33
90841;101601;Dom Pomocy Społecznej Nr 1 - filia|Tomaszów Mazowiecki|Farbiarska 27/29 |97-200 Tomaszów Mazowiecki;63;37;38;7;30;58.73;18.92
90842;101601;Dom Pomocy Społecznej Nr 2|Tomaszów Mazowiecki|Jana Pawła II 37 |97-200 Tomaszów Mazowiecki;112;40;40;2;38;35.71;5.00
90843;101601;Nu-Med Centrum Diagnostyki i Terapii Onkologicznej Spółka z o.o.|Tomaszów Mazowiecki|Jana Pawła II 35 |97-200 Tomaszów Mazowiecki;20;19;19;0;19;95.00;0.00
90844;101602;Zespół Szkolno-Gimnazjalny|Będków|Reymonta 11 |97-319 Będków;1027;558;558;17;541;54.33;3.05
90845;101602;Zespół Szkolno-Gimnazjalny|Będków|Reymonta 11 |97-319 Będków;1082;556;556;17;539;51.39;3.06
90846;101602;Warsztaty Terapii Zajęciowej|Rudnik| 10 |97-319 Będków;679;344;344;14;330;50.66;4.07
90847;101603;Sala konferencyjna Urzędu Gminy w Budziszewicach|Budziszewice|ul. Jana Chryzostoma Paska 66 |97-212 Budziszewice;806;433;433;23;410;53.72;5.31
90848;101603;Punkt Przedszkolny w Rękawcu|Rękawiec| 13 |97-212 Budziszewice;565;243;243;13;230;43.01;5.35
90849;101603;Świetlica wiejska w Węgrzynowicach|Węgrzynowice| 68 |97-212 Budziszewice;430;201;201;6;195;46.74;2.99
90850;101604;Publiczna Szkoła Podstawowa w Czerniewicach|Czerniewice|ul. Mazowiecka 88 |97-216 Czerniewice;1096;497;497;21;476;45.35;4.23
90851;101604;Publiczna Szkoła Podstawowa w Lipiu|Lipie| 45 |97-216 Czerniewice;1137;413;413;20;393;36.32;4.84
90852;101604;Świetlica Środowiskowa w Podkonicach Dużych|Podkonice Duże| 13A |97-216 Czerniewice;903;416;416;16;400;46.07;3.85
90853;101604;Urząd Gminy w Czerniewicach|Czerniewice|ul. Mazowiecka 42 |97-216 Czerniewice;1058;452;452;23;429;42.72;5.09
90854;101605;Publiczna Szkoła Podstawowa im. Juliana Tuwima w Inowłodzu|Inowłódz|Spalska 5 |97-215 Inowłódz;1247;637;637;39;598;51.08;6.12
90855;101605;Szkoła Podstawowa w Królowej Woli|Królowa Wola| 77 |97-215 Inowłódz;655;357;357;13;344;54.50;3.64
90856;101605;Szkoła Podstawowa w Brzustowie|Brzustów| 1 |97-215 Inowłódz;719;297;297;25;272;41.31;8.42
90857;101605;Świetlica Środowiskowa w Spale|Spała|Wojciechowskiego 9 |97-215 Inowłódz;603;330;330;12;318;54.73;3.64
90858;101606;Zespół Szkolno-Przedszkolny|Lubochnia|ul.Łódzka 19 |97-217 Lubochnia;1040;514;514;22;492;49.42;4.28
90859;101606;Publiczne Gimnazjum w Lubochni|Lubochnia|ul.Łódzka 19 |97-217 Lubochnia;759;368;368;11;357;48.48;2.99
90860;101606;Publiczna Szkoła Podstawowa w Glinniku|Glinnik| 48A |97-217 Lubochnia;808;395;395;16;379;48.89;4.05
90861;101606;Budynek OSP|Nowy Jasień| 6 |97-217 Lubochnia;497;236;236;13;223;47.48;5.51
90862;101606;Świetlica Środowiskowa|Tarnowska Wola| 5 |97-217 Lubochnia;350;163;163;13;150;46.57;7.98
90863;101606;Klub Garnizonowy|Nowy Glinnik| 6G |97-217 Lubochnia;910;490;490;15;475;53.85;3.06
90864;101606;Urząd Gminy Lubochnia|Lubochnia, Lubochnia Dworska|ul.Tomaszowska 9 |97-217 Lubochnia;1137;557;557;22;535;48.99;3.95
90865;101607;Urząd Gminy w Rokicinach|Rokiciny-Kolonia|ul.Tomaszowska 9 |97-221 Rokiciny;2132;1186;1186;35;1151;55.63;2.95
90866;101607;Szkoła Podstawowa w Łaznowie|Łaznów| 65 |97-221 Rokiciny;1548;758;758;26;732;48.97;3.43
90867;101607;Gminne Przedszkole w Rokicinach Oddział Przedszkolny w Jankowie|Janków Trzeci| 6 |97-221 Rokiciny;639;223;223;9;214;34.90;4.04
90868;101607;Świetlica Wiejska w Nowych Chrustach|Nowe Chrusty|ul.Główna 19 |97-221 Rokiciny;731;386;386;22;364;52.80;5.70
90869;101607;Dom opieki "Zacisze" w Łaznowskiej Woli|Łaznowska Wola|Południowa 29 |97-221 Rokiciny;88;16;16;4;12;18.18;25.00
90870;101608;Publiczna Szkoła Podstawowa w Rzeczycy Filia w Sadykierzu|Sadykierz| 51 |97-220 Rzeczyca;1338;556;556;37;519;41.55;6.65
90871;101608;Publiczna Szkoła Podstawowa w Rzeczycy Filia w Luboczy|Lubocz| 3 |97-220 Rzeczyca;811;326;326;19;307;40.20;5.83
90872;101608;Publiczna Szkoła Podstawowa w Rzeczycy|Rzeczyca|ul. J. Kitowicza 4 |97-220 Rzeczyca;1007;481;481;23;458;47.77;4.78
90873;101608;Publiczna Szkoła Podstawowa w Rzeczyca|Rzeczyca|ul. J.Kitowicza 4 |97-220 Rzeczyca;801;372;372;26;346;46.44;6.99
90874;101609;Dom Ludowy w Komorowie|Komorów|ul. Biblioteczna 1 |97-200 Tomaszów Maz.;1230;610;610;14;596;49.59;2.30
90875;101609;Biblioteka w Wiadernie|Wiaderno| 89 |97-200 Tomaszów Maz.;1177;571;571;18;553;48.51;3.15
90876;101609;Zespół Szkół w Zawadzie|Zawada| 249/255 |97-200 Tomaszów Maz.;1079;508;508;12;496;47.08;2.36
90877;101609;Zespół Szkolno-Przedszkolny w Smardzewicach (szkoła)|Smardzewice|ul.Główna 10 |97-213 Smardzewice;1177;631;631;11;620;53.61;1.74
90878;101609;Zespół Szkolno-Przedszkolny w Smardzewicach (przedszkole)|Smardzewice|ul.Główna 10 |97-213 Smardzewice;602;341;341;13;328;56.64;3.81
90879;101609;Zespół Szkolno-Przedszkolny w Smardzewicach Oddział w Twardej (przedszkole)|Twarda|ul.Główna 117 |97-213 Smardzewice;601;296;296;5;291;49.25;1.69
90880;101609;Dom Ludowy w Ciebłowicach Dużych|Ciebłowice Duże| 132a |97-200 Tomaszów Maz.;580;260;260;7;253;44.83;2.69
90881;101609;Publiczne Przedszkole w Wąwale|Wąwał|ul. Tomaszowska 2 |97-200 Tomaszów Maz.;1078;510;510;24;486;47.31;4.71
90882;101609;Szkoła Podstawowa w Chorzęcinie|Chorzęcin| 75 |97-200 Tomaszów Maz.;1028;464;464;12;452;45.14;2.59
90883;101610;Gminna Hala Sportowa w Ujeździe|Ujazd|ul. Rokicińska 6 |97-225 Ujazd;989;539;539;18;521;54.50;3.34
90884;101610;Przedszkole Samorządowe|Ujazd|ul. Kościelna 24 |97-225 Ujazd;734;332;332;14;318;45.23;4.22
90885;101610;Świetlica Wiejska w Olszowej|Olszowa| 11A |97-225 Ujazd;714;313;313;11;302;43.84;3.51
90886;101610;Świetlica Wiejska w Bukowie|Buków| 6 |97-225 Ujazd;943;367;367;12;355;38.92;3.27
90887;101610;Gminny Ośrodek Kultury w Ujeździe|Osiedle Niewiadów| 43 |97-225 Ujazd;898;379;379;18;361;42.20;4.75
90888;101610;Gminny Ośrodek Kultury w Ujeździe|Osiedle Niewiadów| 43 |97-225 Ujazd;881;475;475;13;462;53.92;2.74
90889;101610;Ochotnicza Straż Pożarna w Przesiadłowie|Przesiadłów| 31 |97-225 Ujazd;799;383;383;11;372;47.93;2.87
90890;101610;Świetlica Wiejska w Zaosiu|Zaosie| 34a |97-225 Ujazd;420;206;206;13;193;49.05;6.31
90891;101611;Gminny Dom Kultury w Żelechlinku|Żelechlinek|ul. Plac Tysiąclecia 2 |97-226 Żelechlinek;839;415;415;15;400;49.46;3.61
90892;101611;Gminny Dom Kultury w Żelechlinku|Żelechlinek|ul. Plac Tysiąclecia 2 |97-226 Żelechlinek;848;377;377;14;363;44.46;3.71
90893;101611;Świetlica Wiejska w Radwance|Radwanka| 1 |97-226 Żelechlinek;541;291;291;9;282;53.79;3.09
90894;101611;Dom Ludowy w Naropnej|Naropna| 1 |97-226 Żelechlinek;473;225;225;16;209;47.57;7.11
90895;101701;Gminny Ośrodek Kultury i Sportu w Białej|Biała Druga| 4A |98-350 Biała;603;273;273;12;261;45.27;4.40
90896;101701;Urząd Gminy Biała|Biała Druga| 4B |98-350 Biała;548;245;245;7;238;44.71;2.86
90897;101701;Remiza OSP w Białej Rządowej|Biała Rządowa| 97A |98-350 Biała;689;323;323;6;317;46.88;1.86
90898;101701;Dom Ludowy w Kopydłowie|Kopydłów| 36 |98-350 Biała;180;62;62;4;58;34.44;6.45
90899;101701;Gminne Centrum Informacji w Łyskorni|Łyskornia| 55 |98-350 Biała;710;274;274;18;256;38.59;6.57
90900;101701;Publiczna Szkoła Podstawowa w Młynisku|Młynisko| 39 |98-350 Biała;597;248;248;15;233;41.54;6.05
90901;101701;Publiczna Szkoła Podstawowa w Naramicach|Naramice| 125 |98-350 Biała;1124;458;458;13;445;40.75;2.84
90902;101702;Szkoła Podstawowa w Czarnożyłach|Czarnożyły| 17a |98-310 Czarnożyły;1269;625;625;23;602;49.25;3.68
90903;101702;Szkoła Podstawowa w Łagiewnikach|Łagiewniki| 89 |98-310 Czarnożyły;994;423;423;16;407;42.56;3.78
90904;101702;Świetlica Wiejska w Wydrzynie|Wydrzyn| 59a |98-310 Czarnożyły;1008;452;452;17;435;44.84;3.76
90905;101702;Specjalny Ośrodek Szkolno-Wychowawczy w Gromadzicach|Gromadzice| 49 |98-310 Czarnożyły;389;172;172;5;167;44.22;2.91
90906;101703;Urząd Gminy Konopnica|Konopnica|Rynek 15 |98-313 Konopnica;958;459;459;18;441;47.91;3.92
90907;101703;Szkoła Podstawowa|Rychłocice| 108a |98-313 Konopnica;738;345;345;16;329;46.75;4.64
90908;101703;Szkoła Podstawowa|Szynkielów| 53 |98-313 Konopnica;704;344;344;16;328;48.86;4.65
90909;101703;Remiza OSP|Kamyk| 43 |98-313 Konopnica;193;85;85;2;83;44.04;2.35
90910;101703;Remiza OSP|Wrońsko| 29 |98-313 Konopnica;275;133;133;5;128;48.36;3.76
90911;101703;Środowiskowy Dom Samopomocy|Strobin| 34 |98-313 Konopnica;334;140;140;7;133;41.92;5.00
90912;101704;Zespół Szkół i Przedszkola w Mokrsku|Mokrsko| 254 |98-345 Mokrsko;1279;556;556;22;534;43.47;3.96
90913;101704;Świetlica Wiejska w Chotowie|Chotów| 94b |98-345 Mokrsko;403;191;191;13;178;47.39;6.81
90914;101704;Zespół Szkoły i Przedszkola w Krzyworzece|Krzyworzeka| 166 |98-345 Mokrsko;807;360;360;9;351;44.61;2.50
90915;101704;Świetlica Wiejska w Komornikach|Komorniki| 7a |98-345 Mokrsko;795;400;400;18;382;50.31;4.50
90916;101704;Zespół Szkoły i Przedszkola w Ożarowie|Ożarów| 142 |98-345 Mokrsko;802;372;372;13;359;46.38;3.49
90917;101704;Świetlica Wiejska w Słupsku|Słupsko| 29a |98-345 Mokrsko;281;143;143;8;135;50.89;5.59
90918;101705;Publiczne Gimnazjum w Osjakowie|Osjaków|Wieluńska 14 |98-320 Osjaków;673;293;293;5;288;43.54;1.71
90919;101705;Remiza OSP|Czernice|Czernice 23 |98-320 Osjaków;490;207;207;6;201;42.24;2.90
90920;101705;Oddział Przedszkolny|Kolonia Raducka|Kolonia Raducka 41 |98-320 Osjaków;475;219;219;9;210;46.11;4.11
90921;101705;Oddział Przedszkolny|Drobnice|Drobnice 51 |98-320 Osjaków;550;269;269;9;260;48.91;3.35
90922;101705;Oddział Przedszkolny|Chorzyna|Chorzyna 27 |98-320 Osjaków;573;244;244;12;232;42.58;4.92
90923;101705;Gminna Biblioteka Publiczna w Osjakowie|Osjaków|Częstochowska 22 |98-320 Osjaków;1083;590;590;21;569;54.48;3.56
90924;101706;Gminny Ośrodek Upowszechniania Kultury i Sportu w Ostrówku|Ostrówek| 94 |98-311 Ostrówek;851;409;409;11;398;48.06;2.69
90925;101706;Szkoła Podstawowa w Janowie|Janów| 40 |98-311 Ostrówek;639;268;268;12;256;41.94;4.48
90926;101706;Szkoła Podstawowa w Okalewie|Okalew| 19 |98-311 Ostrówek;698;264;264;9;255;37.82;3.41
90927;101706;Szkoła Podstawowa w Skrzynnie|Skrzynno| 96 |98-311 Ostrówek;742;289;289;11;278;38.95;3.81
90928;101706;Filia Przedszkola Ostrówek w Wielgiem|Wielgie| 27 |98-311 Ostrówek;633;296;296;13;283;46.76;4.39
90929;101706;Dom Pomocy Społecznej w Skrzynnie|Skrzynno| 13 |98-311 Ostrówek;82;40;40;12;28;48.78;30.00
90930;101707;Remiza OSP w Bieńcu|Bieniec| 9A |98-335 Pątnów;428;203;203;10;193;47.43;4.93
90931;101707;Zespół Szkół Samorządowych im. Króla Władysława Jagiełły w Dzietrznikach|Dzietrzniki| 105 |98-335 Pątnów;852;429;429;19;410;50.35;4.43
90932;101707;Budynek byłego Zespołu Szkół Samorządowych - Szkoły Filialnej w Grębieniu|Grębień| 107 |98-335 Pątnów;573;251;251;13;238;43.80;5.18
90933;101707;Świetlica Wiejska w Kałużach|Kałuże| 20A |98-335 Pątnów;344;131;131;5;126;38.08;3.82
90934;101707;Remiza OSP w Kamionce|Kamionka| 38A |98-335 Pątnów;486;199;199;6;193;40.95;3.02
90935;101707;Zespół Szkół Samorządowych im. Władysława Stanisława Reymonta w Pątnowie|Pątnów| 105 |98-335 Pątnów;1153;582;582;19;563;50.48;3.26
90936;101707;Budynek byłego Zespołu Szkół Samorządowych - Szkoły Filialnej w Popowicach|Popowice| 57B |98-335 Pątnów;398;194;194;6;188;48.74;3.09
90937;101707;Zespół Szkół Samorządowych im. Jana Pawła II Wielkiego w Załęczu Małym|Załęcze Małe| 35 |98-335 Pątnów;665;272;272;12;260;40.90;4.41
90938;101707;Budynek byłego Zespołu Szkół Samorządowych - Szkoły Filialnej w Załęczu Wielkim|Załęcze Wielkie| 76A |98-335 Pątnów;330;148;148;2;146;44.85;1.35
90939;101708;Publiczne Przedszkole w Skomlinie|Skomlin|Trojanowskiego 2 |98-346 Skomlin;1345;612;613;34;578;45.50;5.56
90940;101708;Przedszkole w Wicherniku|Wichernik| 13 |98-346 Skomlin;504;228;228;10;218;45.24;4.39
90941;101708;Remiza OSP we Wróblewie|Wróblew| 44 |98-346 Skomlin;587;235;235;13;222;40.03;5.53
90942;101708;Remiza OSP w Toplinie|Toplin| 15 |98-346 Skomlin;262;98;99;4;94;37.40;4.08
90943;101709;Zespół Szkół nr 1 w Wieluniu|Wieluń|Wojska Polskiego 32 |98-300 Wieluń;1537;796;796;18;778;51.79;2.26
90944;101709;Szkoła Podstawowa nr 5 w Wieluniu|Wieluń|Traugutta 38 |98-300 Wieluń;1522;818;818;14;804;53.75;1.71
90945;101709;Zespół Szkół nr 2 w Wieluniu|Wieluń|Traugutta 12 |98-300 Wieluń;1178;618;619;16;602;52.46;2.59
90946;101709;Miejska i Gminna Biblioteka Publiczna w Wieluniu|Wieluń|Narutowicza 4 |98-300 Wieluń;1310;751;751;13;738;57.33;1.73
90947;101709;Liceum Ogólnokształcące SPSK w Wieluniu|Wieluń|Śląska 23 |98-300 Wieluń;1386;732;732;12;720;52.81;1.64
90948;101709;Powiatowy Młodzieżowy Dom Kultury i Sportu w Wieluniu|Wieluń|3 Maja 29 |98-300 Wieluń;1651;899;899;13;886;54.45;1.45
90949;101709;Gimnazjum nr 1 w Wieluniu|Wieluń|18 Stycznia 24 |98-300 Wieluń;1171;583;583;14;569;49.79;2.40
90950;101709;Wieluński Dom Kultury w Wieluniu|Wieluń|Krakowskie Przedmieście 5 |98-300 Wieluń;1331;604;604;8;596;45.38;1.32
90951;101709;Publiczne Przedszkole Nr 2 w Wieluniu|Wieluń|P.O.W. 14 |98-300 Wieluń;1129;543;543;7;536;48.10;1.29
90952;101709;Szkoła Podstawowa nr 2 w Wieluniu|Wieluń|Osiedle Wyszyńskiego 30A |98-300 Wieluń;1304;665;665;14;651;51.00;2.11
90953;101709;Szkoła Podstawowa nr 2 w Wieluniu|Wieluń|Osiedle Wyszyńskiego 30A |98-300 Wieluń;921;477;477;11;466;51.79;2.31
90954;101709;I Liceum Ogólnokształcące w Wieluniu|Wieluń|Nadodrzańska 4 |98-300 Wieluń;1100;598;598;7;591;54.36;1.17
90955;101709;I liceum Ogólnokształcące w Wieluniu|Wieluń|Nadodrzańska 4 |98-300 Wieluń;1178;541;541;4;537;45.93;0.74
90956;101709;Spółdzielczy Dom Kultury w Wieluniu|Wieluń|Osiedle Wyszyńskiego 41 |98-300 Wieluń;1059;529;529;12;517;49.95;2.27
90957;101709;Pawilon WSM w Wieluniu|Wieluń|Sadowa 13a |98-300 Wieluń;1180;559;559;15;544;47.37;2.68
90958;101709;Filia Biblioteczna MGBP w Dąbrowie|Dąbrowa|Św.Wawrzyńca 1 |98-300 Wieluń;1015;561;561;17;544;55.27;3.03
90959;101709;Szkoła Podstawowa w Kurowie|Kurów|Wieluńska 11 |98-300 Wieluń;686;345;345;10;335;50.29;2.90
90960;101709;Oddział Przedszkolny w Turowie|Turów| 13 |98-300 Wieluń;675;301;301;16;285;44.59;5.32
90961;101709;Szkoła Podstawowa w Masłowicach|Masłowice| 1 |98-300 Wieluń;1261;477;477;26;451;37.83;5.45
90962;101709;Szkoła Podstawowa w Sieńcu|Sieniec| 81b |98-300 Wieluń;912;363;363;3;360;39.80;0.83
90963;101709;Szkoła Podstawowa w Rudzie|Ruda|Długa 31 |98-300 Wieluń;1466;609;609;23;586;41.54;3.78
90964;101709;Szkoła Podstawowa w Gaszynie|Gaszyn|Harcerska 1 |98-300 Wieluń;736;351;351;9;342;47.69;2.56
90965;101709;Publiczna Szkoła Podstawowa SPSK w Kadłubie|Kadłub| 91 |98-300 Wieluń;442;227;227;2;225;51.36;0.88
90966;101709;SP ZOZ w Wieluniu|Wieluń|Szpitalna 16 |98-300 Wieluń;120;59;59;2;57;49.17;3.39
90967;101710;Urząd Gminy w Wierzchlesie|Wierzchlas|Szkolna 7 |98-324 Wierzchlas;1545;597;597;24;573;38.64;4.02
90968;101710;Szkoła Podstawowa w Kraszkowicach|Kraszkowice|Szkolna 5 |98-324 Wierzchlas;870;369;369;16;353;42.41;4.34
90969;101710;Remiza OSP w Krzeczowie|Krzeczów|Wczasowa 3 |98-324 Wierzchlas;459;198;198;7;191;43.14;3.54
90970;101710;Szkoła Podstawowa w Mierzycach|Mierzyce| 149 |98-324 Wierzchlas;809;360;360;8;352;44.50;2.22
90971;101710;Szkoła Podstawowa w Łaszewie|Łaszew|Szkolna 12 |98-324 Wierzchlas;509;208;208;15;193;40.86;7.21
90972;101710;Szkoła Podstawowa w Toporowie|Toporów|Szkolna 6 |98-324 Wierzchlas;822;389;389;12;377;47.32;3.08
90973;101710;Szkoła Podstawowa w Strugach|Jajczaki| 10 |98-324 Wierzchlas;390;153;153;9;144;39.23;5.88
90974;101801;Gminny Ośrodek Kultury w Bolesławcu|Bolesławiec|Rynek 4 |98-430 Bolesławiec;1381;592;592;20;572;42.87;3.38
90975;101801;Szkoła Podstawowa w Mieleszynie|Mieleszyn| 141 |98-430 Bolesławiec;542;229;229;9;220;42.25;3.93
90976;101801;Szkoła Podstawowa w Chróścinie|Chróścin| 49 |98-430 Bolesławiec;703;273;273;11;262;38.83;4.03
90977;101801;Szkoła Podstawowa w Żdżarach|Żdżary| 123 |98-430 Bolesławiec;739;317;317;20;297;42.90;6.31
90978;101802;Sala OSP w Czastarach|Czastary|Wolności 36 |98-410 Czastary;1890;817;817;43;774;43.23;5.26
90979;101802;Szkoła Podstawowa w Parcicach|Parcice|Dworska 60 |98-410 Czastary;829;324;324;11;313;39.08;3.40
90980;101802;Szkoła Podstawowa w Radostowie Pierwszym|Radostów Pierwszy| 53 |98-410 Czastary;451;165;165;8;157;36.59;4.85
90981;101803;Szkoła Podstawowa w Galewicach|Galewice|M. Konopnickiej 22 |98-405 Galewice;1845;752;752;19;733;40.76;2.53
90982;101803;Wiejski Dom Kultury w Osieku|Osiek| 105a |98-405 Galewice;906;381;381;11;370;42.05;2.89
90983;101803;Świetlica Wiejska w Węglewicach|Węglewice|M.Kopernika 8 |98-405 Galewice;695;279;279;11;268;40.14;3.94
90984;101803;Szkoła Podstawowa w Ostrówku|Ostrówek| 15 |98-405 Galewice;1135;363;363;20;343;31.98;5.51
90985;101803;Szkoła Podstawowa w Biadaszkach|Biadaszki| 29A |98-405 Galewice;403;135;135;6;129;33.50;4.44
90986;101804;Szkoła Podstawowa w Lututowie|Lututów|Wieruszowska 28A |98-360 Lututów;796;409;409;11;398;51.38;2.69
90987;101804;Szkoła Podstawowa w Niemojewie|Lututów|Lipowa 19 |98-360 Lututów;715;344;344;9;335;48.11;2.62
90988;101804;Filialna Szkoła Podstawowa w Hucie|Huta| 46 |98-360 Lututów;454;183;183;5;178;40.31;2.73
90989;101804;Filialna Szkoła Podstawowa w Swobodzie|Swoboda| 6 |98-360 Lututów;442;193;193;6;187;43.67;3.11
90990;101804;Przedszkole Publiczne w Lututowie|Lututów|Wieruszowska 18 |98-360 Lututów;802;318;318;17;301;39.65;5.35
90991;101804;Gimnazjum Publiczne w Lututowie|Lututów|Jana Pawła Stalskiego 5 |98-360 Lututów;501;231;231;10;221;46.11;4.33
90992;101805;Centrum Kultury Wsi w Wójcinie|Wójcin|Świerczewskiego 4 |98-432 Łubnice;984;403;403;24;379;40.96;5.96
90993;101805;Zespół Szkół w Dzietrzkowicach|Dzietrzkowice|Szkolna 1 |98-432 Łubnice;1221;506;506;18;488;41.44;3.56
90994;101805;Centrum Kultury Wsi w Łubnicach|Łubnice|Sikorskiego 98 |98-432 Łubnice;1160;426;426;11;415;36.72;2.58
90995;101806;Gimnazjum Publiczne w Sokolnikach|Sokolniki|Szkolna 1 |98-420 Sokolniki;1880;861;861;16;845;45.80;1.86
90996;101806;Szkoła Podstawowa w Starym Ochędzynie|Stary Ochędzyn| 55 |98-420 Sokolniki;676;322;322;6;316;47.63;1.86
90997;101806;Sala Ochotniczej Straży Pożarnej w Walichnowach|Walichnowy|Aleja Wyzwolenia 8a |98-420 Sokolniki;717;330;330;14;316;46.03;4.24
90998;101806;Szkoła Podstawowa w Pichlicach|Pichlice| 1 |98-420 Sokolniki;680;272;272;9;263;40.00;3.31
90999;101807;Zespół Szkół Nr 2 w Wieruszowie|Wieruszów|Teklinowska 27 |98-400 Wieruszów;1000;531;531;18;513;53.10;3.39
91000;101807;Wieruszowski Dom Kultury|Wieruszów|Rynek 8/9 |98-400 Wieruszów;1586;846;846;16;830;53.34;1.89
91001;101807;Szkoła Podstawowa Nr 1 w Wieruszowie|Wieruszów|Fabryczna 1 |98-400 Wieruszów;1099;559;559;14;545;50.86;2.50
91002;101807;Gimnazjum Nr 1 w Wieruszowie|Wieruszów|Warszawska 123a |98-400 Wieruszów;1441;676;676;20;656;46.91;2.96
91003;101807;Gimnazjum Nr 1 w Wieruszowie|Wieruszów|Warszawska 123a |98-400 Wieruszów;1268;656;656;16;640;51.74;2.44
91004;101807;Zespół Szkół Ponadgimnazjalnych im. Stanisława Staszica|Wieruszów|Szkolna 1-3 |98-400 Wieruszów;586;344;344;5;339;58.70;1.45
91005;101807;Szkoła Podstawowa w Teklinowie|Teklinów| |98-400 Wieruszów;786;323;323;14;309;41.09;4.33
91006;101807;Budynek szkolny w Kuźnicy Skakawskiej|Kuźnica Skakawska| |98-400 Wieruszów;870;391;391;11;380;44.94;2.81
91007;101807;Szkoła Podstawowa w Pieczyskach|Pieczyska|Szkolna |98-400 Wieruszów;909;467;467;21;446;51.38;4.50
91008;101807;Budynek szkolny w Mirkowie|Mirków| |98-400 Wieruszów;472;247;247;12;235;52.33;4.86
91009;101807;Budynek szkolny w Cieszęcinie|Cieszęcin| |98-400 Wieruszów;551;239;239;11;228;43.38;4.60
91010;101807;Szkoła Podstawowa w Wyszanowie|Wyszanów| |98-400 Wieruszów;887;433;433;19;414;48.82;4.39
91011;101807;Powiatowe Centrum Medyczne Sp. z o.o. NZOZ Szpital Powiatowy w Wieruszowie|Wieruszów|Warszawska 104 |98-400 Wieruszów;44;18;18;1;17;40.91;5.56
91012;101901;Publiczne Gimnazjum nr 1|Zduńska Wola|Parkowa 5 |98-220 Zduńska Wola;1449;496;496;15;481;34.23;3.02
91013;101901;Zespół Szkół Zawodowych nr 1|Zduńska Wola|Żeromskiego 10 |98-220 Zduńska Wola;1567;762;762;15;747;48.63;1.97
91014;101901;Szkoła Podstawowa nr 10|Zduńska Wola|Zielona 46 a |98-220 Zduńska Wola;1475;744;744;11;733;50.44;1.48
91015;101901;Zespół Szkół Elektronicznych|Zduńska Wola|Łaska 61 |98-220 Zduńska Wola;1753;978;978;10;968;55.79;1.02
91016;101901;Powiatowe Centrum Kultury, Sportu i Rekreacji|Zduńska Wola|Dolna 41 |98-220 Zduńska Wola;1823;944;944;18;926;51.78;1.91
91017;101901;Publiczne Gimnazjum nr 1 Sala gimnastyczna|Zduńska Wola|Parkowa 5 |98-220 Zduńska Wola;1842;998;998;9;989;54.18;0.90
91018;101901;Hala Sportowa przy Zespole Szkolno-Przedszkolnym nr 1|Zduńska Wola|Złota 67 |98-220 Zduńska Wola;1523;820;820;15;805;53.84;1.83
91019;101901;Zespół Szkolno-Przedszkolny nr 1 - Szkoła Podstawowa nr 6|Zduńska Wola|Złota 67 |98-220 Zduńska Wola;1598;832;832;23;809;52.07;2.76
91020;101901;II Liceum Ogólnokształcące|Zduńska Wola|Komisji Edukacji Narodowej 6 |98-220 Zduńska Wola;1602;619;619;23;596;38.64;3.72
91021;101901;Publiczne Gimnazjum nr 5|Zduńska Wola|Wileńska 3 |98-220 Zduńska Wola;1626;878;878;13;865;54.00;1.48
91022;101901;Publiczne Przedszkole nr 2|Zduńska Wola|Getta Żydowskiego 17 a |98-220 Zduńska Wola;1685;910;910;26;884;54.01;2.86
91023;101901;Szkoła Podstawowa nr 7|Zduńska Wola|Wodna 32 |98-220 Zduńska Wola;1551;899;899;20;879;57.96;2.22
91024;101901;Publiczne Przedszkole nr 3|Zduńska Wola|Szadkowska 22 a |98-220 Zduńska Wola;1723;847;847;21;826;49.16;2.48
91025;101901;Zespół Szkół nr 1 z Oddziałami Integracyjnymi - Szkoła Podstawowa nr 9 z Oddziałami Integracyjnymi|Zduńska Wola|Kilińskiego 27 |98-220 Zduńska Wola;1522;834;834;13;821;54.80;1.56
91026;101901;Publiczne Przedszkole nr 6 z Oddziałami Integracyjnymi|Zduńska Wola|Żytnia 19/23 |98-220 Zduńska Wola;1622;868;868;12;856;53.51;1.38
91027;101901;Zespół Szkół Specjalnych|Zduńska Wola|Zielona 59 a |98-220 Zduńska Wola;1828;1083;1083;26;1057;59.25;2.40
91028;101901;Szkoła Podstawowa nr 2|Zduńska Wola|Spacerowa 90 |98-220 Zduńska Wola;1612;919;919;11;908;57.01;1.20
91029;101901;Publiczne Gimnazjum nr 2|Zduńska Wola|Łaska 84 |98-220 Zduńska Wola;1489;764;764;12;752;51.31;1.57
91030;101901;Świetlica|Zduńska Wola|Świerkowa 65 |98-220 Zduńska Wola;1695;859;859;20;839;50.68;2.33
91031;101901;Szkoła Podstawowa nr 13|Zduńska Wola|1-go Maja 27 |98-220 Zduńska Wola;1690;878;878;24;854;51.95;2.73
91032;101901;Filia Miejskiego Domu Kultury|Zduńska Wola|1-go Maja 5-7 |98-220 Zduńska Wola;1586;821;821;27;794;51.77;3.29
91033;101901;Dom Pomocy Społecznej|Zduńska Wola|Łaska 42 |98-220 Zduńska Wola;55;13;13;2;11;23.64;15.38
91034;101901;Zduńskowolski Szpital Powiatowy Sp. z o.o.|Zduńska Wola|Królewska 29 |98-220 Zduńska Wola;87;37;37;1;36;42.53;2.70
91035;101902;Gimnazjum Publiczne w Szadku|Szadek|Prusinowska 4 |98-240 Szadek;1642;807;807;26;781;49.15;3.22
91036;101902;Szkoła Podstawowa w Sikucinie|Sikucin| 1 |98-240 Szadek;824;312;312;17;295;37.86;5.45
91037;101902;Szkoła Podstawowa w Prusinowicach|Prusinowice| 49 |98-240 Szadek;819;304;304;18;286;37.12;5.92
91038;101902;Szkoła Podstawowa w Krokocicach|Krokocice| 2 |98-240 Szadek;583;251;251;7;244;43.05;2.79
91039;101902;Świetlica Wiejska w Górnej Woli|Górna Wola| 21A |98-240 Szadek;502;256;256;10;246;51.00;3.91
91040;101902;OSP w Przatowie|Przatów Dolny| 23 |98-240 Szadek;340;143;143;6;137;42.06;4.20
91041;101902;Miejsko-Gminny Ośrodek Kultury w Szadkowicach-Ogrodzimiu|Szadkowice-Ogrodzim|Widawska 16 |98-240 Szadek;1304;621;621;20;601;47.62;3.22
91042;101902;Dom Pomocy Społecznej w Przatówku|Przatówek| 1 |98-240 Szadek;38;25;25;4;21;65.79;16.00
91043;101903;Gminny Ośrodek Kultury i Sportu w Zapolicach|Zapolice|Główna 14 |98-161 Zapolice;2002;864;864;27;837;43.16;3.12
91044;101903;Remiza OSP w Paprotni|Paprotnia| 16 |98-161 Zapolice;728;340;340;10;330;46.70;2.94
91045;101903;Szkoła Społeczna w Rembieszowie|Rembieszów| 87 |98-161 Zapolice;778;311;311;13;298;39.97;4.18
91046;101903;Świetlica Wiejska w Swędzieniejewicach|Swędzieniejewice| 22a |98-161 Zapolice;619;252;252;22;230;40.71;8.73
91047;101904;Szkoła Podstawowa w Czechach|Czechy| 142 |98-220 Zduńska Wola;960;444;444;17;427;46.25;3.83
91048;101904;Szkoła Podstawowa w Izabelowie|Izabelów| 50 |98-220 Zduńska Wola;1487;742;742;34;708;49.90;4.58
91049;101904;Szkoła Podstawowa w Krobanowie|Krobanów| 12C |98-220 Zduńska Wola;1421;673;673;22;651;47.36;3.27
91050;101904;Szkoła Podstawowa w Annopolu Starym|Annopole Stare| 5A |98-220 Zduńska Wola;894;333;333;5;328;37.25;1.50
91051;101904;Szkoła Podstawowa w Janiszewicach|Janiszewice| 17 |98-220 Zduńska Wola;2178;1050;1050;28;1022;48.21;2.67
91052;101904;Gimnazjum w Czechach|Czechy| 142 |98-220 Zduńska Wola;1390;868;868;24;844;62.45;2.76
91053;101904;Szkoła Podstawowa w Wojsławicach|Wojsławice| 105 |98-220 Zduńska Wola;1039;428;428;7;421;41.19;1.64
91054;102001;Szkoła Podstawowa Nr 1 w Głownie|Głowno|ul. Plac Reymonta 2 |95-015 Głowno;1641;848;848;15;833;51.68;1.77
91055;102001;Szkoła Podstawowa Nr 2 w Głownie|Głowno|ul. Generała Andersa 37 |95-015 Głowno;1546;764;764;13;751;49.42;1.70
91056;102001;Gimnazjum Miejskie w Głownie|Głowno|ul. Kościuszki 11/13 |95-015 Głowno;1548;779;779;16;763;50.32;2.05
91057;102001;Urząd Miejski w Głownie|Głowno|ul. Dworska 4 |95-015 Głowno;1641;734;735;22;712;44.73;3.00
91058;102001;Szkoła Podstawowa Nr 3 w Głownie|Głowno|ul. Karasicka 35 |95-015 Głowno;1614;828;828;18;810;51.30;2.17
91059;102001;Szkoła Podstawowa Nr 2 w Głownie|Głowno|ul. Generała Andersa 37 |95-015 Głowno;862;422;422;9;413;48.96;2.13
91060;102001;Zespół Szkół nr 1 w Głownie|Głowno|ul. Kopernika 24/26 |95-015 Głowno;1462;772;772;15;757;52.80;1.94
91061;102001;Miejski Ośrodek Kultury w Głownie|Głowno|ul. Kopernika 37 |95-015 Głowno;845;404;404;8;396;47.81;1.98
91062;102001;Miejskie Przedszkole Nr 3 w Głownie|Głowno|ul. Skokowskiego 8/10 |95-015 Głowno;760;381;381;6;375;50.13;1.57
91063;102001;Centrum Zdrowia ABiS w Głownie|Głowno|Wojska Polskiego 32/34 |95-015 Głowno;24;11;11;0;11;45.83;0.00
91064;102001;Dom Pomocy Społecznej w Głownie|Głowno|Karasicka 51 |95-015 Głowno;48;28;28;3;25;58.33;10.71
91065;102001;"Medical" Sp. z o o Głowno|Głowno|Sosnowa 4 |95-015 Głowno;39;4;4;0;4;10.26;0.00
91066;102002;Szkoła Podstawowa Nr 5|Ozorków|Cegielniana 25 |95-035 Ozorków;1078;520;520;9;511;48.24;1.73
91067;102002;Szkoła Podstawowa Nr 5|Ozorków|Cegielniana 25 |95-035 Ozorków;1069;553;553;18;535;51.73;3.25
91068;102002;Przedszkole Miejskie Nr 1|Ozorków|Wigury 7a |95-035 Ozorków;1041;434;434;16;418;41.69;3.69
91069;102002;Szkoła Podstawowa Nr 5|Ozorków|Konarskiego 2 |95-035 Ozorków;1103;581;581;21;560;52.67;3.61
91070;102002;Gimnazjum Nr 1|Ozorków|Lotnicza 1 |95-035 Ozorków;1055;560;560;18;542;53.08;3.21
91071;102002;Szkoła Podstawowa Nr 5|Ozorków|Konarskiego 2 |95-035 Ozorków;1102;522;522;8;514;47.37;1.53
91072;102002;Gimnazjum Nr 1|Ozorków|Lotnicza 1 |95-035 Ozorków;1124;578;578;15;563;51.42;2.60
91073;102002;Przedszkole Miejskie Nr 4|Ozorków|Lotnicza 3 |95-035 Ozorków;1088;409;409;17;392;37.59;4.16
91074;102002;Przedszkole Miejskie Nr 5|Ozorków|Obrońców Westerplatte 1a |95-035 Ozorków;1091;477;477;24;453;43.72;5.03
91075;102002;Gimnazjum Nr 1|Ozorków|Lotnicza 1 |95-035 Ozorków;1076;575;575;15;560;53.44;2.61
91076;102002;Miejski Ośrodek Kultury|Ozorków|Wyszyńskiego 43a |95-035 Ozorków;1038;444;444;14;430;42.77;3.15
91077;102002;Młodzieżowy Dom Kultury|Ozorków|Listopadowa 6b |95-035 Ozorków;947;382;382;13;369;40.34;3.40
91078;102002;Szkoła Podstawowa Nr 4|Ozorków|Średnia 30 |95-035 Ozorków;1042;434;434;11;423;41.65;2.53
91079;102002;Szkoła Podstawowa Nr 4|Ozorków|Średnia 30 |95-035 Ozorków;1077;583;583;23;560;54.13;3.95
91080;102002;Przedszkole Miejskie Nr 3|Ozorków|Zgierska 15a |95-035 Ozorków;1053;511;511;10;501;48.53;1.96
91081;102002;Dom Pomocy Społecznej|Ozorków|Mickiewicza 1 |95-035 Ozorków;77;44;44;6;38;57.14;13.64
91082;102003;Szkoła Podstawowa Nr 12 im. Armii Krajowej Miejsko-Powiatowa Biblioteka Publiczna Filia nr 6|Zgierz|ul. L. Staffa 26 |95-100 Zgierz;1906;1144;1144;20;1124;60.02;1.75
91083;102003;Ośrodek Szkolno-Wychowawczy|Zgierz|ul. Parzęczewska 46 |95-100 Zgierz;1991;1163;1163;24;1139;58.41;2.06
91084;102003;Gimnazjum Nr 3 im. A. Mickiewicza|Zgierz|ul. B. Leśmiana 1 |95-100 Zgierz;1937;1160;1160;26;1134;59.89;2.24
91085;102003;Miejskie Przedszkole nr 2|Zgierz|ul. T. Boya-Żeleńskiego 6 |95-100 Zgierz;1879;1134;1134;18;1116;60.35;1.59
91086;102003;Szkoła Podstawowa nr 8|Zgierz|ul. T. Boya-Żeleńskiego 4 |95-100 Zgierz;1883;1119;1119;23;1096;59.43;2.06
91087;102003;Zgierska Spółdzielnia Mieszkaniowa|Zgierz|ul. Parzęczewska 21 |95-100 Zgierz;1955;1061;1062;20;1041;54.27;1.89
91088;102003;Szkoła Podstawowa Nr 12 im. Armii Krajowej|Zgierz|ul. L. Staffa 26 |95-100 Zgierz;1943;1178;1178;18;1160;60.63;1.53
91089;102003;Miejski Zespół Przychodni Rejonowych|Zgierz|ul. Łęczycka 24 |95-100 Zgierz;1057;499;499;13;486;47.21;2.61
91090;102003;Gimnazjum Nr 1|Zgierz|ul. A. Musierowicza 2 |95-100 Zgierz;988;552;552;15;537;55.87;2.72
91091;102003;Miejsko-Powiatowa Biblioteka Publiczna im. B. Prusa|Zgierz|ul. Łódzka 5 |95-100 Zgierz;1018;447;447;23;424;43.91;5.15
91092;102003;Miejski Żłobek im. "Koziołka Matołka"|Zgierz|ul. Tuwima 21 |95-100 Zgierz;990;572;572;17;555;57.78;2.97
91093;102003;Szkoła Podstawowa nr 1|Zgierz|ul. J. Piłsudskiego 1 |95-100 Zgierz;1116;597;597;13;584;53.49;2.18
91094;102003;Miejskie Przedszkole Nr 13 "Bajkowe Przedszkole"|Zgierz|ul. J. Słowackiego 8 |95-100 Zgierz;1028;476;476;19;457;46.30;3.99
91095;102003;Szkoła Podstawowa Nr 11|Zgierz|ul. S. Dubois 26 |95-100 Zgierz;1253;573;573;11;562;45.73;1.92
91096;102003;Zarząd Oddziału Związku Nauczycielstwa Polskiego|Zgierz|ul. ks. Sz. Rembowskiego 29 |95-100 Zgierz;923;458;458;15;443;49.62;3.28
91097;102003;Internat Zespołu Szkół Nr 1 im. J. S. Cezaka|Zgierz|ul. Długa (wejście od ul. ks. Sz. Rembowskiego) 89/91 |95-100 Zgierz;1071;558;558;12;546;52.10;2.15
91098;102003;Szkoła Podstawowa Nr 11|Zgierz|ul. S. Dubois 26 |95-100 Zgierz;1179;672;672;15;657;57.00;2.23
91099;102003;Zespół Szkół Ogólnokształcących im. S. Staszica|Zgierz|ul. 3 Maja 41 |95-100 Zgierz;1057;451;451;10;441;42.67;2.22
91100;102003;Gimnazjum Nr 2 im. J. Kochanowskiego|Zgierz|ul. 3 Maja 46A |95-100 Zgierz;1160;584;584;18;566;50.34;3.08
91101;102003;Zespół Szkół Ogólnokształcących im. S. Staszica|Zgierz|ul. 3 Maja 41 |95-100 Zgierz;952;378;378;7;371;39.71;1.85
91102;102003;Park Kulturowy Miasto Tkaczy|Zgierz|ul. ks. Sz. Rembowskiego 1 |95-100 Zgierz;1123;398;398;13;385;35.44;3.27
91103;102003;Szkoła Podstawowa Nr 5|Zgierz|ul. 1 Maja 63 |95-100 Zgierz;1901;1154;1155;21;1133;60.70;1.82
91104;102003;Szkoła Podstawowa Nr 5|Zgierz|ul. 1 Maja 63 |95-100 Zgierz;840;500;500;13;487;59.52;2.60
91105;102003;Państwowa Szkoła Muzyczna|Zgierz|ul. Sokołowska 4 |95-100 Zgierz;940;514;514;9;505;54.68;1.75
91106;102003;Starostwo Powiatowe w Zgierzu|Zgierz|ul. Sadowa 6A |95-100 Zgierz;774;500;500;3;497;64.60;0.60
91107;102003;Szkoła Podstawowa Nr 4 im. Jana Niepokoja|Zgierz|ul. Łódzka 2 |95-100 Zgierz;926;444;444;12;432;47.95;2.70
91108;102003;Miejskie Przedsiębiorstwo Gospodarki Komunalnej|Zgierz|ul. Wiosny Ludów 22 |95-100 Zgierz;666;321;321;5;316;48.20;1.56
91109;102003;Szkoła Podstawowa Nr 10|Zgierz|ul. Ozorkowska 68/70 |95-100 Zgierz;1435;780;780;12;768;54.36;1.54
91110;102003;Szkoła Podstawowa Nr 10|Zgierz|ul. Ozorkowska 68/70 |95-100 Zgierz;1428;840;840;23;817;58.82;2.74
91111;102003;Szkoła Podstawowa Nr 1|Zgierz|ul. J. Piłsudskiego 1 |95-100 Zgierz;1240;721;721;8;713;58.15;1.11
91112;102003;Szkoła Podstawowa Nr 3 im. Dąbrowszczaków|Zgierz|ul. Szczawińska 2 |95-100 Zgierz;1065;567;567;16;551;53.24;2.82
91113;102003;Szkoła Podstawowa Nr 3 im. Dąbrowszczaków|Zgierz|ul. Szczawińska 2 |95-100 Zgierz;1072;578;578;12;566;53.92;2.08
91114;102003;Miejskie Przedszkole Nr 10|Zgierz|ul. M. Ossowskiego 26 |95-100 Zgierz;1222;683;683;14;669;55.89;2.05
91115;102003;Miejskie Przedszkole Nr 10|Zgierz|ul. M. Ossowskiego 26 |95-100 Zgierz;996;567;567;12;555;56.93;2.12
91116;102003;Zespół Szkół Nr 1 im. J. S. Cezaka|Zgierz|ul. Długa 89/91 |95-100 Zgierz;1558;876;876;11;865;56.23;1.26
91117;102003;Centrum Rehabilitacyjno-Szkoleniowe|Zgierz|ul. Chełmska 42/42A |95-100 Zgierz;1030;615;615;15;600;59.71;2.44
91118;102003;Wojewódzki Szpital Specjalistyczny im. Marii Skłodowskiej-Curie w Zgierzu|Zgierz|Parzęczewska 35 |95-100 Zgierz;345;89;89;5;84;25.80;5.62
91119;102003;Centrum Medyczne Boruta Sp. z o.o. w Zgierzu|Zgierz|A. Struga 2-4 |95-100 Zgierz;16;13;13;0;13;81.25;0.00
91120;102003;Europejskie Centrum Opieki Medycznej i Pomocy Rodzinie "CARE" sp. z o.o. w Zgierzu|Zgierz|S. Dubois 17 |95-100 Zgierz;172;38;38;1;37;22.09;2.63
91121;102003;Dom Pomocy Społecznej w Zgierzu|Zgierz|Chełmska 16/18 |95-100 Zgierz;86;33;33;4;29;38.37;12.12
91122;102004;Zespół Szkół Sportowych im. Józefa Jaworskiego w Aleksandrowie Łódzkim|Aleksandrów Łódzki|ul. Bankowa 7 |95-070 Aleksandrów Łódzki;2196;1193;1193;28;1165;54.33;2.35
91123;102004;Miejski Zespół Szkół im. Jana Pawła II w Aleksandrowie Łódzkim|Aleksandrów Łódzki|ul. Ludwika Waryńskiego 22/26 |95-070 Aleksandrów Łódzki;1114;646;648;17;629;57.99;2.63
91124;102004;Miejski Zespół Szkół im. Jana Pawła II w Aleksandrowie Łódzkim|Aleksandrów Łódzki|ul. Ludwika Waryńskiego 22/26 |95-070 Aleksandrów Łódzki;1055;612;612;11;601;58.01;1.80
91125;102004;Miejski Zespół Szkół im. Jana Pawła II w Aleksandrowie Łódzkim|Aleksandrów Łódzki|ul. Ludwika Waryńskiego 22/26 |95-070 Aleksandrów Łódzki;1092;651;651;17;634;59.62;2.61
91126;102004;Spółdzielnia Mieszkaniowa w Aleksandrowie Łódzkim|Aleksandrów Łódzki|ul. Romana Dmowskiego 1 |95-070 Aleksandrów Łódzki;1242;780;780;11;769;62.80;1.41
91127;102004;Spółdzielnia Mieszkaniowa w Aleksandrowie Łódzkim|Aleksandrów Łódzki|ul. Romana Dmowskiego 1 |95-070 Aleksandrów Łódzki;1134;711;711;22;689;62.70;3.09
91128;102004;Szkoła Podstawowa nr 4 im. Marii Skłodowskiej-Curie w Aleksandrowie Łódzkim|Aleksandrów Łódzki|al. Wyzwolenia 3 |95-070 Aleksandrów Łódzki;2047;1097;1099;37;1060;53.59;3.37
91129;102004;Szkoła Podstawowa nr 4 im. Marii Skłodowskiej-Curie w Aleksandrowie Łódzkim|Aleksandrów Łódzki|al. Wyzwolenia 3 |95-070 Aleksandrów Łódzki;1998;1189;1191;9;1180;59.51;0.76
91130;102004;Młodzieżowy Dom Kultury w Aleksandrowie Łódzkim|Aleksandrów Łódzki|al. 1 Maja 17/19 |95-070 Aleksandrów Łódzki;1045;530;530;15;515;50.72;2.83
91131;102004;Centrum Pomocy Rodzinie i Usług Socjalnych|Aleksandrów Łódzki|ul. Warszawska 10 |95-070 Aleksandrów Łódzki;2071;1171;1171;57;1114;56.54;4.87
91132;102004;Urząd Miejski w Aleksandrowie Łódzkim|Aleksandrów Łódzki|Plac Kościuszki 2 |95-070 Aleksandrów Łódzki;1092;614;614;15;599;56.23;2.44
91133;102004;Urząd Miejski w Aleksandrowie Łódzkim|Aleksandrów Łódzki|Plac Kościuszki 2 |95-070 Aleksandrów Łódzki;1111;618;618;12;606;55.63;1.94
91134;102004;Szkoła Podstawowa im. Księdza Kardynała Stefana Wyszyńskiego Prymasa Tysiąclecia w Rąbieniu|Rąbień|Słowiańska 5 |95-070 Aleksandrów Łódzki;1430;936;936;4;932;65.45;0.43
91135;102004;Szkoła Podstawowa im. Księdza Kardynała Stefana Wyszyńskiego Prymasa Tysiąclecia w Rąbieniu|Rąbień|Słowiańska 5 |95-070 Aleksandrów Łódzki;1124;713;716;10;703;63.43;1.40
91136;102004;Szkoła Podstawowa z oddziałami integracyjnymi im. Janusza Korczaka w Rudzie Bugaj|Ruda Bugaj| 54 |95-070 Aleksandrów Łódzki;1585;881;881;11;870;55.58;1.25
91137;102004;Ochotnicza Straż Pożarna w Saniach|Sanie| 20 |95-070 Aleksandrów Łódzki;1563;804;804;17;787;51.44;2.11
91138;102004;Szkoła Podstawowa im. Ryszarda Wyrzykowskiego w Bełdowie|Bełdów| 37 |95-070 Aleksandrów Łodzki;1073;612;612;11;601;57.04;1.80
91139;102004;Dom Pomocy Społecznej w Rąbieniu|Rąbień AB| 59 |95-070 Aleksandrów Łódzki;46;11;11;5;6;23.91;45.45
91140;102005;Zespół Szkół Publicznych w Mąkolicach|Mąkolice| 96 |95-015 Głowno;894;477;477;22;455;53.36;4.61
91141;102005;Zespół Szkół w Popowie Głowieńskim|Popów Głowieński| 25 |95-015 Głowno;859;358;358;3;355;41.68;0.84
91142;102005;Ośrodek Upowszechniania Kultury w Bronisławowie|Bronisławów| 10 |95-015 Głowno;683;244;244;5;239;35.72;2.05
91143;102005;Środowiskowy Dom Samopomocy w Woli Zbrożkowej|Wola Zbrożkowa| 36 |95-015 Głowno;291;121;121;2;119;41.58;1.65
91144;102005;Zespół Szkół w Lubiankowie|Lubianków| 45 |95-015 Głowno;739;279;279;4;275;37.75;1.43
91145;102005;Zespół Szkół w Lubiankowie|Lubianków| 45 |95-015 Głowno;498;235;235;8;227;47.19;3.40
91146;102006;Gminny Ośrodek Kultury w Leśmierzu|Leśmierz| 23 |95-035 Ozorków;1044;456;456;26;430;43.68;5.70
91147;102006;Zespół Szkół w Modlnej|Modlna| 29 |95-035 Ozorków;824;450;450;18;432;54.61;4.00
91148;102006;Budynek komunalny-świetlica środowiskowa|Sokolniki Las|ul. Sokolnickiego 1 |95-039 Sokolniki Las;842;582;582;8;574;69.12;1.37
91149;102006;Budynek komunalny-sala|Helenów| 8 |95-035 Ozorków;849;405;405;12;393;47.70;2.96
91150;102006;Zespół Szkół w Solcy Wielkiej|Solca Wielka| 58 |95-035 Ozorków;1085;528;528;13;515;48.66;2.46
91151;102006;Budynek komunalny-świetlica środowiskowa|Skromnica| 22 |95-035 Ozorków;373;198;198;14;184;53.08;7.07
91152;102006;Budynek komunalny-świetlica środowiskowa|Sierpów| 87a |95-035 Ozorków;728;358;358;9;349;49.18;2.51
91153;102007;Forum Inicjatyw Twórczych w Parzęczewie|Parzęczew|ul. Ozorkowska Nr 3 |95-045 Parzęczew;796;369;369;17;352;46.36;4.61
91154;102007;Szkoła Podstawowa w Parzęczewie|Parzęczew|ul. Parkowa Nr 6 |95-045 Parzęczew;584;300;300;5;295;51.37;1.67
91155;102007;Wiejski Ośrodek Kultury w Śniatowej|Śniatowa| Nr 19 |95-045 Parzęczew;321;140;140;8;132;43.61;5.71
91156;102007;Budynek Ochotniczej Straży Pożarnej w Opolu|Opole| Nr 20 |95-043 Leźnica Wielka;359;151;151;5;146;42.06;3.31
91157;102007;Klub Garnizonowy w Leźnicy Wielkiej-Osiedle|Leźnica Wielka-Osiedle| Bl. Nr 1 |95-043 Leźnica Wielka;390;192;192;10;182;49.23;5.21
91158;102007;Budynek Ochotniczej Straży Pożarnej w Śliwnikach|Śliwniki| Nr 3 |95-045 Parzęczew;191;90;90;7;83;47.12;7.78
91159;102007;Szkoła Podstawowa w Chociszewie|Chociszew| Nr 40 |95-045 Parzęczew;691;316;316;12;304;45.73;3.80
91160;102007;Szkoła Podstawowa w Chociszewie|Chociszew| Nr 40 |95-045 Parzęczew;477;241;241;8;233;50.52;3.32
91161;102007;Budynek Ochotniczej Straży Pożarnej w Orłej|Orła| Nr 33 |95-073 Grotniki;279;156;156;11;145;55.91;7.05
91162;102008;Ośrodek Kultury i Rekreacji w Strykowie|Stryków|Plac Łukasińskiego 4 |95-010 Stryków;1670;842;842;24;818;50.42;2.85
91163;102008;Zespół Szkół Nr 1 w Strykowie|Stryków|ul.Targowa 21 |95-010 Stryków;1181;665;665;13;652;56.31;1.95
91164;102008;Świetlica wiejska w Ossem|Osse| 50 |95-010 Stryków;642;361;361;7;354;56.23;1.94
91165;102008;Zespół Szkół Nr 1 im. Batalionów Chłopskiech w Bratoszewicach|Bratoszewice|Plac Staszica 14 |95-011 Bratoszewice;1427;775;775;19;756;54.31;2.45
91166;102008;Szkoła Podstawowa im. gen. dyw. Tadeusza Kutrzeby w Koźlu|Koźle| 65 |95-011 Bratoszewice;731;330;330;17;313;45.14;5.15
91167;102008;Ochotnicza Straż Pożarna w Swędowie|Swędów|ul. Główna 31 |95-010 Stryków;907;487;487;14;473;53.69;2.87
91168;102008;Szkoła Podstawowa im. 24 Lutego 1863 r. w Dobrej|Dobra|ul. Witanówek 8 |95-010 Stryków;1329;689;689;15;674;51.84;2.18
91169;102008;Centrum Kształcenia i Wychowania OHP w Dobieszkowie|Dobieszków| 68 |95-010 Stryków;700;405;405;4;401;57.86;0.99
91170;102008;Szkoła Podstawowa im. Henryka Sienkiewicza w Niesułkowie|Niesułków| 68 |95-010 Stryków;707;313;313;5;308;44.27;1.60
91171;102008;Ochotnicza Straż Pożarna w Warszewicach|Warszewice| 20 |95-010 Stryków;756;405;405;8;397;53.57;1.98
91172;102009;Zespół Szkolno-Gimnazjalny w Grotnikach|Grotniki|ul. Brzozowa 4 |95-073 Grotniki;1711;947;947;9;938;55.35;0.95
91173;102009;Zespół Szkolno-Gimnazjalny w Słowiku|Słowik|ul.Gdańska 42 |95-100 Zgierz;1512;766;766;24;742;50.66;3.13
91174;102009;Świetlica Wiejska, Rosanów|Rosanów|ul. Długa 92 |95-100 Zgierz;838;525;525;5;520;62.65;0.95
91175;102009;Szkoła Podstawowa w Dąbrówce Wielkiej|Dąbrówka Wielka|ul. Główna 49 |95-100 Zgierz;928;521;521;12;509;56.14;2.30
91176;102009;Świetlica gminna, Łagiewniki Nowe|Smardzew|ul. Smardzewska 59 |95-002 Smardzew;1880;1166;1166;9;1157;62.02;0.77
91177;102009;Zespół Szkolno-Gimnazjalny w Szczawinie Kościelnym|Smardzew|ul. Kościelna 21 |95-002 Smardzew;719;405;405;10;395;56.33;2.47
91178;102009;Szkoła Podstawowa w Białej|Biała|ul. Kościelna 4 |95-001 Biała;1244;699;699;25;674;56.19;3.58
91179;102009;Szkoła Podstawowa w Besiekierzu Rudnym|Besiekierz Rudny| 20 |95-001 Biała;838;381;381;4;377;45.47;1.05
91180;102009;Zespół Szkolno-Gimnazjalny w Giecznie|Gieczno|ul. Szkolna 2 |95-001 Biała;1262;674;674;27;647;53.41;4.01
91181;102101;Szkoła Podstawowa Nr 1 w Brzezinach|Brzeziny|ul. Moniuszki 21 |95-060 Brzeziny;1894;913;913;35;878;48.20;3.83
91182;102101;Muzeum Regionalne w Brzezinach|Brzeziny|ul. Marszałka Piłsudskiego 49 |95-060 Brzeziny;1354;638;638;15;623;47.12;2.35
91183;102101;Przedszkole Nr 1 w Brzezinach|Brzeziny|ul. Konstytucji 3-go Maja 1 |95-060 Brzeziny;1252;557;557;21;536;44.49;3.77
91184;102101;Gimnazjum w Brzezinach|Brzeziny|ul. Bohaterów Warszawy 4 |95-060 Brzeziny;1355;707;707;16;691;52.18;2.26
91185;102101;Zespół Szkół Ponadgimnazjalnych w Brzezinach|Brzeziny|ul. Konstytucji 3-go Maja 5 |95-060 Brzeziny;1493;860;860;22;838;57.60;2.56
91186;102101;Szkoła Podstawowa Nr 2 w Brzezinach|Brzeziny|ul. Sienkiewicza 17 |95-060 Brzeziny;1268;732;732;14;718;57.73;1.91
91187;102101;Miejska Biblioteka Publiczna w Brzezinach|Brzeziny|ul. Świętej Anny 36 |95-060 Brzeziny;1340;585;585;20;565;43.66;3.42
91188;102101;Dom Pomocy Społecznej w Brzezinach|Brzeziny|Moniuszki 24 |95-060 Brzeziny;80;37;37;1;36;46.25;2.70
91189;102101;Powiatowe Centrum Zdrowia w Brzezinach Sp.z o.o|Brzeziny|M.Skłodowskiej-Curie 6 |95-060 Brzeziny;79;41;41;0;41;51.90;0.00
91190;102102;Szkoła Podstawowa w Gałkówku-Kolonii|Gałkówek-Kolonia| 38 |95-060 Brzeziny;1055;549;549;14;535;52.04;2.55
91191;102102;Sala OSP Polik|Polik| 45 |95-060 Brzeziny;915;453;453;17;436;49.51;3.75
91192;102102;Szkoła Podstawowa w Dąbrówce Dużej|Dąbrówka Duża| 60 |95-060 Brzeziny;974;419;419;13;406;43.02;3.10
91193;102102;Gimnazjum w Przecławiu|Przecław| 33 |95-060 Brzeziny;666;337;337;4;333;50.60;1.19
91194;102102;Szkoła Podstawowa w Bogdance|Bogdanka| 5 |95-060 Brzeziny;773;434;434;13;421;56.14;3.00
91195;102103;Gimnazjum w Dmosinie|Dmosin| 1C |95-061 Dmosin;535;264;264;4;260;49.35;1.52
91196;102103;Strażnica OSP w Kraszewie|Kraszew| 18 |95-061 Dmosin;473;178;178;5;173;37.63;2.81
91197;102103;Strażnica OSP w Kołacinie|Kołacin| 15D |95-061 Dmosin;629;270;270;11;259;42.93;4.07
91198;102103;Świetlica w Ząbkach|Ząbki| 16A |95-061 Dmosin;551;233;233;3;230;42.29;1.29
91199;102103;Szkoła Podstawowa w Woli Cyrusowej|Wola Cyrusowa| 69 |95-061 Dmosin;424;182;182;4;178;42.92;2.20
91200;102103;Świetlica w Szczecinie|Szczecin| 36A |95-061 Dmosin;284;122;122;2;120;42.96;1.64
91201;102103;Świetlica w Osinach|Osiny| 33A |95-061 Dmosin;434;217;217;5;212;50.00;2.30
91202;102103;Szkoła Podstawowa w Dmosinie|Dmosin| 1C |95-061 Dmosin;449;211;211;4;207;46.99;1.90
91203;102104;Szkoła Podstawowa w Jeżowie- sala gimnastyczna|Jeżów|ul. Wojska Polskiego 2 |95-047 Jeżów;375;184;184;10;174;49.07;5.43
91204;102104;Szkoła Podstawowa w Jeżowie- klasa I|Jeżów|ul. Wojska Polskiego 2 |95-047 Jeżów;348;185;185;6;179;53.16;3.24
91205;102104;Gimnazjum w Jeżowie - biblioteka|Jeżów|ul. Wojska Polskiego 2 |95-047 Jeżów;359;174;174;6;168;48.47;3.45
91206;102104;Dom Pomocy Społecznej w Dąbrowie|Dąbrowa| 1 |95-047 Jeżów;317;123;123;5;118;38.80;4.07
91207;102104;Sala OSP Przybyszyce|Przybyszyce| 35 |95-047 Jeżów;202;103;103;3;100;50.99;2.91
91208;102104;Gimnazjum w Jeżowie - stołówka szkolna|Jeżów|ul. Wojska Polskiego 2 |95-047 Jeżów;274;129;129;4;125;47.08;3.10
91209;102104;Świetlica Wiejska w Górze|Góra| 21 |95-047 Jeżów;255;117;117;8;109;45.88;6.84
91210;102104;"Gościniec" Ireneusz Adamczyk Wola Łokotowa 1|Wola Łokotowa| 1 |95-047 Jeżów;460;210;210;10;200;45.65;4.76
91211;102104;Sala OSP Rewica|Rewica| 24 |95-047 Jeżów;156;68;68;3;65;43.59;4.41
91212;102104;Dom Pomocy Społecznej w Dąbrowie|Dąbrowa| 1 |95-047 Jeżów;55;43;43;0;43;78.18;0.00
91213;102105;była Szkoła Podstawowa w Zacywilkach|Zacywilki| 5 |95-063 Rogów;265;123;123;3;120;46.42;2.44
91214;102105;Szkoła Podstawowa w Przyłęku Dużym|Przyłęk Duży| 49 |95-063 Rogów;523;205;205;11;194;39.20;5.37
91215;102105;budynek Urzędu Gminy w Rogowie (sala konferencyjna)|Rogów|ul. Żeromskiego 23 |95-063 Rogów;770;362;362;10;352;47.01;2.76
91216;102105;Zespół Szkół w Rogowie|Rogów|ul. Szkolna 4 |95-063 Rogów;750;360;360;8;352;48.00;2.22
91217;102105;Ochotnicza Straż Pożarna w Rogowie|Rogów|ul. Strażacka 4 |95-063 Rogów;413;236;236;7;229;57.14;2.97
91218;102105;Gminna Biblioteka Publiczna w Rogowie|Rogów|ul. Wojska Polskiego 26 |95-063 Rogów;540;268;268;5;263;49.63;1.87
91219;102105;Szkoła Podstawowa w Wągrach|Wągry| 87 |95-063 Rogów;627;313;313;3;310;49.92;0.96
91220;106101;Studio Consulting Sp. z o.o.|Łódź|ul. Romanowska 55F |91-174 Łódź;983;680;681;12;668;69.18;1.76
91221;106101;Świetlica Ochotniczej Straży Pożarnej Łódź-Mikołajew|Łódź|ul. Plonowa 18 |91-156 Łódź;1945;1332;1332;12;1320;68.48;0.90
91222;106101;Świetlica Ochotniczej Straży Pożarnej Łódź-Mikołajew|Łódź|ul. Plonowa 18 |91-156 Łódź;570;302;302;3;299;52.98;0.99
91223;106101;XV Liceum Ogólnokształcące im. Jana Kasprowicza|Łódź|ul. Traktorowa 77 |91-204 Łódź;954;347;347;4;343;36.37;1.15
91224;106101;Laboratorium Produkcji Ogrodniczej w Zespole Szkół Rzemiosła im. Jana Kilińskiego|Łódź|ul. Liściasta 181 |91-220 Łódź;864;510;510;3;507;59.03;0.59
91225;106101;Szkoła Podstawowa nr 48 im. Stanisława Moniuszki|Łódź|ul. Rydzowa 15 |91-211 Łódź;829;633;633;5;628;76.36;0.79
91226;106101;Szkoła Podstawowa nr 71 im. Henryka Sienkiewicza|Łódź|ul. Rojna 58C |91-134 Łódź;1161;870;871;3;867;74.94;0.34
91227;106101;Szkoła Podstawowa nr 48 im. Stanisława Moniuszki|Łódź|ul. Rydzowa 15 |91-211 Łódź;1213;750;750;7;743;61.83;0.93
91228;106101;Szkoła Podstawowa nr 48 im. Stanisława Moniuszki|Łódź|ul. Rydzowa 15 |91-211 Łódź;1126;721;721;13;708;64.03;1.80
91229;106101;Szkoła Podstawowa nr 48 im. Stanisława Moniuszki|Łódź|ul. Rydzowa 15 |91-211 Łódź;1751;1150;1150;7;1143;65.68;0.61
91230;106101;Publiczne Gimnazjum nr 13 im. gen. Józefa Bema|Łódź|ul. Wici 16 |91-213 Łódź;1784;1049;1050;13;1036;58.80;1.24
91231;106101;Publiczne Gimnazjum nr 13 im. gen. Józefa Bema|Łódź|ul. Wici 16 |91-213 Łódź;1373;813;815;14;799;59.21;1.72
91232;106101;Szkoła Podstawowa nr 71 im. Henryka Sienkiewicza|Łódź|ul. Rojna 58C |91-134 Łódź;1628;972;972;14;958;59.71;1.44
91233;106101;Publiczne Gimnazjum nr 7 im. Mikołaja Kopernika|Łódź|ul. Rojna 33 |91-134 Łódź;1505;889;889;9;880;59.07;1.01
91234;106101;Publiczne Gimnazjum nr 7 im. Mikołaja Kopernika|Łódź|ul. Rojna 33 |91-134 Łódź;1127;669;669;10;659;59.36;1.49
91235;106101;Publiczne Gimnazjum nr 7 im. Mikołaja Kopernika|Łódź|ul. Rojna 33 |91-134 Łódź;1199;717;717;12;705;59.80;1.67
91236;106101;Szkoła Podstawowa nr 3 im. mjr. Henryka Dobrzańskiego "Hubala"|Łódź|al. Harcerzy Zatorowców 6 |91-144 Łódź;1372;858;858;10;848;62.54;1.17
91237;106101;Szkoła Podstawowa nr 3 im. mjr. Henryka Dobrzańskiego "Hubala"|Łódź|al. Harcerzy Zatorowców 6 |91-144 Łódź;1423;953;953;12;941;66.97;1.26
91238;106101;Przedszkole Miejskie nr 141|Łódź|al. Pasjonistów 15 |91-140 Łódź;1942;1062;1062;12;1050;54.69;1.13
91239;106101;Przedszkole Miejskie nr 123|Łódź|ul. Rojna 24 |91-134 Łódź;1173;681;681;14;667;58.06;2.06
91240;106101;Dom Dziennego Pobytu dla Osób Niepełnosprawnych|Łódź|ul. Rojna 18a |91-128 Łódź;1420;765;765;14;751;53.87;1.83
91241;106101;Przedszkole Miejskie nr 123|Łódź|ul. Rojna 24 |91-134 Łódź;871;473;473;19;454;54.31;4.02
91242;106101;Szkoła Podstawowa nr 182 im. Tadeusza Zawadzkiego "Zośki"|Łódź|ul. Łanowa 16 |91-103 Łódź;1402;796;796;10;786;56.78;1.26
91243;106101;Szkoła Podstawowa nr 182 im. Tadeusza Zawadzkiego "Zośki"|Łódź|ul. Łanowa 16 |91-103 Łódź;1631;975;975;15;960;59.78;1.54
91244;106101;Bałucki Ośrodek Kultury "Lutnia"|Łódź|ul. Łanowa 14 |91-103 Łódź;1302;762;762;7;755;58.53;0.92
91245;106101;Publiczne Gimnazjum nr 17 im. Bohaterów Monte Cassino|Łódź|ul. Traktorowa 35 |91-117 Łódź;1757;1105;1105;10;1095;62.89;0.90
91246;106101;Zespół Szkół Specjalnych nr 5|Łódź|ul. Plantowa 7 |91-104 Łódź;2068;1274;1274;27;1247;61.61;2.12
91247;106101;Centrum Kształcenia Ustawicznego Samorządu Województwa Łódzkiego|Łódź|ul. Wielkopolska 70/72 |91-029 Łódź;1120;618;618;4;614;55.18;0.65
91248;106101;Centrum Kształcenia Ustawicznego Samorządu Województwa Łódzkiego|Łódź|ul. Wielkopolska 70/72 |91-029 Łódź;1664;909;909;9;900;54.63;0.99
91249;106101;Szkoła Podstawowa nr 56 im. Bronisława Czecha|Łódź|ul. Turoszowska 10 |91-025 Łódź;1463;821;821;7;814;56.12;0.85
91250;106101;Szkoła Podstawowa nr 56 im. Bronisława Czecha|Łódź|ul. Turoszowska 10 |91-025 Łódź;851;472;472;6;466;55.46;1.27
91251;106101;Publiczne Gimnazjum nr 8 im. Tadeusza Kościuszki|Łódź|ul. Żubardzka 26 |91-032 Łódź;1482;928;928;13;915;62.62;1.40
91252;106101;Publiczne Gimnazjum nr 8 im. Tadeusza Kościuszki|Łódź|ul. Żubardzka 26 |91-032 Łódź;1626;1037;1037;11;1026;63.78;1.06
91253;106101;Szkoła Podstawowa nr 122|Łódź|ul. Jesionowa 38 |91-363 Łódź;1935;1238;1238;18;1220;63.98;1.45
91254;106101;Szkoła Podstawowa nr 122|Łódź|ul. Jesionowa 38 |91-363 Łódź;1021;579;579;8;571;56.71;1.38
91255;106101;Szkoła Podstawowa nr 122|Łódź|ul. Jesionowa 38 |91-363 Łódź;1119;639;639;7;632;57.10;1.10
91256;106101;Szkoła Podstawowa nr 122|Łódź|ul. Jesionowa 38 |91-363 Łódź;1770;1228;1228;15;1213;69.38;1.22
91257;106101;Zespół Szkół Ogólnokształcących nr 4 im. Ireny Sendlerowej|Łódź|ul. Stawowa 28 |91-358 Łódź;1774;1149;1149;18;1131;64.77;1.57
91258;106101;Zespół Szkół Ogólnokształcących nr 4 im. Ireny Sendlerowej|Łódź|ul. Stawowa 28 |91-358 Łódź;1208;791;791;6;785;65.48;0.76
91259;106101;Zespół Szkół Ogólnokształcących nr 4 im. Ireny Sendlerowej|Łódź|ul. Stawowa 28 |91-358 Łódź;872;562;562;7;555;64.45;1.25
91260;106101;Przedszkole LOKOMOTYWA|Łódź|ul. Kruszynowa 14 |91-356 Łódź;1996;1356;1356;11;1345;67.94;0.81
91261;106101;Przedszkole LOKOMOTYWA|Łódź|ul. Kruszynowa 14 |91-356 Łódź;2236;1461;1462;12;1449;65.34;0.82
91262;106101;Szkoła Podstawowa nr 206|Łódź|ul. Łozowa 9 |91-496 Łódź;1050;656;656;6;650;62.48;0.91
91263;106101;Szkoła Podstawowa nr 206|Łódź|ul. Łozowa 9 |91-496 Łódź;1578;1007;1007;7;1000;63.81;0.70
91264;106101;Szkoła Podstawowa nr 184 im. Ludwika Waryńskiego|Łódź|ul. Syrenki 19A |91-496 Łódź;1859;1217;1231;14;1203;65.47;1.15
91265;106101;Szkoła Podstawowa nr 184 im. Ludwika Waryńskiego|Łódź|ul. Syrenki 19A |91-496 Łódź;2049;1347;1347;9;1338;65.74;0.67
91266;106101;Szkoła Podstawowa nr 184 im. Ludwika Waryńskiego|Łódź|ul. Syrenki 19A |91-496 Łódź;1778;1195;1195;10;1185;67.21;0.84
91267;106101;Przedszkole Miejskie nr 204|Łódź|ul. Sitowie 15 |91-495 Łódź;1553;977;977;4;973;62.91;0.41
91268;106101;Szkoła Podstawowa nr 206|Łódź|ul. Łozowa 9 |91-496 Łódź;1247;849;849;7;842;68.08;0.82
91269;106101;Szkoła Podstawowa nr 206|Łódź|ul. Łozowa 9 |91-496 Łódź;1432;912;912;3;909;63.69;0.33
91270;106101;Szkoła Podstawowa nr 166 im. 19 Stycznia|Łódź|ul. Szamotulska 1/7 |91-037 Łódź;1133;739;739;3;736;65.23;0.41
91271;106101;Szkoła Podstawowa nr 166 im. 19 Stycznia|Łódź|ul. Szamotulska 1/7 |91-037 Łódź;2065;1204;1204;18;1186;58.31;1.50
91272;106101;XXX Liceum Ogólnokształcące im. ks. bp. Ignacego Krasickiego|Łódź|ul. Obornicka 11/13 |91-039 Łódź;819;433;433;7;426;52.87;1.62
91273;106101;XXX Liceum Ogólnokształcące im. ks. bp. Ignacego Krasickiego|Łódź|ul. Obornicka 11/13 |91-039 Łódź;1445;868;868;10;858;60.07;1.15
91274;106101;Publiczne Gimnazjum nr 6 im. ks. Stanisława Konarskiego|Łódź|ul. Limanowskiego 124A |91-041 Łódź;1277;649;649;8;641;50.82;1.23
91275;106101;Zespół Szkół Ekonomiczno-Turystyczno-Hotelarskich im. Władysława Grabskiego|Łódź|ul. Drewnowska 171 |91-008 Łódź;863;481;481;6;475;55.74;1.25
91276;106101;Zespół Państwowych Szkół Plastycznych im. Tadeusza Makowskiego|Łódź|ul. Gandhiego 14 |91-012 Łódź;1152;655;657;11;644;56.86;1.68
91277;106101;Szkoła Podstawowa nr 35 im. Mariana Piechala|Łódź|ul. Tybury 4 |91-013 Łódź;1290;766;766;9;757;59.38;1.17
91278;106101;Szkoła Podstawowa nr 35 im. Mariana Piechala|Łódź|ul. Tybury 4 |91-013 Łódź;1282;712;712;12;700;55.54;1.69
91279;106101;Grupa Szkół Łódzkiego Stowarzyszenia na Rzecz Porozumienia z Europą|Łódź|ul. Wrześnieńska 64 |91-045 Łódź;1683;932;932;22;910;55.38;2.36
91280;106101;Szkoła Podstawowa nr 54 im. Kornela Makuszyńskiego|Łódź|ul. Wróbla 5 |91-050 Łódź;955;419;419;4;415;43.87;0.95
91281;106101;Szkoła Podstawowa nr 54 im. Kornela Makuszyńskiego|Łódź|ul. Wróbla 5 |91-050 Łódź;1454;693;693;13;680;47.66;1.88
91282;106101;Szkoła Podstawowa nr 54 im. Kornela Makuszyńskiego|Łódź|ul. Wróbla 5 |91-050 Łódź;1794;628;628;21;607;35.01;3.34
91283;106101;Zespół Szkół Ponadgimnazjalnych nr 5 im. Króla Bolesława Chrobrego|Łódź|ul. Drewnowska 88 |91-008 Łódź;483;180;180;6;174;37.27;3.33
91284;106101;Zespół Szkół Samochodowych|Łódź|ul. Prożka 3/5 |91-335 Łódź;707;367;367;2;365;51.91;0.54
91285;106101;Szkoła Podstawowa nr 24 im. Hanki Sawickiej|Łódź|ul. Ciesielska 14A |91-308 Łódź;1693;801;801;20;781;47.31;2.50
91286;106101;Publiczne Gimnazjum nr 12 im. Noblistów Polskich|Łódź|ul. Księdza Brzóski 23 |91-315 Łódź;1408;786;786;5;781;55.82;0.64
91287;106101;Publiczne Gimnazjum nr 12 im. Noblistów Polskich|Łódź|ul. Księdza Brzóski 23 |91-315 Łódź;1148;673;673;7;666;58.62;1.04
91288;106101;Szkoła Podstawowa nr 55 im. Eugeniusza Lokajskiego|Łódź|ul. Mackiewicza 9 |91-349 Łódź;1881;1135;1135;11;1124;60.34;0.97
91289;106101;Szkoła Podstawowa nr 55 im. Eugeniusza Lokajskiego|Łódź|ul. Mackiewicza 9 |91-349 Łódź;915;594;594;8;586;64.92;1.35
91290;106101;Szkoła Podstawowa nr 65 im. Juliusza Słowackiego|Łódź|ul. Pojezierska 10 |91-322 Łódź;1879;1149;1149;12;1137;61.15;1.04
91291;106101;Szkoła Podstawowa nr 65 im. Juliusza Słowackiego|Łódź|ul. Pojezierska 10 |91-322 Łódź;1404;838;838;10;828;59.69;1.19
91292;106101;Szkoła Podstawowa nr 65 im. Juliusza Słowackiego|Łódź|ul. Pojezierska 10 |91-322 Łódź;1448;908;908;12;896;62.71;1.32
91293;106101;Przedszkole Miejskie nr 202|Łódź|ul. Sędziowska 8/10 |91-304 Łódź;1943;1314;1314;16;1298;67.63;1.22
91294;106101;Przedszkole Miejskie nr 149|Łódź|ul. Murarska 42 |91-469 Łódź;1936;1214;1214;11;1203;62.71;0.91
91295;106101;Szkoła Podstawowa nr 101 im. Jana Kochanowskiego|Łódź|ul. Wspólna 5/7 |91-464 Łódź;1152;680;680;9;671;59.03;1.32
91296;106101;Szkoła Podstawowa nr 101 im. Jana Kochanowskiego|Łódź|ul. Wspólna 5/7 |91-464 Łódź;1372;860;860;3;857;62.68;0.35
91297;106101;Szkoła Podstawowa nr 101 im. Jana Kochanowskiego|Łódź|ul. Wspólna 5/7 |91-464 Łódź;1849;1127;1127;14;1113;60.95;1.24
91298;106101;Przedszkole Miejskie nr 176|Łódź|ul. Blacharska 21 |91-470 Łódź;1481;956;956;15;941;64.55;1.57
91299;106101;Urząd Stanu Cywilnego|Łódź|ul. Zgierska 71 |91-463 Łódź;700;192;192;7;185;27.43;3.65
91300;106101;Szkoła Podstawowa nr 45 im. Jana Matejki|Łódź|ul. Bojowników Getta Warszawskiego 3 |91-431 Łódź;1660;868;869;24;844;52.29;2.76
91301;106101;XIII Liceum Ogólnokształcące im. Marii Piotrowiczowej|Łódź|ul. Pacanowskiej 4 |91-430 Łódź;1889;922;922;17;905;48.81;1.84
91302;106101;Szkoła Podstawowa nr 30 im. rtm. Witolda Pileckiego|Łódź|ul. Rysownicza 1/3 |91-855 Łódź;1081;612;616;6;606;56.61;0.98
91303;106101;Szkoła Podstawowa nr 30 im. rtm. Witolda Pileckiego|Łódź|ul. Rysownicza 1/3 |91-855 Łódź;1581;879;885;10;869;55.60;1.14
91304;106101;Zespół Szkół Przemysłu Spożywczego im. Powstańców Wielkopolskich|Łódź|ul. Franciszkańska 137 |91-845 Łódź;1742;1079;1079;7;1072;61.94;0.65
91305;106101;Zespół Szkół Przemysłu Spożywczego im. Powstańców Wielkopolskich|Łódź|ul. Franciszkańska 137 |91-845 Łódź;1824;1072;1072;10;1062;58.77;0.93
91306;106101;XXIV Liceum Ogólnokształcące im. Marii Skłodowskiej-Curie|Łódź|ul. Marysińska 61/67 |91-850 Łódź;2020;1248;1248;11;1237;61.78;0.88
91307;106101;XXIV Liceum Ogólnokształcące im. Marii Skłodowskiej-Curie|Łódź|ul. Marysińska 61/67 |91-850 Łódź;1109;625;625;10;615;56.36;1.60
91308;106101;Przedszkole Miejskie nr 35|Łódź|ul. Zachodnia 16A |91-058 Łódź;1650;679;679;3;676;41.15;0.44
91309;106101;Szkoła Podstawowa nr 58 im. Melchiora Wańkowicza|Łódź|ul. Młynarska 42/46 |91-838 Łódź;1111;628;628;6;622;56.53;0.96
91310;106101;Szkoła Podstawowa nr 58 im. Melchiora Wańkowicza|Łódź|ul. Młynarska 42/46 |91-838 Łódź;1051;541;541;11;530;51.47;2.03
91311;106101;Centrum Zajęć Pozaszkolnych nr 1|Łódź|ul. Zawiszy Czarnego 39 |91-818 Łódź;1618;660;660;12;648;40.79;1.82
91312;106101;Centrum Zajęć Pozaszkolnych nr 1|Łódź|ul. Zawiszy Czarnego 39 |91-818 Łódź;1824;806;806;7;799;44.19;0.87
91313;106101;Publiczne Gimnazjum nr 14 im. Roberta Schumana|Łódź|al. I Dywizji 16/18 |91-836 Łódź;1557;809;809;12;797;51.96;1.48
91314;106101;Zespół Szkół Zawodowych Specjalnych nr 2|Łódź|al. I Dywizji 16/18 |91-744 Łódź;1116;598;598;13;585;53.58;2.17
91315;106101;Szkoła Podstawowa nr 153 im. Marii Skłodowskiej-Curie|Łódź|ul. Obrońców Westerplatte 28 |91-762 Łódź;1551;829;829;3;826;53.45;0.36
91316;106101;Szkoła Podstawowa nr 45 im. Jana Matejki|Łódź|ul. Bojowników Getta Warszawskiego 3 |91-705 Łódź;599;230;230;8;222;38.40;3.48
91317;106101;Publiczne Gimnazjum nr 18 im. prof. Jana Karskiego|Łódź|ul. Mostowkiego 23/27 |91-705 Łódź;1978;1304;1304;16;1288;65.93;1.23
91318;106101;Lokal Rady Osiedla Bałuty-Doły|Łódź|ul. Wojska Polskiego 122 |91-743 Łódź;548;262;262;9;253;47.81;3.44
91319;106101;Zespół Szkół Specjalnych nr 3 im. Jacka Kuronia|Łódź|ul. Sucharskiego 2 |91-744 Łódź;2070;1243;1243;20;1223;60.05;1.61
91320;106101;Szkoła Podstawowa nr 81 im. Bohaterskich Dzieci Łodzi|Łódź|ul. Plater 28/32 |91-762 Łódź;1248;750;750;1;749;60.10;0.13
91321;106101;Publiczne Gimnazjum nr 18 im. prof. Jana Karskiego|Łódź|ul. Mostowskiego 23/27 |91-705 Łódź;1396;735;765;3;732;52.65;0.41
91322;106101;Publiczne Gimnazjum nr 10 im. Rajmunda Hiacynta Rembielińskiego|Łódź|ul. Harcerska 8/10 |91-710 Łódź;1317;763;763;10;753;57.93;1.31
91323;106101;Publiczne Gimnazjum nr 10 im. Rajmunda Hiacynta Rembielińskiego|Łódź|ul. Harcerska 8/10 |91-710 Łódź;1473;939;939;9;930;63.75;0.96
91324;106101;Zespół Szkół Ponadgimnazjalnych nr 10 im. Jana Szczepanika|Łódź|ul. Strykowska 10/18 |91-725 Łódź;1181;622;622;7;615;52.67;1.13
91325;106101;Szkoła Podstawowa nr 61 im. św. Franciszka z Asyżu|Łódź|ul. Okólna 183 |91-520 Łódź;522;316;316;2;314;60.54;0.63
91326;106101;Świetlica Ochotniczej Straży Pożarnej Łódź-Łagiewniki|Łódź|ul. Pszczelna 84 |91-511 Łódź;767;517;517;6;511;67.41;1.16
91327;106101;Szkoła Podstawowa nr 142 im. Zawiszy Czarnego|Łódź|ul. Łupkowa 6 |91-527 Łódź;1111;563;563;6;557;50.68;1.07
91328;106101;Publiczne Gimnazjum nr 15 im. Aleksego Rżewskiego|Łódź|ul. Sowińskiego 50/56 |91-485 Łódź;1721;1195;1195;14;1181;69.44;1.17
91329;106101;Szkoła Podstawowa nr 172 im. prof. Stefana Banacha|Łódź|ul. Jaskrowa 15 |91-480 Łódź;1740;1198;1198;4;1194;68.85;0.33
91330;106101;Specjalny Ośrodek Szkolno-Wychowawczy nr 6 im. mjr. Hieronima Baranowskiego|Łódź|ul. Dziewanny 24 |91-866 Łódź;1077;736;736;2;734;68.34;0.27
91331;106101;Przedszkole Miejskie nr 47|Łódź|ul. Deczyńskiego 24 |91-867 Łódź;1769;1115;1115;9;1106;63.03;0.81
91332;106101;Zespół Szkół Geodezyjno -Technicznych im. Sybiraków|Łódź|ul. Skrzydlata 15 |91-503 Łódź;1746;1200;1200;12;1188;68.73;1.00
91333;106101;Szkoła Podstawowa nr 142 im. Zawiszy Czarnego|Łódź|ul. Łupkowa 6 |91-527 Łódź;1735;1183;1183;7;1176;68.18;0.59
91334;106101;Szkoła Podstawowa nr 10 im. Władysława Broniewskiego|Łódź|ul. Przybyszewskiego 15/21 |93-188 Łódź;913;280;280;5;275;30.67;1.79
91335;106101;Szkoła Podstawowa nr 10 im. Władysława Broniewskiego|Łódź|ul. Przybyszewskiego 15/21 |93-188 Łódź;1640;633;633;33;600;38.60;5.21
91336;106101;Urząd Stanu Cywilnego|Łódź|ul. Pabianicka 2 |93-029 Łódź;1507;614;614;8;606;40.74;1.30
91337;106101;Zespół Szkół Ponadgimnazjalnych nr 22|Łódź|ul. Przybyszewskiego 73/75 |93-126 Łódź;885;317;317;9;308;35.82;2.84
91338;106101;Zespół Szkół Ponadgimnazjalnych nr 22|Łódź|ul. Przybyszewskiego 73/75 |93-126 Łódź;1217;479;479;12;467;39.36;2.51
91339;106101;Zespół Szkół Ponadgimnazjalnych nr 22|Łódź|ul. Przybyszewskiego 73/75 |93-126 Łódź;1720;884;884;16;868;51.40;1.81
91340;106101;Publiczne Gimnazjum nr 40 im. Wandy Rutkiewicz|Łódź|ul. Kaliska 25/27 |93-130 Łódź;2081;876;876;21;855;42.10;2.40
91341;106101;Ogólnokształcąca Szkoła Muzyczna I i II stopnia im. Henryka Wieniawskiego|Łódź|ul. Sosnowa 9 |93-102 Łódź;1961;785;785;14;771;40.03;1.78
91342;106101;Ośrodek Kultury "Górna"|Łódź|ul. Siedlecka 1 |93-138 Łódź;1855;975;975;3;972;52.56;0.31
91343;106101;Zespół Szkół Ponadgimnazjalnych nr 9 im. Komisji Edukacji Narodowej|Łódź|al. Politechniki 38 |93-590 Łódź;2092;1056;1056;14;1042;50.48;1.33
91344;106101;Szkoła Podstawowa nr 83 im. Stanisława Jachowicza|Łódź|ul. Podmiejska 21 |93-165 Łódź;824;517;517;14;503;62.74;2.71
91345;106101;Szkoła Podstawowa nr 83 im. Stanisława Jachowicza|Łódź|ul. Podmiejska 21 |93-165 Łódź;1531;954;954;11;943;62.31;1.15
91346;106101;VI Liceum Ogólnokształcące im. Joachima Lelewela|Łódź|ul. Podmiejska 21 |93-165 Łódź;1949;1177;1177;16;1161;60.39;1.36
91347;106101;Publiczne Gimnazjum nr 46 im. rtm. Witolda Pileckiego|Łódź|ul. Krochmalna 15 |93-144 Łódź;1446;696;696;10;686;48.13;1.44
91348;106101;Publiczne Gimnazjum nr 46 im. rtm. Witolda Pileckiego|Łódź|ul. Krochmalna 15 |93-144 Łódź;1410;690;690;14;676;48.94;2.03
91349;106101;Szkoła Podstawowa nr 38 im. dr. Henryka Jordana|Łódź|ul. Krochmalna 21 |93-144 Łódź;1045;578;578;8;570;55.31;1.38
91350;106101;Szkoła Podstawowa nr 38 im. dr. Henryka Jordana|Łódź|ul. Krochmalna 21 |93-144 Łódź;1515;877;877;12;865;57.89;1.37
91351;106101;Zespół Szkół Przemysłu Mody im. bł. Matki Teresy z Kalkuty|Łódź|ul. Naruszewicza 35 |93-161 Łódź;1731;937;937;9;928;54.13;0.96
91352;106101;Szkoła Podstawowa nr 190 im. Jarosława Iwaszkiewicza|Łódź|ul. Malczewskiego 37/47 |93-154 Łódź;1522;907;907;10;897;59.59;1.10
91353;106101;Szkoła Podstawowa nr 190 im. Jarosława Iwaszkiewicza|Łódź|ul. Malczewskiego 37/47 |93-154 Łódź;1127;679;679;9;670;60.25;1.33
91354;106101;Szkoła Podstawowa nr 174 im. Jana Machulskiego|Łódź|ul. Gałczyńskiego 6 |93-259 Łódź;1978;1073;1073;12;1061;54.25;1.12
91355;106101;XXXI Liceum Ogólnokształcące im. Ludwika Zamenhofa|Łódź|ul. Kruczkowskiego 4 |93-236 Łódź;1989;1026;1026;29;997;51.58;2.83
91356;106101;XXXI Liceum Ogólnokształcące im. Ludwika Zamenhofa|Łódź|ul. Kruczkowskiego 4 |93-236 Łódź;1693;915;915;16;899;54.05;1.75
91357;106101;Publiczne Gimnazjum nr 44 im. Wisławy Szymborskiej|Łódź|ul. Deotymy 1 |93-267 Łódź;1538;798;798;16;782;51.89;2.01
91358;106101;Publiczne Gimnazjum nr 44 im. Wisławy Szymborskiej|Łódź|ul. Deotymy 1 |93-267 Łódź;2143;1242;1242;18;1224;57.96;1.45
91359;106101;Przedszkole Miejskie nr 119|Łódź|ul. Rydla 17 |93-203 Łódź;1913;1211;1211;11;1200;63.30;0.91
91360;106101;Szkoła Podstawowa nr 64 im. Hansa Christiana Andersena|Łódź|ul. Anczyca 6 |93-262 Łódź;1073;545;545;11;534;50.79;2.02
91361;106101;Szkoła Podstawowa nr 64 im. Hansa Christiana Andersena|Łódź|ul. Anczyca 6 |93-262 Łódź;1619;812;812;21;791;50.15;2.59
91362;106101;Szkoła Podstawowa nr 64 im. Hansa Christiana Andersena|Łódź|ul. Anczyca 6 |93-262 Łódź;1759;935;935;18;917;53.16;1.93
91363;106101;Miejska Biblioteka Publiczna Łódź-Górna im. Władysława Stanisława Reymonta Filia Nr 10|Łódź|ul. Kadłubka 40 |93-248 Łódź;1467;852;852;7;845;58.08;0.82
91364;106101;Przedszkole Miejskie nr 117|Łódź|ul. Kadłubka 38 |93-248 Łódź;2007;1046;1046;11;1035;52.12;1.05
91365;106101;Fundacja Pomocy Dzieciom "Jaś i Małgosia"|Łódź|ul. Tatrzańska 105 |93-279 Łódź;1578;873;873;11;862;55.32;1.26
91366;106101;Fundacja Pomocy Dzieciom "Jaś i Małgosia"|Łódź|ul. Tatrzańska 105 |93-279 Łódź;1931;1117;1117;13;1104;57.85;1.16
91367;106101;Szkoła Podstawowa nr 189 im. Wandy Zieleńczyk|Łódź|ul. Kossaka 19 |93-213 Łódź;1958;1129;1129;16;1113;57.66;1.42
91368;106101;XXV Liceum Ogólnokształcące im. Stefana Żeromskiego|Łódź|ul. Podhalańska 2A |93-224 Łódź;2039;1168;1168;19;1149;57.28;1.63
91369;106101;XXV Liceum Ogólnokształcące im. Stefana Żeromskiego|Łódź|ul. Podhalańska 2A |93-224 Łódź;1543;898;898;18;880;58.20;2.00
91370;106101;Dom Ludowy "Józefów"|Łódź|ul. Józefów 43 |93-615 Łódź;942;586;586;5;581;62.21;0.85
91371;106101;Klub Osiedlowy Nr 1 Spółdzielni Mieszkaniowej "Chojny"|Łódź|ul. Skupiona 3 |93-323 Łódź;1932;1268;1268;12;1256;65.63;0.95
91372;106101;Szkoła Podstawowa nr 162 im. Jana Nowaka Jeziorańskiego|Łódź|ul. Powszechna 15 |93-321 Łódź;1634;935;935;6;929;57.22;0.64
91373;106101;Szkoła Podstawowa nr 162 im. Jana Nowaka Jeziorańskiego|Łódź|ul. Powszechna 15 |93-321 Łódź;1866;1058;1058;24;1034;56.70;2.27
91374;106101;Szkoła Podstawowa nr 162 im. Jana Nowaka Jeziorańskiego|Łódź|ul. Powszechna 15 |93-321 Łódź;2038;1302;1302;9;1293;63.89;0.69
91375;106101;Szkoła Podstawowa nr 110 im. Partyzantów Ziemi Łódzkiej|Łódź|ul. Zamknięta 3 |93-323 Łódź;1769;1084;1084;18;1066;61.28;1.66
91376;106101;Szkoła Podstawowa nr 110 im. Partyzantów Ziemi Łódzkiej|Łódź|ul. Zamknięta 3 |93-323 Łódź;1585;932;932;13;919;58.80;1.39
91377;106101;Lokal Rady Osiedla Chojny|Łódź|ul. Rzgowska 151 |93-303 Łódź;2427;1324;1324;19;1305;54.55;1.44
91378;106101;Szkoła Podstawowa nr 109 im. Ludwiki Wawrzyńskiej|Łódź|ul. Pryncypalna 74 |93-379 Łódź;1983;1026;1026;12;1014;51.74;1.17
91379;106101;Szkoła Podstawowa nr 109 im. Ludwiki Wawrzyńskiej|Łódź|ul. Pryncypalna 74 |93-379 Łódź;2303;1481;1481;25;1456;64.31;1.69
91380;106101;Szkoła Podstawowa nr 109 im. Ludwiki Wawrzyńskiej|Łódź|ul. Pryncypalna 74 |93-379 Łódź;1368;865;866;6;859;63.23;0.69
91381;106101;Zespół Szkół Ogólnokształcących nr 5 im. Juliana Tuwima|Łódź|ul. Królewska 13/15 |93-319 Łódź;1710;1022;1022;11;1011;59.77;1.08
91382;106101;Zespół Szkół Ogólnokształcących nr 5 im. Juliana Tuwima|Łódź|ul. Królewska 13/15 |93-319 Łódź;1074;701;701;5;696;65.27;0.71
91383;106101;Zespół Szkół Ogólnokształcących nr 5 im. Juliana Tuwima|Łódź|ul. Królewska 13/15 |93-319 Łódź;1405;930;930;8;922;66.19;0.86
91384;106101;Klub Osiedlowy Nr 2 Spółdzielni Mieszkaniowej "Chojny"|Łódź|ul. Gościnna 8 |93-356 Łódź;1206;775;775;13;762;64.26;1.68
91385;106101;Zakład Hoteli i Budynków Mieszkalnych przy Instytucie Centrum Zdrowia Matki Polki w Łodzi|Łódź|ul. Paradna 46 |93-345 Łódź;1353;921;921;9;912;68.07;0.98
91386;106101;Zakład Hoteli i Budynków Mieszkalnych przy Instytucie Centrum Zdrowia Matki Polki w Łodzi|Łódź|ul. Paradna 46 |93-345 Łódź;1157;798;798;5;793;68.97;0.63
91387;106101;Krajowe Towarzystwo Autyzmu Oddział w Łodzi|Łódź|ul. Chocianowicka 198 |93-460 Łódź;882;469;469;5;464;53.17;1.07
91388;106101;Centrum Zajęć Pozaszkolnych nr 2|Łódź|ul. Sopocka 3/5 |93-490 Łódź;1219;690;690;9;681;56.60;1.30
91389;106101;Publiczne Gimnazjum nr 38 im. Kardynała Stefana Wyszyńskiego|Łódź|ul. Dubois 7/9 |93-491 Łódź;2154;1292;1292;21;1271;59.98;1.63
91390;106101;Szkoła Podstawowa nr 138 im. Leopolda Staffa|Łódź|ul. Świętego Franciszka 53 |93-479 Łódź;1501;978;978;4;974;65.16;0.41
91391;106101;Szkoła Podstawowa nr 138 im. Leopolda Staffa|Łódź|ul. Świętego Franciszka 53 |93-479 Łódź;1545;1023;1023;10;1013;66.21;0.98
91392;106101;Zespół Szkół Techniczno-Informatycznych im. Jana Nowaka Jeziorańskiego|Łódź|al. Politechniki 37 |93-502 Łódź;1401;831;831;10;821;59.31;1.20
91393;106101;Szkoła Podstawowa nr 42 im. Stanisława Staszica|Łódź|ul. Przyszkole 42 |93-552 Łódź;1056;618;618;10;608;58.52;1.62
91394;106101;Szkoła Podstawowa nr 42 im. Stanisława Staszica|Łódź|ul. Przyszkole 42 |93-552 Łódź;1585;884;884;17;867;55.77;1.92
91395;106101;XX Liceum Ogólnokształcące im. Juliusza Słowackiego|Łódź|ul. Obywatelska 57 |93-562 Łódź;1954;1204;1204;13;1191;61.62;1.08
91396;106101;XX Liceum Ogólnokształcące im. Juliusza Słowackiego|Łódź|ul. Obywatelska 57 |93-562 Łódź;877;503;503;1;502;57.35;0.20
91397;106101;XX Liceum Ogólnokształcące im. Juliusza Słowackiego|Łódź|ul. Obywatelska 57 |93-562 Łódź;484;125;125;3;122;25.83;2.40
91398;106101;Zespół Szkół Techniczno-Informatycznych im. Jana Nowaka Jeziorańskiego|Łódź|al. Politechniki 37 |93-502 Łódź;1009;339;339;7;332;33.60;2.06
91399;106101;Szkoła Podstawowa nr 7 im. Orląt Lwowskich|Łódź|ul. Wiosenna 1 |93-535 Łódź;1978;1121;1130;13;1108;56.67;1.16
91400;106101;Szkoła Podstawowa nr 7 im. Orląt Lwowskich|Łódź|ul. Wiosenna 1 |93-535 Łódź;1761;883;883;21;862;50.14;2.38
91401;106101;Zespół Szkół Ekonomii i Usług im. Natalii Gąsiorowskiej|Łódź|ul. Astronautów 19 |93-533 Łódź;1189;706;706;20;686;59.38;2.83
91402;106101;Publiczne Gimnazjum nr 37|Łódź|ul. Jarosławska 29 |93-524 Łódź;1686;993;993;16;977;58.90;1.61
91403;106101;Publiczne Gimnazjum nr 37|Łódź|ul. Jarosławska 29 |93-524 Łódź;777;247;247;2;245;31.79;0.81
91404;106101;Szkoła Podstawowa nr 51 im. Stefana Linkego|Łódź|ul. Ciołkowskiego 11A |93-510 Łódź;1668;842;842;12;830;50.48;1.43
91405;106101;IX Liceum Ogólnokształcące im. Jarosława Dąbrowskiego|Łódź|ul. Paderewskiego 24 |93-025 Łódź;1353;830;830;11;819;61.35;1.33
91406;106101;Szkoła Podstawowa nr 113 im. Adolfa Dygasińskiego|Łódź|ul. Unicka 6 |93-009 Łódź;1921;1116;1116;5;1111;58.09;0.45
91407;106101;Szkoła Podstawowa nr 113 im. Adolfa Dygasińskiego|Łódź|ul. Unicka 6 |93-009 Łódź;1735;798;798;16;782;45.99;2.01
91408;106101;Szkoła Podstawowa nr 113 im. Adolfa Dygasińskiego|Łódź|ul. Unicka 6 |93-009 Łódź;1393;710;710;11;699;50.97;1.55
91409;106101;Lokal Rady Osiedla Piastów-Kurak|Łódź|ul. Ciołkowskiego 11 |93-510 Łódź;1888;1171;1171;20;1151;62.02;1.71
91410;106101;Dom Pomocy Społecznej w Łodzi|Łódź|ul. Rudzka 56 |93-423 Łódź;2250;1350;1350;17;1333;60.00;1.26
91411;106101;Szkoła Podstawowa nr 125 im. Janusza Korczaka|Łódź|ul. Dzwonowa 18/20 |93-429 Łódź;1822;951;951;20;931;52.20;2.10
91412;106101;Centrum Zajęć Pozaszkolnych nr 2|Łódź|ul. Zjednoczenia 1 |93-402 Łódź;1470;714;714;23;691;48.57;3.22
91413;106101;Szkoła Podstawowa nr 143|Łódź|ul. Kuźnicka 12 |94-459 Łódź;1926;1180;1180;11;1169;61.27;0.93
91414;106101;Szkoła Podstawowa nr 125 im. Janusza Korczaka|Łódź|ul. Dzwonowa 18/20 |93-429 Łódź;1642;895;895;8;887;54.51;0.89
91415;106101;Ochotnicza Straż Pożarna Łódź-Jędrzejów|Łódź|ul. Tomaszowska 85 |93-635 Łódź;808;491;491;6;485;60.77;1.22
91416;106101;Szkoła Podstawowa nr 130 im. Marszałka Józefa Piłsudskiego|Łódź|ul. Gościniec 1 |93-645 Łódź;1867;1099;1099;28;1071;58.86;2.55
91417;106101;Zespół Szkół Ogólnokształcących nr 7 im. Włodzimierza Puchalskiego|Łódź|ul. Minerska 1/3 |94-304 Łódź;1710;1113;1113;17;1096;65.09;1.53
91418;106101;XVIII Liceum Ogólnokształcące im. Jędrzeja Śniadeckiego|Łódź|ul. Perla 11 |94-203 Łódź;893;488;488;4;484;54.65;0.82
91419;106101;XVIII Liceum Ogólnokształcące im. Jędrzeja Śniadeckiego|Łódź|ul. Perla 11 |94-203 Łódź;1465;886;886;18;868;60.48;2.03
91420;106101;Szkoła Podstawowa nr 91 im. Leonida Teligi|Łódź|ul. Kasprzaka 45 |91-078 Łódź;1545;872;872;18;854;56.44;2.06
91421;106101;Publiczne Gimnazjum nr 19 im. gen. Mariusza Zaruskiego|Łódź|ul. Wapienna 17 |91-087 Łódź;1273;759;759;10;749;59.62;1.32
91422;106101;Szkoła Podstawowa nr 91 im. Leonida Teligi|Łódź|ul. Kasprzaka 45 |91-078 Łódź;1808;1032;1032;6;1026;57.08;0.58
91423;106101;Publiczne Gimnazjum nr 19 im. gen. Mariusza Zaruskiego|Łódź|ul. Wapienna 17 |91-087 Łódź;1320;775;775;6;769;58.71;0.77
91424;106101;Przedszkole Miejskie nr 53|Łódź|ul. Kasprzaka 57 |91-078 Łódź;1579;886;886;15;871;56.11;1.69
91425;106101;Zespół Opieki Zdrowotnej Łódź-Polesie Przychodnia Nr 33|Łódź|ul. Kasprzaka 27 |91-078 Łódź;1601;893;893;12;881;55.78;1.34
91426;106101;Szkoła Podstawowa nr 36 im. Zenona Wasilewskiego|Łódź|ul. Więckowskiego 35 |90-734 Łódź;1500;645;645;7;638;43.00;1.09
91427;106101;Szkoła Podstawowa nr 36 im. Zenona Wasilewskiego|Łódź|ul. Więckowskiego 35 |90-734 Łódź;1664;567;567;10;557;34.07;1.76
91428;106101;Publiczne Gimnazjum nr 26 im. Mikołaja Reja|Łódź|al. 1 Maja 89 |90-755 Łódź;1391;646;646;11;635;46.44;1.70
91429;106101;Zakład Doskonalenia Zawodowego Ośrodek Kształcenia Zawodowego Nr 3|Łódź|ul. Próchnika 42 |90-713 Łódź;1473;650;650;14;636;44.13;2.15
91430;106101;Urząd Skarbowy Łódź-Polesie|Łódź|ul. 6 Sierpnia 84/86 |90-646 Łódź;1681;712;712;13;699;42.36;1.83
91431;106101;Publiczne Gimnazjum nr 26 im. Mikołaja Reja|Łódź|al. 1 Maja 89 |90-755 Łódź;1381;696;696;8;688;50.40;1.15
91432;106101;Szkoła Podstawowa nr 26 im. Armii "Łódź"|Łódź|ul. Kapitana Pogonowskiego 27/29 |90-745 Łódź;2022;844;844;21;823;41.74;2.49
91433;106101;Szkoła Podstawowa nr 36 im. Zenona Wasilewskiego|Łódź|ul. Więckowskiego 35 |90-734 Łódź;1775;786;786;12;774;44.28;1.53
91434;106101;I Liceum Ogólnokształcące im. Mikołaja Kopernika|Łódź|ul. Więckowskiego 41 |90-734 Łódź;1390;563;563;15;548;40.50;2.66
91435;106101;Szkoła Podstawowa nr 36 im. Zenona Wasilewskiego|Łódź|ul. Więckowskiego 35 |90-734 Łódź;1069;461;461;4;457;43.12;0.87
91436;106101;Przedszkole Miejskie nr 208|Łódź|ul. Gdańska 84 |90-613 Łódź;1028;468;468;19;449;45.53;4.06
91437;106101;Szkoła Podstawowa nr 160 im. Powstańców Śląskich|Łódź|ul. Struga 24 |90-513 Łódź;1428;621;621;6;615;43.49;0.97
91438;106101;Gimnazjum Publiczne nr 24 im. gen. Józefa Wybickiego|Łódź|ul. Żeromskiego 26 |90-737 Łódź;1329;565;565;14;551;42.51;2.48
91439;106101;Szkoła Podstawowa nr 26 im. Armii "Łódź"|Łódź|ul. Kapitana Pogonowskiego 27/29 |90-745 Łódź;1447;555;555;19;536;38.36;3.42
91440;106101;Szkoła Podstawowa nr 46 im. Józefa Chełmońskiego|Łódź|ul. Żwirki 11/13 |90-528 Łódź;1439;641;641;10;631;44.54;1.56
91441;106101;Towarzystwo Oświatowe "Edukacja"|Łódź|ul. Inżynierska 2/4 |93-569 Łódź;1368;617;617;9;608;45.10;1.46
91442;106101;Szkoła Podstawowa nr 152 im. Elizy Orzeszkowej|Łódź|ul. 28 Pułku Strzelców Kaniowskich 52/54 |00-000 Łódź;1476;636;636;11;625;43.09;1.73
91443;106101;Zespół Szkół Specjalnych nr 2|Łódź|ul. Karolewska 30/34 |90-561 Łódź;1251;767;767;6;761;61.31;0.78
91444;106101;Zespół Szkół Specjalnych nr 2|Łódź|ul. Karolewska 30/34 |90-561 Łódź;1125;727;727;5;722;64.62;0.69
91445;106101;XXI Liceum Ogólnokształcące im. Bolesława Prusa|Łódź|ul. Kopernika 2 |90-509 Łódź;1156;534;534;12;522;46.19;2.25
91446;106101;XXI Liceum Ogólnokształcące im. Bolesława Prusa|Łódź|ul. Kopernika 2 |90-509 Łódź;875;405;405;7;398;46.29;1.73
91447;106101;Szkoła Podstawowa nr 19|Łódź|ul. Balonowa 1 |94-108 Łódź;1455;1123;1124;3;1120;77.18;0.27
91448;106101;Szkoła Podstawowa nr 19|Łódź|ul. Balonowa 1 |94-108 Łódź;1152;870;870;7;863;75.52;0.80
91449;106101;Zespół Szkół Integracyjnych nr 1 Integracyjna Szkoła Podstawowa nr 67 im. Janusza Korczaka|Łódź|ul. Maratońska 47b |94-102 Łódź;1616;996;996;16;980;61.63;1.61
91450;106101;Liceum Ogólnokształcące Jolanty i Jana Misiaków|Łódź|al. Kardynała Wyszyńskiego 44 |94-047 Łódź;1675;1066;1066;7;1059;63.64;0.66
91451;106101;Szkoła Podstawowa nr 19|Łódź|ul. Balonowa 1 |94-108 Łódź;1630;1079;1079;10;1069;66.20;0.93
91452;106101;Szkoła Podstawowa nr 44 im. prof. Jana Molla|Łódź|ul. Kusocińskiego 100 |94-054 Łódź;1753;1095;1095;10;1085;62.46;0.91
91453;106101;Szkoła Podstawowa nr 44 im. prof. Jana Molla|Łódź|ul. Kusocińskiego 100 |94-054 Łódź;1162;741;741;5;736;63.77;0.67
91454;106101;Szkoła Podstawowa nr 44 im. prof. Jana Molla|Łódź|ul. Kusocińskiego 100 |94-054 Łódź;1067;695;695;7;688;65.14;1.01
91455;106101;Szkoła Podstawowa nr 6|Łódź|ul. Kusocińskiego 116 |94-054 Łódź;974;637;637;6;631;65.40;0.94
91456;106101;Szkoła Podstawowa nr 6|Łódź|ul. Kusocińskiego 116 |94-054 Łódź;977;643;643;4;639;65.81;0.62
91457;106101;Szkoła Podstawowa nr 6|Łódź|ul. Kusocińskiego 116 |94-054 Łódź;1890;1160;1160;8;1152;61.38;0.69
91458;106101;Przedszkole Miejskie nr 174|Łódź|ul. Kusocińskiego 122A |94-054 Łódź;1670;1157;1157;7;1150;69.28;0.61
91459;106101;Zespół Szkół Integracyjnych nr 1 Integracyjna Szkoła Podstawowa nr 67 im. Janusza Korczaka|Łódź|ul. Maratońska 47B |94-056 Łódź;1939;1200;1205;13;1187;61.89;1.08
91460;106101;Zespół Szkół Integracyjnych nr 1 Publiczne Gimnazjum Integracyjne nr 47 im. Janusza Korczaka (budynek Pałacu Młodzieży)|Łódź|al. Kardynała Wyszyńskiego 86 |94-050 Łódź;1934;1230;1230;16;1214;63.60;1.30
91461;106101;Przedszkole Miejskie nr 170|Łódź|ul. Księdza Popiełuszki 13A |94-052 Łódź;1910;1228;1228;20;1208;64.29;1.63
91462;106101;XXVI Liceum Ogólnokształcące im. Krzysztofa Kamila Baczyńskiego|Łódź|ul. Wileńska 22A |94-029 Łódź;1356;848;848;15;833;62.54;1.77
91463;106101;Zespół Szkolno-Przedszkolny nr 1|Łódź|ul. Krzemieniecka 24A |94-017 Łódź;993;620;620;11;609;62.44;1.77
91464;106101;Zespół Szkolno-Przedszkolny nr 1|Łódź|ul. Krzemieniecka 24A |94-017 Łódź;1136;718;718;14;704;63.20;1.95
91465;106101;Miejska Pracownia Urbanistyczna w Łodzi|Łódź|ul. Wileńska 53/55 |94-016 Łódź;1665;1127;1127;7;1120;67.69;0.62
91466;106101;XXVI Liceum Ogólnokształcące im. Krzysztofa Kamila Baczyńskiego|Łódź|ul. Wileńska 22A |94-029 Łódź;1655;988;988;12;976;59.70;1.21
91467;106101;Szkoła Podstawowa nr 164 im. Andrzeja Frycza Modrzewskiego|Łódź|ul. Wróblewskiego 65 |94-035 Łódź;1457;946;947;11;935;64.93;1.16
91468;106101;Szkoła Podstawowa nr 164 im. Andrzeja Frycza Modrzewskiego|Łódź|ul. Wróblewskiego 65 |94-035 Łódź;1933;1173;1173;10;1163;60.68;0.85
91469;106101;Publiczne Gimnazjum nr 20 im. Hugona Kołłątaja|Łódź|ul. Olimpijska 9 |94-043 Łódź;1585;1023;1023;15;1008;64.54;1.47
91470;106101;Publiczne Gimnazjum nr 20 im. Hugona Kołłątaja|Łódź|ul. Olimpijska 9 |94-043 Łódź;1430;909;909;5;904;63.57;0.55
91471;106101;Szkoła Podstawowa nr 41 im. Króla Władysława Jagiełły|Łódź|ul. Rajdowa 18 |94-003 Łódź;1708;1062;1062;17;1045;62.18;1.60
91472;106101;Szkoła Podstawowa nr 41 im. Króla Władysława Jagiełły|Łódź|ul. Rajdowa 18 |94-003 Łódź;1021;722;722;14;708;70.71;1.94
91473;106101;Szkoła Podstawowa nr 41 im. Króla Władysława Jagiełły|Łódź|ul. Rajdowa 18 |94-003 Łódź;1270;796;797;12;784;62.68;1.51
91474;106101;Szkoła Podstawowa nr 11 im. Marii Kownackiej|Łódź|ul. Hufcowa 20A |94-107 Łódź;1566;988;988;13;975;63.09;1.32
91475;106101;Przedszkole Miejskie nr 165|Łódź|ul. Hufcowa 14 |94-107 Łódź;1901;1128;1128;12;1116;59.34;1.06
91476;106101;Łódzkie Stowarzyszenie Oświatowe|Łódź|ul. Babickiego 15 |94-056 Łódź;986;611;611;7;604;61.97;1.15
91477;106101;Łódzkie Stowarzyszenie Oświatowe|Łódź|ul. Babickiego 15 |94-056 Łódź;923;604;604;5;599;65.44;0.83
91478;106101;Szkoła Podstawowa nr 11 im. Marii Kownackiej|Łódź|ul. Hufcowa 20A |94-107 Łódź;1895;1256;1256;9;1247;66.28;0.72
91479;106101;Miejski Zespół Żłobków w Łodzi Żłobek Nr 21|Łódź|ul. Marusarzówny 9 |94-041 Łódź;1347;862;862;7;855;63.99;0.81
91480;106101;Przedszkole Miejskie nr 214|Łódź|ul. Batalionów Chłopskich 21 |94-058 Łódź;1552;1043;1044;16;1027;67.20;1.53
91481;106101;Przedszkole Miejskie nr 214|Łódź|ul. Batalionów Chłopskich 21 |94-058 Łódź;2088;1357;1357;23;1334;64.99;1.69
91482;106101;Szkoła Podstawowa nr 137 im. prof. Aleksandra Kamińskiego|Łódź|ul. Florecistów 3B |94-042 Łódź;1635;1042;1043;10;1032;63.73;0.96
91483;106101;Szkoła Podstawowa nr 137 im. prof. Aleksandra Kamińskiego|Łódź|ul. Florecistów 3B |94-042 Łódź;1617;1007;1008;3;1004;62.28;0.30
91484;106101;"KME" Sp. z o.o.|Łódź|ul. Obywatelska 128 |94-104 Łódź;1577;1042;1042;10;1032;66.07;0.96
91485;106101;Spółdzielnia Mieszkaniowa "Pienista"|Łódź|ul. Kubusia Puchatka 9 |94-119 Łódź;1716;1221;1221;12;1209;71.15;0.98
91486;106101;Grupowa Oczyszczalnia Ścieków w Łodzi Sp. z o.o.|Łódź|ul. Sanitariuszek 70/72 |93-469 Łódź;631;346;346;9;337;54.83;2.60
91487;106101;Szkoła Podstawowa nr 169 im. Marii Dąbrowskiej|Łódź|ul. Napoleońska 7/17 |94-231 Łódź;1512;1057;1057;4;1053;69.91;0.38
91488;106101;Szkoła Podstawowa nr 169 im. Marii Dąbrowskiej|Łódź|ul. Napoleońska 7/17 |94-231 Łódź;1063;700;700;6;694;65.85;0.86
91489;106101;Szkoła Podstawowa nr 169 im. Marii Dąbrowskiej|Łódź|ul. Napoleońska 7/17 |94-231 Łódź;1507;1064;1064;9;1055;70.60;0.85
91490;106101;Navicula Centrum|Łódź|ul. Cedry 2 |91-129 Łódź;1985;1259;1259;7;1252;63.43;0.56
91491;106101;Przedszkole Miejskie nr 207|Łódź|ul. Piotrkowska 272 |90-361 Łódź;1588;876;876;10;866;55.16;1.14
91492;106101;Szkoła Podstawowa nr 14 im. Józefa Lompy|Łódź|ul. Wigury 8/10 |90-301 Łódź;1510;722;722;13;709;47.81;1.80
91493;106101;Miejska Biblioteka Publiczna Łódź-Śródmieście im. Andrzeja Struga Filia Nr 9 dla Dorosłych|Łódź|ul. Brzeźna 10 |90-303 Łódź;1967;1348;1348;6;1342;68.53;0.45
91494;106101;Szkoła Podstawowa nr 2 im. ks. Jana Twardowskiego|Łódź|ul. Sienkiewicza 137/139 |90-302 Łódź;1329;470;470;4;466;35.36;0.85
91495;106101;Szkoła Podstawowa nr 14 im. Józefa Lompy|Łódź|ul. Wigury 8/10 |90-301 Łódź;1482;988;988;5;983;66.67;0.51
91496;106101;Lokal Rady Osiedla Katedralna|Łódź|ul. Żwirki 3 |90-448 Łódź;1113;654;654;5;649;58.76;0.76
91497;106101;Publiczne Gimnazjum nr 5 im. Króla Władysława Jagiełły|Łódź|ul. Sienkiewicza 117 |90-301 Łódź;847;416;416;3;413;49.11;0.72
91498;106101;Przedszkole Miejskie nr 5|Łódź|al. Kościuszki 54 |90-428 Łódź;1714;983;983;8;975;57.35;0.81
91499;106101;Szkoła Podstawowa nr 173 im. I Dywizji Kościuszkowskiej|Łódź|ul. Sienkiewicza 46 |90-009 Łódź;1245;592;592;9;583;47.55;1.52
91500;106101;III Liceum Ogólnokształcące im. Tadeusza Kościuszki|Łódź|ul. Sienkiewicza 46 |90-009 Łódź;1541;909;909;7;902;58.99;0.77
91501;106101;Miejski Ośrodek Pomocy Społecznej w Łodzi|Łódź|ul. Kilińskiego 102/102a |90-012 Łódź;1301;510;510;7;503;39.20;1.37
91502;106101;Miejski Ośrodek Pomocy Społecznej w Łodzi|Łódź|ul. Kilińskiego 102/102a |90-012 Łódź;397;174;174;5;169;43.83;2.87
91503;106101;Uniwersytet Medyczny w Łodzi|Łódź|al. Kościuszki 4 |90-419 Łódź;872;396;396;7;389;45.41;1.77
91504;106101;Związek Młodzieży Chrześcijańskiej Polska YMCA Ognisko w Łodzi|Łódź|ul. Moniuszki 4A |90-111 Łódź;1044;468;468;7;461;44.83;1.50
91505;106101;Łódzki Ośrodek Geodezji|Łódź|ul. Traugutta 21/23 |90-113 Łódź;1290;601;601;9;592;46.59;1.50
91506;106101;Publiczne Gimnazjum nr 2 im. Królowej Jadwigi|Łódź|ul. Jaracza 26 |90-262 Łódź;1571;618;618;11;607;39.34;1.78
91507;106101;Przedszkole Miejskie nr 100|Łódź|ul. Piotrkowska 44 |90-265 Łódź;890;363;363;6;357;40.79;1.65
91508;106101;Ośrodek Szkolenia Kierowców Krzysztof Kołodziejczak|Łódź|ul. Więckowskiego 13 |90-721 Łódź;1689;707;707;12;695;41.86;1.70
91509;106101;Szkoła Podstawowa nr 23 im. Marii Bohuszewiczówny|Łódź|ul. Gdańska 16 |90-707 Łódź;1562;589;589;11;578;37.71;1.87
91510;106101;Szkoła Podstawowa nr 23 im. Marii Bohuszewiczówny|Łódź|ul. Gdańska 16 |90-707 Łódź;661;247;247;4;243;37.37;1.62
91511;106101;IV Liceum Ogólnokształcące im. Emilii Sczanieckiej|Łódź|ul. Pomorska 16 |91-416 Łódź;780;303;303;9;294;38.85;2.97
91512;106101;IV Liceum Ogólnokształcące im. Emilii Sczanieckiej|Łódź|ul. Pomorska 16 |91-416 Łódź;2030;808;808;16;792;39.80;1.98
91513;106101;Szkoła Podstawowa nr 175 im. Henryka Ryla|Łódź|ul. Pomorska 27 |90-202 Łódź;1085;414;414;9;405;38.16;2.17
91514;106101;Szkoła Podstawowa nr 70 im. Stanisława Wyspiańskiego|Łódź|ul. Rewolucji 1905 r. nr 22 |90-207 Łódź;1863;722;722;22;700;38.75;3.05
91515;106101;Publiczne Gimnazjum nr 2 im. Królowej Jadwigi|Łódź|ul. Jaracza 26 |90-262 Łódź;1397;423;423;12;411;30.28;2.84
91516;106101;Lokal Rady Osiedla Śródmieście-Wschód|Łódź|ul. Jaracza 42 |90-252 Łódź;1283;557;557;11;546;43.41;1.97
91517;106101;Szkoła Podstawowa nr 111|Łódź|ul. Jaracza 44/46 |90-252 Łódź;1486;741;741;18;723;49.87;2.43
91518;106101;Akademia Humanistyczno- Ekonomiczna w Łodzi|Łódź|ul. Pomorska 51 |90-204 Łódź;1546;705;705;13;692;45.60;1.84
91519;106101;Szkoła Podstawowa nr 1 im. Adama Mickiewicza|Łódź|ul. Sterlinga 24 |90-212 Łódź;827;501;501;6;495;60.58;1.20
91520;106101;Polsko-Amerykański Ośrodek Kształcenia Zawodowego|Łódź|ul. Kamińskiego 17/19 |90-229 Łódź;1155;612;612;11;601;52.99;1.80
91521;106101;Publiczne Gimnazjum nr 3 im. Fryderyka Chopina|Łódź|ul. Zacisze 7/9 |90-228 Łódź;1333;760;760;15;745;57.01;1.97
91522;106101;VIII Liceum Ogólnokształcące im. Adama Asnyka|Łódź|ul. Pomorska 105 |91-402 Łódź;2082;1244;1246;10;1234;59.75;0.80
91523;106101;MPK - Łódź Sp. z o.o.|Łódź|ul. Tramwajowa 8 |90-132 Łódź;1746;1035;1035;12;1023;59.28;1.16
91524;106101;XXIX Liceum Ogólnokształcące im. hm. Janka Bytnara "Rudego"|Łódź|ul. Zelwerowicza 38/44 |90-148 Łódź;1630;1125;1125;5;1120;69.02;0.44
91525;106101;Bursa Samorządu Województwa Łódzkiego w Łodzi|Łódź|ul. Narutowicza 122 |92-145 Łódź;1037;695;695;2;693;67.02;0.29
91526;106101;Uniwersytet Łódzki Wydział Chemii|Łódź|ul. Tamka 12 |92-403 Łódź;1611;989;989;9;980;61.39;0.91
91527;106101;Szkoła Podstawowa nr 79 im. Łódzkich Olimpijczyków|Łódź|ul. Pomorska 138 |92-404 Łódź;628;410;410;3;407;65.29;0.73
91528;106101;Zespół Szkół Ogólnokształcących nr 8 im. Stanisława Staszica|Łódź|ul. Czernika 1/3 |92-538 Łódź;1267;764;764;15;749;60.30;1.96
91529;106101;Zespół Szkół Ogólnokształcących nr 8 im. Stanisława Staszica|Łódź|ul. Czernika 1/3 |92-538 Łódź;1366;860;860;12;848;62.96;1.40
91530;106101;Zespół Szkół Ogólnokształcących nr 8 im. Stanisława Staszica|Łódź|ul. Czernika 1/3 |92-538 Łódź;1754;1071;1071;25;1046;61.06;2.33
91531;106101;Zespół Szkół Ogólnokształcących nr 8 im. Stanisława Staszica|Łódź|ul. Czernika 1/3 |92-538 Łódź;1150;667;667;13;654;58.00;1.95
91532;106101;Zespół Szkół Ogólnokształcących nr 8 im. Stanisława Staszica|Łódź|ul. Czernika 1/3 |92-538 Łódź;1231;708;708;7;701;57.51;0.99
91533;106101;Szkoła Podstawowa nr 199 im. Juliana Tuwima|Łódź|ul. Elsnera 8 |92-504 Łódź;1458;833;833;16;817;57.13;1.92
91534;106101;Szkoła Podstawowa nr 199 im. Juliana Tuwima|Łódź|ul. Elsnera 8 |92-504 Łódź;1580;994;994;13;981;62.91;1.31
91535;106101;Szkoła Podstawowa nr 199 im. Juliana Tuwima|Łódź|ul. Elsnera 8 |92-504 Łódź;823;528;528;10;518;64.16;1.89
91536;106101;Szkoła Podstawowa nr 199 im. Juliana Tuwima|Łódź|ul. Elsnera 8 |92-504 Łódź;709;461;461;4;457;65.02;0.87
91537;106101;Szkoła Podstawowa nr 199 im. Juliana Tuwima|Łódź|ul. Elsnera 8 |92-504 Łódź;1309;861;861;7;854;65.78;0.81
91538;106101;Szkoła Podstawowa nr 34 im. Leona Kruczkowskiego|Łódź|ul. Ćwiklińskiej 9 |92-508 Łódź;1833;1167;1168;9;1158;63.67;0.77
91539;106101;Szkoła Podstawowa nr 34 im. Leona Kruczkowskiego|Łódź|ul. Ćwiklińskiej 9 |92-508 Łódź;1526;1013;1013;13;1000;66.38;1.28
91540;106101;Szkoła Podstawowa nr 34 im. Leona Kruczkowskiego|Łódź|ul. Ćwiklińskiej 9 |92-508 Łódź;1345;887;887;10;877;65.95;1.13
91541;106101;Zespół Szkół Ogólnokształcących nr 1|Łódź|ul. Czajkowskiego 14 |92-511 Łódź;1238;784;784;6;778;63.33;0.77
91542;106101;Zespół Szkół Ogólnokształcących nr 1|Łódź|ul. Czajkowskiego 14 |92-511 Łódź;991;581;581;6;575;58.63;1.03
91543;106101;Zespół Szkół Ogólnokształcących nr 1|Łódź|ul. Czajkowskiego 14 |92-511 Łódź;871;580;580;8;572;66.59;1.38
91544;106101;Szkoła Podstawowa nr 33 im. Stefana Kopcińskiego|Łódź|ul. Lermontowa 7 |92-512 Łódź;1681;1029;1029;4;1025;61.21;0.39
91545;106101;Szkoła Podstawowa nr 33 im. Stefana Kopcińskiego|Łódź|ul. Lermontowa 7 |92-512 Łódź;1749;1166;1166;18;1148;66.67;1.54
91546;106101;Szkoła Podstawowa nr 33 im. Stefana Kopcińskiego|Łódź|ul. Lermontowa 7 |92-512 Łódź;1652;1020;1020;11;1009;61.74;1.08
91547;106101;Szkoła Podstawowa nr 12 im. Mariana Batki|Łódź|ul. Jurczyńskiego 1/3 |92-306 Łódź;1023;651;651;9;642;63.64;1.38
91548;106101;Szkoła Podstawowa nr 12 im. Mariana Batki|Łódź|ul. Jurczyńskiego 1/3 |92-306 Łódź;1318;828;828;18;810;62.82;2.17
91549;106101;Szkoła Podstawowa nr 12 im. Mariana Batki|Łódź|ul. Jurczyńskiego 1/3 |92-306 Łódź;868;502;502;8;494;57.83;1.59
91550;106101;Szkoła Podstawowa nr 12 im. Mariana Batki|Łódź|ul. Jurczyńskiego 1/3 |92-306 Łódź;958;600;600;8;592;62.63;1.33
91551;106101;Szkoła Podstawowa nr 114 im. prof. Jana Dembowskiego|Łódź|ul. Milionowa 64 |92-334 Łódź;1689;1070;1070;13;1057;63.35;1.21
91552;106101;Szkoła Podstawowa nr 114 im. prof. Jana Dembowskiego|Łódź|ul. Milionowa 64 |92-334 Łódź;1654;1127;1127;13;1114;68.14;1.15
91553;106101;Lokal Rady Osiedla Nr 33|Łódź|ul. Dyspozytorska 3 |92-402 Łódź;628;328;328;6;322;52.23;1.83
91554;106101;Szkoła Podstawowa nr 141 im. gen. Mariusza Zaruskiego|Łódź|ul. Zakładowa 35 |92-402 Łódź;2015;1244;1244;12;1232;61.74;0.96
91555;106101;Szkoła Podstawowa nr 141 im. gen. Mariusza Zaruskiego|Łódź|ul. Zakładowa 35 |92-402 Łódź;1574;991;991;15;976;62.96;1.51
91556;106101;Szkoła Podstawowa nr 141 im. gen. Mariusza Zaruskiego|Łódź|ul. Zakładowa 35 |92-402 Łódź;1615;966;966;16;950;59.81;1.66
91557;106101;Publiczne Gimnazjum nr 36 im. Krzysztofa Kieślowskiego|Łódź|ul.Dąbrówki 1 |92-413 Łódź;1836;1180;1180;11;1169;64.27;0.93
91558;106101;Publiczne Gimnazjum nr 36 im. Krzysztofa Kieślowskiego|Łódź|ul. Dąbrówki 1 |92-413 Łódź;1578;1014;1014;5;1009;64.26;0.49
91559;106101;Publiczne Gimnazjum nr 36 im. Krzysztofa Kieślowskiego|Łódź|ul.Dąbrówki 1 |92-413 Łódź;1738;1090;1090;10;1080;62.72;0.92
91560;106101;Przedszkole Miejskie nr 4|Łódź|ul. Kmicica 5 |92-433 Łódź;1542;1110;1110;19;1091;71.98;1.71
91561;106101;Przedszkole Miejskie nr 4|Łódź|ul. Kmicica 5 |92-433 Łódź;1632;1190;1190;7;1183;72.92;0.59
91562;106101;Przedszkole Miejskie nr 4|Łódź|ul. Kmicica 5 |92-433 Łódź;1893;1215;1215;12;1203;64.18;0.99
91563;106101;Przedszkole Miejskie nr 4|Łódź|ul. Kmicica 5 |92-433 Łódź;1682;1052;1052;4;1048;62.54;0.38
91564;106101;Lokal Rady Osiedla Dolina Łódki|Łódź|ul. Beskidzka 172 |91-610 Łódź;1504;851;851;6;845;56.58;0.71
91565;106101;Publiczna Szkoła Podstawowa "Mileszki"|Łódź|ul. Pomorska 437 |92-735 Łódź;1433;853;853;15;838;59.53;1.76
91566;106101;Szkoła Podstawowa nr 37 im. Janusza Kusocińskiego|Łódź|ul. Szpitalna 9/11 |92-207 Łódź;1144;601;601;7;594;52.53;1.16
91567;106101;Szkoła Podstawowa nr 37 im. Janusza Kusocińskiego|Łódź|ul. Szpitalna 9/11 |92-207 Łódź;1359;744;744;7;737;54.75;0.94
91568;106101;Szkoła Podstawowa nr 37 im. Janusza Kusocińskiego|Łódź|ul. Szpitalna 9/11 |92-207 Łódź;1278;647;647;10;637;50.63;1.55
91569;106101;Szkoła Podstawowa nr 4 im. Komisji Edukacji Narodowej|Łódź|al. Marszałka Piłsudskiego 101 |92-329 Łódź;1139;542;542;25;517;47.59;4.61
91570;106101;Szkoła Podstawowa nr 4 im. Komisji Edukacji Narodowej|Łódź|al. Marszałka Piłsudskiego 101 |92-329 Łódź;1403;763;763;9;754;54.38;1.18
91571;106101;Szkoła Podstawowa nr 29 im. Jana Kochanowskiego|Łódź|ul. Przędzalniana 70 |90-338 Łódź;1529;570;570;10;560;37.28;1.75
91572;106101;Szkoła Podstawowa nr 170 im. Anieli Krzywoń|Łódź|ul. Miedziana 1/3 |90-038 Łódź;1485;553;553;9;544;37.24;1.63
91573;106101;Szkoła Podstawowa nr 170 im. Anieli Krzywoń|Łódź|ul.Miedziana 1/3 |90-038 Łódź;1128;415;415;14;401;36.79;3.37
91574;106101;Szkoła Podstawowa nr 170 im. Anieli Krzywoń|Łódź|ul. Miedziana 1/3 |90-038 Łódź;2120;967;967;18;949;45.61;1.86
91575;106101;II Liceum Ogólnokształcące im. Gabriela Narutowicza|Łódź|ul. Nowa 11/13 |90-031 Łódź;1186;738;738;7;731;62.23;0.95
91576;106101;II Liceum Ogólnokształcące im. Gabriela Narutowicza|Łódź|ul. Nowa 11/13 |90-031 Łódź;976;405;405;7;398;41.50;1.73
91577;106101;Publiczne Gimnazjum nr 32 im. Karola Wojtyły|Łódź|ul. Fabryczna 4 |90-325 Łódź;1565;529;529;16;513;33.80;3.02
91578;106101;Szkoła Podstawowa nr 29 im. Jana Kochanowskiego|Łódź|ul. Przędzalniana 70 |90-338 Łódź;1499;831;831;11;820;55.44;1.32
91579;106101;Szkoła Podstawowa nr 29 im. Jana Kochanowskiego|Łódź|ul. Przędzalniana 70 |90-338 Łódź;1340;707;707;10;697;52.76;1.41
91580;106101;Zespół Szkolno-Przedszkolny nr 2|Łódź|ul. Jugosłowiańska 2 |92-720 Łódź;1682;1078;1078;10;1068;64.09;0.93
91581;106101;Zespół Szkolno-Przedszkolny nr 2|Łódź|ul. Jugosłowiańska 2 |92-720 Łódź;1236;761;761;5;756;61.57;0.66
91582;106101;Przedszkole Miejskie nr 230|Łódź|ul. Przylesie 22 |92-644 Łódź;1286;636;636;9;627;49.46;1.42
91583;106101;Szkoła Podstawowa nr 204 im. Stefana Kardynała Wyszyńskiego|Łódź|ul. Gajcego 7/11 |92-610 Łódź;1607;959;959;18;941;59.68;1.88
91584;106101;Szkoła Podstawowa nr 204 im. Stefana Kardynała Wyszyńskiego|Łódź|ul. Gajcego 7/11 |02-610 Łódź;1659;968;968;12;956;58.35;1.24
91585;106101;Przedszkole Miejskie nr 65|Łódź|ul. Przybyszewskiego 92 |93-100 Łódź;1697;806;806;14;792;47.50;1.74
91586;106101;XLIV Liceum Ogólnokształcące|Łódź|ul. Wacława 22/24 |93-118 Łódź;1164;716;716;7;709;61.51;0.98
91587;106101;Przedszkole Miejskie nr 221-Integracyjne w Łodzi|Łódź|al. Marszałka Śmigłego-Rydza 38 |93-281 Łódź;1587;921;921;5;916;58.03;0.54
91588;106101;Szkoła Podstawowa nr 149 im. Obrońców Westerplatte|Łódź|ul. Tatrzańska 69A |93-219 Łódź;1649;1002;1002;10;992;60.76;1.00
91589;106101;Szkoła Podstawowa nr 149 im. Obrońców Westerplatte|Łódź|ul. Tatrzańska 69A |93-291 Łódź;2086;1248;1248;6;1242;59.83;0.48
91590;106101;Szkoła Podstawowa nr 149 im. Obrońców Westerplatte|Łódź|ul. Tatrzańska 69A |93-219 Łódź;1704;1039;1039;13;1026;60.97;1.25
91591;106101;Szkoła Podstawowa nr 193 im. Krzysztofa Kamila Baczyńskiego|Łódź|ul. Standego 1 |93-221 Łódź;1786;1048;1048;24;1024;58.68;2.29
91592;106101;Szkoła Podstawowa nr 193 im. Krzysztofa Kamila Baczyńskiego|Łódź|ul. Standego 1 |93-221 Łódź;1265;804;804;11;793;63.56;1.37
91593;106101;Szkoła Podstawowa nr 193 im. Krzysztofa Kamila Baczyńskiego|Łódź|ul. Standego 1 |93-221 Łódź;1171;817;817;8;809;69.77;0.98
91594;106101;Publiczne Gimnazjum nr 31 im. Szarych Szeregów|Łódź|ul. Generała Grota-Roweckiego 1 |93-217 Łódź;1138;648;649;10;638;56.94;1.54
91595;106101;Publiczne Gimnazjum nr 31 im. Szarych Szeregów|Łódź|ul. Generała Grota-Roweckiego 1 |93-217 Łódź;1095;647;647;15;632;59.09;2.32
91596;106101;Publiczne Gimnazjum nr 31 im. Szarych Szeregów|Łódź|ul. Generała Grota-Roweckiego 1 |93-217 Łódź;901;538;538;9;529;59.71;1.67
91597;106101;Publiczne Gimnazjum nr 33|Łódź|ul. Janosika 136 |92-108 Łódź;1209;814;814;3;811;67.33;0.37
91598;106101;Publiczne Gimnazjum nr 33|Łódź|ul. Janosika 136 |92-108 Łódź;1092;745;745;11;734;68.22;1.48
91599;106101;Szkoła Podstawowa nr 139 im. Wojska Polskiego|Łódź|ul. Giewont 28 |92-116 Łódź;1884;1118;1118;12;1106;59.34;1.07
91600;106101;Szkoła Podstawowa nr 139 im. Wojska Polskiego|Łódź|ul. Giewont 28 |92-116 Łódź;1651;840;840;8;832;50.88;0.95
91601;106101;Pogotowie Opiekuńcze Nr 1|Łódź|ul. Krokusowa 15/17 |92-101 Łódź;1694;1069;1069;14;1055;63.11;1.31
91602;106101;Publiczne Gimnazjum nr 30 im. Adama Mickiewicza|Łódź|ul. Nowogrodzka 6/14 |92-221 Łódź;1472;666;666;13;653;45.24;1.95
91603;106101;Uniwersytet Łódzki X Dom Studenta|Łódź|ul. Lumumby 12 |91-404 Łódź;309;255;255;3;252;82.52;1.18
91604;106101;Politechnika Łódzka Obiekt C 15|Łódź|al. Politechniki 3a |93-590 Łódź;117;104;104;2;102;88.89;1.92
91605;106101;Specjalistyczny Psychiatryczny Zespół Opieki Zdrowotnej w Łodzi|Łódź|ul. Aleksandrowska 159 |91-229 Łódź;489;122;122;7;115;24.95;5.74
91606;106101;Wojewódzki Zespół Zakładów Opieki Zdrowotnej Centrum Leczenia Chorób Płuc i Rehabilitacji w Łodzi|Łódź|ul. Okólna 181 |91-520 Łódź;169;99;99;2;97;58.58;2.02
91607;106101;Wojewódzki Specjalistyczny Szpital im. dr. Wł. Biegańskiego w Łodzi|Łódź|ul. Kniaziewicza 1/5 |91-347 Łódź;150;91;91;2;89;60.67;2.20
91608;106101;Miejskie Centrum Medyczne im. dr. Karola Jonschera w Łodzi|Łódź|ul. Przyrodnicza 7/9 |91-480 Łódź;54;10;10;0;10;18.52;0.00
91609;106101;Samodzielny Publiczny Zakład Opieki Zdrowotnej Ministerstwa Spraw Wewnętrznych w Łodzi|Łódź|ul. Północna 42 |91-425 Łódź;64;32;32;1;31;50.00;3.12
91610;106101;6 Dom Pomocy Społecznej w Łodzi|Łódź|ul. Złotnicza 10 |91-836 Łódź;106;29;29;1;28;27.36;3.45
91611;106101;Dom Pomocy Społecznej „Pogodna Jesień” w Łodzi|Łódź|ul. Dojazdowa 5/7 |91-503 Łódź;78;33;33;1;32;42.31;3.03
91612;106101;Dom Pomocy Społecznej „Dom Kombatanta” im. majora Eugeniusza Gedymina Kaszyńskiego „Nurta” w Łodzi|Łódź|ul. Przyrodnicza 24/26 |91-480 Łódź;40;30;30;3;27;75.00;10.00
91613;106101;Dom Pomocy Społecznej w Łodzi|Łódź|ul. Rojna 15 |91-142 Łódź;88;33;33;6;27;37.50;18.18
91614;106101;Areszt Śledczy w Łodzi|Łódź|ul. Smutna 21 |91-729 Łódź;800;435;435;61;374;54.37;14.02
91615;106101;Instytut Centrum Zdrowia Matki Polki w Łodzi|Łódź|ul. Rzgowska 281/289 |93-338 Łódź;213;93;93;0;93;43.66;0.00
91616;106101;Wojewódzki Szpital Specjalistyczny im. M. Kopernika w Łodzi|Łódź|ul. Pabianicka 62 |93-490 Łódź;397;167;167;7;160;42.07;4.19
91617;106101;Wojewódzki Szpital Specjalistyczny im. M. Kopernika w Łodzi Ośrodek Wczesnej Rehabilitacji Kardiologicznej|Łódź|ul. Popioły 40 |93-438 Łódź;56;36;36;1;35;64.29;2.78
91618;106101;BONI FRATRES LODZIENSIS sp. z o.o. Szpital Zakonu Bonifratrów św. Jana Bożego w Łodzi|Łódź|ul. Kosynierów Gdyńskich 61 |93-357 Łódź;81;30;30;1;29;37.04;3.33
91619;106101;5 Dom Pomocy Społecznej w Łodzi|Łódź|ul. Podgórna 2/14 |93-278 Łódź;71;21;21;4;17;29.58;19.05
91620;106101;3 Dom Pomocy Społecznej w Łodzi|Łódź|ul. Paradna 36 |93-345 Łódź;43;21;21;1;20;48.84;4.76
91621;106101;Dom Pomocy Społecznej w Łodzi|Łódź|ul. Rudzka 56 |93-423 Łódź;79;37;37;7;30;46.84;18.92
91622;106101;Dom Pomocy Społecznej Sióstr Służebniczek NMP NP im. bł. Edmunda Bojanowskiego w Łodzi|Łódź|ul. Kosynierów Gdyńskich 20 |93-357 Łódź;71;52;52;4;48;73.24;7.69
91623;106101;Zakład Karny Nr 2 w Łodzi|Łódź|ul. Kraszewskiego 1/5 |93-161 Łódź;225;120;120;16;104;53.33;13.33
91624;106101;Samodzielny Publiczny Zakład Opieki Zdrowotnej Uniwersytecki Szpital Kliniczny im. Wojskowej Akademii Medycznej Uniwersytetu Medycznego w Łodzi Centralny Szpital Weteranów|Łódź|ul. Żeromskiego 113 |90-549 Łódź;180;68;68;3;65;37.78;4.41
91625;106101;Samodzielny Publiczny Zakład Opieki Zdrowotnej Uniwersytecki Szpital Kliniczny im. Wojskowej Akademii Medycznej Uniwersytetu Medycznego w Łodzi Centralny Szpital Weteranów|Łódź|pl. Hallera 1 |90-647 Łódź;100;54;54;0;54;54.00;0.00
91626;106101;Wojewódzki Specjalistyczny Szpital im. M. Pirogowa w Łodzi|Łódź|ul. Wólczańska 191/195 |90-531 Łódź;178;82;82;3;79;46.07;3.66
91627;106101;Wojewódzki Specjalistyczny Szpital im. M. Pirogowa w Łodzi Ośrodek Szpitalny im. M. Madurowicza|Łódź|ul. Wileńska 37 |94-029 Łódź;190;89;89;3;86;46.84;3.37
91628;106101;2 Dom Pomocy Społecznej w Łodzi|Łódź|ul. 28 Pułku Strzelców Kaniowskich 32 |90-640 Łódź;82;28;28;10;18;34.15;35.71
91629;106101;Dom Pomocy Społecznej „Włókniarz” im. Jana Pawła II w Łodzi|Łódź|ul. Krzemieniecka 7/9 |94-017 Łódź;108;76;76;2;74;70.37;2.63
91630;106101;Samodzielny Publiczny Zakład Opieki Zdrowotnej Uniwersytecki Szpital Kliniczny im. Wojskowej Akademii Medycznej Uniwersytetu Medycznego w Łodzi Centralny Szpital Weteranów|Łódź|ul. Sterlinga 1/3 |91-425 Łódź;20;18;18;0;18;90.00;0.00
91631;106101;Samodzielny Publiczny Zakład Opieki Zdrowotnej Uniwersytecki Szpital Kliniczny nr 1 im. Norberta Barlickiego Uniwersytetu Medycznego w Łodzi|Łódź|ul. Kopcińskiego 22 |90-153 Łódź;207;60;60;1;59;28.99;1.67
91632;106101;Centrum Medyczne im. dr. L. Rydygiera Sp. z o. o.|Łódź|ul. Sterlinga 13 |90-217 Łódź;48;20;20;0;20;41.67;0.00
91633;106101;Dom Pomocy Społecznej w Łodzi|ul. Narutowicza|ul. Narutowicza 114 |90-145 ;78;28;28;4;24;35.90;14.29
91634;106101;Centrum Rehabilitacyjno-Opiekuńcze-Dom Pomocy Społecznej w Łodzi|Łódź|ul. Przybyszewskiego 255/267 |92-338 Łódź;549;170;170;12;158;30.97;7.06
91635;106101;Samodzielny Publiczny Zakład Opieki Zdrowotnej Centralny Szpital Kliniczny Instytut Stomatologii Uniwersytetu Medycznego w Łodzi|Łódź|ul. Pomorska 251 |92-213 Łódź;124;58;58;5;53;46.77;8.62
91636;106101;Samodzielny Publiczny Zakład Opieki Zdrowotnej Uniwersytecki Szpital Kliniczny im. Wojskowej Akademii Medycznej Uniwersytetu Medycznego w Łodzi Centralny Szpital Weteranów|Łódź|ul. Pieniny 30 |92-115 Łódź;107;25;25;0;25;23.36;0.00
91637;106101;Centrum Kliniczno-Dydaktyczne Uniwersytetu Medycznego w Łodzi Samodzielny Publiczny Zakład Opieki Zdrowotnej Uniwersytecki Szpital Kliniczny im. Wojskowej Akademii Medycznej Uniwersytetu Medycznego w Łodzi Centralny Szpital Weteranów|Łódź|ul. Pomorska 251 |92-213 Łódź;265;158;158;7;151;59.62;4.43
91638;106101;Miejskie Centrum Medyczne im. dr. Karola Jonschera w Łodzi|Łódź|ul. Milionowa 14 |93-102 Łódź;197;56;56;0;56;28.43;0.00
91639;106101;Zakład Karny Nr 1 w Łodzi|Łódź|ul. Beskidzka 54 |91-611 Łódź;497;147;147;16;131;29.58;10.88
91640;106201;Przedszkole Samorządowe Nr 11|Piotrków Trybunalski|ul.Adama Mickiewicza 98/102 |97-300 Piotrków Trybunalski;1142;636;636;6;630;55.69;0.94
91641;106201;Szkoła Podstawowa Nr 5 z Oddziałami Integracyjnymi|Piotrków Trybunalski|ul.Jerozolimska 73 |97-300 Piotrków Trybunalski;1099;610;610;10;600;55.51;1.64
91642;106201;Pogotowie Opiekuńcze|Piotrków Trybunalski|ul.Wojska Polskiego 75 |97-300 Piotrków Trybunalski;1670;814;814;11;803;48.74;1.35
91643;106201;Miejska Biblioteka Publiczna|Piotrków Trybunalski|ul.Jerozolimska 29 |97-300 Piotrków Trybunalski;1615;679;679;21;658;42.04;3.09
91644;106201;Zespół Szkół Ponadgimnazjalnych Nr 4|Piotrków Trybunalski|ul.Henryka Sienkiewicza 10/12 |97-300 Piotrków Trybunalski;880;370;370;11;359;42.05;2.97
91645;106201;Zespół Szkół Ponadgimnazjalnych Nr 5|Piotrków Trybunalski|ul.Leonarda 12/14 |97-300 Piotrków Trybunalski;1550;835;835;17;818;53.87;2.04
91646;106201;Szkoła Policealna Samorządu Województwa Łódzkiego|Piotrków Trybunalski|ul.Ks. Piotra Skargi 3 |97-300 Piotrków Trybunalski;1638;760;760;26;734;46.40;3.42
91647;106201;Lokal Wyborczy|Piotrków Trybunalski|ul.Zamurowa 10 |97-300 Piotrków Trybunalski;975;313;313;7;306;32.10;2.24
91648;106201;I Liceum Ogólnokształcące im. Bolesława Chrobrego|Piotrków Trybunalski|Al. Mikołaja Kopernika 1 |97-300 Piotrków Trybunalski;854;300;300;10;290;35.13;3.33
91649;106201;Przedszkole Samorządowe Nr 5|Piotrków Trybunalski|ul.Kazimierza Wielkiego 5 |97-300 Piotrków Trybunalski;1212;645;645;16;629;53.22;2.48
91650;106201;Gimnazjum Nr 4|Piotrków Trybunalski|ul.Adama Próchnika 8/12 |97-300 Piotrków Trybunalski;1701;848;848;20;828;49.85;2.36
91651;106201;Szkoła Podstawowa Nr 16|Piotrków Trybunalski|ul.Krakowskie Przedmieście 11 |97-300 Piotrków Trybunalski;1931;1033;1033;17;1016;53.50;1.65
91652;106201;Szkoła Podstawowa Nr 11|Piotrków Trybunalski|ul.Kazimierza Szmidta 3 |97-300 Piotrków Trybunalski;1922;892;892;16;876;46.41;1.79
91653;106201;Przedszkole Samorządowe Nr 12|Piotrków Trybunalski|ul.Włókiennicza 7 |97-300 Piotrków Trybunalski;1129;647;647;13;634;57.31;2.01
91654;106201;Lokal Wyborczy|Piotrków Trybunalski|ul.Jeziorna 41 |97-300 Piotrków Trybunalski;1946;1197;1197;13;1184;61.51;1.09
91655;106201;II Liceum Ogólnokształcące im. Marii Curie-Skłodowskiej|Piotrków Trybunalski|ul.Żeromskiego 11 |97-300 Piotrków Trybunalski;1482;885;885;19;866;59.72;2.15
91656;106201;Zespół Szkół Ponadgimnazjalnych Nr 1|Piotrków Trybunalski|ul.Franklina Roosevelta 1 |97-300 Piotrków Trybunalski;1594;755;755;16;739;47.37;2.12
91657;106201;Świetlica Środowiskowa TPD "Stokrotka"|Piotrków Trybunalski|ul.Wronia 55/59 |97-300 Piotrków Trybunalski;788;384;384;11;373;48.73;2.86
91658;106201;Zespół Szkół Ponadgimnazjalnych Nr 2|Piotrków Trybunalski|ul.Romana Dmowskiego 38 |97-300 Piotrków Trybunalski;1676;999;999;17;982;59.61;1.70
91659;106201;Przychodnia Nr 5|Piotrków Trybunalski|ul.Romana Dmowskiego 47 |97-300 Piotrków Trybunalski;1703;953;953;21;932;55.96;2.20
91660;106201;Przedszkole Samorządowe Nr 7|Piotrków Trybunalski|ul.Poprzeczna 7A |97-300 Piotrków Trybunalski;1940;1099;1099;17;1082;56.65;1.55
91661;106201;Szkoła Podstawowa Nr 13|Piotrków Trybunalski|ul.Romana Dmowskiego 11 |97-300 Piotrków Trybunalski;1948;1060;1060;16;1044;54.41;1.51
91662;106201;Przedszkole Samorządowe Nr 15|Piotrków Trybunalski|ul.Belzacka 78A |97-300 Piotrków Trybunalski;1483;894;894;13;881;60.28;1.45
91663;106201;Przedszkole Samorządowe Nr 20|Piotrków Trybunalski|ul.Ignacego Paderewskiego 1A |97-300 Piotrków Trybunalski;2171;1419;1419;22;1397;65.36;1.55
91664;106201;Przedszkole Samorządowe Nr 19|Piotrków Trybunalski|ul.Belzacka 97D |97-300 Piotrków Trybunalski;1775;1033;1033;16;1017;58.20;1.55
91665;106201;Szkoła Podstawowa Nr 12|Piotrków Trybunalski|ul.Belzacka 104/106 |97-300 Piotrków Trybunalski;2011;1212;1212;15;1197;60.27;1.24
91666;106201;Uniwersytet Jana Kochanowskiego w Kielcach Filia w Piotrkowie Trybunalskim|Piotrków Trybunalski|ul.Juliusza Słowackiego 114/118 |97-300 Piotrków Trybunalski;1959;1046;1046;10;1036;53.39;0.96
91667;106201;Szkoła Podstawowa Nr 2|Piotrków Trybunalski|ul.Jarosława Daniłowskiego 3 |97-300 Piotrków Trybunalski;2186;1256;1256;20;1236;57.46;1.59
91668;106201;III Liceum Ogólnokształcące im. Juliusza Słowackiego|Piotrków Trybunalski|Al. Armii Krajowej 17 |97-300 Piotrków Trybunalski;1674;855;855;9;846;51.08;1.05
91669;106201;Miejski Żłobek Dzienny|Piotrków Trybunalski|ul.Belzacka 97E |97-300 Piotrków Trybunalski;2081;1207;1207;24;1183;58.00;1.99
91670;106201;Gimnazjum Nr 5|Piotrków Trybunalski|ul.Kostromska 50 |97-300 Piotrków Trybunalski;1408;824;824;10;814;58.52;1.21
91671;106201;Lokal Wyborczy (na terenie dawnej HSG Hortensja)|Piotrków Trybunalski|ul.1 Maja 21 |97-300 Piotrków Trybunalski;1539;685;685;14;671;44.51;2.04
91672;106201;Dzienny Dom Pomocy Społecznej "Dom Seniora"|Piotrków Trybunalski|ul.Wojska Polskiego 127 |97-300 Piotrków Trybunalski;2351;1430;1430;24;1406;60.83;1.68
91673;106201;Przedszkole Samorządowe Nr 26|Piotrków Trybunalski|ul.Wojska Polskiego 133A |97-300 Piotrków Trybunalski;1953;1201;1201;19;1182;61.50;1.58
91674;106201;Zespół Szkolno-Gimnazjalny Nr 1|Piotrków Trybunalski|ul.Wysoka 28/38 |97-300 Piotrków Trybunalski;1513;798;798;17;781;52.74;2.13
91675;106201;Przedszkole Samorządowe Nr 24 z Oddziałami Integracyjnymi|Piotrków Trybunalski|ul.Topolowa 14A |97-300 Piotrków Trybunalski;1664;911;911;16;895;54.75;1.76
91676;106201;Ośrodek Doradztwa Rolniczego|Piotrków Trybunalski|ul.Kasztelańska 9 |97-300 Piotrków Trybunalski;1281;729;729;17;712;56.91;2.33
91677;106201;Samodzielny Szpital Wojewódzki|Piotrków Trybunalski|Rakowska 15 |97-300 Piotrków Trybunalski;209;77;77;3;74;36.84;3.90
91678;106201;Szpital Powiatowego Zespołu Opieki Zdrowotnej|Piotrków Trybunalski|Franklina Roosevelta 3 |97-300 Piotrków Trybunalski;73;29;29;1;28;39.73;3.45
91679;106201;Areszt Śledczy|Piotrków Trybunalski|Wronia 76/90 |97-300 Piotrków Trybunalski;606;271;271;37;234;44.72;13.65
91680;106201;Dom Pomocy Społecznej|Piotrków Trybunalski|Żwirki 5/7 |97-300 Piotrków Trybunalski;83;34;34;4;30;40.96;11.76
91681;106301;Gimnazium Nr 1|Skierniewice|ul. Szarych Szeregów 6 |96-100 Skierniewice;1410;787;787;16;771;55.82;2.03
91682;106301;Gimnazium Nr 1|Skierniewice|ul. Szarych Szeregów 6 |96-100 Skierniewice;1335;805;806;13;792;60.30;1.61
91683;106301;Przedszkole Nr 4|Skierniewice|ul. Jarosława Iwaszkiewicza 1 |96-100 Skierniewice;1815;1045;1045;15;1030;57.58;1.44
91684;106301;Klub "OAZA"|Skierniewice|ul. Jarosława Iwaszkiewicza 13 |96-100 Skierniewice;2028;1213;1213;11;1202;59.81;0.91
91685;106301;Zespół Szkół Integracyjnych|Skierniewice|ul. Przerwy-Tetmajera 7 |96-100 Skierniewice;1722;979;979;11;968;56.85;1.12
91686;106301;Zespół Szkół Integracyjnych|Skierniewice|ul. Przerwy-Tetmajera 7 |96-100 Skierniewice;1973;1125;1125;20;1105;57.02;1.78
91687;106301;Zespół Szkół Nr 3|Skierniewice|ul. Działkowa 10 |96-100 Skierniewice;712;454;454;5;449;63.76;1.10
91688;106301;Zespół Szkół Zawodowych Nr 2|Skierniewice|ul. Pomologiczna 15 |96-100 Skierniewice;1934;1069;1069;13;1056;55.27;1.22
91689;106301;Szkoła Podstawowa Nr 4|Skierniewice|ul. Jasna 30 |96-100 Skierniewice;1534;969;969;22;947;63.17;2.27
91690;106301;Szkoła Podstawowa Nr 7|Skierniewice|ul. Św. Maksymiliana Kolbe 30 |96-100 Skierniewice;1784;906;906;25;881;50.78;2.76
91691;106301;Zespół Szkół Nr 3|Skierniewice|ul. Działkowa 10 |96-100 Skierniewice;1274;863;865;10;853;67.74;1.16
91692;106301;Przedszkole Nr 10|Skierniewice|ul. Szkolna 1 |96-100 Skierniewice;1342;653;653;11;642;48.66;1.68
91693;106301;Zespół Szkół Integracyjnych|Skierniewice|ul. Przerwy-Tetmajera 7 |96-100 Skierniewice;1076;624;624;6;618;57.99;0.96
91694;106301;Liceum Ogólnokształcące im. Bolesława Prusa|Skierniewice|ul. Henryka Sienkiewicza 10 |96-100 Skierniewice;1865;862;862;24;838;46.22;2.78
91695;106301;Powiatowy Urząd Pracy|Skierniewice|ul. Al. Niepodległości 7 |96-100 Skierniewice;1461;862;862;8;854;59.00;0.93
91696;106301;Zespół Sportowych Szkół Ogólnokształcących|Skierniewice|ul. Marii Konopnickiej 5 |96-100 Skierniewice;1276;710;710;22;688;55.64;3.10
91697;106301;Miejski Ośrodek Kultury|Skierniewice|ul. Władysława Stanisława Reymonta 33 |96-100 Skierniewice;1270;646;646;21;625;50.87;3.25
91698;106301;Zespół Szkół Zawodowych Nr 1|Skierniewice|ul. Pomologiczna 6 |96-100 Skierniewice;1303;716;716;14;702;54.95;1.96
91699;106301;Miejska Biblioteka Publiczna|Skierniewice|ul. Mszczonowska 43 a |96-100 Skierniewice;2066;1108;1108;22;1086;53.63;1.99
91700;106301;Przedszkole Nr 3|Skierniewice|ul. Mikołaja Kopernika 15 |96-100 Skierniewice;1212;723;723;22;701;59.65;3.04
91701;106301;Gimnazium Nr 3|Skierniewice|ul. Jana Kilińskiego 9 |96-100 Skierniewice;2095;1139;1139;31;1108;54.37;2.72
91702;106301;Urząd Stanu Cywilnego|Skierniewice|ul. Piłsudskiego 2 |96-100 Skierniewice;1332;719;719;16;703;53.98;2.23
91703;106301;FERROXCUBE POLSKA Sp. z o.o.|Skierniewice|ul. Zwierzyniecka 2 |96-100 Skierniewice;1147;680;680;11;669;59.29;1.62
91704;106301;|Skierniewice|ul. Łódzka 36 |96-100 Skierniewice;1096;635;635;12;623;57.94;1.89
91705;106301;Przedszkole Nr 1|Skierniewice|Stefana Batorego 61/63 |96-100 Skierniewice;2186;1224;1224;25;1199;55.99;2.04
91706;106301;Wojewódzki Szpital Zespolony|Skierniewice|ul. Stanisława Rybickiego 1 |96-100 Skierniewice;122;41;41;1;40;33.61;2.44
91707;120101;Archiwum Narodowe w Krakowie Oddział w Bochni|Bochnia|ul. Proszowska 54 |32-700 Bochnia;791;385;385;10;375;48.67;2.60
91708;120101;Świetlica Bocheńskich Zakładów Usług Komunalnych Sp. z o.o. w Bochni|Bochnia|ul. 20 Stycznia 15 |32-700 Bochnia;2085;1180;1180;28;1152;56.59;2.37
91709;120101;Miejski Ośrodek Sportu i Rekreacji w Bochni sala JUDO|Bochnia|ul. Wojska Polskiego 1 |32-700 Bochnia;1070;632;632;21;611;59.07;3.32
91710;120101;Miejskie Przedszkole nr 5 w Bochni|Bochnia|ul. Kolejowa 14 |32-700 Bochnia;1090;577;577;7;570;52.94;1.21
91711;120101;Remiza Ochotniczej Straży Pożarnej Chodenice w Bochni|Bochnia|ul. Chodenicka 57 |32-700 Bochnia;1086;660;660;18;642;60.77;2.73
91712;120101;Staropolska Szkoła Wyższa w Kielcach Wydział Zamiejscowy w Bochni|Bochnia|ul. Trudna 1 |32-700 Bochnia;2177;1216;1216;17;1199;55.86;1.40
91713;120101;Publiczna Szkoła Podstawowa Nr 4 im. Św. Barbary w Bochni|Bochnia|ul. Konfederatów Barskich 27 |32-700 Bochnia;1338;819;819;10;809;61.21;1.22
91714;120101;Miejskie Przedszkole nr 6 w Bochni|Bochnia|ul. Murowianka 28 |32-700 Bochnia;1113;620;620;16;604;55.71;2.58
91715;120101;Urząd Miasta Bochnia|Bochnia|ul. Kazimierza Wielkiego 2 |32-700 Bochnia;1567;889;889;15;874;56.73;1.69
91716;120101;Publicza Szkoła Podstawowa nr 2 im. Kazimierza Brodzińskiego w Bochni|Bochnia|ul. Oracka 6 |32-700 Bochnia;2070;1213;1213;15;1198;58.60;1.24
91717;120101;Miejskie Przedszkole nr 3 w Bochni|Bochnia|ul. Kącik 7 |32-700 Bochnia;1363;856;856;16;840;62.80;1.87
91718;120101;Bursa Szkolnictwa Ponadgimnazjalnego w Bochni|Bochnia|ul. Kazimierza Wielkiego 67 |32-700 Bochnia;1299;756;756;8;748;58.20;1.06
91719;120101;Publicza Szkoła Podstawowa Nr 5 im. Jana Matejki w Bochni|Bochnia|ul. Kazimierza Wielkiego 71 |32-700 Bochnia;2163;1282;1282;21;1261;59.27;1.64
91720;120101;Zespół Szkół nr 1 w Bochni|Bochnia|ul. Windakiewicza 23 |32-700 Bochnia;1231;691;691;18;673;56.13;2.60
91721;120101;Miejskie Przedszkole nr 2 w Bochni|Bochnia|ul. Legionów Polskich 8 |32-700 ;1525;870;870;15;855;57.05;1.72
91722;120101;Miejskie Przedszkole nr 1 w Bochni|Bochnia|ul. Jakubowskiego 12 |32-700 Bochnia;1293;740;740;16;724;57.23;2.16
91723;120101;Szpital Powiatowy w Bochni|Bochnia|ul. Krakowska 31 |32-700 Bochnia;77;23;23;1;22;29.87;4.35
91724;120101;Dom Pomocy Społecznej w Bochni (świetlica DPS)|Bochnia|ul. Karolina 14 f |32-700 Bochnia;110;39;39;8;31;35.45;20.51
91725;120102;Zespół Szkół Gminnych w Proszówkach|Proszówki| 365 |32-700 Bochnia;1539;832;832;37;795;54.06;4.45
91726;120102;Świetlica Wiejska w Cikowicach|Cikowice| 69 |32-700 Bochnia;700;417;417;9;408;59.57;2.16
91727;120102;Świetlica Wiejska w Łapczycy|Łapczyca| 496 |32-744 Łapczyca;1661;821;821;33;788;49.43;4.02
91728;120102;Zespół Szkół Gminnych w Nieszkowicach Małych|Nieszkowice Małe| 112 |32-744 Łapczyca;995;479;479;22;457;48.14;4.59
91729;120102;Galeria Wiejska w Chełmie|Chełm| 75 |32-744 Łapczyca;1105;626;626;21;605;56.65;3.35
91730;120102;Zespół Szkół Gminnych w Nieszkowicach Wielkich|Nieszkowice Wielkie| 67 |32-700 Bochnia;1077;572;572;28;544;53.11;4.90
91731;120102;Zespół Szkół Gminnych w Bogucicach|Bogucice| 83 |32-711 Bogucice;1122;581;581;34;547;51.78;5.85
91732;120102;Gminne Przedszkole w Cerekwi|Cerekiew| 7 |32-711 Bogucice;496;249;249;5;244;50.20;2.01
91733;120102;Zespół Szkół Gminnych w Gawłowie|Gawłów| 64 |32-711 Bogucice;975;506;506;18;488;51.90;3.56
91734;120102;Świetlica Wiejska w Gierczycach|Gierczyce| 16 |32-744 Łapczyca;847;406;406;22;384;47.93;5.42
91735;120102;Świetlica Wiejska w Brzeźnicy|Brzeźnica| 168 |32-700 Bochnia;976;474;474;21;453;48.57;4.43
91736;120102;Świetlica Wiejska w Gorzkowie|Gorzków| 7 |32-700 Bochnia;367;225;225;7;218;61.31;3.11
91737;120102;Zespół Szkół Gminnych w Damienicach|Damienice| 11 |32-700 Bochnia;713;389;389;15;374;54.56;3.86
91738;120102;Zespół Szkół Gminnych w Baczkowie|Baczków| 23 |32-708 Dziewin;751;418;418;23;395;55.66;5.50
91739;120102;Zespół Szkół Gminnych w Pogwizdowie|Pogwizdów| 26 |32-700 Bochnia;872;399;399;19;380;45.76;4.76
91740;120102;Zespół Szkół Gminnych w Stanisławicach|Stanisławice| 306 |32-015 Kłaj;1123;555;555;9;546;49.42;1.62
91741;120103;Urząd Gminy w Drwini|Drwinia| 57 |32-709 Drwinia;1065;537;537;21;516;50.42;3.91
91742;120103;Gminne Centrum Kultury i Promocji w Grobli|Grobla| 155 |32-709 Drwinia;1161;674;674;26;648;58.05;3.86
91743;120103;Zespół Szkolny-Przedszkolny w Świniarach|Świniary| 74 |32-709 Drwinia;701;385;385;11;374;54.92;2.86
91744;120103;Zespół Szkolno-Przedszkolny w Mikluszowicach|Mikluszowice| 228 |32-708 Dziewin;1342;715;715;21;694;53.28;2.94
91745;120103;Zespół Szkolno-Przedszkolny w Dziewinie|Dziewin| 231 |32-708 Dziewin;877;419;419;22;397;47.78;5.25
91746;120104;Remiza OSP w Borównej|Borówna| 117 |32-724 Lipnica Murowana;266;118;118;5;113;44.36;4.24
91747;120104;Wiejski Dom Ludowy w Lipnicy Dolnej|Lipnica Dolna| 12 |32-724 Lipnica Murowana;887;466;466;28;438;52.54;6.01
91748;120104;Wiejski Dom Ludowy w Lipnicy Górnej|Lipnica Górna| 65 |32-724 Lipnica Murowana;855;451;451;19;432;52.75;4.21
91749;120104;Gminny Dom Kultury w Lipnicy Murowanej|Lipnica Murowana| 74 |32-724 Lipnica Murowana;591;388;388;13;375;65.65;3.35
91750;120104;Zespół Szkół w Rajbrocie|Rajbrot| 362 |32-725 Rajbrot;1784;850;850;57;793;47.65;6.71
91751;120105;Centrum Kultury Gminy Łapanów|Łapanów| 10 |32-740 Łapanów;1708;943;943;40;903;55.21;4.24
91752;120105;Centrum Kultury Gminy Łapanów|Łapanów| 10 |32-740 Łapanów;1478;700;700;28;672;47.36;4.00
91753;120105;Dom Kultury w Sobolowie|Sobolów| 97 |32-742 Sobolów;1130;607;607;52;555;53.72;8.57
91754;120105;Zespół Szkół w Tarnawie|Tarnawa| 119 |32-741 Tarnawa;1015;489;489;25;464;48.18;5.11
91755;120105;Publiczna Szkoła Podstawowa w Grabiu|Grabie| 60 |32-740 Łapanów;856;414;414;27;387;48.36;6.52
91756;120106;Remiza OSP|Królówka| 315 |32-722 Królówka;1614;904;904;51;853;56.01;5.64
91757;120106;Zespół Szkół|Nowy Wiśnicz|ul. Kościelna 2 |32-720 Nowy Wiśnicz;2133;1337;1337;30;1307;62.68;2.24
91758;120106;Świetlica Wiejska|Połom Duży| 85 |32-720 Nowy Wiśnicz;450;265;265;18;247;58.89;6.79
91759;120106;Środowiskowy Dom Samopomocy w Muchówce|Muchówka| 157 |32-722 Królówka;789;470;470;11;459;59.57;2.34
91760;120106;Zespół Szkół|Stary Wiśnicz| 480 |32-720 Nowy Wiśnicz;2150;1245;1245;38;1207;57.91;3.05
91761;120106;Zespół Szkół|Kobyle| 81 |32-720 Nowy Wiśnicz;1024;520;520;15;505;50.78;2.88
91762;120106;Szkoła Podstawowa|Chronów| 173 |32-720 Nowy Wiśnicz;361;177;177;14;163;49.03;7.91
91763;120106;Zespół Szkół|Nowy Wiśnicz|ul. Kościelna 2 |32-720 Nowy Wiśnicz;1969;1049;1049;40;1009;53.28;3.81
91764;120106;Zakład Karny w Nowym Wiśniczu|Nowy Wiśnicz| |32-720 Nowy Wiśnicz;333;171;171;19;152;51.35;11.11
91765;120107;Ośrodek Rehabilitacji w Rzezawie|Rzezawa|ul. Kościelna 6 |32-765 Rzezawa;2176;1278;1278;26;1252;58.73;2.03
91766;120107;Budynek OSP w Bratucicach|Bratucice| 12 |32-712 Bratucice;578;257;257;15;242;44.46;5.84
91767;120107;Świetlica Wiejska w Okulicach|Okulice| 35 |32-712 Bratucice;518;235;235;12;223;45.37;5.11
91768;120107;Zespół Szkolno - Przedszkolny w Łazach|Łazy| 50 |32-765 Rzezawa;813;424;424;14;410;52.15;3.30
91769;120107;Publiczna Szkoła Podstawowa w Krzeczowie|Krzeczów| 200 |32-700 Bochnia;1159;649;649;27;622;56.00;4.16
91770;120107;Zespół Szkolno - Przedszkolny w Borku|Borek| 148 |32-765 Rzezawa;1331;664;664;17;647;49.89;2.56
91771;120107;Dom Ludowy w Buczkowie|Buczków| 137 |32-712 Bratucice;304;155;155;5;150;50.99;3.23
91772;120107;Świetlica Wiejska w Dąbrówce|Dąbrówka| 1 |32-712 Bratucice;663;289;289;9;280;43.59;3.11
91773;120107;Publiczna Szkoła Podstawowa w Jodłówce|Jodłówka| 274 |32-765 Rzezawa;1095;599;599;18;581;54.70;3.01
91774;120108;Publiczna Szkoła Podstawowa w Kamionnej|Kamionna| 263 |32-732 Kamionna;853;476;476;12;464;55.80;2.52
91775;120108;Publiczna Szkoła Podstawowa w Kierlikówce|Kierlikówka| 4 |32-732 Kamionna;670;412;412;14;398;61.49;3.40
91776;120108;Zespół Szkół w Leszczynie|Leszczyna| 132 |32-733 Trzciana;619;329;329;4;325;53.15;1.22
91777;120108;Publiczna Szkoła Podstawowa w Łąkcie Dolnej|Łąkta Dolna| 136 |32-733 Trzciana;795;478;478;21;457;60.13;4.39
91778;120108;Publiczne Gimnazjum w Trzcianie|Trzciana| 403 |32-733 Trzciana;1246;673;673;22;651;54.01;3.27
91779;120109;Remiza Ochotniczej Straży Pożarnej|Łąkta Górna| 71 |32-731 Żegocina;1256;768;768;16;752;61.15;2.08
91780;120109;Zespół Szkół|Rozdziele| 156 |32-731 Żegocina;677;433;433;6;427;63.96;1.39
91781;120109;Urząd Gminy|Żegocina| 316 |32-731 Żegocina;1610;1029;1029;13;1016;63.91;1.26
91782;120109;Remiza Ochotniczej Straży Pożarnej|Bytomsko| 125 |32-731 Żegocina;544;349;349;12;337;64.15;3.44
91783;120201;Budynek Wielofunkcyjny w Bielczy|Bielcza| 325A |32-824 Bielcza;1317;596;596;21;575;45.25;3.52
91784;120201;Dom Ludowy w Borzęcinie Górnym|Borzęcin| 562 |32-825 Borzęcin;2292;1103;1103;55;1048;48.12;4.99
91785;120201;Publiczna Szkoła Podstawowa w Borzęcinie Dolnym|Borzęcin| 321B |32-825 Borzęcin;763;314;314;12;302;41.15;3.82
91786;120201;Remiza OSP w Łękach|Łęki| 80A |32-823 Szczepanów;500;250;250;15;235;50.00;6.00
91787;120201;Zespół Szkół - Sala Gimnastyczna w Przyborowie|Przyborów| 192 |32-823 Szczepanów;1501;707;707;25;682;47.10;3.54
91788;120201;Świetlica Wiejska w Warysiu|Waryś| 327A |32-825 Borzęcin;386;178;178;13;165;46.11;7.30
91789;120202;Publiczne Przedszkole Nr 4|Brzesko|ul. Ogrodowa 10 |32-800 Brzesko;1338;618;618;12;606;46.19;1.94
91790;120202;Budynek dawnego ratusza|Brzesko|ul. Kościuszki 7 |32-800 Brzesko;1248;686;686;8;678;54.97;1.17
91791;120202;Miejski Zakład Gospodarki Mieszkaniowej|Brzesko|ul. Okocimska 5 |32-800 Brzesko;1216;738;738;16;722;60.69;2.17
91792;120202;Kręgielnia BOSiR|Brzesko|ul. Browarna 13A |32-800 Brzesko;1077;561;561;13;548;52.09;2.32
91793;120202;Rejonowe Przedsiębiorstwo Wodociągów i Kanalizacji Spółka z o. o.|Brzesko|ul. Solskiego 13 |32-800 Brzesko;1387;809;809;21;788;58.33;2.60
91794;120202;Publiczne Gimnazjum Nr 1|Brzesko|ul. Głowackiego 57 |32-800 Brzesko;1171;700;700;13;687;59.78;1.86
91795;120202;Publiczna Szkoła Podstawowa Nr 3|Brzesko|ul. Legionów Piłsudskiego 23 |32-800 Brzesko;1586;939;939;18;921;59.21;1.92
91796;120202;Publiczna Szkoła Podstawowa Nr 3|Brzesko|ul. Legionów Pisudskiego 23 |32-800 Brzesko;1318;768;768;14;754;58.27;1.82
91797;120202;Publiczna Szkoła Podstawowa Nr 2|Brzesko|ul. Królowej Jadwigi 18 |32-800 Brzesko;1112;643;643;15;628;57.82;2.33
91798;120202;Publiczna Szkoła Podstawowa Nr 2|Brzesko|ul. Królowej Jadwigi 18 |32-800 Brzesko;1073;633;633;4;629;58.99;0.63
91799;120202;Publiczne Gimnazjum Nr 2|Brzesko|ul. Czarnowiejska 44 |32-800 Brzesko;1028;589;589;14;575;57.30;2.38
91800;120202;Publiczna Szkoła Podstawowa|Jasień|ul. Zielna 1 |32-800 Brzesko;413;215;215;2;213;52.06;0.93
91801;120202;Publiczna Szkoła Podstawowa|Jasień|ul. Zielna 1 |32-800 Brzesko;2001;1118;1118;31;1087;55.87;2.77
91802;120202;Publiczna Szkoła Podstawowa|Bucze|ul. Okulicka 6 |32-800 Brzesko;1063;525;525;22;503;49.39;4.19
91803;120202;Publiczne Gimnazjum|Jadowniki|ul. Szkolna 7 |32-851 Jadowniki;1364;696;696;23;673;51.03;3.30
91804;120202;Dom Ludowy|Jadowniki|ul.Krakowska 98 |32-851 Jadowniki;1372;706;706;18;688;51.46;2.55
91805;120202;Publiczna Szkoła Podstawowa Nr 1|Jadowniki|ul. Św. Prokopa 4 |32-851 Jadowniki;1265;621;621;22;599;49.09;3.54
91806;120202;Dom Ludowy|Okocim|ul. Goetzów Okocimskich 83 |32-800 Brzesko;1580;716;716;26;690;45.32;3.63
91807;120202;Publiczna Szkoła Podstawowa|Poręba Spytkowska|ul. Kasztelana Spytka 98 |32-800 Brzesko;1695;775;775;25;750;45.72;3.23
91808;120202;Gminny Ośrodek Sportu i Rekreacji|Mokrzyska|ul. Kościelna 1 |32-800 Brzesko;1744;813;813;20;793;46.62;2.46
91809;120202;Publiczna Szkoła Podstawowa|Mokrzyska|ul. Wiślana 47 |32-800 Brzesko;547;296;296;10;286;54.11;3.38
91810;120202;Publiczna Szkoła Podstawowa|Szczepanów|ul. Św. Stanisława 5 |32-823 Szczepanów;1033;531;531;18;513;51.40;3.39
91811;120202;Dom Kultury|Sterkowiec|ul. Sosnowa 18 |32-823 Szczepanów;744;407;407;4;403;54.70;0.98
91812;120202;Dom Ludowy Strażak|Wokowice|ul. Centralna 44 |32-828 Biadoliny Szlacheckie;396;198;198;13;185;50.00;6.57
91813;120202;Samodzielny Publiczny Zespół Opieki Zdrowotnej|Brzesko|ul. Kościuszki 68 |32-800 Brzesko;118;55;55;2;53;46.61;3.64
91814;120202;Powiatowy Publiczny Zakład Opiekuńczo-Leczniczy|Brzesko|ul. Kościuszki 33 |32-800 Brzesko;53;5;5;0;5;9.43;0.00
91815;120203;Publiczna Szkoła Podstawowa w Czchowie|Czchów|ul. Szkolna 2 |32-860 Czchów;1862;1007;1007;30;977;54.08;2.98
91816;120203;Budynek Komunalny w Wytrzyszczce|Wytrzyszczka| 15 |32-860 Czchów;473;252;252;2;250;53.28;0.79
91817;120203;Zespół Szkół w Jurkowie|Jurków| 150 |32-860 Czchów;1032;551;551;31;520;53.39;5.63
91818;120203;Zespół Szkół i Przedszkola w Złotej|Złota| 50 |32-859 Złota;1104;633;633;15;618;57.34;2.37
91819;120203;Zespół Szkół w Tymowej|Tymowa| 376 |32-863 Tymowa;1220;577;577;20;557;47.30;3.47
91820;120203;Zespół Szkół w Tworkowej|Tworkowa| 36 |32-863 Tymowa;849;416;416;25;391;49.00;6.01
91821;120203;Zespół Szkół i Przedszkola w Domosławicach|Domosławice| 24 |32-860 Czchów;584;307;307;12;295;52.57;3.91
91822;120203;Budynek Komunalny w Piaskach-Drużkowie|Piaski-Drużków| 1 |32-860 Czchów;381;175;175;10;165;45.93;5.71
91823;120203;Samodzielny Publiczny Gminny Zakład Opieki Zdrowotnej|Czchów|Sądecka 183 |32-860 Czchów;44;13;13;1;12;29.55;7.69
91824;120204;Zespół Szkolno-Przedszkolny w Dębnie|Dębno| 212 |32-852 Dębno;1328;742;742;26;716;55.87;3.50
91825;120204;Zespół Szkół w Porąbce Uszewskiej|Porąbka Uszewska| 306 |32-854 Porąbka Uszewska;1500;806;806;30;776;53.73;3.72
91826;120204;Publiczna Szkoła Podstawowa w Łoniowej|Łoniowa| 210 |32-854 Porąbka Uszewska;748;438;438;21;417;58.56;4.79
91827;120204;Zespół Szkolno-Przedszkolny w Łysej Górze|Łysa Góra| 275 |32-853 Łysa Góra;1187;692;692;12;680;58.30;1.73
91828;120204;Zespół Szkół w Sufczynie|Sufczyn| 250 |32-852 Dębno;1549;870;870;23;847;56.17;2.64
91829;120204;Zespół Szkolno-Przedszkolny w Maszkienicach|Maszkienice| 51 |32-828 Biadoliny Szlacheckie;1161;536;536;18;518;46.17;3.36
91830;120204;Publiczna Szkoła Podstawowa w Biadolinach Szlacheckich|Biadoliny Szlacheckie| 44 |32-828 Biadoliny Szlacheckie;1106;586;586;22;564;52.98;3.75
91831;120204;Publiczna Szkoła Podstawowa w Jaworsku|Jaworsko| 151 |32-853 Łysa Góra;553;285;285;17;268;51.54;5.96
91832;120204;Publiczna Szkoła Podstawowa w Niedźwiedzy|Niedźwiedza| 130 |32-854 Porąbka Uszewska;479;264;264;9;255;55.11;3.41
91833;120204;Urząd Gminy Dębno|Wola Dębińska| 240 |32-852 Dębno;1406;751;751;16;735;53.41;2.13
91834;120204;Dębińskie Centrum Kultury|Jastew| 13 |32-852 Dębno;409;211;211;9;202;51.59;4.27
91835;120204;Dom Pomocy Społecznej w Porąbce Uszewskiej|Porąbka Uszewska| 272 |32-854 Porąbka Uszewska;26;25;25;0;25;96.15;0.00
91836;120205;Publiczna Szkoła Podstawowa|Gnojnik| 336 |32-864 Gnojnik;1901;1093;1093;42;1051;57.50;3.84
91837;120205;Publiczna Szkoła Podstawowa|Uszew| 205 |32-865 Uszew;1265;631;631;30;601;49.88;4.75
91838;120205;Zespół Szkolno-Przedszkolny|Biesiadki| 58 |32-864 Gnojnik;901;460;460;19;441;51.05;4.13
91839;120205;Publiczna Szkoła Podstawowa|Gosprzydowa| 155 |32-864 Gnojnik;826;374;374;25;349;45.28;6.68
91840;120205;Zespół Szkół i Przedszkola|Lewniowa| 275 |32-864 Gnojnik;713;377;377;24;353;52.88;6.37
91841;120205;Dom Ludowy|Zawada Uszewska| 176 |32-865 Uszew;427;233;233;16;217;54.57;6.87
91842;120206;Publiczne Gimnazjum im. Jana Pawła II w Iwkowej|Iwkowa| 525 |32-861 Iwkowa;1219;646;646;30;616;52.99;4.64
91843;120206;Gminny Ośrodek Kultury w Iwkowej|Iwkowa| 468 |32-861 Iwkowa;912;543;543;16;527;59.54;2.95
91844;120206;Publiczna Szkoła Podstawowa w Kątach im. gen.Marcina Kątskiego|Kąty| 21 |32-862 Porąbka Iwkowska;1363;708;708;44;664;51.94;6.21
91845;120206;Zespół Szkół Publiczna Szkoła Podstawowa im.Kazimierza Brodzińskiego w Wojakowej|Wojakowa| 49 |32-862 Porąbka Iwkowska;1314;708;708;37;671;53.88;5.23
91846;120207;Ochotnicza Straż Pożarna w Górce|Górka| 67A |32-820 Szczurowa;394;121;121;9;112;30.71;7.44
91847;120207;Publiczna Szkoła Podstawowa w Niedzieliskach|Niedzieliska| 111 |32-820 Szczurowa;797;300;300;14;286;37.64;4.67
91848;120207;Publiczna Szkoła Podstawowa w Strzelcach Wielkich|Strzelce Wielkie| 60 |32-822 Strzelce Wielkie;655;237;237;3;234;36.18;1.27
91849;120207;Publiczne Gimnazjum w Szczurowej|Szczurowa|ul. Rynek 14 |32-820 Szczurowa;1594;692;692;17;675;43.41;2.46
91850;120207;Publiczna Szkoła Podstawowa w Woli Przemykowskiej|Wola Przemykowska| 102 |32-821 Zaborów;677;297;297;18;279;43.87;6.06
91851;120207;Publiczne Gimnazjum w Zaborowie|Zaborów| 63 |32-821 Zaborów;1022;403;403;24;379;39.43;5.96
91852;120207;Publiczna Szkoła Podstawowa w Uściu Solnym|Uście Solne| 80A |32-813 Uście Solne;798;379;379;12;367;47.49;3.17
91853;120207;Dom Ludowy w Dołędze|Dołęga| 39A |32-821 Zaborów;357;150;150;3;147;42.02;2.00
91854;120207;Szkoła Podstawowa w Szczurowej Filia Rudy-Rysie|Rudy-Rysie| 118 |32-820 Szczurowa;564;274;274;10;264;48.58;3.65
91855;120207;Szkoła Podstawowa w Szczurowej Filia Strzelce Małe|Strzelce Małe| 90 |32-822 Strzelce Wielkie;521;236;236;8;228;45.30;3.39
91856;120207;Publiczna Szkoła Podstawowa w Strzelcach Wielkich Filia Wrzępia|Wrzępia| 129 |32-822 Strzelce Wielkie;357;142;142;8;134;39.78;5.63
91857;120301;Zespół Szkół Nr 1 w Alwerni|Alwernia|Skłodowskiej-Curie 4 |32-566 Alwernia;1401;797;797;24;773;56.89;3.01
91858;120301;Urząd Miejski w Alwerni|Alwernia|Zbigniewa Gęsikowskiego 7 |32-566 Alwernia;1301;738;738;13;725;56.73;1.76
91859;120301;Zespół Szkół Nr 2 w Brodłach|Brodła|Edukacyjna 1 |32-566 Alwernia;840;366;366;18;348;43.57;4.92
91860;120301;Dom Ludowy w Grojcu|Grojec|Bartosza Głowackiego 11 |32-566 Alwernia;1026;562;562;18;544;54.78;3.20
91861;120301;Zespół Szkół Nr 3 w Kwaczale|Kwaczała|Jana Pawła II 2 |32-566 Awernia;1502;800;800;30;770;53.26;3.75
91862;120301;Dom Ludowy w Okleśnej|Okleśna|Nowowiejska 5 |32-566 Alwernia;1324;610;610;27;583;46.07;4.43
91863;120301;Szkoła Podstawowa w Porębie Żegoty|Poręba Żegoty|Szembeków 24 |32-566 Alwernia;954;434;434;18;416;45.49;4.15
91864;120301;Szkoła Podstawowa w Regulicach|Regulice|al. Jana Pawła II 10 |32-566 Alwernia;1963;1049;1049;34;1015;53.44;3.24
91865;120302;Przedszkole Samorządowe w Babicach|Babice|ul. Krakowska 49 |32-551 ;1224;757;757;29;728;61.85;3.83
91866;120302;Dom Kultury w Jankowicach|Jankowice|ul. Wadowicka 46 |32-551 Babice;606;311;311;12;299;51.32;3.86
91867;120302;Zespół Szkół w Mętkowie|Mętków|ul. Karola Wojtyły 21 |32-551 Babice;1178;631;631;22;609;53.57;3.49
91868;120302;Przedszkole Samorządowe w Olszynach|Olszyny|ul. Przedszkolna 4 |32-551 Babice;643;364;364;17;347;56.61;4.67
91869;120302;Szkoła Podstawowa w Rozkochowie|Rozkochów|ul. Chemików 4 |32-551 Babice;678;332;332;17;315;48.97;5.12
91870;120302;Dom Ludowy w Wygiełzowie|Wygiełzów|ul. Lipowiecka 3 |32-551 Babice;587;347;347;16;331;59.11;4.61
91871;120302;Przedszkole Samorządowe w Zagórzu|Zagórze|ul. Żelatowa 8 |32-555 Zagórze;497;249;249;12;237;50.10;4.82
91872;120302;Zespół Szkół w Zagórzu|Zagórze|ul. Marszałka Józefa Piłsudskiego 139 |32-555 Zagórze;973;480;480;13;467;49.33;2.71
91873;120302;Zespół Szkół w Zagórzu|Zagórze|Marszałka Józefa Piłsudskiego 139 |32-555 Zagórze;980;435;435;17;418;44.39;3.91
91874;120303;Miejski Ośrodek Kultury, Sportu i Rekreacji w Chrzanowie|Chrzanów|ul. Broniewskiego 4 |32-500 Chrzanów;1028;506;506;12;494;49.22;2.37
91875;120303;Zespół Szkół Nr 3 w Chrzanowie (Szkoła Podstawowa Nr 3)|Chrzanów|Aleja Henryka 45 |32-500 Chrzanów;932;508;508;14;494;54.51;2.76
91876;120303;Zespół Szkół Nr 3 w Chrzanowie (Szkoła Podstawowa Nr 3)|Chrzanów|Aleja Henryka 45 |32-500 Chrzanów;1399;674;674;18;656;48.18;2.67
91877;120303;Przedszkole Nr 5 w Chrzanowie|Chrzanów|ul. Kościuszki 27 |32-500 Chrzanów;951;559;559;10;549;58.78;1.79
91878;120303;I Liceum Ogólnokształcące w Chrzanowie|Chrzanów|ul. Piłsudskiego 14 |32-500 Chrzanów;1132;643;643;16;627;56.80;2.49
91879;120303;I Liceum Ogólnokształcące w Chrzanowie|Chrzanów|ul. Piłsudskiego 14 |32-500 Chrzanów;1401;907;907;4;903;64.74;0.44
91880;120303;Przedszkole Nr 1 w Chrzanowie|Chrzanów|ul. Śląska 74 |32-500 Chrzanów;1374;781;781;16;765;56.84;2.05
91881;120303;Szkoła Podstawowa Nr 5 w Chrzanowie|Chrzanów|ul. Fabryczna 23a |32-500 Chrzanów;1138;498;498;22;476;43.76;4.42
91882;120303;Szkoła Podstawowa Nr 5 w Chrzanowie|Chrzanów|ul. Fabryczna 23a |32-500 Chrzanów;1042;586;586;6;580;56.24;1.02
91883;120303;Miejski Ośrodek Kultury, Sportu i Rekreacji w Chrzanowie|Chrzanów|ul. Broniewskiego 4 |32-500 Chrzanów;1666;920;920;21;899;55.22;2.28
91884;120303;Publiczne Gimnazjum Nr 1 w Chrzanowie|Chrzanów|ul. Zielona 15 |32-500 Chrzanów;1641;911;911;16;895;55.51;1.76
91885;120303;Miejska Biblioteka Publiczna w Chrzanowie|Chrzanów|ul. Broniewskiego 10C |32-500 Chrzanów;1602;887;887;14;873;55.37;1.58
91886;120303;Szkoła Podstawowa Nr 1 w Chrzanowie|Chrzanów|ul. Borelowskiego 1 |32-500 Chrzanów;1537;860;860;23;837;55.95;2.67
91887;120303;Zespół Szkół Nr 2 (Szkoła Podstawowa Nr 10) w Chrzanowie|Chrzanów|ul. Kardynała Wyszyńskiego 19 |32-500 Chrzanów;821;452;452;11;441;55.05;2.43
91888;120303;Zespół Szkół Nr 2 (Szkoła Podstawowa Nr 10) w Chrzanowie|Chrzanów|ul. Kardynała Wyszyńskiego 19 |32-500 Chrzanów;1307;780;780;14;766;59.68;1.79
91889;120303;Przedszkole Nr 10 w Chrzanowie|Chrzanów|ul. Sikorskiego 6 |32-500 Chrzanów;1729;1021;1021;21;1000;59.05;2.06
91890;120303;Zespół Szkół Nr 1 w Chrzanowie (Szkoła Podstawowa Nr 8)|Chrzanów|ul. Pogorska 8c |32-500 Chrzanów;1325;683;683;15;668;51.55;2.20
91891;120303;Przedszkole Nr 9 w Chrzanowie|Chrzanów|ul. Brzezina 14 |32-500 Chrzanów;1738;960;960;16;944;55.24;1.67
91892;120303;Zespół Szkół Nr 1 (Szkoła Podstawowa Nr 8) w Chrzanowie|Chrzanów|ul. Pogorska 8c |32-500 Chrzanów;1693;926;926;20;906;54.70;2.16
91893;120303;Przedszkole Nr 9 w Chrzanowie|Chrzanów|ul. Brzezina 14 |32-500 Chrzanów;1653;940;940;13;927;56.87;1.38
91894;120303;Centrum Usług Socjalnych w Chrzanowie|Chrzanów|ul. Kolonia Stella 11 |32-500 Chrzanów;579;244;244;15;229;42.14;6.15
91895;120303;Szkoła Podstawowa Nr 6 w Chrzanowie|Chrzanów|ul. Dworska 5 |32-500 Chrzanów;2190;1347;1347;28;1319;61.51;2.08
91896;120303;Szkoła Podstawowa w Balinie|Balin|ul. Jaworznicka 139 |32-500 Chrzanów;1330;640;640;10;630;48.12;1.56
91897;120303;Szkoła Podstawowa w Balinie|Balin|ul. Jaworznicka 139 |32-500 Chrzanów;1154;601;601;12;589;52.08;2.00
91898;120303;Szkoła Podstawowa w Luszowicach|Luszowice, Okradziejówka|ul. Przybyszewskiego 6 |32-500 Chrzanów;1740;872;872;27;845;50.11;3.10
91899;120303;Zespół Szkół w Płazie|Płaza|ul. Wiosny Ludów 2 |32-552 Płaza;1261;684;684;15;669;54.24;2.19
91900;120303;Zespół Szkół w Płazie|Płaza|ul. Wiosny Ludów 2 |32-552 Płaza;1208;583;583;24;559;48.26;4.12
91901;120303;Szkoła Podstawowa w Pogorzycach|Płaza, Pogorzyce, Żrebce|ul. Szymanowskiego 21 |32-500 Chrzanów;1573;713;713;17;696;45.33;2.38
91902;120303;Szpital Powiatowy w Chrzanowie|Chrzanów|ul. Topolowa 16 -|32-500 Chrzanów;170;93;93;7;86;54.71;7.53
91903;120303;Powiatowy Dom Pomocy Społecznej im. Adama Starzeńskiego w Płazie|Płaza|ul. Wiosny Ludów 4 -|32-552 Płaza;78;35;35;2;33;44.87;5.71
91904;120303;Zakład Opiekuńczo-Leczniczy w Chrzanowie|Chrzanów|ul. Śląska 62a -|32-500 Chrzanów;84;50;50;0;50;59.52;0.00
91905;120304;Szkoła Podstawowa Nr 2 w Libiążu|Libiąż|Plac Zwycięstwa 2 |32-590 Libiąż;1519;869;869;30;839;57.21;3.45
91906;120304;Gimnazjum Nr 1 w Libiążu|Libiąż|ul. Szkolna 1 |32-590 Libiąż;1848;1099;1099;29;1070;59.47;2.64
91907;120304;Miejskie Centrum Medyczne w Libiążu|Libiąż|ul. 9 Maja 2 |32-590 Libiąż;807;484;484;7;477;59.98;1.45
91908;120304;Libiąskie Centrum Kultury|Libiąż|ul. Górnicza 1 |32-590 Libiąż;819;459;459;6;453;56.04;1.31
91909;120304;Zespół Szkolno-Gimnazjalny z Oddziałami Integracyjnymi w Libiążu (wejście boczne)|Libiąż|ul. Paderewskiego 2 |32-590 Libiąż;1738;954;954;29;925;54.89;3.04
91910;120304;Gimnazjum Nr 1 w Libiążu|Libiąż|ul. Szkolna 1 |32-590 Libiąż;974;570;570;9;561;58.52;1.58
91911;120304;Przedszkole Samorządowe Nr 4 w Libiążu|Libiąż|ul. Wańkowicza 1 |32-590 Libiąż;1464;736;736;34;702;50.27;4.62
91912;120304;Zespół Szkolno-Gimnazjalny z Oddziałami Integracyjnymi w Libiążu (wejście główne)|Libiąż|ul. Paderewskiego 2 |32-590 Libiąż;783;411;411;8;403;52.49;1.95
91913;120304;Szkoła Podstawowa Nr 3 w Libiążu|Libiąż|ul. Świętej Barbary 5 |32-590 Libiąż;918;493;493;20;473;53.70;4.06
91914;120304;Miejska Biblioteka Publiczna w Libiążu|Libiąż|ul. Górnicza 11 |32-590 Libiąż;1006;488;488;30;458;48.51;6.15
91915;120304;Ochotnicza Straż Pożarna Moczydło w Libiążu|Libiąż|ul. Generała Andersa 9 |32-590 Libiąż;930;460;460;12;448;49.46;2.61
91916;120304;Szkoła Podstawowa Nr 2 w Libiążu|Libiąż|Plac Zwycięstwa 2 |32-590 Libiąż;1017;608;608;20;588;59.78;3.29
91917;120304;Zespół Szkół w Żarkach|Żarki|ul. Astronautów 3 |32-593 Żarki;1526;831;831;23;808;54.46;2.77
91918;120304;Dom Kultury w Żarkach|Żarki|ul. Klubowa 5 |32-593 Żarki;1495;731;731;23;708;48.90;3.15
91919;120304;Świetlica w Gromcu|Gromiec|ul. Traugutta 1 |32-590 Libiąż;1282;705;705;33;672;54.99;4.68
91920;120305;Zespół Szkół z siedzibą w Trzebini|Trzebinia|Osiedle Związku Walki Młodych 21 |32-540 Trzebinia;1043;587;587;12;575;56.28;2.04
91921;120305;Zespół Szkół z siedzibą w Trzebini|Trzebinia|Osiedle Związku Walki Młodych 21 |32-540 Trzebinia;997;546;546;23;523;54.76;4.21
91922;120305;Zespół Szkół Ekonomiczno-Chemicznych w Trzebini|Trzebinia|Krakowska 12 |32-540 Trzebinia;1550;781;781;27;754;50.39;3.46
91923;120305;Usługi Komunalne w Trzebini|Trzebinia|Rynek 18 |32-540 Trzebinia;962;530;530;19;511;55.09;3.58
91924;120305;Dwór Zieleniewskich w Trzebini|Trzebinia|Piłsudskiego 47a |32-540 Trzebinia;1126;659;659;9;650;58.53;1.37
91925;120305;Powiatowy Młodzieżowy Dom Kultury w Trzebini|Trzebinia|Kościuszki 70 |32-540 Trzebinia;1067;539;539;6;533;50.52;1.11
91926;120305;Szkoła Podstawowa Nr 3 w Trzebini|Trzebinia|1 Maja 60 |32-540 Trzebinia;1245;608;608;17;591;48.84;2.80
91927;120305;Dom Gromadzki w Trzebini|Trzebinia|1 Maja 97 |32-540 Trzebinia;967;530;530;8;522;54.81;1.51
91928;120305;Szkoła Podstawowa Nr 4 w Trzebini|Trzebinia|24 Stycznia 47 |32-540 Trzebinia;672;268;268;15;253;39.88;5.60
91929;120305;Zespół Szkół Techniczno-Usługowych w Trzebini|Trzebinia|Gwarków 3 |32-541 Trzebinia;1160;559;559;21;538;48.19;3.76
91930;120305;Publiczne Społeczne Liceum Ogólnokształcące w Trzebini|Trzebinia|Grunwaldzka 101 |32-541 Trzebinia;1366;685;685;15;670;50.15;2.19
91931;120305;Publiczne Społeczne Liceum Ogólnokształcące w Trzebini|Trzebinia|Grunwaldzka 101 |32-541 Trzebinia;1265;705;705;12;693;55.73;1.70
91932;120305;Szkoła Podstawowa Nr 6|Trzebinia|Osiedle Gaj 39 |32-541 Trzebinia;1855;898;898;37;861;48.41;4.12
91933;120305;Szkoła Podstawowa Nr 6|Trzebinia|Osiedle Gaj 39 |32-541 Trzebinia;565;297;297;8;289;52.57;2.69
91934;120305;Wiejski Dom Kultury w Czyżówce|Czyżówka|Szkolna 15 |32-541 Trzebinia;541;292;292;16;276;53.97;5.48
91935;120305;Dom Strażaka w Płokach|Płoki|Główna 4 |32-543 Myślachowice;796;452;452;27;425;56.78;5.97
91936;120305;Wiejski Dom Kultury w Lgocie|Lgota|Trzebińska 39 |32-543 Myślachowice;740;382;382;8;374;51.62;2.09
91937;120305;Szkoła Podstawowa w Myślachowicach|Myślachowice|Trzebińska 15 |32-543 Myślachowice;1738;1012;1012;27;985;58.23;2.67
91938;120305;Wiejski Dom Kultury w Psarach|Psary|Św. Floriana 4 |32-545 Karniowice;1132;670;670;25;645;59.19;3.73
91939;120305;Wiejski Dom Kultury w Karniowicach|Karniowice|Władysława Łokietka 34 |32-545 Karniowice;1129;560;560;21;539;49.60;3.75
91940;120305;Dom Strażaka w Dulowej|Dulowa|Brata Alberta 5 |32-545 Karniowice;1187;714;714;13;701;60.15;1.82
91941;120305;Zespół Szkolno-Przedszkolny w Młoszowej|Młoszowa|Kamieniec 1 |32-546 Młoszowa;1391;781;781;11;770;56.15;1.41
91942;120305;Zespół Szkolno - Przedszkolny w Młoszowej|Młoszowa|Kamieniec 1 |32-546 Młoszowa;861;470;470;11;459;54.59;2.34
91943;120305;Wiejski Dom Kultury w Pile Kościeleckiej|Piła Kościelecka|Zielona 50 |32-540 Trzebinia;564;371;371;7;364;65.78;1.89
91944;120305;Szkoła Podstawowa w Bolęcinie|Bolęcin|Zakopiańska 14 |32-540 Trzebinia;1540;768;768;30;738;49.87;3.91
91945;120305;Zakład Karny w Trzebini|Trzebinia|Słowackiego 70 |32-540 Trzebinia;226;132;132;15;117;58.41;11.36
91946;120305;Raj-Med Sp. z o.o.|Trzebinia|Sikorskiego 71 |32-540 Trzebinia;32;20;20;9;11;62.50;45.00
91947;120401;Urząd Gminy w Bolesławiu|Bolesław| 68 |33-220 Bolesław;1798;670;670;16;654;37.26;2.39
91948;120401;Dom Ludowy w Samocicach|Samocice| 70 |33-220 Bolesław;538;195;195;8;187;36.25;4.10
91949;120402;Dąbrowski Dom Kultury|Dąbrowa Tarnowska|ul. Kościuszki 11 |33-200 Dąbrowa Tarnowska;1377;675;675;25;650;49.02;3.70
91950;120402;Dąbrowski Dom Kultury|Dąbrowa Tarnowska|ul. Kościuszki 11 |33-200 Dąbrowa Tarnowska;1596;859;859;18;841;53.82;2.10
91951;120402;Publiczne Gimnazjum Nr 1|Dąbrowa Tarnowska|ul. Zaręby 22 |33-200 Dąbrowa Tarnowska;1658;880;880;12;868;53.08;1.36
91952;120402;Publiczne Gimnazjum Nr 1|Dąbrowa Tarnowska|ul. Zaręby 22 |33-200 Dąbrowa Tarnowska;1642;799;799;22;777;48.66;2.75
91953;120402;Publiczna Szkoła Podstawowa Nr 1|Dąbrowa Tarnowska|ul. Kościelna 25A |33-200 Dąbrowa Tarnowska;1548;757;757;13;744;48.90;1.72
91954;120402;Publiczna Szkoła Podstawowa Nr 1|Dąbrowa Tarnowska|ul. Kościelna 25A |33-200 Dąbrowa Tarnowska;938;511;511;10;501;54.48;1.96
91955;120402;Publiczna Szkoła Podstawowa Nr 1|Dąbrowa Tarnowska|ul. Kościelna 25A |33-200 Dąbrowa Tarnowska;924;454;454;13;441;49.13;2.86
91956;120402;Dom Ludowy|Brnik| 36a |33-200 Dąbrowa Tarnowska;446;216;216;6;210;48.43;2.78
91957;120402;Dom Ludowy|Lipiny| 46A |33-206 Luszowice;535;258;258;11;247;48.22;4.26
91958;120402;Dom Ludowy|Nieczajna Dolna| 35b |33-205 Nieczajna Górna;486;199;199;17;182;40.95;8.54
91959;120402;Publiczna Szkoła Podstawowa|Nieczajna Górna| 337 |33-205 Nieczajna Górna;1097;453;453;10;443;41.29;2.21
91960;120402;Publiczna Szkoła Podstawowa|Smęgorzów| 330 |33-202 Smęgorzów;1024;416;416;11;405;40.62;2.64
91961;120402;Filia Publicznej Szkoły Podstawowej|Sutków| 88 |33-202 Smęgorzów;340;144;144;10;134;42.35;6.94
91962;120402;Publiczna Szkoła Podstawowa|Szarwark| 2 |33-200 Dąbrowa Tarnowska;707;302;302;8;294;42.72;2.65
91963;120402;Centrum Kulturalno-Społeczne|Żelazówka| 115A |33-200 Dąbrowa Tarnowska;464;271;271;4;267;58.41;1.48
91964;120402;Zespół Szkoły Podstawowej i Gimnazjum|Gruszów Wielki| 210 |33-200 Dąbrowa Tarnowska;960;400;400;8;392;41.67;2.00
91965;120402;Centrum Kulturalno-Społeczne|Laskówka Chorąska| 150 |33-200 Dąbrowa Tarnowska;547;277;277;11;266;50.64;3.97
91966;120402;Budynek byłej Szkoły Podstawowej|Morzychna| 69 |33-240 Żabno;292;152;152;5;147;52.05;3.29
91967;120402;Dom Pomocy Społecznej Św. Brata Alberta Chmielowskiego|Dąbrowa Tarnowska|ul. Świętego Brata Chmielowskiego 16 |33-200 Dąbrowa Tarnowska;34;12;12;2;10;35.29;16.67
91968;120402;Zespół Opieki Zdrowotnej w Dąbrowie Tarnowskiej|Dąbrowa Tarnowska|ul. Szpitalna 1 |33-200 Dąbrowa Tarnowska;170;33;33;1;32;19.41;3.03
91969;120403;Gminne Centrum Kultury i Czytelnictwa w Gręboszowie|Gręboszów| 143 |33-260 Gręboszów;903;408;408;4;404;45.18;0.98
91970;120403;Budynek Byłej Szkoły Podstawowej w Borusowej|Borusowa| 106 |33-260 Gręboszów;633;294;294;7;287;46.45;2.38
91971;120403;Budynek Byłego Gimnazjum w Woli Żelichowskiej|Wola Żelichowska| 6 |33-260 Gręboszów;652;295;295;4;291;45.25;1.36
91972;120403;Gabinet Rehabilitacji w Ujściu Jezuickim|Ujście Jezuickie| 95 |33-260 Gręboszów;699;312;312;6;306;44.64;1.92
91973;120404;Urząd Gminy w Mędrzechowie|Mędrzechów| 434 |33-221 Mędrzechów;1716;751;751;47;704;43.76;6.26
91974;120404;Dom Ludowy w Grądach|Grądy| 29 |33-221 Mędrzechów;569;220;220;5;215;38.66;2.27
91975;120404;Dom Ludowy w Woli Mędrzechowskiej|Wola Mędrzechowska| 176 |33-221 Mędrzechów;503;205;205;9;196;40.76;4.39
91976;120404;Dom Radosnej Starości w Kupieninie|Kupienin| 35 |33-221 Mędrzechów;64;30;30;1;29;46.88;3.33
91977;120405;Świetlica Urzędu Gminy w Oleśnie|Olesno|Długa 21A |33-210 Olesno;2270;1048;1048;33;1015;46.17;3.15
91978;120405;Dom Strażaka w Ćwikowie|Ćwików| 75B |33-264 Ćwików;689;317;317;11;306;46.01;3.47
91979;120405;Świetlica Wiejska w Podborzu|Podborze| |33-210 Olesno;454;216;216;8;208;47.58;3.70
91980;120405;Remiza OSP w Zalipiu|Zalipie| 4A |33-263 Zalipie;750;284;284;7;277;37.87;2.46
91981;120405;Szkoła Podstawowa w Wielopolu|Wielopole| 1 |33-210 Olesno;538;251;251;13;238;46.65;5.18
91982;120405;Remiza OSP w Pilczy Żelichowskiej|Pilcza Żelichowska| 72A |33-264 Ćwików;446;193;193;8;185;43.27;4.15
91983;120405;Remiza OSP w Dąbrówkach Breńskich|Dąbrówki Breńskie| 151B |33-210 Olesno;579;272;272;9;263;46.98;3.31
91984;120405;Budynek szkoły w Oleśnicy|Oleśnica| |33-200 Dąbrowa Tarnowska;589;283;283;5;278;48.05;1.77
91985;120406;Szkoła Podstawowa w Zarzeczu Dużym|Radgoszcz|ul. Mickiewicza 39 |33-207 Radgoszcz;1060;424;424;22;402;40.00;5.19
91986;120406;Zespół Szkół Publicznych w Radgoszczy|Radgoszcz|pl. Św. Kazimierza 10 |33-207 Radgoszcz;1588;837;837;43;794;52.71;5.14
91987;120406;Budynek Integracji Społeczności Wiejskiej w Żdżarach|Żdżary|ul. Tarnowska 104 |33-207 Radgoszcz;518;252;252;5;247;48.65;1.98
91988;120406;Wiejski Dom Kultury w Radgoszczy - Narożnikach|Radgoszcz|ul. Narożniki 75 |33-207 Radgoszcz;246;128;128;2;126;52.03;1.56
91989;120406;Zespół Szkół Publicznych w Luszowicach|Luszowice|ul. Tarnowska 31 |33-206 Luszowice;1443;714;714;26;688;49.48;3.64
91990;120406;Szkoła Filialna w Małcu|Małec|ul. Szczucińska 36 |33-207 Radgoszcz;433;144;144;9;135;33.26;6.25
91991;120406;Dom Ludowy w Smykowie|Smyków|ul. Jeziorańska 1 |33-206 Luszowice;488;235;235;11;224;48.16;4.68
91992;120407;Zespół Szkół w Borkach|Borki| 164 |33-230 Szczucin;1622;621;621;30;591;38.29;4.83
91993;120407;Szkoła Podstawowa w Zabrniu|Zabrnie| 82 |33-230 Szczucin;1255;442;442;19;423;35.22;4.30
91994;120407;Wiejski Dom Ludowy w Dąbrowicy|Dąbrowica| 231 |33-230 Szczucin;665;290;290;8;282;43.61;2.76
91995;120407;Zespół Szkolno-Przedszkolny w Skrzynce|Skrzynka| 146 |33-230 Szczucin;506;200;200;6;194;39.53;3.00
91996;120407;Wiejski Ośrodek Doradztwa Rolniczego w Lubaszu|Lubasz| 376 |33-230 Szczucin;1101;409;409;22;387;37.15;5.38
91997;120407;Gimnazjum w Radwanie|Radwan| 184 |33-202 Smęgorzów;520;201;201;6;195;38.65;2.99
91998;120407;Zespół Szkolno-Przedszkolny w Słupcu|Słupiec| 27 |33-230 Szczucin;851;376;376;26;350;44.18;6.91
91999;120407;Hala Widowiskowo-Sportowa w Szczucinie|Szczucin|ul. Rudnickiego 12 |33-230 Szczucin;1686;788;788;21;767;46.74;2.66
92000;120407;Urząd Miasta i Gminy w Szczucinie|Szczucin|ul. Wolności 3 |33-230 Szczucin;2397;1123;1123;45;1078;46.85;4.01
92001;120501;Siedziba Zarządu Osiedla Nr 10|Gorlice|ul. Kolejowa 4 |38-300 Gorlice;541;266;266;2;264;49.17;0.75
92002;120501;Gorlickie Centrum Kultury|Gorlice|ul. Józefa Michalusa 4 |38-300 Gorlice;770;335;335;17;318;43.51;5.07
92003;120501;Miejski Zespół Szkół Nr 3|Gorlice|ul. Kard. Stefana Wyszyńskiego 16 |38-300 Gorlice;858;393;393;13;380;45.80;3.31
92004;120501;Miejski Zespół Szkół Nr 3 (wejście boczne)|Gorlice|ul. Kard. Stefana Wyszyńskiego 16 |38-300 Gorlice;784;433;433;7;426;55.23;1.62
92005;120501;Miejskie Przedszkole Nr 8|Gorlice|ul. Gen. Józefa Hallera 17 |38-300 Gorlice;1098;557;557;8;549;50.73;1.44
92006;120501;Świetlica Spółdzielni Mieszkaniowej "Małopolska"|Gorlice|ul. Gen. Józefa Hallera 81 |38-300 Gorlice;965;477;477;5;472;49.43;1.05
92007;120501;I Liceum Ogólnokształcące im. Marcina Kromera|Gorlice|ul. Marcina Kromera 1 |38-300 Gorlice;952;545;545;8;537;57.25;1.47
92008;120501;Świetlica Osiedlowa Nr 5 (dawne przedszkole szwedzkie)|Gorlice|ul. Juliana Tuwima 6 |38-300 Gorlice;1173;601;601;12;589;51.24;2.00
92009;120501;Świetlica Towarzystwa Przyjaciół Dzieci (dawne przedszkole szwedzkie)|Gorlice|ul. Juliana Tuwima 6 |38-300 Gorlice;1035;483;483;10;473;46.67;2.07
92010;120501;Starostwo Powiatowe|Gorlice|ul. Biecka 3 |38-300 Gorlice;1142;548;548;8;540;47.99;1.46
92011;120501;Miejski Zespół Szkół Nr 4|Gorlice|ul. Zygmunta Krasińskiego 9 |38-300 Gorlice;1451;800;800;11;789;55.13;1.38
92012;120501;Państwowa Szkoła Muzyczna|Gorlice|ul. Walerego Wróblewskiego 12 |38-300 Gorlice;1225;581;581;13;568;47.43;2.24
92013;120501;Miejskie Przedszkole Nr 1|Gorlice|ul. Władysława Jagiełły 9 |38-300 Gorlice;689;344;344;9;335;49.93;2.62
92014;120501;Miejski Zespół Szkół Nr 5|Gorlice|ul. Krakowska 5 |38-300 Gorlice;1333;746;746;15;731;55.96;2.01
92015;120501;Miejskie Przedszkole Nr 5|Gorlice|ul. Krakowska 11 |38-300 Gorlice;1068;536;536;9;527;50.19;1.68
92016;120501;Klub "Jubilat"|Gorlice|ul. Mikołaja Kopernika 10 |38-300 Gorlice;983;516;516;8;508;52.49;1.55
92017;120501;Miejskie Przedszkole Nr 4|Gorlice|ul. Władysława Broniewskiego 11 |38-300 Gorlice;1321;678;678;16;662;51.32;2.36
92018;120501;Filia Zespołu Szkół Ekonomicznych|Gorlice|ul. Węgierska 13 |38-300 Gorlice;1035;579;579;4;575;55.94;0.69
92019;120501;Miejski Zespół Szkół Nr 1|Gorlice|ul. Piękna 9 |38-300 Gorlice;1175;593;593;15;578;50.47;2.53
92020;120501;Zespół Szkół Ekonomicznych (wejście główne)|Gorlice|ul. Ariańska 3 |38-300 Gorlice;999;549;549;13;536;54.95;2.37
92021;120501;Zespół Szkół Ekonomicznych (wejście od podwórza)|Gorlice|ul. Ariańska 3 |38-300 Gorlice;885;472;472;13;459;53.33;2.75
92022;120501;Filia Gorlickiego Centrum Kultury|Gorlice|ul. Dukielska 73 |38-300 Gorlice;1091;582;582;12;570;53.35;2.06
92023;120501;Dom Pomocy Społecznej|Gorlice|ul. Józefa Michalusa 14 |38-300 Gorlice;97;34;34;7;27;35.05;20.59
92024;120501;Dom Pomocy Społecznej|Gorlice|ul. Henryka Sienkiewicza 30 |38-300 Gorlice;67;40;40;7;33;59.70;17.50
92025;120501;Szpital Specjalistyczny im. H. Klimontowicza|Gorlice|ul. Węgierska 21 |38-300 Gorlice;390;75;75;4;71;19.23;5.33
92026;120502;Zespół Szkół Nr 1 im. bpa Marcina Kromera|Biecz|ul. Grodzka 22 |38-340 Biecz;1853;976;976;21;955;52.67;2.15
92027;120502;Remiza OSP|Biecz|ul. Kazimierza Wielkiego 15 |38-340 Biecz;1995;880;880;29;851;44.11;3.30
92028;120502;Remiza OSP|Binarowa| 457 |38-340 Biecz;1338;638;638;22;616;47.68;3.45
92029;120502;Dom Ludowy|Grudna Kępska| 163 |38-340 Biecz;554;241;241;8;233;43.50;3.32
92030;120502;Dom Ludowy|Głęboka| 136 |38-340 Biecz;390;130;130;4;126;33.33;3.08
92031;120502;Zespół Szkolno-Przedszkolny im. Świętej Kingi|Korczyna| 213 |38-340 Biecz;779;372;372;11;361;47.75;2.96
92032;120502;Zespół Szkolno-Przedszkolny im. prof. Aleksandra Kosiby|Libusza| 679 |38-306 Libusza;1723;849;849;25;824;49.27;2.94
92033;120502;Zespół Szkolno-Przedszkolny im. prof. Aleksandra Kosiby|Libusza| 679 |38-306 Libusza;910;446;446;22;424;49.01;4.93
92034;120502;Remiza OSP|Racławice| 219 |38-323 Rożnowice;659;281;281;6;275;42.64;2.14
92035;120502;Remiza OSP|Rożnowice| 356 |38-323 Rożnowice;1090;496;496;11;485;45.50;2.22
92036;120502;Szkoła Podstawowa im. Jana Pawła II|Sitnica| 103A |38-323 Rożnowice;499;224;224;6;218;44.89;2.68
92037;120502;Szkoła Podstawowa|Bugaj| 109 |38-323 Rożnowice;352;155;155;2;153;44.03;1.29
92038;120502;Zespół Szkolno-Przedszkolny im. Mikołaja Kopernika|Strzeszyn| 391 |38-340 Biecz;1564;704;704;23;681;45.01;3.27
92039;120503;Centrum Kultury i Promocji Gminy Bobowa|Bobowa|ul. Rynek 2 |38-350 Bobowa;1971;1205;1205;40;1165;61.14;3.32
92040;120503;Zespół Szkół|Brzana| 10 |38-350 Bobowa;952;436;436;23;413;45.80;5.28
92041;120503;Dom Kultury|Jankowa| 252 |38-350 Bobowa;800;464;464;24;440;58.00;5.17
92042;120503;Wiejski Dom Kultury|Siedliska| 298 |38-350 Bobowa;1209;558;558;19;539;46.15;3.41
92043;120503;Szkoła Podstawowa|Sędziszowa| 54 |38-350 Bobowa;437;210;210;1;209;48.05;0.48
92044;120503;Szkoła Podstawowa|Stróżna| 188 |38-350 Bobowa;699;345;345;16;329;49.36;4.64
92045;120503;Dom Kultury|Wilczyska| 30 |38-350 Bobowa;816;450;450;23;427;55.15;5.11
92046;120503;Remiza OSP|Bobowa|ul. Węgierska 17 |38-350 Bobowa;420;192;192;16;176;45.71;8.33
92047;120504;Dom Pracy Twórczej|Bielanka| 25 |38-311 Szymbark;171;70;70;5;65;40.94;7.14
92048;120504;Zespół Szkół|Bystra| 154 |38-300 Gorlice;1180;553;553;33;520;46.86;5.97
92049;120504;Wiejski Dom Kultury|Dominikowice| 44 |38-303 Kobylanka;1665;935;935;37;898;56.16;3.96
92050;120504;Zespół Szkół|Klęczany| 2 |38-333 Zagórzany;660;349;349;5;344;52.88;1.43
92051;120504;Wiejski Dom Kultury|Kobylanka| 207 |38-303 Kobylanka;2030;1035;1035;40;995;50.99;3.86
92052;120504;Zespół Szkół|Kwiatonowice| 21 |38-333 Zagórzany;500;240;240;5;235;48.00;2.08
92053;120504;Zespół Szkół|Ropica Polska| 70 |38-300 Gorlice;1714;856;856;20;836;49.94;2.34
92054;120504;Zespół Szkół|Stróżówka| 159 |38-300 Gorlice;1348;691;691;17;674;51.26;2.46
92055;120504;Zespół Szkół|Szymbark| 464 |38-311 Szymbark;1071;520;520;17;503;48.55;3.27
92056;120504;Zespół Szkół|Szymbark| 464 |38-311 Szymbark;1328;639;639;30;609;48.12;4.69
92057;120504;Dom Ludowy|Zagórzany| 208 |38-333 Zagórzany;1976;935;935;36;899;47.32;3.85
92058;120505;Budynek Wiejski|Pagorzyna| 238 |38-305 Lipinki;598;303;303;5;298;50.67;1.65
92059;120505;Publiczne Gimnazjum|Lipinki| 48A |38-305 Lipinki;1708;891;891;18;873;52.17;2.02
92060;120505;Szkoła Podstawowa|Rozdziele| 50A |38-304 Kryg;199;78;78;4;74;39.20;5.13
92061;120505;Zespół Szkół|Kryg| 397 |38-304 Kryg;1463;756;756;23;733;51.67;3.04
92062;120505;Szkoła Podstawowa|Wójtowa| 52 |38-305 Lipinki;1272;562;562;10;552;44.18;1.78
92063;120505;Dom Strażaka|Bednarka| 103 |38-304 Kryg;124;59;59;1;58;47.58;1.69
92064;120505;Budynek Wiejski|Bednarka| 75 |38-305 Lipinki;136;83;83;4;79;61.03;4.82
92065;120506;Remiza OSP|Biesna| 48 |38-350 Bobowa;580;248;248;5;243;42.76;2.02
92066;120506;Wiejski Dom Kultury|Łużna| 597 |38-322 Łużna;850;380;380;11;369;44.71;2.89
92067;120506;Wiejski Dom Kultury|Łużna| 597 |38-322 Łużna;836;367;367;6;361;43.90;1.63
92068;120506;Wiejski Dom Kultury|Łużna| 597 |38-322 Łużna;827;350;350;15;335;42.32;4.29
92069;120506;Dom Ludowy|Mszanka| 185 |38-322 Łużna;728;368;368;17;351;50.55;4.62
92070;120506;Zespół Szkół|Szalowa| 15 |38-331 Szalowa;1089;570;570;34;536;52.34;5.96
92071;120506;Zespół Szkół|Szalowa| 15 |38-331 Szalowa;592;280;280;4;276;47.30;1.43
92072;120506;Remiza OSP|Bieśnik| 53 |38-331 Szalowa;292;119;119;3;116;40.75;2.52
92073;120506;Dom Wiejski|Wola Łużańska| 177 |38-322 Łużna;793;404;404;15;389;50.95;3.71
92074;120507;Gimnazjum|Moszczenica| 940 |38-321 Moszczenica;1300;682;682;13;669;52.46;1.91
92075;120507;Gimnazjum|Moszczenica| 940 |38-321 Moszczenica;1379;604;604;24;580;43.80;3.97
92076;120507;Zespół Szkół|Staszkówka| 38 |38-321 Moszczenica;1134;446;446;16;430;39.33;3.59
92077;120508;Dom Pomocy Społecznej|Klimkówka| 67 |38-312 Ropa;256;97;97;3;94;37.89;3.09
92078;120508;Szkoła Podstawowa|Łosie| 120 |38-312 Ropa;625;309;309;13;296;49.44;4.21
92079;120508;Urząd Gminy Ropa (świetlica)|Ropa| 733 |38-312 Ropa;1364;750;750;32;718;54.99;4.27
92080;120508;Szkoła Podstawowa Nr 1|Ropa| 780 |38-312 Ropa;707;377;377;7;370;53.32;1.86
92081;120508;Urząd Gminy Ropa (sala obrad)|Ropa| 733 |38-312 Ropa;1075;563;563;18;545;52.37;3.20
92082;120509;Szkoła Podstawowa|Męcina Wielka| 89 |38-307 Sękowa;706;330;330;14;316;46.74;4.24
92083;120509;Gminny Ośrodek Kultury|Sękowa| 181 |38-307 Sękowa;1288;687;687;19;668;53.34;2.77
92084;120509;Szkoła Podstawowa|Siary| 29 |38-307 Sękowa;796;369;369;19;350;46.36;5.15
92085;120509;Budynek byłej Szkoły w Ropicy Górnej|Ropica Górna| 29 |38-307 Sękowa;791;306;306;10;296;38.69;3.27
92086;120509;Szkoła Podstawowa|Bodaki| 45 |38-307 Sękowa;280;116;116;4;112;41.43;3.45
92087;120509;Szkoła Podstawowa|Krzywa| 15 |38-307 Sękowa;154;42;42;4;38;27.27;9.52
92088;120510;Zespół Szkół|Uście Gorlickie| 276 |38-315 Uście Gorlickie;1207;480;480;31;449;39.77;6.46
92089;120510;Zespół Szkół|Brunary| 50 |38-315 Uście Gorlickie;828;331;331;13;318;39.98;3.93
92090;120510;Szkoła Podstawowa|Śnietnica| 28 |38-315 Uście Gorlickie;546;256;256;14;242;46.89;5.47
92091;120510;Szkoła Podstawowa|Wysowa-Zdrój| 97 |38-316 Wysowa-Zdrój;812;454;454;5;449;55.91;1.10
92092;120510;Szkoła Podstawowa|Gładyszów| 106 |38-315 Uście Gorlickie;295;117;117;2;115;39.66;1.71
92093;120510;Szkoła Podstawowa|Smerekowiec| 41 |38-315 Uście Gorlickie;374;130;130;7;123;34.76;5.38
92094;120510;Świetlica Wiejska|Zdynia| 30 |38-315 Uście Gorlickie;216;70;70;5;65;32.41;7.14
92095;120510;Szkoła Podstawowa|Banica| 24 |38-315 Uście Gorlickie;360;134;134;12;122;37.22;8.96
92096;120510;Szkoła Podstawowa|Hańczowa| 96 |38-316 Wysowa-Zdrój;459;187;187;14;173;40.74;7.49
92097;120510;Świetlica Wiejska|Kwiatoń| 34 |38-315 Uście Gorlickie;310;124;124;11;113;40.00;8.87
92098;120601;Urząd Gminy Czernichów|Czernichów| 2 |32-070 Czernichów;1671;905;905;31;874;54.16;3.43
92099;120601;Szkoła Podstawowa w Kłokoczynie|Kłokoczyn| 175 |32-070 Czernichów;297;138;138;5;133;46.46;3.62
92100;120601;Remiza OSP w Przegini Narodowej|Przeginia Narodowa| 65 |32-070 Czernichów;539;289;289;5;284;53.62;1.73
92101;120601;Remiza OSP w Zagaciu|Zagacie| 142 |32-070 Czernichów;648;331;331;12;319;51.08;3.63
92102;120601;Zespół Placówek Oświatowych w Kamieniu|Kamień| 145 |32-071 Kamień;1229;480;480;17;463;39.06;3.54
92103;120601;Szkoła Podstawowa w Rusocicach|Rusocice| 115 |32-071 Kamień;936;442;442;20;422;47.22;4.52
92104;120601;Remiza OSP w Rybnej|Rybna| 166 |32-061 Rybna;2085;1083;1083;39;1044;51.94;3.60
92105;120601;Szkoła Podstawowa w Nowej Wsi Szlacheckiej|Nowa Wieś Szlachecka| 255 |32-060 Liszki;626;304;304;8;296;48.56;2.63
92106;120601;Szkoła Podstawowa w Przegini Duchownej|Przeginia Duchowna| 70 |32-061 Rybna;929;465;465;9;456;50.05;1.94
92107;120601;Dom Ludowy w Wołowicach|Wołowice| 401 |32-070 Czernichów;1185;631;631;14;617;53.25;2.22
92108;120601;Remiza OSP w Dąbrowie Szlacheckiej|Dąbrowa Szlachecka| 258 |32-070 Czernichów;591;345;345;7;338;58.38;2.03
92109;120601;Szkoła Podstawowa w Czułówku|Czułówek| 85 |32-061 Rybna;399;252;252;5;247;63.16;1.98
92110;120602;Gminne Centrum Edukacji w Igołomi (szkoła)|Igołomia| 252 |32-125 Wawrzeńczyce;1285;515;515;17;498;40.08;3.30
92111;120602;Gminne Centrum Edukacji w Igołomi (szkoła)|Igołomia| 252 |32-125 Wawrzeńczyce;1072;424;424;15;409;39.55;3.54
92112;120602;Budynek byłej szkoły podstawowej w Pobiedniku Małym (WTZ)|Pobiednik Mały| 67 |32-125 Wawrzeńczyce;810;322;322;11;311;39.75;3.42
92113;120602;Gminne Centrum Edukacji w Wawrzeńczycach (szkoła)|Wawrzeńczyce| 385 |32-125 Wawrzeńczyce;938;455;455;12;443;48.51;2.64
92114;120602;Gminne Centrum Edukacji w Wawrzeńczycach (szkoła)|Wawrzeńczyce| 385 |32-125 Wawrzeńczyce;1003;409;409;13;396;40.78;3.18
92115;120602;Szkoła Podstawowa w Dobranowicach|Dobranowice| 67 |32-125 Wawrzeńczyce;520;219;219;8;211;42.12;3.65
92116;120602;Budynek Domu Ludowego w Stręgoborzycach|Stręgoborzyce| |32-125 Wawrzeńczyce;512;184;184;18;166;35.94;9.78
92117;120603;Samorządowe Przedszkole w Sieciechowicach|Sieciechowice| 63A |32-095 Iwanowice;1369;642;642;26;616;46.90;4.05
92118;120603;Szkoła Podstawowa w Celinach|Celiny| 155 |32-095 Iwanowice;649;253;253;16;237;38.98;6.32
92119;120603;Szkoła Podstawowa w Iwanowicach|Iwanowice Włościańskie| 98 |32-095 Iwanowice;1198;659;659;22;637;55.01;3.34
92120;120603;Szkoła Podstawowa w Widomej|Widoma| 51 |32-095 Iwanowice;1107;580;580;15;565;52.39;2.59
92121;120603;Szkoła Podstawowa w Naramie|Narama| 7 |32-095 Iwanowice;1384;826;826;12;814;59.68;1.45
92122;120603;Gimnazjum w Iwanowicach|Iwanowice Włościańskie| 98 |32-095 Iwanowice;1322;683;683;22;661;51.66;3.22
92123;120604;Remiza OSP w Gotkowicach|Gotkowice| 34 |32-048 Jerzmanowice;638;321;321;14;307;50.31;4.36
92124;120604;Zespół Szkół w Jerzmanowicach|Jerzmanowice| 366 |32-048 Jerzmanowice;2020;1134;1134;26;1108;56.14;2.29
92125;120604;Szkoła Podstawowa w Szklarach|Szklary| 121 |32-048 Jerzmanowice;499;253;253;15;238;50.70;5.93
92126;120604;Remiza OSP w Łazach|Łazy| 19 |32-048 Jerzmanowice;410;224;224;7;217;54.63;3.12
92127;120604;Szkoła Podstawowa w Sąspowie|Sąspów| 32 |32-048 Jerzmanowice;1135;580;580;16;564;51.10;2.76
92128;120604;Dom Ludowy w Przegini|Przeginia| 116a |32-049 Przeginia;1914;1049;1049;51;998;54.81;4.86
92129;120604;Szkoła Podstawowa w Czubrowicach|Czubrowice| 85 |32-049 Przeginia;895;434;434;23;411;48.49;5.30
92130;120604;Budynek Wielofunkcyjny w Racławicach|Racławice| 54a |32-049 Przeginia;1235;567;567;45;522;45.91;7.94
92131;120605;Szkoła Podstawowa w Goszycach|Goszyce| 53 |32-010 Luborzyca;1392;679;679;28;651;48.78;4.12
92132;120605;Szkoła Podstawowa w Luborzycy|Wysiołek Luborzycki| 160B |32-010 Luborzyca;2127;1119;1119;28;1091;52.61;2.50
92133;120605;Szkoła Podstawowa w Goszczy|Goszcza| |32-010 Luborzyca;896;416;416;10;406;46.43;2.40
92134;120605;Szkoła Podstawowa w Łuczycach|Łuczyce| 116 |32-010 Luborzyca;1157;652;652;12;640;56.35;1.84
92135;120605;Świetlica wiejska w Zastowie|Zastów| 6 |32-010 Luborzyca;1274;687;687;23;664;53.92;3.35
92136;120605;Przedszkole Samorządowe w Dojazdowie|Dojazdów| 33 |32-010 Luborzyca;1343;786;786;11;775;58.53;1.40
92137;120605;Szkoła Podstawowa w Karniowie - Szkolny Punkt Filialny w Czulicach|Czulice| 50 |32-010 Luborzyca;820;379;379;30;349;46.22;7.92
92138;120605;Szkoła Podstawowa w Pietrzejowicach|Pietrzejowice| 52 |32-010 Luborzyca;602;302;302;16;286;50.17;5.30
92139;120605;Filia Gminnej Biblioteki Publicznej w Kocmyrzowie|Kocmyrzów| 68 |32-010 Luborzyca;1100;593;593;17;576;53.91;2.87
92140;120605;Szkoła Podstawowa w Maciejowicach|Maciejowice| 25 |32-010 Luborzyca;783;396;396;4;392;50.57;1.01
92141;120606;Urząd Miejski w Krzeszowicach|Krzeszowice|ul. Grunwaldzka 4 |32-065 Krzeszowice;1053;609;609;7;602;57.83;1.15
92142;120606;Urząd Miejski w Krzeszowicach|Krzeszowice|ul. Grunwaldzka 4 |32-065 Krzeszowice;996;642;642;12;630;64.46;1.87
92143;120606;Szkoła Podstawowa w Krzeszowicach|Krzeszowice|ul. Szkolna 7 |32-065 Krzeszowice;925;543;543;8;535;58.70;1.47
92144;120606;Szkoła Podstawowa w Krzeszowicach|Krzeszowice|ul. Szkolna 7 |32-065 Krzeszowice;1015;522;522;8;514;51.43;1.53
92145;120606;Szkoła Podstawowa w Krzeszowicach|Krzeszowice|ul. Krakowska 11 |32-065 Krzeszowice;977;598;598;18;580;61.21;3.01
92146;120606;Szkoła Podstawowa w Krzeszowicach|Krzeszowice|ul. Krakowska 11 |32-065 Krzeszowice;1002;593;593;12;581;59.18;2.02
92147;120606;Publiczne Gimnazjum w Krzeszowicach|Krzeszowice|ul.Długa 22 |32-065 ;1330;816;816;19;797;61.35;2.33
92148;120606;Szkoła Podstawowa w Krzeszowicach|Krzeszowice|ul. Szkolna 7 |32-065 Krzeszowice;863;510;510;8;502;59.10;1.57
92149;120606;Remiza OSP w Czernej|Czerna| 325 |32-065 Krzeszowice;932;515;515;11;504;55.26;2.14
92150;120606;Szkoła Podstawowa w Paczółtowicach|Paczółtowice| 2 |32-065 Krzeszowice;723;382;382;17;365;52.84;4.45
92151;120606;Budynek Komunalny w Siedlcu|Siedlec| 5 |32-065 Krzeszowice;837;470;470;12;458;56.15;2.55
92152;120606;Szkoła Podstawowa w Nawojowej Górze|Nawojowa Góra|ul. Szkolna 1 |32-065 Krzeszowice;1570;827;827;15;812;52.68;1.81
92153;120606;Szkoła Podstawowa w Filipowicach|Filipowice| 554 |32-065 Krzeszowice;1706;906;906;27;879;53.11;2.98
92154;120606;Zespół Placówek Oświatowych w Woli Filipowskiej|Wola Filipowska|ul. Szkolna 2 |32-065 Krzeszowice;1128;568;568;22;546;50.35;3.87
92155;120606;Zespół Placówek Oświatowych w Woli Filipowskiej|Wola Filipowska|ul. Szkolna 2 |32-065 Krzeszowice;1115;605;605;25;580;54.26;4.13
92156;120606;Szkoła Podstawowa w Rudnie|Rudno| 48 |32-067 Tenczynek;612;296;296;19;277;48.37;6.42
92157;120606;Zespół Szkół w Zalasiu|Zalas| 533 |32-067 Tenczynek;915;457;457;23;434;49.95;5.03
92158;120606;Szkoła Podstawowa w Sance|Sanka| 266 |32-067 Tenczynek;1194;587;587;18;569;49.16;3.07
92159;120606;Zespół Szkół w Tenczynku|Tenczynek|ul. Szkolna 6 |32-067 Tenczynek;1126;599;599;10;589;53.20;1.67
92160;120606;Zespół Szkół w Tenczynku|Tenczynek|ul. Szkolna 6 |32-067 Tenczynek;1823;1010;1010;18;992;55.40;1.78
92161;120606;Dom Gromadzki w Nowej Górze|Nowa Góra| 479 |32-065 Krzeszowice;991;550;550;19;531;55.50;3.45
92162;120606;Szkoła Podstawowa w Ostrężnicy|Ostrężnica| 47 |32-065 Krzeszowice;1188;592;592;23;569;49.83;3.89
92163;120606;Szkoła Podstawowa w Miękini|Miękinia| 180 |32-065 Krzeszowice;1026;490;490;12;478;47.76;2.45
92164;120606;Zespół Szkół w Zalasiu|Zalas| 533 |32-067 Tenczynek;954;408;408;14;394;42.77;3.43
92165;120606;Dom Pomocy Społecznej w Czernej|Czerna| 110 |32-065 Krzeszowice;63;28;28;2;26;44.44;7.14
92166;120606;Ośrodek Rehabilitacji Narządu Ruchu w Krzeszowicach|Krzeszowice|Daszyńaskiego 1 |32-065 Krzeszowice;176;134;134;4;130;76.14;2.99
92167;120607;Zespół Szkół w Liszkach (budynek Szkoły Podstawowej w Liszkach)|Liszki| 5 |32-060 Liszki;1533;853;853;23;830;55.64;2.70
92168;120607;Szkoła Podstawowa w Rącznej|Rączna| 1 |32-060 Liszki;1485;666;666;12;654;44.85;1.80
92169;120607;Szkoła Podstawowa w Jeziorzanach|Jeziorzany| 1 |32-060 Liszki;751;324;324;11;313;43.14;3.40
92170;120607;Remiza OSP w Ściejowicach|Ściejowice| 186 |32-060 Liszki;726;383;383;12;371;52.75;3.13
92171;120607;Szkoła Podstawowa w Kaszowie|Kaszów| 185 |32-060 Liszki;1640;804;804;26;778;49.02;3.23
92172;120607;Szkoła Podstawowa w Czułowie|Czułów| 188 |32-060 Liszki;943;543;543;12;531;57.58;2.21
92173;120607;Gimnazjum w Mnikowie|Mników| 13 |32-084 Morawica;954;570;570;14;556;59.75;2.46
92174;120607;Dom Ludowy w Chrosnej|Chrosna| 150 |32-084 Morawica;541;300;300;9;291;55.45;3.00
92175;120607;Szkoła Podstawowa w Morawicy|Morawica| 1 |32-084 Morawica;876;428;428;10;418;48.86;2.34
92176;120607;Szkoła Podstawowa w Kryspinowie|Kryspinów| 356 |32-060 Liszki;1242;731;731;12;719;58.86;1.64
92177;120607;Szkoła Podstawowa w Cholerzynie|Cholerzyn| 205 |32-060 Liszki;1199;686;686;31;655;57.21;4.52
92178;120607;Szkoła Podstawowa w Piekarach|Piekary| 100 |32-060 Liszki;1225;685;685;14;671;55.92;2.04
92179;120608;Urząd Gminy Michałowice|Michałowice|pl. Józefa Piłsudskiego 1 |32-091 Michałowice;1402;921;921;12;909;65.69;1.30
92180;120608;Zespól Szkół w Michałowicach|Michałowice|ul. Jana Pawła II 1 |32-091 Michałowice;1380;773;774;15;758;56.01;1.94
92181;120608;Zespół Szkół w Michałowicach|Michałowice|ul. Jana Pawła II 1 |32-091 Michałowice;1977;1102;1102;35;1067;55.74;3.18
92182;120608;Zespół Szkół w Więcławicach Starych|Więcławice Stare| 19 |32-091 Michałowice;1639;894;894;12;882;54.55;1.34
92183;120608;Zespół Szkół w Raciborowicach|Raciborowice|Jana Długosza 36 |32-091 Michałowice;1119;608;608;17;591;54.33;2.80
92184;120609;Szkoła Podstawowa im.Oskara Kolberga w Bukowie|Buków| 1 |32-031 Mogilany;784;425;425;19;406;54.21;4.47
92185;120609;Budynek starej Szkoły Podstawowej w Chorowicach|Chorowice| 30 |32-031 Mogilany;887;537;537;22;515;60.54;4.10
92186;120609;Zespół Szkół im.Jana Pawła II w Gaju|Gaj|ul.Szkolna 73 |32-031 Mogilany;2256;1341;1341;20;1321;59.44;1.49
92187;120609;Szkoła Podstawowa im.Marii Konopnickiej w Konarach|Konary| 65 |32-031 Mogilany;848;429;429;13;416;50.59;3.03
92188;120609;Szkoła Podstawowa w Libertowie|Libertów|ul.Jana Pawła II 43 |30-444 Kraków 55;1887;1200;1200;8;1192;63.59;0.67
92189;120609;Sala narad w UG Mogilany|Mogilany|ul.Rynek 2 |32-031 Mogilany;1358;817;817;19;798;60.16;2.33
92190;120609;Szkoła Podstawowa we Włosani|Włosań|ul.Królowej Polski 142 |32-031 Mogilany;1102;634;634;17;617;57.53;2.68
92191;120609;budynek strażnicy OSP w Mogilanach|Mogilany|ul.Krakowska 5 |32-031 Mogilany;1154;709;709;11;698;61.44;1.55
92192;120610;Remiza Ochotniczej Straży Pożarnej w Skale|Skała|Klub Florian ul. Krakowska 34 |32-043 Skała;1520;852;852;22;830;56.05;2.58
92193;120610;Szkoła Podstawowa w Skałe|Skała|ul.Topolowa 25 |32-043 Skała;1926;1081;1081;30;1051;56.13;2.78
92194;120610;Szkoła Podstawowa w Minodze|Minoga| 18 |32-046 Minoga;1937;864;864;32;832;44.61;3.70
92195;120610;Remiza Ochotniczej Straży Pożarnej w Smardzowicach|Smardzowice| 6 |32-077 Smardzowice;1055;615;615;16;599;58.29;2.60
92196;120610;Dom Pomocy Społecznej im.Brata Alberta w Ojcowie|Ojców| 64 |32-047 Ojców;199;116;116;3;113;58.29;2.59
92197;120610;Szkoła Podstawowa w Szczodrkowicach|Szczodrkowice| 3 |32-043 Skała;539;298;298;9;289;55.29;3.02
92198;120610;Szkoła Podstawowa w Cianowicach|Cianowice|ul.Szkolna 30 |32-043 Skała;1082;491;491;12;479;45.38;2.44
92199;120611;Gimnazjum Nr 2 w Skawinie|Skawina|ul. Mickiewicza 11 a |32-050 Skawina;2043;1078;1078;23;1055;52.77;2.13
92200;120611;Gimnazjum Nr 2 w Skawinie|Skawina|ul. Mickiewicza 11 a |32-050 Skawina;1543;879;879;22;857;56.97;2.50
92201;120611;Szkoła Podstawowa Nr 1 w Skawinie|Skawina|ul. Korabnicka 19 |32-050 Skawina;1138;661;661;10;651;58.08;1.51
92202;120611;Zespół Szkół Ogólnokształcących w Skawinie|Skawina|ul. Żwirki i Wigury 17 |32-050 Skawina;1780;870;870;18;852;48.88;2.07
92203;120611;Szkoła Podstawowa Nr 2 w Skawinie|Skawina|ul. Żwirki i Wigury 17 |32-050 Skawina;1783;991;991;14;977;55.58;1.41
92204;120611;Zespół Szkół Techniczno-Ekonomicznych w Skawinie|Skawina|ul. Kopernika 13 |32-050 Skawina;1165;692;692;13;679;59.40;1.88
92205;120611;Zespół Szkół Techniczno-Ekonomicznych w Skawinie|Skawina|ul. Kopernika 13 |32-050 Skawina;2128;1157;1157;21;1136;54.37;1.82
92206;120611;Spółdzielnia Mieszkaniowa Lokatorsko - Własnościowa w Skawinie|Skawina|ul. Ogrody 31 |32-050 Skawina;1671;905;905;13;892;54.16;1.44
92207;120611;Centrum Wspierania Rodziny, Urząd Miasta i Gminy w Skawinie|Skawina|ul.Popiełuszki 17 |32-050 Skawina;1917;1054;1054;11;1043;54.98;1.04
92208;120611;Gimnazjum Nr 1 w Skawinie|Skawina|ul. Witosa 4 |32-050 Skawina;1300;684;684;12;672;52.62;1.75
92209;120611;Gimnazjum Nr 1 w Skawinie|Skawina|ul. Witosa 4 |32-050 Skawina;1110;629;629;9;620;56.67;1.43
92210;120611;Szkoła Podstawowa Nr 4|Skawina|ul.Wyspiańskiego 5 |32-050 Skawina;1418;876;876;15;861;61.78;1.71
92211;120611;Zespół Szkół Publicznych w Radziszowie|Radziszów|ul. Szkolna 7 |32-052 Radziszów;1645;950;950;18;932;57.75;1.89
92212;120611;Dom Ludowy w Woli Radziszowskiej|Wola Radziszowska| 590 |32-053 Wola Radziszowska;1899;916;916;36;880;48.24;3.93
92213;120611;Szkoła Podstawowa w Krzęcinie|Krzęcin| 301 |32-051 Wielkie Drogi;1265;664;664;34;630;52.49;5.12
92214;120611;Dom Ludowy w Jaśkowicach|Jaśkowice| 13 |32-051 Wielkie Drogi;845;399;399;22;377;47.22;5.51
92215;120611;Zespół Placówek Edukacyjno-Opiekuńczo-Wychowawczych w Wielkich Drogach|Wielkie Drogi| 192 |32-051 Wielkie Drogi;1475;692;692;14;678;46.92;2.02
92216;120611;Szkoła Podstawowa w Zelczynie|Zelczyna| 120 |32-051 Wielkie Drogi;758;447;447;11;436;58.97;2.46
92217;120611;Dom Ludowy w Pozowicach|Pozowice| 170 |32-051 WIELKIE DROGI;542;247;247;15;232;45.57;6.07
92218;120611;Szkoła Podstawowa w Rzozowie|Rzozów| 90 |32-052 Radziszów;1709;933;933;38;895;54.59;4.07
92219;120611;Zespół Placówek Oświatowych w Borku Szlacheckim|Borek Szlachecki| 106 |32-050 Skawina;1085;573;573;16;557;52.81;2.79
92220;120611;Zespół Placówek Oświatowych w Kopance|Kopanka| 62 |32-050 Skawina;725;350;350;14;336;48.28;4.00
92221;120611;Zespół Szkół Publicznych w Radziszowie|Radziszów|ul.Szkolna 7 |32-052 Radziszów;1423;790;790;25;765;55.52;3.16
92222;120611;Dom Ludowy w Ochodzy|Ochodza| 96 |32-051 Wielkie Drogi;699;340;340;9;331;48.64;2.65
92223;120611;Przedszkole Samorządowe w Polance Hallera|Polanka Hallera| 37 |32-052 Radziszów;675;345;345;18;327;51.11;5.22
92224;120612;Hala Sportowa w Słomnikach|Słomniki|ul. Karola Świerczewskiego 20 |32-090 Słomniki;1464;750;750;18;732;51.23;2.40
92225;120612;Zespół Szkoł Ogólnokształcących w Słomnikach|Słomniki|ul. Karola Świerczewskiego 2 |32-090 Słomniki;1396;737;737;18;719;52.79;2.44
92226;120612;Miejsko-Gminne Centrum Kultury w Słomnikach|Słomniki|ul. Wolności 4 |32-090 Słomniki;1472;840;840;32;808;57.07;3.81
92227;120612;Zespół Szkół w Niedźwiedziu|Niedźwiedź| 21a |32-090 Słomniki;1351;639;639;11;628;47.30;1.72
92228;120612;Świetlica Wiejska w Szczepanowicach|Szczepanowice| 17 |32-090 Słomniki;369;151;151;10;141;40.92;6.62
92229;120612;Szkoła Podstawowa w Kacicach|Kacice| 80 |32-090 Słomniki;984;403;403;13;390;40.96;3.23
92230;120612;Zespół Szkół w Prandocinie|Prandocin| 64a |32-090 Słomniki;1323;601;601;18;583;45.43;3.00
92231;120612;Remiza OSP w Wężerowie|Wężerów| 60a |32-090 Słomniki;448;195;195;9;186;43.53;4.62
92232;120612;Budynek OSP w Muniakowicach|Muniakowice| |32-090 Słomniki;348;157;157;4;153;45.11;2.55
92233;120612;Świetlica Wiejska w Polanowicach|Polanowice| 31 |32-090 Słomniki;568;246;246;12;234;43.31;4.88
92234;120612;Zespół Szkół w Waganowicach|Waganowice| 19 |32-090 Słomniki;800;319;319;11;308;39.88;3.45
92235;120612;Zespół Szkół w Smrokowie|Smroków| 44a |32-090 Słomniki;442;195;195;6;189;44.12;3.08
92236;120613;Urząd Gminy w Sułoszowej|Sułoszowa I| 80 |32-045 Sułoszowa;1065;595;595;27;568;55.87;4.54
92237;120613;Centrum Kultury w Sułoszowej|Sułoszowa I| 386 |32-045 Sułoszowa;976;567;567;21;546;58.09;3.70
92238;120613;Szkoła Podstawowa Nr 2 w Sułoszowej|Sułoszowa III| 110 |32-045 Sułoszowa;839;515;515;12;503;61.38;2.33
92239;120613;Zespół Placówek Oświatowych w Woli Kalinowskiej|Wola Kalinowska|ul. Szkolna 12 |32-045 Sułoszowa;522;258;258;11;247;49.43;4.26
92240;120613;Szkoła Podstawowa w Wielmoży|Wielmoża| 192 |32-045 Sułoszowa;1259;569;569;13;556;45.19;2.28
92241;120614;Zespół Szkół w Świątnikach Górnych|Świątniki Górne|Bruchnalskiego 35 |32-040 Świątniki Górne;1950;1256;1256;24;1232;64.41;1.91
92242;120614;Szkoła Podstawowa we Wrząsowicach|Wrząsowice|Szkolna 5 |32-040 Świątniki Górne;1686;872;873;16;856;51.72;1.83
92243;120614;Szkoła Podstawowa w Ochojnie|Ochojno|Podhalańska 27 |32-040 Świątniki Górne;1311;627;627;10;617;47.83;1.59
92244;120614;Szkoła Podstawowa w Rzeszotarach|Rzeszotary|Pod Dębiną 45 |32-040 Świątniki Górne;2204;1088;1088;26;1062;49.36;2.39
92245;120614;Szkoła Podstawowa w Olszowicach|Olszowice|Św. Floriana 18 |32-040 Świątniki Górne;567;304;304;11;293;53.62;3.62
92246;120615;Szkoła Podstawowa w Będkowicach, Będkowice|Będkowice|ul. Brzozowa 16 |32-089 Wielka Wieś;466;260;260;3;257;55.79;1.15
92247;120615;Szkoła Podstawowa w Bęble, Bębło|Bębło|ul. Krakowska 76 |32-089 Wielka Wieś;1495;828;828;25;803;55.38;3.02
92248;120615;Szkoła Podstawowa w Białym Kościele, Biały Kościół|Biały Kościół|ul. Królowej Jadwigi 4 |32-089 Wielka Wieś;1151;754;754;17;737;65.51;2.25
92249;120615;Szkoła Podstawowa w Białym Kościele, Biały Kościół|Biały Kościół|ul. Królowej Jadwigi 4 |32-089 Wielka Wieś;1225;728;728;11;717;59.43;1.51
92250;120615;Zespół Szkolno-Przedszkolny w Modlnicy, Modlnica|Modlnica|ul. Sportowa 2 |32-085 Modlnica;1217;738;738;18;720;60.64;2.44
92251;120615;Zespół Szkolno-Przedszkolny w Modlnicy, Modlnica|Modlnica|ul. Sporotwa 2 |32-085 Modlnica;1018;564;564;15;549;55.40;2.66
92252;120615;Budynek Komunalny w Giebułtowie, Giebułtów|Giebułtów|Orlich Gniazd 30 |32-085 Modlnica;1006;635;635;16;619;63.12;2.52
92253;120615;Świetlica w budynku komunalnym wielofunkcyjnym w Modlniczce, Modlniczka|Modlniczka|ul. Św. Faustyny 5 |32-085 Modlnica;1093;695;695;26;669;63.59;3.74
92254;120615;Niepubliczny Zakład Opieki Zdrowotnej w Modlniczce, Modlniczka|Modlniczka|os. Krakowskie Przedmieście 28 |32-085 Modlniczka;48;31;31;0;31;64.58;0.00
92255;120616;Świetlica Aleksandrowice|Aleksandrowice| 133 |32-084 Morawica;582;345;345;11;334;59.28;3.19
92256;120616;Szkoła Podstawowa Balice|Balice|Szkolna 66 |32-083 Balice;1374;829;829;17;812;60.33;2.05
92257;120616;Szkoła Podstawowa Brzezie|Brzezie|Szkolna 1 |32-080 Zabierzów;1205;752;752;21;731;62.41;2.79
92258;120616;Świetlica Wiejska Brzezinka|Brzezinka|Krakowska 26 |32-064 Rudawa;562;372;372;7;365;66.19;1.88
92259;120616;Szkoła Podstawowa Bolechowice|Bolechowice|Szkolna 7 |32-082 Bolechowice;1645;1078;1078;24;1054;65.53;2.23
92260;120616;Szkoła Podstawowa w Zelkowie|Zelków|Jana Pawła II 22 |32-082 Bolechowice;691;451;451;12;439;65.27;2.66
92261;120616;Remiza OSP Brzoskwinia|Brzoskwinia| 42 |32-084 Morawica;763;436;436;9;427;57.14;2.06
92262;120616;Dom Pomocy Społecznej Karniowice|Karniowice|Osiedle XXXV Lecia PRL 10 |32-082 Bolechowice;727;402;402;15;387;55.30;3.73
92263;120616;Świetlica Wiejska Kleszczów|Kleszczów| 110 |32-084 Morawica;302;169;169;6;163;55.96;3.55
92264;120616;Szkoła Podstawowa Kobylany|Kobylany|Jana Pawła II 61 |32-082 Bolechowice;678;394;394;20;374;58.11;5.08
92265;120616;Świetlica Wiejska Niegoszowice|Niegoszowice| 71 |32-064 Rudawa;692;399;399;8;391;57.66;2.01
92266;120616;Szkoła Podstawowa Nielepice|Nielepice| 182 |32-064 Rudawa;642;392;392;6;386;61.06;1.53
92267;120616;Świetlica OSP Radwanowice|Radwanowice|21 Lipca 56 |32-064 Rudawa;526;327;327;34;293;62.17;10.40
92268;120616;Zespół Szkół w Rudawie|Rudawa|Stanisława Polaczka 25 |32-064 Rudawa;1525;930;930;40;890;60.98;4.30
92269;120616;Zespół Szkół w Rudawie|Rudawa|Stanisława Polaczka 25 |32-064 Rudawa;788;423;423;12;411;53.68;2.84
92270;120616;Zespół Szkół w Rząsce|Rząska|Krakowska 122 |30-199 Kraków;1962;1290;1290;24;1266;65.75;1.86
92271;120616;Świetlica Wiejska Szczyglice|Szczyglice|Sportowa 38 |32-083 Balice;570;365;365;10;355;64.04;2.74
92272;120616;Dom Pomocy Społecznej Więckowice|Więckowice|Słoneczna 3 |32-082 Bolechowice;501;307;307;15;292;61.28;4.89
92273;120616;SCKiP Zabierzów|Zabierzów|Szkolna 2 |32-080 Zabierzów;1858;1138;1138;16;1122;61.25;1.41
92274;120616;Gimnazjum Zabierzów|Zabierzów|Kolejowa 15 |32-080 Zabiertzów;924;624;624;2;622;67.53;0.32
92275;120616;Gimnazjum Zabierzów|Zabierzów|Kolejowa 15 |32-080 Zabierzów;1636;1014;1014;24;990;61.98;2.37
92276;120617;Dom Kultury w Batowicach|Batowice| 98 |32-086 ZIELONKI;847;460;460;9;451;54.31;1.96
92277;120617;Przedszkole Samorządowe w Węgrzcach z siedzibą w Bibicach|Bibice|ul. Tadeusza Kościuszki 56 |32-087 ZIELONKI;1722;1162;1162;9;1153;67.48;0.77
92278;120617;Przedszkole Samorządowe w Wegrzcach z siedzibą w Bibicach|Bibice|Tadeusza Kościuszki 56 |32-087 ZIELONKI;1261;772;773;9;763;61.22;1.17
92279;120617;Zespół Szkół w Bibicach|Bibice|ul. Tadeusza Kościuszki 56 A |32-087 ZIELONKI;1074;738;738;8;730;68.72;1.08
92280;120617;Zespół Szkół w Bibicach|Bibice|ul. Tadeusza Kościuszki 56A |32-087 ZIELONKI;1251;725;725;21;704;57.95;2.90
92281;120617;Zespół Szkół w Zielonkach|Zielonki|ul. Księdza Michalika 2 |32-087 ZIELONKI;1855;1299;1299;10;1289;70.03;0.77
92282;120617;Zespół Szkół w Zielonkach|Zielonki|Księdza Michalika 2 |32-087 ZIELONKI;1373;940;940;9;931;68.46;0.96
92283;120617;Zespół Szkół w Zielonkach|Zielonki|ul. Księdza Michalika 2 |32-087 ZIELONKI;1068;662;662;7;655;61.99;1.06
92284;120617;Sala Konferencyjna w Zielonkach|Zielonki|ul. Krakowskie Przedmieście 116 |32-087 ZIELONKI;1103;634;634;13;621;57.48;2.05
92285;120617;Zespół Szkół w Korzkwi|Korzkiew| 18 |32-088 ZIELONKI;1717;1013;1013;38;975;59.00;3.75
92286;120617;Zespół Szkół w Woli Zachariaszowskiej|Wola Zachariaszowska|Świętego Floriana 1 |32-087 ZIELONKI;984;589;589;18;571;59.86;3.06
92287;120617;Szkoła Podstawowa w Owczarach|Owczary|Długa 72 |32-088 ZIELONKI;1041;533;533;15;518;51.20;2.81
92288;120617;Dom Pomocy Społecznej w Owczarach|Owczary|Kasztanowa 20 |32-088 Zielonki;83;27;27;6;21;32.53;22.22
92289;120617;Dom Pomocy Społecznej w Batowicach|Batowice| 1 |32-086 Zielonki;115;66;66;10;56;57.39;15.15
92290;120701;Zespół Szkół Samorządowych Nr 1|Limanowa|ul. Marii Konopnickiej 4 |34-600 Limanowa;897;532;532;11;521;59.31;2.07
92291;120701;Limanowski Dom Kultury|Limanowa|ul. Bronisława Czecha 4 |34-600 Limanowa;781;485;485;15;470;62.10;3.09
92292;120701;Zespół Szkół Samorządowych Nr 2|Limanowa|ul. Józefa Piłsudskiego 91 |34-600 Limanowa;711;435;435;9;426;61.18;2.07
92293;120701;Zespół Szkół Samorządowych Nr 2|Limanowa|ul. Józefa Piłsudskiego 91 |34-600 Limanowa;892;510;510;17;493;57.17;3.33
92294;120701;Zespół Szkół Samorządowych Nr 4|Limanowa|ul. Władysława Reymonta 3 |34-600 Limanowa;852;521;521;9;512;61.15;1.73
92295;120701;Auto-Moto Klub Limanowa|Limanowa|ul. Wincentego Witosa 22 |34-600 Limanowa;698;391;391;12;379;56.02;3.07
92296;120701;Zespół Szkół Samorządowych Nr 1|Limanowa|ul. Marii Konopnickiej 4 |34-600 Limanowa;1493;875;875;22;853;58.61;2.51
92297;120701;Miejska Biblioteka Publiczna|Limanowa|ul. M.B.Bolesnej 13 |34-600 Limanowa;1388;882;882;28;854;63.54;3.17
92298;120701;Państwowa Szkoła Muzyczna|Limanowa|ul. Tadeusza Kościuszki 23 |34-600 Limanowa;1514;980;980;21;959;64.73;2.14
92299;120701;Zespół Szkół Samorządowych Nr 3|Limanowa|ul. Stanisława Jordana 3 |34-600 Limanowa;743;481;481;11;470;64.74;2.29
92300;120701;Muzeum Regionalne Ziemi Limanowskiej|Limanowa|ul. Józefa Marka 13 |34-600 Limanowa;769;429;429;8;421;55.79;1.86
92301;120701;Muzeum Regionalne Ziemi Limanowskiej|Limanowa|ul. Józefa Marka 13 |34-600 Limanowa;976;502;502;16;486;51.43;3.19
92302;120701;Dom Pomocy Społecznej|Limanowa|ul. Wincentego Witosa 24 |34-600 Limanowa;49;19;19;4;15;38.78;21.05
92303;120701;Szpital Powiatowy|Limanowa|ul. Józefa Piłsudskiego 61 |34-600 Limanowa;216;71;71;6;65;32.87;8.45
92304;120702;Zespół Szkół Miejskich Nr 1|Mszana Dolna|ul. Sienkiewicza 2 |34-730 Mszana Dolna;1274;710;710;12;698;55.73;1.69
92305;120702;Zespół Szkół Miejskich Nr 1|Mszana Dolna|ul. Sienkiewicza 2 |34-730 Mszana Dolna;1501;800;800;10;790;53.30;1.25
92306;120702;Urząd Miasta|Mszana Dolna|ul. Piłsudskiego 2 |34-730 Mszana Dolna;1666;928;928;27;901;55.70;2.91
92307;120702;Zespół Szkół Miejskich Nr 2|Mszana Dolna|ul. Rynek 21 |34-730 Mszana Dolna;1672;972;972;29;943;58.13;2.98
92308;120703;Zespół Szkół Ogólnokształcących (sala I)|Dobra| 1 |34-642 Dobra;1191;614;614;27;587;51.55;4.40
92309;120703;Zespół Szkół Ogólnokształcących (sala II)|Dobra| 1 |34-642 Dobra;1016;476;476;23;453;46.85;4.83
92310;120703;Zespół Szkół Ogólnokształcących (sala III)|Dobra| 1 |34-642 Dobra;1104;543;543;21;522;49.18;3.87
92311;120703;Zespół Placówek Oświatowych (sala I)|Jurków| 115 |34-643 Jurków;893;470;470;11;459;52.63;2.34
92312;120703;Zespół Placówek Oświatowych (sala I)|Skrzydlna| 186 |34-625 Skrzydlna;847;400;400;18;382;47.23;4.50
92313;120703;Szkoła Podstawowa|Stróża| 1 |34-625 Skrzydlna;448;218;218;7;211;48.66;3.21
92314;120703;Szkoła Podstawowa|Wilczyce| 109 |34-643 Jurków;490;228;228;7;221;46.53;3.07
92315;120703;Zespół Placówek Oświatowych (sala II)|Jurków| 115 |34-643 Jurków;985;396;396;16;380;40.20;4.04
92316;120703;Zespół Placówek Oświatowych (sala II)|Skrzydlna| 186 |34-625 Skrzydlna;665;284;284;9;275;42.71;3.17
92317;120704;Urząd Gminy|Jodłownik| 198 |34-620 Jodłownik;1207;568;568;30;538;47.06;5.28
92318;120704;Remiza OSP|Krasne-Lasocice| 150 |34-620 Jodłownik;779;356;356;13;343;45.70;3.65
92319;120704;Szkoła Podstawowa|Szczyrzyc| 123 |34-623 Szczyrzyc;1699;794;794;30;764;46.73;3.78
92320;120704;Szkoła Podstawowa|Szyk| 117 |34-620 Jodłownik;664;371;371;30;341;55.87;8.09
92321;120704;Zespół Szkół|Wilkowisko| 222 |34-617 Jodłownik;1017;560;560;26;534;55.06;4.64
92322;120704;Urząd Gminy|Jodłownik| 198 |34-620 Jodłownik;791;379;379;26;353;47.91;6.86
92323;120704;Świetlica Wiejska|Góra Świętego Jana| 85 |34-623 Szczyrzyc;264;164;164;2;162;62.12;1.22
92324;120704;Szpital pw. św. Jana Jerozolimskiego|Szczyrzyc| 107 |34-620 Szczyrzyc;44;23;23;2;21;52.27;8.70
92325;120704;Dom Pomocy Społecznej|Szczyrzyc| 182 |34-620 Szczyrzyc;58;28;28;6;22;48.28;21.43
92326;120705;Szkoła Podstawowa Nr 1|Kamienica| 490 |34-608 Kamienica;1673;845;845;37;808;50.51;4.38
92327;120705;Szkoła Podstawowa Nr 2|Kamienica| 343 |34-608 Kamienica;858;407;407;21;386;47.44;5.16
92328;120705;Zespół Szkoły Podstawowej i Gimnazjum|Szczawa| 167 |34-607 Kamienica;1541;797;797;45;752;51.72;5.65
92329;120705;Zespół Szkoły Podstawowej i Gimnazjum|Zalesie| 265 |34-608 Kamienica;758;396;396;12;384;52.24;3.03
92330;120705;Zepół Szkoły i Przedszkola|Zbludza| 110 |34-608 Kamienica;560;277;277;16;261;49.46;5.78
92331;120705;Szkoła Podstawowa|Zasadne| 91 |34-608 Kamienica;451;231;231;9;222;51.22;3.90
92332;120706;Gminny Ośrodek Kultury, Sportu i Turystyki (sala nr 1)|Laskowa| 700 |34-602 Laskowa;1201;785;785;27;758;65.36;3.44
92333;120706;Szkoła Podstawowa|Kamionka Mała| 134 |34-602 Laskowa;669;385;385;16;369;57.55;4.16
92334;120706;Zespół Szkół|Ujanowice| 55 |34-603 Ujanowice;1123;722;722;12;710;64.29;1.66
92335;120706;Szkoła Podstawowa|Krosna| 109 |34-603 Ujanowice;692;444;444;11;433;64.16;2.48
92336;120706;Szkoła Podstawowa|Jaworzna| 111 |34-602 Laskowa;393;276;276;5;271;70.23;1.81
92337;120706;Szkoła Podstawowa|Żmiąca| 128 |34-603 Ujanowice;512;311;311;19;292;60.74;6.11
92338;120706;Gminny Ośrodek Kultury, Sportu i Turystyki (sala nr 2)|Laskowa| 700 |34-602 Laskowa;1250;798;798;21;777;63.84;2.63
92339;120707;Zespół Szkół|Rupniów| 206 |34-652 Nowe Rybie;1195;650;650;17;633;54.39;2.62
92340;120707;Zespół Szkół Nr 1|Stara Wieś| 549 |34-600 Limanowa;1983;1148;1148;31;1117;57.89;2.70
92341;120707;Szkoła Podstawowa|Kanina| 71 |34-600 Limanowa;440;261;261;5;256;59.32;1.92
92342;120707;Świetlica w Siekierczynie I|Siekierczyna| 453 |34-600 Limanowa;868;495;495;14;481;57.03;2.83
92343;120707;Szkoła Podstawowa Nr 2|Siekierczyna| 326 |34-600 Limanowa;463;261;261;22;239;56.37;8.43
92344;120707;Zespół Szkół|Mordarka| 204 |34-600 Limanowa;1988;1190;1190;31;1159;59.86;2.61
92345;120707;Zespół Szkół|Pisarzowa| 346 |34-654 Męcina;1590;912;912;14;898;57.36;1.54
92346;120707;Zespół Szkół Nr 1|Męcina| 530 |34-654 Męcina;1838;1085;1085;27;1058;59.03;2.49
92347;120707;Szkoła Podstawowa|Kłodne| 144 |34-654 Męcina;766;432;432;18;414;56.40;4.17
92348;120707;Remiza OSP w Łososinie Górnej|Limanowa|ul. Łososińska 23 |34-600 Limanowa;1125;662;662;21;641;58.84;3.17
92349;120707;Zespół Szkół|Pasierbiec| 108 |34-600 Limanowa;1020;578;578;18;560;56.67;3.11
92350;120707;Szkoła Podstawowa|Młynne| 149 |34-600 Limanowa;1045;632;632;20;612;60.48;3.16
92351;120707;Dom Ludowy|Nowe Rybie| 157 |34-652 Nowe Rybie;535;257;257;21;236;48.04;8.17
92352;120707;Świetlica w Lipowem|Lipowe| 264 |34-600 Limanowa;607;377;377;13;364;62.11;3.45
92353;120707;Zespół Szkół w Starej Wsi II|Stara Wieś| 459 |34-600 Limanowa;1067;628;628;26;602;58.86;4.14
92354;120707;Budynek wielofunkcyjny|Stare Rybie| 11 |34-652 Nowe Rybie;273;140;140;5;135;51.28;3.57
92355;120707;Szkoła Podstawowa Nr 2|Męcina| 504 |34-654 Męcina;722;397;397;19;378;54.99;4.79
92356;120707;Szkoła Podstawowa|Wysokie| 5 |34-600 Limanowa;506;266;266;12;254;52.57;4.51
92357;120707;Świetlica Wiejska|Sowliny| 332 |34-600 Limanowa;606;379;379;20;359;62.54;5.28
92358;120708;Szkoła Podstawowa|Jastrzębie| 131 |34-606 Łukowica;899;457;457;11;446;50.83;2.41
92359;120708;Szkoła Podstawowa|Łukowica| 285 |34-606 Łukowica;1680;1051;1051;34;1017;62.56;3.24
92360;120708;Szkoła Podstawowa|Młyńczyska| 136 |34-606 Łukowica;732;342;342;19;323;46.72;5.56
92361;120708;Świetlica Wiejska|Przyszowa| 605 |34-604 Przyszowa;1818;941;941;49;892;51.76;5.21
92362;120708;Szkoła Podstawowa|Świdnik| 22 |34-606 Łukowica;759;436;436;12;424;57.44;2.75
92363;120708;Szkoła Podstawowa|Stronie| 2 |34-604 Przyszowa;795;518;518;18;500;65.16;3.47
92364;120708;Szkoła Podstawowa|Roztoka| 165 |34-606 Łukowica;608;283;283;8;275;46.55;2.83
92365;120709;Szkoła Podstawowa|Glisne| 70 |34-730 Mszana Dolna;244;139;139;1;138;56.97;0.72
92366;120709;Szkoła Podstawowa (k/kościoła)|Kasina Wielka| 761 |34-741 Kasina Wielka;1350;645;645;19;626;47.78;2.95
92367;120709;Szkoła Podstawowa w Kasinie Wielkiej Przymiarki|Kasina Wielka| 762 |34-741 Kasina Wielka;935;424;424;17;407;45.35;4.01
92368;120709;Szkoła Podstawowa Nr 1|Kasinka Mała| 513 |34-734 Kasinka Mała;1328;822;822;34;788;61.90;4.14
92369;120709;Szkoła Podstawowa Nr 2|Kasinka Mała| 432 |34-734 Kasinka Mała;1342;760;760;27;733;56.63;3.55
92370;120709;Szkoła Podstawowa Nr 1|Lubomierz| 345 |34-736 Lubomierz;1549;752;752;49;703;48.55;6.52
92371;120709;Remiza OSP|Łętowe| 305 |34-733 Mszana Górna;948;483;483;22;461;50.95;4.55
92372;120709;Szkoła Podstawowa|Łostówka| 245 |34-730 Mszana Dolna;1094;450;450;24;426;41.13;5.33
92373;120709;Szkoła Podstawowa Nr 1|Mszana Górna| 589 |34-733 Mszana Górna;2048;1096;1096;36;1060;53.52;3.28
92374;120709;Remiza OSP|Olszówka| 415 |34-730 Mszana Dolna;1248;593;593;17;576;47.52;2.87
92375;120709;Remiza OSP|Raba Niżna| 252 |34-730 Mszana Dolna;914;489;489;26;463;53.50;5.32
92376;120709;Dom Pomocy Społecznej|Kasina Wielka| 448 |34-741 Kasina Wielka;43;43;43;3;40;100.00;6.98
92377;120709;Dom Pomocy Społecznej|Raba Niżna| 1 |34-730 Mszana Dolna;58;29;29;3;26;50.00;10.34
92378;120710;Zespół Placówek Oświatowych|Konina| 211 |34-735 Niedźwiedź;1553;609;609;35;574;39.21;5.75
92379;120710;Dom Kultury im. Ks. Franciszka Baradzieja|Niedźwiedź| 130 |34-735 Niedźwiedź;1062;427;427;14;413;40.21;3.28
92380;120710;Zespół Szkoły Podstawowej i Gimnazjum Publicznego|Poręba Wielka| 222 |34-735 Niedźwiedź;1827;809;809;31;778;44.28;3.83
92381;120710;Zespół Placówek Oświatowych|Podobin| 257 |34-735 Niedźwiedź;938;367;367;20;347;39.13;5.45
92382;120711;Zespół Placówek Oświatowych|Słopnice| 732 |34-615 Słopnice;1320;720;720;28;692;54.55;3.89
92383;120711;Szkoła Podstawowa Nr 4|Słopnice| 363 |34-615 Słopnice;519;315;315;11;304;60.69;3.49
92384;120711;Zespół Szkoły Podstawowej i Przedszkola|Słopnice| 336 |34-615 Słopnice;1025;592;592;12;580;57.76;2.03
92385;120711;Filia Zespołu Placówek Oświatowych Słopnice - Granice|Słopnice| 731 |34-615 Słopnice;468;258;258;12;246;55.13;4.65
92386;120711;Zespół Placówek Oświatowych|Słopnice| 732 |34-615 Słopnice;1260;693;693;30;663;55.00;4.33
92387;120712;Nowy budynek Pana Marka Dziadonia|Podłopień| 68 |34-650 Tymbark;1119;681;681;17;664;60.86;2.50
92388;120712;Gimnazjum Samorządowe|Tymbark| 29 |34-650 Tymbark;997;629;629;14;615;63.09;2.23
92389;120712;Przedszkole Samorządowe|Tymbark| 495 |34-650 Tymbark;1267;755;755;24;731;59.59;3.18
92390;120712;Gimnazjum Samorządowe|Tymbark| 29 |34-650 Tymbark;987;627;627;24;603;63.53;3.83
92391;120712;Szkoła Podstawowa|Piekiełko| 40 |34-650 Tymbark;575;348;348;6;342;60.52;1.72
92392;120801;Zespół Szkół im.A.Malatyńskiego w Miechowie-Charsznicy|Miechów-Charsznica|Szkolna 14 |32-250 Charsznica;1348;646;646;16;630;47.92;2.48
92393;120801;Zespół Szkół im.A.Malatyńskiego w Miechowie-Charsznicy|Miechów-Charsznica|Szkolna 14 |32-250 Charsznica;1009;381;381;6;375;37.76;1.57
92394;120801;Szkoła Podstawowa w Swojczanach|Swojczany| 200 |32-250 Charsznica;813;312;312;12;300;38.38;3.85
92395;120801;Szkoła Podstawowa w Pogwizdowie|Pogwizdów| 58 |32-250 Charsznica;708;224;224;10;214;31.64;4.46
92396;120801;Remiza Ochotniczej Straży Pożarnej w Uniejowie-Kolonii|Uniejów-Kolonia| 32a |32-250 Charsznica;696;264;264;5;259;37.93;1.89
92397;120801;Remiza Ochotniczej Straży Pożarnej w Tczycy|Tczyca| 145 |32-250 Charsznica;1276;570;570;16;554;44.67;2.81
92398;120801;Budynek gminny w Podlesicach|Podlesice| 37a |32-250 Charsznica;319;142;142;8;134;44.51;5.63
92399;120801;Dom Pomocy Społecznej CARITAS Diecezji Kieleckiej w Miechowie-Charsznicy|Miechów-Charsznica|Młyńska 2 |32-250 Charsznica;24;8;8;4;4;33.33;50.00
92400;120802;Urząd Gminy w Gołczy|Gołcza| 80 |32-075 Gołcza;1259;705;705;38;667;56.00;5.39
92401;120802;Remiza OSP w Chobędzy|Chobędza| 60 |32-075 Gołcza;381;185;185;12;173;48.56;6.49
92402;120802;Szkoła Podstawowa w Szreniawie|Szreniawa| 9 |32-075 Gołcza;1210;555;555;15;540;45.87;2.70
92403;120802;Budynek po byłej szkole podstawowej w Mostku|Mostek| 21 |32-075 Gołcza;478;239;239;9;230;50.00;3.77
92404;120802;Budynek po byłej szkole podstawowej w Ulinie Wielkiej|Ulina Wielka| 103 |32-075 Gołcza;443;218;218;5;213;49.21;2.29
92405;120802;Szkoła Podstawowa w Wysocicach|Wysocice| 47 |32-075 Gołcza;582;236;236;2;234;40.55;0.85
92406;120802;Remiza OSP w Czaplach Wielkich|Czaple Wielkie| 20 |32-075 Gołcza;687;287;287;9;278;41.78;3.14
92407;120803;Społeczna Szkoła Podstawowa w Przybysławicach|Przybysławice| 60 |32-241 Kozłów;530;175;175;11;164;33.02;6.29
92408;120803;Centrum Kształcenia na Odległość w Kamionce|Kamionka| 90A |32-241 Kozłów;339;148;148;9;139;43.66;6.08
92409;120803;Remiza OSP w Kępiu|Kępie| 164a |32-241 Kozłów;413;133;133;12;121;32.20;9.02
92410;120803;Remiza OSP w Marcinowicach|Marcinowice| 65 |32-241 Kozłów;517;166;166;13;153;32.11;7.83
92411;120803;Gminny Zespół Szkół w Kozłowie|Kozłów| 303 |32-241 Kozłów;912;393;393;16;377;43.09;4.07
92412;120803;Budynek gminny w Przysiece|Przysieka| 41 |32-241 Kozłów;468;187;187;8;179;39.96;4.28
92413;120803;Budynek gminny w Bryzdzyniu|Bryzdzyn| 58 |32-241 Kozłów;340;121;121;1;120;35.59;0.83
92414;120803;Budynek gminny w Wolicy|Wolica| 14 |32-241 Kozłów;224;79;79;1;78;35.27;1.27
92415;120803;Remiza OSP w Wierzbicy|Wierzbica| 34 |32-241 Kozłów;214;86;86;4;82;40.19;4.65
92416;120804;Szkoła Podstawowa w Książu Małym|Książ Mały| 59 |32-210 Książ Wielki;787;332;332;15;317;42.19;4.52
92417;120804;Zespół Szkolno-Przedszkolny w Książu Wielkim|Książ Wielki|ul. Reja 4 |32-210 Książ Wielki;716;374;374;16;358;52.23;4.28
92418;120804;Remiza OSP w Książu Wielkim|Książ Wielki|ul. Śniadeckiego 11 |32-210 Książ Wielki;567;242;242;9;233;42.68;3.72
92419;120804;Świetlica Wiejska w Głogowianach-Wrzosach|Rzędowice| 29 |32-210 Książ Wielki;414;154;154;3;151;37.20;1.95
92420;120804;Szkoła Podstawowa w Antolce|Antolka| 13 |32-210 Książ Wielki;446;223;223;7;216;50.00;3.14
92421;120804;Remiza OSP w Moczydle|Moczydło| 114 |32-210 Książ Wielki;281;120;120;3;117;42.70;2.50
92422;120804;Świetlica Wiejska w Giebułtowie|Giebułtów| 19 |32-210 Książ Wielki;261;102;102;2;100;39.08;1.96
92423;120804;Świetlica Wiejska w Zaryszynie|Zaryszyn| 24 |32-210 Książ Wielki;212;93;93;4;89;43.87;4.30
92424;120804;Świetlica Wiejska w Konaszówce|Konaszówka| 79 |32-210 Książ Wielki;336;156;156;4;152;46.43;2.56
92425;120804;Świetlica Wiejska w Cisiu|Cisie| 94A |32-210 Książ Wielki;292;115;115;1;114;39.38;0.87
92426;120804;Dom Pomocy Społecznej w Mianocicach|Mianocice| 51 |32-210 Książ Wielki;57;22;22;0;22;38.60;0.00
92427;120805;Bursa Szkolna w Miechowie|Miechów|ul. Henryka Sienkiewicza 27A |32-200 Miechów;1114;591;591;14;577;53.05;2.37
92428;120805;Przedszkole Samorządowe Nr 2 w Miechowie|Miechów|ul. Jagiellońska 34 |32-200 Miechów;924;511;511;8;503;55.30;1.57
92429;120805;Centrum Kultury i Sportu w Miechowie, Dom Kultury|Miechów|ul. Racławicka 10 |32-200 Miechów;833;433;433;10;423;51.98;2.31
92430;120805;Przedszkole Samorządowe Nr 1 im. J. Porazińskiej w Miechowie|Miechów|ul. Powstańców 1863 Roku 13 |32-200 Miechów;1163;651;651;8;643;55.98;1.23
92431;120805;Państwowa Szkoła Muzyczna I Stopnia im. M.K. Ogińskiego w Miechowie|Miechów|ul. Rynek 5 |32-200 Miechów;1012;555;555;8;547;54.84;1.44
92432;120805;Świetlica Socjoterapeutyczna|Miechów|Os. XXX-lecia PRL bl 11 |32-200 Miechów;1300;625;625;16;609;48.08;2.56
92433;120805;Szkoła Podstawowa Nr 1 im. Henryka Sienkiewicza w Miechowie|Miechów|ul. Marii Konopnickiej 13 |32-200 Miechów;1294;687;687;11;676;53.09;1.60
92434;120805;Gimnazjum Nr 1 im. Macieja Miechowity w Miechowie|Miechów|Osiedle Generała Sikorskiego 15B |32-200 Miechów;876;475;475;4;471;54.22;0.84
92435;120805;Szkoła Podstawowa Nr 2 im. Marii Konopnickiej w Miechowie|Miechów|Osiedle Generała Sikorskiego 15A |32-200 Miechów;834;467;467;6;461;56.00;1.28
92436;120805;Remiza Strażacka w Strzeżowie Drugim|Strzeżów Drugi| |32-200 Miechów;449;197;197;5;192;43.88;2.54
92437;120805;Świetlica Wiejska w Brzuchanii|Brzuchania| 58 |32-200 Miechów;234;119;119;9;110;50.85;7.56
92438;120805;Szkoła Podstawowa w Bukowskiej Woli im. Samodzielnej Brygady Strzelców Karpackich Obrońców Tobruku|Bukowska Wola| 79 |32-200 Miechów;951;401;401;10;391;42.17;2.49
92439;120805;Szkoła Podstawowa w Pojałowicach im.Gen.Stanisława Maczka|Pojałowice| 18 |32-200 Miechów;521;190;190;3;187;36.47;1.58
92440;120805;Centrum Kultury Wsi Miechowskiej w Nasiechowicach|Nasiechowice| |32-200 Miechów;461;183;183;10;173;39.70;5.46
92441;120805;Remiza Strażacka w Sławicach Szlacheckich|Sławice Szlacheckie| 40 |32-200 Miechów;427;162;162;2;160;37.94;1.23
92442;120805;Niepubliczna Szkoła Podstawowa w Parkoszowicach im.106 Dywizji Piechoty Armii Krajowej|Parkoszowice| |32-200 Miechów;589;252;252;10;242;42.78;3.97
92443;120805;Szkoła Podstawowa w Jaksicach im.Adama Mickiewicza|Jaksice| 110 |32-200 Miechów;1130;499;499;7;492;44.16;1.40
92444;120805;Wiejskie Centrum Kultury, Sportu i Rekreacji w Falniowie|Falniów| |32-200 Miechów;694;247;247;7;240;35.59;2.83
92445;120805;Szkoła Podstawowa w Pstroszycach|Pstroszyce Pierwsze| 66 |32-200 Miechów;765;341;341;9;332;44.58;2.64
92446;120805;Specjalny Ośrodek Szkolno-Wychowawczy w Zagorzycach|Zagorzyce| 9 |32-200 Miechów;276;108;108;1;107;39.13;0.93
92447;120805;Szpital Św.Anny w Miechowie|Miechów|Szpitalna 3 |32-200 Miechów;149;47;47;1;46;31.54;2.13
92448;120805;Dom Pomocy Społecznej w Miechowie|Miechów|Warszawska 49a |32-200 Miechów;31;10;10;1;9;32.26;10.00
92449;120805;Dom Pomocy Społecznej "BETANIA" w Miechowie|Miechów|ks.Skorupki 19 |32-200 Miechów;60;22;22;1;21;36.67;4.55
92450;120806;Szkoła Podstawowa w Racławicach|Racławice| 147 |32-222 Racławice;1116;403;403;11;392;36.11;2.73
92451;120806;Świetlica Wiejska w Klonowie|Klonów| 50 |32-222 Racławice;431;135;135;2;133;31.32;1.48
92452;120806;Środowiskowy Dom Samopomocy w Kościejowie|Kościejów| 52 |32-222 Racławice;535;205;205;10;195;38.32;4.88
92453;120807;Urząd Gminy w Słaboszowie, Słaboszów|Słaboszów| 57 |32-218 Słaboszów;1227;399;399;24;375;32.52;6.02
92454;120807;Zespół Szkół w Dziaduszycach, Dziaduszyce|Dziaduszyce| 23 |32-218 Słaboszów;935;333;333;22;311;35.61;6.61
92455;120807;Gminna Biblioteka Publiczna w Kalinie Wielkiej|Kalina Wielka| 62 |32-218 Słaboszów;632;292;292;10;282;46.20;3.42
92456;120807;Szkoła Podstawowa w Janowicach,Janowice|Janowice| 50 |32-218 Słaboszów;271;109;109;0;109;40.22;0.00
92457;120901;Szkoła Podstawowa w Dobczycach|Dobczyce|ul. Jagiellońska 4 |32-410 Dobczyce;1497;822;822;26;796;54.91;3.16
92458;120901;Przedszkole Samorządowe Nr 1 w Dobczycach|Dobczyce|Pl. Zgody 9 |32-410 Dobczyce;1721;1004;1004;19;985;58.34;1.89
92459;120901;Przedszkole Samorządowe Nr 3 w Dobczycach|Dobczyce|ul. Szkolna 27 |32-410 Dobczyce;1949;1129;1129;17;1112;57.93;1.51
92460;120901;Szkoła Podstawowa w Brzączowicach|Brzączowice| 186 |32-410 Dobczyce;1179;636;636;17;619;53.94;2.67
92461;120901;Szkoła Podstawowa w Kornatce|Kornatka| 105 |32-410 Dobczyce;1291;755;755;10;745;58.48;1.32
92462;120901;Szkoła Podstawowa w Stadnikach|Stadniki| 148 |32-410 Dobczyce;1361;741;741;41;700;54.45;5.53
92463;120901;Szkoła Podstawowa w Dziekanowicach|Dziekanowice| 66 |32-410 Dobczyce;1309;658;658;22;636;50.27;3.34
92464;120901;Szkoła Podstawowa w Nowej Wsi|Nowa Wieś| 16 |32-410 Dobczyce;829;386;386;13;373;46.56;3.37
92465;120901;Strażnica OSP w Stojowicach|Stojowice| 130 |32-410 Dobczyce;485;310;310;13;297;63.92;4.19
92466;120902;Szkoła Podstawowa w Lubniu|Lubień| 513 |32-433 Lubień;1444;865;865;27;838;59.90;3.12
92467;120902;Budynek Urzędu Gminy w Lubniu|Lubień| 50 |32-433 lubień;1429;710;710;39;671;49.69;5.49
92468;120902;Szkoła Podstawowa w Tenczynie|Tenczyn| 171 |32-433 Lubień;1723;987;987;28;959;57.28;2.84
92469;120902;Zespół Szkół w Krzeczowie|Krzeczów| 174 |32-433 Lubień;679;385;385;14;371;56.70;3.64
92470;120902;Szkoła Podstawowa w Skomielnej Białej|Skomielna Biała| 1 |32-434 Skomielna Biała;2241;1255;1255;31;1224;56.00;2.47
92471;120903;Gimnazjum Nr 1 w Myślenicach|Myślenice|ul. Jana Sobieskiego 1 |32-400 Myślenice;1902;1258;1258;19;1239;66.14;1.51
92472;120903;Szkoła Podstawowa Nr 3|Myślenice|ul. Pardyaka 26 |32-400 Myślenice;1956;1148;1148;17;1131;58.69;1.48
92473;120903;Zespół Szkół im. Andrzeja Średniawskiego w Myślenicach|Myślenice|ul. 3 Maja 97b |32-400 Myślenice;1450;892;892;15;877;61.52;1.68
92474;120903;Małopolski System Informacji Turystycznej|Myślenice|Rynek 27 |32-400 Myślenice;1085;708;708;12;696;65.25;1.69
92475;120903;Szkoła Podstawowa Nr 2 w Myślenicach|Myślenice|ul.Żeromskiego 2 |32-400 Myślenice;1341;883;883;8;875;65.85;0.91
92476;120903;Myślenicki Ośrodek Kultury i Sportu|Myślenice|ul. Marszałka Piłsudskiego 20 |32-400 Myślenice;1430;902;902;23;879;63.08;2.55
92477;120903;Zespół Placówek Oświatowych Nr 1 w Myślenicach|Myślenice|ul. Kazimierza Wielkiego 123 |32-400 Myślenice;2050;1334;1334;31;1303;65.07;2.32
92478;120903;Szkoła Podstawowa Nr 4 w Myślenicach|Myślenice|ul. Zdrojowa 14 |32-400 Myślenice;1279;746;746;25;721;58.33;3.35
92479;120903;Cech Rzemiosł Różnych w Myślenicach|Myślenice|ul. Ogrodowa 1 |32-400 Myślenice;1936;1104;1104;20;1084;57.02;1.81
92480;120903;Szkoła Podstawowa w Bęczarce|Bęczarka| 14 |32-444 Głogoczów;824;434;434;10;424;52.67;2.30
92481;120903;Zespół Plcówek Oświatowych w Bysinie|Bysina| 284 |32-400 Myślenice;1036;607;607;14;593;58.59;2.31
92482;120903;Zespół Placówek Oświatowych w Jasienicy|Jasienica| 48 |32-400 Myślenice;1323;574;574;12;562;43.39;2.09
92483;120903;Szkoła Podstawowa w Jaworniku|Jawornik| 293 |32-400 Myślenice;1200;650;650;16;634;54.17;2.46
92484;120903;Zespół Placówek Oświatowych w Borzęcie|Borzęta| 368 |32-400 Myślenice;1302;678;678;22;656;52.07;3.24
92485;120903;Zespół Placówek Oświatowych w Głogoczowie|Głogoczów| 297 |32-444 Głogoczów;2282;1256;1256;31;1225;55.04;2.47
92486;120903;Szkoła Podstawowa w Krzyszkowicach|Krzyszkowice| 368 |32-445 Krzyszkowice;1813;1053;1053;21;1032;58.08;1.99
92487;120903;Szkoła Podstawowa w Polance|Polanka| 71 |32-400 Myślenice;823;453;453;6;447;55.04;1.32
92488;120903;Szkoła Podstawowa w Zawadzie|Zawada| 24 |32-445 Krzyszkowice;901;589;589;12;577;65.37;2.04
92489;120903;Zespół Placówek Oświatowych w Drogini|Droginia| 20 |32-400 Myślenice;923;533;533;10;523;57.75;1.88
92490;120903;Zespół Placówek Oświatowych w Osieczanach|Osieczany| 100 |32-400 Myślenice;1400;788;788;14;774;56.29;1.78
92491;120903;Szkoła Podstawowa w Porębie|Poręba| 16 |32-425 Trzemeśnia;941;517;517;13;504;54.94;2.51
92492;120903;Szkoła Podstawowa w Trzemeśni|Trzemeśnia| 250 |32-425 Trzemeśnia;1777;969;969;18;951;54.53;1.86
92493;120903;Szkoła Podstawowa w Zasani|Zasań| 102 |32-425 Trzemeśnia;623;318;318;12;306;51.04;3.77
92494;120903;Świetlica Wiejska w Łękach|Łęki| 259 |32-425 Trzemeśnia;820;477;477;6;471;58.17;1.26
92495;120903;Gimnazjum w Jaworniku|Jawornik| 293 |32-400 Myślenice;1178;718;718;19;699;60.95;2.65
92496;120903;SP ZOZ W MYŚLENICACH|Myślenice|Szpitalna 2 |32-400 ;82;10;10;0;10;12.20;0.00
92497;120903;DPS TRZEMEŚNIA|TRZEMEŚNIA| 377 |32-425 ;46;38;38;1;37;82.61;2.63
92498;120903;CENTRUM SENIORA W DROGINI|DROGINIA| 351 |32-400 ;54;23;23;3;20;42.59;13.04
92499;120903;DOM SENIORA "NA WZGÓRZU"W GŁOGOCZOWIE|GŁOGOCZÓW| 805 |32-444 ;50;10;10;0;10;20.00;0.00
92500;120904;Szkoła Podstawowa Nr 1 w Pcimiu|Pcim| 599 |32-432 Pcim;1472;883;883;33;850;59.99;3.74
92501;120904;Przedszkole Samorządowe Nr 2 w Pcimiu|Pcim| 564 |32-432 Pcim;1165;716;716;31;685;61.46;4.33
92502;120904;Szkoła Podstawowa Nr 3 w Pcimiu|Pcim| 598 |32-432 Pcim;1114;591;591;38;553;53.05;6.43
92503;120904;Szkoła Podstawowa Nr 3 w Stróży|Stróża| 168 |32-431 Stróża;1062;553;553;29;524;52.07;5.24
92504;120904;Szkoła Podstawowa Nr 1 w Stróży|Stróża| 1 |32-431 Stróża;1380;884;884;21;863;64.06;2.38
92505;120904;Szkoła Podstawowa w Trzebuni|Trzebunia| 444 |32-438 Trzebunia;1834;938;938;24;914;51.15;2.56
92506;120904;Budynek komunalny w Pcimiu|Pcim| 596 |32-432 Pcim;353;212;212;8;204;60.06;3.77
92507;120904;Dom Pomocy Społecznej w Pcimiu|Pcim| 638 |32-432 Pcim;60;42;42;7;35;70.00;16.67
92508;120905;Zespół Szkół Nr 1 w Raciechowicach|Raciechowice| 106 |32-415 Raciechowice;1189;680;680;24;656;57.19;3.53
92509;120905;Szkoła Podstawowa w Zegartowicach|Zegartowice| 114 |32-415 Raciechowice;1171;535;535;22;513;45.69;4.11
92510;120905;Zespół Szkół Nr 2 w Gruszowie|Gruszów| 150 |32-414 Raciechowice;970;434;434;18;416;44.74;4.15
92511;120905;Zespół Szkół Nr 3 w Czasławiu|Czasław| 105 |32-415 Raciechowice;662;324;324;14;310;48.94;4.32
92512;120905;Zespół Szkół Nr 1 w Raciechowicach|Raciechowice|- 106 -|32-415 Raciechowice;1001;481;481;22;459;48.05;4.57
92513;120906;Dom Kultury i Biblioteka w Sieprawiu|Siepraw|ul. Jana Pawła II 30 |32-447 ;2327;1176;1176;17;1159;50.54;1.45
92514;120906;Hala Sportowa przy Gimnazjum w Sieprawiu|Siepraw|ul. Ks. J. Przytockiego 10 |32-447 ;1793;1030;1030;10;1020;57.45;0.97
92515;120906;Szkoła Podstawowa w Czechówce|Czechówka|ul. Szkolna 72 |32-406 ;887;472;472;2;470;53.21;0.42
92516;120906;Zespół Placówek Oświatowych w Zakliczynie|Zakliczyn|ul. Podgórska 123 |32-406 ;1629;884;884;29;855;54.27;3.28
92517;120907;Gminny Ośrodek Kultury z siedzibą w Sułkowicach|Sułkowice|ul.1 Maja 70 |32-440 Sułkowice;713;334;334;11;323;46.84;3.29
92518;120907;Przedszkole Samorządowe Nr 2 w Sułkowicach|Sułkowice|ul.1 Maja 56 |32-440 Sułkowice;1595;815;815;20;795;51.10;2.45
92519;120907;Szkoła Podstawowa w Sułkowicach|Sułkowice|ul.Rynek 6 |32-440 Sułkowice;1312;654;654;23;631;49.85;3.52
92520;120907;Szkoła Podstawowa w Sułkowicach|Sułkowice|ul.Rynek 6 |32-440 Sułkowice;1489;715;715;36;679;48.02;5.03
92521;120907;Zespół Placówek Oświatowych w Harbutowicach|Harbutowice| 179 |32-440 Sułkowice;1393;517;517;30;487;37.11;5.80
92522;120907;Stare Przedszkole w Rudniku|Rudnik|ul.Centralna 137 |32-440 Sułkowice;973;458;458;17;441;47.07;3.71
92523;120907;Remiza OSP w Rudniku|Rudnik|ul. Centralna 205 |32-440 Sułkowice;1775;947;947;45;902;53.35;4.75
92524;120907;Zespół Placówek Oświatowych w Biertowicach|Biertowice| 222 |32-440 Sułkowice;756;408;408;20;388;53.97;4.90
92525;120907;Zespół Placówek Oświatowych w Krzywaczce|Krzywaczka| 41 |32-442 Krzywaczka;1351;730;730;28;702;54.03;3.84
92526;120908;Zespół Placówek Oświatowych w Krzczonowie|Krzczonów| 82 |32-435 Krzczonów;1887;1030;1030;34;996;54.58;3.30
92527;120908;Szkoła Podstawowa w Skomielnej Czarnej|Skomielna Czarna| 267 |32-437 Skomielna Czarna;1362;699;699;34;665;51.32;4.86
92528;120908;Szkoła Podstawowa Nr 1 w Tokarni|Tokarnia| 379 |32-436 Tokarnia;1626;996;996;47;949;61.25;4.72
92529;120908;Szkoła Podstawowa Nr 2 w Tokarni|Tokarnia| 709 |32-436 Tokarnia;821;456;456;12;444;55.54;2.63
92530;120908;budynek OSP w Więciórce|Więciórka| 119 |32-436 Tokarnia;350;185;185;4;181;52.86;2.16
92531;120908;Szkoła Podstawowa w Bogdanówce|Bogdanówka| 100 |32-437 Skomielna Czarna;514;285;285;13;272;55.45;4.56
92532;120909;Zespół Placówek Oświatowych w Glichowie|Glichów| 29 |32-412 Wiśniowa;339;181;181;11;170;53.39;6.08
92533;120909;Zespół Placówek Oświatowych w Kobielniku|Kobielnik| 84 |32-412 Wiśniowa;372;218;218;8;210;58.60;3.67
92534;120909;Zespół Placówek Oświatowych w Lipniku|Lipnik| 14 |32-412 Wiśniowa;1262;739;739;41;698;58.56;5.55
92535;120909;Oddział Przedszkolny w Poznachowicach Dolnych|Poznachowice Dolne| 60 |32-412 Wiśniowa;379;218;218;9;209;57.52;4.13
92536;120909;Zespół Placówek Oświatowych w Węglówce|Węglówka| 203 |32-412 Wiśniowa;952;530;530;13;517;55.67;2.45
92537;120909;Oddział Przedszkolny w Wierzbanowej|Wierzbanowa| 100 |32-412 Wiśniowa;503;250;250;12;238;49.70;4.80
92538;120909;Gminny Ośrodek Kultury i Sportu w Wiśniowej|Wiśniowa| 320 |32-412 Wiśniowa;1727;967;967;38;929;55.99;3.93
92539;121001;Liceum Ogólnokształcące|Grybów|ul. Rynek 4 |33-330 Grybów;1183;716;716;24;692;60.52;3.35
92540;121001;Urząd Miejski|Grybów|ul. Rynek 12 |33-330 Grybów;1381;816;816;20;796;59.09;2.45
92541;121001;Zespół Szkół Zawodowych|Grybów|ul. Armii Krajowej 19 |33-330 Grybów;1221;676;676;19;657;55.36;2.81
92542;121001;Zakład Opiekuńczo-Leczniczy "Caritas"|Grybów|ul. Rynek 10 |33-330 Grybów;19;15;15;1;14;78.95;6.67
92543;121001;Miejski Dom Kultury|Grybów|ul. Kościuszki 7 |33-330 Grybów;1003;590;590;5;585;58.82;0.85
92544;121002;Zespół Szkół|Chełmiec|ul. Marcinkowicka 9 |33-395 Chełmiec;1210;748;748;13;735;61.82;1.74
92545;121002;Zespół Szkół|Świniarsko| 132 |33-395 Chełmiec;1576;956;956;27;929;60.66;2.82
92546;121002;Zespół Szkół|Trzetrzewina| 193 |33-395 Chełmiec;1751;938;938;43;895;53.57;4.58
92547;121002;Szkoła Podstawowa|Marcinkowice| 132 |33-393 Marcinkowice;1663;982;982;39;943;59.05;3.97
92548;121002;Gminny Ośrodek Kultury|Klęczany| 1 |33-394 Klęczany;839;400;400;20;380;47.68;5.00
92549;121002;Zespół Szkół|Chomranice| 12 |33-394 Klęczany;961;576;576;13;563;59.94;2.26
92550;121002;Zespół Szkół|Wielogłowy| 56 |33-311 Wielogłowy;1702;1049;1049;25;1024;61.63;2.38
92551;121002;Zespół Szkół|Librantowa| 86 |33-300 Nowy Sącz;985;566;566;25;541;57.46;4.42
92552;121002;Zespół Szkół|Paszyn| 410 |33-326 Mogilno;1807;1026;1026;38;988;56.78;3.70
92553;121002;Zespół Szkół|Piątkowa| 1 |33-300 Nowy Sącz;1023;547;547;18;529;53.47;3.29
92554;121002;Szkoła Podstawowa|Krasne Potockie| 118 |33-394 Klęczany;708;419;419;14;405;59.18;3.34
92555;121002;Zespół Szkół|Biczyce Dolne| 30 |33-395 Chełmiec;687;398;398;12;386;57.93;3.02
92556;121002;Świetlica Wiejska|Wielopole| 195 |33-311 Wielogłowy;662;383;383;12;371;57.85;3.13
92557;121002;Szkoła Podstawowa|Januszowa| 5 |33-300 Nowy Sącz;609;317;317;7;310;52.05;2.21
92558;121002;Szkoła Podstawowa|Niskowa| 62 |33-395 Chełmiec;575;370;370;11;359;64.35;2.97
92559;121002;Świetlica Wiejska|Kunów| 120 |33-300 Nowy Sącz;378;250;250;6;244;66.14;2.40
92560;121002;Świetlica Wiejska|Mała Wieś|ul. Jordana 2 |33-395 Chełmiec;733;467;467;11;456;63.71;2.36
92561;121002;Zespół Szkół|Wielogłowy| 56 |33-311 Wielogłowy;999;608;608;12;596;60.86;1.97
92562;121002;Szkoła Podstawowa|Boguszowa| 40 |33-300 Nowy Sącz;134;82;82;2;80;61.19;2.44
92563;121002;Szkoła Podstawowa|Rdziostów| 55 |33-393 Marcinkowice;396;240;240;2;238;60.61;0.83
92564;121002;Zespół Szkół|Chełmiec|ul. Marcinkowicka 9 |33-395 Chełmiec;1355;820;820;13;807;60.52;1.59
92565;121002;Dom Pomocy Społecznej|Klęczany| 169 |33-394 Klęczany;53;22;22;1;21;41.51;4.55
92566;121003;Wiejski Dom Kultury|Rożnów| 638 |33-316 Rożnów;1551;854;854;24;830;55.06;2.81
92567;121003;Szkoła Podstawowa|Roztoka-Brzeziny| 211 |33-316 Rożnów;925;419;419;36;383;45.30;8.59
92568;121003;Wiejski Dom Kultury|Bartkowa-Posadowa| 375 |33-318 Gródek nad Dunajcem;1527;783;783;29;754;51.28;3.70
92569;121003;Zespół Szkół|Przydonica| 24 |33-318 Gródek nad Dunajcem;1010;494;494;15;479;48.91;3.04
92570;121003;Szkoła Podstawowa|Sienna| 27 |33-318 Gródek nad Dunajcem;1278;690;690;24;666;53.99;3.48
92571;121003;Zespół Szkół|Gródek nad Dunajcem| 195 |33-318 Gródek nad Dunajcem;573;322;322;12;310;56.20;3.73
92572;121003;Dom Pomocy Społecznej|Zbyszyce| 12 |33-318 Gródek nad Dunajcem;57;39;39;2;37;68.42;5.13
92573;121004;Zespół Szkolno-Przedszkolny|Biała Niżna| 495 |33-330 Grybów;2086;1300;1300;37;1263;62.32;2.85
92574;121004;Szkoła Podstawowa|Binczarowa| 26 |33-332 Florynka;952;499;499;19;480;52.42;3.81
92575;121004;Szkoła Podstawowa|Cieniawa| 140 |33-333 Ptaszkowa;1193;744;744;16;728;62.36;2.15
92576;121004;Zespół Szkół|Florynka| 64 |33-332 Florynka;1146;577;577;26;551;50.35;4.51
92577;121004;Szkoła Podstawowa|Gródek| 38 |33-331 Stróże;841;475;475;25;450;56.48;5.26
92578;121004;Zespół Szkolno-Przedszkolny|Kąclowa| 280 |33-330 Grybów;1679;1072;1072;22;1050;63.85;2.05
92579;121004;Zespół Szkolno-Przedszkolny|Krużlowa Wyżna| 205 |33-325 Krużlowa Wyżna;2010;1247;1247;38;1209;62.04;3.05
92580;121004;Szkoła Podstawowa|Polna| 30 |33-331 Stróże;848;554;554;18;536;65.33;3.25
92581;121004;Zespół Szkolno-Przedszkolny Nr 1|Ptaszkowa| 406 |33-333 Ptaszkowa;1519;983;983;17;966;64.71;1.73
92582;121004;Zespół Szkolno-Przedszkolny|Ptaszkowa| 495 |33-333 Ptaszkowa;969;647;647;12;635;66.77;1.85
92583;121004;Warsztat Terapii Zajęciowej|Siołkowa| 31 |33-330 Grybów;1543;985;985;45;940;63.84;4.57
92584;121004;Szkoła Podstawowa|Stara Wieś| 162 |33-325 Krużlowa Wyżna;789;441;441;14;427;55.89;3.17
92585;121004;Gimnazjum|Stróże| 396 |33-331 Stróże;2006;1256;1256;39;1217;62.61;3.11
92586;121004;Szkoła Podstawowa|Wawrzka| 61 |33-332 Florynka;323;197;197;8;189;60.99;4.06
92587;121004;Szkoła Podstawowa|Wyskitna| 44 |33-331 Stróże;500;283;283;9;274;56.60;3.18
92588;121005;Zespół Szkół Podstawowo Gimnazjalnych|Kamionka Wielka| 154 |33-334 Kamionka Wielka;1265;814;814;23;791;64.35;2.83
92589;121005;Wiejski Dom Ludowy|Mystków| 477 |33-334 Kamionka Wielka;1438;846;846;24;822;58.83;2.84
92590;121005;Zespół Szkół Podstawowo Gimnazjalnych|Królowa Górna| 16 |33-334 Kamionka Wielka;678;379;379;20;359;55.90;5.28
92591;121005;Szkoła Podstawowa|Jamnica| 182 |33-300 Nowy Sącz;595;341;341;11;330;57.31;3.23
92592;121005;Zespół Szkół|Mszalnica| 127 |33-334 Kamionka Wielka;900;546;546;19;527;60.67;3.48
92593;121005;Remiza OSP|Bogusza| 13 |33-334 Kamionka Wielka;494;254;254;13;241;51.42;5.12
92594;121005;Szkoła Podstawowa|Królowa Polska| 1 |33-334 Kamionka Wielka;614;379;379;17;362;61.73;4.49
92595;121005;Zespół Szkół Podstawowo Gimnazjalnych|Kamionka Wielka| 154 |33-334 Kamionka Wielka;1538;908;908;25;883;59.04;2.75
92596;121006;Urząd Gminy (sala obrad)|Korzenna| 325 |33-322 Korzenna;2172;1294;1294;38;1256;59.58;2.94
92597;121006;Zespół Szkół|Mogilno| 14 |33-326 Mogilno;1371;795;795;28;767;57.99;3.52
92598;121006;Zespół Szkół|Siedlce| 162 |33-322 Korzenna;1290;707;707;31;676;54.81;4.38
92599;121006;Remiza OSP|Jasienna| 208 |33-322 Korzenna;764;414;414;17;397;54.19;4.11
92600;121006;Budynek po Szkole Podstawowej|Bukowiec| 94 |33-322 Korzenna;226;96;96;11;85;42.48;11.46
92601;121006;Zespół Szkół|Lipnica Wielka| 25 |33-322 Korzenna;1479;848;848;25;823;57.34;2.95
92602;121006;Szkoła Podstawowa|Wojnarowa| 278 |33-322 Korzenna;1123;688;688;26;662;61.26;3.78
92603;121006;Zespół Szkół|Siedlce| 162 |33-322 Korzenna;1390;717;717;32;685;51.58;4.46
92604;121006;Zespół Szkół|Koniuszowa| 203 |33-326 Mogilno;926;490;490;15;475;52.92;3.06
92605;121007;Szkoła Podstawowa Nr 2|Krynica-Zdrój|ul. Józefa Ignacego Kraszewskiego 158 |33-380 Krynica-Zdrój;921;465;465;22;443;50.49;4.73
92606;121007;MPGK Spółka z o.o.|Krynica-Zdrój|ul. Józefa Ignacego Kraszewskiego 37 |33-380 Krynica-Zdrój;1432;689;689;23;666;48.11;3.34
92607;121007;Gminne Przedszkole Nr 2|Krynica-Zdrój|ul. Władysława Stanisława Reymonta 10 |33-380 Krynica-Zdrój;2018;1098;1098;20;1078;54.41;1.82
92608;121007;Środowiskowy Dom Samopomocy|Krynica-Zdrój|ul. Źródlana 59 |33-380 Krynica-Zdrój;1266;653;653;15;638;51.58;2.30
92609;121007;Centrum Kultury Kino Cyfrowe Jaworzyna II|Krynica-Zdrój|ul. Marszałka Józefa Piłsudskiego 19 |33-380 Krynica-Zdrój;998;658;658;8;650;65.93;1.22
92610;121007;Kawiarnia "Zacisze"|Krynica-Zdrój|ul. Pułaskiego 36 |33-380 Krynica-Zdrój;662;404;404;14;390;61.03;3.47
92611;121007;Zespół Szkolno-Przedszkolny, Szkoła Podstawowa Nr 1|Krynica-Zdrój|ul. Marszałka Józefa Piłsudskiego 91 |33-380 Krynica-Zdrój;1477;779;779;18;761;52.74;2.31
92612;121007;Punkt Informacji Turystycznej|Krynica-Zdrój|ul. Zdrojowa 4 2|33-380 Krynica-Zdrój;1002;660;660;5;655;65.87;0.76
92613;121007;Zespół Szkolno-Przedszkolny, Szkoła Podstawowa|Mochnaczka Wyżna| 103 |33-380 Krynica-Zdrój;533;253;253;8;245;47.47;3.16
92614;121007;Samorządowe Centrum Edukacji Szkolnej w Tyliczu, Oddział Zamiejscowy|Mochnaczka Niżna| 44 |33-380 Krynica-Zdrój;551;228;228;16;212;41.38;7.02
92615;121007;Wiejski Dom Kultury|Tylicz|ul. Rynek 1 |33-383 Tylicz;1084;576;576;25;551;53.14;4.34
92616;121007;Samorządowe Centrum Edukacji Szkolnej, Szkoła Podstawowa|Tylicz|ul. Kazimierza Wielkiego 9 |33-383 Tylicz;422;199;199;5;194;47.16;2.51
92617;121007;Zespół Szkolno-Przedszkolny, Szkoła Podstawowa|Muszynka| 16 |33-383 Tylicz;343;129;129;11;118;37.61;8.53
92618;121007;Dom Ludowy|Berest| 23 |33-380 Krynica-Zdrój;585;287;287;14;273;49.06;4.88
92619;121007;Samorządowe Centrum Edukacji Szkolnej w Bereście, Oddział Zamiejscowy|Polany| 1 |33-380 Krynica-Zdrój;402;208;208;8;200;51.74;3.85
92620;121007;Dom Kultury|Piorunka| 63 |33-380 Krynica-Zdrój;285;83;83;6;77;29.12;7.23
92621;121007;Zespół Szkolno-Przedszkolny, Szkoła Podstawowa|Czyrna| 36 |33-380 Krynica-Zdrój;216;100;100;7;93;46.30;7.00
92622;121007;SPZOZ Szpital im. dr J. Dietla|Krynica-Zdrój|ul. Józefa Ignacego Kraszewskiego 142 |33-380 Krynica-Zdrój;36;36;36;0;36;100.00;0.00
92623;121008;Szkoła Podstawowa|Czaczów| 67A |33-336 Łabowa;569;293;293;11;282;51.49;3.75
92624;121008;Szkoła Podstawowa|Maciejowa| 83 |33-336 Łabowa;640;335;335;16;319;52.34;4.78
92625;121008;Urząd Gminy|Łabowa| 38 |33-336 Łabowa;1304;682;682;34;648;52.30;4.99
92626;121008;Szkoła Podstawowa|Nowa Wieś| 96 |33-336 Łabowa;1230;566;566;20;546;46.02;3.53
92627;121008;Szkoła Podstawowa Filia w Roztoce Wielkiej|Roztoka Wielka| |33-336 Łabowa;484;265;265;14;251;54.75;5.28
92628;121009;Zespół Szkolno-Gimnazjalny|Łącko| 284 |33-390 Łącko;833;490;490;21;469;58.82;4.29
92629;121009;Zespół Szkolno-Przedszkolny|Czarny Potok| 111 |33-390 Łącko;495;254;254;14;240;51.31;5.51
92630;121009;Zespół Szkolno-Gimnazjalny|Jazowsko| 171 |33-389 Jazowsko;1631;863;863;24;839;52.91;2.78
92631;121009;Szkoła Podstawowa Nr 1|Obidza| 206 |33-389 Jazowsko;1101;517;517;29;488;46.96;5.61
92632;121009;Remiza OSP|Zabrzeż| 394 |33-390 Łącko;1324;719;719;28;691;54.31;3.89
92633;121009;Zespół Szkolno-Gimnazjalny|Zagorzyn| 172 |33-390 Łącko;1554;785;785;31;754;50.51;3.95
92634;121009;Zespół Szkolno-Gimnazjalny|Łącko| 284 |33-390 Łącko;1329;718;718;44;674;54.03;6.13
92635;121009;Świetlica Środowiskowa|Brzyna| 183 |33-389 Jazowsko;496;233;233;12;221;46.98;5.15
92636;121009;Szkoła Podstawowa|Kicznia| 121 |33-390 Łącko;605;338;338;14;324;55.87;4.14
92637;121009;Szkoła Podstawowa|Szczereż| 69 |33-390 Łącko;395;221;221;8;213;55.95;3.62
92638;121009;Zespół Szkolno-Gimnazjalny|Łącko| 284 |33-390 Łącko;1559;897;897;36;861;57.54;4.01
92639;121009;Zespół Szkolno-Gimnazjalny|Jazowsko| 171 |33-389 Jazowsko;773;440;440;19;421;56.92;4.32
92640;121010;Zespół Szkół Podstawowo-Gimnazjalnych im. Jana Pawła II|Łososina Dolna| 82 |33-314 Łososina Dolna;2099;1264;1264;46;1218;60.22;3.64
92641;121010;Szkoła Podstawowa|Tabaszowa| 51 |33-312 Tęgoborze;870;477;477;14;463;54.83;2.94
92642;121010;Gimnazjum|Tęgoborze| 6 |33-312 Tęgoborze;1778;1169;1169;29;1140;65.75;2.48
92643;121010;Szkoła Podstawowa im. mjr Henryka Sucharskiego|Żbikowice| 55 |33-314 Łososina Dolna;701;412;412;17;395;58.77;4.13
92644;121010;Szkoła Podstawowa im. Św. Świerada|Witowice Dolne| 95 |33-314 Łososina Dolna;792;407;407;9;398;51.39;2.21
92645;121010;Szkoła Podstawowa im. Kardynała Stefana Wyszyńskiego|Michalczowa| 87 |33-314 Łososina Dolna;667;411;411;7;404;61.62;1.70
92646;121010;Gimnazjum|Tęgoborze| 6 |33-312 Tęgoborze;1055;604;604;13;591;57.25;2.15
92647;121011;Szkoła Podstawowa Nr 1|Muszyna|ul. Rynek 13 |33-370 Muszyna;1348;724;724;13;711;53.71;1.80
92648;121011;Centrum Edukacji Zawodowej Resortu Finansów Ośrodek Zamiejscowy|Muszyna|ul. Nowa 70 |33-370 Muszyna;341;178;178;2;176;52.20;1.12
92649;121011;Przedszkole|Muszyna|ul. Piłsudskiego 89 |33-370 Muszyna;1618;846;846;29;817;52.29;3.43
92650;121011;Szkoła Podstawowa Nr 2|Muszyna|ul. Kościuszki 54 |33-370 Muszyna;779;406;406;8;398;52.12;1.97
92651;121011;Świetlica Wiejska|Andrzejówka| 46 |33-370 Muszyna;362;141;141;5;136;38.95;3.55
92652;121011;Filialna Szkoła Podstawowa|Milik| 28 |33-370 Muszyna;544;306;306;10;296;56.25;3.27
92653;121011;Szkoła Podstawowa|Żegiestów| 77A |33-370 Muszyna;773;360;360;25;335;46.57;6.94
92654;121011;Świetlica Wiejska|Szczawnik| 43b |33-370 Muszyna;712;380;380;12;368;53.37;3.16
92655;121011;Świetlica Wiejska|Złockie| 28b |33-370 Muszyna;725;365;365;8;357;50.34;2.19
92656;121011;Szkoła Podstawowa|Jastrzębik| 25 |33-370 Muszyna;364;119;119;5;114;32.69;4.20
92657;121011;Szkoła Podstawowa|Powroźnik| 42 |33-370 Muszyna;1263;632;632;18;614;50.04;2.85
92658;121011;Świetlica|Leluchów| 14 |33-370 Muszyna;176;67;67;6;61;38.07;8.96
92659;121011;Filialna Szkoła Podstawowa|Wojkowa| 22 |33-370 Muszyna;156;78;78;4;74;50.00;5.13
92660;121011;Dom Pomocy Społecznej|Muszyna|ul. Zielona 26 |33-370 Muszyna;60;60;60;14;46;100.00;23.33
92661;121012;Publiczne Gimnazjum|Nawojowa| 139 |33-335 Nawojowa;936;535;535;16;519;57.16;2.99
92662;121012;Szkoła Podstawowa|Frycowa| 177 |33-335 Nawojowa;967;573;573;19;554;59.26;3.32
92663;121012;Szkoła Podstawowa|Żeleźnikowa Wielka| 216 |33-335 Nawojowa;852;453;453;19;434;53.17;4.19
92664;121012;Szkoła Podstawowa|Żeleźnikowa Mała| 38 |33-335 Nawojowa;395;192;192;14;178;48.61;7.29
92665;121012;Szkoła Podstawowa|Bącza-Kunina| 37 |33-335 Nawojowa;458;256;256;11;245;55.90;4.30
92666;121012;Szkoła Podstawowa|Homrzyska| 41 |33-335 Nawojowa;419;228;228;9;219;54.42;3.95
92667;121012;Publiczne Gimnazjum|Nawojowa| 139 |33-335 Nawojowa;877;484;484;18;466;55.19;3.72
92668;121012;Publiczne Gimnazjum|Nawojowa| 139 |33-335 Nawojowa;1290;717;717;21;696;55.58;2.93
92669;121013;Miejsko - Gminny Ośrodek Kulltury|Piwniczna-Zdrój|ul. Rynek 11 |33-350 Piwniczna-Zdrój;2159;1104;1104;29;1075;51.13;2.63
92670;121013;Szkoła Podstawowa Nr 1|Piwniczna-Zdrój|ul. Krynicka 2 |33-350 Piwniczna-Zdrój;1670;845;845;22;823;50.60;2.60
92671;121013;Szkoła Podstawowa Nr 2|Piwniczna-Zdrój|Kosarzyska 23 |33-350 Piwniczna-Zdrój;986;421;421;29;392;42.70;6.89
92672;121013;Remiza OSP|Głębokie| 100 |33-350 Piwniczna-Zdrój;788;400;400;21;379;50.76;5.25
92673;121013;Szkoła Podstawowa|Kokuszka| 95 |33-350 Piwniczna-Zdrój;494;183;183;5;178;37.04;2.73
92674;121013;Świetlica Środowiskowa|Łomnica-Zdrój| 571 |33-351 Piwniczna-Zdrój;1453;634;634;9;625;43.63;1.42
92675;121013;Szkoła Podstawowa|Wierchomla Wielka| 144 |33-350 Piwniczna-Zdrój;596;299;299;9;290;50.17;3.01
92676;121013;Świetlica Środowiskowa|Zubrzyk| 90 |33-350 Piwniczna-Zdrój;283;124;124;2;122;43.82;1.61
92677;121014;Gimnazjum|Brzezna| 447 |33-386 Podegrodzie;1848;1090;1090;22;1068;58.98;2.02
92678;121014;Dom Parafialny w Brzeznej-Strzygańcu|Brzezna| 244 |33-386 Podegrodzie;314;168;168;5;163;53.50;2.98
92679;121014;Szkoła Podstawowa|Długołęka-Świerkla| 64 |33-386 Podegrodzie;669;352;352;14;338;52.62;3.98
92680;121014;Szkoła Podstawowa|Gostwica| 27 |33-386 Podegrodzie;1152;608;608;21;587;52.78;3.45
92681;121014;Szkoła Podstawowa|Mokra Wieś| 141 |33-386 Podegrodzie;434;225;225;12;213;51.84;5.33
92682;121014;Szkoła Podstawowa|Rogi| 53 |33-386 Podegrodzie;267;151;151;6;145;56.55;3.97
92683;121014;Świetlica Wiejska|Naszacowice| 96 |33-386 Podegrodzie;617;330;330;16;314;53.48;4.85
92684;121014;Strażnica OSP|Juraszowa| 48 |33-386 Podegrodzie;199;114;114;4;110;57.29;3.51
92685;121014;Szkoła Podstawowa|Olszana| 127 |33-386 Podegrodzie;871;498;498;18;480;57.18;3.61
92686;121014;Szkoła Podstawowa|Olszanka| 24 |33-386 Podegrodzie;489;344;344;16;328;70.35;4.65
92687;121014;Szkoła Podstawowa|Podegrodzie| 6 |33-386 Podegrodzie;1482;856;856;24;832;57.76;2.80
92688;121014;Strażnica OSP|Podrzecze| 44 |33-386 Podegrodzie;453;261;261;5;256;57.62;1.92
92689;121014;Szkoła Podstawowa|Stadła| 30 |33-386 Podegrodzie;658;366;366;11;355;55.62;3.01
92690;121015;Hala Sportowa przy Gimnazjum Publicznym|Rytro| 99 |33-343 Rytro;1593;872;872;33;839;54.74;3.78
92691;121015;Hala Sportowa przy Gimnazjum Publicznym|Rytro| 99 |33-343 Rytro;1382;732;732;26;706;52.97;3.55
92692;121016;"Dom Kingi" Klasztor Sióstr Klarysek|Stary Sącz|ul. Plac Św. Kingi 1 |33-340 Stary Sącz;819;497;497;9;488;60.68;1.81
92693;121016;Gminne Przedszkole|Stary Sącz|Osiedle Słoneczne |33-340 Stary Sącz;2073;1171;1171;24;1147;56.49;2.05
92694;121016;Gimnazjum|Stary Sącz|ul. Daszyńskiego 23 |33-340 Stary Sącz;1346;770;770;13;757;57.21;1.69
92695;121016;Szkoła Podstawowa Nr 1|Stary Sącz|ul. Mickiewicza 59 |33-340 Stary Sącz;2271;1321;1321;45;1276;58.17;3.41
92696;121016;Środowiskowy Dom Samopomocy|Stary Sącz|ul. Cyganowice 95 |33-340 Stary Sącz;694;364;364;8;356;52.45;2.20
92697;121016;Szkoła Podstawowa|Gołkowice Górne| 65 |33-388 Gołkowice Dolne;1676;1040;1040;30;1010;62.05;2.88
92698;121016;Szkoła Podstawowa|Gaboń| 67 |33-388 Gołkowice Dolne;827;461;461;20;441;55.74;4.34
92699;121016;Zespół Szkół|Barcice| 66 |33-342 Barcice;1933;951;951;35;916;49.20;3.68
92700;121016;Zespół Szkół|Przysietnica| 152 |33-342 Barcice;1588;798;798;18;780;50.25;2.26
92701;121016;Szkoła Podstawowa|Moszczenica Niżna| 64 |33-340 Stary Sącz;1266;773;773;26;747;61.06;3.36
92702;121016;Wiejski Dom Kultury|Łazy Biegonickie| |33-340 Stary Sącz;983;575;575;19;556;58.49;3.30
92703;121016;Szkoła Podstawowa|Popowice| 115 |33-340 Stary Sącz;475;233;233;23;210;49.05;9.87
92704;121016;Zespół Szkół|Barcice| 66 |33-342 Barcice;986;596;596;18;578;60.45;3.02
92705;121016;Wiejski Dom Kultury|Mostki| 86 |33-340 Stary Sącz;538;324;324;9;315;60.22;2.78
92706;121016;Szkoła Podstawowa|Skrudzina| 42 |33-388 Gołkowice Dolne;554;341;341;13;328;61.55;3.81
92707;121101;Szkoła Podstawowa Nr 4|Nowy Targ|Osiedle Niwa 4c |34-400 Nowy Targ;1195;551;551;12;539;46.11;2.18
92708;121101;Szkoła Podstawowa Nr 4|Nowy Targ|Osiedle Niwa 4c |34-400 Nowy Targ;998;466;466;13;453;46.69;2.79
92709;121101;Szkoła Podstawowa Nr 3|Nowy Targ|ul. Kowaniec 125a |34-400 Nowy Targ;1128;471;471;21;450;41.76;4.46
92710;121101;Remiza OSP|Nowy Targ|ul. Kowaniec 92 |34-400 Nowy Targ;979;500;500;15;485;51.07;3.00
92711;121101;Galeria "Jatki"|Nowy Targ|ul. Tadeusza Kościuszki 4 |34-400 Nowy Targ;1277;708;708;14;694;55.44;1.98
92712;121101;Polski Komitet Pomocy Społecznej|Nowy Targ|ul. Tadeusza Kościuszki 8 |34-400 Nowy Targ;1514;827;827;10;817;54.62;1.21
92713;121101;Stadion Miejski im. Józefa Piłsudskiego|Nowy Targ|ul. Kolejowa 161 |34-400 Nowy Targ;1460;809;809;15;794;55.41;1.85
92714;121101;Szkoła Podstawowa Nr 6|Nowy Targ|Osiedle Na Skarpie 11 |34-400 Nowy Targ;1203;660;660;26;634;54.86;3.94
92715;121101;Miejski Ośrodek Kultury|Nowy Targ|Aleja Tysiąclecia 37 |34-400 Nowy Targ;1469;696;696;20;676;47.38;2.87
92716;121101;Gimnazjum Nr 1|Nowy Targ|Plac Słowackiego 14 |34-400 Nowy Targ;1448;823;823;13;810;56.84;1.58
92717;121101;Szkoła Podstawowa Nr 5|Nowy Targ|ul. Władysława Orkana 17 |34-400 Nowy Targ;1514;845;845;7;838;55.81;0.83
92718;121101;Miejski Zakład Komunikacji|Nowy Targ|Osiedle Konfederacji Tatrzańskiej 1a |34-400 Nowy Targ;1141;506;506;13;493;44.35;2.57
92719;121101;Szkoła Podstawowa Nr 2|Nowy Targ|Aleja Mikołaja Kopernika 28 |34-400 Nowy Targ;1218;508;508;23;485;41.71;4.53
92720;121101;Zespół Szkół Technicznych|Nowy Targ|ul. Wojska Polskiego 9 |34-400 Nowy Targ;1203;552;552;10;542;45.89;1.81
92721;121101;Niepubliczne Przedszkole|Nowy Targ|ul. Wojska Polskiego 26 |34-400 Nowy Targ;1219;603;603;16;587;49.47;2.65
92722;121101;Szkoła Podstawowa Nr 2|Nowy Targ|Aleja Mikołaja Kopernika 28 |34-400 Nowy Targ;1179;560;560;20;540;47.50;3.57
92723;121101;Miejska Hala Sportowa "Gorce"|Nowy Targ|Aleja Tysiąclecia 74 |34-400 Nowy Targ;1134;601;601;13;588;53.00;2.16
92724;121101;Pływalnia Miejska|Nowy Targ|Plac Evry 4 |34-400 Nowy Targ;840;450;450;8;442;53.57;1.78
92725;121101;Szkoła Podstawowa Nr 11|Nowy Targ|Plac Evry 3 |34-400 Nowy Targ;1289;657;657;14;643;50.97;2.13
92726;121101;Gimnazjum Nr 2|Nowy Targ|Plac Evry 3 |34-400 Nowy Targ;1271;599;599;9;590;47.13;1.50
92727;121101;Świetlica przy Parafii Rzymsko-Katolickiej pw. Św. Jana Pawła II|Nowy Targ|ul. Szaflarska 160 |34-400 Nowy Targ;1445;737;737;15;722;51.00;2.04
92728;121101;Podhalański Szpital Specjalistyczny im. Jana Pawła II|Nowy Targ|ul. Szpitalna 14 |34-400 Nowy Targ;379;60;60;3;57;15.83;5.00
92729;121102;Remiza OSP|Jaworki|ul. Czarna Woda 2 |34-460 Szczawnica;474;220;220;20;200;46.41;9.09
92730;121102;Szkoła Podstawowa|Szlachtowa|ul. Jana Pawła II 25 |34-460 Szczawnica;672;272;272;18;254;40.48;6.62
92731;121102;Remiza OSP|Szczawnica|ul. Szalaya 84 |34-460 Szczawnica;1325;554;554;26;528;41.81;4.69
92732;121102;Szkoła Podstawowa Nr 1|Szczawnica|ul. Główna 12 |34-460 Szczawnica;992;543;543;15;528;54.74;2.76
92733;121102;Sanatorium Uzdrowiskowe "Papiernik"|Szczawnica|Aleja 1 Maja 3 |34-460 Szczawnica;1150;565;565;22;543;49.13;3.89
92734;121102;Gimnazjum Publiczne|Szczawnica|ul. Główna 116 |34-460 Szczawnica;1516;713;713;42;671;47.03;5.89
92735;121103;Remiza OSP|Czarny Dunajec|ul. Józefa Piłsudskiego 2A |34-470 Czarny Dunajec;843;354;354;10;344;41.99;2.82
92736;121103;Budynek Liceum|Czarny Dunajec|ul. Ks. Kmietowicza 2 |34-470 Czarny Dunajec;900;295;295;13;282;32.78;4.41
92737;121103;"Dworek"|Czarny Dunajec|ul. Kolejowa 14 |34-470 Czarny Dunajec;1186;423;423;15;408;35.67;3.55
92738;121103;Remiza OSP|Wróblówka| 40a |34-470 Czarny Dunajec;467;169;169;10;159;36.19;5.92
92739;121103;Szkoła Podstawowa|Pieniążkowice| 142 |34-408 Odrowąż;678;248;248;23;225;36.58;9.27
92740;121103;Szkoła Podstawowa|Dział| 9 |34-408 Odrowąż;404;119;119;12;107;29.46;10.08
92741;121103;Szkoła Podstawowa|Odrowąż| 41 |34-408 Odrowąż;798;288;288;19;269;36.09;6.60
92742;121103;Gimnazjum|Załuczne| 84A |34-408 Odrowąż;556;275;275;21;254;49.46;7.64
92743;121103;Szkoła Podstawowa|Podszkle| 47 |34-472 Piekielnik;663;265;265;8;257;39.97;3.02
92744;121103;Ośrodek Zdrowia|Piekielnik| 129c |34-472 Piekielnik;907;331;331;13;318;36.49;3.93
92745;121103;Zespół Szkół Podstawowej i Gimnazjum|Piekielnik| 202 |34-472 Piekielnik;886;358;358;13;345;40.41;3.63
92746;121103;Remiza OSP|Podczerwone| 112 |34-470 Czarny Dunajec;788;273;273;8;265;34.64;2.93
92747;121103;Remiza OSP|Koniówka| 215c |34-470 Czarny Dunajec;303;115;115;3;112;37.95;2.61
92748;121103;Szkoła Podstawowa|Chochołów| 184B |34-513 Chochołów;972;393;393;9;384;40.43;2.29
92749;121103;Szkoła Podstawowa Nr 1|Ciche| 152 |34-407 Ciche;792;291;291;8;283;36.74;2.75
92750;121103;Remiza OSP (Ciche Środkowe)|Ciche| 343B |34-407 Ciche;838;322;322;10;312;38.42;3.11
92751;121103;Szkoła Podstawowa Nr 3|Ciche| 611A |34-407 Ciche;750;278;278;6;272;37.07;2.16
92752;121103;Remiza OSP (Ratułów Dolny)|Ratułów| 110c |34-407 Ciche;820;348;348;16;332;42.44;4.60
92753;121103;Remiza OSP (Ratułów Górny)|Ratułów| 252a |34-407 Ciche;856;343;343;10;333;40.07;2.92
92754;121103;Szkoła Podstawowa Nr 1|Czerwienne| 89 |34-407 Ciche;610;267;267;7;260;43.77;2.62
92755;121103;Katolickie Gimnazjum i Szkoła Podstawowa Stowarzyszenia Przyjaciół Szkół Katolickich|Czerwienne| 245 |34-407 Ciche;655;280;280;9;271;42.75;3.21
92756;121103;Szkoła Podstawowa Nr 2 Stowarzyszenia Przyjaciół Szkół Katolickich|Stare Bystre| 124 |34-407 Ciche;684;261;261;14;247;38.16;5.36
92757;121103;Szkoła Podstawowa Nr 1 i Gimnazjum Stowarzyszenia Przyjaciół Szkół Katolickich|Stare Bystre| 347 |34-407 Ciche;646;213;213;7;206;32.97;3.29
92758;121104;Urząd Gminy Czorsztyn z/s w Maniowach|Maniowy|ul. Gorczańska 3 |34-436 Maniowy;828;302;302;17;285;36.47;5.63
92759;121104;Urząd Gminy Czorsztyn z/s w Maniowach|Maniowy|ul. Gorczańska 3 |34-436 Maniowy;1024;437;437;19;418;42.68;4.35
92760;121104;Remiza OSP|Mizerna| 144 |34-440 Kluszkowce;443;172;172;8;164;38.83;4.65
92761;121104;Dom Kultury|Kluszkowce|ul. Stażacka 1 |34-440 Kluszkowce;1445;632;632;29;603;43.74;4.59
92762;121104;Remiza OSP|Czorsztyn|ul. Jana Pawła II 2a |34-440 Kluszkowce;310;165;165;7;158;53.23;4.24
92763;121104;Szkoła Podstawowa|Sromowce Wyżne|ul. Nad Zalew 12 |34-443 Sromowce Wyżne;962;486;486;28;458;50.52;5.76
92764;121104;Szkoła Podstawowa|Sromowce Niżne|ul. Szkolna 7 |34-443 Sromowce Wyżne;842;482;482;30;452;57.24;6.22
92765;121105;Remiza OSP|Chyżne| 140 |34-481 Chyżne;847;336;336;11;325;39.67;3.27
92766;121105;Zespół Szkół|Jabłonka|ul. Piusa Jabłońskiego 4 |34-480 Jabłonka;1967;1022;1022;27;995;51.96;2.64
92767;121105;Zespół Szkół|Jabłonka|ul. Piusa Jabłońskiego 4 |34-480 Jabłonka;1219;540;540;16;524;44.30;2.96
92768;121105;Szkoła Podstawowa Nr 2|Lipnica Mała| 346 |34-482 Lipnica Mała;1765;849;849;34;815;48.10;4.00
92769;121105;Remiza OSP|Orawka| 62 |34-480 Jabłonka;805;465;465;21;444;57.76;4.52
92770;121105;Szkoła Podstawowa Nr 1|Podwilk| 287 |34-722 Podwilk;1930;976;976;45;931;50.57;4.61
92771;121105;Zespół Szkół|Zubrzyca Dolna| 257 |34-484 Zubrzyca Górna;1397;644;644;23;621;46.10;3.57
92772;121105;Zespół Szkół|Zubrzyca Górna| 482 |34-484 Zubrzyca Górna;1203;572;572;16;556;47.55;2.80
92773;121105;Szkoła Podstawowa w Jabłonce Bory|Jabłonka|ul. Kopernika 14 |34-480 Jabłonka;686;354;354;18;336;51.60;5.08
92774;121105;Szkoła Podstawowa Nr 2|Lipnica Mała| 346 |34-482 Lipnica Mała;917;437;437;25;412;47.66;5.72
92775;121105;Zespół Szkół|Zubrzyca Górna| 482 |34-484 Zubrzyca Górna;1148;542;542;18;524;47.21;3.32
92776;121106;Zespół Szkół|Krościenko nad Dunajcem|ul. Zdrojowa 11 |34-450 Krościenko nad Dunajcem;966;510;510;12;498;52.80;2.35
92777;121106;Budynek Starej Plebanii|Krościenko nad Dunajcem|ul. Rynek 32 |34-450 Krościenko nad Dunajcem;1433;730;730;18;712;50.94;2.47
92778;121106;Gimnazjum Publiczne|Krościenko nad Dunajcem|ul. Biały Potok 1 |34-450 Krościenko nad Dunajcem;762;372;372;36;336;48.82;9.68
92779;121106;Szkoła Podstawowa|Grywałd|ul. Szkolna 29 |34-450 Krościenko nad Dunajcem;1164;536;536;21;515;46.05;3.92
92780;121106;Remiza OSP|Hałuszowa| 32A |34-450 Krościenko nad Dunajcem;215;110;110;8;102;51.16;7.27
92781;121106;Szkoła Podstawowa|Krośnica|ul. Ojca Leona 1 |34-450 Krościenko nad Dunajcem;820;386;386;25;361;47.07;6.48
92782;121107;Szkoła Podstawowa|Kiczory| 60 |34-483 Lipnica Wielka;511;252;252;10;242;49.32;3.97
92783;121107;Szkoła Podstawowa Nr 1|Lipnica Wielka| 205 |34-483 Lipnica Wielka;1054;562;562;12;550;53.32;2.14
92784;121107;Dom Ludowy|Lipnica Wielka| 521 |34-483 Lipnica Wielka;1351;711;711;32;679;52.63;4.50
92785;121107;Szkoła Podstawowa Nr 3|Lipnica Wielka| 825 |34-483 Lipnica Wielka;840;378;378;20;358;45.00;5.29
92786;121107;Szkoła Podstawowa Nr 4|Lipnica Wielka| 1043 |34-483 Lipnica Wielka;727;297;297;15;282;40.85;5.05
92787;121108;Zespół Szkół - Szkoła Podstawowa i Gimnazjum|Frydman|ul. Szkolna 4 |34-435 Frydman;1360;494;494;23;471;36.32;4.66
92788;121108;Remiza Ochotniczej Straży Pożarnej|Falsztyn| 121 |34-435 Frydman;244;112;112;4;108;45.90;3.57
92789;121108;Remiza Ochotniczej Straży Pożarnej|Niedzica-Zamek|ul. Nad Zalewem 1 |34-441 Niedzica;201;95;95;5;90;47.26;5.26
92790;121108;Zespół Placówek Oświatowych|Niedzica|ul. 3 Maja 97 |34-441 Niedzica;1431;579;579;27;552;40.46;4.66
92791;121108;Dom Strażaka|Kacwin|ul. Kościelna 1 |34-441 Niedzica;972;377;377;8;369;38.79;2.12
92792;121108;Dom Ludowy|Łapsze Niżne|ul. Jana Pawła II 57 |34-442 Łapsze Niżne;1191;510;510;12;498;42.82;2.35
92793;121108;Szkoła Podstawowa|Łapsze Wyżne|ul. Świętego Floriana 51 |34-442 Łapsze Niżne;760;300;300;10;290;39.47;3.33
92794;121108;Szkoła Podstawowa|Łapszanka| 32 |34-442 Łapsze Niżne;324;146;146;4;142;45.06;2.74
92795;121108;Szkoła Podstawowa|Trybsz|ul. Świętej Elżbiety 175 |34-442 Łapsze Niżne;654;231;231;9;222;35.32;3.90
92796;121109;Szkoła Podstawowa|Dębno|ul. Szkolna 3 |34-434 Dębno;644;301;301;22;279;46.74;7.31
92797;121109;Szkoła Podstawowa|Harklowa| 26 |34-434 Dębno;438;258;258;9;249;58.90;3.49
92798;121109;Zespół Szkoły Podstawowej i Gimnazjum|Łopuszna|ul. Szkolna 1 |34-432 Łopuszna;1295;650;650;23;627;50.19;3.54
92799;121109;Szkoła Podstawowa|Ostrowsko|ul. Jana Pawła II 13 |34-431 Waksmund;1023;431;431;18;413;42.13;4.18
92800;121109;Zespół Szkoły Podstawowej i Gimnazjum|Waksmund|ul. Na Równi 28 |34-431 Waksmund;1887;892;892;48;844;47.27;5.38
92801;121109;Zespół Szkoły Podstawowej i Gimnazjum|Gronków| 210 |34-400 Nowy Targ;1331;575;575;19;556;43.20;3.30
92802;121109;Szkoła Podstawowa|Nowa Biała|ul. Główna 13 |34-433 Nowa Biała;1081;423;423;30;393;39.13;7.09
92803;121109;Szkoła Podstawowa|Krempachy|ul. Długa 17 |34-433 Nowa Biała;1037;554;554;33;521;53.42;5.96
92804;121109;Szkoła Podstawowa|Dursztyn|ul. Pienińska 1 |34-433 Nowa Biała;400;188;188;6;182;47.00;3.19
92805;121109;Szkoła Podstawowa|Klikuszowa| 240 |34-404 Klikuszowa;1162;483;483;15;468;41.57;3.11
92806;121109;Szkoła Podstawowa|Lasek| 69 |34-404 Klikuszowa;854;368;368;17;351;43.09;4.62
92807;121109;Szkoła Podstawowa|Morawczyna| 57 |34-404 Klikuszowa;532;164;164;7;157;30.83;4.27
92808;121109;Szkoła Podstawowa|Pyzówka|ul. Orkana 6 |34-404 Klikuszowa;731;358;358;20;338;48.97;5.59
92809;121109;Szkoła Podstawowa|Krauszów| 55 |34-471 Ludźmierz;559;251;251;8;243;44.90;3.19
92810;121109;Budynek byłej Szkoły Podstawowej|Długopole| 85 |34-471 Ludźmierz;403;150;150;8;142;37.22;5.33
92811;121109;Szkoła Podstawowa|Ludźmierz|ul. Kazimierza Przerwy-Tetmajera 56 |34-471 Ludźmierz;1972;839;839;24;815;42.55;2.86
92812;121109;Szkoła Podstawowa|Rogoźnik| 69 |34-471 Ludźmierz;720;294;294;13;281;40.83;4.42
92813;121109;Szkoła Podstawowa|Obidowa| 37 |34-404 Klikuszowa;606;206;206;8;198;33.99;3.88
92814;121109;Szkoła Podstawowa|Knurów| 46 |34-434 Dębno;410;178;178;13;165;43.41;7.30
92815;121109;Szkoła Podstawowa|Szlembark|ul. Ks.K.K. Wojtyły 44 |34-434 Dębno;457;184;184;20;164;40.26;10.87
92816;121109;Remiza OSP w Trutem|Lasek Trute| 71A |34-404 Klikuszowa;468;192;192;4;188;41.03;2.08
92817;121110;Szkoła Podstawowa im. Marii Konopnickiej|Ochotnica Górna| 207 |34-453 Ochotnica Górna;1654;721;721;35;686;43.59;4.85
92818;121110;Szkoła Podstawowa im. Jana Pawła II w Ochotnicy Dolnej - Centrum|Ochotnica Dolna| 105 |34-452 Ochotnica Dolna;1794;978;978;36;942;54.52;3.68
92819;121110;Niepubliczna Szkoła Podstawowa w Ochotnicy Dolnej - Młynne|Ochotnica Dolna| 85 |34-452 Ochotnica Dolna;636;319;319;16;303;50.16;5.02
92820;121110;Zespół Szkolno-Przedszkolny im. mjr. Henryka Sucharskiego (sala Nr 1)|Tylmanowa|os. Kozielce 296 |34-451 Tylmanowa;988;421;421;13;408;42.61;3.09
92821;121110;Zespół Szkolno-Przedszkolny im. mjr. Henryka Sucharskiego (sala Nr 2)|Tylmanowa|os. Kozielce 296 |34-451 Tylmanowa;1301;653;653;26;627;50.19;3.98
92822;121111;Przedszkole Gminne|Raba Wyżna| 29 |34-721 Raba Wyżna;1284;640;640;27;613;49.84;4.22
92823;121111;Urząd Gminy|Raba Wyżna| 41 |34-721 Raba Wyżna;2063;997;997;34;963;48.33;3.41
92824;121111;Szkoła Podstawowa|Bielanka| 29 |34-723 Sieniawa;337;186;186;11;175;55.19;5.91
92825;121111;Szkoła Podstawowa|Rokiciny Podhalańskie| 13 |34-721 Raba Wyżna;1254;559;559;21;538;44.58;3.76
92826;121111;Szkoła Podstawowa|Podsarnie| 59 |34-721 Raba Wyżna;639;324;324;10;314;50.70;3.09
92827;121111;Szkoła Podstawowa|Harkabuz| 47 |34-721 Raba Wyżna;434;188;188;9;179;43.32;4.79
92828;121111;Remiza OSP|Bukowina-Osiedle| 28C |34-721 Raba Wyżna;191;96;96;8;88;50.26;8.33
92829;121111;Zespół Szkół|Skawa| 584a |34-713 Skawa;2131;1029;1029;33;996;48.29;3.21
92830;121111;Szkoła Podstawowa Nr 3|Skawa| 278 |34-713 Skawa;1353;626;626;26;600;46.27;4.15
92831;121111;Szkoła Podstawowa|Sieniawa| 92 |34-723 Sieniawa;1479;668;668;32;636;45.17;4.79
92832;121111;Zakład Opiekuńczo-Leczniczy im. Św. Siostry Faustyny Kowalskiej|Raba Wyżna| 435A |34-721 Raba Wyżna;41;39;39;0;39;95.12;0.00
92833;121112;Szkoła Podstawowa Nr 4|Rabka-Zdrój|ul. Zaryte 78 |34-700 Rabka-Zdrój;843;433;433;17;416;51.36;3.93
92834;121112;Szkoła Podstawowa Nr 3|Rabka-Zdrój|ul. Poniatowskiego 186 |34-700 Rabka-Zdrój;1389;742;742;15;727;53.42;2.02
92835;121112;Szkoła Podstawowa Nr 2|Rabka-Zdrój|ul. Sądecka 2 |34-700 Rabka-Zdrój;969;491;491;10;481;50.67;2.04
92836;121112;Świetlica Związku Podhalan|Rabka-Zdrój|ul. Podhalańska 6 |34-700 Rabka-Zdrój;1269;715;715;17;698;56.34;2.38
92837;121112;Przedszkole Nr 1|Rabka-Zdrój|ul. Orkana 18i |34-700 Rabka-Zdrój;1440;774;774;25;749;53.75;3.23
92838;121112;Gimnazjum Nr 1|Rabka-Zdrój|ul. Jana Pawła II 40 |34-700 Rabka-Zdrój;1373;815;815;5;810;59.36;0.61
92839;121112;Galeria Miejskiego Ośrodka Kultury "Pod Aniołem"|Rabka-Zdrój|ul. Parkowa 5 |34-700 Rabka-Zdrój;1634;982;982;24;958;60.10;2.44
92840;121112;Szkoła Podstawowa Nr 2|Rabka-Zdrój|ul. Sądecka 2 |34-700 Rabka-Zdrój;1626;944;944;23;921;58.06;2.44
92841;121112;Zespół Szkół Szkoła Podstawowa i Gimnazjum|Chabówka| 232 |34-720 Chabówka;1251;625;625;18;607;49.96;2.88
92842;121112;Zespół Szkoły Podstawowej i Gimnazjum|Ponice| 105 |34-700 Rabka-Zdrój;930;388;388;19;369;41.72;4.90
92843;121112;Zespół Szkoły Podstawowej i Gimnazjum|Rdzawka| 60 |34-700 Rabka-Zdrój;1154;601;601;26;575;52.08;4.33
92844;121112;Szpital Miejski (świetlica)|Rabka-Zdrój|ul. Słoneczna 3 |34-700 Rabka-Zdrój;56;20;20;0;20;35.71;0.00
92845;121112;Dom Pomocy Społecznej "Smrek" (świetlica)|Rabka-Zdrój|ul. Parkowa 4 |34-700 Rabka-Zdrój;49;19;19;1;18;38.78;5.26
92846;121113;Szkoła Podstawowa Nr 3|Spytkowice| 153 |34-745 Spytkowice;691;311;311;12;299;45.01;3.86
92847;121113;Zespół Szkół Podstawowo-Gimnazjalnych|Spytkowice| 12 |34-745 Spytkowice;674;289;289;8;281;42.88;2.77
92848;121113;Zespół Szkół Podstawowo-Gimnazjalnych|Spytkowice| 12 |34-745 Spytkowice;674;312;312;23;289;46.29;7.37
92849;121113;Zespół Szkół Podstawowo-Gimnazjalnych|Spytkowice| 12 |34-745 Spytkowice;669;310;310;9;301;46.34;2.90
92850;121113;Szkoła Podstawowa Nr 2|Spytkowice| 566 |34-754 Spytkowice;652;328;328;7;321;50.31;2.13
92851;121114;Zespół Szkoły Podstawowej i Gimnazjum|Bańska Niżna|ul. Papieska 141 |34-424 Szaflary;936;322;322;20;302;34.40;6.21
92852;121114;Zespół Szkoły Podstawowej i Gimnazjum|Bańska Wyżna|ul. Szlak Papieski 64 |34-424 Szaflary;797;287;287;13;274;36.01;4.53
92853;121114;Szkoła Podstawowa|Bór|ul. Jana Pawła II 44 |34-424 Szaflary;395;140;140;7;133;35.44;5.00
92854;121114;Zespół Szkoły Podstawowej i Gimnazjum w Maruszynie Górnej|Maruszyna|ul. Jana Pawła II 29 |34-424 Szaflary;974;360;360;14;346;36.96;3.89
92855;121114;Zespół Szkoły Podstawowej i Gimnazjum w Maruszynie Dolnej|Maruszyna|ul. Jana Pawła II 83 |34-424 Szaflary;551;212;212;10;202;38.48;4.72
92856;121114;Zespół Szkoły Podstawowej i Gimnazjum|Skrzypne|ul. Św. Jadwigi Królowej 128 |34-424 Szaflary;836;370;370;10;360;44.26;2.70
92857;121114;Zespół Szkoły Podstawowej i Gimnazjum|Szaflary|ul. Szkolna 6 |34-424 Szaflary;1358;539;539;20;519;39.69;3.71
92858;121114;Zespół Szkoły Podstawowej i Gimnazjum|Szaflary|ul. Szkolna 6 |34-424 Szaflary;1322;485;485;20;465;36.69;4.12
92859;121114;Zespół Szkoły Podstawowej i Gimnazjum|Zaskale|ul. Kardynała Karola Wojtyły 51 |34-424 Szaflary;1056;447;447;20;427;42.33;4.47
92860;121114;Dom Pomocy Społecznej "Smrek"|Zaskale|ul. Kardynała Karola Wojtyły 136 |34-424 Szaflary;74;30;30;5;25;40.54;16.67
92861;121201;Filia Miejskiego Ośrodka Kultury w Bukownie Podlesiu|Bukowno, Podlesie|Olkuska 8 |32-332 Bukowno;309;155;155;2;153;50.16;1.29
92862;121201;Filia Miejskiego Ośrodka Kultury w Bukownie Borze|Bukowno, Bór Biskupi|Wiejska 19 |32-332 Bukowno;452;215;215;12;203;47.57;5.58
92863;121201;Miejski Ośrodek Sportu i Rekreacji w Bukownie|Bukowno|Spacerowa 1 |32-332 Bukowno;1101;594;594;12;582;53.95;2.02
92864;121201;Przedszkole Sióstr Prezentek w Bukownie|Bukowno|Kościuszki 57 |32-332 Bukowno;544;336;336;16;320;61.76;4.76
92865;121201;Zespół Szkół Nr 1 w Bukownie|Bukowno|Szkolna 8 |32-332 Bukowno;827;371;371;8;363;44.86;2.16
92866;121201;Miejski Ośrodek Kultury w Bukownie|Bukowno|Kolejowa 3 |32-332 Bukowno;1767;820;820;13;807;46.41;1.59
92867;121201;Miejskie Przedszkole w Bukownie|Bukowno|Niepodległości 11 |32-332 Bukowno;1612;869;869;32;837;53.91;3.68
92868;121201;Filia Miejskiego Ośrodka Kultury w Bukownie|Bukowno|Wodąca 51 |32-332 Bukowno;599;313;313;7;306;52.25;2.24
92869;121201;Zespół Szkół Nr 2 w Bukownie|Bukowno|Sławkowska 133 |32-332 Bukowno;1302;642;642;18;624;49.31;2.80
92870;121201;Dom Seniora "Leśna Polana"|Bukowno|Długa 2 |32-332 Bukowno;67;52;52;3;49;77.61;5.77
92871;121203;Centrum Kultury im. Marii Płonowskiej w Bolesławiu|Bolesław|ul. Główna 55 |32-329 Bolesław;2205;1103;1103;16;1087;50.02;1.45
92872;121203;Zespół Przedszkolo-Szkolno-Gimnazjalny w Podlipiu|Podlipie| 153 |32-329 Bolesław;1247;615;615;31;584;49.32;5.04
92873;121203;Dom Wiejski w Krzykawie|Krzykawa| 54A |32-329 Bolesław;1909;866;866;19;847;45.36;2.19
92874;121203;Remiza Ochotniczej Straży Pożarnej w Laskach|Laski|ul. Główna 3 |32-329 Bolesław;1114;492;492;21;471;44.17;4.27
92875;121203;Kamiliańskie Centrum Opiekuńczo – Lecznicze w Hutkach|Hutki|Jurajska 36 |32-329 Bolesław;106;36;36;4;32;33.96;11.11
92876;121204;Dom Kultury"Papiernik" w Kluczach|Klucze|ul.Rudnicka 2a |32-310 Klucze;2392;1293;1293;38;1255;54.06;2.94
92877;121204;Szkoła Podstawowa w Kluczach|Klucze|ul. Zawierciańska 30 |32-310 Klucze;1746;956;956;28;928;54.75;2.93
92878;121204;Dom Ludowy w Chechle|Chechło|ul. Plac Partyzantów 3 |32-310 Klucze;1344;638;638;15;623;47.47;2.35
92879;121204;Szkoła Podstawowa w Rodakach|Rodaki|ul. Strażacka 11 |32-310 Klucze;756;393;393;13;380;51.98;3.31
92880;121204;Szkoła Podstawowa w Ryczówku|Ryczówek|ul. Dolna 12 |32-310 Klucze;984;470;470;18;452;47.76;3.83
92881;121204;Zespół Szkolno-Przedszkolny w Kwaśniowie Dolnym|Kwaśniów Dolny|ul. Basztowa 2 |32-310 Klucze;1311;675;676;28;647;51.49;4.15
92882;121204;Dom Ludowy w Cieślinie|Cieślin|ul. Jurajska 67 |32-310 Klucze;260;147;147;2;145;56.54;1.36
92883;121204;Dom Kultury "Hutnik" w Jaroszowcu|Jaroszowiec|ul. Leśna 1 |32-310 Klucze;1327;730;730;17;713;55.01;2.33
92884;121204;Budynek wielofunkcyjny w Kolbarku|Kolbark|ul. Źródlana 3 |32-310 Klucze;446;274;274;8;266;61.43;2.92
92885;121204;Budynek wielofunkcyjny w Krzywopłotach|Krzywopłoty|ul. Partyzantów 26 |32-310 Klucze;435;256;256;3;253;58.85;1.17
92886;121204;Zespół Szkolno-Przedszkolny w Bydlinie|Bydlin|ul. Legionów 32 |32-310 Klucze;837;453;453;9;444;54.12;1.99
92887;121204;Świetlica Wiejska w Golczowicach|Golczowice|ul. Wesoła 17 |32-310 Klucze;241;128;128;5;123;53.11;3.91
92888;121204;Budynek po byłym przedszkolu w Bogucinie Dużym|Bogucin Duży| 59 |32-310 Klucze;283;166;166;3;163;58.66;1.81
92889;121204;Wojewódzki Szpital Chorób Płuc i Rehabilitacji w Jaroszowcu|Jaroszowiec|Kolejowa 1a |32-310 Klucze;155;82;84;7;75;52.90;8.54
92890;121205;Zespół Szkół Nr 1 w Olkuszu|Olkusz|ul. Górnicza 12 |32-300 Olkusz;881;516;516;14;502;58.57;2.71
92891;121205;Szkoła Podstawowa Nr 1 w Olkuszu|Olkusz|ul. Jana Kantego 5 |32-300 Olkusz;1509;899;899;16;883;59.58;1.78
92892;121205;Zespół Szkół Nr 3 w Olkuszu|Olkusz|ul. Francesco Nullo 32 |32-300 Olkusz;1953;891;891;20;871;45.62;2.24
92893;121205;Szkoła Podstawowa Nr 4 w Olkuszu|Olkusz|ul. Francesco Nullo 36 |32-300 Olkusz;1026;578;578;12;566;56.34;2.08
92894;121205;Powiatowe Centrum Pomocy Rodzinie w Olkuszu|Olkusz|ul. Marszałka Józefa Piłsudskiego 21 |32-300 Olkusz;1492;951;951;6;945;63.74;0.63
92895;121205;Szkoła Podstawowa Nr 6 w Olkuszu|Olkusz|ul. Długa 67 |32-300 Olkusz;1473;857;857;22;835;58.18;2.57
92896;121205;Szkoła Podstawowa Nr 5 w Olkuszu|Olkusz|ul. Cegielniana 24 |32-300 Olkusz;2135;1331;1331;21;1310;62.34;1.58
92897;121205;Olkuska Spółdzielnia Mieszkaniowa, Administracja nr 3, w Olkuszu|Olkusz|ul. Juliana Tuwima 2 |32-300 Olkusz;1937;1061;1061;23;1038;54.78;2.17
92898;121205;Zespół Szkolno-Przedszkolny Integracyjny Nr 1 w Olkuszu|Olkusz|ul. Jana Kochanowskiego 2 |32-300 Olkusz;1790;938;938;20;918;52.40;2.13
92899;121205;Przedszkole Nr 10 w Olkuszu|Olkusz|ul. Stefana Żeromskiego 6 |32-300 Olkusz;1581;843;843;12;831;53.32;1.42
92900;121205;Szkoła Podstawowa Nr 10 w Olkuszu|Olkusz|ul. Stefana Żeromskiego 1 |32-300 Olkusz;1808;974;974;12;962;53.87;1.23
92901;121205;Szkoła Podstawowa Nr 3 w Olkuszu|Olkusz|ul. Kpt. Hardego 11a |32-300 Olkusz;1846;1017;1017;15;1002;55.09;1.47
92902;121205;Zespół Szkół Nr 4 w Olkuszu|Olkusz|ul. Legionów Polskich 1 |32-300 Olkusz;1847;986;986;24;962;53.38;2.43
92903;121205;Przedszkole Nr 8 w Olkuszu|Olkusz|ul. Legionów Polskich 12 |32-300 Olkusz;1615;913;913;24;889;56.53;2.63
92904;121205;Gimnazjum Nr 3 w Olkuszu|Olkusz|ul. Janusza Korczaka 7 |32-300 Olkusz;1502;914;914;18;896;60.85;1.97
92905;121205;Szkoła Podstawowa Nr 9 w Olkuszu|Olkusz|ul. Kosynierów 14 |32-300 Olkusz;2235;1258;1258;18;1240;56.29;1.43
92906;121205;Przedszkole Nr 13 w Olkuszu|Olkusz|ul. Kosynierów 14 |32-300 Olkusz;2185;1254;1254;27;1227;57.39;2.15
92907;121205;Świetlica Wiejska MOK w Bogucinie Małym|Bogucin Mały| 66 |32-300 Olkusz;778;476;476;6;470;61.18;1.26
92908;121205;Szkoła Podstawowa w Braciejówce|Braciejówka| 60 |32-300 Olkusz;657;305;305;14;291;46.42;4.59
92909;121205;Świetlica Wiejska w Podlesiu|Podlesie| 63C |32-300 Olkusz;399;200;200;6;194;50.13;3.00
92910;121205;Wiejski Dom Kultury w Troksie|Troks| 43 |32-300 Olkusz;453;203;203;4;199;44.81;1.97
92911;121205;Publiczna Szkoła Podstawowa w Witeradowie|Witeradów| 394 |32-300 Olkusz;790;442;442;9;433;55.95;2.04
92912;121205;Szkoła Podstawowa w Żuradzie|Żurada Kolonia III| 10a |32-300 Olkusz;962;598;598;8;590;62.16;1.34
92913;121205;Szkoła Podstawowa w Osieku|Osiek| 79b |32-300 Olkusz;1408;829;829;23;806;58.88;2.77
92914;121205;Remiza OSP w Zimnodole|Zimnodół| |32-300 Olkusz;583;314;314;14;300;53.86;4.46
92915;121205;Szkoła Podstawowa w Kosmolowie|Kosmolów| 152 |32-300 Olkusz;821;450;450;14;436;54.81;3.11
92916;121205;Szkoła Podstawowa w Sienicznie|Sieniczno|ul. Marii Dąbrowskiej 14 |32-300 Olkusz;904;529;529;7;522;58.52;1.32
92917;121205;Klub Rolnika w Gorenicach|Gorenice|ul. Chrzanowska 4 |32-327 Gorenice;1110;612;612;14;598;55.14;2.29
92918;121205;Wiejski Dom Kultury w Niesułowicach|Niesułowice|ul. Galicyjska 112 |32-300 Olkusz;455;214;214;3;211;47.03;1.40
92919;121205;Szkoła Podstawowa w Zedermanie|Zederman| 99 |32-300 Olkusz;1147;629;629;19;610;54.84;3.02
92920;121205;Szkoła Podstawowa w Zawadzie|Zawada| 110 |32-327 Gorenice;514;273;273;6;267;53.11;2.20
92921;121205;Dom Pomocy Społecznej w Olkuszu|Olkusz|Jana Kantego 4 |32-300 Olkusz;92;42;42;6;36;45.65;14.29
92922;121205;Niepubliczny Zakład Opieki Zdrowotnej Nowy Szpital w Olkuszu|Olkusz|Al. 1000-lecia 13 |32-300 Olkusz;126;51;51;3;48;40.48;5.88
92923;121205;Niepubliczny Zakład Opiekuńczo Leczniczy "Pomorzany" Olkusz|Olkusz|Gwarków 4A |32-300 Olkusz;104;13;13;0;13;12.50;0.00
92924;121206;Zespół Szkół - Szkoła Podstawowa i Gimnazjum w Jangrocie, Jangrot|Jangrot| 83 |32-353 Trzyciąż;2266;1058;1058;44;1014;46.69;4.16
92925;121206;Zespół Szkół - Szkoła Podstawowa i Gimnazjum w Suchej, Sucha|Sucha| 32 |32-353 Trzyciąż;1064;479;479;12;467;45.02;2.51
92926;121206;Biały Domek w Imbramowicach, Imbramowice|Imbramowice| 141 |32-353 Trzyciąż;741;348;348;19;329;46.96;5.46
92927;121206;Zespół Szkół - Szkoła Podstawowa i Gimnazjum w Zadrożu, Zadroże|Zadroże| 69 |32-353 Trzyciąż;1630;806;806;28;778;49.45;3.47
92928;121207;Szkoła Podstawowa w Chełmie|Chełm| 98 |32-340 Wolbrom;716;353;353;3;350;49.30;0.85
92929;121207;Szkoła Filiana Chrząstowice|Chrząstowice| 15 |32-340 Wolbrom;558;283;283;14;269;50.72;4.95
92930;121207;Zespół Szkół w Dłużcu|Dłużec| 7 |32-340 Wolbrom;957;527;527;17;510;55.07;3.23
92931;121207;Remiza OSP w Załężu|Załęże| 108 |32-310 Klucze;810;432;432;11;421;53.33;2.55
92932;121207;Zespół Szkół w Gołaczewach|Gołaczewy| 17a |32-340 Wolbrom;1049;532;532;22;510;50.71;4.14
92933;121207;Szkoła Podstawowa w Jeżówce|Jeżówka| 253 |32-340 Wolbrom;960;386;386;14;372;40.21;3.63
92934;121207;Szkoła Podstawowa w Kąpielach Wielkich|Kąpiele Wielkie| 75a |32-340 Wolbrom;750;414;414;10;404;55.20;2.42
92935;121207;Szkoła Podstawowa w Łobzowie|Łobzów| 220 |32-340 Wolbrom;1287;643;643;19;624;49.96;2.95
92936;121207;Niepubliczna Szkoła Podstawowa w Porębie Dzierżnej|Poręba Dzierżna| 148 |32-340 Wolbrom;563;273;273;6;267;48.49;2.20
92937;121207;Niepubliczna Szkoła Podstawowa w Porębie Górnej|Poręba Górna| 62 |32-340 Wolbrom;983;444;444;9;435;45.17;2.03
92938;121207;Budynek byłej Szkoły Podstawowej w Strzegowej|Strzegowa| 92 |32-340 Wolbrom;606;283;283;13;270;46.70;4.59
92939;121207;Zespół Szkół w Wierzchowisku|Wierzchowisko| 32b |32-340 Wolbrom;1289;544;544;18;526;42.20;3.31
92940;121207;Zespół Szkół w Zarzeczu|Zarzecze|Szkolna 2 |32-340 Wolbrom;1123;532;532;12;520;47.37;2.26
92941;121207;Gimnazjum Nr 4 w Wolbromiu|Wolbrom|Osiedle Władysława Łokietka 10 |32-340 Wolbrom;1591;866;866;21;845;54.43;2.42
92942;121207;Gimnazjum Nr 4 w Wolbromiu|Wolbrom|Osiedle Władysława Łokietka 10 |32-340 Wolbrom;1067;524;524;9;515;49.11;1.72
92943;121207;Szkoła Podstawowa Nr 1 w Wolbromiu|Wolbrom|Mariacka 28 |32-340 Wolbrom;945;566;566;12;554;59.89;2.12
92944;121207;Urząd Miasta i Gminy w Wolbromiu|Wolbrom|Krakowska 1 |32-340 Wolbrom;945;530;530;12;518;56.08;2.26
92945;121207;Środowiskowy Dom Samopomocy Wolbrom|Wolbrom|Skalska 20 |32-340 Wolbrom;779;442;442;12;430;56.74;2.71
92946;121207;Zespół Szkół w Wolbromiu|Wolbrom|Skalska 18 |32-340 Wolbrom;914;495;495;10;485;54.16;2.02
92947;121207;Zespół Szkół w Wolbromiu|Wolbrom|Pod Lasem 1 |32-340 Wolbrom;960;469;469;13;456;48.85;2.77
92948;121301;Szkoła Podstawowa Nr 5 w Oświęcimiu|Oświęcim|ul. Eugeniusza Kalicińskiego 5 |32-600 Oświęcim;1380;667;667;11;656;48.33;1.65
92949;121301;Powiatowy Zespół Nr 4 Szkół Ekonomiczno-Gastronomicznych w Oświęcimiu|Oświęcim|ul. Obozowa 39 |32-600 Oświęcim;1660;952;952;11;941;57.35;1.16
92950;121301;Powiatowy Zespół Nr 5 Szkół Budowlanych im. Edwarda Szymańskiego w Oświęcimiu|Oświęcim|ul. Obozowa 31 |32-600 Oświęcim;1844;1000;1000;38;962;54.23;3.80
92951;121301;Niepubliczne Przedszkole "Promyczek" w Oświęcimiu|Oświęcim|ul. Powstańców Warszawy 1A |32-600 Oświęcim;823;482;482;21;461;58.57;4.36
92952;121301;Miejskie Gimnazjum Nr 4 w Oświęcimiu|Oświęcim|ul. Wyzwolenia 3 |32-600 Oświęcim;570;294;294;10;284;51.58;3.40
92953;121301;Powiatowy Zespół Nr 1 Szkół Ogólnokształcących im. St. Konarskiego w Oświęcimiu|Oświęcim|ul. Stanisława Konarskiego 24 |32-600 Oświęcim;1124;559;559;7;552;49.73;1.25
92954;121301;Klub MSM "BUDOWLANKA" w Oświęcimiu|Oświęcim|ul. Wiktora Bałandy 4D |32-600 Oświęcim;1423;760;760;27;733;53.41;3.55
92955;121301;Miejskie Gimnazjum Nr 3 w Oświęcimiu|Oświęcim|ul. Ignacego Krasickiego 16 |32-600 Oświęcim;1807;1092;1092;15;1077;60.43;1.37
92956;121301;Szkoła Podstawowa Nr 1 w Oświęcimiu|Oświęcim|ul. Królowej Jadwigi 12 |32-600 Oświęcim;906;443;443;18;425;48.90;4.06
92957;121301;Niepubliczne Przedszkole "Jedyneczka" w Oświęcimiu|Oświęcim|ul. Kościelecka 1 |32-600 Oświęcim;779;537;537;12;525;68.93;2.23
92958;121301;Szkoła Podstawowa Nr 9 w Oświęcimiu|Oświęcim|ul. Budowlanych 68 |32-600 Oświęcim;1531;835;835;40;795;54.54;4.79
92959;121301;Przedszkole Miejskie Nr 15 w Oświęcimiu|Oświęcim|ul. Budowlanych 43 |32-600 Oświęcim;590;373;373;6;367;63.22;1.61
92960;121301;Przedszkole Miejskie Nr 14 w Oświęcimiu|Oświęcim|ul. Władysława Broniewskiego 12 |32-600 Oświęcim;1236;780;780;7;773;63.11;0.90
92961;121301;Szkoła Podstawowa Nr 4 w Oświęcimiu|Oświęcim|ul. Jędrzeja Śniadeckiego 26 |32-600 Oświęcim;1699;1050;1050;15;1035;61.80;1.43
92962;121301;Szkoła Podstawowa Oświęcimskiego Towarzystwa Oświatowego w Oświęcimiu|Oświęcim|ul. Zwycięstwa 75 |32-600 Oświęcim;1140;660;660;25;635;57.89;3.79
92963;121301;Miejskie Gimnazjum Nr 2 w Oświęcimiu|Oświęcim|ul. Karola Olszewskiego 2 |32-600 Oświęcim;1406;681;681;21;660;48.44;3.08
92964;121301;Miejska Biblioteka Publiczna im. Łukasza Górnickiego GALERIA KSIĄŻKI w Oświęcimiu|Oświęcim|ul. Józefa Nojego 2B |32-600 Oświęcim;1546;981;981;16;965;63.45;1.63
92965;121301;Oświęcimskie Centrum Kultury w Oświęcimiu|Oświęcim|ul. Jędrzeja Śniadeckiego 24 |32-600 Oświęcim;1336;769;769;17;752;57.56;2.21
92966;121301;Szkoła Podstawowa Nr 11 w Oświęcimiu|Oświęcim|Aleja Juliusza Słowackiego 2A |32-600 Oświęcim;1883;1136;1136;19;1117;60.33;1.67
92967;121301;Zespół Szkół Nr 1 w Oświęcimiu|Oświęcim|Aleja Juliusza Słowackiego 41 |32-600 Oświęcim;1656;894;894;17;877;53.99;1.90
92968;121301;Przedszkole Miejskie Nr 7 w Oświęcimiu|Oświęcim|Aleja Juliusza Słowackiego 8 |32-600 Oświęcim;695;321;321;11;310;46.19;3.43
92969;121301;Powiatowy Zespół Nr 2 Szkół Ogólnokształcących Mistrzostwa Sportowego i Technicznych w Oświęcimiu|Oświęcim|ul. gen. Józefa Bema 8 |32-600 Oświęcim;1211;646;646;20;626;53.34;3.10
92970;121301;Powiatowy Zespół Nr 2 Szkół Ogólnokształcących Mistrzostwa Sportowego i Technicznych w Oświęcimiu|Oświęcim|ul. gen. Józefa Bema 8 |32-600 Oświęcim;1456;901;901;19;882;61.88;2.11
92971;121301;Dom Osiedlowy Stare Stawy w Oświęcimiu|Oświęcim|ul Zagrodowa 1 |32-600 Oświęcim;1816;1118;1118;18;1100;61.56;1.61
92972;121301;Zespół Opieki Zdrowotnej w Oświęcimiu|Oświęcim|Wysokie Brzegi 4 |32-600 Oświęcim;182;72;72;7;65;39.56;9.72
92973;121301;Zakład Opiekuńczo-Leczniczy Zgromadzenia Córek Matki Bożej Bolesnej (Siostry Serafitki) Prowincja Oświęcimska w Oświęcimiu|Oświęcim|Plac Tadeusza Kościuszki 8 |32-600 Oświęcim;34;34;34;0;34;100.00;0.00
92974;121301;Centrum Kardiologii Inwazynej Elekroterapii i Angiologii G.V.M. Carint Sp. z o.o. w Oświęcimiu|Oświęcim|Wysokie Brzegi 4 |32-600 Oświęcim;4;4;4;0;4;100.00;0.00
92975;121302;Przedszkole Nr 2 z oddziałami integracyjnymi "Słoneczko" w Brzeszczach|Brzeszcze|ul. Narutowicza 6 |32-620 Brzeszcze;1894;999;999;44;955;52.75;4.40
92976;121302;Zespół Szkolno-Przedszkolny nr 5 w Brzeszczach, Szkoła Podstawowa nr 2 im. M. Kopernika|Brzeszcze|ul. Mickiewicza 3 |32-620 Brzeszcze;1504;803;803;23;780;53.39;2.86
92977;121302;Ośrodek Kultury w Brzeszczach|Brzeszcze|ul. Narutowicza 1 |32-620 Brzeszcze;1366;915;915;21;894;66.98;2.30
92978;121302;Gimnazjum Nr 2 w Brzeszczach|Brzeszcze|ul. Lipowa 3 |32-620 Brzeszcze;1956;1287;1287;36;1251;65.80;2.80
92979;121302;Zespół Szkolno-Przedszkolny nr 4 z Oddziałami Integracyjnymi w Brzeszczach, Szkoła Podstawowa Nr 1 z Oddziałami Integracyjnymi im. S. Staszica w Brzeszczach|Brzeszcze|ul. Szkolna 6 |32-620 Brzeszcze;1890;1122;1122;42;1080;59.37;3.74
92980;121302;Dom Ludowy Brzeszcze-Bór|Brzeszcze|ul.Bór 65 |32-620 Brzeszcze;758;506;506;23;483;66.75;4.55
92981;121302;Świetlica Ośrodka Kultury w Jawiszowicach|Jawiszowice|Osiedle Paderewskiego 26 |32-626 Brzeszcze;2012;1145;1145;58;1087;56.91;5.07
92982;121302;Zespół Szkolno-Przedszkolny nr 6 w Jawiszowicach, Przedszkole nr 4 "Pod Tęczą" w Jawiszowicach|Jawiszowice|ul. Gałczyńskiego 1 |32-626 Brzeszcze;1617;997;997;16;981;61.66;1.60
92983;121302;Zespół-Szkolno Przedszkolny nr 6 w Jawiszowicach, Szkoła Podstawowa im. K. I. Gałczyńskiego w Jawiszowicach|Jawiszowice|ul. Kusocińskiego 1 |32-626 Brzeszcze;1796;1213;1213;24;1189;67.54;1.98
92984;121302;Zespół Szkolno-Przedszkolny nr 1 im. Wandy Chotomskiej w Przecieszynie, Szkoła Podstawowa w Przecieszynie|Przecieszyn|ul. Wyzwolenia 54a |32-625 Brzeszcze;909;609;610;22;587;67.00;3.61
92985;121302;Zespół Szkolno-Przedszkolny nr 3 w Skidziniu, Szkoła Podstawowa im. E. Szelburg-Zarębiny w Skidziniu|Skidziń|ul. Oświęcimska 39 |32-625 Brzeszcze;1024;701;701;25;676;68.46;3.57
92986;121302;Zespół Szkolno-Przedszkolny nr 2 im. Kostka Jagiełły w Zasolu, Przedszkole Publiczne w Zasolu im. Kostka Jagiełły w Zasolu|Zasole|ul. Kostka Jagiełły 8 |32-626 Brzeszcze;631;348;348;16;332;55.15;4.60
92987;121303;Powiatowy Zespół Nr 8 Szkół Zawodowych i Ogólnokształcących w Chełmku|Chełmek|Krakowska 18 |32-660 Chełmek;663;423;423;9;414;63.80;2.13
92988;121303;Samorządowy Zespół Szkolno-Przedszkolny Nr 2 w Chełmku|Chełmek|Brzozowa 7-9 |32-660 Chełmek;1296;569;569;25;544;43.90;4.39
92989;121303;Samorządowy Zespół Szkolno-Przedszkolny Nr 2 w Chełmku|Chełmek|ul. Marszałka Piłsudskiego 1 |32-660 Chełmek;1364;741;741;25;716;54.33;3.37
92990;121303;Samorządowy Zespół Szkolno-Przedszkolny Nr 2 w Chełmku|Chełmek|ul. Marszałka Piłsudskiego 1 |32-660 Chełmek;1294;663;663;20;643;51.24;3.02
92991;121303;Remiza Ochotniczej Straży Pożarnej w Chełmku|Chełmek|ul. Staicha 3 |32-660 Chełmek;1333;825;825;16;809;61.89;1.94
92992;121303;Samorządowy Zespół Szkół nr 1 w Chełmku|Chełmek|ul. Chrobrego 9 |32-661 Chełmek;1373;775;775;21;754;56.45;2.71
92993;121303;Samorządowy Zespół Szkół w Gorzowie|Gorzów|ul. Szkolna 3 |32-660 Chełmek;1516;881;881;40;841;58.11;4.54
92994;121303;Samorządowy Zespół Szkół w Bobrku|Bobrek|Nadwiślańska 9 |32-661 Bobrek;1539;903;903;39;864;58.67;4.32
92995;121303;Dom Pomocy Społecznej w Bobrku - Nowy Hostel|Bobrek|Księżnej Ogińskiej 2 |32-661 Bobrek;47;20;20;5;15;42.55;25.00
92996;121304;Powiatowy Zespół nr 10 Szkół Mechaniczno-Elektrycznych im. Mikołaja Kopernika w Kętach|Kęty|ul. Żwirki i Wigury 27a |32-650 Kęty;1681;925;925;28;897;55.03;3.03
92997;121304;Zespół Szkolno-Gimnazjalny nr 2 w Kętach|Kęty|ul. Stanisława Wyspiańskiego 1 |32-650 Kęty;1765;1000;1000;20;980;56.66;2.00
92998;121304;Dom Kultury w Kętach|Kęty|ul. Żwirki i Wigury 2a |32-650 Kęty;1127;619;619;19;600;54.92;3.07
92999;121304;Zespół Szkolno-Gimnazjalny nr 2 w Kętach|Kęty|ul. Stanisława Wyspiańskiego 1 |32-650 Kęty;1302;700;700;11;689;53.76;1.57
93000;121304;Powiatowy Zespół nr 11 Szkół Ogólnokształcących im. Stanisława Wyspiańskiego w Kętach|Kęty|ul. Stanisława Wyspiańskiego 2 |32-650 Kęty;1144;681;681;14;667;59.53;2.06
93001;121304;Powiatowy Zespół nr 9 Szkół im. Marii Dąbrowskiej w Kętach|Kęty|ul. Tadeusza Kościuszki 29 |32-650 Kęty;1221;748;748;15;733;61.26;2.01
93002;121304;Przedsiębiorstwo Komunalne "Komax" w Kętach|Kęty|ul. Adama Mickiewicza 8 |32-650 Kęty;1281;635;635;23;612;49.57;3.62
93003;121304;Zespół Szkolno-Gimnazjalny nr 1 w Kętach|Kęty|ul. Jana III Sobieskiego 6 |32-650 Kęty;1276;806;806;12;794;63.17;1.49
93004;121304;Zespół Szkolno-Gimnazjalny nr 1 w Kętach|Kęty|ul. Jana III Sobieskiego 6 |32-650 Kęty;1185;750;750;7;743;63.29;0.93
93005;121304;Powiatowy Zespół nr 9 Szkół im. Marii Dąbrowskiej w Kętach|Kęty|ul. Tadeusza Kościuszki 29 |32-650 Kęty;1023;586;586;14;572;57.28;2.39
93006;121304;Zespół Szkolno-Przedszkolny nr 3 w Kętach|Kęty|ul. Szkolna 3 |32-650 Kęty;2117;1267;1267;26;1241;59.85;2.05
93007;121304;Wiejski Dom Kultury w Bielanach|Bielany|Plac Świętego Macieja 1 |32-651 Nowa Wieś;1518;843;843;33;810;55.53;3.91
93008;121304;Zespół Szkolno-Przedszkolny w Bulowicach|Bulowice|ul. Bielska 59 |32-652 Bulowice;1304;741;741;22;719;56.83;2.97
93009;121304;Zespół Szkolno-Przedszkolny w Bulowicach|Bulowice|ul. Bielska 59 |32-652 Bulowice;1203;737;737;19;718;61.26;2.58
93010;121304;Zespół Szkolno-Przedszkolny w Bulowicach|Bulowice|ul. Bielska 59 |32-652 Bulowice;1293;716;716;25;691;55.38;3.49
93011;121304;Zespół Szkolno-Przedszkolny w Łękach|Łęki|ul. Akacjowa 28 |32-651 Nowa Wieś;1054;561;561;21;540;53.23;3.74
93012;121304;Wiejski Dom Kultury w Malcu|Malec|ul. K. Jędrzejowskiego 16 |32-651 Nowa Wieś;1071;604;604;28;576;56.40;4.64
93013;121304;Zespół Szkolno-Gimnazjalny w Nowej Wsi|Nowa Wieś|ul. Stanisława Konarskiego 4 |32-651 Nowa Wieś;1303;733;733;13;720;56.25;1.77
93014;121304;"Dworek" w Nowej Wsi|Nowa Wieś|ul. Dworska 7 |32-651 Nowa Wieś;1316;733;733;16;717;55.70;2.18
93015;121304;Zespół Szkolno-Przedszkolny w Witkowicach|Witkowice|ul. Beskidzka 98 |32-650 Kęty;1790;948;948;35;913;52.96;3.69
93016;121304;Dom Pomocy Społecznej Braci Albertynów w Bulowicach|Bulowice|Bł. Faustyny 4 |32-652 Bulowice;39;34;34;0;34;87.18;0.00
93017;121305;Sala WDK w Osieku|Osiek|ul. Główna 125 |32-608 Osiek;2079;1106;1106;57;1049;53.20;5.15
93018;121305;Budynek SP ZOZ w Osieku|Osiek|ul. Starowiejska 175 |32-608 Osiek;1689;879;879;56;823;52.04;6.37
93019;121305;Szkoła Podstawowa Nr 2 w Osieku|Osiek|ul. Główna 450 |32-608 Osiek;1625;922;922;40;882;56.74;4.34
93020;121305;Wiejski Dom Kultury w Głębowicach|Głębowice|ul. Oświęcimska 8 |32-608 Osiek;1083;578;578;27;551;53.37;4.67
93021;121306;Szkoła Podstawowa w Babicach|Babice|ul. Różana 23 |32-600 Oświęcim;1509;928;928;19;909;61.50;2.05
93022;121306;LKS "Puls" w Broszkowicach|Broszkowice|ul. Łąkowa 6 |32-600 Oświęcim;492;325;325;10;315;66.06;3.08
93023;121306;Gminny Ośrodek Pomocy Społecznej|Grojec|ul. Beskidzka 100 |32-615 Grojec;764;484;484;8;476;63.35;1.65
93024;121306;Szkoła Podstawowa w Brzezince|Brzezinka|ul. Szkolna 19 |32-600 Oświęcim;1909;1232;1232;27;1205;64.54;2.19
93025;121306;Zespół Szkolno-Przedszkolny w Harmężach|Harmęże|ul. Borowskiego 30 |32-600 Oświęcim;556;317;317;11;306;57.01;3.47
93026;121306;Dom Ludowy w Porębie Wielkiej|Poręba Wielka|ul. Wadowicka 79 |32-600 Oświęcim;1716;1023;1023;46;977;59.62;4.50
93027;121306;Szkoła Podstawowa w Rajsku|Rajsko|ul. Edukacyjna 11 |32-600 Oświęcim;1246;797;797;32;765;63.96;4.02
93028;121306;Szkoła Podstawowa we Włosienicy|Włosienica|ul. Józefa Suskiego 53 |32-642 Włosienica;1258;751;751;18;733;59.70;2.40
93029;121306;Dom Ludowy w Dworach Drugich|Dwory Drugie|ul. Oświęcimska 28 |32-642 Włosienica;270;131;131;6;125;48.52;4.58
93030;121306;Gimnazjum Gminne Nr 2 w Zaborzu|Zaborze|ul. Jezioro 2 |32-600 Oświęcim;1308;876;876;26;850;66.97;2.97
93031;121306;Szkoła Podstawowa w Grojcu|Grojec|ul. Aleja Ogrodowa 2 |32-615 Grojec;988;516;516;19;497;52.23;3.68
93032;121306;Dom Ludowy w Pławach|Pławy|ul. Pławianka 3 |32-600 Oświęcim;308;178;178;5;173;57.79;2.81
93033;121306;Remiza OSP w Stawach Monowskich|Stawy Monowskie|ul. Dogodna 1 |32-642 Włosienica;249;163;163;12;151;65.46;7.36
93034;121306;Szkoła Podstawowa w Grojcu|Grojec|ul. Aleja Ogrodowa 2 |32-615 Grojec;1013;525;525;41;484;51.83;7.81
93035;121306;Przedszkole Samorządowe w Zaborzu|Zaborze|ul. Grojecka 54 |32-600 Oświęcim;1010;664;664;24;640;65.74;3.61
93036;121307;Strażnica Ochotniczej Straży Pożarnej w Polance Wielkiej|Polanka Wielka|ul.Kasztanowa 2 |32-607 Polanka Wielka;1590;865;865;30;835;54.40;3.47
93037;121307;Gminne Centrum Kultury w Polance Wielkiej|Polanka Wielka|ul.Długa 61 |32-607 Polanka Wielka;885;500;500;42;458;56.50;8.40
93038;121307;Publiczne Gimnazjum w Polance Wielkiej|Polanka Wielka|ul. Długa 175 |32-607 Polanka Wielka;939;569;569;23;546;60.60;4.04
93039;121308;Zespół Szkół Podstawowo-Gimnazjalnych w Przeciszowie|Przeciszów|ul.Szkolna 93 |32-641 Przeciszów;2331;1231;1231;37;1194;52.81;3.01
93040;121308;Zespół Szkół Podstawowo-Gimnazjalnych w Przeciszowie-Podlesiu|Przeciszów|ul.Podlesie 92 |32-641 Przeciszów;1297;688;688;22;666;53.05;3.20
93041;121308;Zespół Szkół Podstawowo-Gimnazjalnych w Piotrowicach|Piotrowice|ul.Andrychowska 222 |32-641 Przeciszów;1811;909;909;30;879;50.19;3.30
93042;121309;Zespół Szkół Ogólnokształcących w Zatorze|Zator|ul.Kongresowa 11 |32-640 Zator;1366;756;756;27;729;55.34;3.57
93043;121309;Dom Ludowy w Rudzach|Rudze| 120 |32-640 Zator;368;200;200;5;195;54.35;2.50
93044;121309;Szkoła Podstawowa w Laskowej|Laskowa| 3 |32-640 Zator;601;304;304;10;294;50.58;3.29
93045;121309;Dom Ludowy w Palczowicach|Palczowice| 65 |32-640 Zator;757;431;431;18;413;56.94;4.18
93046;121309;Zespół Szkół Ogólnokształcących w Podolszu|Podolsze|ul.Zatorska 37 |32-640 Zator;1170;654;654;31;623;55.90;4.74
93047;121309;Remiza OSP w Graboszycach|Graboszyce| 195 |32-640 Zator;630;327;327;13;314;51.90;3.98
93048;121309;Szkoła Podstawowa w Łowiczkach|Łowiczki| 1 |32-640 Zator;407;186;186;13;173;45.70;6.99
93049;121309;Szkoła Podstawowa w Grodzisku|Grodzisko| 100 |32-640 Zator;396;222;222;12;210;56.06;5.41
93050;121309;Szkoła Podstawowa w Smolicach|Smolice| 2 |32-640 Zator;534;260;260;17;243;48.69;6.54
93051;121309;Zespół Szkół Ogólnokształcących w Zatorze|Zator|ul.Kongresowa 11 |32-640 Zator;1221;735;735;14;721;60.20;1.90
93052;121309;Dom Pomocy Społecznej w Zatorze ul.Jana Pawła II 3|Zator|Jana Pawła II 3 |32-640 Zator;81;30;30;1;29;37.04;3.33
93053;121401;Zespół Szkół -Biórków Wielki|Biórków Wielki| 107 |32-104 Koniusza;774;332;332;19;313;42.89;5.72
93054;121401;Szkoła Podstawowa - Glewiec|Glewiec| 2 |32-104 Koniusza;789;248;248;8;240;31.43;3.23
93055;121401;Remiza OSP Wronin|Wronin| 20 |32-104 Koniusza;582;199;199;9;190;34.19;4.52
93056;121401;Remiza OSP Wierzbno|Wierzbno| 36 |32-104 Koniusza;1003;344;344;7;337;34.30;2.03
93057;121401;Gminny Ośrodek Kultury Koniusza|Koniusza| 5 |32-104 Koniusza;987;470;470;25;445;47.62;5.32
93058;121401;Szkoła Podstawowa Niegardów|Niegardów| 57 |32-104 Koniusza;944;425;425;20;405;45.02;4.71
93059;121401;Szkoła Podstawowa Rzędowice|Rzędowice| 44 |32-104 Koniusza;396;156;156;7;149;39.39;4.49
93060;121401;Zespół Szkół Piotrkowice Małe|Piotrkowice Małe| 89 |32-104 Koniusza;618;303;303;8;295;49.03;2.64
93061;121401;Gimnazjum Posądza|Posądza| 94 |32-104 Koniusza;860;436;436;17;419;50.70;3.90
93062;121401;Dom Pomocy Społecznej w Łyszkowicach nr 64|Łyszkowice| 64 |32-104 ;71;50;50;5;45;70.42;10.00
93063;121402;Szkoła Muzyczna I stopnia w Koszycach|Koszyce|ul. Curie-Skłodowskiej 5 |32-130 Koszyce;1710;653;653;25;628;38.19;3.83
93064;121402;Szkoła Podstawowa w Książnicach Wielkich|Książnice Wielkie| 37 |32-130 Koszyce;1772;662;662;24;638;37.36;3.63
93065;121402;Centrum Komunikacji Społecznej w Przemykowie|Przemyków| 78 |32-130 Koszyce;1164;407;407;8;399;34.97;1.97
93066;121403;Miejsko-Gminne Centrum Kultury i Promocji w Nowym Brzesku|Nowe Brzesko|ul. Marszałka Józefa Piłsudskiego 17a |32-120 Nowe Brzesko;1374;762;762;20;742;55.46;2.62
93067;121403;Centrum Społeczno-Kulturalne w Hebdowie|Hebdów| 147 |32-120 Nowe Brzesko;620;280;280;10;270;45.16;3.57
93068;121403;Zespół Przedszkolno-Szkolno-Gimnazjalny w Nowym Brzesku|Nowe Brzesko|ul. Krakowska 29 |32-120 Nowe Brzesko;1192;504;504;21;483;42.28;4.17
93069;121403;Centrum Komunikacji Społecznej w Śmiłowicach|Śmiłowice| 16 |32-120 Nowe Brzesko;856;332;332;15;317;38.79;4.52
93070;121403;Środowiskowy Dom Samopomocy w Gruszowie|Gruszów| 28 |32-120 Nowe Brzesko;653;293;293;13;280;44.87;4.44
93071;121404;Zespół Szkół w Pałecznicy|Pałecznica|ul.Św.Jakuba 43 |32-109 Pałecznica;997;510;510;23;487;51.15;4.51
93072;121404;Zespół Szkół w Ibramowicach|Ibramowice| 42 |32-109 Pałecznica;675;353;353;13;340;52.30;3.68
93073;121404;Szkoła Podstawowa w Czuszowie|Czuszów| 74 |32-109 Pałecznica;491;220;220;7;213;44.81;3.18
93074;121404;Szkoła Podstawowa w Nadzowie|Nadzów| 101 |32-109 Pałecznica;341;148;148;4;144;43.40;2.70
93075;121404;Szkoła Podstawowa w Winiarach|Winiary| 63 |32-109 Pałecznica;375;137;137;5;132;36.53;3.65
93076;121405;Zespół Placówek Caritas w Proszowicach|Proszowice|ul. 3 Maja 2 |32-100 Proszowice;919;498;498;10;488;54.19;2.01
93077;121405;Urząd Gminy i Miasta Proszowice|Proszowice|ul. 3 Maja 72 |32-100 Proszowice;1566;820;820;14;806;52.36;1.71
93078;121405;Centrum Kultury i Wypoczynku w Proszowicach|Proszowice|Rynek 18 |32-100 Proszowice;1296;612;612;15;597;47.22;2.45
93079;121405;Gimnazjum w Proszowicach|Proszowice|ul. Mikołaja Kopernika 7 |32-100 Proszowice;1199;626;626;17;609;52.21;2.72
93080;121405;Zespół Szkół w Klimontowie|Klimontów| 180 |32-112 Klimontów;1136;481;481;14;467;42.34;2.91
93081;121405;Remiza OSP w Kościelcu|Kościelec| 130 |32-100 Proszowice;938;415;415;5;410;44.24;1.20
93082;121405;Szkoła Podstawowa w Ostrowie|Ostrów| 1 |32-112 Klimontów;1077;416;416;8;408;38.63;1.92
93083;121405;Budynek Wiejski w Bobinie|Bobin| 26 |32-100 Proszowice;810;371;371;13;358;45.80;3.50
93084;121405;Zespół Szkół w Żębocinie|Żębocin| 65 |32-100 Proszowice;1161;403;403;9;394;34.71;2.23
93085;121405;Szkoła Podstawowa w Stogniowicach|Stogniowice| 25 |32-100 Proszowice;894;388;388;23;365;43.40;5.93
93086;121405;Szkoła Podstawowa w Szczytnikach|Szczytniki| 91a |32-112 Klimontów;690;278;278;8;270;40.29;2.88
93087;121405;Remiza OSP w Opatkowicach|Opatkowice| 37 |32-100 Proszowice;727;356;356;8;348;48.97;2.25
93088;121405;Szkoła Podstawowa nr 1 w Proszowicach|Proszowice|ul. Tadeusza Kościuszki 15 |32-100 Proszowice;826;337;337;11;326;40.80;3.26
93089;121405;Samodzielny Publiczny Zespół Opieki Zdrowotnej w Proszowicach|Proszowice|Mikołaja Kopernika 13 |32-100 Proszowice;115;32;32;2;30;27.83;6.25
93090;121406;Świetlica Urzędu Gminy w Radziemicach|Radziemice| 74 |32-107 Radziemice;1106;465;465;18;447;42.04;3.87
93091;121406;Szkoła Podstawowa w Łętkowicach|Łętkowice| 113 |32-107 Radziemice;796;341;341;12;329;42.84;3.52
93092;121406;Szkoła Podstawowa w Zielenicach|Zielenice| 1 |32-107 Radziemice;486;213;213;15;198;43.83;7.04
93093;121406;Środowiskowy Dom Samopomocy we Wrocimowicach|Wrocimowice| 4 |32-107 Radziemice;381;162;162;10;152;42.52;6.17
93094;121501;Szkoła Podstawowa|Jordanów|ul. Kolejowa 7 |34-240 Jordanów;1543;869;869;25;844;56.32;2.88
93095;121501;Szkoła Podstawowa|Jordanów|ul. Kolejowa 7 |34-240 Jordanów;1331;695;695;25;670;52.22;3.60
93096;121501;Gimnazjum|Jordanów|ul. Konopnickiej 2 |34-240 Jordanów;1303;703;703;21;682;53.95;2.99
93097;121502;Szkoła Podstawowa Nr 2|Sucha Beskidzka|ul. Zasypnicka 1 |34-200 Sucha Beskidzka;2050;1151;1151;47;1104;56.15;4.08
93098;121502;Zespół Szkół im. W. Witosa|Sucha Beskidzka|ul. Spółdzielców 1 |34-200 Sucha Beskidzka;868;498;498;12;486;57.37;2.41
93099;121502;Zespół Szkół Ogólnokształcących|Sucha Beskidzka|ul. Płk. Semika 1 |34-200 Sucha Beskidzka;1015;578;578;17;561;56.95;2.94
93100;121502;Urząd Miejski|Sucha Beskidzka|ul. Mickiewicza 19 |34-200 Sucha Beskidzka;932;492;492;13;479;52.79;2.64
93101;121502;Zespół Szkół im. W. Goetla|Sucha Beskidzka|ul. Kościelna 5 |34-200 Sucha Beskidzka;1631;891;891;30;861;54.63;3.37
93102;121502;Filia Szkoły Podstawowej Nr 2|Sucha Beskidzka|ul. Błądzonka 118 |34-200 Sucha Beskidzka;1046;609;609;27;582;58.22;4.43
93103;121502;Szpital Rejonowy|Sucha Beskidzka|ul. Szpitalna 22 |34-200 Sucha Beskidzka;169;70;70;3;67;41.42;4.29
93104;121503;Dom Wiejski|Bieńkówka| 523 |34-212 Bieńkówka;1669;747;747;24;723;44.76;3.21
93105;121503;Gimnazjum|Budzów| 553 |34-211 Budzów;2094;904;904;43;861;43.17;4.76
93106;121503;Gminny Ośrodek Kultury|Jachówka| 232 |34-211 Budzów;801;429;429;12;417;53.56;2.80
93107;121503;Szkoła Podstawowa|Baczyn| 100 |34-211 Budzów;704;352;352;24;328;50.00;6.82
93108;121503;Szkoła Podstawowa|Palcza| 195 |34-211 Budzów;977;416;416;16;400;42.58;3.85
93109;121503;Szkoła Podstawowa|Zachełmna| 112 |34-211 Budzów;418;171;171;9;162;40.91;5.26
93110;121504;Remiza OSP (sala OSP)|Bystra| 373 |34-235 Bystra;1421;688;688;29;659;48.42;4.22
93111;121504;Remiza OSP (sala OSP)|Bystra| 373 |34-235 Bystra;1050;416;416;23;393;39.62;5.53
93112;121504;Remiza OSP (sala OSP)|Sidzina| 998 |34-236 Sidzina;1377;654;654;31;623;47.49;4.74
93113;121504;Remiza OSP (sala Lasów Ekwiwalentowych)|Sidzina| 998 |34-236 Sidzina;1320;656;656;28;628;49.70;4.27
93114;121505;Zespół Szkół|Łętownia| 286 |34-242 Łętownia;2083;1126;1126;35;1091;54.06;3.11
93115;121505;Zespół Szkół|Naprawa| 378 |34-240 Jordanów;1564;775;775;26;749;49.55;3.35
93116;121505;Zespół Szkół|Osielec| 440 |34-234 Osielec;1167;640;640;27;613;54.84;4.22
93117;121505;Zespół Szkół|Osielec| 440 |34-234 Osielec;1208;622;622;21;601;51.49;3.38
93118;121505;Gminny Ośrodek Kultury|Toporzysko| 250 |34-240 Jordanów;1662;714;714;28;686;42.96;3.92
93119;121505;Zespół Szkół|Wysoka| 42 |34-240 Jordanów;654;342;342;9;333;52.29;2.63
93120;121505;Dom Pomocy Społecznej|Łętownia| 353 |34-242 Łętownia;46;35;35;3;32;76.09;8.57
93121;121506;Szkoła Podstawowa Stowarzyszenia Przyjaciół Szkół Katolickich|Maków Podhalański|ul. Szkolna 3 |34-220 Maków Podhalański;1016;570;570;20;550;56.10;3.51
93122;121506;Zespół Szkół|Maków Podhalański|ul. Wolności 53 |34-220 Maków Podhalański;1903;1056;1056;13;1043;55.49;1.23
93123;121506;Dom Kultury|Maków Podhalański|ul. Kościuszki 3 |34-220 Maków Podhalański;1810;942;942;27;915;52.04;2.87
93124;121506;Zespół Szkół|Białka| 334 |34-220 Maków Podhalański;2041;1055;1055;28;1027;51.69;2.65
93125;121506;Zespół Szkół|Grzechynia| 314 |34-220 Maków Podhalański;1862;943;943;36;907;50.64;3.82
93126;121506;Zespół Szkół|Juszczyn| 268 |34-231 Juszczyn;1970;1036;1036;37;999;52.59;3.57
93127;121506;Szkoła Podstawowa im. Fryderyka Chopina|Kojszówka| 154 |34-231 Juszczyn;538;320;320;13;307;59.48;4.06
93128;121506;Szkoła Podstawowa im. Mieczysława Karłowicza|Wieprzec| 100 |34-231 Juszczyn;546;292;292;13;279;53.48;4.45
93129;121506;Dom Ludowy|Żarnówka| 366 |34-220 Maków Podhalański;1005;591;591;13;578;58.81;2.20
93130;121506;Zakład Długoterminowej Opieki Medycznej|Maków Podhalański|ul. Mickiewicza 7 |34-220 Maków Podhalański;146;45;45;3;42;30.82;6.67
93131;121506;Szpital|Maków Podhalański|Al. Kasztanowa 17 |34-220 Maków Podhalański;94;22;22;4;18;23.40;18.18
93132;121506;Dom Pomocy Społecznej|Maków Podhalański|ul. Żeromskiego 17 |34-220 Maków Podhalański;50;30;30;0;30;60.00;0.00
93133;121507;Zespół Szkół Samorządowych|Krzeszów| 216 |34-206 Krzeszów;1325;665;665;37;628;50.19;5.56
93134;121507;Szkoła Podstawowa|Kuków| 52 |34-206 Krzeszów;699;380;380;12;368;54.36;3.16
93135;121507;Warsztat Terapii Zajęciowej|Kuków| 157 |34-206 Krzeszów;586;300;300;14;286;51.19;4.67
93136;121507;Szkoła Podstawowa Nr 2|Stryszawa| 278B |34-205 Stryszawa;2086;1112;1112;30;1082;53.31;2.70
93137;121507;Gimnazjum Nr 1|Stryszawa| 400A |34-205 Stryszawa;2189;1266;1266;36;1230;57.83;2.84
93138;121507;Gimnazjum Nr 2|Lachowice| 232B |34-232 Lachowice;1687;896;896;40;856;53.11;4.46
93139;121507;Szkoła Podstawowa|Kurów| 101A |34-233 Hucisko;485;232;232;3;229;47.84;1.29
93140;121507;Szkoła Podstawowa|Pewelka| 63 |34-233 Hucisko;499;247;247;7;240;49.50;2.83
93141;121508;Zespół Szkół w Skawicy|Skawica| 278 |34-221 Skawica;1674;791;792;17;774;47.25;2.15
93142;121508;Remiza Ochotniczej Straży Pożarnej w Skawicy Sucha Góra|Skawica| 671 |34-221 Skawica;351;134;134;16;118;38.18;11.94
93143;121508;Szkoła Podstawowa Nr 4 w Zawoi Przysłop|Zawoja| 886 |34-222 Zawoja;262;144;144;10;134;54.96;6.94
93144;121508;Remiza Ochotniczej Straży Pożarnej w Zawoi Dolnej|Zawoja| |34-222 Zawoja;959;512;512;19;493;53.39;3.71
93145;121508;Zespół Szkół w Zawoi Centrum|Zawoja| 1551 |34-222 Zawoja;1671;844;844;49;795;50.51;5.81
93146;121508;Remiza Ochotniczej Straży Pożarnej w Zawoi Wełcza|Zawoja| |34-222 Zawoja;447;239;239;9;230;53.47;3.77
93147;121508;Zespół Szkolno Przedszkolny Zawoja Mosorne|Zawoja| 900 |34-222 Zawoja;706;337;337;9;328;47.73;2.67
93148;121508;Zespół Szkół w Zawoi Wilcznej Szkoła Podstawowa Nr 2|Zawoja| 1570 |34-222 Zawoja;1129;552;552;13;539;48.89;2.36
93149;121509;Szkoła Podstawowa|Marcówka| 120 |34-210 Zembrzyce;534;270;270;29;241;50.56;10.74
93150;121509;Zespół Szkół|Zembrzyce| 490 |34-210 Zembrzyce;1796;938;938;45;893;52.23;4.80
93151;121509;Budynek OSP|Tarnawa Dolna| 190 |34-210 Zembrzyce;1175;599;599;23;576;50.98;3.84
93152;121509;Szkoła Podstawowa|Śleszowice| 166A |34-210 Zembrzyce;687;397;397;24;373;57.79;6.05
93153;121509;Klub Rolnika|Tarnawa Górna| 50 |34-210 Zembrzyce;289;141;141;8;133;48.79;5.67
93154;121601;Centrum Kultury i Promocji Gminy Ciężkowice|Ciężkowice|ul.Rynek 1 |33-190 Ciężkowice;2164;1018;1018;39;979;47.04;3.83
93155;121601;Dom Ludowy w Bruśniku|Bruśnik| 42A |33-192 Bruśnik;1619;700;700;40;660;43.24;5.71
93156;121601;Urząd Gminy Ciężkowice|Ciężkowice|ul.Tysiąclecia 19 |33-190 Ciężkowice;1988;1086;1086;37;1049;54.63;3.41
93157;121601;Zespół Szkół Publicznych w Jastrzębi|Jastrzębia| 1 |33-191 Jastrzębia;1818;876;876;41;835;48.18;4.68
93158;121601;Zespół Szkół Publicznych w Zborowicach|Zborowice| 5A |33-190 Ciężkowice;1349;579;579;33;546;42.92;5.70
93159;121602;Dom Ludowy|Brzozowa| 71 |33-182 Brzozowa;774;325;325;19;306;41.99;5.85
93160;121602;Zespół Szkół|Chojnik| 287 |33-180 Gromnik;1016;515;515;10;505;50.69;1.94
93161;121602;Szkoła Podstawowa|Golanka| 47 |33-180 Gromnik;322;183;183;8;175;56.83;4.37
93162;121602;Dom Ludowy|Gromnik|ul. Jana Pawła II 11 |33-180 Gromnik;1255;704;704;29;675;56.10;4.12
93163;121602;Dom Ludowy|Gromnik|ul. Jana Pawła II 11 |33-180 Gromnik;1434;738;738;33;705;51.46;4.47
93164;121602;Dom Ludowy|Rzepiennik Marciszewski| 144 |33-180 Gromnik;552;235;235;14;221;42.57;5.96
93165;121602;Dom Ludowy|Siemiechów| 282 |33-181 Siemiechów;1472;665;665;24;641;45.18;3.61
93166;121603;Przedszkole|Lisia Góra|ul. Jaracza 1 |33-140 Lisia Góra;1665;876;876;29;847;52.61;3.31
93167;121603;Szkoła Podstawowa|Pawęzów| 66 |33-103 Tarnów;701;395;395;9;386;56.35;2.28
93168;121603;Zespół Gimnazjum, Szkoły Podstawowej i Gminnego Przedszkola|Nowa Jastrząbka| 156 |33-151 Nowa Jastrząbka;943;480;480;17;463;50.90;3.54
93169;121603;Zespół Gimnazjum i Szkoły Podstawowej|Zaczarnie| 25 |33-140 Lisia Góra;1505;694;694;28;666;46.11;4.03
93170;121603;Dom Strażaka|Nowe Żukowice| 48 A |33-151 Nowa Jastrząbka;747;384;384;15;369;51.41;3.91
93171;121603;Zespół Gimnazjum i Szkoły Podstawowej|Stare Żukowice| 132 A |33-151 Nowa Jastrząbka;1420;742;742;23;719;52.25;3.10
93172;121603;Szkoła Podstawowa|Łukowa| 86 A |33-140 Lisia Góra;924;516;516;32;484;55.84;6.20
93173;121603;Szkoła Podstawowa|Breń| 25 |33-140 Lisia Góra;591;324;324;8;316;54.82;2.47
93174;121603;Szkoła Podstawowa|Brzozówka|ul. Tarnowska 36 |33-140 Lisia Góra;968;537;537;12;525;55.48;2.23
93175;121603;Szkoła Podstawowa|Kobierzyn| 61 A |33-140 Lisia Góra;456;224;224;9;215;49.12;4.02
93176;121603;Gminny Ośrodek Kultury|Śmigno| 30 |33-140 Lisia Góra;675;303;303;6;297;44.89;1.98
93177;121603;Przedszkole|Lisia Góra|ul. Jaracza 1 |33-140 Lisia Góra;830;476;476;11;465;57.35;2.31
93178;121604;Budynek Szkoły Podstawowej w Dąbrówce Szczepanowskiej|Dąbrówka Szczepanowska| 184 |33-115 Janowice;426;178;178;13;165;41.78;7.30
93179;121604;Filia Centrum Kultury Sportu i Promocji Gminy Pleśna w Janowicach|Janowice| 128A |33-115 Janowice;943;413;413;25;388;43.80;6.05
93180;121604;Szkoła Podstawowa w Lichwinie|Lichwin| 182A |33-172 Siedliska;923;438;438;20;418;47.45;4.57
93181;121604;Szkoła Podstawowa w Lubince|Lubinka| 12A |33-115 Janowice;301;132;132;6;126;43.85;4.55
93182;121604;Centrum Kultury, Sportu i Promocji Gminy Pleśna|Pleśna| 240 |33-171 Pleśna;915;498;498;35;463;54.43;7.03
93183;121604;Szkoła Podstawowa w Pleśnej|Pleśna| 228 |33-171 Pleśna;1075;584;584;17;567;54.33;2.91
93184;121604;Gimnazjum w Pleśnej|Pleśna| 228A |33-171 Pleśna;894;478;478;9;469;53.47;1.88
93185;121604;Zespół Szkolno Przedszkolny w Rzuchowej|Rzuchowa| 278 |33-114 Rzuchowa;1396;822;822;16;806;58.88;1.95
93186;121604;Szkoła Podstawowa w Rychwałdzie|Rychwałd| 120 |33-171 Pleśna;517;243;243;18;225;47.00;7.41
93187;121604;Szkoła Podstawowa w Szczepanowicach|Szczepanowice| 107 |33-114 Rzuchowa;1214;594;594;27;567;48.93;4.55
93188;121604;Szkoła Podstawowa w Świebodzinie|Świebodzin| 129 |33-114 Rzuchowa;788;385;385;6;379;48.86;1.56
93189;121605;Remiza Ochotniczej Straży Pożarnej w Radłowie|Radłów|Plac Kościuszki 5 |33-130 Radłów;2252;1073;1073;55;1018;47.65;5.13
93190;121605;Zespół Szkoły Podstawowej i Przedszkola w Niwce Niepubliczna Szkoła Podstawowa w Niwce|Niwka| 25 |33-130 Radłów;720;378;378;16;362;52.50;4.23
93191;121605;Wiejski Dom Kultury w Biskupicach Radłowskich|Biskupice Radłowskie|ul. Bohaterów Września 14a |33-130 Radłów;867;356;356;17;339;41.06;4.78
93192;121605;Zespół Szkół w Radłowie|Radłów|ul. Szkolna 1 |33-130 Radłów;809;379;379;13;366;46.85;3.43
93193;121605;Dom Ludowy w Marcinkowicach|Marcinkowice| 92 |33-273 Marcinkowice;976;449;449;22;427;46.00;4.90
93194;121605;Zespół Szkół w Zabawie|Zabawa| 6 |33-133 Wał-Ruda;1268;634;634;36;598;50.00;5.68
93195;121605;Zespół Szkolno-Przedszkolny w Woli Radłowskiej|Wola Radłowska| 67 |33-133 Wał-Ruda;1012;432;432;15;417;42.69;3.47
93196;121605;Dom Opieki "U Wronów" w Zabawie|Zabawa| 100a |33-133 Wał-Ruda;35;23;23;1;22;65.71;4.35
93197;121606;Publiczne Gimnazjum nr 1 w Ryglicach|Ryglice|ul. Tarnowska 25 |33-160 Ryglice;1186;560;560;23;537;47.22;4.11
93198;121606;Dom Kultury w Ryglicach|Ryglice|ul. Ks.Jakuba Wyrwy 2 |33-160 Ryglice;1095;487;487;25;462;44.47;5.13
93199;121606;Szkoła Podstawowa w Bistuszowej|Bistuszowa| 82 |33-160 Ryglice;752;311;311;11;300;41.36;3.54
93200;121606;Remiza Ochotniczej Straży Pożarnej w Joninach|Joniny| 213 |33-160 Ryglice;655;279;279;17;262;42.60;6.09
93201;121606;Remiza Ochotniczej Straży Pożarnej w Kowalowej|Kowalowa| 196 |33-161 Kowalowa;784;310;310;12;298;39.54;3.87
93202;121606;Remiza Ochotniczej Straży Pożarnej w Woli Lubeckiej|Wola Lubecka| 18 |33-162 Lubcza;674;304;304;14;290;45.10;4.61
93203;121606;Zespół Szkolno-Przedszkolny w Zalasowej|Zalasowa|ul. Karpacka 21 |33-159 Zalasowa;1219;638;638;28;610;52.34;4.39
93204;121606;Pałac pod Dębami w Zalasowej|Zalasowa|ul. Kościelna 5 |33-159 Zalasowa;1294;644;644;28;616;49.77;4.35
93205;121606;Zespół Szkół w Lubczy|Lubcza| 51 |33-162 Lubcza;1527;669;669;22;647;43.81;3.29
93206;121607;Remiza Ochotniczej Straży Pożarnej w Olszynach|Olszyny| 552 |33-164 Olszyny;1711;999;999;25;974;58.39;2.50
93207;121607;Szkoła Podstawowa w Rzepienniku Biskupim|Rzepiennik Biskupi| 292 |33-163 Rzepiennik Strzyżewski;961;433;433;7;426;45.06;1.62
93208;121607;Remiza Ochotniczej Straży Pożarnej w Rzepienniku Strzyżewskim|Rzepiennik Strzyżewski| 404 |33-163 Rzepiennik Strzyżewski;1002;480;480;18;462;47.90;3.75
93209;121607;Gminny Ośrodek Kultury w Rzepienniku Suchym|Rzepiennik Suchy| 200 |33-163 Rzepiennik Strzyżewski;508;273;273;16;257;53.74;5.86
93210;121607;Dom Ludowy w Turzy|Turza| 1 |33-167 Turza;945;493;493;13;480;52.17;2.64
93211;121607;Remiza Ochotniczej Straży Pożarnej w Kołkówce|Kołkówka| 59 |33-163 Rzepiennik Strzyżewski;208;94;94;5;89;45.19;5.32
93212;121608;Zespół Szkoły Podstawowej Nr 1 i Gimnazjum w Skrzyszowie|Skrzyszów| 629A |33-156 Skrzyszów;1515;729;729;33;696;48.12;4.53
93213;121608;Zespół Szkoły Podstawowej Nr 1 i Gimnazjum w Skrzyszowie|Skrzyszów| 629A |33-156 Skrzyszów;1463;806;806;22;784;55.09;2.73
93214;121608;Szkoła Podstawowa w Ładnej|Ładna| 98B |33-156 Skrzyszów;1300;755;755;29;726;58.08;3.84
93215;121608;Przedszkole Publiczne w Łękawicy|Łękawica| 281A |33-157 Skrzyszów;1001;530;530;21;509;52.95;3.96
93216;121608;Przedszkole Publiczne w Łękawicy|Łękawica| 281A |33-157 Skrzyszów;756;368;368;17;351;48.68;4.62
93217;121608;Zespół Szkoły Podstawowej i Gimnazjum w Pogórskiej Woli|Pogórska Wola| 77A |33-152 Pogórska Wola;1250;643;643;20;623;51.44;3.11
93218;121608;Zespół Szkoły Podstawowej i Gimnazjum w Pogórskiej Woli|Pogórska Wola| 77A |33-152 Pogórska Wola;1149;537;537;19;518;46.74;3.54
93219;121608;Zespół Szkoły Podstawowej Nr 1 i Gimnazjum w Szynwałdzie|Szynwałd| 11 |33-158 Szynwałd;1239;677;677;13;664;54.64;1.92
93220;121608;Zespół Szkoły Podstawowej Nr 1 i Gimnazjum w Szynwałdzie|Szynwałd| 11 |33-158 Szynwałd;1235;616;616;18;598;49.88;2.92
93221;121609;Szkoła Podstawowa w Błoniu|Błonie| 20 |33-113 Zgłobice;627;385;385;11;374;61.40;2.86
93222;121609;Szkoła Podstawowa w Zgłobicach, Filia w Białej|Biała| 26 |33-102 Tarnów;398;204;204;14;190;51.26;6.86
93223;121609;Niepubliczna Szkoła Podstawowa w Koszycach Małych|Koszyce Małe|ul. Oświatowa 1 |33-111 Koszyce Wielkie;1071;603;603;16;587;56.30;2.65
93224;121609;Zespół Szkół Publicznych w Koszycach Wielkich|Koszyce Wielkie|ul. Szkolna 22 |33-111 Koszyce Wielkie;1051;604;604;18;586;57.47;2.98
93225;121609;Zespół Szkół Publicznych w Koszycach Wielkich|Koszyce Wielkie|ul. Szkolna 22 |33-111 Koszyce Wielkie;1167;647;647;21;626;55.44;3.25
93226;121609;Szkoła Podstawowa w Jodłówce-Wałkach|Jodłówka-Wałki| 54 |33-150 Wola Rzędzińska;955;502;502;22;480;52.57;4.38
93227;121609;Szkoła Podstawowa w Łękawce|Łękawka| 133A |33-112 Tarnowiec;555;276;276;9;267;49.73;3.26
93228;121609;Szkoła Podstawowa w Porębie Radlnej|Poręba Radlna| 119A |33-112 Tarnowiec;605;330;330;15;315;54.55;4.55
93229;121609;Dom Wielofunkcyjny w Radlnej|Radlna| 66 |33-112 Tarnowiec;556;313;313;4;309;56.29;1.28
93230;121609;Przedszkole Niepubliczne w Tarnowcu|Tarnowiec|ul. Tarnowska 79 |33-112 Tarnowiec;1053;627;627;12;615;59.54;1.91
93231;121609;Zespół Szkół Publicznych w Tarnowcu|Tarnowiec|ul. Tarnowska 60 |33-112 Tarnowiec;768;395;395;5;390;51.43;1.27
93232;121609;Szkoła Podstawowa Nr 1 w Woli Rzędzińskiej|Wola Rzędzińska| 435 |33-150 Wola Rzędzińska;918;492;492;8;484;53.59;1.63
93233;121609;Szkoła Podstawowa Nr 1 w Woli Rzędzińskiej|Wola Rzędzińska| 435 |33-150 Wola Rzędzińska;1262;708;708;26;682;56.10;3.67
93234;121609;Szkoła Podstawowa Nr 1 w Woli Rzędzińskiej|Wola Rzędzińska| 435 |33-150 Wola Rzędzińska;1044;542;542;8;534;51.92;1.48
93235;121609;Zespół Szkół Publicznych w Woli Rzędzińskiej|Wola Rzędzińska| 253A |33-150 Wola Rzędzińska;490;263;263;4;259;53.67;1.52
93236;121609;Zespół Szkół Publicznych w Woli Rzędzińskiej|Wola Rzędzińska| 253A |33-150 Wola Rzędzińska;959;541;541;23;518;56.41;4.25
93237;121609;Szkoła Podstawowa w Zawadzie|Zawada| 87A |33-112 Tarnowiec;843;532;532;9;523;63.11;1.69
93238;121609;Szkoła Podstawowa w Zbylitowskiej Górze|Zbylitowska Góra|ul. Św. Floriana 1 |33-113 Zgłobice;1063;647;647;14;633;60.87;2.16
93239;121609;Szkoła Podstawowa w Zbylitowskiej Górze|Zbylitowska Góra|ul. Św. Floriana 1 |33-113 Zgłobice;1056;629;629;10;619;59.56;1.59
93240;121609;Szkoła Podstawowa w Zgłobicach|Zgłobice|ul. Zgłobicka 4 |33-113 Zgłobice;1277;735;736;13;722;57.56;1.77
93241;121609;Szkoła Podstawowa w Zgłobicach|Zgłobice|ul. Zgłobicka 4 |33-113 Zgłobice;978;547;547;15;532;55.93;2.74
93242;121609;Niepubliczna Szkoła Podstawowa w Koszycach Małych|Koszyce Małe|ul. Oświatowa 1 |33-111 Koszyce Wielkie;442;256;256;3;253;57.92;1.17
93243;121609;Dom Ludowy w Nowodworzu|Nowodworze| 70A |33-112 Tarnowiec;557;348;348;10;338;62.48;2.87
93244;121609;Dom Pomocy Społecznej w Nowodworzu|Nowodworze| 64 |33-112 Tarnowiec;63;59;59;6;53;93.65;10.17
93245;121610;Publiczna Szkoła Podstawowa|Buchcice| 41 |33-170 Tuchów;530;249;249;17;232;46.98;6.83
93246;121610;Dom Kultury|Burzyn| 1 |33-170 Tuchów;1034;530;530;20;510;51.26;3.77
93247;121610;Szkoła Podstawowa|Dąbrówka Tuchowska| 145A |33-170 Tuchów;650;357;357;4;353;54.92;1.12
93248;121610;Dom wielofunkcyjny "Jodełka"|Jodłówka Tuchowska| 75 |33-173 Jodłówka Tuchowska;1080;537;537;19;518;49.72;3.54
93249;121610;Zespół Szkół|Karwodrza| 139A |33-170 Tuchów;669;329;329;16;313;49.18;4.86
93250;121610;Remiza OSP|Lubaszowa| 7 |33-172 Siedliska;710;361;361;13;348;50.85;3.60
93251;121610;Szkoła Podstawowa|Piotrkowice| 7 |33-170 Tuchów;758;329;329;14;315;43.40;4.26
93252;121610;Dom Kultury|Siedliska| 229 |33-172 Siedliska;1761;962;962;35;927;54.63;3.64
93253;121610;Niepubliczna Szkoła Podstawowa|Trzemesna| 100 |33-170 Tuchów;343;126;126;7;119;36.73;5.56
93254;121610;Szkoła Podstawowa|Zabłędza| 38A |33-170 Tuchów;649;300;300;10;290;46.22;3.33
93255;121610;Publiczna Szkoła Podstawowa|Meszna Opacka| 110 |33-170 Tuchów;415;173;173;12;161;41.69;6.94
93256;121610;Szkoła Podstawowa|Łowczów| 96 |33-170 Tuchów;365;168;168;8;160;46.03;4.76
93257;121610;Klasztor oo. Redemptorystów, Sala "Betania"|Tuchów|ul. Wysoka 1 |33-170 Tuchów;1892;1080;1080;24;1056;57.08;2.22
93258;121610;Dom Kultury w Tuchowie (wejście od strony wschodniej)|Tuchów|ul. Chopina 10 |33-170 Tuchów;1204;729;729;13;716;60.55;1.78
93259;121610;Dom Kultury w Tuchowie (wejście od strony północnej)|Tuchów|ul. Chopina 10 |33-170 Tuchów;2136;1193;1193;24;1169;55.85;2.01
93260;121610;Centrum Zdrowia Tuchów Sp. z o.o|Tuchów|ul. Szpitalna 1 |33-170 Tuchów;25;9;9;1;8;36.00;11.11
93261;121611;Dom Ludowy|Bobrowniki Małe| 223 |33-122 Wierzchosławice;694;387;387;12;375;55.76;3.10
93262;121611;Szkoła Podstawowa - Filia im. Św. Jadwigi Królowej Polski|Bogumiłowice| 275 |33-121 Bogumiłowice;982;584;584;15;569;59.47;2.57
93263;121611;Szkoła Podstawowa im. Ks. Jana Twardowskiego|Ostrów| 139 |33-122 Wierzchosławice;1147;666;666;31;635;58.06;4.65
93264;121611;Szkoła Podstawowa im. Wincentego Witosa|Rudka| 163 |33-122 Wierzchosławice;1045;560;560;30;530;53.59;5.36
93265;121611;Szkoła Podstawowa im. Tadeusza Kościuszki|Łętowice| 371 |33-121 Bogumiłowice;1269;629;629;24;605;49.57;3.82
93266;121611;Szkoła Podstawowa im. Mikołaja Kopernika|Mikołajowice| 168 |33-121 Bogumiłowice;762;455;455;16;439;59.71;3.52
93267;121611;Szkoła Podstawowa im. 100 - lecia Ruchu Ludowego|Wierzchosławice| 713 |33-122 Wierzchosławice;1317;706;706;26;680;53.61;3.68
93268;121611;Szkoła Podstawowa im. 100 - lecia Ruchu Ludowego|Wierzchosławice| 713 |33-122 Wierzchosławice;1333;685;685;21;664;51.39;3.07
93269;121612;Dom Ludowy w Jadownikach Mokrych|Jadowniki Mokre| 339 |33-270 Wietrzychowice;781;339;339;15;324;43.41;4.42
93270;121612;Dom Ludowy w Demblinie|Demblin| 96 |33-270 Wietrzychowice;399;179;179;14;165;44.86;7.82
93271;121612;Dom Ludowy w Wietrzychowicach|Wietrzychowice| 19 |33-270 Wietrzychowice;1641;680;680;42;638;41.44;6.18
93272;121612;Dom Ludowy w Woli Rogowskiej|Wola Rogowska| 160 |33-270 Wietrzychowice;375;185;185;4;181;49.33;2.16
93273;121612;Dom Pomocy Społecznej w Wietrzychowicach|Wietrzychowice| 9 |33-270 Wietrzychowice;72;37;37;7;30;51.39;18.92
93274;121613;Zespół Szkół Licealnych i Technicznych|Wojnicz|ul. Jagiellońska 17 |32-830 Wojnicz;1350;796;796;15;781;58.96;1.88
93275;121613;Publiczne Gimnazjum|Wojnicz|ul. Szkolna 10 |32-830 Wojnicz;817;440;440;5;435;53.86;1.14
93276;121613;Szkoła Podstawowa|Wojnicz|ul. Rynek 30 |32-830 Wojnicz;897;497;497;21;476;55.41;4.23
93277;121613;Szkoła Podstawowa|Wojnicz|ul. Rynek 30 |32-830 Wojnicz;1518;783;783;21;762;51.58;2.68
93278;121613;Remiza OSP|Więckowice| 2 |32-830 Wojnicz;705;377;377;14;363;53.48;3.71
93279;121613;Zespół Szkoły Podstawowej i Gimnazjum|Biadoliny Radłowskie| 135 |32-828 Biadoliny Szlacheckie;955;446;446;21;425;46.70;4.71
93280;121613;Zespół Szkoły Podstawowej i Gimnazjum|Grabno| 285 |32-830 Wojnicz;1025;469;469;17;452;45.76;3.62
93281;121613;Zespół Szkolno - Przedszkolny|Wielka Wieś| 210 |32-830 Wojnicz;1042;515;515;23;492;49.42;4.47
93282;121613;Zespół Szkolno - Przedszkolny|Olszyny| 57 |32-831 Olszyny;1126;510;510;21;489;45.29;4.12
93283;121613;Szkoła Podstawowa|Łopoń| 105 |32-830 Wojnicz;664;337;337;14;323;50.75;4.15
93284;121613;Szkoła Podstawowa|Milówka| 1 |32-830 Wojnicz;460;215;215;5;210;46.74;2.33
93285;121614;Ratusz w Zakliczynie|Zakliczyn|Rynek 1 |32-840 Zakliczyn;1851;1011;1011;23;988;54.62;2.27
93286;121614;Zespół Szkoły Podstawowej i Gimnazjum|Zakliczyn|ul. Jacka Malczewskiego 56 |32-840 Zakliczyn;1998;1054;1054;35;1019;52.75;3.32
93287;121614;Zespół Szkolno-Przedszkolny|Paleśnica| 115 |32-842 Paleśnica;1298;542;542;27;515;41.76;4.98
93288;121614;Zespół Szkoły Podstawowej i Przedszkola|Filipowice| 125 |32-841 Filipowice;736;325;325;14;311;44.16;4.31
93289;121614;Szkoła Podstawowa|Stróże| 88 |32-840 Zakliczyn;1134;575;575;39;536;50.71;6.78
93290;121614;Szkoła Filialna|Charzewice| 95 |32-840 Zakliczyn;566;288;288;15;273;50.88;5.21
93291;121614;Zespół Szkoły Podstawowej i Przedszkola|Gwoździec| 199 |32-855 Gwoździec;753;344;344;12;332;45.68;3.49
93292;121614;Niepubliczna Szkoła Podstawowa we Wróblowicach|Wróblowice| 142 |32-840 Zakliczyn;545;247;247;17;230;45.32;6.88
93293;121614;Świetlica Wiejska w Wesołowie|Wesołów| 39 |32-840 Zakliczyn;697;385;385;26;359;55.24;6.75
93294;121614;Dom Pomocy Społecznej w Stróżach|Stróże| 1 |32-840 Zakliczyn;57;48;48;5;43;84.21;10.42
93295;121614;Dom Pogodnej Jesieni w Zakliczynie|Zakliczyn|Grabina 11 |32-840 Zakliczyn;53;19;19;3;16;35.85;15.79
93296;121615;Urząd Miejski w Żabnie - sala ślubów|Żabno|ul. Władysława Jagiełły 1 |33-240 Żabno;1788;931;931;37;894;52.07;3.97
93297;121615;Urząd Miejski w Żabnie - sala USC|Żabno|ul. Władysława Jagiełły 1 |33-240 Żabno;1833;961;961;23;938;52.43;2.39
93298;121615;Gimnazjum Publiczne|Łęg Tarnowski|ul. Tarnowska 158 |33-131 Łęg Tarnowski;1005;535;535;14;521;53.23;2.62
93299;121615;Budynek KOS Łęg Tarnowski|Łęg Tarnowski|ul. Witosa 187A |33-131 Łęg Tarnowski;2163;1077;1077;45;1032;49.79;4.18
93300;121615;Szkoła Podstawowa|Otfinów| 58 |33-250 Otfinów;2115;863;863;22;841;40.80;2.55
93301;121615;Szkoła Podstawowa|Ilkowice|ul. Rudno 195 |33-131 Łęg Tarnowski;1067;600;600;16;584;56.23;2.67
93302;121615;Szkoła Podstawowa|Odporyszów|ul. Źwiernik 41 |33-240 Żabno;1704;831;835;28;803;48.77;3.37
93303;121615;Dom Ludowy|Czyżów| 28 |33-250 Otfinów;1284;538;538;27;511;41.90;5.02
93304;121615;Szkoła Podstawowa|Niedomice|ul. Szkolna 2 |33-132 Niedomice;1519;727;727;29;698;47.86;3.99
93305;121615;Szkoła Podstawowa|Bobrowniki Wielkie|ul. Długa 63 |33-131 Łęg Tarnowski;615;332;332;8;324;53.98;2.41
93306;121615;Dom Pomocy Społecznej w Sieradzy|Sieradza| 208 |33-240 Żabno;34;33;33;2;31;97.06;6.06
93307;121616;Urząd Gminy Szerzyny|Szerzyny| 521 |38-246 Szerzyny;1817;883;883;48;835;48.60;5.44
93308;121616;Wiejski Dom Kultury|Ołpiny| 86 |38-247 Ołpiny;1882;1016;1016;35;981;53.99;3.44
93309;121616;Wiejski Dom Kultury|Czermna| 119 |38-245 Czermna;1372;490;490;27;463;35.71;5.51
93310;121616;Remiza Ochotniczej Straży Pożarnej|Żurowa| 247 |38-247 Ołpiny;830;468;468;4;464;56.39;0.85
93311;121616;Dom Strażaka|Swoszowa| 150 |38-246 Szerzyny;476;171;171;7;164;35.92;4.09
93312;121701;ZCE im. H. Modrzejewskiej|Zakopane|ul. Kasprusie 35A |34-500 Zakopane;1290;775;775;12;763;60.08;1.55
93313;121701;Biuro Promocji Zakopanego|Zakopane|ul. Kościeliska 7 |34-500 Zakopane;1185;702;702;16;686;59.24;2.28
93314;121701;Szkoła Podstawowa Nr 2|Zakopane|ul. Skibówki 2D |34-500 Zakopane;1061;544;544;6;538;51.27;1.10
93315;121701;D.W. "APENA"|Zakopane|Osiedle Krzeptówki 87 |34-500 Zakopane;1179;625;625;8;617;53.01;1.28
93316;121701;Czytelnia Miejskiej Biblioteki Publicznej im. S. Żeromskiego|Zakopane|ul. Łukaszówki 4A |34-500 Zakopane;1152;622;622;17;605;53.99;2.73
93317;121701;Zespół Szkół Ogólnokształcących|Zakopane|ul. Słoneczna 1 |34-500 Zakopane;915;576;576;13;563;62.95;2.26
93318;121701;Szkoła Podstawowa Nr 5|Zakopane|ul. Chramcówki 27 |34-500 Zakopane;1750;961;961;22;939;54.91;2.29
93319;121701;Gimnazjum Nr 1|Zakopane|ul. Nowotarska 42 |34-500 Zakopane;1371;691;691;18;673;50.40;2.60
93320;121701;Szkoła Podstawowa Nr 3|Zakopane|ul. Karłowicza 6 |34-500 Zakopane;1328;831;831;16;815;62.58;1.93
93321;121701;Spółdzielnia Mieszkaniowa "Pardałówka"|Zakopane|Osiedle Pardałówka 1 5A|34-500 Zakopane;1040;558;558;12;546;53.65;2.15
93322;121701;Szkoła Podstawowa Nr 7|Zakopane|ul. Cyrhla 57 |34-500 Zakopane;851;372;372;13;359;43.71;3.49
93323;121701;Szkoła Podstawowa Nr 9|Zakopane|ul. Harenda 21 |34-500 Zakopane;1360;687;687;20;667;50.51;2.91
93324;121701;Szkoła Podstawowa Nr 4|Zakopane|ul. Olcza Janosówka 15B |34-500 Zakopane;1458;721;721;21;700;49.45;2.91
93325;121701;Gimnazjum Nr 2|Zakopane|ul. Sienkiewicza 27 |34-500 Zakopane;1022;606;606;10;596;59.30;1.65
93326;121701;Tatrzański Park Narodowy|Zakopane|ul. Chałubińskiego 42 |34-500 Zakopane;1149;668;668;9;659;58.14;1.35
93327;121701;Przedszkole Nr 9|Zakopane|ul. Sabały 10 |34-500 Zakopane;865;507;507;7;500;58.61;1.38
93328;121701;Zespół Szkół Hotelarsko-Turystycznych|Zakopane|ul. Partyzantów 1 |34-500 Zakopane;990;589;589;3;586;59.49;0.51
93329;121701;Szkoła Podstawowa Nr 1|Zakopane|ul. Orkana 6 |34-500 Zakopane;999;576;576;12;564;57.66;2.08
93330;121701;Gimnazjum Nr 1|Zakopane|ul. Nowotarska 42 |34-500 Zakopane;1375;657;657;9;648;47.78;1.37
93331;121701;Szpital Powiatowy im. dr T. Chałubińskiego|Zakopane|ul. Kamieniec 10 |34-500 Zakopane;63;30;30;3;27;47.62;10.00
93332;121701;Szpital Specjalistyczny Chorób Płuc im. dr O. Sokołowskiego|Zakopane|ul. Gładkie 1 |34-500 Zakopane;81;37;37;0;37;45.68;0.00
93333;121701;Wojewódzki Szpital Rehabilitacyjny im. dr S. Jasińskiego|Zakopane|ul. Ciągłówka 9 |34-500 Zakopane;163;108;108;8;100;66.26;7.41
93334;121701;Uniwersytecki Szpital Ortopedyczno-Rehabilitacyjny|Zakopane|ul. Balzera 15 |34-500 Zakopane;89;56;56;1;55;62.92;1.79
93335;121701;Dom Pomocy Społecznej im. Jana Pawła II|Zakopane|ul. Szpitalna 21 |34-500 Zakopane;68;26;26;4;22;38.24;15.38
93336;121702;Zespół Szkoły Podstawowej i Gimnazjum Nr 1 (sala nr 1)|Biały Dunajec|ul. Jana Pawła II 184A |34-425 Biały Dunajec;768;298;298;8;290;38.80;2.68
93337;121702;Zespół Szkoły Podstawowej i Gimnazjum Nr 1 (sala nr 2)|Biały Dunajec|ul. Jana Pawła II 184A |34-425 Biały Dunajec;1138;467;467;11;456;41.04;2.36
93338;121702;Zespół Szkoły Podstawowej i Gimnazjum Nr 2 (sala nr 1)|Biały Dunajec|ul. Miłośników Podhala 23 |34-425 Biały Dunajec;721;330;330;11;319;45.77;3.33
93339;121702;Zespół Szkoły Podstawowej i Gimnazjum Nr 2 (sala nr 2)|Biały Dunajec|ul. Miłośników Podhala 23 |34-425 Biały Dunajec;1081;502;502;18;484;46.44;3.59
93340;121702;Szkoła Podstawowa|Gliczarów Dolny| 70 |34-425 Biały Dunajec;420;184;184;6;178;43.81;3.26
93341;121702;Zespół Szkoły Podstawowej i Gimnazjum|Gliczarów Górny| 101 |34-425 Biały Dunajec;637;295;295;6;289;46.31;2.03
93342;121702;Remiza OSP|Leszczyny| 39 |34-425 Biały Dunajec;309;131;131;1;130;42.39;0.76
93343;121702;Zespół Szkoły Podstawowej i Gimnazjum|Sierockie| 90B |34-425 Biały Dunajec;438;170;170;3;167;38.81;1.76
93344;121703;Zespół Szkół|Bukowina Tatrzańska|ul. Kościuszki 11 |34-530 Bukowina Tatrzańska;1439;852;852;34;818;59.21;3.99
93345;121703;Zespół Szkół|Bukowina Tatrzańska|ul. Kościuszki 11 |34-530 Bukowina Tatrzańska;985;571;571;9;562;57.97;1.58
93346;121703;Zespół Szkół|Białka Tatrzańska|ul. Środkowa 184 |34-405 Białka Tatrzańska;1772;902;902;19;883;50.90;2.11
93347;121703;Szkoła Podstawowa|Brzegi|ul. Halna 58 |34-532 Jurgów;584;262;262;7;255;44.86;2.67
93348;121703;Szkoła Podstawowa|Czarna Góra|ul. Nadwodnia 140 |34-532 Jurgów;762;311;311;13;298;40.81;4.18
93349;121703;Szkoła Podstawowa|Czarna Góra|ul. Zagóra 149 |34-532 Jurgów;566;204;204;10;194;36.04;4.90
93350;121703;Gimnazjum|Leśnica|ul. Polna 44 |34-405 Leśnica;1458;573;573;17;556;39.30;2.97
93351;121703;"Śpisko Izba" nad sklepem GS|Jurgów| 15 |34-532 Jurgów;719;437;437;11;426;60.78;2.52
93352;121703;Gimnazjum|Leśnica|ul. Polna 44 |34-406 Leśnica;1301;529;529;12;517;40.66;2.27
93353;121703;Szkoła Podstawowa|Rzepiska|ul. Potok Grocholów 8 |34-532 Jurgów;578;243;243;14;229;42.04;5.76
93354;121704;Zespół Szkół|Kościelisko|ul. Szeligówka 11 |34-511 Kościelisko;1794;973;973;32;941;54.24;3.29
93355;121704;Zespół Szkół|Kościelisko|ul. Szeligówka 11 |34-511 Kościelisko;1746;846;846;17;829;48.45;2.01
93356;121704;Zespół Szkół|Dzianisz| 201 |34-514 Dzianisz;1752;699;699;29;670;39.90;4.15
93357;121704;Zespół Szkół|Witów| 119 |34-512 Witów;1361;590;590;12;578;43.35;2.03
93358;121705;Gminny Ośrodek Kultury|Poronin|ul. Józefa Piłsudskiego 2 |34-520 Poronin;1646;789;789;24;765;47.93;3.04
93359;121705;Urząd Gminy|Poronin|ul. Józefa Piłsudskiego 5 |34-520 Poronin;1185;543;543;16;527;45.82;2.95
93360;121705;Szkoła Podstawowa|Małe Ciche| 22 |34-531 Murzasichle;393;201;201;5;196;51.15;2.49
93361;121705;Zespół Szkół - Szkoła Podstawowa i Gimnazjum|Murzasichle|ul. Sądelska 31 |34-531 Murzasichle;1103;538;538;14;524;48.78;2.60
93362;121705;Szkoła Podstawowa|Suche| 115A |34-520 Poronin;971;409;409;12;397;42.12;2.93
93363;121705;Zespół Szkół - Szkoła Podstawowa i Gimnazjum|Ząb| 6 |34-521 Ząb;1913;802;802;35;767;41.92;4.36
93364;121705;Zespół Szkół - Szkoła Podstawowa i Gimnazjum|Nowe Bystre| 61 |34-521 Ząb;1017;394;394;10;384;38.74;2.54
93365;121705;Szkoła Podstawowa w Stasikówce|Poronin|ul. Stasikówka 65 |34-520 Poronin;465;218;218;8;210;46.88;3.67
93366;121801;Andrychów, Urząd Miejski|Andrychów|ul. Rynek 16 |34-120 Andrychów;1832;1047;1047;22;1025;57.15;2.10
93367;121801;Andrychów, Gimnazjum Nr 1|Andrychów|ul. Daszyńskiego 14 |34-120 Andrychów;1766;1005;1005;22;983;56.91;2.19
93368;121801;Andrychów, Remiza OSP|Andrychów|ul. Rynek 16a |34-120 Andrychów;1790;1084;1084;19;1065;60.56;1.75
93369;121801;Andrychów, Przychodnia NZOZ "Medican" Sp. z o.o.|Andrychów|ul. Krakowska 91 |34-120 Andrychów;1743;1064;1064;32;1032;61.04;3.01
93370;121801;Andrychów, Miejski Dom Kultury|Andrychów|ul. Szewska 7 |34-120 Andrychów;1743;1028;1028;19;1009;58.98;1.85
93371;121801;Andrychów, Małopolski Inkubator Przedsiębiorczości|Andrychów|ul. Starowiejska 22b |34-120 Andrychów;1817;859;859;28;831;47.28;3.26
93372;121801;Andrychów, Szkoła Podstawowa Nr 4|Andrychów|ul. Włókniarzy 10a |34-120 Andrychów;1653;935;935;16;919;56.56;1.71
93373;121801;Andrychów, Klub Osiedlowy ASM|Andrychów|ul. Stanisława Lenartowicza 7 |34-120 Andrychów;1527;862;862;22;840;56.45;2.55
93374;121801;Andrychów, Gimnazjium Nr 2|Andrychów|ul. Stanisława Lenartowicza 26 |34-120 Andrychów;1399;811;811;11;800;57.97;1.36
93375;121801;Andrychów, Przedszkole Nr 3|Andrychów|ul. Stanisława Lenartowicza 36 |34-120 Andrychów;1504;848;848;26;822;56.38;3.07
93376;121801;Roczyny, Zespół Szkół Samorządowych, Sala lekcyjna|Roczyny|ul. Szkolna 10 |34-120 Andrychów;1622;976;976;31;945;60.17;3.18
93377;121801;Roczyny, Zespół Szkół Samorządowych, Stołówka|Roczyny|ul. Szkolna 10 |34-120 Andrychów;1529;936;936;30;906;61.22;3.21
93378;121801;Sułkowice-Łęg, Zespół Szkół Samorządowych|Sułkowice|ul. Centralna 2 |34-120 Andrychów;1891;1069;1069;31;1038;56.53;2.90
93379;121801;Sułkowice-Łęg, Remiza OSP|Sułkowice|ul. Beskidzka 124a |34-120 Andrychów;1674;1006;1006;31;975;60.10;3.08
93380;121801;Sułkowice-Bolęcina, Zespół Szkół Samorządowych|Sułkowice|ul. Racławicka 188 |34-125 Sułkowice;1720;909;909;31;878;52.85;3.41
93381;121801;Targanice, Zespół Szkół Samorządowych, Mała sala gimnastyczna|Targanice|ul. Beskidzka 46 |34-120 Andrychów;1349;751;751;33;718;55.67;4.39
93382;121801;Targanice, Zespół Szkół Samorządowych, Świetlica|Targanice|ul. Beskidzka 46 |34-120 Andrychów;1116;614;614;17;597;55.02;2.77
93383;121801;Rzyki, Świetlica CKiW|Rzyki|os. Młocki Dolne 72 |34-125 Sułkowice;1209;613;613;36;577;50.70;5.87
93384;121801;Rzyki, Zespół Szkół Samorządowych|Rzyki|os. Szczęśniaki 1 |34-125 Sułkowice;1262;655;655;27;628;51.90;4.12
93385;121801;Zagórnik, Zespół Szkół Samorządowych|Zagórnik|ul. Szkolna 12 |34-120 Andrychów;1791;1002;1002;38;964;55.95;3.79
93386;121801;Inwałd, Zespół Szkół Samorządowych, Stary Budynek|Inwałd|ul. Wadowicka 79 |34-120 Andrychów;1323;783;783;31;752;59.18;3.96
93387;121801;Inwałd, Zespół Szkół Samorządowych, Nowy Budynek|Inwałd|ul. Wadowicka 79 |34-120 Andrychów;1311;731;731;20;711;55.76;2.74
93388;121801;Andrychów, Wojewódzki Szpital Psychiatryczny|Andrychów|Dąbrowskiego 19 |34-120 Andrychów;216;67;67;9;58;31.02;13.43
93389;121802;Zespół Szkolno-Przedszkolny w Brzeźnicy|Brzeźnica|Adama Gorczyńskiego 1 |34-114 Brzeźnica;1356;687;687;23;664;50.66;3.35
93390;121802;Szkoła Podstawowa w Marcyporębie|Marcyporęba| 81 |34-114 Brzeźnica;1391;663;663;21;642;47.66;3.17
93391;121802;Zespół Szkolno-Przedszkolny w Tłuczani|Tłuczań| 157A |34-114 Brzeźnica;1104;501;501;15;486;45.38;2.99
93392;121802;Szkoła Podstawowa w Paszkówce|Paszkówka| 143 |34-113 Paszkówka;1177;535;535;25;510;45.45;4.67
93393;121802;Zespół Szkół w Łączanach|Łączany| 396 |34-115 Ryczów;1300;638;638;32;606;49.08;5.02
93394;121802;Szkoła Podstawowa w Sosnowicach|Sosnowice| 107 |34-113 Paszkówka;907;389;389;12;377;42.89;3.08
93395;121802;Szkoła Filialna w Chrząstowicach|Chrząstowice| 34 |34-114 Brzeźnica;764;370;370;20;350;48.43;5.41
93396;121803;Budynek Wielofunkcyjny w Kalwarii Zebrzydowskiej|Kalwaria Zebrzydowska|ul. Mickiewicza 4 |34-130 Kalwaria Zebrzydowska;1872;1174;1174;27;1147;62.71;2.30
93397;121803;Biblioteka Publiczna w Kalwarii Zebrzydowskiej|Kalwaria Zebrzydowska|al. Jana Pawła II 24 |34-130 Kalwaria Zebrzydowska;1794;983;983;12;971;54.79;1.22
93398;121803;Zespół Szkół w Barwałdzie Górnym|Barwałd Górny| 213 |34-130 Kalwaria Zebrzydowska;1111;516;516;24;492;46.44;4.65
93399;121803;Zespół Szkół w Barwałdzie Średnim|Barwałd Średni| 70 |34-124 Klecza Górna;1093;454;454;12;442;41.54;2.64
93400;121803;Zespół Szkół w Brodach|Brody| 479 |34-130 Kalwaria Zebrzydowska;1003;535;535;19;516;53.34;3.55
93401;121803;Zespół Szkół w Brodach|Brody| 479 |34-130 Kalwaria Zebrzydowska;1093;530;530;17;513;48.49;3.21
93402;121803;Remiza Ochotniczej Straży Pożarnej w Bugaju, Bugaj|Bugaj| |34-130 Kalwaria Zebrzydowska;380;204;204;6;198;53.68;2.94
93403;121803;Zespoł Szkół w Leńczach|Leńcze| 276 |34-142 Leńcze;1182;604;604;28;576;51.10;4.64
93404;121803;Zespoł Szkół w Przytkowicach|Przytkowice| 542 |34-141 Przytkowice;2088;951;951;31;920;45.55;3.26
93405;121803;Zespół Szkół w Stanisławiu Dolnym|Stanisław Dolny| 256 |34-130 Kalwaria Zebrzydowska;1298;673;673;20;653;51.85;2.97
93406;121803;Zespół Szkolno-Przedszkolny w Stanisławiu Dolnym - Dolany|Stanisław Dolny, Dolany| 73 |34-130 Kalwaria Zebrzydowska;820;431;431;14;417;52.56;3.25
93407;121803;Zespół Szkół w Zebrzydowicach|Zebrzydowice| 193 |34-130 Kalwaria Zebrzydowska;1176;639;639;23;616;54.34;3.60
93408;121803;Szkoła Podstawowa w Zarzycach Wielkich|Zarzyce Wielkie| 56 |34-142 Leńcze;450;238;238;7;231;52.89;2.94
93409;121803;Świetlica Wiejska w Zarzycach Małych, Zarzyce Małe|Zarzyce Małe| |34-142 Leńcze;93;43;43;2;41;46.24;4.65
93410;121803;Zespół Szkół w Leńczach, filia w Podolanach|Podolany| 21 |34-142 Leńcze;305;126;126;8;118;41.31;6.35
93411;121803;Dom Pomocy Społecznej Zakonu Bonifratrów w Zebrzydowicach|Zebrzydowice| 1 |34-130 Kalwaria Zebrzydowska;35;18;18;0;18;51.43;0.00
93412;121804;Gminny Osrodek Kultury w Lanckoronie|Lanckorona| 473 |34-143 Lanckorona;1638;803;803;35;768;49.02;4.36
93413;121804;Zespół Szkół w Izdebniku|Izdebnik| 219 |34-144 Izdebnik;1761;794;794;40;754;45.09;5.04
93414;121804;Zespół Szkół w Skawinkach|Skawinki| 220 |34-143 Lanckorona;823;364;364;19;345;44.23;5.22
93415;121804;Dom Kultury w Jastrzębi|Jastrzębia| 53 |34-143 Lanckorona;526;243;243;15;228;46.20;6.17
93416;121805;Szkoła Podstawowa w Mucharzu|Mucharz| 238 |34-106 Mucharz;855;490;490;9;481;57.31;1.84
93417;121805;Dom Kultury w Świnnej Porębie|Świnna Poręba| 111 |34-106 Mucharz;714;402;402;13;389;56.30;3.23
93418;121805;Świetlica w budynku komunalnym w Skawcach|Skawce| 191 |34-106 Mucharz;327;201;201;2;199;61.47;1.00
93419;121805;Wiejski Dom Kultury w Kozińcu|Koziniec| 218 |34-106 Mucharz;537;263;263;9;254;48.98;3.42
93420;121805;Dom Strażaka w Jaszczurowej|Jaszczurowa| 351 |34-106 Mucharz;730;366;366;10;356;50.14;2.73
93421;121806;Zespół Szkolno-Przedszkolny w Bachowicach|Bachowice|ul. Księdza Gołby 1 |34-116 Spytkowice;1755;907;907;33;874;51.68;3.64
93422;121806;Zespół Szkolno-Przedszkolny w Ryczowie|Ryczów|ul. Szkolna 18 |34-115 Ryczów;2114;1045;1045;44;1001;49.43;4.21
93423;121806;Dom Wiejski w Miejscu|Miejsce|ul. Floriana 62 |34-116 Spytkowice;533;297;297;20;277;55.72;6.73
93424;121806;Szkoła Podstawowa Nr 2 w Spytkowicach|Spytkowice, Przewóz|ul. Wiślana 53 |34-116 Spytkowice;976;442;442;20;422;45.29;4.52
93425;121806;Zespół Szkolno-Przedszkolny w Spytkowicach|Spytkowice, Spytkowice Dolne|ul. Szkolna 14 |34-116 Spytkowice;2276;1120;1120;51;1069;49.21;4.55
93426;121806;Dom Strażaka Półwieś|Półwieś|ul. Świętego Floriana 28 |34-115 Ryczów;429;170;170;12;158;39.63;7.06
93427;121807;Szkoła Podstawowa w Łękawicy|Łękawica| 19 |34-124 Klecza Górna;1120;629;629;29;600;56.16;4.61
93428;121807;Szkoła Podstawowa w Dąbrówce|Dąbrówka| 43 |34-146 Stryszów;522;270;270;10;260;51.72;3.70
93429;121807;Szkoła Podstawowa w Stryszowie|Stryszów| 90 |34-146 Stryszów;1629;742;742;34;708;45.55;4.58
93430;121807;Gimnazjum w Zakrzowie|Zakrzów| 131 |34-145 Stronie;925;476;476;23;453;51.46;4.83
93431;121807;Szkoła Podstawowa w Stroniu|Stronie| 67 |34-145 Stronie;1206;573;573;44;529;47.51;7.68
93432;121808;Szkoła Podstawowa w Witanowicach|Witanowice|Jana Pawła II 107 |34-103 Witanowice;1328;715;715;26;689;53.84;3.64
93433;121808;Szkoła Podstawowa w Radoczy|Radocza|Dębowa 49 |34-100 Wadowice;1393;704;704;24;680;50.54;3.41
93434;121808;Zespół Szkolno-Przedszkolny w Tomicach|Tomice|Floriańska 16 |34-100 Wadowice;2012;1084;1084;40;1044;53.88;3.69
93435;121808;Szkoła Podstawowa w Woźnikach|Woźniki|Wadowicka 133 |34-103 Witanowice;1318;563;563;16;547;42.72;2.84
93436;121809;Przedszkole Nr 1 w Wadowicach|Wadowice|ul. Gimnazjalna 10 |34-100 Wadowice;1544;857;857;23;834;55.51;2.68
93437;121809;Wadowickie Centrum Kultury w Wadowicach|Wadowice|ul. Teatralna 1 |34-100 Wadowice;1875;1015;1015;13;1002;54.13;1.28
93438;121809;Zespół Szkół Publicznych Nr 1 w Wadowicach|Wadowice|ul. Słowackiego 2 |34-100 Wadowice;1229;730;730;17;713;59.40;2.33
93439;121809;Zespół Szkół Publicznych Nr 3 w Wadowicach|Wadowice|ul. Sienkiewicza 9 |34-100 Wadowice;1600;824;824;28;796;51.50;3.40
93440;121809;Zespół szkół Publicznych Nr 3 w Wadowicach|Wadowice|ul. Sienkiewicza 9 |34-100 Wadowice;919;476;476;13;463;51.80;2.73
93441;121809;Zespół Szkół Publicznych Nr 2 w Wadowicach|Wadowice|Osiedle Kopernika 11 |34-100 Wadowice;1717;994;994;16;978;57.89;1.61
93442;121809;Zespół Szkół Publicznych Nr 2 w Wadowicach|Wadowice|Osiedle Kopernika 11 |34-100 Wadowice;1686;987;987;18;969;58.54;1.82
93443;121809;Szkoła Podstawowa Nr 1 w Wadowicach|Wadowice|Osiedle Pod Skarpą 10 |34-100 Wadowice;1150;661;661;12;649;57.48;1.82
93444;121809;Szkoła Podstawowa Nr 1 w Wadowicach|Wadowice|Osiedle Pod Skarpą 10 |34-100 Wadowice;1626;930;930;19;911;57.20;2.04
93445;121809;Szkoła Podstawowa Nr 1 w Wadowicach|Wadowice|Osiedle Pod Skarpą 10 |34-100 Wadowice;1757;1047;1047;26;1021;59.59;2.48
93446;121809;Zespół Szkół Nr 1 w Choczni|Chocznia|ul. Główna 1 |34-100 Chocznia;1815;985;985;23;962;54.27;2.34
93447;121809;Zespół Szkół Nr 1 w Choczni|Chocznia|ul. Główna 1 |34-123 Chocznia;1513;761;761;26;735;50.30;3.42
93448;121809;Zespół Szkół Nr 2 w Choczni|Chocznia|ul. Główna 65 |34-123 Chocznia;1462;736;736;8;728;50.34;1.09
93449;121809;Zespół Szkół w Ponikwi|Ponikiew| 116 |34-100 Wadowice;800;379;379;8;371;47.38;2.11
93450;121809;Zespół Szkół w Jaroszowicach|Jaroszowice| 88 |34-100 Wadowice;952;507;507;11;496;53.26;2.17
93451;121809;Szkoła Podstawowa w Zawadce|Zawadka| 90 |34-100 Wadowice;681;359;359;18;341;52.72;5.01
93452;121809;Zespół Szkół Publicznych w Kleczy Dolnej|Klecza Dolna| 181 |34-124 Klecza Górna;1881;1009;1009;26;983;53.64;2.58
93453;121809;Zespół Szkół Publicznych w Kleczy Dolnej|Klecza Dolna| 181 |34-124 Klecza Górna;633;325;325;6;319;51.34;1.85
93454;121809;Szkoła Podstawowa w Barwałdzie Dolnym|Barwałd Dolny| 64 |34-124 Klecza Górna;564;284;284;7;277;50.35;2.46
93455;121809;Dom Ludowy w Babicy|Babica| 82A |34-103 Witanowice;958;505;505;19;486;52.71;3.76
93456;121809;Zespół Szkół Publicznych w Wysokiej|Wysoka| 195 |34-105 Wysoka;1487;726;726;24;702;48.82;3.31
93457;121809;Szkoła Podstawowa w Stanisławiu Górnym|Stanisław Górny| 132 |34-105 Wysoka;865;406;406;7;399;46.94;1.72
93458;121809;Centrum Kultury Jaroszowice-Zbywaczówka|Jaroszowice| 206 |34-100 Wadowice;1256;645;645;20;625;51.35;3.10
93459;121809;Dom Pomocy Społecznej im. św. Rafała Kalinowskiego w Wadowicach|Wadowice|Generała Pułaskiego 5 |34-100 Wadowice;74;27;27;1;26;36.49;3.70
93460;121809;Szpital Powiatowy w Wadowicach|Wadowice|Karmelicka 12 |34-100 Wadowice;173;48;48;1;47;27.75;2.08
93461;121809;Zakład Karny w Wadowicach|Wadowice|Trybunalska 8 |34-100 Wadowice;298;180;180;22;158;60.40;12.22
93462;121809;Dom Pomocy Społecznej Nr 1 w Wadowicach|Wadowice|Parkowa 1 |34-100 Wadowice;62;37;37;0;37;59.68;0.00
93463;121810;Gminny Ośrodek Kultury w Wieprzu|Wieprz|Centralna 7 |34-122 Wieprz;1257;774;774;19;755;61.58;2.45
93464;121810;Zespół Szkolno-Przedszkolny nr 1 im. Jana Pawła II w Wieprzu|Wieprz|Centralna 19 |34-122 Wieprz;1417;843;843;22;821;59.49;2.61
93465;121810;Zespół Szkolno-Przedszkolny nr 2 im. Kard. Stefana Wyszyńskiego w Wieprzu|Wieprz|Beskidzka 324 |34-122 Wieprz;1291;716;716;23;693;55.46;3.21
93466;121810;Zespół Szkolno-Przedszkolny im. Jana Brzechwy we Frydrychowicach|Frydrychowice| 58b |34-108 Frydrychowice;1078;515;515;21;494;47.77;4.08
93467;121810;Wiejski Dom Kultury we Frydrychowicach|Frydrychowice| 91 |34-108 Frydrychowice;1085;515;515;14;501;47.47;2.72
93468;121810;Wiejski Dom Kultury w Gierałtowicach|Gierałtowice|św. Marcina 8 |34-122 Wieprz;1344;727;727;39;688;54.09;5.36
93469;121810;Wiejski Dom Kultury w Nidku|Nidek| 52 |34-122 Wieprz;1096;597;597;16;581;54.47;2.68
93470;121810;Remiza Ochotniczej Straży Pożarnej w Przybradzu|Przybradz|Szkolna 36 |34-108 Frydrychowice;806;408;408;17;391;50.62;4.17
93471;121901;Szkoła Podstawowa w Biskupicach|Biskupice| 322 |32-020 Wieliczka;1247;661;661;15;646;53.01;2.27
93472;121901;Szkoła Podstawowa w Przebieczanach|Tomaszkowice| 3 |32-020 Wieliczka;902;477;477;20;457;52.88;4.19
93473;121901;Szkoła Podstawowa w Bodzanowie|Bodzanów| 464 |32-020 Wieliczka;1079;571;571;18;553;52.92;3.15
93474;121901;Publiczna Szkoła Podstawowa w Trąbkach|Trąbki| 312 |32-020 Wieliczka;1118;577;577;21;556;51.61;3.64
93475;121901;Świetlica Wiejska w Łazanach|Łazany| 63 |32-020 Wieliczka;729;382;382;11;371;52.40;2.88
93476;121901;Placówka Wsparcia Dziennego w Zabłociu|Zabłocie| 171 |32-020 Wieliczka;755;396;396;13;383;52.45;3.28
93477;121901;Gimnazjum w Sławkowicach|Sławkowice| 162 |32-020 Wieliczka;701;399;399;16;383;56.92;4.01
93478;121901;Świetlica Środowiskowa w Jawczycach|Jawczyce| 135 |32-020 Wieliczka;400;192;192;3;189;48.00;1.56
93479;121901;Urząd Gminy Biskupice|Tomaszkowice| 455 |32-020 Wieliczka;499;278;278;10;268;55.71;3.60
93480;121901;Dom Pomocy Społecznej w Biskupicach|Biskupice| 5 |32-020 Wieliczka;65;32;32;3;29;49.23;9.38
93481;121902;Centrum Kultury w Gdowie|Gdów| 398 |32-420 Gdów;1455;758;758;18;740;52.10;2.37
93482;121902;Gimnazjum w Gdowie|Gdów| 1206 |32-420 Gdów;2236;1205;1205;45;1160;53.89;3.73
93483;121902;Szkoła Podstawowa w Zręczycach|Zręczyce| 222 |32-420 Gdów;1066;516;516;13;503;48.41;2.52
93484;121902;Budynek Szkolny w Zagórzanach|Zagórzany| 109 |32-420 Gdów;510;227;227;7;220;44.51;3.08
93485;121902;Szkoła Podstawowa w Winiarach|Winiary| 169 |32-420 Gdów;1108;561;561;16;545;50.63;2.85
93486;121902;Szkoła Podstawowa w Bilczycach|Bilczyce| 92 |32-420 Gdów;787;419;419;20;399;53.24;4.77
93487;121902;Gimnazjum w Niegowici|Niegowić| 62 |32-420 Gdów;1526;752;752;34;718;49.28;4.52
93488;121902;Gimnazjum w Niegowici|Niegowić| 62 |32-420 Gdów;1364;651;651;17;634;47.73;2.61
93489;121902;Szkoła Podstawowa w Marszowicach|Marszowice| 149 |32-420 Gdów;1149;624;624;27;597;54.31;4.33
93490;121902;Szkoła Podstawowa w Książnicach|Książnice| 191 |32-420 Gdów;618;340;340;7;333;55.02;2.06
93491;121902;Szkoła Podstawowa w Jaroszówce|Jaroszówka| 59 |32-420 Gdów;705;343;343;10;333;48.65;2.92
93492;121902;Szkoła Podstawowa w Szczytnikach|Szczytniki| 10 |32-420 Gdów;1119;610;610;19;591;54.51;3.11
93493;121903;Wiejski Dom Kultury w Brzeziu|Brzezie| 79 |32-014 Brzezie;762;379;379;15;364;49.74;3.96
93494;121903;Wiejski Dom Kultury w Dąbrowie|Dąbrowa| 151 |32-014 Brzezie;632;387;387;9;378;61.23;2.33
93495;121903;Szkoła Podstawowa w Grodkowicach|Grodkowice| 80 |32-015 Kłaj;325;167;167;6;161;51.38;3.59
93496;121903;Wiejski Dom Kultury w Łężkowicach|Łężkowice| 96 |32-015 Kłaj;300;162;162;2;160;54.00;1.23
93497;121903;Wiejski Dom Kultury w Gruszkach|Brzezie, Gruszki| 338 |32-014 Brzezie;588;311;311;8;303;52.89;2.57
93498;121903;Zespół Szkół Ogólnokształcących w Kłaju|Kłaj| 361 |32-015 Kłaj;1248;652;652;35;617;52.24;5.37
93499;121903;Zespół Szkół Ogólnokształcących w Kłaju|Kłaj,| 361 |32-015 Kłaj;1484;779;779;14;765;52.49;1.80
93500;121903;Wiejski Dom Kultury w Łysokaniach|Łysokanie| 90 |32-014 Brzezie;519;301;301;4;297;58.00;1.33
93501;121903;Wiejski Dom Kultury w Szarowie|Szarów| 346 |32-014 Brzezie;1110;630;630;17;613;56.76;2.70
93502;121903;Wiejski Dom Kultury w Targowisku|Targowisko| 423 |32-015 Kłaj;1430;714;714;17;697;49.93;2.38
93503;121904;Zamek Królewski w Niepołomicach|Niepołomice|Zamkowa 2 |32-005 Niepołomice;1562;908;908;10;898;58.13;1.10
93504;121904;Zamek Królewski w Niepołomicach|Niepołomice|Zamkowa 2 |32-005 Niepołomice;1795;1134;1134;17;1117;63.18;1.50
93505;121904;Zamek Królewski w Niepołomicach|Niepołomice|Zamkowa 2 |32-005 Niepołomice;1626;983;983;23;960;60.46;2.34
93506;121904;Małopolskie Centrum Dźwięku i Słowa|Niepołomice|Zamkowa 4 |32-005 Niepołomice;1266;719;719;16;703;56.79;2.23
93507;121904;Remiza Ochotniczej Straży Pożarnej w Niepołomicach|Niepołomice|Sportowa 1 |32-005 Niepołomice;596;346;346;11;335;58.05;3.18
93508;121904;Dom dla Niewidomych Mężczyzn im. Matki Elżbiety Czackiej|Niepołomice|Zabierzowska 24 |32-005 Niepołomice;1769;1044;1044;20;1024;59.02;1.92
93509;121904;Niepubliczne Gimnazjum w Podłężu|Podłęże| 220 |32-003 Podłęże;1699;1007;1007;12;995;59.27;1.19
93510;121904;Dom Kultury w Staniątkach|Staniątki| 315 |32-005 Niepołomice;2087;1181;1181;32;1149;56.59;2.71
93511;121904;Dom Kultury w Zagórzu|Zagórze| 145 |32-005 Niepołomice;1631;892;892;21;871;54.69;2.35
93512;121904;Szkoła Podstawowa w Zakrzowie|Zakrzów| 323 |32-003 Podłęże;1374;715;715;20;695;52.04;2.80
93513;121904;Dom Kultury w Woli Batorskiej|Wola Batorska| 25 |32-007 Zabierzów Bocheński;2336;1244;1244;26;1218;53.25;2.09
93514;121904;Zespół Szkół z Oddziałami Integracyjnymi w Zabierzowie Bocheńskim|Zabierzów Bocheński| 465 |32-007 Zabierzów Bocheński;1337;669;669;17;652;50.04;2.54
93515;121904;Szkoła Podstawowa w Woli Zabierzowskiej|Wola Zabierzowska| 1 |32-007 Zabierzów Bocheński;1275;574;574;21;553;45.02;3.66
93516;121905;Szkoła Podstawowa nr 2 w Wieliczce|Wieliczka|ul. Moniuszki 1 |32-020 Wieliczka;1627;937;937;15;922;57.59;1.60
93517;121905;Centrum Edukacyjno-Rekreacyjne "Solne Miasto" w Wieliczce|Wieliczka|ul. Kościuszki 15 |32-020 Wieliczka;1071;572;572;10;562;53.41;1.75
93518;121905;Samorządowe Przedszkole nr 2 w Wieliczce|Wieliczka|ul. Asnyka 40 |32-020 Wieliczka;1407;807;807;20;787;57.36;2.48
93519;121905;Samorządowe Przedszkole nr 5 w Wieliczce|Wieliczka|ul. Wincentego Pola 23 |32-020 Wieliczka;1697;936;936;12;924;55.16;1.28
93520;121905;Szkoła Podstawowa nr 3 w Wieliczce|Wieliczka|os. Sienkiewicza 14 |32-020 Wieliczka;1763;974;974;20;954;55.25;2.05
93521;121905;Gimnazjum w Wieliczce|Wieliczka|ul. Piłsudskiego 20 |32-020 Wieliczka;2106;1320;1320;20;1300;62.68;1.52
93522;121905;Liceum Ogólnokształcące w Wieliczce|Wieliczka|ul. Piłsudskiego 18 |32-020 Wieliczka;1096;730;730;17;713;66.61;2.33
93523;121905;Świetlica Środowiskowa w Wieliczce|Wieliczka|ul. Reformacka 76 |32-020 Wieliczka;1047;611;611;11;600;58.36;1.80
93524;121905;Centrum Edukacyjno-Rekreacyjne "Solne Miasto" w Wieliczce|Wieliczka|ul. Kosciuszki 15 |32-020 Wieliczka;1936;1107;1107;12;1095;57.18;1.08
93525;121905;Szkoła Podstawowa Nr 4 w Wieliczce|Wieliczka|ul. Krzyszkowicka 18 |32-020 Wieliczka;1650;1035;1035;20;1015;62.73;1.93
93526;121905;Dom Osiedlowy w Wieliczce|Wieliczka|ul. Krzyszkowicka 5c |32-020 Wieliczka;1473;956;956;18;938;64.90;1.88
93527;121905;Szkoła Podstawowa w Sierczy|Siercza| 428 |32-020 Wieliczka;1183;622;622;10;612;52.58;1.61
93528;121905;Szkoła Podstawowa w Sygneczowie|Sygneczów| 1 |32-020 Wieliczka;1476;802;802;14;788;54.34;1.75
93529;121905;Szkoła Podstawowa w Golkowicach|Golkowice| 454 |30-698 Kraków;1478;701;701;15;686;47.43;2.14
93530;121905;Świetlica Środowiskowa w Janowicach|Janowice| 402 |32-020 Wieliczka;1000;492;492;10;482;49.20;2.03
93531;121905;Szkoła Podstawowa w Podstolicach|Podstolice| 204 |32-020 Wieliczka;822;445;445;11;434;54.14;2.47
93532;121905;Szkoła Podstawowa w Koźmicach Wielkich|Koźmice Wielkie| 1 |32-020 Wieliczka;1296;607;607;20;587;46.84;3.29
93533;121905;Gimnazjum w Koźmicach Wielkich|Koźmice Wielkie| 605 |32-020 Wieliczka;1189;682;682;23;659;57.36;3.37
93534;121905;Szkoła Podstawowa w Byszycach|Byszyce| 1 |32-020 Wieliczka;581;331;331;5;326;56.97;1.51
93535;121905;Szkoła Podstawowa w Gorzkowie|Gorzków| 168 |32-020 Wieliczka;1095;520;520;11;509;47.49;2.12
93536;121905;Szkoła Podstawowa w Raciborsku|Raciborsko| 71 |32-020 Wieliczka;960;510;510;8;502;53.12;1.57
93537;121905;Dom Strażaka w Grajowie|Grajów| 340 |32-020 Wieliczka;690;339;339;8;331;49.13;2.36
93538;121905;Szkoła Podstawowa w Mietniowie|Mietniów| 60 |32-020 Wieliczka;835;467;467;6;461;55.93;1.28
93539;121905;Wiejski Dom Kultury w Pawlikowicach|Pawlikowice| 71 |32-020 Wieliczka;1463;792;792;14;778;54.14;1.77
93540;121905;Gimnazjum w Dobranowicach|Dobranowice| 121 |32-020 Wieliczka;506;276;276;7;269;54.55;2.54
93541;121905;Dom Strażaka w Chorągwicy|Chorągwica| 140 |32-020 Wieliczka;738;386;386;11;375;52.30;2.85
93542;121905;Świetlica Środowiskowa w Lednicy Górnej|Lednica Górna| 451 |32-020 Wieliczka;1100;594;594;15;579;54.00;2.53
93543;121905;Szkoła Podstawowa Nr 2 w Wieliczce Szkoła Filialna w Sułkowie|Sułków| 235 |32-020 Wieliczka;989;581;581;20;561;58.75;3.44
93544;121905;Wiejski Dom Kultury w Małej Wsi|Mała Wieś| 303 |32-002 Węgrzce Wielkie;765;440;440;14;426;57.52;3.18
93545;121905;Wiejski Dom Kultury w Strumianach|Strumiany| 254 |32-002 Węgrzce Wielkie;471;300;300;6;294;63.69;2.00
93546;121905;Szkoła Podstawowa w Węgrzcach Wielkich|Wegrzce Wielkie| 190 |32-002 Węgrzce Wielkie;1683;1076;1076;15;1061;63.93;1.39
93547;121905;Szkoła Podstawowa w Grabiu|Grabie| 2 |32-002 Węgrzce Wielkie;601;344;344;9;335;57.24;2.62
93548;121905;Dom Ludowy w Brzegach|Brzegi| 234 |32-002 Węgrzce Wielkie;483;288;288;5;283;59.63;1.74
93549;121905;Dom Strażaka w Kokotowie|Kokotów| 553 |32-002 Węgrzce Wielkie;1706;928;928;15;913;54.40;1.62
93550;121905;Dom Strażaka w Zabawie|Zabawa| 340 |32-020 Wieliczka;792;438;438;12;426;55.30;2.74
93551;121905;Przedszkole Samorządowe w Śledziejowicach|Śledziejowice| 203A |32-020 Wieliczka;1333;766;766;20;746;57.46;2.61
93552;121905;Dom Ludowy w Czarnochowicach|Czarnochowice| 150 |32-020 Wieliczka;1117;620;620;19;601;55.51;3.06
93553;126101;VI Liceum Ogólnokształcące|Kraków|ul. Wąska 7 |31-057 ;1021;623;623;11;612;61.02;1.77
93554;126101;VI Liceum Ogólnokształcące|Kraków|ul.Wąska 7 |31-057 ;936;536;536;7;529;57.26;1.31
93555;126101;Staromiejskie Centrum Kultury Młodzieży|Kraków|ul. Dietla 53 |31-054 ;1116;615;615;5;610;55.11;0.81
93556;126101;Zespół Szkolno-Przedszkolny Nr 3|Kraków|ul. Miodowa 36 |31-052 ;979;575;575;7;568;58.73;1.22
93557;126101;Zespół Szkolno-Przedszkolny Nr 3|Kraków|ul. Miodowa 36 |31-052 ;993;562;562;18;544;56.60;3.20
93558;126101;Zespół Szkół Mechanicznych Nr 4|Kraków|ul. Podbrzezie 10 |31-054 ;528;334;334;4;330;63.26;1.20
93559;126101;Szkoła Podstawowa z Oddziałami Integracyjnymi Nr 22|Kraków|ul. Chmielowskiego 1 |31-067 ;1413;861;861;9;852;60.93;1.05
93560;126101;Przedszkole Samorządowe Nr 45|Kraków|ul. Piekarska 14 |31-067 ;1261;711;711;5;706;56.38;0.70
93561;126101;Gimnazjum Nr 1|Kraków|ul. Bernardyńska 7 |31-069 ;781;441;441;5;436;56.47;1.13
93562;126101;Gimnazjum Nr 1|Kraków|ul. Bernardyńska 7 |31-069 ;799;539;539;1;538;67.46;0.19
93563;126101;Zespół Szkolno-Przedszkolny Nr 6|Kraków|ul. Dietla 70 |31-039 ;867;566;566;6;560;65.28;1.06
93564;126101;Zespół Szkolno-Przedszkolny Nr 6|Kraków|ul. Dietla 70 |31-039 ;719;441;441;7;434;61.34;1.59
93565;126101;Urząd Miasta Krakowa|Kraków|ul. Wielopole 17A |31-072 ;1280;855;855;8;847;66.80;0.94
93566;126101;Szkoła Podstawowa Nr 1|Kraków|ul. św. Marka 34 |31-026 ;606;481;481;6;475;79.37;1.25
93567;126101;Szkoła Podstawowa Nr 1|Kraków|ul. św. Marka 34 |31-024 ;1078;780;780;3;777;72.36;0.38
93568;126101;Szkoła Podstawowa Nr 1|Kraków|ul. św. Marka 34 |31-024 ;1205;829;829;4;825;68.80;0.48
93569;126101;I Liceum Ogólnokształcące|Kraków|pl. Na Groblach 9 |31-101 ;819;508;508;7;501;62.03;1.38
93570;126101;Szkoła Podstawowa Nr 4|Kraków|ul. Smoleńsk 5-7 |31-108 ;989;704;704;4;700;71.18;0.57
93571;126101;Szkoła Podstawowa Nr 4|Kraków|ul. Smoleńsk 5-7 |31-108 ;861;598;598;5;593;69.45;0.84
93572;126101;Zespół Szkół Mechanicznych Nr 1|Kraków|al. Mickiewicza wejście od ul. Humberta 1 5 |31-120 ;629;455;455;5;450;72.34;1.10
93573;126101;Zespół Szkół Energetycznych|Kraków|ul. Loretańska 16 |31-114 ;1021;669;669;1;668;65.52;0.15
93574;126101;Specjalny Ośrodek Szkolno-Wychowawczy Nr 1|Kraków|ul. Szujskiego 2 |31-123 ;768;500;500;2;498;65.10;0.40
93575;126101;Specjalny Ośrodek Szkolno-Wychowawczy Nr 1|Kraków|ul. Szujskiego 2 |31-123 ;579;406;406;1;405;70.12;0.25
93576;126101;II Liceum Ogólnokształcące|Kraków|ul. Sobieskiego 9 |31-136 ;1351;882;882;2;880;65.28;0.23
93577;126101;II Liceum Ogólnokształcące|Kraków|ul. Sobieskiego 9 |31-136 ;1117;694;694;5;689;62.13;0.72
93578;126101;Małopolskie Centrum Doskonalenia Nauczycieli Ośrodek Doskonalenia Nauczycieli w Krakowie|Kraków|ul. Garbarska 1 |31-131 ;1055;691;691;6;685;65.50;0.87
93579;126101;Centrum Medyczne 4M|Kraków|ul. Krowoderska 17 |31-141 ;1406;956;956;6;950;67.99;0.63
93580;126101;Przedszkole Samorządowe Nr 44|Kraków|ul. Żuławskiego 9 |31-145 ;811;532;532;6;526;65.60;1.13
93581;126101;X Liceum Ogólnokształcące|Kraków|ul. Wróblewskiego 8 |31-148 ;643;422;422;3;419;65.63;0.71
93582;126101;X Liceum Ogólnokształcące|Kraków|ul. Wróblewskiego 8 |31-148 ;1025;668;668;1;667;65.17;0.15
93583;126101;Gimnazjum Nr 4|Kraków|Rynek Kleparski 18 |31-150 ;1403;897;897;12;885;63.93;1.34
93584;126101;Szkoła Podstawowa Nr 95|Kraków|ul. Wileńska 9 |31-413 ;928;559;559;0;559;60.24;0.00
93585;126101;Zespół Szkół Ogólnokształcących Nr 11|Kraków|ul. Wilka-Wyrwińskiego 1 |31-517 ;1310;876;876;5;871;66.87;0.57
93586;126101;Młodzieżowy Dom Kultury|Kraków|ul. Grunwaldzka 5 |31-526 ;1261;851;851;7;844;67.49;0.82
93587;126101;Urząd Miasta Krakowa|Kraków|ul. Kasprowicza 29 |31-523 ;1230;821;821;3;818;66.75;0.37
93588;126101;Zespół Szkół i Placówek Specjalnych|Kraków|ul. Lubomirskiego 21 |31-509 ;824;522;522;2;520;63.35;0.38
93589;126101;Szkoła Podstawowa z Oddziałami Integracyjnymi Nr 3|Kraków|ul. Topolowa 22 |31-506 ;1081;675;675;5;670;62.44;0.74
93590;126101;Zespół Szkół Ogólnokształcących Mistrzostwa Sportowego|Kraków|ul. Grochowska 20 |31-521 ;1044;702;702;7;695;67.24;1.00
93591;126101;Zespół Szkół Ogólnokształcących Mistrzostwa Sportowego|Kraków|ul. Grochowska 20 |31-521 ;1558;1074;1074;17;1057;68.93;1.58
93592;126101;Gimnazjum Nr 7|Kraków|ul. Jachowicza 5 |31-564 ;1760;1115;1115;12;1103;63.35;1.08
93593;126101;Gimnazjum Nr 7|Kraków|ul. Jachowicza 5 |31-564 ;1374;803;803;10;793;58.44;1.25
93594;126101;Szkoła Podstawowa Nr 18|Kraków|ul. Półkole 11 |31-559 ;1369;851;851;4;847;62.16;0.47
93595;126101;Szkoła Podstawowa Nr 18|Kraków|ul. Półkole 11 |31-559 ;1194;761;761;5;756;63.74;0.66
93596;126101;Szkoła Podstawowa Nr 38|Kraków|ul. Pułkownika Nullo 23 |31-543 ;1508;1024;1024;3;1021;67.90;0.29
93597;126101;Szkoła Podstawowa Nr 38|Kraków|ul. Pułkownika Nullo 23 |31-543 ;1461;924;924;4;920;63.24;0.43
93598;126101;Szkoła Podstawowa Nr 38|Kraków|ul. Pułkownika Nullo 23 |31-543 ;1108;712;712;3;709;64.26;0.42
93599;126101;XIII Liceum Ogólnokształcące|Kraków|ul. Sądowa 4 |31-542 ;1314;844;844;10;834;64.23;1.18
93600;126101;XIII Liceum Ogólnokształcące|Kraków|ul. Sądowa 4 |31-542 ;1120;771;771;4;767;68.84;0.52
93601;126101;VIII Liceum Ogólnokształcące|Kraków|ul. Grzegórzecka 24 |31-531 ;1132;654;654;1;653;57.77;0.15
93602;126101;VIII Liceum Ogólnokształcące|Kraków|ul. Grzegórzecka 24 |31-531 ;1079;657;657;13;644;60.89;1.98
93603;126101;Zespół Szkół Zawodowych Nr 1|Kraków|ul. Rzeźnicza 4 |31-540 ;1268;788;788;2;786;62.15;0.25
93604;126101;Zespół Szkół Ogólnokształcących Nr 1|Kraków|ul. Księdza Blachnickiego 1 |31-535 ;1387;868;868;14;854;62.58;1.61
93605;126101;Filia Przedszkola Samorządowego Nr 162|Kraków|ul. Duchacka 3 |31-426 ;688;493;493;3;490;71.66;0.61
93606;126101;Szkoła Podstawowa Nr 95|Kraków|ul. Wileńska 9 |31-413 ;1542;1025;1025;5;1020;66.47;0.49
93607;126101;Szkoła Podstawowa Nr 95|Kraków|ul. Wileńska 9 |31-413 ;1461;822;822;12;810;56.26;1.46
93608;126101;Szkoła Podstawowa Nr 95|Kraków|ul. Wileńska 9 |31-413 ;1329;827;827;19;808;62.23;2.30
93609;126101;Młodzieżowy Dom Kultury|Kraków|al. 29 Listopada 100 |31-416 ;1079;723;723;3;720;67.01;0.41
93610;126101;Śródmiejski Ośrodek Kultury Klub Muzyki Współczesnej "Malwa"|Kraków|ul. Dobrego Pasterza 6 |31-416 ;1192;842;842;3;839;70.64;0.36
93611;126101;Przedszkole Samorządowe Nr 178|Kraków|ul. Sudolska 3 |31-423 ;1470;990;990;6;984;67.35;0.61
93612;126101;Przedszkole Samorządowe Nr 178|Kraków|ul. Sudolska 3 |31-423 ;1076;747;747;5;742;69.42;0.67
93613;126101;Zespół Szkół Ogólnokształcących Nr 13|Kraków|ul. Kazimierza Odnowiciela 2 |31-481 ;734;518;518;3;515;70.57;0.58
93614;126101;Zespół Szkół Ogólnokształcących Nr 13|Kraków|ul. Kazimierza Odnowiciela 2 |31-481 ;1312;823;823;13;810;62.73;1.58
93615;126101;Szkoła Podstawowa Nr 2|Kraków|ul. Strzelców 5a |31-422 ;1414;835;835;4;831;59.05;0.48
93616;126101;Szkoła Podstawowa Nr 2|Kraków|ul. Strzelców 5a |31-422 ;1134;740;740;9;731;65.26;1.22
93617;126101;Szkoła Podstawowa Nr 2|Kraków|ul. Strzelców 5a |31-422 ;1040;672;672;6;666;64.62;0.89
93618;126101;Szkoła Podstawowa nr 2|Kraków|ul. Strzelców 5a |31-422 ;1105;631;632;14;617;57.10;2.22
93619;126101;Szkoła Podstawowa Nr 2|Kraków|ul. Strzelców 5a |31-422 ;2066;1399;1399;9;1390;67.72;0.64
93620;126101;Szkoła Podstawowa Nr 2|Kraków|ul. Strzelców 5a |31-422 ;1910;1274;1274;17;1257;66.70;1.33
93621;126101;Szkoła Podstawowa Nr 64|Kraków|ul. Sadzawki 1 |31-465 ;1113;663;666;12;651;59.57;1.81
93622;126101;Szkoła Podstawowa Nr 64|Kraków|ul. Sadzawki 1 |31-465 ;944;596;596;9;587;63.14;1.51
93623;126101;Szkoła Podstawowa Nr 64|Kraków|ul. Sadzawki 1 |31-465 ;1983;1433;1433;10;1423;72.26;0.70
93624;126101;Przedszkole Samorządowe Nr 14|Kraków|ul. Młyńska Boczna 4 |31-470 ;1098;666;666;12;654;60.66;1.80
93625;126101;Zespół Szkół Społecznych Nr 7|Kraków|ul. Stanisława ze Skalbmierza 7 |31-436 ;1015;696;696;9;687;68.57;1.29
93626;126101;Zespół Szkół Społecznych Nr 7|Kraków|ul. Stanisława ze Skalbmierza 7 |31-436 ;1125;610;610;17;593;54.22;2.79
93627;126101;Zespół Szkół Społecznych Nr 7|Kraków|ul. Stanisława ze Skalbmierza 7 |31-436 ;1463;878;878;7;871;60.01;0.80
93628;126101;Zespół Szkół Społecznych Nr 7|Kraków|ul. Stanisława ze Skalbmierza 7 |31-436 ;1042;606;606;4;602;58.16;0.66
93629;126101;Szkoła Muzyczna I Stopnia Nr 1|Kraków|ul. Pilotów 51 |31-462 ;1990;1419;1419;9;1410;71.31;0.63
93630;126101;Zespół Szkół Ogólnokształcących Nr 9|Kraków|ul. Seniorów Lotnictwa 5 |31-455 ;1685;1138;1138;16;1122;67.54;1.41
93631;126101;Zespół Szkół Ogólnokształcących Nr 9|Kraków|ul. Seniorów Lotnictwa 5 |31-455 ;831;537;537;7;530;64.62;1.30
93632;126101;Zespół Szkół Nr 1|Kraków|ul. Ułanów 3 |31-450 ;1164;699;699;10;689;60.05;1.43
93633;126101;Zespół Szkół Nr 1|Kraków|ul. Ułanów 3 |31-450 ;1198;723;723;13;710;60.35;1.80
93634;126101;Szkoła Podstawowa Nr 114|Kraków|ul. Łąkowa 31 |31-443 ;1961;1288;1288;10;1278;65.68;0.78
93635;126101;Szkoła Podstawowa Nr 114|Kraków|ul. Łąkowa 31 |31-443 ;1031;697;697;1;696;67.60;0.14
93636;126101;Zespół Szkół Ogólnokształcących Nr 53|Kraków|ul. Stawowa 179 |31-346 ;1818;1230;1230;16;1214;67.66;1.30
93637;126101;Zespół Szkół Ogólnokształcących Nr 53|Kraków|ul. Stawowa 179 |31-346 ;2084;1489;1489;11;1478;71.45;0.74
93638;126101;Zespół Szkół Ogólnokształcących Nr 5|Kraków|ul. Chełmońskiego 24 |31-322 ;1107;693;693;19;674;62.60;2.74
93639;126101;Zespół Szkół Ogólnokształcących Nr 5|Kraków|ul. Chełmońskiego 24 |31-322 ;1174;695;695;8;687;59.20;1.15
93640;126101;Zespół Szkół Ogólnokształcących Nr 5|Kraków|ul. Chełmońskiego 24 |31-322 ;1551;892;892;12;880;57.51;1.35
93641;126101;Klub Kultury "Vademecum"|Kraków|ul. Radzikowskiego 29 |31-315 ;1624;863;863;5;858;53.14;0.58
93642;126101;Szkoła Podstawowa Nr 119|Kraków|ul. Czerwieńskiego 1 |31-319 ;1189;906;906;6;900;76.20;0.66
93643;126101;Szkoła Podstawowa Nr 119|Kraków|ul. Czerwieńskiego 1 |31-319 ;1199;796;796;6;790;66.39;0.75
93644;126101;Szkoła Podstawowa Nr 119|Kraków|ul. Czerwieńskiego 1 |31-319 ;1095;614;614;8;606;56.07;1.30
93645;126101;Szkoła Podstawowa Nr 119|Kraków|ul. Czerwieńskiego 1 |31-319 ;956;492;492;2;490;51.46;0.41
93646;126101;Szkoła Podstawowa Nr 119|Kraków|ul. Czerwieńskiego 1 |31-319 ;953;537;537;8;529;56.35;1.49
93647;126101;Szkoła Podstawowa Nr 113|Kraków|ul. Stachiewicza 33 |31-328 ;2063;1125;1125;10;1115;54.53;0.89
93648;126101;Szkoła Podstawowa Nr 113|Kraków|ul. Stachiewicza 33 |31-328 ;788;434;435;9;425;55.08;2.07
93649;126101;Szkoła Podstawowa Nr 113|Kraków|ul. Stachiewicza 33 |31-328 ;1061;534;534;9;525;50.33;1.69
93650;126101;Szkoła Rodzenia|Kraków|ul. Siemaszki 17d |31-201 ;1080;621;621;6;615;57.50;0.97
93651;126101;Szkoła Podstawowa Nr 107|Kraków|ul. Zdrowa 6 |31-216 ;1594;922;922;15;907;57.84;1.63
93652;126101;Szkoła Podstawowa Nr 107|Kraków|ul. Zdrowa 6 |31-216 ;0;0;0;0;0;-99;-99
93653;126101;Szkoła Podstawowa Nr 107|Kraków|ul. Zdrowa 6 |31-216 ;1151;853;853;4;849;74.11;0.47
93654;126101;Szkoła Podstawowa Nr 107|Kraków|ul. Zdrowa 6 |31-216 ;1261;867;867;4;863;68.75;0.46
93655;126101;Zespół Szkół nr 5|Kraków|ul. Mackiewicza 15 |31-214 ;1261;846;846;14;832;67.09;1.65
93656;126101;Zespół Szkół nr 5|Kraków|ul. Mackiewicza 15 |31-214 ;1036;755;755;9;746;72.88;1.19
93657;126101;Zespół Szkół nr 5|Kraków|ul. Mackiewicza 15 |31-214 ;760;504;504;1;503;66.32;0.20
93658;126101;Zespół Szkół nr 5|Kraków|ul. Mackiewicza 15 |31-214 ;1877;1256;1256;7;1249;66.92;0.56
93659;126101;Zespół Szkół nr 5|Kraków|ul. Mackiewicza 15 |31-214 ;1058;694;694;4;690;65.60;0.58
93660;126101;Zespół Szkół nr 5|Kraków|ul. Mackiewicza 15 |31-230 ;1134;793;793;10;783;69.93;1.26
93661;126101;Szkoła Podstawowa Nr 58|Kraków|ul. Pigonia 2 |31-230 ;1538;1094;1094;8;1086;71.13;0.73
93662;126101;Szkoła Podstawowa Nr 58|Kraków|ul. Pigonia 2 |31-230 ;1105;750;751;4;746;67.87;0.53
93663;126101;Przedszkole Samorządowe Nr 165|Kraków|ul. Danka 1 |31-229 ;1971;1290;1291;9;1281;65.45;0.70
93664;126101;Szkoła Podstawowa Nr 21|Kraków|ul. Batalionu "Skała" AK 12 |31-273 ;1986;1265;1265;13;1252;63.70;1.03
93665;126101;Szkoła Podstawowa Nr 21|Kraków|ul. Batalionu "Skała" AK 12 |31-273 ;1894;1313;1313;7;1306;69.32;0.53
93666;126101;Szkoła Podstawowa Nr 21|Kraków|ul. Batalionu "Skała" AK 12 |31-271 ;1628;1083;1083;10;1073;66.52;0.92
93667;126101;Gimnazjum Nr 12|Kraków|ul. Kluczborska 3 |31-271 ;2051;1351;1351;20;1331;65.87;1.48
93668;126101;Gimnazjum Nr 12|Kraków|ul. Kluczborska 3 |31-271 ;1115;632;632;7;625;56.68;1.11
93669;126101;Gimnazjum Nr 12|Kraków|ul. Kluczborska 3 |31-271 ;1559;1006;1006;4;1002;64.53;0.40
93670;126101;Gimnazjum Nr 12|Kraków|ul. Kluczborska 3 |31-271 ;1696;1179;1179;5;1174;69.52;0.42
93671;126101;Szkoła Podstawowa Nr 67|Kraków|ul. Kaczorówka 4 |31-264 ;1599;1046;1046;8;1038;65.42;0.76
93672;126101;Zespół Szkolno-Przedszkolny Nr 2|Kraków|ul. Porzeczkowa 3 |31-234 ;1400;920;920;9;911;65.71;0.98
93673;126101;Zespół Szkolno-Przedszkolny Nr 2|Kraków|ul. Porzeczkowa 3 |31-234 ;1148;779;779;5;774;67.86;0.64
93674;126101;Młodzieżowy Dom Kultury|Kraków|al. 29 Listopada 100 |31-406 ;1105;737;737;4;733;66.70;0.54
93675;126101;Młodzieżowy Dom Kultury|Kraków|al. 29 Listopada 100 |31-406 ;1120;491;491;8;483;43.84;1.63
93676;126101;Samorządowe Przedszkole Nr 66|Kraków|ul. Arcybiskupa Felińskiego 35 |31-236 ;1682;1165;1165;14;1151;69.26;1.20
93677;126101;VII Liceum Ogólnokształcące|Kraków|ul. Skarbińskiego 5 |30-071 ;1780;1260;1261;11;1249;70.79;0.87
93678;126101;VII Liceum Ogólnokształcące|Kraków|ul. Skarbińskiego 5 |30-059 ;1259;995;995;7;988;79.03;0.70
93679;126101;VII Liceum Ogólnokształcące|Kraków|ul. Skarbińskiego 5 |30-071 ;1214;845;845;6;839;69.60;0.71
93680;126101;VII Liceum Ogólnokształcące|Kraków|ul. Skarbińskiego 5 |30-071 ;919;507;507;6;501;55.17;1.18
93681;126101;Towarzystwo Sportowe "Wisła"|Kraków|ul. Reymonta 22 |30-059 ;735;590;590;4;586;80.27;0.68
93682;126101;Zespół Szkół Ogólnokształcących Integracyjnych Nr 1|Kraków|al. Kijowska 3 |30-079 ;1539;1031;1031;8;1023;66.99;0.78
93683;126101;Zespół Szkół Ogólnokształcących Nr 51|Kraków|al. Kijowska 8 |30-079 ;1486;957;957;6;951;64.40;0.63
93684;126101;Zespół Szkół Specjalnych Nr 4|Kraków|ul. Zakątek 2 |30-074 ;1780;1199;1199;11;1188;67.36;0.92
93685;126101;Zespół Szkół Specjalnych Nr 4|Kraków|ul. Zakątek 2 |30-076 ;768;578;578;3;575;75.26;0.52
93686;126101;Zespół Szkół Specjalnych Nr 4|Kraków|ul. Zakątek 2 |30-076 ;1006;613;613;6;607;60.93;0.98
93687;126101;Zespół Szkolno-Przedszkolny Nr 4|Kraków|ul. Urzędnicza 65 |30-074 ;1354;927;927;4;923;68.46;0.43
93688;126101;Zespół Szkolno-Przedszkolny Nr 4|Kraków|ul. Urzędnicza 65 |30-074 ;921;639;639;9;630;69.38;1.41
93689;126101;Uniwersytet Ekonomiczny Wydział Towaroznawstwa|Kraków|ul. Sienkiewicza 4 |30-033 ;750;506;506;3;503;67.47;0.59
93690;126101;IX Liceum Ogólnokształcące|Kraków|ul. Czapińskiego 5 |30-048 ;748;483;483;3;480;64.57;0.62
93691;126101;IX Liceum Ogólnokształcące|Kraków|ul. Czapińskiego 5 |30-048 ;944;622;623;8;614;65.89;1.29
93692;126101;Gimnazjum Nr 16|Kraków|ul. Konarskiego 2 |30-049 ;1176;829;829;8;821;70.49;0.97
93693;126101;Urząd Miasta Krakowa|Kraków|ul. Lubelska 27 |30-003 ;1351;946;946;3;943;70.02;0.32
93694;126101;Szkoła Podstawowa Nr 36|Kraków|ul. Mazowiecka 70 |30-019 ;1383;958;958;10;948;69.27;1.04
93695;126101;Szkoła Podstawowa Nr 36|Kraków|ul. Mazowiecka 70 |30-019 ;1094;726;727;8;718;66.36;1.10
93696;126101;Szkoła Podstawowa Nr 36|Kraków|ul. Mazowiecka 70 |30-019 ;1060;664;664;4;660;62.64;0.60
93697;126101;Szkoła Podstawowa Nr 36|Kraków|ul. Mazowiecka 70 |30-019 ;1513;1010;1010;8;1002;66.75;0.79
93698;126101;Gimnazjum Nr 17|Kraków|ul. Litewska 34 |31-351 ;1343;871;871;10;861;64.85;1.15
93699;126101;Gimnazjum Nr 17|Kraków|ul. Litewska 34 |30-014 ;1316;882;882;4;878;67.02;0.45
93700;126101;Gimnazjum Nr 17|Kraków|ul. Litewska 34 |30-014 ;1284;888;888;3;885;69.16;0.34
93701;126101;Szkoła Podstawowa Nr 50|Kraków|ul. Katowicka 28 |31-351 ;1268;937;937;5;932;73.90;0.53
93702;126101;Szkoła Podstawowa Nr 153|Kraków|ul. Na Błonie 15d |30-147 ;1769;1258;1258;6;1252;71.11;0.48
93703;126101;Szkoła Podstawowa Nr 153|Kraków|ul. Na Błonie 15d |30-147 ;1031;692;692;1;691;67.12;0.14
93704;126101;Szkoła Podstawowa Nr 153|Kraków|ul. Na Błonie 15d |30-198 ;1010;750;750;5;745;74.26;0.67
93705;126101;Zespół Szkół Ogólnokształcących Nr 8|Kraków|ul. Na Błonie 15B |30-147 ;1605;1112;1112;12;1100;69.28;1.08
93706;126101;Zespół Szkół Ogólnokształcących Nr 8|Kraków|ul. Na Błonie 15B |30-147 ;1501;1095;1095;5;1090;72.95;0.46
93707;126101;Szkoła Podstawowa Nr 138|Kraków|ul. Wierzyńskiego 3 |30-198 ;2198;1487;1487;17;1470;67.65;1.14
93708;126101;Szkoła Podstawowa Nr 93|Kraków|ul. Szlachtowskiego 31 |30-132 ;1977;1331;1331;3;1328;67.32;0.23
93709;126101;Szkoła Podstawowa Nr 93|Kraków|ul. Szlachtowskiego 31 |30-132 ;1196;799;799;8;791;66.81;1.00
93710;126101;Zespół Szkół Ogólnokształcących Nr 7|Kraków|ul. Złoty Róg 30 |30-127 ;1129;751;751;10;741;66.52;1.33
93711;126101;Zespół Szkół Ogólnokształcących Nr 7|Kraków|ul. Złoty Róg 30 |30-095 ;1085;794;794;6;788;73.18;0.76
93712;126101;Zespół Szkół Ogólnokształcących Nr 7|Kraków|ul. Złoty Róg 30 |30-095 ;1032;651;651;9;642;63.08;1.38
93713;126101;Zespół Szkół Budowlanych Nr 1|Kraków|ul. Szablowskiego 1 |30-127 ;890;667;667;7;660;74.94;1.05
93714;126101;Zespół Szkół Budowlanych Nr 1|Kraków|ul. Szablowskiego 1 |30-127 ;733;506;506;4;502;69.03;0.79
93715;126101;Centrum Kształcenia Praktycznego|Kraków|ul. Wesele 41 |30-127 ;1651;1062;1062;13;1049;64.32;1.22
93716;126101;Szkoła Podstawowa Nr 48|Kraków|ul. Księcia Józefa 337 |30-243 ;1539;1226;1226;11;1215;79.66;0.90
93717;126101;Klub Kultury "Chełm"|Kraków|ul. Chełmska 16 |30-238 ;1751;1233;1233;9;1224;70.42;0.73
93718;126101;Publiczna Szkoła Podstawowa Sióstr Pijarek im. św. Józefa Kalasancjusza|Kraków|ul. Korzeniaka 18 |30-298 ;1218;692;692;16;676;56.81;2.31
93719;126101;Klub Kultury "Przegorzały"|Kraków|ul. Kamedulska 70 |30-252 ;947;666;666;8;658;70.33;1.20
93720;126101;Zespół Szkół Ogólnokształcących Nr 18|Kraków|ul. Senatorska 35 |30-106 ;740;508;508;0;508;68.65;0.00
93721;126101;Zespół Szkół Ogólnokształcących Nr 18|Kraków|ul. Senatorska 35 |30-106 ;939;628;628;5;623;66.88;0.80
93722;126101;Zespół Szkół Ogólnokształcących Nr 18|Kraków|ul. Senatorska 35 |30-106 ;851;543;543;9;534;63.81;1.66
93723;126101;Zespół Szkół Ogólnokształcących Nr 18|Kraków|ul. Senatorska 35 |30-106 ;761;506;506;5;501;66.49;0.99
93724;126101;Szkoła Podstawowa Nr 31|Kraków|ul. Prusa 18 |30-117 ;566;369;369;5;364;65.19;1.36
93725;126101;Szkoła Podstawowa Nr 31|Kraków|ul. Prusa 18 |30-117 ;661;431;431;4;427;65.20;0.93
93726;126101;Szkoła Podstawowa Nr 31|Kraków|ul. Prusa 18 |30-117 ;1008;686;687;10;676;68.06;1.46
93727;126101;Szkoła Podstawowa Nr 32|Kraków|ul. Królowej Jadwigi 78 |30-209 ;1810;1314;1316;10;1304;72.60;0.76
93728;126101;Szkoła Podstawowa Nr 32|Kraków|ul. Królowej Jadwigi 78 |30-209 ;577;400;400;3;397;69.32;0.75
93729;126101;Szkoła Podstawowa Nr 72|Kraków|al. Modrzewiowa 23 |30-224 ;1513;1082;1082;11;1071;71.51;1.02
93730;126101;Szkoła Podstawowa Nr 72|Kraków|al. Modrzewiowa 23 |30-224 ;1650;1248;1248;9;1239;75.64;0.72
93731;126101;Szkoła Podstawowa Nr 53|Kraków|ul. Skośna 8 |30-383 ;1534;1070;1070;11;1059;69.75;1.03
93732;126101;Szkoła Podstawowa Nr 53|Kraków|ul. Skośna 8 |30-383 ;1091;762;762;2;760;69.84;0.26
93733;126101;Szkoła Podstawowa Nr 53|Kraków|ul. Skośna 8 |30-383 ;1530;1157;1157;5;1152;75.62;0.43
93734;126101;Szkoła Podstawowa Nr 53|Kraków|ul. Skośna 8 |30-383 ;1394;988;988;4;984;70.88;0.40
93735;126101;Szkoła Podstawowa Nr 53|Kraków|ul. Skośna 8 |30-385 ;1370;979;979;7;972;71.46;0.72
93736;126101;Szkoła Podstawowa Nr 53|Kraków|ul. Skośna 8 |30-385 ;1331;811;811;6;805;60.93;0.74
93737;126101;Szkoła Podstawowa Nr 40|Kraków|ul. Pszczelna 13 |30-383 ;1996;1342;1342;10;1332;67.23;0.75
93738;126101;Szkoła Podstawowa Nr 40|Kraków|ul. Pszczelna 13 |30-383 ;1295;881;881;10;871;68.03;1.14
93739;126101;Szkoła Podstawowa Nr 40|Kraków|ul. Pszczelna 13 |30-383 ;1699;1082;1082;9;1073;63.68;0.83
93740;126101;Szkoła Podstawowa Nr 40|Kraków|ul. Pszczelna 13 |30-383 ;1487;927;927;15;912;62.34;1.62
93741;126101;Szkoła Podstawowa Nr 40|Kraków|ul. Pszczelna 13 |30-383 ;1161;708;708;8;700;60.98;1.13
93742;126101;Szkoła Podstawowa Nr 40|Kraków|ul. Pszczelna 13 |30-383 ;1096;588;588;7;581;53.65;1.19
93743;126101;Zespół Szkolno-Przedszkolny Nr 7|Kraków|ul. Skotnicka 86 |30-394 ;2004;1212;1213;23;1189;60.48;1.90
93744;126101;Zespół Szkolno-Przedszkolny Nr 7|Kraków|ul. Skotnicka 86 |30-394 ;1374;778;778;13;765;56.62;1.67
93745;126101;Zespół Szkolno-Przedszkolny Nr 8|Kraków|ul. Wrony 115 |30-399 ;2088;1257;1257;9;1248;60.20;0.72
93746;126101;Dom Kultury "Podgórze" Klub Osiedlowy "Tyniec"|Kraków|ul. Dziewiarzy 7 |30-398 ;1262;738;749;34;704;58.48;4.61
93747;126101;Dom Kultury "Podgórze" Klub Osiedlowy "Tyniec"|Kraków|ul. Dziewiarzy 7 |30-398 ;1043;554;554;10;544;53.12;1.81
93748;126101;Szkoła Podstawowa Nr 54|Kraków|ul. Tyniecka 122 |30-376 ;1519;944;944;14;930;62.15;1.48
93749;126101;Szkoła Podstawowa Nr 62|Kraków|ul. Ćwikłowa 1 |30-377 ;1040;672;672;9;663;64.62;1.34
93750;126101;Szkoła Podstawowa Nr 62|Kraków|ul. Ćwikłowa 1 |30-377 ;940;705;705;4;701;75.00;0.57
93751;126101;Specjalny Ośrodek Szkolno-Wychowawczy Nr 3|Kraków|ul. Praska 64 |30-322 ;1058;637;637;7;630;60.21;1.10
93752;126101;Zespół Szkół Łączności|Kraków|ul. Monte Cassino 31 |30-337 ;1745;1288;1288;5;1283;73.81;0.39
93753;126101;Zespół Szkół Łączności|Kraków|ul. Monte Cassino 31 |30-337 ;1823;1254;1254;7;1247;68.79;0.56
93754;126101;Gimnazjum Nr 22|Kraków|ul. Skwerowa 3 |30-317 ;1779;1174;1174;8;1166;65.99;0.68
93755;126101;Gimnazjum Nr 22|Kraków|ul. Skwerowa 3 |30-317 ;1024;642;642;5;637;62.70;0.78
93756;126101;Zespół Szkół Ogólnokształcących Integracyjnych Nr 2|Kraków|ul. Lipińskiego 2 |30-349 ;1283;715;715;14;701;55.73;1.96
93757;126101;Zespół Szkół Ogólnokształcących Integracyjnych Nr 2|Kraków|ul. Lipińskiego 2 |30-349 ;2238;1472;1472;16;1456;65.77;1.09
93758;126101;Zespół Szkół Ogólnokształcących Integracyjnych Nr 2|Kraków|ul. Lipińskiego 2 |30-349 ;1157;793;793;5;788;68.54;0.63
93759;126101;Zespół Szkół Ogólnokształcących Integracyjnych Nr 2|Kraków|ul. Lipińskiego 2 |30-349 ;1309;791;791;4;787;60.43;0.51
93760;126101;Gimnazjum Nr 21|Krakówi|ul. Komandosów 29 |30-334 ;1349;864;864;14;850;64.05;1.62
93761;126101;Gimnazjum Nr 21|Kraków|ul. Komandosów 29 |30-334 ;1549;985;991;10;975;63.59;1.02
93762;126101;Szkoła Podstawowa Nr 25|Kraków|ul. Komandosów 29 |30-334 ;1475;1011;1011;27;984;68.54;2.67
93763;126101;Szkoła Podstawowa Nr 25|Kraków|ul. Komandosów 29 |30-334 ;982;649;649;1;648;66.09;0.15
93764;126101;Szkoła Podstawowa Nr 25|Kraków|ul. Komandosów 29 |30-334 ;1193;846;846;6;840;70.91;0.71
93765;126101;Gimnazjum Nr 24|Kraków|ul. Montwiłła-Mireckiego 29 |30-426 ;1594;1086;1086;7;1079;68.13;0.64
93766;126101;Gimnazjum Nr 24|Kraków|ul. Montwiłła-Mireckiego 29 |30-426 ;1473;940;940;14;926;63.82;1.49
93767;126101;Specjalny Ośrodek Szkolno-Wychowawczy Nr 6|Kraków|ul. Niecała 8 |30-425 ;540;394;394;2;392;72.96;0.51
93768;126101;Specjalny Ośrodek Szkolno-Wychowawczy Nr 6|Kraków|ul. Niecała 8 |30-425 ;1326;706;706;13;693;53.24;1.84
93769;126101;Centrum Sztuki Współczesnej "Solvay"|Kraków|ul. Zakopiańska 62 |30-418 ;716;422;422;10;412;58.94;2.37
93770;126101;Zespół Szkół Ogólnokształcących Nr 17|Kraków|ul. Fredry 65/71 |30-605 ;1430;928;928;11;917;64.90;1.19
93771;126101;Zespół Szkół Ogólnokształcących Nr 17|Kraków|ul. Fredry 65/71 |30-605 ;1255;860;860;11;849;68.53;1.28
93772;126101;Miejskie Przedsiębiorstwo Komunikacyjne S.A.|Kraków|ul. Brożka 3 |30-347 ;1345;874;874;4;870;64.98;0.46
93773;126101;Instytut Przemysłu Skórzanego|Kraków|ul. Zakopiańska 9 |30-418 ;1296;924;924;7;917;71.30;0.76
93774;126101;Zespół Szkół Ogólnokształcących Integracyjnych Nr 3|Kraków|ul. Strąkowa 3A |30-410 ;1569;991;991;7;984;63.16;0.71
93775;126101;Stowarzyszenie RAJSKA SZKOŁA Rajski Publiczny Punkt Przedszkolny|Kraków|ul. Sztaudyngera 5 |30-694 ;687;409;409;8;401;59.53;1.96
93776;126101;Klub Osiedlowy "SOBONIOWICE"|Kraków|ul. Kuryłowicza 115 |30-699 ;717;388;388;5;383;54.11;1.29
93777;126101;Stowarzyszenie Rajska-Szkoła|Kraków|ul. Tuchowska 113 |30-699 ;821;476;476;6;470;57.98;1.26
93778;126101;Ochotnicza Straż Pożarna Zbydniowice|Kraków|ul. Matematyków Krakowskich 102 |30-698 ;626;282;282;12;270;45.05;4.26
93779;126101;Zespół Szkół Ogólnokształcących Nr 35|Kraków|ul. Mirtowa 2 |30-698 ;1330;801;801;14;787;60.23;1.75
93780;126101;Osiedlowy Klub Kultury "WRÓBLOWICE"|Kraków|ul. Niewodniczańskiego 74 |30-698 ;1149;578;578;19;559;50.30;3.29
93781;126101;Szkoła Podstawowa Nr 43|Kraków|ul. Myślenicka 112 |30-698 ;1680;1055;1055;12;1043;62.80;1.14
93782;126101;Szkoła Podstawowa Nr 43|Kraków|ul. Myślenicka 112 |30-398 ;1961;1295;1295;15;1280;66.04;1.16
93783;126101;Filia Szkoła Podstawowej Nr 97|Kraków|ul. Armii Kraków 76 |30-433 ;1729;1245;1245;12;1233;72.01;0.96
93784;126101;Szkoła Podstawowa Nr 97|Kraków|ul. Doktora Judyma 10 |30-436 ;1644;986;986;6;980;59.98;0.61
93785;126101;Szkoła Podstawowa Nr 97|Kraków|ul. Doktora Judyma 10 |30-436 ;1305;917;917;7;910;70.27;0.76
93786;126101;Szkoła Podstawowa Nr 97|Kraków|ul. Doktora Judyma 10 |30-436 ;1178;817;817;6;811;69.35;0.73
93787;126101;Dom Kultury Podgórze Klub Kultury Kliny|Kraków|ul. Biskupa Małysiaka 1 |30-389 ;1116;790;790;6;784;70.79;0.76
93788;126101;Dom Kultury Podgórze Klub Kultury Kliny|Kraków|ul. Biskupa Małysiaka 1 |30-389 ;1728;1179;1179;6;1173;68.23;0.51
93789;126101;Szkoła Podstawowa Nr 134|Kraków|ul. Kłuszyńska 46 |30-499 ;1374;900;900;9;891;65.50;1.00
93790;126101;Szkoła Podstawowa Nr 134|Kraków|ul. Kłuszyńska 46 |30-499 ;1098;540;540;14;526;49.18;2.59
93791;126101;Szkoła Podstawowa Nr 27|Kraków|ul. Podedworze 16 |30-686 ;1944;1240;1240;11;1229;63.79;0.89
93792;126101;Szkoła Podstawowa Nr 27|Kraków|ul. Podedworze 16 |30-686 ;1275;858;858;6;852;67.29;0.70
93793;126101;Szkoła Podstawowa Nr 27|Kraków|ul. Podedworze 16 |30-686 ;1570;1040;1040;15;1025;66.24;1.44
93794;126101;Zespół Szkół Odzieżowych Nr 1|Kraków|ul. Cechowa 57 |30-614 ;1693;1141;1141;2;1139;67.40;0.18
93795;126101;Zespół Szkół Odzieżowych Nr 1|Kraków|ul. Cechowa 57 |30-614 ;1222;852;852;10;842;69.72;1.17
93796;126101;Zespół Szkół Odzieżowych Nr 1|Kraków|ul. Cechowa 57 |30-614 ;1319;804;804;12;792;60.96;1.49
93797;126101;Przedszkole Samorządowe Nr 33|Kraków|ul. Rżącka 1 |30-687 ;1429;948;949;18;930;66.34;1.90
93798;126101;Zespół Szkół Elektrycznych Nr 1 INTERNAT|Kraków|ul. Kamieńskiego 49 |30-644 ;882;578;578;12;566;65.53;2.08
93799;126101;Gimnazjum Nr 27|Kraków|ul. Malborska 98 |30-624 ;1018;656;656;8;648;64.44;1.22
93800;126101;Gimnazjum Nr 27|Kraków|ul. Malborska 98 |30-624 ;1701;1008;1008;8;1000;59.26;0.79
93801;126101;Zarząd Infrastruktury Sportowej|Kraków|ul. Sławka 10 |30-633 ;1585;1030;1042;0;1030;64.98;0.00
93802;126101;Zarząd Infrastruktury Sportowej|Kraków|ul. Sławka 10 |30-633 ;992;596;596;19;577;60.08;3.19
93803;126101;Zespół Szkół Ogólnokształcących Integracyjnych Nr 7|Kraków|ul. Czarnogórska 14 |30-638 ;1935;1113;1113;7;1106;57.52;0.63
93804;126101;Zespół Szkół Ogólnokształcących Integracyjnych Nr 7|Kraków|ul. Czarnogórska 14 |30-638 ;1067;597;597;3;594;55.95;0.50
93805;126101;Zespół Szkół Ogólnokształcących Integracyjnych Nr 7|Kraków|ul. Czarnogórska 14 |30-638 ;1988;1218;1218;14;1204;61.27;1.15
93806;126101;Zespół Szkół Ogólnokształcących Integracyjnych Nr 7|Kraków|ul. Czarnogórska 14 |30-638 ;1582;980;980;10;970;61.95;1.02
93807;126101;Gimnazjum Nr 28|Kraków|ul. Bujaka 15 |30-611 ;1138;704;704;19;685;61.86;2.70
93808;126101;Gimnazjum Nr 28|Kraków|ul. Bujaka 15 |30-611 ;1226;805;805;4;801;65.66;0.50
93809;126101;Gimnazjum Nr 28|Kraków|ul. Bujaka 15 |30-611 ;2002;1223;1223;16;1207;61.09;1.31
93810;126101;Gimnazjum Nr 28|Kraków|ul. Bujaka 15 |30-611 ;1462;856;856;15;841;58.55;1.75
93811;126101;Gimnazjum Nr 28|Kraków|ul. Bujaka 15 |30-611 ;1106;781;781;5;776;70.61;0.64
93812;126101;Gimnazjum Nr 28|Kraków|ul. Bujaka 15 |30-611 ;1089;696;696;9;687;63.91;1.29
93813;126101;Szkoła Podstawowa Nr 162|Kraków|ul. Stojałowskiego 31 |30-620 ;1040;681;681;9;672;65.48;1.32
93814;126101;Szkoła Podstawowa Nr 162|Kraków|ul. Stojałowskiego 31 |30-611 ;1976;1210;1210;15;1195;61.23;1.24
93815;126101;Szkoła Podstawowa Nr 162|Kraków|ul. Stojałowskiego 31 |30-611 ;2007;1189;1189;20;1169;59.24;1.68
93816;126101;Szkoła Podstawowa Nr 162|Kraków|ul. Stojałowskiego 31 |30-611 ;1749;1139;1139;12;1127;65.12;1.05
93817;126101;Szkoła Podstawowa Nr 55|Kraków|ul. Dobczycka 20 |30-620 ;1365;864;864;12;852;63.30;1.39
93818;126101;Szkoła Podstawowa nr 55|Kraków|ul. Dobczycka 20 |30-620 ;1692;1057;1057;13;1044;62.47;1.23
93819;126101;Szkoła Podstawowa Nr 55|Kraków|ul. Dobczycka 20 |30-620 ;1155;689;689;12;677;59.65;1.74
93820;126101;Zespół Szkół Specjalnych nr 11|Kraków|ul. Dobczycka 20 |30-620 ;1117;703;703;8;695;62.94;1.14
93821;126101;Filia Szkoły Podstawowej Nr 124|Kraków|ul. Sucharskiego 38 |30-898 ;1088;536;536;13;523;49.26;2.43
93822;126101;Filia Szkoły Podstawowej Nr 124|Kraków|ul. Sucharskiego 38 |30-898 ;1593;945;945;10;935;59.32;1.06
93823;126101;Szkoła Podstawowa Nr 124|Kraków|ul. Weigla 2 |30-898 ;1844;1141;1141;15;1126;61.88;1.31
93824;126101;Szkoła Podstawowa Nr 124|Kraków|ul. Weigla 2 |30-898 ;1423;920;920;8;912;64.65;0.87
93825;126101;Szkoła Podstawowa Nr 124|Kraków|ul. Weigla 2 |30-898 ;1483;910;910;17;893;61.36;1.87
93826;126101;Szkoła Podstawowa Nr 111|Kraków|ul. Bieżanowska 204 |30-856 ;1416;899;899;18;881;63.49;2.00
93827;126101;Zespół Szkół Ogólnokształcących Nr 12|Kraków|ul. Telimeny 9 |30-838 ;1413;843;843;5;838;59.66;0.59
93828;126101;Zespół Szkół Ogólnokształcących Nr 12|Kraków|ul. Telimeny 9 |30-838 ;1429;873;873;9;864;61.09;1.03
93829;126101;Zespół Szkół Ogólnokształcących Nr 12|Kraków|ul. Telimeny 9 |30-838 ;1062;605;605;9;596;56.97;1.49
93830;126101;Gimnazjum Nr 29|Kraków|ul. Aleksandry 17 |30-837 ;2032;1257;1257;16;1241;61.86;1.27
93831;126101;Gimnazjum Nr 29|Kraków|ul. Aleksandry 17 |30-837 ;1054;643;643;10;633;61.01;1.56
93832;126101;Szkoła Podstawowa nr 24|Kraków|ul. Aleksandry 17 |30-837 ;1001;619;619;6;613;61.84;0.97
93833;126101;Szkoła Podstawowa Nr 24|Kraków|ul. Aleksandry 17 |30-837 ;902;585;585;8;577;64.86;1.37
93834;126101;Szkoła Podstawowa Nr 24|Kraków|ul. Aleksandry 17 |30-837 ;1901;1150;1150;5;1145;60.49;0.43
93835;126101;Szkoła Podstawowa Nr 41|Kraków|ul. Jerzmanowskiego 6 |30-836 ;957;600;600;8;592;62.70;1.33
93836;126101;Szkoła Podstawowa Nr 41|Kraków|ul. Jerzmanowskiego 6 |30-836 ;1145;688;688;10;678;60.09;1.45
93837;126101;Szkoła Podstawowa Nr 41|Kraków|ul. Jerzmanowskiego 6 |30-836 ;942;530;530;13;517;56.26;2.45
93838;126101;Szkoła Podstawowa Nr 41|Kraków|ul. Jerzmanowskiego 6 |30-836 ;2047;1235;1236;11;1224;60.33;0.89
93839;126101;Szkoła Podstawowa Nr 117|Kraków|ul. Kurczaba 15 |30-868 ;1765;999;999;11;988;56.60;1.10
93840;126101;Szkoła Podstawowa Nr 117|Kraków|ul. Kurczaba 15 |30-886 ;1113;699;699;5;694;62.80;0.72
93841;126101;Szkoła Podstawowa Nr 117|Kraków|ul. Kurczaba 15 |30-868 ;1721;856;856;16;840;49.74;1.87
93842;126101;Szkoła Podstawowa Nr 117|Kraków|ul. Kurczaba 15 |30-868 ;1013;625;625;10;615;61.70;1.60
93843;126101;Zespół Szkół Ogólnokształcących Integracyjnych Nr 4|Kraków|ul. Żabia 20 |30-809 ;1250;815;815;11;804;65.20;1.35
93844;126101;Zespół Szkół Ogólnokształcących Integracyjnych Nr 4|Kraków|ul. Żabia 20 |30-809 ;1251;769;769;11;758;61.47;1.43
93845;126101;Zespół Szkół Ogólnokształcących Nr 15|Kraków|ul. Rydygiera 20 |30-695 ;880;528;528;6;522;60.00;1.14
93846;126101;Zespół Szkół Ogólnokształcących Nr 15|Kraków|ul. Rydygiera 20 |30-695 ;1864;1086;1086;15;1071;58.26;1.38
93847;126101;Młodzieżowy Dom Kultury - Filia|Kraków|ul. Na Wrzosach 57 |30-816 ;1912;1188;1189;13;1175;62.13;1.09
93848;126101;Szkoła Podstawowa Nr 61|Kraków|ul. Popławskiego 17 |30-818 ;1192;779;779;8;771;65.35;1.03
93849;126101;Szkoła Podstawowa Nr 61|Kraków|ul. Popławskiego 17 |30-818 ;750;474;474;7;467;63.20;1.48
93850;126101;Szkoła Podstawowa Nr 61|Kraków|ul. Popławskiego 17 |30-818 ;566;357;357;3;354;63.07;0.84
93851;126101;Zespół Szkół Ogólnokształcących Nr 10 XV Liceum Ogólnokształcące|Kraków|al. Dygasińskiego 15 |30-820 ;1753;1191;1191;12;1179;67.94;1.01
93852;126101;Zespół Szkół Ogólnokształcących Nr 10 XV Liceum Ogólnokształcące|Kraków|al. Dygasińskiego 15 |30-820 ;1427;821;821;11;810;57.53;1.34
93853;126101;Szkoła Podstawowa Nr 123|Kraków|ul. Okólna 16 |30-669 ;1678;880;880;25;855;52.44;2.84
93854;126101;Szkoła Podstawowa Nr 123|Kraków|ul. Okólna 16 |30-669 ;1298;678;678;7;671;52.23;1.03
93855;126101;Szkoła Podstawowa Nr 123|Kraków|ul. Okólna 16 |30-669 ;1292;575;575;9;566;44.50;1.57
93856;126101;KOSTKA Publiczne Gimnazjum Jezuitów im. Św. Stanisława Kostki|Kraków|ul. Spółdzielców 5 |30-682 ;1344;727;727;15;712;54.09;2.06
93857;126101;KOSTKA Publiczne Gimnazjum Jezuitów im. Św. Stanisława Kostki|Kraków|ul. Spółdzielców 5 |30-682 ;1803;1075;1075;19;1056;59.62;1.77
93858;126101;KOSTKA Publiczne Gimnazjum Jezuitów im. Św. Stanisława Kostki|Kraków|ul. Spółdzielców 5 |30-682 ;1230;710;710;12;698;57.72;1.69
93859;126101;Przedszkole Samorządowe nr 11|Kraków|ul. Saska 11 |30-715 ;1157;732;732;4;728;63.27;0.55
93860;126101;Przedszkole Samorządowe nr 11|Kraków|ul. Saska 11 |30-715 ;1349;855;855;16;839;63.38;1.87
93861;126101;Zespół Szkolno-Przedszkolny Nr 1|Kraków|ul. Myśliwska 64 |30-718 ;1702;1061;1061;7;1054;62.34;0.66
93862;126101;Zespół Szkolno-Przedszkolny Nr 1|Kraków|ul. Myśliwska 64 |30-718 ;1309;887;887;8;879;67.76;0.90
93863;126101;Zespół Szkolno-Przedszkolny Nr 1|Kraków|ul. Myśliwska 64 |30-718 ;1377;981;981;11;970;71.24;1.12
93864;126101;Zespół Szkolno-Przedszkolny Nr 1|Kraków|ul. Myśliwska 64 |30-718 ;1988;1278;1282;15;1263;64.29;1.17
93865;126101;Zespół Szkół Nr 2|Kraków|ul. Goszczyńskiego 44 |30-724 ;953;584;584;4;580;61.28;0.68
93866;126101;Zespół Szkół Nr 2|Kraków|ul. Goszczyńskiego 44 |30-724 ;1245;710;710;8;702;57.03;1.13
93867;126101;Szkoła Podstawowa Nr 65|Kraków|ul. Golikówka 52 |30-723 ;1141;621;621;15;606;54.43;2.42
93868;126101;Szkoła Podstawowa Nr 137|Kraków|ul. Wrobela 79 |30-798 ;1116;557;557;13;544;49.91;2.33
93869;126101;Szkoła Podstawowa Nr 26|Kraków|ul. Krasickiego 34 |30-515 ;966;595;595;5;590;61.59;0.84
93870;126101;Szkoła Podstawowa Nr 26|Kraków|ul. Krasickiego 34 |30-515 ;1141;705;705;3;702;61.79;0.43
93871;126101;Dom Kultury "PODGÓRZE"|Kraków|ul. Sokolska 13 |30-510 ;563;341;341;2;339;60.57;0.59
93872;126101;Ośrodek Szkolno-Wychowawczy Nr 2 im. J. Korczaka|Kraków|ul. Zamoyskiego 100 |30-523 ;886;531;531;4;527;59.93;0.75
93873;126101;Urząd Miasta Krakowa|Kraków|Rynek Podgórski 1 |30-533 ;938;540;542;5;535;57.57;0.93
93874;126101;Szkoła Podstawowa Nr 29|Kraków|al. Dembowskiego 12 |30-540 ;541;330;330;3;327;61.00;0.91
93875;126101;Gimnazjum Nr 35|Kraków|ul. Limanowskiego 60/62 |30-534 ;688;433;434;6;427;62.94;1.39
93876;126101;Gimnazjum Nr 35|Kraków|ul. Limanowskiego 60/62 |30-534 ;1227;729;729;7;722;59.41;0.96
93877;126101;Gimnazjum Nr 35|Kraków|ul. Limanowskiego 60/62 |30-551 ;759;433;433;3;430;57.05;0.69
93878;126101;Gimnazjum Nr 35|Kraków|ul. Limanowskiego 60/62 |30-551 ;785;451;451;8;443;57.45;1.77
93879;126101;Gimnazjum Nr 34|Kraków|ul. Potebni 7 |30-537 ;1037;584;584;6;578;56.32;1.03
93880;126101;Szkoła Muzyczna I i II Stopnia|Kraków|ul. Józefińska 10 |30-529 ;1360;764;764;18;746;56.18;2.36
93881;126101;Niepubliczny Zakład Opieki Zdrowotnej Krakowskie Centrum Terapii Uzależnień|Kraków|ul. Wielicka 73 |30-552 ;2039;1355;1355;4;1351;66.45;0.30
93882;126101;Urząd Miasta Krakowa|Kraków|ul. Wielicka 28a |30-552 ;1428;824;824;15;809;57.70;1.82
93883;126101;Zespół Szkół Mechanicznych Nr 2|Kraków|al. Skrzyneckiego 12 |30-363 ;788;551;551;3;548;69.92;0.54
93884;126101;Szkoła Podstawowa Nr 156|Kraków|ul. Centralna 39 |31-586 ;1205;742;742;6;736;61.58;0.81
93885;126101;Szkoła Podstawowa Nr 156|Kraków|ul. Centralna 39 |31-586 ;1897;1174;1174;13;1161;61.89;1.11
93886;126101;Szkoła Podstawowa Nr 156|Kraków|ul. Centralna 39 |31-586 ;1070;700;700;6;694;65.42;0.86
93887;126101;Gimnazjum Nr 48|Kraków|os. Kolorowe 29 |31-941 ;1251;701;701;15;686;56.04;2.14
93888;126101;Gimnazjum Nr 48|Kraków|os. Kolorowe 29 |31-941 ;1580;886;886;12;874;56.08;1.35
93889;126101;Zespół Szkół Nr 1|Kraków|Ułanów 3 |31-450 ;746;529;529;5;524;70.91;0.95
93890;126101;Szkoła Podstawowa Nr 155|Kraków|os. 2 Pułku Lotniczego 21 |31-869 ;2069;1430;1430;2;1428;69.12;0.14
93891;126101;Szkoła Podstawowa Nr 155|Kraków|os. 2 Pułku Lotniczego 21 |31-869 ;1625;930;930;10;920;57.23;1.08
93892;126101;Szkoła Podstawowa Nr 155|Kraków|os. 2 Pułku Lotniczego 21 |31-869 ;2168;1450;1450;16;1434;66.88;1.10
93893;126101;Zespół Szkół Ogólnokształcących Nr 14|Kraków|os. Dywizjonu 303 66 |31-875 ;1087;769;769;3;766;70.75;0.39
93894;126101;Zespół Szkół Ogólnokształcących Nr 14|Kraków|os. Dywizjonu 303 66 |31-875 ;1216;777;777;5;772;63.90;0.64
93895;126101;Zespół Szkół Ogólnokształcących Nr 14|Kraków|os. Dywizjonu 303 66 |31-875 ;1144;763;763;5;758;66.70;0.66
93896;126101;Zespół Szkół Ogólnokształcących Nr 14|Kraków|os. Dywizjonu 303 66 |31-875 ;1121;711;711;14;697;63.43;1.97
93897;126101;Zespół Szkół Ogólnokształcących Nr 14|Kraków|os. Dywizjonu 303 66 |31-875 ;1030;649;649;7;642;63.01;1.08
93898;126101;Zespół Szkół Ogólnokształcących Nr 14|Kraków|os. Dywizjonu 303 66 |31-875 ;1163;792;792;13;779;68.10;1.64
93899;126101;Urząd Miasta Krakowa Archiwum|Kraków|ul. Na Załęczu 2 |31-465 ;623;363;363;10;353;58.27;2.75
93900;126101;Międzynarodowe Centrum Kształcenia|Kraków|ul. Skarżyńskiego 1 |31-866 ;942;738;738;7;731;78.34;0.95
93901;126101;Przedszkole Samorządowe Nr 177|Kraków|os. Kombatantów 13 |31-630 ;1976;1179;1179;21;1158;59.67;1.78
93902;126101;Młodzieżowy Dom Kultury im. A. Bursy|Kraków|os. Tysiąclecia 15 |31-606 ;1477;909;909;8;901;61.54;0.88
93903;126101;Młodzieżowy Dom Kultury im. A . Bursy|Kraków|os. Tysiąclecia 15 |31-606 ;1326;804;804;10;794;60.63;1.24
93904;126101;Młodzieżowy Dom Kultury im. A. Bursy|Kraków|os. Tysiąclecia 15 |31-606 ;1520;1012;1012;5;1007;66.58;0.49
93905;126101;Szkoła Podstawowa Nr 126|Kraków|os. Tysiąclecia 57 |31-610 ;1505;985;985;14;971;65.45;1.42
93906;126101;Szkoła Podstawowa Nr 126|Kraków|os. Tysiąclecia 57 |31-610 ;1344;864;864;4;860;64.29;0.46
93907;126101;Zespół Szkolno-Przedszkolny Nr 5|Kraków|os. Oświecenia 30 |31-636 ;1751;1214;1214;7;1207;69.33;0.58
93908;126101;Zespół Szkolno-Przedszkolny Nr 5|Kraków|os. Oświecenia 30 |31-636 ;1216;771;771;18;753;63.40;2.33
93909;126101;Zespół Szkolno-Przedszkolny Nr 5|Kraków|os. Oświecenia 30 |31-636 ;1349;835;835;16;819;61.90;1.92
93910;126101;Zespół Szkolno-Przedszkolny Nr 5|Kraków|os. Oświecenia 30 |31-636 ;1144;764;764;10;754;66.78;1.31
93911;126101;Zespół Szkolno-Przedszkolny Nr 5|Kraków|os. Oświecenia 30 |31-636 ;1496;986;986;8;978;65.91;0.81
93912;126101;Ośrodek Kultury im. C. K. Norwida "Kuźnia"|Kraków|os. Złotego Wieku 14 |31-616 ;1521;924;924;9;915;60.75;0.97
93913;126101;Ośrodek Kultury im. C. K. Norwida "Kuźnia"|Kraków|os. Złotego Wieku 14 |31-616 ;1900;1174;1174;13;1161;61.79;1.11
93914;126101;Gimnazjum Nr 37|Kraków|os. Złotego Wieku 36 |31-618 ;1215;727;727;15;712;59.84;2.06
93915;126101;Gimnazjum Nr 37|Kraków|os. Złotego Wieku 36 |31-618 ;1740;1016;1016;10;1006;58.39;0.98
93916;126101;Szkoła Podstawowa Nr 85|Kraków|os. Złotego Wieku 4 |31-615 ;1862;1287;1287;8;1279;69.12;0.62
93917;126101;Szkoła Podstawowa Nr 85|Kraków|os. Złotego Wieku 4 |31-615 ;1541;984;984;19;965;63.85;1.93
93918;126101;Szkoła Podstawowa z Oddziałami Integracyjnymi Nr 144|Kraków|os. Bohaterów Września 13 |31-620 ;1275;862;862;9;853;67.61;1.04
93919;126101;Szkoła Podstawowa z Oddziałami Integracyjnymi Nr 144|Kraków|os. Bohaterów Września 13 |31-620 ;1098;517;517;14;503;47.09;2.71
93920;126101;Szkoła Podstawowa z Oddziałami Integracyjnymi Nr 144|Kraków|os. Bohaterów Września 13 |31-620 ;1417;899;899;13;886;63.44;1.45
93921;126101;Szkoła Podstawowa z Oddziałami Integracyjnymi Nr 144|Kraków|os. Bohaterów Września 13 |31-620 ;1052;638;638;12;626;60.65;1.88
93922;126101;Szkoła Podstawowa z Oddziałami Integracyjnymi Nr 144|Kraków|os. Bohaterów Września 13 |31-620 ;1221;708;708;10;698;57.99;1.41
93923;126101;Szkoła Podstawowa Nr 89|Kraków|os. Piastów 34A |31-624 ;1825;1110;1110;17;1093;60.82;1.53
93924;126101;Szkoła Podstawowa Nr 89|Kraków|os. Piastów 34A |31-624 ;1980;964;964;20;944;48.69;2.07
93925;126101;Szkoła Podstawowa Nr 89|Kraków|os. Piastów 34A |31-624 ;1701;845;845;14;831;49.68;1.66
93926;126101;Szkoła Podstawowa Nr 89|Kraków|os. Piastów 34A |31-624 ;1945;1103;1103;30;1073;56.71;2.72
93927;126101;Zespół Szkół Salezjańskich|Kraków|os. Piastów 34 |31-624 ;1939;1208;1208;15;1193;62.30;1.24
93928;126101;Zespół Szkół Salezjańskich|Kraków|os. Piastów 34 |31-624 ;1171;727;727;9;718;62.08;1.24
93929;126101;Zespół Szkół Salezjańskich|Kraków|os. Piastów 34 |31-624 ;1027;627;627;10;617;61.05;1.59
93930;126101;Publiczna Szkoła Podstawowa Sióstr Salezjanek im. Błogosławionej Laury Vicuna|Kraków|os. Kościuszkowskie 7 |31-858 ;1033;652;652;10;642;63.12;1.53
93931;126101;Publiczna Szkoła Podstawowa Sióstr Salezjanek im. Błogosławionej Laury Vicuna|Kraków|os. Kościuszkowskie 7 |31-858 ;1144;707;707;11;696;61.80;1.56
93932;126101;III Liceum Ogólnokształcące|Kraków|os. Wysokie 6 |31-818 ;977;522;522;7;515;53.43;1.34
93933;126101;III Liceum Ogólnokształcące|Kraków|os. Wysokie 6 |31-818 ;1209;636;636;14;622;52.61;2.20
93934;126101;Szkoła Podstawowa Nr 104|Kraków|os. Wysokie 7 |31-819 ;1360;686;686;12;674;50.44;1.75
93935;126101;Szkoła Podstawowa Nr 104|Kraków|os. Wysokie 7 |31-819 ;1756;1060;1060;19;1041;60.36;1.79
93936;126101;Gimnazjum Nr 42|Kraków|os. Strusia 19 |31-810 ;1360;772;772;18;754;56.76;2.33
93937;126101;Gimnazjum Nr 42|Kraków|os. Strusia 19 |31-810 ;1439;831;831;10;821;57.75;1.20
93938;126101;Szkoła Podstawowa Nr 82|Kraków|os. Kalinowe 17 |31-814 ;1126;595;595;12;583;52.84;2.02
93939;126101;Szkoła Podstawowa Nr 92|Kraków|os. Kalinowe 18 |31-814 ;1011;471;471;10;461;46.59;2.12
93940;126101;Szkoła Podstawowa Nr 92|Kraków|os. Kalinowe 18 |31-814 ;1680;876;876;20;856;52.14;2.28
93941;126101;Gimnazjum im. Bogdana Jańskiego|Kraków|os. Niepodległości 19 |31-862 ;1088;670;670;7;663;61.58;1.04
93942;126101;Gimnazjum im. Bogdana Jańskiego|Kraków|os. Niepodległości 19 |31-862 ;1057;658;658;9;649;62.25;1.37
93943;126101;Szkoła Podstawowa Nr 100|Kraków|os. Albertyńskie 36 |31-855 ;1294;720;720;8;712;55.64;1.11
93944;126101;Szkoła Podstawowa Nr 100|Kraków|os. Albertyńskie 36 |31-855 ;1539;829;829;25;804;53.87;3.02
93945;126101;Szkoła Podstawowa Nr 100|Kraków|os. Albertyńskie 36 |31-855 ;1146;715;715;12;703;62.39;1.68
93946;126101;Szkoła Podstawowa Nr 86|Kraków|os. Jagiellońskie 18 |31-834 ;1230;787;787;11;776;63.98;1.40
93947;126101;Szkoła Podstawowa Nr 86|Kraków|os. Jagiellońskie 18 |31-834 ;1011;586;586;10;576;57.96;1.71
93948;126101;Szkoła Podstawowa Nr 86|Kraków|os. Jagiellońskie 18 |31-834 ;1282;689;689;10;679;53.74;1.45
93949;126101;Zespół Szkół Gastronomicznych Nr 1|Kraków|os. Złotej Jesieni 16 |31-828 ;492;265;265;3;262;53.86;1.13
93950;126101;Zespół Szkół Gastronomicznych Nr 1|Kraków|os. Złotej Jesieni 16 |31-828 ;1173;735;736;10;725;62.66;1.36
93951;126101;Zespół Szkół Gastronomicznych Nr 1|Kraków|os. Złotej Jesieni 16 |31-828 ;1091;636;637;9;627;58.30;1.42
93952;126101;Zespół Szkół Zawodowych Huty im.T. Sendzimira|Kraków|os. Złotej Jesieni 2 |31-826 ;1115;674;674;9;665;60.45;1.34
93953;126101;Zespół Szkół Zawodowych Huty im. T. Sendzimira|Kraków|os. Złotej Jesieni 2 |31-826 ;1307;751;751;16;735;57.46;2.13
93954;126101;Szkoła Podstawowa Nr 101|Kraków|os. Jagiellońskie 9 |31-832 ;2090;1145;1145;20;1125;54.78;1.75
93955;126101;Szkoła Podstawowa Nr 101|Kraków|os. Jagiellońskie 9 |31-832 ;1519;735;735;17;718;48.39;2.31
93956;126101;Szkoła Podstawowa Nr 101|Kraków|os. Jagiellońskie 9 |31-832 ;1738;848;848;14;834;48.79;1.65
93957;126101;Szkoła Podstawowa Nr 101|Kraków|os. Jagiellońskie 9 |31-832 ;1390;725;725;13;712;52.16;1.79
93958;126101;Ośrodek Kultury Kraków Nowa Huta Klub "KRZESŁAWICE"|Kraków|ul. Wańkowicza 17 |31-752 ;668;436;436;7;429;65.27;1.61
93959;126101;Szkoła Podstawowa Nr 129|Kraków|os. Na Wzgórzach 13A |31-722 ;1634;775;776;9;766;47.43;1.16
93960;126101;Szkoła Podstawowa Nr 129|Kraków|os. Na Wzgórzach 13A |31-722 ;875;416;416;8;408;47.54;1.92
93961;126101;Szkoła Podstawowa Nr 129|Kraków|os. Na Wzgórzach 13A |31-722 ;1354;661;662;14;647;48.82;2.12
93962;126101;Zespół Szkół Ogólnokształcących Integracyjnych Nr 6|Kraków|os. Na Stoku 52 |31-708 ;1722;946;946;15;931;54.94;1.59
93963;126101;Gimnazjum Nr 44|Kraków|os. Na Stoku 34 |31-706 ;1727;963;963;18;945;55.76;1.87
93964;126101;Gimnazjum Nr 44|Kraków|os. Na Stoku 34 |31-706 ;2126;1408;1408;9;1399;66.23;0.64
93965;126101;Gimnazjum Nr 44|Kraków|os. Na Stoku 34 |31-706 ;1028;585;585;9;576;56.91;1.54
93966;126101;Ośrodek Kultury Kraków Nowa Huta Klub "Dukat"|Kraków|ul. Styczna 1 (Grębałów) |31-764 ;1574;937;937;15;922;59.53;1.60
93967;126101;Gimnazjum Nr 43|Kraków|ul. Łuczanowicka 2A |31-766 ;744;371;371;6;365;49.87;1.62
93968;126101;Szkoła Podstawowa Nr 78|Kraków|ul. Jaskrowa 5 |31-990 ;2081;1163;1163;20;1143;55.89;1.72
93969;126101;Miejski Ośrodek Pomocy Społecznej w Krakowie, Filia nr 9 Program Aktywności Lokalnej ZIK|Kraków|ul. Morcinka 15 |31-762 ;1225;647;647;13;634;52.82;2.01
93970;126101;Zespół Szkół Ogólnokształcących Nr 52|Kraków|ul. Sawy-Calińskiego 12 |31-999 ;1431;643;643;28;615;44.93;4.35
93971;126101;Ośrodek Kultury Kraków Nowa Huta Klub "Jędruś"|Kraków|os. Centrum A 6A |31-923 ;1876;1014;1014;21;993;54.05;2.07
93972;126101;Zespół Szkół Ogólnokształcących Nr 19|Kraków|os. Willowe 1 |31-901 ;1542;846;846;18;828;54.86;2.13
93973;126101;Zespół Szkół Ogólnokształcących Nr 19|Kraków|os. Willowe 1 |31-901 ;1206;628;628;11;617;52.07;1.75
93974;126101;Ośrodek Kultury Kraków Nowa Huta Klub "Wersalik"|Kraków|os. Ogrodowe 15 |31-916 ;1297;750;750;4;746;57.83;0.53
93975;126101;Szkoła Podstawowa Nr 80|Kraków|os. Na Skarpie 8 |31-909 ;1659;836;836;13;823;50.39;1.56
93976;126101;Szkoła Podstawowa Nr 80|Kraków|os. Na Skarpie 8 |31-909 ;1041;671;671;6;665;64.46;0.89
93977;126101;Szkoła Podstawowa Nr 80|Kraków|os. Na Skarpie 8 |31-909 ;1656;935;935;14;921;56.46;1.50
93978;126101;Szkoła Podstawowa Nr 37|Kraków|os. Stalowe 18 |31-922 ;1054;534;534;9;525;50.66;1.69
93979;126101;Szkoła Podstawowa Nr 37|Kraków|os. Stalowe 18 |31-922 ;1470;791;791;12;779;53.81;1.52
93980;126101;Rada i Zarząd Dzielnicy XVIII|Kraków|os. Centrum B 6 |31-927 ;1869;1054;1054;19;1035;56.39;1.80
93981;126101;Szkoła Podstawowa Nr 88|Kraków|os. Szklane Domy 2 |31-972 ;697;401;401;6;395;57.53;1.50
93982;126101;Zespół Szkół Ogólnokształcących Integracyjnych Nr 5|Kraków|os. Słoneczne 12 |31-957 ;1469;788;788;17;771;53.64;2.16
93983;126101;Filia Młodzieżowego Domu Kultury im. J. Korczaka|Kraków|os. Szkolne 5 |31-956 ;1571;832;832;18;814;52.96;2.16
93984;126101;Zespół Szkół Elektrycznych Nr 2|Kraków|os. Szkolne 26 |31-958 ;971;505;505;6;499;52.01;1.19
93985;126101;Zespół Szkół Zawodowych Nr 2|Kraków|os. Szkolne 18 |31-958 ;1733;900;903;7;893;51.93;0.78
93986;126101;Zespół Szkół Zawodowych Nr 2|Kraków|os. Szkolne 18 |31-977 ;964;493;499;11;482;51.14;2.23
93987;126101;Miejski Ośrodek Wspierania Inicjatyw Społecznych (wejście do lokalu wyborczego przez podjazd dla osób niepełnosprawnych)|Kraków|os. Centrum C 10 |31-931 ;1487;811;811;14;797;54.54;1.73
93988;126101;Ośrodek Kultury Kraków Nowa Huta|Kraków|os. Zgody 1 |31-949 ;1422;811;811;14;797;57.03;1.73
93989;126101;Zespół Szkół Ogólnokształcących Sportowych nr 2|Kraków|os.Teatralne 35 |31-948 ;1565;852;852;15;837;54.44;1.76
93990;126101;Zespół Szkół Ogólnokształcących Sportowych nr 2|Kraków|os. Teatralne 35 |31-948 ;926;510;510;17;493;55.08;3.33
93991;126101;Ośrodek Kultury im. C. K. Norwida|Kraków|os. Górali 5 |31-959 ;1182;662;662;13;649;56.01;1.96
93992;126101;Szkoła Podstawowa im.Św.Wincentego Pallotiego|Kraków|os. Krakowiaków 47 |31-964 ;1061;600;600;18;582;56.55;3.00
93993;126101;Szkoła Podstawowa im.Św.Wincentego Pallotiego|Kraków|os. Krakowiaków 47 |31-964 ;1144;667;669;16;651;58.30;2.40
93994;126101;Zespół Szkół Ogólnokształcących Nr 2|Kraków|os. Teatralne 33 |31-948 ;1476;797;797;17;780;54.00;2.13
93995;126101;Zespół Szkół Ogólnokształcących Sportowych Nr 1|Kraków|os. Handlowe 4 |31-935 ;1215;701;701;8;693;57.70;1.14
93996;126101;Zespół Szkół Ogólnokształcących Sportowych Nr 1|Kraków|os. Handlowe 4 |31-935 ;1061;609;609;10;599;57.40;1.64
93997;126101;Gimnazjum Nr 48|Kraków|os. Kolorowe 29 |31-941 ;1557;899;899;13;886;57.74;1.45
93998;126101;Gimnazjum Nr 48|Kraków|os. Kolorowe 29 |31-941 ;1554;930;930;17;913;59.85;1.83
93999;126101;Zespół Szkół Ekonomicznych Nr 2|Kraków|os. Spółdzielcze 6 |31-943 ;1146;677;677;10;667;59.08;1.48
94000;126101;Zespół Szkół Specjalnych Nr 6|Kraków|ul. Ptaszyckiego 9 |31-979 ;1621;988;989;11;977;60.95;1.11
94001;126101;Szkoła Podstawowa Nr 74|Kraków|ul. Branicka 26 |31-985 ;739;380;380;14;366;51.42;3.68
94002;126101;Zespół Szkolno-Przedszkolny Nr 9|Kraków|ul. Prawocheńskiego 7 |31-998 ;1287;678;678;26;652;52.68;3.83
94003;126101;Szkoła Podstawowa nr 142|Kraków|ul. Drożyska 13 (os. Wolica) |31-998 ;1010;486;486;13;473;48.12;2.67
94004;126101;Towarzystwo Przyjaciół Ziemi Pleszowskiej Świetlica Osiedlowa|Kraków|ul. Nadbrzezie 18 |31-983 ;323;137;137;4;133;42.41;2.92
94005;126101;SP ZOZ Szpital Uniwersytecki w Krakowie (oddziały kliniczne zlokalizowane przy ul. Skawińskiej 8)|Kraków|ul. Skawińska 8 |32-066 ;99;75;75;3;72;75.76;4.00
94006;126101;SZPITAL ZAKONU BONIFRATRÓW ŚW. JANA GRANDEGO W KRAKOWIE SP. Z O.O.|Kraków|ul. Trynitarska 11 |31-061 ;55;26;26;0;26;47.27;0.00
94007;126101;CENTRUM ONKOLOGII INSTYTUT IM. M. SKŁODOWSKIEJ-CURIE Oddział w Krakowie|Kraków|ul. Garncarska 11 |31-115 ;154;72;72;4;68;46.75;5.56
94008;126101;DOM POMOCY SPOŁECZNEJ, UL. KRAKOWSKA 43, 45, 47, 53, 55|Kraków|ul. Krakowska 55 |31-066 ;168;150;150;0;150;89.29;0.00
94009;126101;SZPITAL SPECJALISTYCZNY IM. J. DIETLA W KRAKOWIE|Kraków|ul. Skarbowa 1 |31-121 ;208;94;94;2;92;45.19;2.13
94010;126101;Dom Pomocy Społecznej|Kraków|ul. Helclów 2 |31-137 ;317;116;116;13;103;36.59;11.21
94011;126101;Areszt Śledczy Kraków|Kraków|ul. Montelupich 7 |31-148 ;568;321;321;44;277;56.51;13.71
94012;126101;Dom Pomocy Społecznej|Kraków|ul. Radziwiłłowska 8 |31-155 ;60;36;36;2;34;60.00;5.56
94013;126101;SP ZOZ Szpital Uniwersytecki w Krakowie (Oddziały Kliniczne zlokalizowane przy: ul. Botanicznej 3, Kopernika 21, Kopernika 23, Kopernika 50)|Kraków|ul. Kopernika 23 |31-026 ;232;93;93;4;89;40.09;4.30
94014;126101;SP ZOZ SZPITAL UNIWERSYTECKI W KRAKOWIE Oddziały Kliniczne zlokalizowane przy: ul. Kopernika 15, Kopernika 15C, Kopernika 17, Kopernika 36, Kopernika 38, Kopernika 40)|Kraków|ul. Kopernika 36 |31-501 ;241;119;119;2;117;49.38;1.68
94015;126101;SP ZOZ Szpital Uniwersytecki w Krakowie (Oddziały Kliniczne zlokalizowane przy: ul. Grzegórzeckiej 18, Kopernika 21A, Śniadeckich 2, Śniadeckich 5, Śniadeckich 10)|Kraków|ul. Sniadeckich 10 |31-502 ;265;128;128;7;121;48.30;5.47
94016;126101;Zakład Opiekuńczo Lecznicy prowadzony przez zgromadzenie Sióstr Felicjanek|Kraków|ul. Kołłataja 7 |31-502 ;74;32;32;0;32;43.24;0.00
94017;126101;DOM POMOCY SPOŁECZNEJ|Kraków|ul. Rozrywka 1 |31-419 ;40;22;22;1;21;55.00;4.55
94018;126101;KRAKOWSKI SZPITAL SPECJALISTYCZNY IM. JANA PAWŁA II|Kraków|ul. Prądnicka 80 |31-202 ;339;167;167;9;158;49.26;5.39
94019;126101;SZPITAL MIEJSKI SPECJALISTYCZNY IM. GABRIELA NARUTOWICZA W KRAKOWIE|Kraków|ul. Prądnicka 35-37 |31-202 ;342;93;93;6;87;27.19;6.45
94020;126101;DOM POMOCY SPOŁECZNEJ|Kraków|ul. Kluzeka 6 |31-222 ;89;45;45;3;42;50.56;6.67
94021;126101;ZAKŁAD OPIEKUŃCZO-LECZNICZY BONA-MED SP. Z O.O.|Kraków|ul. Księdza Siemaszki 17C |31-207 ;103;19;19;0;19;18.45;0.00
94022;126101;Dom Studencki Bydgoska, Dom Studencki Nawojka, Dom Studencki Piast, Dom Studencki Żaczek|Kraków|ul. Bydgoska 19 |30-056 ;511;451;451;2;449;88.26;0.44
94023;126101;SP ZOZ Ministerstwa Spraw Wewnętrznych w Krakowie|Kraków|ul. Kronikarza Galla 25 |30-053 ;77;38;38;1;37;49.35;2.63
94024;126101;5 Wojskowy Szpital Kliniczny z Polikliniką Sp ZOZ w Krakowie|Kraków|ul. Wrocławska 1-3 |30-006 ;179;79;79;4;75;44.13;5.06
94025;126101;Małopolskie Centrum Reumatologii Immunologii i Rehabilitacji Oddział Reumatologii|Kraków|al. Focha 33 |30-119 ;68;45;45;3;42;66.18;6.67
94026;126101;KRAKOWSKIE CENTRUM REHABILITACJI I ORTOPEDII|KRAKÓW|AL. MODRZEWIOWA 22 |30-224 ;107;59;59;3;56;55.14;5.08
94027;126101;DOM POMOCY SPOŁECZNEJ|Kraków|Praska 25 |30-328 ;80;32;32;4;28;40.00;12.50
94028;126101;DOM POMOCY SPOŁECZNEJ ŚW. BRATA ALBERTA|Kraków|Nowaczyńskiego 1 |30-336 ;137;60;60;3;57;43.80;5.00
94029;126101;DOM POMOCY SPOŁECZNEJ SIÓSTR SŁUŻEBNICZEK STAROWIEJSKICH|kRAKÓW|PODGÓRKI TYNIECKIE 96 |30-398 ;49;40;40;0;40;81.63;0.00
94030;126101;DOM POMOCY SPOŁECZNEJ, UL. DOKTORA BABIŃSKIEGO 25|KRAKÓW|DOKTORA BABIŃSKIEGO 25 |30-393 ;41;24;24;1;23;58.54;4.17
94031;126101;SZPITAL SPECJALISTYCZNY im. DR JÓZEFA BABIŃSKIEGO SP ZOZ W KRAKOWIE|KRAKÓW|DOKTORA BABIŃSKIEGO 29 |30-698 ;781;246;246;16;230;31.50;6.50
94032;126101;UZDROWISKO KRAKÓW SWOSZOWICE SP. Z O.O.|KRAKÓW|KĄPIELOWA 70 |30-698 ;67;49;49;4;45;73.13;8.16
94033;126101;SZPITAL ŚW. RAFAŁA SP. Z O.O.|KRAKÓW|BOCHENKA 12 |30-693 ;50;32;32;0;32;64.00;0.00
94034;126101;ZAKŁAD OPIEKUŃCZO-LECZNICZY W KRAKOWIE SP. ZOZ|KRAKÓW|WIELICKA 267 |30-663 ;447;91;91;4;87;20.36;4.40
94035;126101;ARESZT ŚLEDCZY W KRAKOWIE|KRAKÓW|CZARNIECKIEGO 3 |30-536 ;178;113;113;9;104;63.48;7.96
94036;126101;DOM POMOCY SPOŁECZNEJ ZAKONU PRZENAJŚWIĘTSZEJ TRÓJCY|KRAKÓW|ŁANOWA 1B |30-725 ;35;23;23;2;21;65.71;8.70
94037;126101;DOM POMOCY SPOŁECZNEJ, UL. ŁANOWA 39, 43|KRAKÓW|ŁANOWA 39 |30-725 ;143;30;30;4;26;20.98;13.33
94038;126101;DOM POMOCY SPOŁECZNEJ (BUDYNKI: UL. ŁANOWA 41,41A,41B,43D,43E)|KRAKÓW|ŁANOWA 41 |30-725 ;204;57;57;7;50;27.94;12.28
94039;126101;DOM POMOCY SPOŁECZNEJ IM. WŁADYSŁAWA GODYNIA W KRAKOWIE|Kraków|ul. Sołtysowska 13D |30-589 ;66;29;29;7;22;43.94;24.14
94040;126101;SZPITAL SPECJALISTYCZNY IM.LUDWIKA RYDYGIERA W KRAKOWIE SP.Z O.O ODDZIAŁY: ANESTEZJOLOGII, GINEKOLOGII I POŁOŻNICTWA, ONKOLOGII KLINICZNEJ, RADIOTERAPII, ORTOPEDII I TRAUMATOLOGII NARZĄDU RUCHU, UROLOGII, OTOLARYNGOLOGII, TOKSYKOLOGII, DERMATOLOGII, CHIRURGII OGÓLNEJ I ONKOLOGICZNEJ, HEMATOLOGII I CHORÓB WEWNĘTRZNYCH/|KRAKÓW|os. Złotej Jesieni 1 |31-826 ;217;96;96;7;89;44.24;7.29
94041;126101;SZPITAL SPECJALISTYCZNY IM. LUDWIKA RYDYGIERA W KRAKOWIE SP. Z O.O./ODDZIAŁY:REHABILITACJI NEUROLOGICZNEJ I OGÓLNOUSTROJOWEJ, OPARZEŃ I CHIRURGII PLASTYCZNEJ, PSYCHIATRII, CHIRURGII SZCZĘKOWO-TWARZOWEJ ,URAZÓW WIELONARZĄDOWYCH i NEUROORTOPEDII, NEUROLOGII I UDARÓW MÓZGU, OKULISTYKI, KARDIOLOGII, CHORÓB WEWNĘTRZNYCH/|Kraków|os. Złotej Jesieni 1 |31-826 ;213;81;81;4;77;38.03;4.94
94042;126101;ZAKŁAD KARNY KRAKÓW - NOWA HUTA|Kraków|ul. Spławy 2 |31-987 ;234;121;121;8;113;51.71;6.61
94043;126101;DOM POMOCY SPOŁECZNEJ|Kraków|os. Sportowe 9 |31-965 ;42;26;26;3;23;61.90;11.54
94044;126101;DOM POMOCY SPOŁECZNEJ|Kraków|os. Szkolne 28 |31-978 ;32;21;21;1;20;65.62;4.76
94045;126101;CENTRUM MEDYCZNE UJASTEK SP. Z O.O.|Kraków|ul. Ujastek 3 |31-752 ;105;36;36;0;36;34.29;0.00
94046;126101;SZPITAL SPECJALISTYCZNY IM. STEFANA ŻEROMSKIEGO SP ZOZ W KRAKOWIE|Kraków|os. Na Skarpie 66 |31-913 ;205;95;95;0;95;46.34;0.00
94047;126201;Świetlica Osiedlowa|Nowy Sącz|ul. Starowiejska 2 |33-300 Nowy Sącz;1433;862;862;11;851;60.15;1.28
94048;126201;Miejskie Przedszkole Nr 7|Nowy Sącz|ul. Krakowska 50 |33-300 Nowy Sącz;2014;1165;1165;21;1144;57.85;1.80
94049;126201;Zespół Szkół Nr 4|Nowy Sącz|ul. Św. Ducha 6 |33-300 Nowy Sącz;1000;510;510;8;502;51.00;1.57
94050;126201;Gimnazjm Nr 11|Nowy Sącz|ul. Długosza 2 |33-300 Nowy Sącz;869;460;460;10;450;52.93;2.17
94051;126201;Zespół Szkół Ogólnokształcących Nr 2 im. M. Konopnickiej|Nowy Sącz|ul. Żeromskiego 16 |33-300 Nowy Sącz;1404;789;789;12;777;56.20;1.52
94052;126201;Okręgowa Spółdzielnia Mleczarska|Nowy Sącz|ul. Flisaków 1 |33-300 Nowy Sącz;1398;899;899;8;891;64.31;0.89
94053;126201;Szkoła Podstawowa Nr 3|Nowy Sącz|ul. Szkolna 9 |33-300 Nowy Sącz;1881;1114;1114;16;1098;59.22;1.44
94054;126201;Osiedlowy Dom Kultury|Nowy Sącz|ul. Kołłątaja 13 |33-300 Nowy Sącz;1860;1011;1011;16;995;54.35;1.58
94055;126201;Niepubliczne Przedszkole "Promyczek"|Nowy Sącz|ul. Żywiecka 72 |33-300 Nowy Sącz;1423;910;910;15;895;63.95;1.65
94056;126201;Specjalny Ośrodek Szkolno-Wychowawczy|Nowy Sącz|ul. Broniewskiego 1 |33-300 Nowy Sącz;1982;1115;1115;28;1087;56.26;2.51
94057;126201;Szkoła Podstawowa Nr 6|Nowy Sącz|ul. Tarnowska 109 |33-300 Nowy Sącz;937;532;532;8;524;56.78;1.50
94058;126201;Szkoła Podstawowa Nr 18|Nowy Sącz|ul. Broniewskiego 5 |33-300 Nowy Sącz;1098;602;602;12;590;54.83;1.99
94059;126201;Szkoła Podstawowa Nr 18|Nowy Sącz|ul. Broniewskiego 5 |33-300 Nowy Sącz;928;510;510;7;503;54.96;1.37
94060;126201;Specjalny Ośrodek Szkolno-Wychowawczy|Nowy Sącz|ul. Broniewskiego 1 |33-300 Nowy Sącz;1361;801;801;17;784;58.85;2.12
94061;126201;Niepubliczne Przedszkole "Jaś i Małgosia"|Nowy Sącz|ul. Broniewskiego 22 |33-300 Nowy Sącz;1466;765;765;22;743;52.18;2.88
94062;126201;Osiedlowy Klub Kultury "Bajka"|Nowy Sącz|ul. Westerplatte 23 |33-300 Nowy Sącz;1328;736;736;11;725;55.42;1.49
94063;126201;Przedszkole Nr 18|Nowy Sącz|ul. Sucharskiego 56 |33-300 Nowy Sącz;1454;872;872;11;861;59.97;1.26
94064;126201;Państwowa Wyższa Szkoła Zawodowa|Nowy Sącz|ul. Chruślicka 6 |33-300 Nowy Sącz;1249;829;829;13;816;66.37;1.57
94065;126201;Państwowa Wyższa Szkoła Zawodowa|Nowy Sącz|ul. Chruślicka 6 |33-300 Nowy Sącz;1395;841;841;8;833;60.29;0.95
94066;126201;Szkoła Podstawowa Nr 20|Nowy Sącz|ul. Nadbrzeżna 77 |33-300 Nowy Sącz;1745;1107;1107;20;1087;63.44;1.81
94067;126201;Przedszkole Katolickie|Nowy Sącz|ul. Nadbrzeżna 12 |33-300 Nowy Sącz;871;544;544;5;539;62.46;0.92
94068;126201;Szkoła Podstawowa Nr 11|Nowy Sącz|ul. Gen. W. Długoszowskiego 126 |33-300 Nowy Sącz;1028;636;636;10;626;61.87;1.57
94069;126201;Zespół Szkół Samochodowych|Nowy Sącz|ul. Rejtana 18 |33-300 Nowy Sącz;1825;1135;1135;29;1106;62.19;2.56
94070;126201;Gimnazjum Nr 3|Nowy Sącz|ul. Kr. Jadwigi 29 |33-300 Nowy Sącz;1047;587;587;8;579;56.06;1.36
94071;126201;Gimnazjum Nr 3|Nowy Sącz|ul. Kr. Jadwigi 29 |33-300 Nowy Sącz;1089;659;659;9;650;60.51;1.37
94072;126201;Osiedlowy Klub Kultury "Piast"|Nowy Sącz|ul. Nawojowska 3 |33-300 Nowy Sącz;1555;924;924;16;908;59.42;1.73
94073;126201;Szkoła Podstawowa Nr 21|Nowy Sącz|ul. Rokitniańczyków 26 |33-300 Nowy Sącz;2123;1281;1281;18;1263;60.34;1.41
94074;126201;Szkoła Podstawowa Nr 21|Nowy Sącz|ul. Rokitniańczyków 26 |33-300 Nowy Sącz;1753;990;990;13;977;56.47;1.31
94075;126201;Stowarzyszenie "Nadzieja"|Nowy Sącz|ul. Freislera 10 |33-300 Nowy Sącz;1729;1034;1034;15;1019;59.80;1.45
94076;126201;Zespół Szkół Podstawowo-Gimnazjalnych Nr 1|Nowy Sącz|ul. 29 Listopada 22 |33-300 Nowy Sącz;815;484;484;8;476;59.39;1.65
94077;126201;Zespół Szkół Podstawowo-Gimnazjalnych Nr 1|Nowy Sącz|ul. 29 Listopada 22 |33-300 Nowy Sącz;1242;726;726;12;714;58.45;1.65
94078;126201;Zespół Szkół Podstawowo-Gimnazjalnych Nr 1|Nowy Sącz|ul. 29 Listopada 22 |33-300 Nowy Sącz;1000;550;550;8;542;55.00;1.45
94079;126201;Zespół Szkół Podstawowo-Gimnazjalnych Nr 2|Nowy Sącz|ul. Gen. Bora Komorowskiego 7 |33-300 Nowy Sącz;1655;1034;1034;17;1017;62.48;1.64
94080;126201;Państwowa Szkoła Muzyczna|Nowy Sącz|ul. Nawojowska 213 |33-300 Nowy Sącz;1954;1208;1208;12;1196;61.82;0.99
94081;126201;Siedziba Zarządów Osiedli "Gorzków" i "Wojska Polskiego"|Nowy Sącz|ul. Freislera 4a |33-300 Nowy Sącz;1109;685;685;13;672;61.77;1.90
94082;126201;Zespół Szkół Elektro-Mechanicznych|Nowy Sącz|ul. Limanowskiego 4 |33-300 Nowy Sącz;1196;682;682;22;660;57.02;3.23
94083;126201;Szkoła Podstawowa Nr 7|Nowy Sącz|ul. Gen. Grota-Roweckiego 15 |33-300 Nowy Sącz;1680;985;985;21;964;58.63;2.13
94084;126201;Szkoła Podstawowa Nr 8|Nowy Sącz|Al. Stefana Batorego 76 |33-300 Nowy Sącz;1521;828;828;18;810;54.44;2.17
94085;126201;Miejskie Przedszkole Integracyjne|Nowy Sącz|ul. Podhalańska 7 |33-300 Nowy Sącz;1074;624;624;10;614;58.10;1.60
94086;126201;Świetlica "Sądeckich Wodociągów"|Nowy Sącz|ul. W. Pola 22 |33-300 Nowy Sącz;1233;775;775;5;770;62.85;0.65
94087;126201;Szkoła Podstawowa Nr 9|Nowy Sącz|ul. Piramowicza 16 |33-300 Nowy Sącz;1621;913;913;11;902;56.32;1.20
94088;126201;Szkoła Podstawowa Nr 9|Nowy Sącz|ul. Piramowicza 16 |33-300 Nowy Sącz;1002;586;586;13;573;58.48;2.22
94089;126201;Szkoła Podstawowa Nr 9|Nowy Sącz|ul. Piramowicza 16 |33-300 Nowy Sącz;1431;868;868;18;850;60.66;2.07
94090;126201;Szkoła Podstawowa Nr 14|Nowy Sącz|ul. Towarowa 6 |33-300 Nowy Sącz;1151;767;767;11;756;66.64;1.43
94091;126201;Szkoła Podstawowa Nr 17|Nowy Sącz|ul. Mała Poręba 57 |33-300 Nowy Sącz;1791;1089;1089;17;1072;60.80;1.56
94092;126201;Zakład Ubezpieczeń Społecznych|Nowy Sącz|ul. Sienkiewicza 77 |33-300 Nowy Sącz;1100;632;632;14;618;57.45;2.22
94093;126201;Spółdzielnia Mieszkaniowa "BESKID"|Nowy Sącz|ul. B. A. Konstanty 12A |33-300 Nowy Sącz;1289;819;819;12;807;63.54;1.47
94094;126201;Dom Pomocy Społecznej|Nowy Sącz|ul. E. Plater 20 |33-300 Nowy Sącz;99;46;46;12;34;46.46;26.09
94095;126201;Dom Pomocy Społecznej|Nowy Sącz|ul. Nawojowska 155 |33-300 Nowy Sącz;57;27;27;1;26;47.37;3.70
94096;126201;Dom Pomocy Społecznej|Nowy Sącz|ul. Nawojowska 159 |33-300 Nowy Sącz;84;32;32;9;23;38.10;28.12
94097;126201;Szpital Spacjalistyczny im. J. Śniadeckiego|Nowy Sącz|ul. Młyńska 5 |33-300 Nowy Sącz;180;129;129;13;116;71.67;10.08
94098;126201;Szpital Położniczo-Ginekologiczny MEDIKOR|Nowy Sącz|ul. Rzemieślnicza 5 |33-300 Nowy Sącz;25;20;20;0;20;80.00;0.00
94099;126201;Zakład Karny|Nowy Sącz|ul. Pijarska 1 |33-300 Nowy Sącz;303;172;172;24;148;56.77;13.95
94100;126301;Tarnowskie Centrum Kultury|Tarnów|Rynek 5 |33-100 Tarnów;866;333;333;16;317;38.45;4.80
94101;126301;III Liceum Ogólnokształcące im. A. Mickiewicza|Tarnów|ul. Brodzińskiego 6 |33-100 Tarnów;1531;657;657;21;636;42.91;3.20
94102;126301;I Liceum Ogólnokształcące im. K. Brodzińskiego|Tarnów|ul. Piłsudskiego 4 |33-100 Tarnów;751;337;341;2;335;44.87;0.59
94103;126301;XVI Liceum Ogólnokształcące im. Armii Krajowej|Tarnów|Aleja Solidarności 18 |33-100 Tarnów;540;275;275;3;272;50.93;1.09
94104;126301;Szkoła Podstawowa Nr 3 im. M. Konopnickiej|Tarnów|ul. Kopernika 10 |33-100 Tarnów;1144;546;546;5;541;47.73;0.92
94105;126301;Zespół Szkół Ekonomiczno-Gastronomicznych im. J. Piłsudskiego|Tarnów|ul. Bema 9/11 |33-100 Tarnów;833;388;388;5;383;46.58;1.29
94106;126301;Zespół Szkół Ogólnokształcących Nr 6 z Oddziałami Integracyjnymi|Tarnów|ul. Bandrowskiego 4 |33-100 Tarnów;1231;668;668;10;658;54.26;1.50
94107;126301;Przedszkole Publiczne Nr 17|Tarnów|ul. Kościuszki 9 |33-100 Tarnów;1574;906;906;20;886;57.56;2.21
94108;126301;Zespół Szkół Ogólnokształcących Nr 5|Tarnów|ul. Reymonta 30 |33-100 Tarnów;1969;1011;1011;14;997;51.35;1.38
94109;126301;Zespół Szkół Ogólnokształcących Nr 5|Tarnów|ul. Reymonta 30 |33-100 Tarnów;1181;681;681;9;672;57.66;1.32
94110;126301;Przedszkole Publiczne Nr 34|Tarnów|ul. Wiejska Nr 29 |33-100 Tarnów;1216;643;643;13;630;52.88;2.02
94111;126301;VII Liceum Ogólnokształcące|Tarnów|ul. Staszica 8 |33-100 Tarnów;836;418;418;5;413;50.00;1.20
94112;126301;Zespół Szkół Mechaniczno - Elektrycznych|Tarnów|ul. Szujskiego 13 |33-100 Tarnów;1034;635;635;8;627;61.41;1.26
94113;126301;Szkoła Podstawowa Nr 18 im. J. Kochanowskiego|Tarnów|ul. 3 Maja 10 |33-100 Tarnów;1020;560;560;8;552;54.90;1.43
94114;126301;Szkoła Podstawowa Nr 18 im. J. Kochanowskiego|Tarnów|ul. 3 Maja 10 |33-100 Tarnów;1037;552;552;7;545;53.23;1.27
94115;126301;Gimnazjum Nr 11 im. Romana Brandstaettera|Tarnów|ul. Szujskiego 15 |33-100 Tarnów;1885;1037;1037;14;1023;55.01;1.35
94116;126301;Przedszkole Publiczne Nr 14|Tarnów|ul. Pułaskiego 93A |33-100 Tarnów;1491;673;673;20;653;45.14;2.97
94117;126301;Dom Studenta Państwowej Wyższej Szkoły Zawodowej|Tarnów|ul. Słowackiego 7 |33-100 Tarnów;2045;1175;1175;7;1168;57.46;0.60
94118;126301;Przedszkole Publiczne Nr 19|Tarnów|ul. Paderewskiego 24 |33-100 Tarnów;1376;775;775;11;764;56.32;1.42
94119;126301;V Liceum Ogólnokształcące im. Janusza Korczaka|Tarnów|ul. Rejtana 20 |33-100 Tarnów;1265;697;697;9;688;55.10;1.29
94120;126301;Specjalny Ośrodek Szkolno-Wychowawczy im. E Gierat|Tarnów|ul. Romanowicza 9 |33-100 Tarnów;1186;709;709;2;707;59.78;0.28
94121;126301;Specjalny Ośrodek Szkolno-Wychowawczy im. E Gierat|Tarnów|ul. Romanowicza 9 |33-100 Tarnów;1541;1016;1016;6;1010;65.93;0.59
94122;126301;Zespół Szkół Niepublicznych Stowarzyszenia "Siódemka"|Tarnów|ul. Poniatowskiego 5 |33-100 Tarnów;961;530;530;9;521;55.15;1.70
94123;126301;Zespół Szkół Niepublicznych Stowarzyszenia "Siódemka"|Tarnów|ul. Poniatowskiego 5 |33-100 Tarnów;1029;468;468;7;461;45.48;1.50
94124;126301;Dom Pomocy Społecznej im. Świętego Brata Alberta|Tarnów|ul. Szpitalna 53 |33-100 Tarnów;142;73;73;9;64;51.41;12.33
94125;126301;Przedszkole Publiczne Nr 26|Tarnów|ul. Bitwy o Wał Pomorski 11 |33-100 Tarnów;1006;558;558;9;549;55.47;1.61
94126;126301;Dom Pomocy Społecznej im. Świętego Brata Alberta|Tarnów|ul. Szpitalna 53 |33-100 Tarnów;1354;745;745;16;729;55.02;2.15
94127;126301;Zespół Szkół Ogólnokształcących Nr 4|Tarnów|ul. Osiedle Legionów Dąbrowskiego 16 |33-100 Tarnów;969;590;590;6;584;60.89;1.02
94128;126301;Zespół Szkół Ogólnokształcących Nr 4|Tarnów|ul. Osiedle Legionów Dąbrowskiego 16 |33-100 Tarnów;1006;517;517;5;512;51.39;0.97
94129;126301;Przedszkole Publiczne Nr 24|Tarnów|ul. Westerplatte 11 |33-100 Tarnów;1390;804;804;11;793;57.84;1.37
94130;126301;Przedszkole Publiczne Nr 24|Tarnów|ul. Westerplatte 11 |33-100 Tarnów;1266;721;721;7;714;56.95;0.97
94131;126301;Przedszkole Publiczne Nr 18 z Oddziałami Integracyjnymi|Tarnów|ul. Westerplatte 10 |33-100 Tarnów;1231;671;671;11;660;54.51;1.64
94132;126301;Przedszkole Publiczne Nr 18 z Oddziałami Integracyjnymi|Tarnów|ul. Westerplatte 10 |33-100 Tarnów;918;521;521;5;516;56.75;0.96
94133;126301;Żłobek Nr 5|Tarnów|ul. Do Prochowni 20 |33-100 Tarnów;1206;707;707;11;696;58.62;1.56
94134;126301;Przedszkole Publiczne Nr 31|Tarnów|ul. Promienna 13 |33-100 Tarnów;1067;628;628;3;625;58.86;0.48
94135;126301;Przedszkole Publiczne Nr 32|Tarnów|ul. Długa 23A |33-100 Tarnów;1686;1005;1005;14;991;59.61;1.39
94136;126301;Gimnazjum Nr 4 im. Jerzego Brauna|Tarnów|ul. Bitwy pod Studziankami 5 |33-100 Tarnów;981;536;536;6;530;54.64;1.12
94137;126301;Szkoła Podstawowa Nr 8 im. K.K. Baczyńskiego|Tarnów|ul. Bitwy pod Studziankami 5 |33-100 Tarnów;885;505;505;4;501;57.06;0.79
94138;126301;Szkoła Podstawowa Nr 5 im. T. Kościuszki|Tarnów|ul. Skowronków 8 |33-100 Tarnów;1776;970;970;20;950;54.62;2.06
94139;126301;Przedszkole Publiczne Nr 12|Tarnów|ul. Jasna 6 |33-100 Tarnów;1567;834;834;5;829;53.22;0.60
94140;126301;Miejska Przychodnia Lekarska Nr IV NZOZ sp. z o.o.|Tarnów|ul. Osiedle 25-lecia PRL 3A |33-100 Tarnów;1464;736;736;5;731;50.27;0.68
94141;126301;Szkoła Podstawowa Nr 15 im. Gen. J. Bema|Tarnów|ul. Krupnicza 8 |33-100 Tarnów;1291;652;652;16;636;50.50;2.45
94142;126301;Zespół Szkół Ogólnokształcących Nr 2|Tarnów|ul. Mickiewicza 16 |33-100 Tarnów;1059;509;509;7;502;48.06;1.38
94143;126301;Przedszkole Publiczne Nr 6|Tarnów|ul. Waryńskiego 19 |33-100 Tarnów;1385;702;702;19;683;50.69;2.71
94144;126301;Katolicka Szkoła Podstawowa ul. Warzywna 3, Katolickie Gimnazjum ul. Warzywna 3|Tarnów|ul. Warzywna 3 |33-100 Tarnów;1448;724;724;10;714;50.00;1.38
94145;126301;Przedszkole Publiczne Nr 21|Tarnów|ul. Burtnicza 11 |33-100 Tarnów;1918;1050;1050;17;1033;54.74;1.62
94146;126301;Hala Sportowo Widowiskowa Pałacu Młodzieży|Tarnów|ul. Gumniska 28 |33-100 Tarnów;1477;826;826;8;818;55.92;0.97
94147;126301;Zespół Szkół Ekonomiczno-Ogrodniczych im. T. Kościuszki|Tarnów|ul. Sanguszków 28 |33-100 Tarnów;1148;651;651;8;643;56.71;1.23
94148;126301;Szkoła Podstawowa Nr 2 im. St. Konarskiego|Tarnów|ul. Szewska 7 |33-100 Tarnów;887;398;398;4;394;44.87;1.01
94149;126301;Szkoła Podstawowa Nr 2 im. St. Konarskiego|Tarnów|ul. Szewska 7 |33-100 Tarnów;1532;909;909;12;897;59.33;1.32
94150;126301;Niepubliczna Szkoła Podstawowa im. Polskiej Marynarki Handlowej|Tarnów|ul. Skorupki 9 |33-100 Tarnów;1155;589;589;3;586;51.00;0.51
94151;126301;Niepubliczna Szkoła Podstawowa im. Polskiej Marynarki Handlowej|Tarnów|ul. Skorupki 9 |33-100 Tarnów;1198;611;611;17;594;51.00;2.78
94152;126301;Budynek Rady Osiedla Nr 15 "Koszyce"|Tarnów|ul. Waszkiewicza 2 |33-100 Tarnów;1958;1126;1126;9;1117;57.51;0.80
94153;126301;Hala Sportowa Zespołu Szkół Ogólnokształcących Nr 1|Tarnów|ul. Pszenna 10 |33-101 Tarnów;2066;1284;1284;12;1272;62.15;0.93
94154;126301;Zespół Szkół Ogólnokształcących Nr 1|Tarnów|ul. Norwida 22 |33-100 Tarnów;2209;1332;1332;9;1323;60.30;0.68
94155;126301;Zespół Szkół Ogólnokształcących Nr 1|Tarnów|ul. Norwida 22 |33-100 Tarnów;1310;835;835;5;830;63.74;0.60
94156;126301;Zespół Szkół Sportowych im. Polskich Olimpijczyków|Tarnów|ul. Zbylitowska 7 |33-101 Tarnów;1311;760;760;9;751;57.97;1.18
94157;126301;Zespół Szkół Technicznych im. I. Mościckiego|Tarnów|ul. Kwiatkowskiego 17 |33-101 Tarnów;1381;710;710;17;693;51.41;2.39
94158;126301;Szkoła Podstawowa Nr 11 Integracyjna im. M. Dąbrowskiej|Tarnów|ul. Mościckiego 177A |33-100 Tarnów;1510;869;869;21;848;57.55;2.42
94159;126301;Przedszkole Publiczne Nr 5|Tarnów|ul. Zagumnie 27 |33-100 Tarnów;2063;1044;1044;20;1024;50.61;1.92
94160;126301;Szkoła Podstawowa Nr 14 im. S. Jaracza|Tarnów|ul. Krzyska 118 |33-100 Tarnów;1611;846;846;14;832;52.51;1.65
94161;126301;Gimnazjum Nr 6 im. Jana Pawła II|Tarnów|ul. Krzyska 118 |33-100 Tarnów;1566;932;932;12;920;59.51;1.29
94162;126301;Szkoła Podstawowa Nr 14 im. S. Jaracza|Tarnów|ul. Krzyska 118 |33-100 Tarnów;1420;810;810;7;803;57.04;0.86
94163;126301;Szkoła Podstawowa Nr 9 im. Orląt Lwowskich|Tarnów|ul. Dąbrowskiej 6 |33-100 Tarnów;1381;832;832;5;827;60.25;0.60
94164;126301;Przedszkole Publiczne Nr 8|Tarnów|ul. Dąbrowskiej 1 |33-100 Tarnów;1580;943;943;17;926;59.68;1.80
94165;126301;Szkoła Podstawowa Nr 9 im. Orląt Lwowskich|Tarnów|ul. Dąbrowskiej 6 |33-100 Tarnów;1359;770;771;4;766;56.66;0.52
94166;126301;Przedszkole Publiczne Nr 8|Tarnów|ul. Dąbrowskiej 1 |33-100 Tarnów;2014;1095;1095;14;1081;54.37;1.28
94167;126301;Specjalistyczny Szpital im. E. Szczeklika|Tarnów|ul. Szpitalna 13 |33-100 Tarnów;265;148;148;4;144;55.85;2.70
94168;126301;Szpital Wojewódzki im. Św. Łukasza Samodzielny Publiczny Zakład Opieki Zdrowotnej|Tarnów|ul. Lwowska 178 a |33-100 Tarnów;338;128;128;6;122;37.87;4.69
94169;126301;Dom Pomocy Społecznej|Tarnów|ul. Czarna Droga 48 |33-101 Tarnów;79;53;53;4;49;67.09;7.55
94170;126301;Zakład Opiekuńczo-Leczniczy przy Mościckim Centrum Medycznym Sp. z o.o.|Tarnów|ul. Eugeniusza Kwiatkowskiego 15 |33-101 Tarnów;42;8;8;0;8;19.05;0.00
94171;126301;Zakład Karny Tarnów-Mościce|Tarnów|ul. Jędrzeja Śniadeckiego 9 |33-101 Tarnów;328;146;146;18;128;44.51;12.33
94172;126301;Zakład Karny w Tarnowie|Tarnów|ul. Stanisława Konarskiego 2 |33-100 Tarnów;604;283;283;47;236;46.85;16.61
94173;126301;Zakład Karny w Tarnowie - Oddział Penitencjarny Nr 3|Tarnów|ul. Wspólna 15 |33-100 Tarnów;232;97;97;7;90;41.81;7.22
94174;140101;Publiczna Szkoła Podstawowa Nr 1 im.Komisji Edukacji Narodowej w Białobrzegach|Białobrzegi|ul. Rzemieślnicza 21/31 |26-800 Białobrzegi;1722;956;956;25;931;55.52;2.62
94175;140101;Publiczne Przedszkole Nr 2 im. Kubusia Puchatka w Białobrzegach|Białobrzegi|ul. Marii Konopnickiej 1 |26-800 Białobrzegi;1404;786;786;25;761;55.98;3.18
94176;140101;Publiczna Szkoła Podstawowa Nr 1 im. Komisji Edukacji Narodowej w Białobrzegach|Białobrzegi|ul. Rzemieślnicza 21/31 |26-800 Białobrzegi;1858;843;843;33;810;45.37;3.91
94177;140101;Biblioteka Publiczna Miasta i Gminy w Białobrzegach|Białobrzegi|ul. Kościelna 31 |26-800 Białobrzegi;1984;1090;1090;51;1039;54.94;4.68
94178;140101;Publiczna Szkoła Podstawowa w Suchej|Sucha|ul. Szlachecka 88A |26-800 Białobrzegi;1270;581;581;15;566;45.75;2.58
94179;140101;Oddział Zewnętrzny w Stawiszynie|Stawiszyn| 31C |26-800 Białobrzegi;176;66;66;2;64;37.50;3.03
94180;140102;Urząd Gminy w Promnie|Promna-Kolonia| 5 |26-803 Promna;2068;944;944;42;902;45.65;4.45
94181;140102;Remiza OSP w Olszamach|Olszamy| 23 |05-610 Goszczyn;874;417;417;9;408;47.71;2.16
94182;140102;Świetlica wiejska|Lisów| 4A |05-610 Goszczyn;730;328;328;13;315;44.93;3.96
94183;140102;Szkoła Podstawowa w Przybyszewie|Przybyszew|ul. Władysława Rosłońca 5 |26-803 Promna;857;365;365;18;347;42.59;4.93
94184;140103;Świetlica Wiejska w Radzanowie|Radzanów| 25 |26-807 Radzanów;1649;767;767;20;747;46.51;2.61
94185;140103;Świetlica Wiejska w Bukównie|Bukówno| 31 |26-807 Radzanów;1361;701;701;29;672;51.51;4.14
94186;140104;Zespół Szkół Gminnych w Starej Błotnicy|Stara Błotnica| 49 |26-806 Stara Błotnica;1815;822;822;34;788;45.29;4.14
94187;140104;Zespół Szkół Gminnych w Starym Goździe|Stary Gózd| 90 |26-806 Stara Błotnica;1828;820;820;31;789;44.86;3.78
94188;140104;Publiczna Szkoła Podstawowa w Kaszowie|Kaszów| 37 |26-806 Stara Błotnica;470;217;217;10;207;46.17;4.61
94189;140105;Publiczna Szkoła Podstawowa w Bobrku|Bobrek-Kolonia| 24 |26-804 Stromiec;465;206;206;13;193;44.30;6.31
94190;140105;Publiczna Szkoła Podstawowa w Bożem|Boże| 1 |26-804 Stromiec;705;261;261;18;243;37.02;6.90
94191;140105;Publiczna Szkoła Podstawowa w Dobieszynie|Kolonia Sielce| 46 |26-804 Stromiec;931;348;348;22;326;37.38;6.32
94192;140105;Publiczna Szkoła Podstawowa w Podlesiu Dużym|Podlesie Duże| 71 |26-804 Stromiec;608;228;228;11;217;37.50;4.82
94193;140105;Urząd Gminy w Stromcu|Stromiec|ul.Piaski 4 |26-804 Stromiec;935;350;350;28;322;37.43;8.00
94194;140105;Publiczna Szkoła Podstawowa w Stromcu|Stromiec|ul.Radomska 27 |26-804 Stromiec;837;439;439;16;423;52.45;3.64
94195;140106;URZĄD MIEJSKI W WYŚMIERZYCACH|WYŚMIERZYCE|ul. ADAMA MICKIEWICZA 75 |26-811 WYŚMIERZYCE;1463;702;702;22;680;47.98;3.13
94196;140106;REMIZA OSP W WITASZYNIE|WITASZYN| 18 B |26-811 WYŚMIERZYCE;357;169;169;3;166;47.34;1.78
94197;140106;SZKOŁA PODSTAWOWA W KOSTRZYNIE|KOSTRZYN| 66A |26-811 WYŚMIERZYCE;565;254;254;8;246;44.96;3.15
94198;140201;Miejski Zespół Szkół Nr 1|Ciechanów|ul. Powstańców Wielkopolskich 1 |06-400 Ciechanów;1839;973;973;17;956;52.91;1.75
94199;140201;Przedszkole Nr 5|Ciechanów|ul. Gwardii Ludowej 12 |06-400 Ciechanów;1774;925;928;20;905;52.14;2.16
94200;140201;Przedszkole Nr 10|Ciechanów|ul. Batalionów Chłopskich 4 |06-400 Ciechanów;1788;908;908;13;895;50.78;1.43
94201;140201;Państwowa Wyższa Szkoła Zawodowa|Ciechanów|ul. Wojska Polskiego 51 |06-400 Ciechanów;1747;823;823;12;811;47.11;1.46
94202;140201;Dom Pomocy Społecznej KOMBATANT|Ciechanów|ul. Batalionów Chłopskich 12 |06-400 Ciechanów;1793;939;939;17;922;52.37;1.81
94203;140201;Przedszkole Nr 1|Ciechanów|ul. Nadfosna 12 |06-400 Ciechanów;1895;917;917;22;895;48.39;2.40
94204;140201;Powiatowe Centrum Kultury i Sztuki im. M. Konopnickiej|Ciechanów|ul. Strażacka 5 |06-400 Ciechanów;1702;893;893;17;876;52.47;1.90
94205;140201;Gimnazjum Nr 1|Ciechanów|ul. Orylska 3 |06-400 Ciechanów;1803;856;856;9;847;47.48;1.05
94206;140201;Liga Obrony Kraju Ośrodek Szkolenia Kierowców|Ciechanów|ul. Rzeczkowska 4 |06-400 Ciechanów;1916;1002;1002;18;984;52.30;1.80
94207;140201;Szkoła Podstawowa Nr 4|Ciechanów|ul. Płońska 143 |06-400 Ciechanów;1757;920;920;18;902;52.36;1.96
94208;140201;BUDMAT AUTO 2 Sp. z o.o.|Ciechanów|ul. Sońska 2 |06-400 Ciechanów;1566;729;729;27;702;46.55;3.70
94209;140201;Przedszkole Nr 8|Ciechanów|ul. Graniczna 41 |06-400 Ciechanów;1681;825;825;24;801;49.08;2.91
94210;140201;Miejski Zespół Szkół Nr 2|Ciechanów|ul. Stefana Czarnieckiego 40 |06-400 Ciechanów;1741;767;767;14;753;44.06;1.83
94211;140201;Miejski Zespół Szkół Nr 2|Ciechanów|ul. Stefana Czarnieckiego 40 |06-400 Ciechanów;1663;930;930;13;917;55.92;1.40
94212;140201;Zespół Placówek Oświatowych|Ciechanów|ul. 17 Stycznia 49 |06-400 Ciechanów;1572;816;816;13;803;51.91;1.59
94213;140201;Miejski Ośrodek Pomocy Społecznej|Ciechanów|ul. Henryka Sienkiewicza 32d |06-400 Ciechanów;1616;678;678;21;657;41.96;3.10
94214;140201;Zespół Szkół Nr 3|Ciechanów|ul. Stefana Okrzei 6 |06-400 Ciechanów;1590;612;612;17;595;38.49;2.78
94215;140201;Gimnazjum Nr 3|Ciechanów|ul. 17 Stycznia 17 |06-400 Ciechanów;1589;687;687;20;667;43.23;2.91
94216;140201;Szkoła Podstawowa Nr 5|Ciechanów|ul. Władysława Broniewskiego 1 |06-400 Ciechanów;1513;795;795;17;778;52.54;2.14
94217;140201;Hala Sportowo-Widowiskowa|Ciechanów|ul. Ignacego Kraszewskiego 8 |06-400 Ciechanów;1620;881;881;13;868;54.38;1.48
94218;140201;Gimnazjum nr 3|Ciechanów|ul. 17 Stycznia 17 |06-400 Ciechanów;1607;841;841;19;822;52.33;2.26
94219;140201;Specjalistyczny Szpital Wojewódzki|Ciechanów|ul. Powstańców Wielkopolskich 2 |06-400 Ciechanów;248;51;51;5;46;20.56;9.80
94220;140201;Dom Pomocy Społecznej|Ciechanów|ul. Krucza 32 |06-400 Ciechanów;162;87;87;26;61;53.70;29.89
94221;140202;Urząd Gminy Ciechanów|Ciechanów|ul. Fabryczna 8 |06-400 Ciechanów;2103;993;993;27;966;47.22;2.72
94222;140202;Szkoła Podstawowa w Chotumiu|Chotum| 25 |06-452 Ościsłowo;912;303;303;14;289;33.22;4.62
94223;140202;Urząd Gminy Ciechanów|Ciechanów|ul. Fabryczna 8 |06-400 Ciechanów;1577;668;668;22;646;42.36;3.29
94224;140202;Gimnazjum w Gumowie|Gumowo| 8 |06-452 Ościsłowo;922;330;330;33;297;35.79;10.00
94225;140203;Szkoła Podstawowa im. Marii Konopnickiej w Glinojecku|Glinojeck|ul. Płocka 7 |06-450 Glinojeck;1562;561;561;31;530;35.92;5.53
94226;140203;Hala Sportowa w Glinojecku|Glinojeck|ul. Ciechanowska 8 C |06-450 Glinojeck;1431;609;609;34;575;42.56;5.58
94227;140203;Miejsko-Gminny Ośrodek Kultury w Glinojecku|Glinojeck|ul. Polna 2C |06-450 Glinojeck;1520;644;644;37;607;42.37;5.75
94228;140203;Remiza OSP|Ościsłowo| 37 |06-452 Ościsłowo;570;206;206;7;199;36.14;3.40
94229;140203;Szkoła Podstawowa w Woli Młockiej|Wola Młocka| 32 |06-450 Glinojeck;1261;440;440;12;428;34.89;2.73
94230;140204;Publiczne Gimnazjum w Gołyminie - Ośrodku|Gołymin-Ośrodek|ul. Ks. Michalaka 10C |06-420 Gołymin-Ośrodek;1043;449;449;23;426;43.05;5.12
94231;140204;Gminna Biblioteka Publiczna w Gołyminie-Ośrodku|Gołymin-Ośrodek|ul. Ks. Michalaka 10B |06-420 Gołymin-Ośrodek;878;345;345;16;329;39.29;4.64
94232;140204;Szkoła Podstawowa im. P.J. Gołaszewskiego Szkoła Filialna w Gostkowie|Gostkowo| 2 |06-420 Gołymin-Ośrodek;1267;441;441;28;413;34.81;6.35
94233;140205;Zespół Placówek Oświatowych Gimnazjum Publiczne|Grudusk|ul. Szkolna 2 |06-460 Grudusk;1029;427;427;21;406;41.50;4.92
94234;140205;Gminny Ośrodek Kultury|Grudusk|Plac Grunwaldu 4 |06-460 Grudusk;945;441;441;21;420;46.67;4.76
94235;140205;Dom Strażaka|Łysakowo| 59 |06-460 Grudusk;1043;442;442;13;429;42.38;2.94
94236;140206;Szkoła Podstawowa w Ojrzeniu|Ojrzeń|ul. Przedszkolna 7 |06-456 Ojrzeń;801;387;387;20;367;48.31;5.17
94237;140206;Urząd Gminy w Ojrzeniu|Ojrzeń|ul. Ciechanowska 27 |06-456 Ojrzeń;704;232;232;15;217;32.95;6.47
94238;140206;Zespół Szkół w Młocku|Młock| 73 |06-456 Ojrzeń;1003;373;373;20;353;37.19;5.36
94239;140206;Zespół Szkół w Kraszewie|Kraszewo| 57A |06-456 Ojrzeń;977;374;374;21;353;38.28;5.61
94240;140207;Urząd Gminy w Opinogórze Górnej|Opinogóra Górna|ul. Z. Krasińskiego 4 |06-406 Opinogóra Górna;1033;439;439;10;429;42.50;2.28
94241;140207;Świetlica Wiejska|Dzbonie| 22 |06-406 Opinogóra Górna;794;333;333;8;325;41.94;2.40
94242;140207;Szkoła Podstawowa w Woli Wierzbowskiej|Wola Wierzbowska| 27 |06-406 Opinogóra Górna;596;251;251;7;244;42.11;2.79
94243;140207;Szkoła Podstawowa w Kołaczkowie|Kołaczków| 10 |06-406 Opinogóra Górna;952;314;314;22;292;32.98;7.01
94244;140207;Świetlica Wiejska|Władysławowo|ul. E. Krasińskiego 39 |06-406 Opinogóra Górna;811;386;386;11;375;47.60;2.85
94245;140207;Świetlica wiejska|Rembówko| 27 |06-406 Opinogóra Górna;575;242;242;9;233;42.09;3.72
94246;140208;Urząd Gminy w Regiminie|Regimin| 22 |06-461 Regimin;2167;908;908;46;862;41.90;5.07
94247;140208;Szkoła Podstawowa w Zeńboku|Zeńbok| 50 |06-461 Regimin;494;173;173;11;162;35.02;6.36
94248;140208;Budynek Świetlicy Wiejskiej w Pniewie-Czeruchach|Pniewo-Czeruchy| 23 |06-461 Regimin;504;212;212;5;207;42.06;2.36
94249;140208;Szkoła Podstawowa w Szulmierzu|Szulmierz| 78 |06-461 Regimin;874;324;324;12;312;37.07;3.70
94250;140209;Szkoła Podstawowa|Sońsk|ul. Szkolna 4 |06-430 Sońsk;2230;1022;1022;24;998;45.83;2.35
94251;140209;Świetlica Wiejska|Ciemniewo| 47 |06-430 Sońsk;674;275;275;12;263;40.80;4.36
94252;140209;Szkoła Podstawowa|Bądkowo| 1 |06-440 Gąsocin;945;384;384;22;362;40.63;5.73
94253;140209;Gimnazjum|Gąsocin|ul. Błotna 12 |06-440 Gąsocin;2114;800;800;16;784;37.84;2.00
94254;140209;Świetlica Wiejska|Wola Ostaszewska| 17 |06-440 Gąsocin;366;118;118;5;113;32.24;4.24
94255;140209;Niepubliczny Zespół Zakładów Opieki Zdrowotnej "Palium" w Sońsku|Sońsk|ul. Zacisze 1 |06-430 Sońsk;72;37;37;0;37;51.39;0.00
94256;140301;Publiczna Szkoła Podstawowa Nr 1|Garwolin|Aleja Żwirki i Wigury 16 |08-400 Garwolin;898;562;562;12;550;62.58;2.14
94257;140301;Publiczna Szkoła Podstawowa Nr 1|Garwolin|Aleja Żwirki i Wigury 16 |08-400 Garwolin;816;430;430;18;412;52.70;4.19
94258;140301;Centrum Sportu i Kultury|Garwolin|Nadwodna 1 |08-400 Garwolin;607;391;391;6;385;64.42;1.53
94259;140301;Centrum Sportu i Kultury|Garwolin|Nadwodna 1 |08-400 Garwolin;784;482;482;11;471;61.48;2.28
94260;140301;Zespół Szkół Nr 2|Garwolin|Aleja Legionów 21 |08-400 Garwolin;830;547;547;7;540;65.90;1.28
94261;140301;Zespół Szkół Nr 2|Garwolin|Aleja Legionów 21 |08-400 Garwolin;713;431;431;11;420;60.45;2.55
94262;140301;Zespół Szkół Nr 2|Garwolin|Aleja Legionów 21 |08-400 Garwolin;1321;760;760;12;748;57.53;1.58
94263;140301;Zespół Szkół|Garwolin|Długa 35 |08-400 Garwolin;1207;729;729;6;723;60.40;0.82
94264;140301;Zespół Szkół|Garwolin|Długa 35 |08-400 Garwolin;905;549;549;12;537;60.66;2.19
94265;140301;Powiatowy Urząd Pracy|Garwolin|Kościuszki 27 |08-400 Garwolin;989;623;623;8;615;62.99;1.28
94266;140301;Zespół Szkół Ponadgimnazjalnych Nr 2|Garwolin|II Armii Wojska Polskiego 20 |08-400 Garwolin;842;549;549;9;540;65.20;1.64
94267;140301;Zespół Szkół Ponadgimnazjalnych Nr 2|Garwolin|II Armii Wojska Polskiego 20 |08-400 Garwolin;759;410;410;8;402;54.02;1.95
94268;140301;Zespół Szkół Nr 5|Garwolin|Janusza Korczaka 10 |08-400 Garwolin;809;486;486;5;481;60.07;1.03
94269;140301;Zespół Szkół Nr 5|Garwolin|Janusza Korczaka 10 |08-400 Garwolin;1003;597;597;7;590;59.52;1.17
94270;140301;Zespół Szkół Nr 5|Garwolin|Janusza Korczaka 10 |08-400 Garwolin;802;500;500;13;487;62.34;2.60
94271;140301;Szpital Powiatowy SP ZOZ|Garwolin|Lubelska 50 |08-400 Garwolin;49;28;28;2;26;57.14;7.14
94272;140302;Zespół Szkół Nr 1 w Łaskarzewie|Łaskarzew|Alejowa 23 |08-450 Łaskarzew;784;402;402;18;384;51.28;4.48
94273;140302;Zespół Szkół Nr 2 w Łaskarzewie|Łaskarzew|Kolejowa 13 |08-450 Łaskarzew;1128;618;618;16;602;54.79;2.59
94274;140302;Zespół Szkół Nr 1 w Łaskarzewie|Łaskarzew|Alejowa 23 |08-450 Łaskarzew;1053;537;537;11;526;51.00;2.05
94275;140302;Dom Pracy Twórczej "Bajka" w Łaskarzewie|Łaskarzew|Alejowa 13 |08-450 Łaskarzew;1076;531;531;23;508;49.35;4.33
94276;140303;Zespół Oświatowy w Borowiu|Borowie|ul. Al. Sasimowskiego 3 |08-412 Borowie;1070;508;508;20;488;47.48;3.94
94277;140303;Publiczna Szkoła Podstawowa w Brzuskowoli|Brzuskowola| 22 |08-412 Borowie;433;213;213;5;208;49.19;2.35
94278;140303;Zespół Szkół w Głoskowie|Głosków| 29 |08-412 Borowie;1065;525;525;17;508;49.30;3.24
94279;140303;Publiczna Szkoła Podstawowa w Iwowem|Iwowe| 140 |08-412 Borowie;675;348;348;12;336;51.56;3.45
94280;140303;Zespół Oświatowy w Borowiu|Borowie|ul. Al. Sasimowskiego 3 |08-412 Borowie;905;543;543;15;528;60.00;2.76
94281;140304;Zespół Szkół im.Ks.Bronisława Markiewicza w Rudzie Talubskiej|Ruda Talubska|ul. Akacjowa 10 |08-400 Garwolin;699;371;371;11;360;53.08;2.96
94282;140304;Świetlica OSP w Izdebniku|Izdebnik| 16 |08-410 Garwolin;635;302;302;6;296;47.56;1.99
94283;140304;Szkoła Podstawowa im. Marii Wójcik w Wilkowyi|Wilkowyja| 48 |08-410 Garwolin;586;340;340;9;331;58.02;2.65
94284;140304;Urząd Gminy w Garwolinie|Garwolin|Mazowiecka 16 |08-400 Garwolin;1230;686;686;18;668;55.77;2.62
94285;140304;Świetlica wiejska w Jagodnem|Jagodne| 57A |08-400 Garwolin;870;455;455;16;439;52.30;3.52
94286;140304;Szkoła Podstawowa w Woli Władysławowskiej|Wola Władysławowska| 27 |08-410 Garwolin;545;218;218;5;213;40.00;2.29
94287;140304;Szkoła Podstawowa w Woli Rębkowskiej|Wola Rębkowska|ul. Długa 90 |08-410 Garwolin;1165;659;659;13;646;56.57;1.97
94288;140304;Szkoła Podstawowa w Krystynie|Krystyna| 78A |08-410 Garwolin;522;197;197;8;189;37.74;4.06
94289;140304;Świetlica OSP w Sulbinach|Sulbiny|ul. Wspólna 46 |08-400 Garwolin;1363;787;787;7;780;57.74;0.89
94290;140304;Szkoła Podstawowa im. Armii Krajowej w Rębkowie|Rębków|Starowiejska 8 |08-410 Garwolin;902;436;436;12;424;48.34;2.75
94291;140304;Świetlica OSP w Miętnem|Miętne|Główna 118 |08-400 Garwolin;1413;817;817;24;793;57.82;2.94
94292;140305;Publiczna Szkoła Podstawowa w Uninie|Unin| 86b |08-400 Garwolin;968;450;450;15;435;46.49;3.33
94293;140305;Publiczna Szkoła Podstawowa w Łąkach|Łąki| 78 |08-404 Górzno;690;357;357;6;351;51.74;1.68
94294;140305;Budynek po Publicznej Szkole Podstawowej w Górznie filia w Wólce Ostrożeńskiej|Wólka Ostrożeńska| 23a |08-404 Górzno;575;347;347;8;339;60.35;2.31
94295;140305;Publiczna Szkoła Podstawowa w Samorządkach|Samorządki| 44a |08-404 Górzno;457;233;233;12;221;50.98;5.15
94296;140305;Publiczna Szkoła Podstawowa w Górznie|Górzno-Kolonia| 109 |08-404 Górzno;723;459;459;9;450;63.49;1.96
94297;140305;Publiczna Szkoła Podstawowa w Górznie|Górzno-kolonia| 109 |08-404 Górzno;1037;552;552;14;538;53.23;2.54
94298;140305;Publiczne Przedszkole w Górznie z siedzibą w Reducinie|Reducin| 20a |08-404 Górzno;528;291;291;4;287;55.11;1.37
94299;140305;Budynek Ośrodka w Wólce Ostrożeńskiej|Wólka Ostrożeńska| 15a |08-404 Górzno;63;23;23;2;21;36.51;8.70
94300;140306;Publiczna Szkoła Podstawowa w Dąbrowie z siedzibą w Woli Łaskarzewskiej|Wola Łaskarzewska| 88 |08-450 Łaskarzew;1048;584;584;19;565;55.73;3.25
94301;140306;Zespół Szkół w Izdebnie|Izdebno| 1 |08-450 Łaskarzew;521;215;215;18;197;41.27;8.37
94302;140306;Zespół Szkół w Starym Pilczynie|Stary Pilczyn| 36 |08-450 Łaskarzew;1572;851;851;24;827;54.13;2.82
94303;140306;Dom Kultury w Starym Helenowie|Stary Helenów| 30 |08-450 Łaskarzew;583;222;222;16;206;38.08;7.21
94304;140306;Publiczna Szkoła Podstawowa w Krzywdzie|Krzywda| 27A |08-450 Łaskarzew;583;272;272;18;254;46.66;6.62
94305;140307;Publiczna Szkoła Podstawowa w Maciejowicach (świetlica)|Maciejowice|Tadeusza Kościuszki 19 |08-480 Maciejowice;1202;617;617;20;597;51.33;3.24
94306;140307;Publiczna Szkoła Podstawowa w Maciejowicach (sala gimnastyczna)|Maciejowice|Tadeusza Kościuszki 19 |08-480 Maciejowice;1492;653;653;17;636;43.77;2.60
94307;140307;Budynek po dawnej Publicznej Szkole Podstawowej w Strychu|Strych| 12 |08-480 Maciejowice;367;155;155;11;144;42.23;7.10
94308;140307;Publiczna Szkoła Podstawowa w Antoniówce Świerżowskiej|Antoniówka Świerżowska| 24a |08-480 Maciejowice;398;162;162;14;148;40.70;8.64
94309;140307;Świetlica wiejska w Domaszewie|Domaszew| 77 |08-480 Maciejowice;400;149;149;8;141;37.25;5.37
94310;140307;Zespół Szkół w Samogoszczy|Samogoszcz| 2 |08-480 Maciejowice;1159;621;621;20;601;53.58;3.22
94311;140307;Budynek po dawnej Publicznej Szkole Podstawowej we Wróblach-Wargocinie|Wróble-Wargocin| 6 |08-480 Maciejowice;477;172;172;3;169;36.06;1.74
94312;140307;Publiczna Szkoła Podstawowa w Oronnem|Oronne| 8 |08-480 Maciejowice;359;163;163;10;153;45.40;6.13
94313;140308;Publiczna Szkoła Podstawowa w Miastkowie Kościelnym|Miastków Kościelny|Szkolna 8 |08-420 Miastków Kościelny;988;499;499;21;478;50.51;4.21
94314;140308;Budynek należący do Gminy Miastków Kościelny|Brzegi| 124 |08-420 Miastków Kościelny;526;251;251;11;240;47.72;4.38
94315;140308;Budynek należący do Gminy Miastków Kościelny|Oziemkówka| 1 |08-420 Miastków Kościelny;520;274;274;11;263;52.69;4.01
94316;140308;Świetlica wiejska|Zabruzdy| 37 |08-420 Miastków Kościelny;584;281;281;11;270;48.12;3.91
94317;140308;Publiczna Szkoła Podstawowa w Zwoli|Zwola| 45 |08-420 Miastków Kościelny;618;294;294;10;284;47.57;3.40
94318;140308;Publiczna Szkoła Podstawowa w Zgórzu|Zgórze| 30 |08-420 Miastków Kościelny;695;337;337;18;319;48.49;5.34
94319;140309;Zespół Placówek Oświatowych w Parysowie|Parysów|ul. Książęca 11 |08-441 Parysów;880;527;527;24;503;59.89;4.55
94320;140309;Gminna Biblioteka Publiczna w Parysowie|Parysów|ul.Borowska 1 |08-441 Parysów;1280;595;595;45;550;46.48;7.56
94321;140309;Publiczna Szkoła Podstawowa w Woli Starogrodzkiej|Wola Starogrodzka| 102 |08-441 Parysów;481;192;192;10;182;39.92;5.21
94322;140309;Dom Strażaka w Choinach|Choiny| 44 |08-441 Parysów;635;308;308;18;290;48.50;5.84
94323;140310;Publiczna Szkoła Podstawowa w Gocławiu|Gocław|ul. Szkolna 2 |08-440 Pilawa;1266;594;594;15;579;46.92;2.53
94324;140310;Publiczna Szkoła Podstawowa w Puznówce|Puznówka| 136 |08-440 Pilawa;628;338;338;12;326;53.82;3.55
94325;140310;Publiczna Szkoła Podstawowa w Trąbkach|Trąbki|ul. Osadnicza 4 |08-440 Pilawa;1089;484;484;18;466;44.44;3.72
94326;140310;Publiczne Gimnazjum w Trąbkach|Trąbki|Osadnicza 4 |08-440 Pilawa;532;306;306;7;299;57.52;2.29
94327;140310;Dom Strażaka Wygoda|Wygoda| 79 |08-440 Pilawa;387;202;202;7;195;52.20;3.47
94328;140310;Dom Strażaka Lipówki|Lipówki| 71 |08-440 Pilawa;630;319;319;4;315;50.63;1.25
94329;140310;Publiczne Gimnazjum w Pilawie|Pilawa|Leśna 6 |08-440 Pilawa;1279;708;708;21;687;55.36;2.97
94330;140310;Publiczna Szkoła Podstawowa w Pilawie|Pilawa|Leśna 6 |08-440 Pilawa;1014;554;554;19;535;54.64;3.43
94331;140310;Samorządowe Przedszkole w Pilawie|Pilawa|Wojska Polskiego 4 |08-440 Pilawa;1165;713;713;8;705;61.20;1.12
94332;140310;Świetlica Wiejska Jaźwiny|Jaźwiny| 27a |08-440 Pilawa;543;296;296;7;289;54.51;2.36
94333;140311;Zespół Szkół|Gończyce| 106 |08-460 Sobolew;1705;1015;1015;38;977;59.53;3.74
94334;140311;Szkoła Podstawowa|Sokół| 48 |08-460 Sobolew;780;423;423;14;409;54.23;3.31
94335;140311;Zespół Szkół im. Henryka Sienkiewicza|Sobolew|ul. Kościuszki 17 |08-460 Sobolew;1631;795;795;33;762;48.74;4.15
94336;140311;Liceum Ogólnokształcące|Sobolew|ul. Kościuszki 19 |08-460 Sobolew;1306;653;653;19;634;50.00;2.91
94337;140311;Szkoła Podstawowa|Kaleń Drugi| 65 |08-460 Sobolew;485;233;233;6;227;48.04;2.58
94338;140311;Budynek byłej Szkoły Podstawowej|Godzisz| 4 |08-460 Sobolew;527;208;208;12;196;39.47;5.77
94339;140312;Zespół Szkół w Podebłociu|Podebłocie| 109 |08-455 Trojanów;841;430;430;14;416;51.13;3.26
94340;140312;Szkoła Podstawowa w Więckowie|Więcków| 43 |08-455 Trojanów;675;332;332;10;322;49.19;3.01
94341;140312;Zespół Szkół w Trojanowie|Trojanów| 161 |08-455 Trojanów;1202;626;626;19;607;52.08;3.04
94342;140312;Szkoła Podstawowa w Dudkach|Dudki| 43 |08-455 Trojanów;397;210;210;5;205;52.90;2.38
94343;140312;Szkoła Podstawowa w Budziskach|Budziska| 47A |08-455 Trojanów;479;268;268;7;261;55.95;2.61
94344;140312;Zespół Szkół w Korytnicy|Korytnica| 106 |08-455 Trojanów;1199;627;627;11;616;52.29;1.75
94345;140312;Zespół Szkół w Życzynie|Życzyn| 55A |08-455 Trojanów;1103;506;506;10;496;45.87;1.98
94346;140312;Dom Pomocy Społecznej dla Dorosłych w Życzynie z/s w Dębówce|Dębówka| 53 |08-455 Trojanów;36;31;31;0;31;86.11;0.00
94347;140313;Gminny Ośrodek Kultury|Wilga|ul. Warszawska 34 |08-470 Wilga;1095;597;597;18;579;54.52;3.02
94348;140313;Publiczna Szkoła Podstawowa w Mariańskim Porzeczu|Mariańskie Porzecze| 36 |08-470 Wilga;945;445;445;15;430;47.09;3.37
94349;140313;Publiczna Szkoła Podstawowa w Kępie Celejowskiej|Zakrzew| 37 |08-470 Wilga;790;313;313;8;305;39.62;2.56
94350;140313;Publiczna Szkoła Podstawowa w Żabieńcu|Nowy Żabieniec| 2 |08-470 Wilga;453;229;229;10;219;50.55;4.37
94351;140313;Urząd Gminy w Wildze|Wilga|ul. Warszawska 38 |08-470 Wilga;1030;492;492;13;479;47.77;2.64
94352;140314;Zespół Szkół w Żelechowie|Żelechów|ul. Ogrodowa 3 |08-430 Żelechów;1481;825;825;22;803;55.71;2.67
94353;140314;Miejsko-Gminny Ośrodek Kultury w Żelechowie|Żelechów|ul.Traugutta 5 |08-430 Żelechów;1769;924;924;23;901;52.23;2.49
94354;140314;Klub Strażaka w Żelechowie|Żelechów|ul. Kościuszki 27 |08-430 Żelechów;1163;608;608;17;591;52.28;2.80
94355;140314;Szkoła Podstawowa w Starym Goniwilku|Stary Goniwilk| 41 |08-430 Żelechów;736;369;369;17;352;50.14;4.61
94356;140314;Zespół Szkół w Stefanowie|Stefanów| 108 |08-430 Żelechów;1049;490;490;21;469;46.71;4.29
94357;140314;Szkoła Podstawowa w Starym Kębłowie|Stary Kębłów| 23 |08-430 Żelechów;476;253;253;12;241;53.15;4.74
94358;140401;Szkoła Podstawowa Nr 3|Gostynin|ul. Gen. Józefa Bema 23 |09-500 Gostynin;993;492;492;16;476;49.55;3.25
94359;140401;Szkoła Podstawowa Nr 3|Gostynin|ul. Gen. Józefa Bema 23 |09-500 Gostynin;1268;654;654;14;640;51.58;2.14
94360;140401;Dom Nauczyciela|Gostynin|ul. Wojska Polskiego 10 |09-500 Gostynin;895;472;472;12;460;52.74;2.54
94361;140401;Miejskie Przedszkole Nr 4|Gostynin|ul. Armii Krajowej 7 |09-500 Gostynin;1115;576;576;5;571;51.66;0.87
94362;140401;Gimnazjum Nr 2|Gostynin|ul. Wojska Polskiego 23 |09-500 Gostynin;1130;551;551;8;543;48.76;1.45
94363;140401;Szkoła Podstawowa Nr 1|Gostynin|ul. Józefa Ozdowskiego 2 |09-500 Gostynin;1155;622;622;12;610;53.85;1.93
94364;140401;Zespół Szkół|Gostynin|ul. Kowalska 5 |09-500 Gostynin;938;354;354;15;339;37.74;4.24
94365;140401;Urząd Miasta Gostynina|Gostynin|ul. Parkowa 22 |09-500 Gostynin;917;444;444;12;432;48.42;2.70
94366;140401;Liceum Ogólnokształcące|Gostynin|ul. 3 Maja 15 |09-500 Gostynin;976;442;442;14;428;45.29;3.17
94367;140401;Miejskie Przedszkole Nr 2|Gostynin|ul. Wojska Polskiego 54 |09-500 Gostynin;1249;684;684;24;660;54.76;3.51
94368;140401;Hala Sportowa MOSiR|Gostynin|ul. Kutnowska 7a |09-500 Gostynin;1000;529;529;14;515;52.90;2.65
94369;140401;Gimnazjum Nr 1|Gostynin|ul. Polna 36 |09-500 Gostynin;1787;933;933;29;904;52.21;3.11
94370;140401;Miejskie Centrum Kultury|Gostynin|ul. 18 Stycznia 2 |09-500 Gostynin;1760;843;843;22;821;47.90;2.61
94371;140401;Wojewódzki Samodzielny Zespół Publicznych Zakładów Opieki Zdrowotnej im. prof. Eugeniusza Wilczkowskiego|Gostynin|Zalesie 1 |09-500 Gostynin;279;68;68;5;63;24.37;7.35
94372;140401;Powiatowy Dom Pomocy Społecznej w Czarnowie Filia w Gostyninie|Gostynin|ul. 3 Maja 47 |09-500 Gostynin;58;38;38;2;36;65.52;5.26
94373;140401;Regionalny Ośrodek Psychiatrii Sądowej|Gostynin|Zalesie 1A |09-500 Gostynin;47;26;26;2;24;55.32;7.69
94374;140402;Zespół Szkoły Podstawowej i Gimnazjum w Sierakówku|Sierakówek| 1 |09-500 Gostynin;838;390;390;12;378;46.54;3.08
94375;140402;Szkoła Podstawowa w Zwoleniu|Zwoleń| 35/36 |09-500 Gostynin;626;251;251;13;238;40.10;5.18
94376;140402;Zespół Szkoły Podstawowej i Gimnazjum w Lucieniu|Lucień| 50 |09-500 Gostynin;1324;538;538;32;506;40.63;5.95
94377;140402;Remiza OSP w Skrzanach|Skrzany| 27 |09-500 Gostynin;678;231;231;17;214;34.07;7.36
94378;140402;Zespół Szkoły Podstawowej i Gimnazjum w Emilianowie|Stefanów| 38 |09-500 Gostynin;1468;724;724;26;698;49.32;3.59
94379;140402;Zespół Szkoły Podstawowej i Gimnazjum w Białotarsku|Białotarsk| 34 |09-500 Gostynin;1175;441;441;34;407;37.53;7.71
94380;140402;Szkoła Podstawowa w Teodorowie|Krzywie| 47 |09-500 Gostynin;657;262;262;13;249;39.88;4.96
94381;140402;Zespół Szkoły Podstawowej i Gimnazjum w Solcu|Solec| 6 |09-500 Gostynin;557;287;287;18;269;51.53;6.27
94382;140402;Remiza OSP w Kozicach|Kozice| 5b |09-500 Gostynin;588;272;272;10;262;46.26;3.68
94383;140402;Szkoła Podstawowa w Sokołowie|Sokołów| 10 |09-500 Gostynin;1057;349;349;21;328;33.02;6.02
94384;140402;Remiza OSP w Gorzewie|Gorzewo| 44a |09-500 Gostynin;840;394;394;15;379;46.90;3.81
94385;140402;Szpital ARION Med sp. z o.o. Zespół Opieki Zdrowotnej|Gorzewo|Kruk 5 |09-500 Gostynin;104;48;48;5;43;46.15;10.42
94386;140402;Dom Pomocy Społecznej w Rogożewku|Rogożewek| 32A |09-500 Gostynin;27;16;16;3;13;59.26;18.75
94387;140403;Urząd Gminy w Pacynie,|Pacyna|ul.Wyzwolenia 7 |09-541 Pacyna;757;371;371;18;353;49.01;4.85
94388;140403;Zespół Szkół Ogólnokształących w Pacynie,|Pacyna|ul.Kopycińskiego 5 |09-541 Pacyna;895;361;361;24;337;40.34;6.65
94389;140403;Przedszkole Samorządowe w Luszynie,|Luszyn| 6 |09-541 Pacyna;765;305;305;17;288;39.87;5.57
94390;140403;Przedszkole Samorządowe w Skrzeszewach,|Skrzeszewy| 21 |09-541 Pacyna;637;277;277;17;260;43.49;6.14
94391;140403;Zakład Opiekuńczo-Leczniczy dla Dorosłych w Skrzeszewach,|Skrzeszewy| 26 |09-541 Pacyna;53;38;38;0;38;71.70;0.00
94392;140404;Była Szkoła Podstawowa w Brzezi|Brzezia| 39A |09-540 Sanniki;374;153;153;6;147;40.91;3.92
94393;140404;Remiza OSP Sielce|Sielce| 27A |09-540 Sanniki;338;131;131;6;125;38.76;4.58
94394;140404;Szkoła Podstawowa w Osmolinie|Osmolin|ul. Sannicka 4 |09-540 Sanniki;604;224;224;11;213;37.09;4.91
94395;140404;Szkoła Podstawowa w Sannikach|Sanniki|ul. Warszawska 183 |09-540 Sanniki;738;387;387;8;379;52.44;2.07
94396;140404;Siedziba Instytucji Gminnych|Sanniki|ul. Wólczyńska 75 |09-540 Sanniki;716;344;344;11;333;48.04;3.20
94397;140404;Siedziba Instytucji Gminnych|Sanniki|ul. Wólczyńska 75 |09-540 Sanniki;688;310;310;13;297;45.06;4.19
94398;140404;Remiza OSP w Wólce|Wólka Wysoka| 5A |09-540 Sanniki;248;114;114;6;108;45.97;5.26
94399;140404;Szkoła Podstawowa w Sannikach|Sanniki|ul. Warszawska 183 |09-540 Sanniki;664;312;312;9;303;46.99;2.88
94400;140404;Remiza OSP Lwówek|Lwówek| 48 |09-540 Sanniki;306;111;111;4;107;36.27;3.60
94401;140404;Była Szkoła Podstawowa w Barciku|Nowy Barcik| 47 |09-540 Sanniki;428;158;158;4;154;36.92;2.53
94402;140404;Dom Pomocy Społecznej w Sannikach|Sanniki|Wólczyńska 10 |09-540 Sanniki;25;25;25;1;24;100.00;4.00
94403;140405;Szkoła Podstawowa|Szczawin Kościelny|ul. Jana Pawła II 1 |09-550 Szczawin Kościelny;1166;547;547;20;527;46.91;3.66
94404;140405;Gminne Centrum Kultury i Rekreacji|Szczawin Kościelny|ul. Spółdzielcza 4 |09-550 Szczawin Kościelny;879;301;301;10;291;34.24;3.32
94405;140405;Remiza Ochotniczej Straży Pożarnej|Suserz| 48 |09-550 Szczawin Kościelny;1121;475;475;24;451;42.37;5.05
94406;140405;Szkoła Podstawowa|Trębki| 1 |09-550 Szczawin Kościelny;949;357;357;20;337;37.62;5.60
94407;140501;Szkoła Podstawowanr 2|Milanówek|ul. Literacka 20 |05-822 Milanówek;1514;987;987;13;974;65.19;1.32
94408;140501;Zespół Szkół nr 2 im. gen. J. Bema|Milanówek|ul. Wójtowska 3 |05-822 Milanówek;1835;1170;1170;14;1156;63.76;1.20
94409;140501;Zespół Szkół Gminnych nr 3|Milanówek|ul. Żabie Oczko 1 |05-822 Milanówek;2319;1587;1587;14;1573;68.43;0.88
94410;140501;Ochotnicza Straż Pożarna|Milanówek|ul. Warszawska 18 |05-822 Milanówek;1660;1077;1077;11;1066;64.88;1.02
94411;140501;Klub G.S.M.|Milanówek|ul. Piotra Skargi 7 |05-822 Milanówek;2033;1203;1203;13;1190;59.17;1.08
94412;140501;Zespół Szkół Gminnych nr 1|Milanówek|ul. Królewska 69 |05-822 Milanówek;1914;1284;1284;19;1265;67.08;1.48
94413;140501;Archiwum Dokumentacji Osobowej i Płacowej w Milanówku|Milanówek|Okrzei 1 |05-822 Milanówek;1746;1071;1071;15;1056;61.34;1.40
94414;140502;Centrum Kultury i Inicjatyw Obywatelskich|Podkowa Leśna|ul. Świerkowa 1 |05-807 Podkowa Leśna;900;650;650;4;646;72.22;0.62
94415;140502;Centrum Kultury i Inicjatyw Obywatelskich|Podkowa Leśna|ul. Świerkowa 1 |05-807 Podkowa Leśna;730;568;568;3;565;77.81;0.53
94416;140502;Zespół Szkół|Podkowa Leśna|ul. Jana Pawła II 20 |05-807 Podkowa Leśna;813;610;610;6;604;75.03;0.98
94417;140502;Zespół Szkół|Podkowa Leśna|ul. Jana Pawła II 20 |05-807 Podkowa Leśna;736;538;538;5;533;73.10;0.93
94418;140503;Zespół Szkół w Baranowie|Baranów|Armii Krajowej 49 |96-314 Baranów;627;239;239;6;233;38.12;2.51
94419;140503;Zespół Szkół w Baranowie|Baranów|Armii Krajowej 49 |96-314 Baranów;688;343;343;19;324;49.85;5.54
94420;140503;Gminne Przedszkole w Cegłowie|Cegłów| 22B |96-314 Baranów;746;373;373;11;362;50.00;2.95
94421;140503;Zespół Szkół w Bożej Woli|Boża Wola|1 Maja 13 |96-314 Baranów;578;335;335;11;324;57.96;3.28
94422;140503;Zespół Szkół w Kaskach|Kaski|Królewska 23 |96-314 Baranów;717;317;317;14;303;44.21;4.42
94423;140503;Zespół Szkół w Kaskach|Kaski|Królewska 23 |96-314 Baranów;685;309;309;6;303;45.11;1.94
94424;140504;Szkoła Podstawowa Nr 4|Grodzisk Mazowiecki|ul. Zielony Rynek 2 |05-825 Grodzisk Mazowiecki;1257;708;708;17;691;56.32;2.40
94425;140504;Gimnazjum nr 1|Grodzisk Mazowiecki, Łąki|ul. Zielony Rynek 2 |05-825 Grodzisk Mazowiecki;1201;663;663;12;651;55.20;1.81
94426;140504;Centrum Kultury, wejścia A|Grodzisk Mazowiecki|ul. Spółdzielcza 9 |05-825 Grodzisk Mazowiecki;1783;1031;1031;19;1012;57.82;1.84
94427;140504;Gimnazjum nr 3|Grodzisk Mazowiecki|ul. L. Zondka 6 |05-825 Grodzisk Mazowiecki;1591;804;804;21;783;50.53;2.61
94428;140504;Zespół Szkół nr 2|Grodzisk Mazowiecki|ul. Kilińskiego 8c |05-825 Grodzisk Mazowiecki;1349;776;776;6;770;57.52;0.77
94429;140504;ZGM|Grodzisk Mazowiecki|ul. Sportowa 29 |05-825 Grodzisk Mazowiecki;1656;915;915;21;894;55.25;2.30
94430;140504;Szkoła Podstawowa nr 1|Grodzisk Mazowiecki|ul. Bartniaka 13a |05-825 Grodzisk Mazowiecki;1412;808;809;11;797;57.22;1.36
94431;140504;Szkoła Podstawowa nr 6|Grodzisk Mazowiecki|ul. Sportowa 31 |05-825 Grodzisk Mazowiecki;2002;1275;1275;27;1248;63.69;2.12
94432;140504;Przedszkole nr 7|Grodzisk Mazowiecki|ul. Kopernika 15 |05-825 Grodzisk Mazowiecki;1733;1069;1069;21;1048;61.68;1.96
94433;140504;Szkoła Podstawowa Nr 2 (świetlica)|Grodzisk Mazowiecki|ul. Westfala 3 |05-827 Grodzisk Mazowiecki;1513;1011;1011;14;997;66.82;1.38
94434;140504;Gimnazjum nr 2|Grodzisk Mazowiecki|ul. Westfala 3 |05-827 Grodzisk Mazowiecki;1538;997;998;17;980;64.82;1.71
94435;140504;Szkoła Podstawowa Nr 2 (oddziały przedszkolne)|Grodzisk Mazowiecki|ul. Westfala 3 |05-827 Grodzisk Mazowiecki;1607;1084;1084;12;1072;67.45;1.11
94436;140504;Przedszkole nr 4|Grodzisk Mazowiecki|ul. Górna 12 |05-825 Grodzisk Mazowiecki;2054;1431;1431;19;1412;69.67;1.33
94437;140504;Przedszkole Nr 4|Grodzisk Mazowiecki|ul. Górna 12 |05-825 Grodzisk Mazowiecki;2158;1361;1361;16;1345;63.07;1.18
94438;140504;Świetlica Sołectwa w Natolinie|Natolin| 31 |05-825 Grodzisk Mazowiecki;1557;806;806;10;796;51.77;1.24
94439;140504;Ludowy Klub Sportowy Chlebnia|Chlebnia| 54 |05-825 Grodzisk Mazowiecki;1865;945;945;32;913;50.67;3.39
94440;140504;Swietlica Sołectwa w Kozerkach|Kozerki|ul. Marsa 37 |05-825 Grodzisk Mazowiecki;1398;772;772;24;748;55.22;3.11
94441;140504;Szkoła Podstawowa w Adamowiźnie (świetlica)|Adamowizna|ul. Osowiecka 33 |05-825 Grodzisk Mazowiecki;856;488;488;10;478;57.01;2.05
94442;140504;Szkoła Postawowa w Adamowiźnie (sala gimnastyczna)|Adamowizna|ul. Osowiecka 33 |05-825 Grodzisk Mazowiecki;1289;779;779;11;768;60.43;1.41
94443;140504;Świetlica Sołectwa w Kadach|Kady|ul. Środkowa 72 |05-825 Grodzisk Mazowiecki;1465;970;970;13;957;66.21;1.34
94444;140504;Szkoła Podstawowa w Książenicach|Książenice|aleja E. Marylskiego 3 |05-825 Grodzisk Mazowiecki;1414;877;878;7;870;62.02;0.80
94445;140504;RAVAK|Kałęczyn|ul. Radziejowicka 124 |05-825 Grodzisk Mazowiecki;1128;680;680;11;669;60.28;1.62
94446;140504;Oddział Zewnętrzny Aresztu Śledczego Warszawa Służewiec w Grodzisku Mazowieckim|Grodzisk Mazowiecki|1 Maja 27 |05-825 Grodzisk Mazowiecki;62;57;57;4;53;91.94;7.02
94447;140504;Szpital Zachodni w Grodzisku Mazowieckim|Grodzisk Mazowiecki|Daleka 11 |05-825 Grodzisk Mazowiecki;131;20;20;0;20;15.27;0.00
94448;140504;DPS w Izdebnie Kościelnym|Izdebno Kościelne|Ks. M. Oziębłowskiego 20 |05-825 Grodzisk Mazowiecki;16;14;14;1;13;87.50;7.14
94449;140504;DPS Filia w Grodzisku Mazowieckim|Grodzisk Mazowiecki|3 Maja 63 |05-825 Grodzisk Mazowiecki;13;13;13;1;12;100.00;7.69
94450;140505;Ochotnicza Straż Pożarna|Jaktorów|ul. Warszawska 2 |96-313 Jaktorów;1555;863;863;25;838;55.50;2.90
94451;140505;Gimnazjum|Międzyborów|ul. Staszica 5 |96-316 Międzyborów;1663;1018;1018;22;996;61.21;2.16
94452;140505;Budy Zosine Nr 109 (była szkoła)|Budy Zosine| 109 |96-313 Jaktorów;579;264;264;7;257;45.60;2.65
94453;140505;Budy Michałowskie Nr 77 (była szkoła)|Budy Michałowskie| 77 |96-316 Międzyborów;437;167;167;4;163;38.22;2.40
94454;140505;Szkoła Podstawowa|Jaktorów|ul. Warszawska 88 |96-313 Jaktorów;1755;1019;1019;22;997;58.06;2.16
94455;140505;Sala Gimnastyczna przy Szkole Podstawowej|Międzyborów|ul. Staszica 5 |96-316 Międzyborów;1780;909;909;24;885;51.07;2.64
94456;140505;Gimnazjum|Jaktorów|ul. Chełmońskiego 4 |96-313 Jaktorów;1306;731;731;18;713;55.97;2.46
94457;140506;Szkoła Podstawowa im. Stefanii Dziewulskiej|Ojrzanów|ul. Szkolna 1 |96-321 Żabia Wola;1657;916;916;19;897;55.28;2.07
94458;140506;Szkoła Podstawowa im.Marii Kownackiej|Skuły|ul. Mszczonowska 3 |96-321 Żabia Wola;1413;649;649;26;623;45.93;4.01
94459;140506;Dawny budynek Szkoły Podstawowej|Słubica Dobra|ul. Słoneczna 36 |96-321 Żabia Wola;620;335;335;6;329;54.03;1.79
94460;140506;Gimnazjum im.Józefa Chełmońskiego|Józefina|ul. Mazowiecka 1 |96-321 Żabia Wola;1640;1033;1033;12;1021;62.99;1.16
94461;140506;Dom Kultury|Żabia Wola|ul. Warszawska 27 |96-321 Żabia Wola;1062;612;612;14;598;57.63;2.29
94462;140601;Budynek Urzędu Gminy w Belsku Dużym|Belsk Duży|ul. Jana Kozietulskiego 4 |05-622 Belsk Duży;1186;560;560;13;547;47.22;2.32
94463;140601;Publiczna Szkoła Podstawowa w Lewiczynie|Lewiczyn| 94 |05-622 Belsk Duży;629;306;306;3;303;48.65;0.98
94464;140601;Publiczna Szkoła Podstawowa w Łęczeszycach|Łęczeszyce| 47 |05-622 Belsk Duży;816;434;434;10;424;53.19;2.30
94465;140601;Remiza OSP w Wilczogórze|Wilczogóra| 12a |05-622 Belsk Duży;345;173;173;0;173;50.14;0.00
94466;140601;Budynek Szkoły Podstawowej w Rożcach|Rożce| 9 |05-622 Belsk Duży;494;168;168;9;159;34.01;5.36
94467;140601;Publiczna Szkoła Podstawowa w Zaborowie|Zaborów| 40 |05-622 Belsk Duży;601;303;303;8;295;50.42;2.64
94468;140601;Budynek Urzędu Gminy w Belsku Dużym|Belsk Duży|ul. Jana Kozietulskiego 4 |05-622 Belsk Duży;1018;447;447;24;423;43.91;5.37
94469;140601;Budynek Świetlicy Wiejskiej w Bodzewie|Bodzew| 13 |05-622 Belsk Duży;264;153;153;0;153;57.95;0.00
94470;140602;Publiczna Szkoła Podstawowa w Błędowie|Błędów|ul. Stary Rynek 9 |05-620 Błędów;1232;667;667;15;652;54.14;2.25
94471;140602;Publiczna Szkoła Podstawowa w Gołoszach|Gołosze| 28 |05-620 Błędów;784;348;348;6;342;44.39;1.72
94472;140602;Publiczna Szkoła Podstawowa w Wilkowie|Wilków Drugi| 82a |05-620 Błędów;1817;668;668;11;657;36.76;1.65
94473;140602;Publiczna Szkoła Podstawowa w Lipiu|Lipie| 32 |05-620 Błędów;1215;486;486;13;473;40.00;2.67
94474;140602;Publiczne Gimnazium w Błędowie|Błędów|ul. Stary Rynek 9 |05-620 Błędów;1214;511;511;3;508;42.09;0.59
94475;140603;Publiczne Gimnazjum w Chynowie|Chynów|ul. Szkolna 1 |05-650 Chynów;1897;998;998;16;982;52.61;1.60
94476;140603;Publiczna Szkoła Podstawowa w Machcinie|Machcin| 30 |05-650 Chynów;702;263;263;8;255;37.46;3.04
94477;140603;Publiczna Szkoła Podstawowa w Zalesiu|Zalesie| 12 |05-650 Chynów;607;229;229;3;226;37.73;1.31
94478;140603;Publiczna Szkoła Podstawowa w Watraszewie|Watraszew| 4B |05-650 Chynów;513;254;254;8;246;49.51;3.15
94479;140603;Publiczna Szkoła Podstawowa w Budziszynku|Budziszynek| 5 |05-650 Chynów;707;288;288;8;280;40.74;2.78
94480;140603;Zespół Szkół w Drwalewie|Drwalew|ul. Szkolna 4 |05-651 Chynów;1466;689;689;25;664;47.00;3.63
94481;140603;Publiczna Szkoła Podstawowa w Pieczyskach|Pieczyska| 13 |05-651 Chynów;464;251;251;5;246;54.09;1.99
94482;140603;Publiczna Szkoła Podstawowa w Sułkowicach|Sułkowice|ul. Ogrodowa 38A |05-650 Chynów;1554;828;828;27;801;53.28;3.26
94483;140604;Hala Sportowa w Goszczynie|Goszczyn|ul. Armii Krajowej 2 |05-610 Goszczyn;1084;484;484;12;472;44.65;2.48
94484;140604;Ochotnicza Straż Pożarna w Długowoli|Długowola| 145 |05-610 Goszczyn;770;359;359;15;344;46.62;4.18
94485;140604;Publiczna Szkoła Podstawowa w Bądkowie|Bądków| 68 |05-610 Goszczyn;503;330;330;7;323;65.61;2.12
94486;140605;Publiczna Szkoła Podstawowa Nr 1 w Grójcu|Grójec|ul. Józefa Piłsudskiego 68 |05-600 Grójec;1943;1082;1082;19;1063;55.69;1.76
94487;140605;Starostwo Powiatowe w Grójcu|Grójec|ul. Józefa Piłsudskiego 59 |05-600 Grójec;2146;1256;1256;31;1225;58.53;2.47
94488;140605;Powiatowy Cech Rzemieślników i Przedsiębiorców w Grójcu|Grójec|ul. Polskiej Organizacji Wojskowej 4 |05-600 Grójec;1892;1059;1059;24;1035;55.97;2.27
94489;140605;Publiczne Gimnazjum w Grójcu|Grójec|ul. Polna 17 |05-600 Grójec;1793;1005;1005;16;989;56.05;1.59
94490;140605;Publiczna Szkoła Podstawowa Nr 2 w Grójcu|Grójec|ul. Polna 17A |05-600 Grójec;1710;957;957;33;924;55.96;3.45
94491;140605;Ratusz Miejski w Grójcu|Grójec|Plac Wolności 2 |05-600 Grójec;1660;801;801;22;779;48.25;2.75
94492;140605;Publiczna Szkoła Podstawowa Nr 3 w Grójcu|Grójec|ul. Armii Krajowej 34 |05-600 Grójec;2060;1024;1024;32;992;49.71;3.12
94493;140605;Siedziba byłej Publicznej Szkoły Podstawowej w Słomczynie|Słomczyn| 42 |05-600 Grójec;547;257;257;9;248;46.98;3.50
94494;140605;Regionalna Dyrekcja Lasów Państwowych w Radomiu Nadleśnictwo Grójec|Podole| 91 |05-600 Grójec;1199;602;602;12;590;50.21;1.99
94495;140605;Publiczna Szkoła Podstawowa w Lesznowoli|Lesznowola|ul. Szkolna 1 |05-600 Grójec;1485;762;762;11;751;51.31;1.44
94496;140605;Publiczna Szkoła Podstawowa w Częstoniewie|Częstoniew| 60 |05-600 Grójec;640;236;236;16;220;36.88;6.78
94497;140605;Publiczna Szkoła Podstawowa w Bikówku|Bikówek| 21 |05-600 Grójec;1114;573;573;15;558;51.44;2.62
94498;140605;Ochotnicza Staż Pożarna w Pabierowicach|Pabierowice| 39B |05-600 Grójec;759;366;366;7;359;48.22;1.91
94499;140605;SGGW w Warszawie RZD Wilanów Obory w Kociszewie|Kociszew| 1E |05-600 Grójec;615;278;278;9;269;45.20;3.24
94500;140605;Areszt Śledczy w Grójcu|Grójec|Armii Krajowej 21 |05-600 Grójec;188;105;105;13;92;55.85;12.38
94501;140605;Powiatowe Centrum Medyczne w Grójcu|Grójec|Księdza Piotra Skargi 10 |05-600 Grójec;74;36;36;0;36;48.65;0.00
94502;140605;Dom Pomocy Społecznej "Pod Topolami" w Lesznowoli|Lesznowola|Grójecka 1 |05-600 Grójec;80;15;15;5;10;18.75;33.33
94503;140606;Gminna Biblioteka Publiczna w Jasieńcu|Jasieniec|ul. Warecka 42 |05-604 Jasieniec;2014;939;939;44;895;46.62;4.69
94504;140606;Publiczna Szkoła Podstawowa w Zbroszy Dużej|Zbrosza Duża| 30 |05-604 Jasieniec;798;363;363;12;351;45.49;3.31
94505;140606;Świetlica wiejska w Nowym Miedzechowie|Nowy Miedzechów| 26a |05-604 Jasieniec;657;258;258;9;249;39.27;3.49
94506;140606;Ochotnicza Straż Pożarna w Boglewicach|Boglewice| 46 |05-604 Jasieniec;820;327;327;20;307;39.88;6.12
94507;140607;Zespół Szkół Ogólnokształcących w Mogielnicy|Mogielnica|ul. Nowomiejska 1 |05-640 Mogielnica;1249;555;555;24;531;44.44;4.32
94508;140607;Budynek Biura Rady Miejskiej|Mogielnica|ul. Rynek 15 |05-640 Mogielnica;1003;544;544;28;516;54.24;5.15
94509;140607;Publiczna Szkoła Podstawowa w Mogielnicy|Mogielnica|Przylesie 10 |05-640 Mogielnica;1439;572;572;26;546;39.75;4.55
94510;140607;Publiczna Szkoła Podstawowa w Borowem|Borowe| 29 |05-640 Mogielnica;716;272;272;13;259;37.99;4.78
94511;140607;Publiczna Szkoła Podstawowa w Michałowicach|Michałowice| 4 |05-640 Mogielnica;575;272;272;21;251;47.30;7.72
94512;140607;Publiczna Szkoła Podstawowa w Brzostowcu|Brzostowiec| 55 |05-640 Mogielnica;595;251;251;9;242;42.18;3.59
94513;140607;Budynek OSP w Miechowicach|Miechowice| 32 |05-640 Mogielnica;758;305;305;9;296;40.24;2.95
94514;140607;Niepubliczna Szkoła Podstawowa w Kozietułach|Kozietuły| 83 |05-640 Mogielnica;592;247;247;3;244;41.72;1.21
94515;140607;Dom Pomocy Społecznej w Tomczycach|Tomczyce| 40 |05-640 Mogielnica;476;189;189;11;178;39.71;5.82
94516;140608;Publiczne Gimnazjum w Nowym Mieście nad Pilicą|Nowe Miasto nad Pilicą|ul. Ogrodowa 16 |26-420 Nowe Miasto nad Pilicą;1751;959;959;20;939;54.77;2.09
94517;140608;Przychodnia Rejonowa w Nowym Mieście nad Pilicą|Nowe Miasto nad Pilicą|ul. Spacerowa 1 |26-420 Nowe Miasto nad Pilicą;1506;907;907;22;885;60.23;2.43
94518;140608;Publiczna Szkoła Podstawowa w Żdżarach|Żdżary| 75B |26-420 Nowe Miasto nad Pilicą;1258;558;558;33;525;44.36;5.91
94519;140608;Remiza OSP w Łęgonicach|Łęgonice| 119 |26-420 Nowe Miasto nad Pilicą;974;390;390;25;365;40.04;6.41
94520;140608;Publiczna Szkoła Podstawowa w Nowym Mieście nad Pilicą|Nowe Miasto nad Pilicą|ul. Szkolna 4 |26-420 Nowe Miasto nad Pilicą;1320;648;648;25;623;49.09;3.86
94521;140608;Dom Pomocy Społecznej im. Natalii Nitosławskiej|Nowe Miasto nad Pilicą|Bielińskiego 26 |26-420 Nowe Miasto nad Pilicą;63;46;46;1;45;73.02;2.17
94522;140608;Samodzielny Publiczny Zakład Opieki Zdrowotnej|Nowe Miasto nad Pilicą|Tomaszowska 43 |26-420 Nowe Miasto nad Pilicą;34;14;14;1;13;41.18;7.14
94523;140609;Publiczna Szkoła Podstawowa w Karolewie|Karolew| 3 |05-652 Pniewy;1019;454;454;25;429;44.55;5.51
94524;140609;Publiczna Szkoła Podstawowa w Ciechlinie|Ciechlin| 39A |05-652 Pniewy;658;284;284;8;276;43.16;2.82
94525;140609;Publiczna Szkoła Podstawowa w Jeziorze|Jeziora| 45A |05-652 Pniewy;777;374;374;10;364;48.13;2.67
94526;140609;Publiczne Gimnazjum w Kruszewie|Kruszew| 57B |05-652 Pniewy;1359;673;673;27;646;49.52;4.01
94527;140611;Publiczne Gimnazjum Nr1 w Warce|Warka|ul.Warszawska 24 |05-660 Warka;1854;1056;1056;9;1047;56.96;0.85
94528;140611;Publiczna Szkoła Podstawowa Nr 2 w Warce|Warka|ul.Polna 17 |05-660 Warka;1670;886;886;22;864;53.05;2.48
94529;140611;Publiczna Szkoła Podstawowa Nr 1 w Warce|Warka|ul.Polna 19 |05-660 Warka;1256;577;577;18;559;45.94;3.12
94530;140611;Zespół Szkół Ponadgimnazjalnych w Warce|Warka|ul.Obwodowa 2 |05-660 Warka;1105;543;543;13;530;49.14;2.39
94531;140611;Przedszkole Samorządowe Nr 1 w Warce|Warka|Armii Krajowej 10 |05-660 Warka;1687;924;924;45;879;54.77;4.87
94532;140611;Muzeum im. Kazimierza Pułaskiego w Warce (w budynku Centrum Edukacyjno-Muzealnym)|Warka|Kazimierza Pułaskiego 22 |05-660 Warka;1793;998;998;32;966;55.66;3.21
94533;140611;Publiczna Szkoła Podstawowa w Michałowie|Michałów-Parcela| 23 |05-660 Warka;676;225;225;16;209;33.28;7.11
94534;140611;Publiczna Szkoła Podstawowa we Wrociszewie|Wrociszew| 20 |05-660 Warka;1204;461;461;12;449;38.29;2.60
94535;140611;Zespół Szkolno-Przedszkolny w Nowej Wsi|Nowa Wieś| 69 |05-660 Warka;554;226;226;7;219;40.79;3.10
94536;140611;Świetlica wiejska w Laskach|Laski| 2 |05-660 Warka;678;307;307;10;297;45.28;3.26
94537;140611;Świetlica wiejska w Gośniewicach|Gośniewice| 49 |05-660 Warka;608;261;261;4;257;42.93;1.53
94538;140611;Publiczne Gimnazjum w Dębnowoli|Dębnowola| 67 |05-660 Warka;863;366;366;8;358;42.41;2.19
94539;140611;Publiczna Szkoła Podstawowa w Ostrołęce|Ostrołęka| 3 |05-660 Warka;538;225;225;9;216;41.82;4.00
94540;140611;Publiczna Szkoła Podstawowa w Konarach|Konary| 20 |05-660 Warka;849;440;440;7;433;51.83;1.59
94541;140701;Przedszkole Samorządowe "Pod Sosnową Szyszką"|Garbatka-Letnisko|ul. Ignacego Krasickiego 4 |26-930 Garbatka-Letnisko;595;322;322;3;319;54.12;0.93
94542;140701;Publiczne Gimnazjum|Garbatka-Letnisko|ul. Hanki Lewandowicz 2 |26-930 Garbatka-Letnisko;1251;638;638;13;625;51.00;2.04
94543;140701;Lokal po Gminnym Centrum Kultury, Sportu i Promocji|Garbatka-Letnisko|ul. Jana Kochanowskiego 135 |26-930 Garbatka-Letnisko;1546;778;778;27;751;50.32;3.47
94544;140701;Publiczna Szkoła Podstawowa w Bogucinie|Bogucin| |26-930 Garbatka-Letnisko;491;170;170;7;163;34.62;4.12
94545;140701;Budynek po Publicznej Szkole Podstawowej w Bąkowcu|Bąkowiec| 50 |26-930 Garbatka-Letnisko;473;206;206;8;198;43.55;3.88
94546;140701;Zakład Karny w Żytkowicach|Żytkowice| |26-930 Garbatka-Letnisko;394;161;161;22;139;40.86;13.66
94547;140702;Zespół Szkół Ogólnokształcących w Brzózie|Brzóza|ul. Aleja Lipowa 4 |26-903 Głowaczów;1640;838;838;13;825;51.10;1.55
94548;140702;Ochotnicza Straż Pożarna w Mariampolu|Mariampol| 8 |26-903 Głowaczów;596;211;211;8;203;35.40;3.79
94549;140702;Publiczne Gimnazjum w Głowaczowie|Głowaczów|ul. Warecka 10 |26-903 Głowaczów;1418;766;766;20;746;54.02;2.61
94550;140702;Ochotnicza Straż Pożarna w Miejskiej Dąbrowie|Miejska Dąbrowa| 24 |26-903 Głowaczów;618;241;241;12;229;39.00;4.98
94551;140702;Zespół Szkół w Ursynowie|Ursynów| 48 |26-903 Głowaczów;1227;558;558;20;538;45.48;3.58
94552;140702;Ochotnicza Straż Pożarna w Bobrownikach|Bobrowniki| 42A |26-903 Głowaczów;616;248;248;13;235;40.26;5.24
94553;140703;Zespół Szkolno-Przedszkolny w Gniewoszowie|Gniewoszów|ul.Konopnickiej 19 |26-920 Gniewoszów;554;268;268;3;265;48.38;1.12
94554;140703;Publiczna Szkoła Podstawowa w Wysokim Kole|Wysokie Koło| 22 |26-920 Gniewoszów;1106;506;506;19;487;45.75;3.75
94555;140703;Budynek po byłej Szkole Podstawowej w Oleksowie|Oleksów| 63 |26-920 Gniewoszów;1034;471;471;14;457;45.55;2.97
94556;140703;Remiza Ochotniczej Straży Pożarnej w Sarnowie|Sarnów| 24 |26-920 Gniewoszów;615;208;208;7;201;33.82;3.37
94557;140704;Zespół Szkół w Grabowie nad Pilicą|Grabów nad Pilicą|Ul. Parkowa 4 |26-902 Grabów nad Pilicą;1268;635;635;24;611;50.08;3.78
94558;140704;Świetlica Zespółu Szkół w Grabowie nad Pilicą|Grabów nad Pilicą|Parkowa 4 |26-902 Grabów nad Pilicą;935;423;423;26;397;45.24;6.15
94559;140704;Budynek Ochotniczej Straży Pożarnej w Łękawicy|Łękawica| 10B |26-902 Grabów nad Pilicą;567;192;192;10;182;33.86;5.21
94560;140704;Publiczna Szkoła Podstawowa w Augustowie|Augustów|ul. Wspólna 19 |26-902 Grabów nad pilicą;426;210;210;16;194;49.30;7.62
94561;140705;Publiczna Szkoła Podstawowa w Ryczywole|Ryczywół|ul. Warszawska 17 |26-900 Kozienice;1030;453;453;13;440;43.98;2.87
94562;140705;Publiczne Gimnazjum w Świerżach Górnych|Świerże Górne| 25a |26-900 Kozienice;1169;506;506;27;479;43.28;5.34
94563;140705;Publiczna Szkoła Podstawowa w Stanisławicach|Stanisławice| 94 |26-900 Kozienice;850;445;445;12;433;52.35;2.70
94564;140705;Publiczna Szkoła Podstawowa w Brzeźnicy|Brzeźnica| 9 |26-900 Kozienice;1067;523;523;21;502;49.02;4.02
94565;140705;Zarząd Dróg Powiatowych w Kozienicach, siedziba w Aleksandrówce|Aleksandrówka|ul. Serdeczna 3 |26-900 Kozienice;1458;794;794;30;764;54.46;3.78
94566;140705;Publiczne Przedszkole Nr 3 w Kozienicach|Kozienice|ul. Głowaczowska 45 |26-900 Kozienice;973;517;517;22;495;53.13;4.26
94567;140705;Publiczna Szkoła Podstawowa w Janikowie|Janików| 1 |26-900 Kozienice;1229;547;547;13;534;44.51;2.38
94568;140705;Publiczna Szkoła Podstwowa w Nowej Wsi|Nowa Wieś| 81 |26-900 Kozienice;1001;445;445;7;438;44.46;1.57
94569;140705;Świetlica OSP Przewóz|Przewóz| 2a |26-900 Kozienice;672;281;281;13;268;41.82;4.63
94570;140705;Publiczna Szkoła Podstawowa w Wólce Tyrzyńskiej|Wólka Tyrzyńska| 21a |26-900 Kozienice;522;212;212;6;206;40.61;2.83
94571;140705;Publiczne Przedszkole Nr 3 w Kozienicach|Kozienice|ul. Głowaczowska 45 |26-900 Kozienice;1151;689;689;9;680;59.86;1.31
94572;140705;Publiczne Przedszkole Nr 2 w Kozienicach|Kozienice|ul. Stefana Żeromskiego 3 |26-900 Kozienice;1261;642;642;18;624;50.91;2.80
94573;140705;Publiczne Przedszkole Nr 1 w Kozienicach|Kozienice|ul. Mikołaja Kopernika 11 |26-900 Kozienice;1221;636;636;15;621;52.09;2.36
94574;140705;Publiczna Szkoła Podstawowa Nr 3 w Kozienicach|Kozienice|ul. Stanisława Konarskiego 4 |26-900 Kozienice;1207;686;686;11;675;56.84;1.60
94575;140705;Zespół Szkół Nr 1 w Kozienicach|Kozienice|ul. Warszawska 72 |26-900 Kozienice;1103;648;648;14;634;58.75;2.16
94576;140705;Gimnazjum Nr 2 w Kozienicach|Kozienice|ul. Głowaczowska 33 |26-900 Kozienice;1218;716;716;10;706;58.78;1.40
94577;140705;Publiczna Szkoła Podstawowa Nr 1 w Kozienicach|Kozienice|ul. Tadeusza Kościuszki 1 |26-900 Kozienice;1092;578;578;9;569;52.93;1.56
94578;140705;Gimnazjum Nr 1 w Kozienicach|Kozienice|ul. Nowy Świat 24 |26-900 Kozienice;1207;648;648;10;638;53.69;1.54
94579;140705;Publiczna Szkoła Podstawowa Nr 1 w Kozienicach|Kozienice|ul. Tadeusza Kościuszki 1 |26-900 Kozienice;1321;672;672;15;657;50.87;2.23
94580;140705;Kozienicki Dom Kultury im. Bogusława Klimczuka w Kozienicach|Kozienice|Al. 1 Maja 8 |26-900 Kozienice;1312;648;648;11;637;49.39;1.70
94581;140705;Dom Pomocy Społecznej dla Dorosłych w Kozienicach|Kozienice|ul. Lubelska 50 |26-900 Kozienice;88;48;48;4;44;54.55;8.33
94582;140705;Świetlica OSP ul. Lubelska 89 w Kozienicach|Kozienice|ul. Lubelska 89 |26-900 Kozienice;1049;600;600;5;595;57.20;0.83
94583;140705;Liceum Ogólnokształcące w Kozienicach|Kozienice|ul. Warszawska 25 |26-900 Kozienice;1397;729;729;23;706;52.18;3.16
94584;140705;SPZZOZ w Kozienicach, budynek główny|Kozienice|ul. Al. Władysława Sikorskiego 10 |26-900 Kozienice;189;49;49;0;49;25.93;0.00
94585;140705;SPZZOZ w Kozienicach, pawilon "Z"|Kozienice|ul. Al. Władysława Sikorskiego 10 |26-900 Kozienice;53;33;33;1;32;62.26;3.03
94586;140706;Publiczna Szkoła Podstawowa w Magnuszewie|Magnuszew|ul. Bohaterów Września 10 |26-910 Magnuszew;944;451;451;10;441;47.78;2.22
94587;140706;Publiczne Gimnazjum w Magnuszewie|Magnuszew|ul. Bohaterów Września 10 |26-910 Magnuszew;910;397;397;11;386;43.63;2.77
94588;140706;Publiczna Szkoła Podstawowa w Przydworzycach|Przydworzyce| 37 |26-910 Magnuszew;721;353;353;7;346;48.96;1.98
94589;140706;Świetlica w Trzebieniu|Trzebień| 36 |26-910 Magnuszew;334;136;136;9;127;40.72;6.62
94590;140706;Ochotnicza Straż Pożarna w Wilczkowicach Dolnych|Wilczkowice Dolne| 4A |26-910 Magnuszew;432;212;212;3;209;49.07;1.42
94591;140706;Publiczna Szkoła Podstawowa w Chmielewie|Chmielew| 20a |26-910 Magnuszew;605;252;252;5;247;41.65;1.98
94592;140706;Publiczne Gimnazjum w Mniszewie|Mniszew| 43A |26-910 Magnuszew;581;282;282;3;279;48.54;1.06
94593;140706;Publiczna Szkoła Podstawowa w Rozniszewie|Rozniszew| 20A |26-910 Magnuszew;831;426;426;24;402;51.26;5.63
94594;140706;Budynek Byłej Szkoły Podstawowej w Osiemborowie|Osiemborów| 27B |26-910 Magnuszew;315;126;126;7;119;40.00;5.56
94595;140707;Zespół Szkolno - Przedszkolny w Słowikach Starych|Słowiki Stare| 9 |26-922 Sieciechów;761;303;303;14;289;39.82;4.62
94596;140707;Zespół Placówek Oświatowych w Sieciechowie|Sieciechów|ul. Szkolna 1 |26-922 Sieciechów;1252;540;540;14;526;43.13;2.59
94597;140707;Świetlica Wiejska w Zajezierzu|Zajezierze|ul. 28 Pułku Artylerii Lekkiej 7 |26-922 Sieciechów;1290;576;576;14;562;44.65;2.43
94598;140801;Powiatowy Zespół Szkół Ponadgimnazjalnych|Legionowo|ul. Targowa 73A |05-120 Legionowo;1583;982;983;12;970;62.03;1.22
94599;140801;Przedszkole Miejskie Nr 1|Legionowo|ul. Olszankowa E |05-120 Legionowo;1893;1010;1010;23;987;53.35;2.28
94600;140801;Zespół Szkolno-Przedszkolny|Legionowo|ul. Jana Pawła I 2 |05-119 Legionowo;1902;1200;1200;19;1181;63.09;1.58
94601;140801;Zespół Szkół|Legionowo|ul. Zegrzyńska 3 |05-119 Legionowo;1767;1217;1217;12;1205;68.87;0.99
94602;140801;Zespół Szkół|Legionowo|ul. Zegrzyńska 3 |05-119 Legionowo;2264;1239;1239;15;1224;54.73;1.21
94603;140801;Przedszkole Miejskie Nr 11|Legionowo|ul. Zegrzyńska 9 |05-119 Legionowo;2146;1494;1494;16;1478;69.62;1.07
94604;140801;Przedszkole Miejskie Nr 3|Legionowo|ul. Zegrzyńska 71 |05-119 Legionowo;2353;1464;1464;12;1452;62.22;0.82
94605;140801;Zespół Szkół Nr 1|Legionowo|ul. Zakopiańska 4 |05-120 Legionowo;1967;1277;1277;26;1251;64.92;2.04
94606;140801;Dawna siedziba Urzędu Miasta Legionowo|Legionowo|ul. marsz. Józefa Piłsudskiego 3 |05-120 Legionowo;2075;1314;1314;12;1302;63.33;0.91
94607;140801;Urząd Miasta Legionowo|Legionowo|ul. marsz.Józefa Piłsudskiego 41 |05-120 Legionowo;2265;1474;1474;13;1461;65.08;0.88
94608;140801;Zespół Szkolno-Przedszkolny Nr 2|Legionowo|ul. Jagiellońska 67 |05-120 Legionowo;984;638;638;4;634;64.84;0.63
94609;140801;Zespół Szkolno-Przedszkolny Nr 2|Legionowo|ul. Jagiellońska 67 |05-120 Legionowo;1631;1052;1052;11;1041;64.50;1.05
94610;140801;Arena Legionowo|Legionowo|ul. Bolesława Chrobrego 50B |05-120 Legionowo;1265;885;885;3;882;69.96;0.34
94611;140801;Administracja Osiedla Sobieskiego|Legionowo|ul. Jana III Sobieskiego 47A |05-120 Legionowo;1669;1077;1077;19;1058;64.53;1.76
94612;140801;Przedszkole Miejskie z Oddziałami Integracyjnymi Nr 7|Legionowo|ul. Husarska 18A |05-120 Legionowo;1631;1059;1059;14;1045;64.93;1.32
94613;140801;Szkoła Podstawowa nr 7|Legionowo|ul. Królowej Jadwigi 7 |05-120 Legionowo;1519;927;927;15;912;61.03;1.62
94614;140801;Miejski Ośrodek Kultury|Legionowo|ul. Cypriana Kamila Norwida 10 |05-120 Legionowo;1869;1164;1164;20;1144;62.28;1.72
94615;140801;Warsztat Terapii Zajęciowej|Legionowo|ul. Zwycięstwa 4 |05-120 Legionowo;1873;1221;1221;20;1201;65.19;1.64
94616;140801;Zespół Szkół Nr 3|Legionowo|ul. Władysława Broniewskiego 7 |05-120 Legionowo;1558;990;990;11;979;63.54;1.11
94617;140801;Przedszkole Miejskie Nr 6|Legionowo|ul. Władysława Broniewskiego 3 |05-120 Legionowo;1522;923;923;14;909;60.64;1.52
94618;140801;Żłobek Miejski|Legionowo|ul. ppłk. Edwarda Dietricha 1 |05-120 Legionowo;1765;1031;1031;27;1004;58.41;2.62
94619;140801;Liceum Ogólnokształcące|Legionowo|ul. marsz. Józefa Piłsudskiego 26 |05-120 Legionowo;2016;1239;1239;22;1217;61.46;1.78
94620;140801;Powiatowy Zespół Szkół i Placówek Specjalnych|Legionowo|Jagiellońska 69 |05-120 Legionowo;1267;840;840;13;827;66.30;1.55
94621;140801;Dom Opieki Społecznej "Kombatant"|Legionowo|Jagiellońska 71 |05-120 Legionowo;77;51;51;3;48;66.23;5.88
94622;140802;Szkoła Podstawowa im. Armii Krajowej|Jabłonna|Szkolna 2 |05-110 JABŁONNA;1756;1096;1096;20;1076;62.41;1.82
94623;140802;Szkoła Podstawowa im. Armii Krajowej|Jabłonna|Szkolna 2 |05-110 JABŁONNA;1908;1281;1281;14;1267;67.14;1.09
94624;140802;Szkoła Podstawowa im. Armii Krajowej|Jabłonna|Szkolna 2 |05-110 JABŁONNA;1243;815;815;4;811;65.57;0.49
94625;140802;Szkoła Podstawowa im. Armii Krajowej|Jabłonna|Szkolna 2 |05-110 JABŁONNA;1415;858;858;17;841;60.64;1.98
94626;140802;Publiczne Gimnazjum im. Orła Białego|Chotomów|Partyzantów 23 |05-123 CHOTOMÓW;1156;764;764;15;749;66.09;1.96
94627;140802;Publiczne Gimnazjum im. Orła Białego|Chotomów|Partyzantów 23 |05-123 Chotomów;1684;1076;1076;8;1068;63.90;0.74
94628;140802;Publiczne Gimnazjum im. Orła Białego|Chotomów|Partyzantów 23 |05-123 CHOTOMÓW;1989;1331;1331;12;1319;66.92;0.90
94629;140802;GCKiS Filia w Skierdach|Skierdy|Nadwiślańska 1 |05-101 Nowy Dwór Mazowiecki;1038;654;654;0;654;63.01;0.00
94630;140802;Klub Rolnika|Boża Wola| 42 |05-101 Nowy Dwór Mazowiecki;906;532;532;10;522;58.72;1.88
94631;140803;Gimnazjum im. Bohaterów Bitwy Warszawskiej 1920 r. w Stanisławowie Pierwszym|Stanisławów Pierwszy|ul. Jana Kazimierza 291 |05-126 Nieporęt;745;581;581;10;571;77.99;1.72
94632;140803;Gminne Przedszkole w Nieporęcie|Nieporęt|ul.Jana Kazimierza 104 |05-126 Nieporęt;942;643;643;12;631;68.26;1.87
94633;140803;Szkoła Podstawowa Nr 1 im. Bronisława Tokaja w Nieporęcie|Nieporęt|ul. Dworcowa 9 |05-126 Nieporęt;676;429;429;5;424;63.46;1.17
94634;140803;Szkoła Podstawowa Nr 1 im. Bronisława Tokaja w Nieporęcie|Nieporęt|ul. Dworcowa 9 |05-126 Nieporęt;921;596;596;12;584;64.71;2.01
94635;140803;Szkoła Podstawowa im.Wojska Polskiego w Białobrzegach|Białobrzegi|ul. Wojska Polskiego 21 |05-127 Białobrzegi;1199;657;657;14;643;54.80;2.13
94636;140803;Gimnazjum im. Bohaterów Bitwy Warszawskiej 1920 r. w Stanisławowie Pierwszym|Stanisławów Pierwszy|ul. Jana Kazimierza 291 |05-126 Nieporęt;835;588;588;2;586;70.42;0.34
94637;140803;Szkoła Podstawowa im. Batalionu Saperów Kościuszkowskich w Izabelinie|Izabelin|ul. Szkolna 1 |05-126 Nieporęt;680;446;446;6;440;65.59;1.35
94638;140803;Szkoła Podstawowa im.Wandy Chotomskiej w Józefowie|Józefów|ul. Szkolna 62 |05-119 Legionowo;820;515;515;17;498;62.80;3.30
94639;140803;Ośrodek Kultury w Kątach Węgierskich|Kąty Węgierskie|ul. Kościelna 22 |05-126 Nieporęt;1054;661;661;10;651;62.71;1.51
94640;140803;Szkoła Podstawowa im. Wandy Chotomskiej w Józefowie|Józefów|ul. Szkolna 62 |05-119 Legionowo;597;481;481;6;475;80.57;1.25
94641;140803;Ośrodek Kultury w Stanisławowie Drugim|Stanisławów Drugi|ul. Wolska 71A |05-119 Legionowo;775;508;509;1;507;65.55;0.20
94642;140803;Zespół Szkolno-Przedszkolny im. 28 Pułku Strzelców Kaniowskich w Wólce Radzymińskiej|Wólka Radzymińska|ul. Szkolna 79 |05-126 Nieporęt;802;431;431;13;418;53.74;3.02
94643;140803;Ośrodek Kultury w Zegrzu Południowym|Zegrze Południowe|ul. Osiedle Wojskowe 13 |05-130 Zegrze Południowe;714;385;385;6;379;53.92;1.56
94644;140804;Szkoła Podstawowa|Serock|ul. Pułtuska 68 |05-140 Serock;2038;1137;1137;16;1121;55.79;1.41
94645;140804;Samorządowe Przedszkole|Serock|ul. Wolskiego 15 |05-140 Serock;1360;760;760;15;745;55.88;1.97
94646;140804;Świetlica Środowiskowa|Wierzbica| 28 B |05-140 Serock;1407;688;688;17;671;48.90;2.47
94647;140804;Zespół Szkolno-Przedszkolny|Wola Kiełpińska| 1 |05-140 Serock;2077;1035;1035;8;1027;49.83;0.77
94648;140804;Zespół Szkolno-Przedszkolny|Wola Kiełpińska| 1 |05-140 Serock;1889;937;937;23;914;49.60;2.45
94649;140804;Szkoła Podstawowa|Jadwisin|ul. Szkolna 46 |05-140 Serock;1608;889;889;14;875;55.29;1.57
94650;140804;Dom Parafialny|Zegrze|ul. Groszkowskiego 1 |05-131 Zegrze;850;525;525;7;518;61.76;1.33
94651;140805;Szkoła Podstawowa im. Józefa Wybickiego|Janówek Pierwszy|ul. Dworcowa 5 |05-124 Skrzeszew;1320;749;749;19;730;56.74;2.54
94652;140805;Szkoła Podstawowa im. Bronisława Sokoła|Olszewnica Stara|ul. Warszawska 40 |05-123 Chotomów;670;415;415;11;404;61.94;2.65
94653;140805;Szkoła Podstawowa im.Kornela Makuszyńskiego|Skrzeszew|ul. Szkolna 10 |05-124 Skrzeszew;2076;1265;1265;16;1249;60.93;1.26
94654;140805;Szkoła Podstawowa im. Tadeusza Kościuszki|Wieliszew|ul. Modlińska 60 |05-135 Wieliszew;1385;773;773;25;748;55.81;3.23
94655;140805;Szkoła Podstawowa im. Tadeusza Kościuszki|Wieliszew|ul. Modlińska 60 |05-135 Wieliszew;1794;1061;1061;31;1030;59.14;2.92
94656;140805;Zespól Szkół w Łajskach|Łajski|ul. Kościelna 63 |05-119 Legionowo;1456;904;904;29;875;62.09;3.21
94657;140805;Dom Ogrodnika Michałów-Reginów|Michałów-Reginów|ul. Nowodworska 31 |05-119 Legionowo;1264;792;792;19;773;62.66;2.40
94658;140805;Mazowiecki Szpital Onkologiczny w Wieliszewie|Wieliszew|Kościelna 61 |05-135 Wieliszew;74;49;49;1;48;66.22;2.04
94659;140901;Remiza OSP w Białobrzegach|Białobrzegi| 18 a |27-312 Chotcza;479;149;149;6;143;31.11;4.03
94660;140901;Zespół Szkół Samorządowych w Chotczy|Chotcza-Józefów| 68 |27-312 Chotcza;836;288;288;11;277;34.45;3.82
94661;140901;Zespół Szkół Samorządowych w Chotczy Filia w Tymienicy|Tymienica Stara| 1 |27-312 Chotcza;703;245;245;13;232;34.85;5.31
94662;140902;Remiza Strażacka w Antoniowie|Antoniów| 36 |27-310 Ciepielów;354;140;140;15;125;39.55;10.71
94663;140902;Publiczna Szkoła Podstawowa w Bąkowej|Bąkowa| 107 |27-310 Ciepielów;494;156;156;7;149;31.58;4.49
94664;140902;Publiczna Szkoła Podstawowa w Ciepielowie|Ciepielów|Lekarska 1 |27-310 Ciepielów;727;324;324;14;310;44.57;4.32
94665;140902;Publiczne Gimnazjum w Ciepielowie|Ciepielów|Plac Zwycięstwa 37 |27-310 Ciepielów;1729;591;591;31;560;34.18;5.25
94666;140902;Dom Ludowy w Wielgiem|Wielgie| |27-310 Ciepielów;697;298;298;12;286;42.75;4.03
94667;140902;Dzienny Ośrodek Fizjoterapii w Pcinie|Pcin| 39 |27-310 Ciepielów;319;103;103;3;100;32.29;2.91
94668;140902;Środowiskowy Dom Samopomocy w Łaziskach|Łaziska| 101 |27-310 Ciepielów;343;122;122;5;117;35.57;4.10
94669;140903;Publiczna Szkoła Podstawowa w Lipsku|Lipsko|ul.Zwoleńska 16 |27-300 Lipsko;1675;761;761;17;744;45.43;2.23
94670;140903;Zespół Szkół Ponadgimnazjalnych w Lipsku|Lipsko|ul.Zwoleńska 12 |27-300 Lipsko;1347;608;608;9;599;45.14;1.48
94671;140903;Lipskie Centrum Kultury w Lipsku|Lipsko|ul.Rynek 2 |27-300 Lipsko;1723;808;808;17;791;46.89;2.10
94672;140903;Budynek byłego Przedszkola w Śląsku|Śląsko| 41 |27-300 Lipsko;545;185;185;7;178;33.94;3.78
94673;140903;Zespół Placówek Oświatowych w Długowoli|Walentynów| 103 |27-300 Lipsko;1005;352;352;6;346;35.02;1.70
94674;140903;Zespół Placówek Oświatowych w Krępie Kościelnej|Krępa Kościelna| 48 |27-300 Lipsko;875;357;357;14;343;40.80;3.92
94675;140903;Ośrodek Szkolno-Wychowawczy w Hucie|Huta| 3 |27-300 Lipsko;234;65;65;6;59;27.78;9.23
94676;140903;Budynek byłej Szkoły Podstawowej w Lipie-Miklas|Lipa-Miklas| 109 |27-300 Lipsko;787;321;321;11;310;40.79;3.43
94677;140903;Swietlica wiejska w Katarzynowie|Katarzynów| 3a |27-300 Lipsko;547;171;171;1;170;31.26;0.58
94678;140903;Publiczna Szkoła Podstawowa w Woli Soleckiej Pierwszej|Wola Solecka Pierwsza| 173 |27-300 Lipsko;669;247;247;8;239;36.92;3.24
94679;140903;Dom Pomocy Społecznej w Lipsku|Lipsko|ul.1 Maja 79 |27-300 Lipsko;89;21;21;3;18;23.60;14.29
94680;140903;SPZ ZOZ w Lipsku|Lipsko|Jędrzeja Śniadeckiego 2 |27-300 Lipsko;99;53;53;1;52;53.54;1.89
94681;140904;Zespół Szkół w Rzeczniowie|Rzeczniów| 1b |27-353 Rzeczniów;1336;614;614;30;584;45.96;4.89
94682;140904;Publiczne Przedszkole w Pawliczce|Pawliczka| 31 |27-353 Rzeczniów;387;154;154;3;151;39.79;1.95
94683;140904;Publiczna Szkoła Podstawowa w Grabowcu|Grabowiec|ul. Wąchocka 20A |27-353 Rzeczniów;1059;435;435;23;412;41.08;5.29
94684;140904;Budynek byłej Niepublicznej Szkoły Podstawowej w Pasztowej Woli|Pasztowa Wola-Kolonia| 27 |27-353 Rzeczniów;469;173;173;11;162;36.89;6.36
94685;140904;Środowiskowy Dom Samopomocy w Podkońcach|Podkońce| 99 |27-353 Rzeczniów;491;128;128;5;123;26.07;3.91
94686;140905;Urząd Gminy Sienno|Sienno|Rynek 36/40 |27-350 Sienno;1973;791;791;24;767;40.09;3.03
94687;140905;Niepubliczna Szkoła Podstawowa|Kochanówka| 83 |27-350 Sienno;485;181;181;11;170;37.32;6.08
94688;140905;Świetlica Wiejska|Olechów Stary| 2 |27-350 Sienno;642;150;150;5;145;23.36;3.33
94689;140905;Niepubliczna Szkoła Podstawowa|Gozdawa| 6 |27-350 Sienno;460;191;191;4;187;41.52;2.09
94690;140905;Zespół Szkół|Jawor Solecki| 68 |27-350 Sienno;923;400;400;9;391;43.34;2.25
94691;140905;Świetlica Wiejska|Osówka| 62B |27-350 Sienno;531;204;204;9;195;38.42;4.41
94692;140906;Gminny Ośrodek Kultury w Solcu nad Wisłą|Solec nad Wisłą|Plac Bolesława Śmiałego 6 |27-320 Solec nad Wisłą;1177;435;435;19;416;36.96;4.37
94693;140906;Budynek Szkoły Podstawowej w Boiskach|Boiska| 126 |27-320 Solec nad Wisłą;289;73;73;3;70;25.26;4.11
94694;140906;Strażnica Ochotniczej Straży Pożarnej w Sadkowicach|Sadkowice| 76 |27-320 Solec nad Wisłą;522;169;169;12;157;32.38;7.10
94695;140906;Zespół Szkół Samorządowych w Pawłowicach|Pawłowice| 88 |27-320 Solec nad Wisłą;643;256;256;18;238;39.81;7.03
94696;140906;Świetlica Wiejska w Zemborzynie Pierwszym|Zemborzyn Pierwszy| 100 |27-320 Solec nad Wisłą;434;136;136;5;131;31.34;3.68
94697;140906;Wiejski Dom Kultury w Dziurkowie|Dziurków| 116 |27-320 Solec nad Wisłą;734;253;253;9;244;34.47;3.56
94698;140906;Strażnica OSP w Słuszczynie|Słuszczyn| 49 |27-320 Solec nad Wisłą;223;108;108;5;103;48.43;4.63
94699;140906;Budynek Szkoły Podstawowej w Glinie|Glina| 30 |27-320 Solec nad Wisłą;368;129;129;3;126;35.05;2.33
94700;141001;Urząd Gminy w Huszlewie|Huszlew| 77 |08-206 Huszlew;722;375;375;3;372;51.94;0.80
94701;141001;Zespół Szkolno-Wychowawczy w Huszlewie|Huszlew| 113 |08-206 Huszlew;553;220;220;4;216;39.78;1.82
94702;141001;Niepubliczna Szkoła Podstawowa w Mostowie|Mostów| 10 |08-206 Huszlew;440;246;246;6;240;55.91;2.44
94703;141001;Budynek Byłej Szkoły Podstawowej w Żurawlówce|Żurawlówka| 25 |08-206 Huszlew;604;265;265;5;260;43.87;1.89
94704;141002;Zespół Szkół Nr 1 Łosice|Łosice|Szkolna 5 |08-200 Łosice;2144;1162;1162;21;1141;54.20;1.81
94705;141002;Zespół Szkół Nr 2 Łosice|Łosice|Piłsudskiego 9 |08-200 Łosice;1411;720;720;17;703;51.03;2.36
94706;141002;Szkoła Podstawowa Nr 2 Łosice|Łosice|Bialska 13 |08-200 Łosice;1141;572;572;5;567;50.13;0.87
94707;141002;Łosicki Dom Kultury Łosice|Łosice|Piłsudskiego 4 |08-200 Łosice;1485;707;707;9;698;47.61;1.27
94708;141002;Szkoła Podstawowa w Czuchlebach 60|Czuchleby| 60 |08-200 Łosice;631;287;287;9;278;45.48;3.14
94709;141002;Strażnica OSP w Niemojkach 42|Niemojki| 42 |08-200 Łosice;1137;486;486;23;463;42.74;4.73
94710;141002;Szkoła Podstawowa w Chotyczach 71|Chotycze| 71 |08-200 Łosice;584;231;231;9;222;39.55;3.90
94711;141002;Świetlica w Zakrzu 38|Zakrze| 38 |08-200 Łosice;493;234;234;17;217;47.46;7.26
94712;141002;Szpital Powiatowy w Łosicach|Łosice|Słoneczna 1 |08-200 Łosice;101;36;36;2;34;35.64;5.56
94713;141003;Urząd Gminy w Olszance|Olszanka| 37 |08-207 Olszanka;504;249;249;4;245;49.40;1.61
94714;141003;Ośrodek Kultury Wiejskiej w Szydłówce|Szydłówka| 40 |08-207 Olszanka;524;243;243;5;238;46.37;2.06
94715;141003;Szkoła Podstawowa w Hadynowie|Hadynów| 1 |08-207 Olszanka;872;456;456;13;443;52.29;2.85
94716;141003;Niepubliczna Szkoła Podstawowa w Próchenkach|Próchenki| 90 |08-207 Olszanka;576;380;380;5;375;65.97;1.32
94717;141004;Szkoła Podstawowa w Lipnie|Lipno| 25 |08-210 Platerów;639;312;312;11;301;48.83;3.53
94718;141004;Gminny Ośrodek Kultury w Platerowie|Platerów|ul. 3 Maja 13 |08-210 Platerów;753;370;370;10;360;49.14;2.70
94719;141004;Zespół Szkół w Górkach|Górki| 4 |08-210 Platerów;946;357;357;15;342;37.74;4.20
94720;141004;Przedszkole Samorządowe w Ruskowie|Rusków| 104 |08-210 Platerów;433;170;170;8;162;39.26;4.71
94721;141004;Młodzieżowy Ośrodek Wychowawczy w Czuchowie-Pieńkach|Czuchów-Pieńki| 1 |08-210 Platerów;429;152;152;3;149;35.43;1.97
94722;141004;Świetlica wiejska w Mężeninie|Mężenin| 25A |08-210 Platerów;351;148;148;8;140;42.17;5.41
94723;141004;Świetlica wiejska w Ostromęczynie|Ostromęczyn| 75 |08-210 Platerów;517;213;213;6;207;41.20;2.82
94724;141005;Zespół Szkół w Sarnakach|Sarnaki|3 Maja 27 |08-220 Sarnaki;1252;557;557;14;543;44.49;2.51
94725;141005;Budynek gminny|Nowe Hołowczyce| 79 |08-221 Sarnaki;958;391;391;17;374;40.81;4.35
94726;141005;Zespół Szkolno-Przedszkolny w Serpelicach|Serpelice| 83 |08-221 Sarnaki;1031;491;491;15;476;47.62;3.05
94727;141005;Urząd Gminy Sarnaki|Sarnaki|Berka Joselewicza 3 |08-220 Sarnaki;910;500;500;14;486;54.95;2.80
94728;141006;Urząd Gminy w Starej Kornicy|Stara Kornica| 191 |08-205 Kornica;1116;525;525;19;506;47.04;3.62
94729;141006;Zespół Publicznych Placówek Oświatowych im. Odzyskania Niepodległości w Starej Kornicy|Stara Kornica| 172 |08-205 Kornica;900;396;396;5;391;44.00;1.26
94730;141006;Szkoła Podstawowa w Starych Szpakach|Stare Szpaki| 36 |08-205 Kornica;641;333;333;11;322;51.95;3.30
94731;141006;Szkoła Podstawowa im. Marii Konopnickiej w Kobylanach|Kobylany| 114 |08-205 Kornica;564;218;218;10;208;38.65;4.59
94732;141006;Szkoła Podstawowa w Koszelówce|Koszelówka| 55 |08-205 Kornica;768;319;319;13;306;41.54;4.08
94733;141101;Zespół Szkół Nr 1 w Makowie Mazowieckim|Maków Mazowiecki|ul. Sportowa 9 |06-200 Maków Mazowiecki;1232;629;629;8;621;51.06;1.27
94734;141101;Zespół Szkół Nr 2 w Makowie Mazowieckim|Maków Mazowiecki|ul. Gen. Pułaskiego 15 |06-200 Maków Mazowiecki;1511;631;631;23;608;41.76;3.65
94735;141101;Liceum Ogólnokształcące Nr 1 w Makowie Mazowieckim|Maków Mazowiecki|ul. Kopernika 2 |06-200 Maków Mazowiecki;1767;872;872;21;851;49.35;2.41
94736;141101;Zespół Szkół w Makowie Mazowieckim|Maków Mazowiecki|ul. Duńskiego Czerwonego Krzyża 3 |06-200 Maków Mazowiecki;1661;896;896;11;885;53.94;1.23
94737;141101;Miejski Dom Kultury w Makowie Mazowieckim|Maków Mazowiecki|ul. Moniuszki 2 |06-200 Maków Mazowiecki;1676;764;764;12;752;45.58;1.57
94738;141101;SP ZOZ Zespół Zakładów w Makowie Mazowieckim|Maków Mazowiecki|ul. Wincentego Witosa 2 |06-200 Maków Mazowiecki;119;33;33;2;31;27.73;6.06
94739;141101;Dom Pomocy Społecznej w Makowie Mazowieckim|Maków Mazowiecki|ul. Mazowiecka 2 |06-200 Maków Mazowiecki;32;20;20;0;20;62.50;0.00
94740;141102;Publiczne Gimnazjum w Czerwonce|Czerwonka Włościańska| 37A |06-232 Czerwonka;1042;522;522;21;501;50.10;4.02
94741;141102;Budynek po byłej Publicznej Szkole Podstawowej w Budzynie Walędziętach|Budzyno| 31 |06-200 Maków Mazowiecki;766;336;336;19;317;43.86;5.65
94742;141102;Świetlica Wiejska w Krzyżewo Markach|Krzyżewo-Marki| 2A |06-232 Czerwonka;165;73;73;5;68;44.24;6.85
94743;141102;Budynek po byłej Szkole Podstawowej w Gutach Dużych|Guty Duże| 42 |06-232 Czerwonka;191;108;108;6;102;56.54;5.56
94744;141103;Publiczne Gimnazjum w Karniewie|Karniewo|ul. Szkolna 9B |06-425 Karniewo;1946;897;897;42;855;46.09;4.68
94745;141103;Remiza Ochotniczej Straży Pożarnej w Łukowie|Łukowo| 71 |06-425 Karniewo;654;282;282;10;272;43.12;3.55
94746;141103;Szkoła Podstawowa w Romanowie|Romanowo| 12 |06-425 Karniewo;770;345;345;8;337;44.81;2.32
94747;141103;Szkoła Podstawowa w Szwelicach|Szwelice| 66 |06-100 Pułtusk;832;452;452;18;434;54.33;3.98
94748;141104;Zespół Szkół|Krasnosielc|ul. Ogrodowa 2A |06-212 Krasnosielc;1406;566;566;14;552;40.26;2.47
94749;141104;Gminny Ośrodek Kultury|Krasnosielc|ul.Rynek 40A |06-212 Krasnosielc;1074;484;484;18;466;45.07;3.72
94750;141104;Szkoła Podstawowa|Amelin| 33 |06-212 Krasnosielc;584;223;223;13;210;38.18;5.83
94751;141104;Budynek byłej Szkoły Podstawowej|Pienice| 19 |06-212 Krasnosielc;416;161;161;14;147;38.70;8.70
94752;141104;Szkoła Podstawowa|Drążdżewo| 62 |06-214 Drążdżewo;1268;524;524;33;491;41.32;6.30
94753;141104;Szkoła Podstawowa|Raki| 55A |06-214 Drążdżewo;460;184;184;10;174;40.00;5.43
94754;141105;Publiczna Szkoła Podstawowa z Publicznym Przedszkolem|Młynarze|ul. Ostrołęcka 24 |06-231 Młynarze;740;416;416;14;402;56.22;3.37
94755;141105;Świetlica wiejska|Kołaki| |06-231 Młynarze;329;140;140;5;135;42.55;3.57
94756;141105;Budynek po byłej Szkole Podstawowej|Głażewo-Cholewy| |06-231 Młynarze;334;145;145;6;139;43.41;4.14
94757;141106;Remiza OSP w Jaciążku|Jaciążek| 25 |06-210 Płoniawy-Bramura;573;246;246;13;233;42.93;5.28
94758;141106;Remiza OSP w Starym Podosiu|Stary Podoś| 45 |06-210 Płoniawy-Bramura;245;117;117;5;112;47.76;4.27
94759;141106;Zespół Szkół w Płoniawach-Bramurze|Płoniawy-Bramura| 80a |06-210 Płoniawy-Bramura;821;395;395;21;374;48.11;5.32
94760;141106;Szkoła Podstawowa w Chodkowie Wielkim|Chodkowo Wielkie| 29 |06-210 Płoniawy-Bramura;536;250;250;4;246;46.64;1.60
94761;141106;Zespół Szkół w Krasińcu|Szczuki, Krasiniec| 18 |06-211 Płoniawy-Bramura;1067;340;340;14;326;31.87;4.12
94762;141106;Szkoła Podstawowa w Węgrzynowie|Węgrzynowo| 150 |06-211 Płoniawy-Bramura;752;288;288;29;259;38.30;10.07
94763;141106;Świetlica wiejska w Kobylinku|Kobylinek| |06-211 Płoniawy-Bramura;314;135;135;10;125;42.99;7.41
94764;141106;Remiza OSP w Zawadach Dworskich|Zawady Dworskie| |06-210 Płoniawy-Bramura;289;93;93;5;88;32.18;5.38
94765;141107;Gminny Ośrodek Upowszechniania Kultury w Różanie|Różan|ul. Mickiewicza 5 |06-230 Różan;1057;554;554;22;532;52.41;3.97
94766;141107;Urząd Gminy (sala konferencyjna) w Różanie|Różan|Plac Obrońców Różana 4 |06-230 Różan;1184;572;572;23;549;48.31;4.02
94767;141107;Dom Dziennego Pobytu w Różanie|Różan|ul. Gdańska 4 3|06-230 Różan;1411;634;634;34;600;44.93;5.36
94768;141108;Publiczna Szkoła Podstawowa w Rzewniu|Rzewnie| 3 |06-225 Rzewnie;1257;613;613;27;586;48.77;4.40
94769;141108;budynek po Publicznej Szkole Podstawowej w Orłowie|Orłowo| 10 |06-225 Rzewnie;316;124;124;7;117;39.24;5.65
94770;141108;budynek po Publicznej Szkole Podstawowej w Nowym Sielcu|Nowy Sielc| 42 |06-225 Rzewnie;352;157;157;5;152;44.60;3.18
94771;141108;budynek po Publicznej Szkole Podstawowej w Drozdowie|Drozdowo| 43 |06-225 Rzewnie;261;109;109;2;107;41.76;1.83
94772;141109;Gminny Ośrodek Kultury w Sypniewie|Sypniewo|Ostrołęcka 39 |06-216 Sypniewo;1141;564;564;19;545;49.43;3.37
94773;141109;Szkoła Podstawowa w Maminie|Mamino| 43 |06-216 Sypniewo;211;90;90;3;87;42.65;3.33
94774;141109;Świetlica Wiejska w Rawach|Rawy| 32 |06-213 Sypniewo;238;103;103;3;100;43.28;2.91
94775;141109;Szkoła Podstawowa w Gąsewie Poduchownym|Gąsewo Poduchowne|Władysława Stanisława Reymonta 12 |06-213 Sypniewo;1165;552;552;9;543;47.38;1.63
94776;141110;Gminne Centrum Kultury, Czytelnictwa i Sportu w Starym Szelkowie|Stary Szelków| 35A |06-220 Stary Szelków;1046;468;468;29;439;44.74;6.20
94777;141110;Świetlica wiejska w Makowicy|Makowica| 41 |06-200 Maków Mazowiecki;560;237;237;11;226;42.32;4.64
94778;141110;Świetlica OSP w Pomaskach Wielkich|Pomaski Wielkie| 5 |06-200 Maków Mazowiecki;226;123;123;4;119;54.42;3.25
94779;141110;Świetlica wiejska w Przeradowie|Przeradowo| 23 |06-220 Stary Szelków;353;188;188;3;185;53.26;1.60
94780;141110;Świetlica wiejska w Ciepielewie|Ciepielewo| 66 |06-220 Stary Szelków;365;175;175;6;169;47.95;3.43
94781;141110;Publiczna Szkoła Podstawowa w Nowym Strachocinie|Nowy Strachocin| 22 |06-220 Stary Szelków;195;91;91;0;91;46.67;0.00
94782;141110;Świetlica wiejska w Dzierżanowie|Dzierżanowo| 53 |06-200 Maków Mazowiecki;212;74;74;2;72;34.91;2.70
94783;141201;Szkoła Podstawowa Nr 5|Mińsk Mazowiecki|Małopolska 11 |05-300 Mińsk Mazowiecki;1517;1016;1016;18;998;66.97;1.77
94784;141201;Gimnazjum Miejskie Nr 2|Mińsk Mazowiecki|Budowlana 2 |05-300 Mińsk Mazowiecki;1484;931;933;14;917;62.74;1.50
94785;141201;Szkoła Podstawowa Nr 5|Mińsk Mazowiecki|Małopolska 11 |05-300 Mińsk Mazowiecki;1461;992;992;8;984;67.90;0.81
94786;141201;Przedszkole Miejskie Nr 4|Mińsk Mazowiecki|Juliana Tuwima 2 |05-300 Mińsk Mazowiecki;1631;1016;1016;22;994;62.29;2.17
94787;141201;Miejski Dom Kultury|Mińsk Mazowiecki|Warszawska 173 |05-300 Mińsk Mazowiecki;1865;1191;1191;19;1172;63.86;1.60
94788;141201;Gimnazjum Miejskie Nr 2|Mińsk Mazowiecki|Budowlana 2 |05-300 Mińsk Mazowiecki;1475;852;852;11;841;57.76;1.29
94789;141201;Zespół Szkół Miejskich Nr 1|Mińsk Mazowiecki|Mikołaja Kopernika 9 |05-300 Mińsk Mazowiecki;1832;1148;1148;11;1137;62.66;0.96
94790;141201;Gimnazjum i Liceum Ogólnokształcące im. Polskiej Macierzy Szkolnej|Mińsk Mazowiecki|Piękna 7A |05-300 Mińsk Mazowiecki;1661;1108;1108;27;1081;66.71;2.44
94791;141201;Zespół Szkół Miejskich Nr 1|Mińsk Mazowiecki|Mikołaja Kopernika 9 |05-300 Mińsk Mazowiecki;1868;1099;1099;34;1065;58.83;3.09
94792;141201;Zespół Szkół Ekonomicznych|Mińsk Mazowiecki|Zygmunta Kazikowskiego 18 |05-300 Mińsk Mazowiecki;1434;860;860;8;852;59.97;0.93
94793;141201;Miejska Biblioteka Publiczna|Mińsk Mazowiecki|Józefa Piłsudskiego 1a |05-300 Mińsk Mazowiecki;1612;979;979;13;966;60.73;1.33
94794;141201;Szkoła Podstawowa Nr 2|Mińsk Mazowiecki|Dąbrówki 10 |05-300 Mińsk Mazowiecki;1332;763;763;14;749;57.28;1.83
94795;141201;Przedszkole Miejskie Nr 6|Mińsk Mazowiecki|Warszawska 250/81 |05-300 Mińsk Mazowiecki;1345;776;776;19;757;57.70;2.45
94796;141201;Przedszkole Miejskie Nr 6|Mińsk Mazowiecki|Warszawska 250/81 |05-300 Mińsk Mazowiecki;1309;727;727;27;700;55.54;3.71
94797;141201;Zespół Szkół im.Marii Skłodowskiej-Curie|Mińsk Mazowiecki|1 PLM Warszawa 1 |05-300 Mińsk Mazowiecki;1327;656;656;13;643;49.43;1.98
94798;141201;Zespół Szkół im.Marii Skłodowskiej-Curie|Mińsk Mazowiecki|1 PLM Warszawa 1 |05-300 Mińsk Mazowiecki;825;527;527;3;524;63.88;0.57
94799;141201;Gimnazjum Miejskie Nr 3|Mińsk Mazowiecki|Siennicka 17 |05-300 Mińsk Mazowiecki;1414;855;855;11;844;60.47;1.29
94800;141201;Szkoła Podstawowa Nr 2|Mińsk Mazowiecki|Dąbrówki 10 |05-300 Mińsk Mazowiecki;1073;683;683;5;678;63.65;0.73
94801;141201;Zespół Szkół Zawodowych Nr 2|Mińsk Mazowiecki|gen. Kazimierza Sosnkowskiego 43 |05-300 Mińsk Mazowiecki;1562;911;911;10;901;58.32;1.10
94802;141201;Szkoła Podstawowa Nr 6|Mińsk Mazowiecki|ul. gen. Kazimierza Sosnkowskiego 1 |05-300 Mińsk Mazowiecki;1160;683;683;10;673;58.88;1.46
94803;141201;Gimnazjum Miejskie Nr 3|Mińsk Mazowiecki|Siennicka 17 |05-300 Mińsk Mazowiecki;1380;829;829;10;819;60.07;1.21
94804;141201;SP ZOZ w Mińsku Mazowieckim|Mińsk Mazowiecki|Szpitalna 37 |05-300 Mińsk Mazowiecki;191;37;37;0;37;19.37;0.00
94805;141204;Urząd Gminy Cegłów|Cegłów|ul. Tadeusza Kościuszki 4 |05-319 Cegłów;1817;1074;1074;31;1043;59.11;2.89
94806;141204;Strażnica Ochotniczej Straży Pożarnej w Cegłowie|Cegłów|Pl. Anny Jagiellonki 11 |05-319 Cegłów;453;210;210;7;203;46.36;3.33
94807;141204;Dom Ludowy w Kiczkach|Kiczki Pierwsze| 72 |05-319 Cegłów;441;225;225;9;216;51.02;4.00
94808;141204;Strażnica Ochotniczej Straży Pożarnej w Podcierniu|Podciernie| 85 |05-319 Cegłów;602;264;264;12;252;43.85;4.55
94809;141204;Świetlica Wiejska w Posiadałach|Posiadały| 52 |05-319 Cegłów;693;300;300;10;290;43.29;3.33
94810;141204;Strażnica Ochotniczej Straży Pożarnej w Mieni|Mienia| 64 |05-319 Cegłów;808;372;372;8;364;46.04;2.15
94811;141204;Dom Pomocy Społecznej im. Św Józefa w Mieni|Mienia| 94 |05-319 Cegłów;117;32;32;6;26;27.35;18.75
94812;141205;Zespół Szkół w Dębem Wielkim|Dębe Wielkie|ul. Warszawska 78A |05-311 Dębe Wielkie;1275;671;671;22;649;52.63;3.28
94813;141205;Zespół Szkół w Dębem Wielkim|Dębe Wielkie|ul. Warszawska 78A |05-311 Dębe Wielkie;1218;649;649;24;625;53.28;3.70
94814;141205;Szkoła Podstawowa w Cygance|Cyganka|ul. Szkolna 21 |05-311 Dębe Wielkie;1103;471;471;20;451;42.70;4.25
94815;141205;Szkoła Podstawowa w Rudzie|Ruda|ul.Szkolna 7 |05-311 Dębe Wielkie;1776;908;908;28;880;51.13;3.08
94816;141205;Zespół Szkół w Dębem Wielkim|Dębe Wielkie|ul.Warszawska 78A |05-311 Dębe Wielkie;1345;781;781;18;763;58.07;2.30
94817;141205;Zespół Szkół w Dębem Wielkim|Dębe Wielkie|ul. Warszawska 78A |05-311 Dębe Wielkie;830;514;514;13;501;61.93;2.53
94818;141206;Gimnazjum im. Henryka Sienkiewicza w Dobrem|Dobre|Szkolna 3 |05-307 Dobre;1157;612;612;19;593;52.90;3.10
94819;141206;Gminazjum im. Henryka Sienkiewicza w Dobrem|Dobre|Szkolna 3 |05-307 Dobre;865;406;406;16;390;46.94;3.94
94820;141206;Gimnazjum im. Henryka Sienkiewicza w Dobrem|Dobre|Szkolna 3 |05-307 Dobre;1096;455;455;11;444;41.51;2.42
94821;141206;Szkoła Podstawowa w Dropiu|Drop| 31 |05-307 Dobre;753;313;313;11;302;41.57;3.51
94822;141206;Remiza Ochotniczej Straży Pożarnej w Rudzienku|Rudzienko| 40A |05-307 Dobre;962;447;447;20;427;46.47;4.47
94823;141207;Urząd Miejski w Halinowie|Halinów|ul. Spółdzielcza 1 |05-074 Halinów;1014;581;581;13;568;57.30;2.24
94824;141207;Urząd Miejski w Halinowie|Halinów|ul. Spółdzielcza 1 |05-074 Halinów;1783;1155;1155;23;1132;64.78;1.99
94825;141207;Urząd Miejski w Halinowie|Halinów|ul. Spółdzielcza 1 |05-074 Halinów;1749;1058;1058;15;1043;60.49;1.42
94826;141207;Gminne Centrum Kultury Okuniew|Okuniew|ul. Rynek 46 2|05-079 Okuniew;1731;973;973;27;946;56.21;2.77
94827;141207;Oddział GCK Michałów|Michałów| 74 |05-079 Okuniew;469;253;253;7;246;53.94;2.77
94828;141207;Zespół Szkolno-Przedszkolny w Cisiu|Cisie|ul. Mostowa 61 |05-074 Halinów;813;433;433;14;419;53.26;3.23
94829;141207;Zespół Szkolno-Przedszkolny w Brzezinach|Brzeziny| 3 |05-074 Halinów;914;598;598;12;586;65.43;2.01
94830;141207;Zespół Szkolno-Przedszkolny w Halinowie|Halinów|Okuniewska 115 |05-074 Halinów;905;573;574;5;568;63.31;0.87
94831;141207;Długa Szlachecka|Długa Szlachecka|ul. Popiełuszki 53 |05-071 Sulejówek;791;445;445;11;434;56.26;2.47
94832;141207;Zespół Szkolno-Przedszkolny w Halinowie|Halinów|ul. Okuniewska 115 |05-074 Halinów;1408;790;790;15;775;56.11;1.90
94833;141208;Urząd Gminy Jakubów|Jakubów|Mińska 15 |05-306 Jakubów;1830;919;919;38;881;50.22;4.13
94834;141208;Szkoła Podstawowa w Jędrzejowie Nowym|Jędrzejów Nowy| 30 |05-306 Jakubów;463;265;265;5;260;57.24;1.89
94835;141208;Szkoła Podstawowa w Mistowie|Mistów|Szkolna 3 |05-306 Jakubów;1002;482;482;33;449;48.10;6.85
94836;141208;Szkoła Podstawowa w Wiśniewie|Wiśniew| 45A |05-306 Jakubów;710;320;320;11;309;45.07;3.44
94837;141209;Dom Kultury w Kałuszynie|Kałuszyn|Warszawska 45 |05-310 Kałuszyn;1262;595;595;28;567;47.15;4.71
94838;141209;Dom Kultury w Kałuszynie|Kałuszyn|Warszawska 45 |05-310 Kałuszyn;1009;576;576;7;569;57.09;1.22
94839;141209;Szkoła Podstawowa w Kałuszynie|Kałuszyn|Pocztowa 4 |05-310 Kałuszyn;1280;593;593;26;567;46.33;4.38
94840;141209;Szkoła Filialna w Chrościcach|Chrościce|Chrościce |05-310 Kałuszyn;487;216;216;11;205;44.35;5.09
94841;141209;Budynek po byłej Szkole Podstawowej w Nowych Groszkach|Nowe Groszki|Nowe Groszki |05-310 Kałuszyn;670;268;268;11;257;40.00;4.10
94842;141210;Zespół Szkół w Latowiczu|Latowicz|Rynek 24 |05-334 Latowicz;1161;482;482;15;467;41.52;3.11
94843;141210;Szkoła Filialna W Dębem Małym Szkoły Podstawowej W Zespole Szkół im. Rodziny Wyleżyńskich w Wielgolesie|Dębe Małe|Dębe Małe 68 |05-334 Latowicz;618;200;200;8;192;32.36;4.00
94844;141210;Zespół Szkół im. Rodziny Wyleżyńskich w Wielgolesie|Wielgolas|Szkolna 11 |05-334 Latowicz;1461;652;652;22;630;44.63;3.37
94845;141210;Zespół Szkół w Latowiczu|Latowicz|Rynek 24 |05-334 Latowicz;990;425;425;7;418;42.93;1.65
94846;141211;Szkoła Podstawowa w Brzózem|Brzóze|ul. Szkolna 20 |05-300 Mińsk Mazowiecki;742;359;359;15;344;48.38;4.18
94847;141211;Zespół Szkół w Stojadłach|Stojadła|ul. Południowa 20 |05-300 Mińsk Mazowiecki;962;533;533;5;528;55.41;0.94
94848;141211;Zespół Szkół w Zamieniu|Zamienie|ul. Kołbielska 34 |05-300 Mińsk Mazowiecki;1457;764;764;25;739;52.44;3.27
94849;141211;Zespół Szkół w Hucie Mińskiej z siedzibą w Cielechowiźnie|Cielechowizna| 1A |05-300 Mińsk Mazowiecki;1335;639;639;18;621;47.87;2.82
94850;141211;Zespół Szkół w Janowie|Janów|ul. Strażacka 18 |05-300 Mińsk Mazowiecki;827;373;373;15;358;45.10;4.02
94851;141211;Zespół Szkół w Starej Niedziałce|Stara Niedziałka|ul. Mazowiecka 154 |05-300 Mińsk Mazowiecki;1836;1011;1011;36;975;55.07;3.56
94852;141211;Szkoła Podstawowa w Mariance|Marianka| 42 |05-300 Mińsk Mazowiecki;707;324;324;10;314;45.83;3.09
94853;141211;Świetlica w Barczącej|Barcząca|ul. Prosta 1 |05-300 Mińsk Mazowiecki;940;490;490;4;486;52.13;0.82
94854;141211;Publiczne Przedszkole w Nowych Osinach|Nowe Osiny|ul. Piękna 21 |05-300 Mińsk Mazowiecki;719;452;452;5;447;62.87;1.11
94855;141211;Świetlica w Targówce|Targówka|ul. Mazowiecka 39 |05-300 Mińsk Mazowiecki;776;453;453;6;447;58.38;1.32
94856;141211;Remiza OSP w Królewcu|Królewiec|ul. Wspólna 116 |05-300 Mińsk Mazowiecki;619;369;369;13;356;59.61;3.52
94857;141211;Remiza OSP w Dłużce|Dłużka| 100 |05-300 Mińsk Mazowiecki;418;242;242;7;235;57.89;2.89
94858;141212;Niepubliczna Szkoła Podstawowa w Lipinach|Lipiny| 71 |05-317 Jeruzal;521;179;179;11;168;34.36;6.15
94859;141212;Zespół Szkół w Jeruzalu|Jeruzal|Szkolna 8 |05-317 Jeruzal;618;247;247;8;239;39.97;3.24
94860;141212;Budynek administracyjny przy remizie OSP w Małej Wsi|Mała Wieś| 79A |05-320 Mrozy;531;237;237;10;227;44.63;4.22
94861;141212;Świetlica Wiejska w Dąbrowie|Dąbrowa| 87 |05-320 Mrozy;483;183;183;10;173;37.89;5.46
94862;141212;Remiza OSP w Guzewie|Guzew| 105 |05-320 Mrozy;390;146;146;2;144;37.44;1.37
94863;141212;Zespół Szkół w Mrozach|Mrozy|Licealna 3 |05-320 Mrozy;1436;786;786;8;778;54.74;1.02
94864;141212;Szkoła Podstawowa w Grodzisku|Grodzisk|Mazowiecka 86 |05-320 Mrozy;895;320;320;14;306;35.75;4.38
94865;141212;Szkoła Podstawowa w Mrozach (hol główny)|Mrozy|Szkolna 2 |05-320 Mrozy;973;566;566;14;552;58.17;2.47
94866;141212;Szkoła Podstawowa w Mrozach (sala gimnastyczna)|Mrozy|Szkolna 2 |05-320 Mrozy;1071;605;605;16;589;56.49;2.64
94867;141212;Samodzielny Specjalistyczny Zespół Zakładów Opieki Zdrowotnej w Rudce|Rudka|Al. Teodora Dunina 1 |05-320 Mrozy;154;55;55;3;52;35.71;5.45
94868;141213;Zespół Szkół w Siennicy|Siennica|Mińska 38 |05-332 Siennica;1693;908;908;36;872;53.63;3.96
94869;141213;Zespół Szkół w Żakowie|Żaków| 48A |05-332 Siennica;729;383;383;15;368;52.54;3.92
94870;141213;Ochotnicza Straż Pożarna w Wólce Dłużewskiej|Wólka Dłużewska| 15 |05-332 Siennica;691;308;308;19;289;44.57;6.17
94871;141213;Publiczna Szkoła Podstawowa w Siennicy|Siennica|ul. Latowicka 16 |05-332 Siennica;743;299;299;15;284;40.24;5.02
94872;141213;Publiczna Szkoła Podstawowa w Nowej Pogorzeli|Nowa Pogorzel|ul. Pałacowa 17 |05-332 Siennica;1144;564;564;25;539;49.30;4.43
94873;141213;Zespół Niepublicznych Specjalnych Placówek Oświatowych "Możesz więcej" w Nowym Zglechowie, Szkoła Podstawowa, Przedszkole, Gimnazjum|Nowy Zglechów| 27 |05-332 Siennica;739;300;300;12;288;40.60;4.00
94874;141214;Gimnazjum w Stanisławowie|Stanisławów|ul. Szkolna 4a |05-304 Stanisławów;1338;794;794;18;776;59.34;2.27
94875;141214;Zespół Szkół w Pustelniku|Pustelnik|ul. Szkolna 16 |05-304 Stanisławów;1287;624;624;33;591;48.48;5.29
94876;141214;Zespół Szkolny w Ładzyniu|Ładzyń|Szkolna 4 |05-304 Stanisławów;606;297;297;7;290;49.01;2.36
94877;141214;Gimnazjum w Stanisławowie|Stanisławów|ul. Szkolna 4a |05-304 Stanisławów;1231;596;596;23;573;48.42;3.86
94878;141214;Zespół Szkolny w Stanisławowie|Stanisławów|Szkolna 4 |05-304 Stanisławów;836;398;398;9;389;47.61;2.26
94879;141215;Zespół Szkół Nr 1|Sulejówek|Idzikowskiego 2a |05-070 Sulejówek;2317;1575;1575;17;1558;67.98;1.08
94880;141215;Zespół Szkół Nr 1|Sulejówek|Idzikowskiego 2a |05-070 Sulejówek;1311;914;914;3;911;69.72;0.33
94881;141215;Zespół Szkół Nr 2|Sulejówek|Okuniewska 2 |05-070 Sulejówek;2199;1496;1496;17;1479;68.03;1.14
94882;141215;Szkoła Podstawowa Nr 3|Sulejówek|Głowackiego 47 |05-071 Sulejówek;2145;1202;1202;23;1179;56.04;1.91
94883;141215;Szkoła Podstawowa Nr 3|Sulejówek|Głowackiego 47 |05-071 Sulejówek;1195;701;701;13;688;58.66;1.85
94884;141215;Gimnazjum Nr 2|Sulejówek|Narutowicza 10 |05-071 Sulejówek;2010;1205;1205;18;1187;59.95;1.49
94885;141215;Gimnazjum Nr 2|Sulejówek|Narutowicza 10 |05-071 Sulejówek;974;622;622;8;614;63.86;1.29
94886;141215;Zespół Szkół Ponadgimnazjalnych|Sulejówek|Paderewskiego 29 |05-070 Sulejówek;1474;831;831;12;819;56.38;1.44
94887;141215;Zespół Szkół Ponadgimnazjalnych|Sulejówek|Paderewskiego 29 |05-070 Sulejówek;1852;1211;1211;14;1197;65.39;1.16
94888;141301;Zespół Placówek Oświatowych Nr 2 Szkoła Podstawowa Nr 4 im. Haliny Rudnickiej w Mławie|Mława|ul. Graniczna 39 |06-500 Mława;1143;461;461;27;434;40.33;5.86
94889;141301;Zespół Placówek Oświatowych Nr 2 Miejskie Przedszkole Samorządowe Nr 2|Mława|ul. Przyrynek 5 |06-500 Mława;1188;476;476;9;467;40.07;1.89
94890;141301;Zespół Placówek Oświatowych Nr 2 Miejskie Przedszkole Samorządowe Nr 2|Mława|ul. Przyrynek 5 |06-500 Mława;1114;522;522;12;510;46.86;2.30
94891;141301;Zespół Szkół Nr 2 w Mławie|Mława|ul. Zuzanny Morawskiej 29B |06-500 Mława;960;494;494;9;485;51.46;1.82
94892;141301;Zespół Placówek Oświatowych Nr 3 w Mławie Szkoła Podstawowa Nr 7 im. Zuzanny Morawskiej|Mława|ul. Ordona 14 |06-500 Mława;1387;702;702;10;692;50.61;1.42
94893;141301;Zespół Placówek Oświatowych Nr 3 w Mławie Szkoła Podstawowa Nr 7 im. Zuzanny Morawskiej|Mława|ul. Ordona 14 |06-500 Mława;1264;640;640;16;624;50.63;2.50
94894;141301;Zespół Szkół Nr 1 w Mławie|Mława|ul. Zuzanny Morawskiej 29 |06-500 Mława;1189;470;470;13;457;39.53;2.77
94895;141301;Miejski Ośrodek Sportu i Rekreacji w Mławie|Mława|ul. Mikołaja Kopernika 38 |06-500 Mława;1169;557;557;5;552;47.65;0.90
94896;141301;Miejski Ośrodek Sportu i Rekreacji w Mławie|Mława|ul. Mikołaja Kopernika 38 |06-500 Mława;1166;637;637;11;626;54.63;1.73
94897;141301;Gimnazjum Nr 2 im. Józefa Ostaszewskiego w Mławie|Mława|ul. Henryka Pogorzelskiego 4 |06-500 Mława;1288;521;521;11;510;40.45;2.11
94898;141301;Gimnazjum Nr 2 im. Józefa Ostaszewskiego w Mławie|Mława|ul. Henryka Pogorzelskiego 4 |06-500 Mława;1191;553;553;12;541;46.43;2.17
94899;141301;Zespół Placówek Oświatowych Nr 3 w Mławie Miejskie Przedszkole Samorządowe Nr 3 im. Jana Brzechwy|Mława|ul. Hoża 6 |06-500 Mława;1275;646;646;17;629;50.67;2.63
94900;141301;Gimnazjum Nr 1 im. Mikołaja Kopernika w Mławie|Mława|ul. Sportowa 1 |06-500 Mława;1112;530;530;16;514;47.66;3.02
94901;141301;Gimnazjum Nr 1 im. Mikołaja Kopernika w Mławie|Mława|ul. Sportowa 1 |06-500 Mława;1200;551;551;12;539;45.92;2.18
94902;141301;I Liceum Ogólnokształcące w Mławie|Mława|ul. Wyspiańskiego 1 |06-500 Mława;1185;527;527;10;517;44.47;1.90
94903;141301;Szkoła Podstawowa Nr 6 im. Kornela Makuszyńskiego w Mławie|Mława|ul. Żołnierzy 80 PP 4 |06-500 Mława;1094;554;554;20;534;50.64;3.61
94904;141301;Szkoła Podstawowa Nr 6 im. Kornela Makuszyńskiego w Mławie|Mława|ul. Żołnierzy 80 PP 4 |06-500 Mława;953;485;485;14;471;50.89;2.89
94905;141301;Miejski Ośrodek Pomocy Społecznej w Mławie|Mława|ul. Narutowicza 6 |06-500 Mława;1083;551;553;15;536;50.88;2.72
94906;141301;Zespół Placówek Oświatowych Nr 1 Miejskie Przedszkole Samorządowe Nr 1 im. Marii Konopnickiej w Mławie|Mława|ul. Warszawska 52 |06-500 Mława;965;439;439;15;424;45.49;3.42
94907;141301;Zespół Placówek Oświatowych Nr 1 Szkoła Podstawowa Nr 1 im. Hugona Kołłątaja w Mławie|Mława|ul. Warszawska 52 |06-500 Mława;1185;548;548;3;545;46.24;0.55
94908;141301;Miejski Dom Kultury w Mławie|Mława|ul. Stary Rynek 13 |06-500 Mława;1164;576;576;16;560;49.48;2.78
94909;141301;Samodzielny Publiczny Zakład Opieki Zdrowotnej w Mławie|Mława|ul. Dobrskiej 1 |06-500 Mława;81;17;17;1;16;20.99;5.88
94910;141302;Budynek po byłej Szkole Podstawowej|Nowe Brzozowo| 25 |06-520 Dzierzgowo;545;207;207;11;196;37.98;5.31
94911;141302;Remiza OSP|Dobrogosty| 4 |06-520 Dzierzgowo;318;123;123;6;117;38.68;4.88
94912;141302;Publiczne Gimnazjum|Dzierzgowo|ul. Jagiellońska 21a |06-520 Dzierzgowo;671;302;302;4;298;45.01;1.32
94913;141302;Szkoła Podstawowa|Dzierzgowo|ul. Jagiellońska 21 |06-520 Dzierzgowo;597;186;186;7;179;31.16;3.76
94914;141302;Szkoła Podstawowa|Rzęgnowo| 94 |06-520 Dzierzgowo;474;157;157;6;151;33.12;3.82
94915;141303;Gimnazjum w Lipowcu Kościelnym|Lipowiec Kościelny| 212 |06-545 Lipowiec Kościelny;1187;449;449;14;435;37.83;3.12
94916;141303;Szkoła Podstawowa w Turzy Małej|Turza Mała| 15 |06-545 Lipowiec Kościelny;1070;371;371;27;344;34.67;7.28
94917;141303;Szkoła Podstawowa w Zawadach|Zawady| 60 |06-545 Lipowiec Kościelny;856;308;308;11;297;35.98;3.57
94918;141303;Szkoła Podstawowa w Łomi|Łomia| 109 |06-500 Mława;801;282;282;8;274;35.21;2.84
94919;141304;Remiza Ochotniczej Straży Pożarnej w Gradzanowie Włościańskim|Gradzanowo Włościańskie| 13 |06-540 Radzanów;402;146;146;3;143;36.32;2.05
94920;141304;Remiza Ochotniczej Straży Pożarnej w Józefowie|Józefowo| 25 |06-540 Radzanów;179;84;84;2;82;46.93;2.38
94921;141304;Gminny Ośrodek Kultury w Radzanowie|Radzanów|ul.Mławska 4 |06-540 Radzanów;1572;645;645;45;600;41.03;6.98
94922;141304;Szkoła Podstawowa we Wróblewie|Wróblewo| 27 |06-540 Radzanów;653;258;258;25;233;39.51;9.69
94923;141305;Centrum Kulturowo-Historyczne "Kantor Młyński"|Strzegowo|ul. Ciechanowska 18A |06-445 Strzegowo;978;369;369;15;354;37.73;4.07
94924;141305;Zespół Szkół Strzegowo|Strzegowo|ul. Wyzwolenia 13 |06-445 Strzegowo;1347;493;493;17;476;36.60;3.45
94925;141305;Świetlica wiejska|Breginie| 17A |06-445 Strzegowo;463;179;179;12;167;38.66;6.70
94926;141305;Strażnica OSP|Unierzyż| 27 |06-445 Strzegowo;642;233;233;9;224;36.29;3.86
94927;141305;Zespół Szkół|Niedzbórz| 19 |06-445 Strzegowo;1624;511;511;47;464;31.47;9.20
94928;141305;Szkoła Podstawowa|Dąbrowa| 85 |06-445 Strzegowo;1284;532;532;28;504;41.43;5.26
94929;141306;Świetlica w Stupsku|Stupsk|ul. Adama Mickiewicza 46 |06-561 Stupsk;1655;616;616;49;567;37.22;7.95
94930;141306;Budynek Gminy|Konopki|ul. Kredytowa 4 |06-560 Konopki;1481;649;649;47;602;43.82;7.24
94931;141306;Dom Strażaka|Dąbek| 124 |06-561 Stupsk;814;329;329;32;297;40.42;9.73
94932;141306;Krajowy Ośrodek Mieszkalno-Rehabilitacyjny dla Osób Chorych na SM|Dąbek| 128 |06-561 Stupsk;56;46;46;0;46;82.14;0.00
94933;141307;Zespół Placówek Oświatowych|Szreńsk|ul. Budzyn 8 |06-550 Szreńsk;2127;908;908;37;871;42.69;4.07
94934;141307;Szkoła Podstawowa|Miączyn Mały| 24 |06-550 Szreńsk;660;216;216;6;210;32.73;2.78
94935;141307;Szkoła Podstawowa|Proszkowo| 3 |06-550 Szreńsk;687;283;283;18;265;41.19;6.36
94936;141308;Szkoła Podstawowa im. 49 Pułku Piechoty w Szydłowie|Szydłowo|ul. Szkolna 2 |06-516 Szydłowo;1495;644;644;34;610;43.08;5.28
94937;141308;Szkoła Podstawowa w Nosarzewie Borowym im. Wojciecha Piechowskiego|Nosarzewo Borowe| 34 |06-516 Szydłowo;1355;614;614;43;571;45.31;7.00
94938;141308;Szkoła Podstawowa w Dębsku|Dębsk| 104 |06-516 Szydłowo;862;365;365;22;343;42.34;6.03
94939;141309;Zespół Szkół w Wieczfni Kościelnej|Wieczfnia Kościelna| 56C |06-513 Wieczfnia Kościelna;1085;506;506;18;488;46.64;3.56
94940;141309;Zespół Szkół w Wieczfni Kościelnej Szkoła Filialna w Grzebsku|Grzebsk| 21 |06-513 Wieczfnia Kościelna;562;199;199;13;186;35.41;6.53
94941;141309;Szkoła Podstawowa w Uniszkach Zawadzkich|Uniszki Zawadzkie| 24 |06-513 Wieczfnia Kościelna;1020;348;348;17;331;34.12;4.89
94942;141309;Szkoła Podstawowa w Windykach|Windyki| 20 |06-513 Wieczfnia Kościelna;536;222;222;6;216;41.42;2.70
94943;141310;Zespół Szkół w Wiśniewie|Wiśniewo| 78 |06-521 Wiśniewo;1064;442;442;36;406;41.54;8.14
94944;141310;Szkoła Podstawowa w Starych Kosinach|Stare Kosiny| 1 |06-521 Wiśniewo;1122;404;404;18;386;36.01;4.46
94945;141310;Szkoła Podstawowa w Bogurzynie|Bogurzyn| 84 |06-521 Wiśniewo;1228;518;518;27;491;42.18;5.21
94946;141310;Świetlica Wiejska w Wojnówce|Wojnówka| 3 |06-521 Wiśniewo;781;268;268;7;261;34.31;2.61
94947;141310;Dom Pomocy Społecznej Zdrowa Jesień w Bogurzynie|Bogurzyn| 87 |06-521 Wiśniewo;19;19;19;3;16;100.00;15.79
94948;141401;Zespół Szkół Nr 1 Szkoła Podstawowa Nr 7|Nowy Dwór Mazowiecki|ul. Młodzieżowa 1 |05-101 Nowy Dwór Mazowiecki;1090;616;616;12;604;56.51;1.95
94949;141401;Zespół Szkół Nr 1 Publiczne Gimnazjum Nr 2|Nowy Dwór Mazowiecki|ul. Młodzieżowa 3 |05-101 Nowy Dwór Mazowiecki;2351;1436;1436;27;1409;61.08;1.88
94950;141401;Zespół Szkół Nr 1 Szkoła Podstawowa Nr 7|Nowy Dwór Mazowiecki|ul.Młodzieżowa 1 (stołówka)|05-101 Nowy Dwór Mazowiecki;2237;1322;1322;22;1300;59.10;1.66
94951;141401;Szkoła Podstawowa Nr 5|Nowy Dwór Mazowiecki|ul. Chemików 1A |05-100 Nowy Dwór Mazowiecki;1866;931;931;20;911;49.89;2.15
94952;141401;Liceum Ogólnokształcące|Nowy Dwór Mazowiecki|ul.Chemików 1 |05-100 Nowy Dwór Mazowiecki;1777;1029;1029;16;1013;57.91;1.55
94953;141401;Zespół Szkół Nr 2|Nowy Dwór Mazowiecki|ul. Długa 10 |05-100 Nowy Dwór Mazowiecki;1221;608;608;9;599;49.80;1.48
94954;141401;Urząd Miejski|Nowy Dwór Mazowiecki|ul. Zakroczymska 30 |05-100 Nowy Dwór Mazowiecki;1124;605;605;8;597;53.83;1.32
94955;141401;Publiczne Gimnazjum Nr 1|Nowy Dwór Mazowiecki|ul. Słowackiego 2 |05-100 Nowy Dwór Mazowiecki;2173;1161;1161;31;1130;53.43;2.67
94956;141401;Publiczne Przedszkole Nr 3|Nowy Dwór Mazowiecki|ul. Bohaterów Modlina 26 |05-100 Nowy Dwór Mazowiecki;1664;787;787;18;769;47.30;2.29
94957;141401;Zespół Szkół|Nowy Dwór Mazowiecki|ul. Bema 312 |05-160 Nowy Dwór Mazowiecki;2171;1129;1129;27;1102;52.00;2.39
94958;141401;Zespół Szkół (wejście od ul.29 Listopada)|Nowy Dwór Mazowiecki|ul. Bema 227 |05-160 Nowy Dwór Mazowiecki;2014;993;993;16;977;49.30;1.61
94959;141401;Zespół Szkół Nr 3|Nowy Dwór Mazowiecki|ul. Szkolna 3 |05-102 Nowy Dwór Mazowiecki;2232;1093;1093;24;1069;48.97;2.20
94960;141401;Szpital Powiatowy w Nowym Dworze Mazowieckim (Nowodworskie Centrum Medyczne)|Nowy Dwór Mazowiecki|Miodowa 2 |05-100 Nowy Dwór Mazowiecki;56;17;17;2;15;30.36;11.76
94961;141402;Zespół Szkół Publicznych w Cząstkowie Mazowieckim|Cząstków Mazowiecki| 55 |05-152 Czosnów;1211;750;750;13;737;61.93;1.73
94962;141402;Zespół Szkół Publicznych w Małocicach|Małocice|ul. Wojska Polskiego 76 |05-152 Czosnów;1725;980;980;28;952;56.81;2.86
94963;141402;Zespół Szkół Publicznych w Kazuniu Polskim|Kazuń Polski|ul. Szkolna 2 |05-152 Czosnów;1471;873;873;16;857;59.35;1.83
94964;141402;Zespół Szkół Publicznych w Sowiej Woli|Sowia Wola|ul. Szkolna 108 |05-152 Czosnów;1206;514;514;17;497;42.62;3.31
94965;141402;Zespół Szkół Publicznych w Łomnie|Łomna|ul. Jana Kochanowskiego 89 |05-152 Czosnów;1790;1059;1059;19;1040;59.16;1.79
94966;141402;Szkoła Podstawowa w Kazuniu Nowym|Kazuń Nowy|ul. Główna 6 |05-152 Czosnów;748;400;400;15;385;53.48;3.75
94967;141403;Zespół Szkół w Górkach|Górki| 67 |05-155 Leoncin;450;211;211;11;200;46.89;5.21
94968;141403;Zespół Szkół w Leoncinie|Leoncin|Isaaca Bashevisa Singera 3 |05-155 Leoncin;1481;782;782;25;757;52.80;3.20
94969;141403;Zespół Szkół w Głusku z siedzibą w Nowych Grochalach|Nowe Grochale| 40 |05-155 Leoncin;1379;706;706;28;678;51.20;3.97
94970;141403;Strażnica Ochotniczej Straży Pożarnej w Wilkowie Polskim|Wilków Polski| 54A |05-155 Leoncin;1229;576;576;12;564;46.87;2.08
94971;141404;Zespół Szkół Ogólnokształcących|Nasielsk|ul.Starzyńskiego 10 |05-190 Nasielsk;864;404;404;16;388;46.76;3.96
94972;141404;Zespół Szkół Ogólnokształcących|Nasielsk|ul.Starzyńskiego 10 |05-190 Nasielsk;782;416;416;10;406;53.20;2.40
94973;141404;Hala Sportowa|Nasielsk|ul. Staszica 1 |05-190 Nasielsk;1067;517;517;13;504;48.45;2.51
94974;141404;Publiczne Gimnazjum Nr 1|Nasielsk|ul. Staszica 1 |05-190 Nasielsk;1069;511;511;19;492;47.80;3.72
94975;141404;Zespół Szkół Zawodowych|Nasielsk|ul.Lipowa 10 |05-190 Nasielsk;1145;466;466;17;449;40.70;3.65
94976;141404;Szkoła Podstawowa|Nasielsk|ul. Tadeusza Kościuszki 21 |05-190 Nasielsk;1047;494;494;18;476;47.18;3.64
94977;141404;Zespół Szkół Nr 2|Stare Pieścirogi|ul. Kolejowa 65 |05-191 Nasielsk;1166;570;570;18;552;48.89;3.16
94978;141404;Zespół Szkół Nr 2|Stare Pieścirogi|ul.Kolejowa 65 |05-191 Nasielsk;1279;513;513;18;495;40.11;3.51
94979;141404;Zespół Szkół Zawodowych|Nasielsk|ul. Lipowa 10 |05-190 Nasielsk;1142;371;371;14;357;32.49;3.77
94980;141404;Szkoła Podstawowa|Popowo Borowe| |05-190 Nasielsk;973;381;381;13;368;39.16;3.41
94981;141404;Szkoła Podstawowa im. Pierre'a de Coubertina|Budy Siennickie| |05-190 Nasielsk;1144;503;503;12;491;43.97;2.39
94982;141404;Remiza Ochotniczej Straży Pożarnej|Nuna| |05-190 Nasielsk;713;281;281;13;268;39.41;4.63
94983;141404;Ośrodek Zdrowia|Stare Pieścirogi|ul. Sikorskiego 1 |05-191 Nasielsk;940;403;403;19;384;42.87;4.71
94984;141404;Szkoła Podstawowa|Dębinki| |05-191 Nasielsk;1052;424;424;18;406;40.30;4.25
94985;141404;Zespół Szkół Nr 3|Cieksyn|ul. Marszałka Józefa Piłsudskiego 43 |05-192 Cieksyn;1273;487;487;29;458;38.26;5.95
94986;141404;Dom Pomocy Społecznej w Nasielsku|Nasielsk|Tadeusza Kościuszki 25 |05-190 Nasielsk;72;38;38;6;32;52.78;15.79
94987;141405;Hala Sportowa w Pomiechówku|Pomiechówek|Szkolna 3 Wejście A|05-180 Pomiechówek;954;563;563;19;544;59.01;3.37
94988;141405;Hala Sportowa w Pomiechówku|Pomiechówek|Szkolna 3 Wejście B|05-180 Pomiechówek;1005;626;626;9;617;62.29;1.44
94989;141405;Gminny Ośrodek Kultury w Pomiechówku|Pomiechówek|Jana Kilińskiego 1 |05-180 Pomiechówek;1594;837;837;28;809;52.51;3.35
94990;141405;Klub wiejski w Kosewie|Kosewo| |05-180 Pomiechówek;1152;482;482;10;472;41.84;2.07
94991;141405;Klub wiejski w Czarnowie|Czarnowo| |05-180 Pomiechówek;478;258;258;11;247;53.97;4.26
94992;141405;Szkoła Podstawowa w Starym Orzechowie|Stare Orzechowo| |05-180 Pomiechówek;496;242;242;8;234;48.79;3.31
94993;141405;Szkoła Podstawowa w Goławicach Pierwszych|Goławice Pierwsze| |05-180 Pomiechówek;1151;553;553;18;535;48.05;3.25
94994;141405;Klub wiejski w Szczypiornie|Szczypiorno| |05-180 Pomiechówek;468;252;252;4;248;53.85;1.59
94995;141406;Szkoła Podstawowa|Zakroczym|ul. o.Honorata Koźmińskiego 63 |05-170 Zakroczym;1390;655;655;21;634;47.12;3.21
94996;141406;Strażnica OSP|Zakroczym|ul.o.Honorata Koźmińskiego 11 |05-170 Zakroczym;1257;552;552;22;530;43.91;3.99
94997;141406;Szkoła Podstawowa|Wojszczyce| |05-180 Pomiechówek;673;244;244;5;239;36.26;2.05
94998;141406;Remiza Strażacka|Trębki Nowe| |05-170 Zakroczym;1018;367;367;14;353;36.05;3.81
94999;141406;Szkoła Podstawowa|Emolinek| |05-170 Zakroczym;778;233;233;13;220;29.95;5.58
95000;141501;Zespół Szkół Gminnych w Baranowie|Baranowo|Niepodległości 27A |06-320 Baranowo;1396;651;651;18;633;46.63;2.76
95001;141501;Szkoła Podstawowa w Jastrząbce|Jastrząbka| 33 |06-320 Baranowo;586;218;218;7;211;37.20;3.21
95002;141501;Budynek Szkoły w Cierpiętach|Cierpięta| 22 |06-320 Baranowo;618;226;226;12;214;36.57;5.31
95003;141501;Remiza Strażacka w Brodowych Łąkach|Brodowe Łąki| 30 |06-320 Baranowo;1134;390;390;20;370;34.39;5.13
95004;141501;Szkoła Podstawowa w Bakule - Ziomku|Ziomek| 1 |06-320 Baranowo;453;168;168;11;157;37.09;6.55
95005;141501;Zespół Szkół Powiatowych w Baranowie|Baranowo|Niepodległości 27 |06-320 Baranowo;1156;364;364;13;351;31.49;3.57
95006;141502;Szkoła Podstawowa w Czarni|Czarnia| 42 |07-431 Czarnia;705;240;240;7;233;34.04;2.92
95007;141502;Remizo-Świetlica w Bandysiach|Bandysie| 33a |07-431 Czarnia;283;83;83;2;81;29.33;2.41
95008;141502;Szkoła Podstawowa w Długiem|Długie| 13 |07-431 Czarnia;221;92;92;7;85;41.63;7.61
95009;141502;Szkoła Podstawowa w Surowem|Surowe| 194 |07-431 Czarnia;803;303;303;13;290;37.73;4.29
95010;141503;Szkoła Podstawowa w Czerwinie|Czerwin|ul. Szkolna 5 |07-407 Czerwin;1700;805;805;20;785;47.35;2.48
95011;141503;Szkoła Podstawowa w Jarnutach|Jarnuty| 46 |07-407 Czerwin;253;76;76;3;73;30.04;3.95
95012;141503;Remiza OSP w Suchcicach|Suchcice|ul. Zadworska 2 |07-407 Czerwin;208;89;89;1;88;42.79;1.12
95013;141503;Szkoła Podstawowa w Laskach|Laski| 35A |07-407 Czerwin;523;227;227;10;217;43.40;4.41
95014;141503;Szkoła Podstawowa w Piskach|Piski|ul. Juliusza Słowackiego 22 |07-407 Czerwin;922;387;387;20;367;41.97;5.17
95015;141503;Remiza OSP w Malinowie Nowym|Malinowo Nowe| 14 |07-407 Czerwin;242;116;116;5;111;47.93;4.31
95016;141503;Szkoła Podstawowa w Gocłach|Gocły| 39 |07-407 Czerwin;334;126;126;2;124;37.72;1.59
95017;141504;Zespół Szkół Nr 1 Goworowo|Goworówek| 43a |07-440 Goworowo;1720;698;698;27;671;40.58;3.87
95018;141504;Gminny Ośrodek Kultury, Sportu i Rekreacji|Goworowo|ul. Szkolna 16a |07-440 Goworowo;1318;450;450;24;426;34.14;5.33
95019;141504;Szkoła Podstawowa|Pasieki|ul. Szkolna 2 |07-440 Goworowo;922;305;305;21;284;33.08;6.89
95020;141504;Szkoła Podstawowa|Kunin| 22a |07-440 Goworowo;912;370;370;21;349;40.57;5.68
95021;141504;Budynek byłej Szkoły Podstawowej Kruszewo|Jawory Wielkopole| 35a |07-440 Goworowo;496;192;192;11;181;38.71;5.73
95022;141504;Filia Gminnej Biblioteki Publicznej|Żabin| 100 |07-440 Goworowo;792;292;292;12;280;36.87;4.11
95023;141504;Świetlica|Brzeźno| 37A |07-440 Goworowo;421;158;158;9;149;37.53;5.70
95024;141504;Ośrodek Edukacji Regionalnej|Lipianka| 37a |07-440 Goworowo;357;146;146;4;142;40.90;2.74
95025;141505;Zespół Placówek Oświatowych w Kadzidle (świetlica szkolna)|Kadzidło|ul. Kościuszki 13 |07-420 Kadzidło;511;264;264;6;258;51.66;2.27
95026;141505;Publiczne Gimnazjum w Kadzidle (sala gimnastyczna)|Kadzidło|ul. Kościuszki 13 |07-420 Kadzidło;554;250;250;2;248;45.13;0.80
95027;141505;Zespół Placówek Oświatowych w Kadzidle (sala lekcyjna)|Kadzidło|ul. Kościuszki 13 |07-420 Kadzidło;609;295;295;6;289;48.44;2.03
95028;141505;Zespół Placówek Oświatowych w Kadzidle (sala lekcyjna)|Kadzidło|ul. Kościuszki 13 |07-420 Kadzidło;504;237;237;10;227;47.02;4.22
95029;141505;Zespół Placówek Oświatowych w Kadzidle (sala lekcyjna)|Kadzidło|ul. Kościuszki 13 |07-420 Kadzidło;731;407;407;5;402;55.68;1.23
95030;141505;Publiczne Gimnazjum w Kadzidle (sala lekcyjna)|Kadzidło|Kościuszki 13 |07-420 Kadzidło;494;238;238;7;231;48.18;2.94
95031;141505;Publiczne Gimnazjum w Kadzidle (sala lekcyjna)|Kadzidło|Kościuszki 13 |07-420 Kadzidło;766;317;317;21;296;41.38;6.62
95032;141505;Zespół Placówek Oświatowych w Dylewie (świetlica szkolna)|Dylewo|Szkolna 1 |07-420 Kadzidło;744;286;286;10;276;38.44;3.50
95033;141505;Zespół Placówek Oświatowych w Dylewie (sala lekcyjna)|Dylewo|Szkolna 1 |07-420 Kadzidło;528;245;245;6;239;46.40;2.45
95034;141505;Zespół Szkół w Chudku|Chudek| 36 |07-420 Kadzidło;513;223;223;12;211;43.47;5.38
95035;141505;Szkoła Podstawowa w Glebie|Gleba| 37B |07-420 Kadzidło;497;170;170;3;167;34.21;1.76
95036;141505;Świetlica Wiejska w Strzałkach|Strzałki| 15 |07-420 Kadzidło;490;188;188;5;183;38.37;2.66
95037;141505;Zespół Szkół w Wachu|Wach| 96 |07-420 Kadzidło;827;250;250;9;241;30.23;3.60
95038;141505;Szkoła Podstawowa w Jazgarce|Jazgarka| 54 |07-420 Kadzidło;575;184;184;18;166;32.00;9.78
95039;141505;Szkoła Podstawowa w Czarni|Czarnia| 67 |07-420 Kadzidło;504;224;224;16;208;44.44;7.14
95040;141506;Gminny Ośrodek Kulturalno-Oświatowy w Lelisie|Lelis|ul. Szkolna 48 |07-402 Lelis;1693;788;788;43;745;46.54;5.46
95041;141506;Szkoła Podstawowa w Nasiadkach|Nasiadki| 37 |07-402 Lelis;599;287;287;16;271;47.91;5.57
95042;141506;Szkoła Podstawowa w Olszewce|Olszewka| 24a |07-402 Lelis;637;297;297;12;285;46.62;4.04
95043;141506;Szkoła Podstawowa w Łęgu Przedmiejskim|Łęg Przedmiejski| 80 |07-402 Lelis;1247;573;573;25;548;45.95;4.36
95044;141506;Szkoła Podstawowa w Dąbrówce|Dąbrówka| 55 |07-402 Lelis;774;336;336;21;315;43.41;6.25
95045;141506;Szkoła Podstawowa w Łęgu Starościńskim|Łęg Starościński| 23 |07-402 Lelis;578;247;247;6;241;42.73;2.43
95046;141506;Szkoła Podstawowa w Obierwi|Obierwia| 120 |07-402 Lelis;703;351;351;10;341;49.93;2.85
95047;141506;Szkoła Podstawowa w Białobieli|Białobiel|ul. Szkolna 1 |07-402 Lelis;952;544;544;7;537;57.14;1.29
95048;141507;Szkoła Podstawowa w Łączkach|Łączki| 103 |07-438 Zalas;398;120;120;5;115;30.15;4.17
95049;141507;Szkoła Podstawowa w Warmiaku|Warmiak| 16 |07-438 Zalas;412;146;146;9;137;35.44;6.16
95050;141507;Zespół Szkół w Zalasiu|Zalas| 1 |07-438 Zalas;821;325;325;8;317;39.59;2.46
95051;141507;Gminny Ośrodek Kultury Sportu i Rekreacji w Łysych|Łyse|ul. Kościelna 19 |07-437 Łyse;1261;422;422;15;407;33.47;3.55
95052;141507;Zespół Szkół w Łysych|Łyse|ul. Szkolna 1 |07-437 Łyse;1835;663;663;24;639;36.13;3.62
95053;141507;Zespół Szkół w Lipnikach|Lipniki|ul. Ks. kan. E. Sierbińskiego 30 |07-436 Lipniki;868;319;319;5;314;36.75;1.57
95054;141507;Szkoła Podstawowa w Szafrankach|Szafranki| 33 |07-436 Lipniki;514;179;179;12;167;34.82;6.70
95055;141507;Świetlica wiejska w Babie|Baba| 56A |07-436 Lipniki;391;132;132;3;129;33.76;2.27
95056;141508;Zespół Szkół Powiatowych w Myszyńcu|Myszyniec|ul. Dzieci Polskich 5 |07-430 Myszyniec;1294;548;548;26;522;42.35;4.74
95057;141508;Przedszkole Samorządowe w Myszyńcu|Myszyniec|ul. Dzieci Polskich 1 |07-430 Myszyniec;1337;642;642;19;623;48.02;2.96
95058;141508;Budynek po Szkole Podstawowej w Myszyńcu Starym|Myszyniec Stary| 105 |07-430 Myszyniec;680;286;286;14;272;42.06;4.90
95059;141508;Szkoła Podstawowa w Pełtach|Pełty| 37 |07-430 Myszyniec;503;196;196;15;181;38.97;7.65
95060;141508;Środowiskowy Dom Samopomocy w Białusnym Lasku|Białusny Lasek| 19 |07-430 Myszyniec;394;154;154;11;143;39.09;7.14
95061;141508;Publiczna Szkoła Podstawowa w Wydmusach|Wydmusy| 117A |07-430 Myszyniec;762;307;307;25;282;40.29;8.14
95062;141508;Zespół Szkół w Wykrocie|Wykrot| 21A |07-430 Myszyniec;669;279;279;11;268;41.70;3.94
95063;141508;Zespół Szkół w Wolkowych|Wolkowe| 1 |07-430 Myszyniec;824;248;248;25;223;30.10;10.08
95064;141508;Publiczna Szkoła Podstawowa w Olszynach|Olszyny| 34 |07-430 Myszyniec;387;130;130;13;117;33.59;10.00
95065;141508;Budynek po Szkole Podstawowej w Cięćku|Cięćk| 45 |07-430 Myszyniec;183;77;77;2;75;42.08;2.60
95066;141508;Świetlica Wiejska w Niedźwiedziu|Niedźwiedź| 2 |07-430 Myszyniec;168;62;62;1;61;36.90;1.61
95067;141508;Publiczna Szkoła Podstawowa w Krysiakach|Krysiaki| 29 |07-430 Myszyniec;294;89;89;8;81;30.27;8.99
95068;141508;Szkoła Podstawowa w Zdunku|Zdunek| 31 |07-430 Myszyniec;362;140;140;8;132;38.67;5.71
95069;141508;Publiczna Szkoła Podstawowa w Zalesiu|Zalesie| 36A |07-430 Myszyniec;410;173;173;11;162;42.20;6.36
95070;141509;Szkoła Podstawowa im. Wł. Broniewskiego w Olszewie-Borkach|Olszewo-Borki|ul. Broniewskiego 17 |07-415 Olszewo-Borki;1614;925;925;21;904;57.31;2.27
95071;141509;Gimnazjum im. Papieża Jana Pawła II w Olszewie-Borkach|Olszewo-Borki|ul. Dojazdowa 14A |07-415 Olszewo-Borki;1670;805;805;7;798;48.20;0.87
95072;141509;Szkoła Podstawowa w Nowej Wsi|Nowa Wieś|Szkolna 1 |07-416 Olszewo-Borki;1671;647;647;29;618;38.72;4.48
95073;141509;Szkoła Podstawowa w Przystani|Przystań| 33 |07-416 Olszewo-Borki;465;182;182;1;181;39.14;0.55
95074;141509;Szkoła Podstawowa w Grabówku|Grabówek| 20 |07-416 Olszewo-Borki;403;110;110;7;103;27.30;6.36
95075;141509;Szkoła Podstawowa im. J. Korczaka w Antoniach|Antonie|Szkolna 6 |07-410 Ostrołęka;1681;841;841;14;827;50.03;1.66
95076;141509;Remiza Ochotniczej Straży Pożarnej w Dobrołęce|Dobrołęka| 29 |07-415 Olszewo-Borki;529;303;303;15;288;57.28;4.95
95077;141510;Remiza OSP w Rzekuniu|Rzekuń|ul. Kościuszki 44 |07-411 Rzekuń;2172;1201;1201;26;1175;55.29;2.16
95078;141510;Gimnazjum im. Marszałka J. Piłsudskiego w Rzekuniu|Rzekuń|ul. Szkolna 1 |07-411 Rzekuń;1669;862;862;24;838;51.65;2.78
95079;141510;Szkoła Podstawowa im. Orła Białego w Borawem|Borawe| 107 |07-411 Rzekuń;1080;452;452;22;430;41.85;4.87
95080;141510;Szkoła Podstawowa im. Mieczysława Czychowskiego w Dzbeninie|Dzbenin| 6a |07-410 Ostrołęka;674;385;385;7;378;57.12;1.82
95081;141510;Zespół Szkół w Ołdakach|Ołdaki| 8a |07-411 Rzekuń;1371;606;606;14;592;44.20;2.31
95082;141510;Szkoła Podstawowa im. ks. Antoniego Pęksy w Laskowcu|Laskowiec|ul. Długa 90 |07-401 Ostrołęka;1114;513;513;9;504;46.05;1.75
95083;141510;Zakład Karny w Przytułach Starych|Przytuły Stare| 13A |07-411 Rzekuń;641;195;195;32;163;30.42;16.41
95084;141511;Gimnazjum w Troszynie|Troszyn|ul. Gajowa 1 |07-405 Troszyn;1075;469;469;14;455;43.63;2.99
95085;141511;Szkoła Filialna w Łątczynie|Łątczyn| 69A |07-405 Troszyn;287;117;117;6;111;40.77;5.13
95086;141511;Świetlica Wiejska w Milewie Wielkim|Milewo Wielkie| 15 |07-405 Troszyn;475;231;231;1;230;48.63;0.43
95087;141511;Szkoła Podstawowa w Kleczkowie|Kleczkowo|ul. Bielawska 2 |07-405 Troszyn;784;346;346;14;332;44.13;4.05
95088;141511;Świetlica Wiejska w Opęchowie|Opęchowo|ul. Adama Mickiewicza 5 |07-405 Troszyn;524;229;229;10;219;43.70;4.37
95089;141511;Centrum Kultury w Troszynie|Troszyn|ul. Szkolna 6 |07-405 Troszyn;754;409;409;14;395;54.24;3.42
95090;141601;Liga Obrony Kraju|Ostrów Mazowiecka|ul. Różańska 5 |07-300 Ostrów Mazowiecka;1749;951;951;24;927;54.37;2.52
95091;141601;Szkoła Podstawowa Nr 1|Ostrów Mazowiecka|ul. Partyzantów 39 |07-300 Ostrów Mazowiecka;1832;881;881;18;863;48.09;2.04
95092;141601;Szkoła Podstawowa nr 1|Ostrów Mazowiecka|ul. Partyzantów 39 |07-300 Ostrów Mazowiecka;974;422;422;6;416;43.33;1.42
95093;141601;Miejskie Przedszkole Nr 2|Ostrów Mazowiecka|ul. Zwycięstwa 2 |07-300 Ostrów Mazowiecka;1725;952;952;5;947;55.19;0.53
95094;141601;Centrum Integracji Społecznej|Ostrów Mazowiecka|ul. Chopina 2b |07-300 Ostrów Mazowiecka;1712;734;734;13;721;42.87;1.77
95095;141601;Zespół Szkół Nr 2|Ostrów Mazowiecka|ul. Tadeusza Kościuszki 8 |07-300 Ostrów Mazowiecka;878;453;453;2;451;51.59;0.44
95096;141601;Zespół Szkół Publicznych Nr 1|Ostrów Mazowiecka|ul. Grota Roweckiego 6 |07-300 Ostrów Mazowiecka;798;376;376;6;370;47.12;1.60
95097;141601;Zespół Szkół Publicznych Nr 1|Ostrów Mazowiecka|ul. Grota Roweckiego 6 |07-300 Ostrów Mazowiecka;1771;793;793;19;774;44.78;2.40
95098;141601;Zespół Szkół Publicznych Nr 2|Ostrów Mazowiecka|ul. Szkoły Podchorążych Piechoty 1 |07-300 Ostrów Mazowiecka;1733;720;720;20;700;41.55;2.78
95099;141601;Szkoła Podstawowa Nr 3|Ostrów Mazowiecka|Widnichowska 4 |07-300 Ostrów Mazowiecka;1653;853;853;9;844;51.60;1.06
95100;141601;Szkoła Podstawowa Nr 3|Ostrów Mazowiecka|Widnichowska 4 |07-300 Ostrów Mazowiecka;1679;902;902;16;886;53.72;1.77
95101;141601;Liceum Ogólnokształcące|Ostrów Mazowiecka|ul. Kościuszki 36 |07-300 Ostrów Mazowiecka;1715;852;852;16;836;49.68;1.88
95102;141601;Samodzielny Publiczny Zespół Zakładów Opieki Zdrowotnej|Ostrów Mazowiecka|ul. Duboisa 68 |07-300 Ostrów Mazowiecka;119;64;64;1;63;53.78;1.56
95103;141602;Gminne Gimnazjum w Andrzejewie|Andrzejewo|ul. Srebińska 12a |07-305 Andrzejewo;988;544;544;9;535;55.06;1.65
95104;141602;Szkoła Podstawowa w Andrzejewie|Andrzejewo|Warszawska 4 |07-305 Andrzejewo;926;469;469;5;464;50.65;1.07
95105;141602;Szkoła Podstawowa w Starej Ruskołęce|Stara Ruskołęka| 40a |07-305 Andrzejewo;1119;485;485;11;474;43.34;2.27
95106;141602;Świetlica Wiejska w Zarębach Warchołach|Zaręby-Warchoły| 27B |07-305 Andrzejewo;473;247;247;8;239;52.22;3.24
95107;141603;Gminny Ośrodek Kultury i Sportu|Boguty-Pianki|ul. Pawła Olszewskiego 2 |07-325 Boguty-Pianki;962;524;524;10;514;54.47;1.91
95108;141603;Szkoła Podstawowa|Białe-Szczepanowice| 10 |07-325 Boguty-Pianki;388;190;190;2;188;48.97;1.05
95109;141603;Szkoła Podstawowa|Kutyłowo-Perysie| 46 |07-325 Boguty-Pianki;261;117;117;2;115;44.83;1.71
95110;141603;Szkoła Podstawowa|Tymianki-Bucie| 18 |07-325 Boguty-Pianki;330;186;186;2;184;56.36;1.08
95111;141603;Szkoła Podstawowa|Zawisty, Zawisty-Dworaki| 58 |07-325 Boguty-Pianki;266;142;142;2;140;53.38;1.41
95112;141604;Zespół Publicznych Placówek Oświatowych w Broku|Brok|ul. Jana Pawła II 50 |07-306 Brok;916;444;444;18;426;48.47;4.05
95113;141604;Szkoła Podstawowa w Kaczkowie Starym|Kaczkowo Stare| 86 |07-306 Brok;411;195;195;11;184;47.45;5.64
95114;141604;Zespół Publicznych Placówek Oświatowych w Broku|Brok|ul. Jana Pawła II 50 |07-306 Brok;1016;507;507;9;498;49.90;1.78
95115;141605;Zespół Szkół Gminnych|Małkinia Górna|ul. Ostrowska 58 |07-320 Małkinia Górna;1130;536;536;17;519;47.43;3.17
95116;141605;Zespół Szkół|Małkinia Górna|ul. Nurska 150 |07-320 Małkinia Górna;885;408;408;14;394;46.10;3.43
95117;141605;Przedszkole Samorządowe|Małkinia Górna|ul. Przedszkolna 2 |07-320 Małkinia Górna;909;403;403;6;397;44.33;1.49
95118;141605;Gminny Ośrodek Kultury i Sportu|Małkinia Górna|ul. Przedszkolna 3 |07-320 Małkinia Górna;1005;465;465;7;458;46.27;1.51
95119;141605;Zespół Szkół Gminnych Nr 2|Małkinia Górna|ul. Leśna 15 |07-320 Małkinia Górna;616;364;364;4;360;59.09;1.10
95120;141605;Szkoła Podstawowa|Kiełczew|ul. Prymasa Tysiąclecia 49 |07-319 Prostyń;575;253;253;8;245;44.00;3.16
95121;141605;Zespół Szkół Gminnych|Prostyń| 60 |07-319 Prostyń;629;288;288;13;275;45.79;4.51
95122;141605;Świetlica|Grądy| 24A |07-319 Prostyń;555;259;259;10;249;46.67;3.86
95123;141605;Szkoła Podstawowa|Kańkowo| 58 |07-320 Małkinia Górna;674;288;288;11;277;42.73;3.82
95124;141605;Świetlica Rostki Wielkie|Rostki Wielkie| 27A |07-320 Małkinia Górna;637;330;330;8;322;51.81;2.42
95125;141605;Remiza Ochotniczej Straży Pożarnej|Daniłówka Pierwsza| 129 |07-320 Małkinia Górna;650;264;264;9;255;40.62;3.41
95126;141605;Szkoła Podstawowa|Orło| 11 |07-320 Małkinia Górna;677;304;304;18;286;44.90;5.92
95127;141605;Szkoła Podstawowa|Glina| 83 |07-320 Małkinia Górna;738;356;356;24;332;48.24;6.74
95128;141606;Gminny Ośrodek Kultury|Nur|Drohiczyńska 2 |07-322 Nur;1349;643;643;15;628;47.66;2.33
95129;141606;Świetlica wiejska|Godlewo-Warsze| |07-322 Nur;330;144;144;2;142;43.64;1.39
95130;141606;Świetlica wiejska|Murawskie Nadbużne| |07-322 Nur;496;263;263;8;255;53.02;3.04
95131;141606;Świetlica Wiejska|Zuzela| |07-322 Nur;313;155;155;5;150;49.52;3.23
95132;141607;Publiczna Szkoła Podstawowa|Dybki| 18 |07-308 Brok;616;253;253;11;242;41.07;4.35
95133;141607;Publiczna Szkoła Podstawowa|Nowa Osuchowa|ul. Szkolna 50 |07-308 Brok;459;226;226;8;218;49.24;3.54
95134;141607;Publiczna Szkoła Podstawowa|Nagoszewka Druga| 89 |07-300 Ostrów Mazowiecka;738;343;343;9;334;46.48;2.62
95135;141607;Publiczna Szkoła Podstawowa|Koziki| 2 |07-300 Ostrów Mazowiecka;629;261;261;6;255;41.49;2.30
95136;141607;Zespół Szkół Publicznych|Komorowo|ul. Mazowiecka 81 |07-310 Ostrów Mazowiecka;781;369;369;3;366;47.25;0.81
95137;141607;Zespół Szkół Publicznych|Komorowo|ul. Mazowiecka 81 |07-310 Ostrów Mazowiecka;762;311;311;12;299;40.81;3.86
95138;141607;Zespół Szkół Publicznych|Jelonki| 16 |07-302 Ostrów Mazowiecka;766;302;302;9;293;39.43;2.98
95139;141607;Publiczna Szkoła Podstawowa|Stare Lubiejewo|ul. Szkolna 15 |07-300 Ostrów Mazowiecka;754;323;323;6;317;42.84;1.86
95140;141607;Świetlica Wiejska|Prosienica| 63 |07-304 Ostrów Mazowiecka;537;226;226;5;221;42.09;2.21
95141;141607;Publiczna Szkoła Podstawowa|Kalinowo| 90 |07-304 Ostrów Mazowiecka;720;288;288;2;286;40.00;0.69
95142;141607;Publiczna Szkoła Podstawowa|Jasienica|ul. Pawła Jasienicy 23 |07-304 Ostrów Mazowiecka;518;217;217;5;212;41.89;2.30
95143;141607;Świetlica Wiejska|Nieskórz| 27 |07-304 Ostrów Mazowiecka;633;244;244;7;237;38.55;2.87
95144;141607;Publiczna Szkoła Podstawowa|Ugniewo|ul. Szkolna 28 |07-300 Ostrów Mazowiecka;740;324;324;9;315;43.78;2.78
95145;141607;Publiczna Szkoła Podstawowa|Dudy| 19 |07-300 Ostrów Mazowiecka;792;305;305;7;298;38.51;2.30
95146;141607;Przedszkole Samorządowe|Komorowo|ul. Płk Dypl. Ludwika Bociańskiego 2 |07-310 Ostrów Mazowiecka;661;320;320;5;315;48.41;1.56
95147;141608;Szkoła Podstawowa|Stary Lubotyń| 7 |07-303 Stary Lubotyń;1299;560;560;23;537;43.11;4.11
95148;141608;Szkoła Podstawowa|Gniazdowo| 23 |07-303 Stary Lubotyń;342;168;168;3;165;49.12;1.79
95149;141608;Szkoła Podstawowa|Sulęcin Szlachecki| 73 |07-303 Stary Lubotyń;491;207;207;6;201;42.16;2.90
95150;141608;Remiza OSP|Podbiele| 28a |07-303 Stary Lubotyń;504;271;271;16;255;53.77;5.90
95151;141608;Remiza OSP|Rząśnik| 47a |07-303 Stary Lubotyń;186;88;88;6;82;47.31;6.82
95152;141608;Remiza OSP|Koskowo| 23 |07-303 Stary Lubotyń;203;65;65;1;64;32.02;1.54
95153;141609;Budynek Zespołu Szkół w Szulborzu Wielkim (budynek szkoły podstawowej)|Szulborze Wielkie|ul. Szarych Szeregów 1 |07-324 Szulborze Wielkie;780;389;389;14;375;49.87;3.60
95154;141609;Budynek Zespołu Szkół w Szulborzu Wielkim (budynek publicznego gimnazjum)|Szulborze Wielkie|ul. Szarych Szeregów 1 |07-324 Szulborze Wielkie;700;325;325;9;316;46.43;2.77
95155;141610;Gminne Centrum Sportu i Rekreacji - hala sportowa w Wąsewie|Wąsewo|ul. Armii Krajowej 6 |07-311 Wąsewo;1468;834;834;24;810;56.81;2.88
95156;141610;Publiczna Szkoła Podstawowa w Brudkach Starych|Brudki Stare| 73 |07-311 Wąsewo;512;234;234;11;223;45.70;4.70
95157;141610;Publiczna Szkoła Podstawowa w Rząśniku Włościańskim|Rząśnik Włościański| 30 |07-311 Wąsewo;898;424;424;11;413;47.22;2.59
95158;141610;Budynek Szkoły Podstawowej w Trynosach-Osiedle|Trynosy-Osiedle| 14 |07-311 Wąsewo;683;345;345;13;332;50.51;3.77
95159;141611;Publiczna Szkoła Podstawowa|Zaręby Kościelne|ul. Farna 20 |07-323 Zaręby Kościelne;1068;488;488;11;477;45.69;2.25
95160;141611;Budynek Komunalny po Publicznej Szkole Podstawowej|Zakrzewo-Kopijki| |07-323 Zaręby Kościelne;773;327;327;12;315;42.30;3.67
95161;141611;Budynek Ośrodka Zdrowia|Zaręby Kościelne|ul. Kowalska 16A |07-323 Zaręby Kościelne;1192;604;604;11;593;50.67;1.82
95162;141701;Szkoła Podstawowa Nr 2 ( sala Nr 19)|Józefów|ul. Graniczna 26 |05-410 Józefów;2185;1501;1501;21;1480;68.70;1.40
95163;141701;Gimnazjum Nr 1|Józefów|ul. Leśna 39 |05-420 Józefów;1132;786;786;10;776;69.43;1.27
95164;141701;Miejski Ośrodek Kultury|Józefów|ul.Kardynała Wyszyńskiego 1 |05-420 Józefów;1807;1269;1269;22;1247;70.23;1.73
95165;141701;Szkoła Podstawowa Nr 1 ( sala Nr 9)|Józefów|ul. Mickiewicza 11 9|05-420 Józefów;1790;1164;1164;29;1135;65.03;2.49
95166;141701;Szkoła Podstawowa Nr 1 ( sala Nr 4)|Józefów|ul. Mickiewicza 11 4|05-420 Józefów;925;680;680;8;672;73.51;1.18
95167;141701;Ochotnicza Straż Pożarna "Świdry Małe"|Józefów|ul. Nadwiślańska 132 |05-420 Józefów;2229;1553;1553;21;1532;69.67;1.35
95168;141701;Przedszkole Miejskie Nr 1|Józefów|ul. Sobieskiego 21 |05-410 Józefów;906;646;646;6;640;71.30;0.93
95169;141701;Młodzieżowy Ośrodek Socjoterapii "Jędruś"|Józefów|ul. Główna 10 |05-410 Józefów;1671;1045;1045;17;1028;62.54;1.63
95170;141701;Szkoła Podstawowa nr 2 ( stołówka)|Józefów|ul.Graniczna 26 |05-410 Józefów;2294;1539;1539;16;1523;67.09;1.04
95171;141702;Gimnazjum nr 2|Otwock|ul. Poniatowskiego 47/49 |05-400 Otwock;1495;937;937;8;929;62.68;0.85
95172;141702;Szkoła Podstawowa nr 12|Otwock|ul. Andriollego 76 |05-400 Otwock;775;509;509;6;503;65.68;1.18
95173;141702;Osiedlowy Klub Perła|Otwock|ul. Sportowa 3 |05-400 Otwock;1564;976;976;8;968;62.40;0.82
95174;141702;Biuro Otwockiej Spółdzielni Mieszkaniowej|Otwock|ul. Andriollego 54 |05-400 Otwock;1516;1004;1004;13;991;66.23;1.29
95175;141702;Urząd Miasta Otwocka|Otwock|ul. Armii Krajowej 5 budynek C|05-400 Otwock;1068;678;678;7;671;63.48;1.03
95176;141702;Ośrodek Pomocy Społecznej|Otwock|ul. Sosnowa 4 |05-400 Otwock;785;494;494;18;476;62.93;3.64
95177;141702;Gimnazjum nr 4|Otwock|ul. Szkolna 31 |05-400 Otwock;1750;1053;1053;20;1033;60.17;1.90
95178;141702;Szkoła Podstawowa nr 1|Otwock|ul. Karczewska 14/16 |05-400 Otwock;1245;847;847;6;841;68.03;0.71
95179;141702;Osiedlowy Klub Batory|Otwock|ul. Batorego 34 |05-400 Otwock;1859;1138;1138;15;1123;61.22;1.32
95180;141702;Przedszkole nr 3|Otwock|ul. Jodłowa 14 |05-400 Otwock;1115;663;663;12;651;59.46;1.81
95181;141702;Stacja Pomp OPWiK|Otwock|ul. Batorego 2 |05-400 Otwock;2200;1420;1420;22;1398;64.55;1.55
95182;141702;Szkoła Podstawowa nr 6|Otwock|ul. Ambasadorska 1 |05-400 Otwock;2236;1461;1461;25;1436;65.34;1.71
95183;141702;Powiatowa Poradnia Psychologiczno-Pedagogiczna|Otwock, Świder|ul. Majowa 17/19 |05-402 Otwock;1512;780;780;18;762;51.59;2.31
95184;141702;Przedszkole nr 18|Otwock, Świder|ul. Komunardów 4 |05-402 Otwock;1107;691;691;26;665;62.42;3.76
95185;141702;Szkoła Podstawowa nr 5|Otwock, Świder|ul. Słowackiego 66 |05-402 Otwock;1512;936;936;7;929;61.90;0.75
95186;141702;Centrum Edukacji Zawodowej Resortu Finansów, Ośrodek Zamiejscowy w Otwocku|Otwock, Świder|ul. Kolorowa 13 |05-402 Otwock;1559;926;926;13;913;59.40;1.40
95187;141702;Osiedlowy Klub Smok|Otwock|ul. Warszawska 11/13 |05-400 Otwock;1557;933;933;12;921;59.92;1.29
95188;141702;Gimnazjum nr 3|Otwock|ul. Kościuszki 28 |05-400 Otwock;1446;990;990;17;973;68.46;1.72
95189;141702;Liceum Ogólnokształcące im.Juliusza Słowackiego|Otwock|ul. Słowackiego 4/10 |05-400 Otwock;1294;683;683;24;659;52.78;3.51
95190;141702;Zespół Szkół Ekonomiczno-Gastronomicznych|Otwock|ul. Konopnickiej 3 |05-400 Otwock;674;368;368;7;361;54.60;1.90
95191;141702;Przedszkole nr 10|Otwock|ul. Kochanowskiego 10 |05-400 Otwock;968;585;586;13;572;60.43;2.22
95192;141702;Przedszkole nr 6|Otwock, Śródborów|ul. Kubusia Puchatka 28 |05-400 Otwock;991;538;538;3;535;54.29;0.56
95193;141702;Gimnazjum nr 1|Otwock, Mlądz|ul. Majowa 267 |05-400 Otwock;1123;623;623;10;613;55.48;1.61
95194;141702;Szkoła Podstawowa nr 8|Otwock, Wólka Mlądzka|ul. Stefana Żeromskiego 235 |05-400 Otwock;1311;866;866;10;856;66.06;1.15
95195;141702;Szkoła Podstawowa nr 9|Otwock, Jabłonna|ul. Gabriela Narutowicza 275 |05-400 Otwock;1163;713;713;15;698;61.31;2.10
95196;141702;Klub Otwockiej Spółdzielni Mieszkaniowej "Grota"|Otwock|ul. Grota Roweckiego 2 |05-480 Karczew;1096;693;694;12;681;63.23;1.73
95197;141702;Powiatowe Centrum Zdrowia Sp.z o.o.|Otwock|Batorego 44 |05-400 Otwock;44;34;34;2;32;77.27;5.88
95198;141702;Samodzielny Publiczny Szpital Kliniczny im. prof. A. Grucy|Otwock|Konarskiego 13 |05-400 Otwock;157;127;127;2;125;80.89;1.57
95199;141702;Samodzielny Publiczny Zakład Opieki Zdrowotnej, Szpital Specjalistyczny Ministerstwa Spraw Wewnętrznych|Otwock|Prusa 1/3 |05-400 Otwock;139;92;92;2;90;66.19;2.17
95200;141702;Mazowieckie Centrum Leczenia Chorób Płuc i Gruźlicy|Otwock|Reymonta 83/91 |05-400 Otwock;369;91;91;4;87;24.66;4.40
95201;141703;Klub Wiejski w Pogorzeli|Pogorzel|ul. Leśna 2 |05-430 Celestynów;571;341;341;10;331;59.72;2.93
95202;141703;Szkoła Podstawowa w Starej Wsi|Stara Wieś|ul. Fabryczna 6 |05-430 Celestynów;1255;795;795;25;770;63.35;3.14
95203;141703;Szkoła Podstawowa w Ostrowie|Ostrów| 15 |05-430 Celestynów;1012;497;497;22;475;49.11;4.43
95204;141703;Szkoła Podstawowa w Celestynowie|Celestynów|ul. Wrzosowa 42 |05-430 Celestynów;1991;1278;1278;33;1245;64.19;2.58
95205;141703;Zespół Szkół w Celestynowie|Celestynów|ul. Świętego Kazimierza 55 |05-430 Celestynów;2000;1310;1310;32;1278;65.50;2.44
95206;141703;Szkoła Podstawowa w Regucie|Regut|ul. Wiatraczna 13 |05-430 Celestynów;480;255;255;13;242;53.12;5.10
95207;141703;"Mała Szkoła" - Szkoła Podstawowa w Podbieli|Podbiel| 87 |05-430 Celestynów;525;310;310;11;299;59.05;3.55
95208;141703;Remiza OSP w Zabieżkach|Zabieżki|ul. Prymasa Stefana Wyszyńskiego 3 |05-430 Celestynów;618;405;405;11;394;65.53;2.72
95209;141703;Remiza OSP w Dąbrówce|Dąbrówka|ul. Strażacka 5 |05-430 Celestynów;795;482;482;13;469;60.63;2.70
95210;141704;Centrum Kultury|Karczew|ul. Widok 2 |05-480 Karczew;2306;1406;1406;21;1385;60.97;1.49
95211;141704;Szkoła Podstawowa Nr 2|Karczew|ul. Otwocka 13 |05-480 Karczew;1595;1009;1009;22;987;63.26;2.18
95212;141704;Gminne Przedszkole Nr 2|Karczew|ul. Mariana Buczka 13 |05-480 Karczew;1406;898;898;16;882;63.87;1.78
95213;141704;Gminne Przedszkole Nr 3|Karczew|ul. Ks. Bp. Władysława Miziołka 52 |05-480 Karczew;1667;1032;1032;6;1026;61.91;0.58
95214;141704;Gminne Przedszkole Nr 3|Karczew|ul. Ks. Bp. Władysława Miziołka 52 |05-480 Karczew;1077;707;707;17;690;65.65;2.40
95215;141704;Szkoła Podstawowa|Glinki| 50 |05-480 Karczew;856;421;421;13;408;49.18;3.09
95216;141704;Zespół Szkolno-Przedszkolny|Sobiekursk| 36 |05-480 Karczew;2047;1029;1029;30;999;50.27;2.92
95217;141704;Zespół Szkolno-Przedszkolny|Otwock Wielki|ul. Zamkowa 4 |05-480 Karczew;1764;894;894;33;861;50.68;3.69
95218;141705;Urząd Gminy w Kołbieli|Kołbiel|ul. Szkolna 1 |05-340 Kołbiel;1537;860;860;21;839;55.95;2.44
95219;141705;Szkoła Podstawowa w Rudzienku|Rudzienko|ul. Szkolna 11 |05-340 Kołbiel;1070;503;503;22;481;47.01;4.37
95220;141705;Świetlica w Sępochowie|Sępochów| 51 |05-340 Kołbiel;536;243;243;8;235;45.34;3.29
95221;141705;Szkoła Podstwowa w Człekówce|Człekówka| 62 |05-340 Kołbiel;973;564;564;14;550;57.97;2.48
95222;141705;Szkoła Podstawowa w Kątach|Kąty|ul. Królewska 58 |05-340 Kołbiel;823;434;434;8;426;52.73;1.84
95223;141705;Świetlica w Sufczynie|Sufczyn| 23 |05-340 Kołbiel;906;467;467;17;450;51.55;3.64
95224;141705;Szkoła Podstawowa w Kołbieli|Kołbiel|Szkolna 5 |05-340 Kołbiel;672;346;346;9;337;51.49;2.60
95225;141706;Szkoła Podstawowa w Osiecku|Osieck|ul.Warszawska 61 |08-445 Osieck;712;379;379;6;373;53.23;1.58
95226;141706;Filia Gminnej Biblioteki Publicznej w Natolinie|Natolin| 40 |08-445 Osieck;395;197;197;11;186;49.87;5.58
95227;141706;Szkoła Podstawowa w Augustówce|Augustówka|ul. Kolejowa 2 |08-445 Osieck;755;435;435;13;422;57.62;2.99
95228;141706;Gimnazjum w Osiecku|Osieck|Warszawska 61 |08-445 Osieck;1012;532;534;9;523;52.57;1.69
95229;141707;Publiczna Szkoła Postawowa w Sobieniach-Jeziorach|Sobienie-Jeziory|Garwolińska 14 |08-443 Sobienie-Jeziory;1176;636;638;27;609;54.08;4.25
95230;141707;Świetlica Wiejska w Sobieniach-Jeziorach|Sobienie-Jeziory|Duży Rynek 25 |08-443 Sobienie-Jeziory;1069;555;555;9;546;51.92;1.62
95231;141707;Publiczna Szkoła Podstawowa w Siedzowie|Siedzów| 30A |08-443 Sobienie-Jeziory;635;252;252;2;250;39.69;0.79
95232;141707;Puliczna Szkoła Podstawowa w Starym Zambrzykowie|Stary Zambrzyków| 59 |08-443 Sobienie-Jeziory;705;327;327;4;323;46.38;1.22
95233;141707;Publiczna Szkoła Podstawowa w Warszawicach|Warszawice| 13 |08-443 Sobienie-Jeziory;1562;864;864;9;855;55.31;1.04
95234;141708;Zespół Szkolno-Gimnazjalny w Zakręcie|Zakręt|ul. Szkolna 11 |05-077 Warszawa-Wesoła;1195;771;771;17;754;64.52;2.20
95235;141708;Świetlica w Duchnowie|Duchnów|ul. Wspólna 157 |05-462 Wiązowna;699;396;396;4;392;56.65;1.01
95236;141708;Zespół Szkolno-Gimnazjalny w Wiązownie|Wiązowna|ul. Kościelna 20 |05-462 Wiązowna;1466;956;956;20;936;65.21;2.09
95237;141708;Gminny Ośrodek Kultury w Wiązownie|Wiązowna|ul. Kościelna 41 |05-462 Wiązowna;931;683;683;18;665;73.36;2.64
95238;141708;Przedszkole w Pęclinie|Pęclin|Radosna 74 |05-462 Wiązowna;563;260;260;12;248;46.18;4.62
95239;141708;Szkoła Podstawowa w Gliniance|Glinianka|ul. Napoleońska 1 |05-408 Glinianka;851;513;513;16;497;60.28;3.12
95240;141708;Gimnazjum w Gliniance|Glinianka|ul. Napoleońska 53A |05-408 Glinianka;1252;730;730;21;709;58.31;2.88
95241;141708;Zespół Szkolno-Gimnazjalny w Wiązownie|Wiązowna|Kościelna 20 |05-462 Wiązowna;1655;1026;1026;25;1001;61.99;2.44
95242;141708;Szkoła Podstawowa w Malcanowie|Malcanów|Mazowiecka 55 |05-462 Wiązowna;659;444;444;14;430;67.37;3.15
95243;141801;Szkoła Podstawowa w Czersku|Czersk|Warszawska 17 |05-530 Góra Kalwaria;803;460;460;5;455;57.29;1.09
95244;141801;Zespół Szkół w Coniewie|Coniew| 30 |05-530 Góra Kalwaria;1107;445;445;10;435;40.20;2.25
95245;141801;Szkoła Podstawowa w Czaplinku|Czaplinek|Szkolna 5 |05-530 Góra Kalwaria;1058;483;483;19;464;45.65;3.93
95246;141801;Szkoła Podstawowa w Czachówku|Czachówek|Główna 56 |05-530 Góra Kalwaria;969;531;531;17;514;54.80;3.20
95247;141801;Gimnazjum w Cendrowicach|Cendrowice|Szkolna 4 |05-530 Góra Kalwaria;1018;518;518;17;501;50.88;3.28
95248;141801;Szkoła Podstawowa w Dobieszu|Dobiesz|Wolska 36 |05-530 Góra Kalwaria;770;425;425;13;412;55.19;3.06
95249;141801;Zespół Szkół w Baniosze|Baniocha|Szkolna 1 |05-532 Baniocha;1054;589;589;17;572;55.88;2.89
95250;141801;Szkoła Podstawowa w Baniosze|Baniocha|Szkolna 1 |05-532 Baniocha;1805;952;952;27;925;52.74;2.84
95251;141801;Szkoła Podstawowa w Kątach|Kąty|Puławska 4 |05-532 Baniocha;1444;839;839;28;811;58.10;3.34
95252;141801;Zespół Szkół w Brześcach|Brześce|Wilanowska 55 |05-520 Konstancin Jeziorna;1309;645;645;22;623;49.27;3.41
95253;141801;Samorządowe Przedszkole nr 1 w Górze Kalwarii|Góra Kalwaria|Księdza Zygmunta Sajny 18 |05-530 Góra Kalwaria;1625;928;928;25;903;57.11;2.69
95254;141801;Świetlica Spółdzielni Mieszkaniowej w Górze Kalwarii|Góra Kalwaria|Kard.Stefana Wyszyńskiego 3bl.1 |05-530 Góra Kalwaria;1321;727;727;25;702;55.03;3.44
95255;141801;Zespół Szkół Ogólnokształcących w Górze Kalwarii|Góra Kalwaria|Księdza Zygmunta Sajny 16 |05-530 Góra Kalwaria;1136;608;608;17;591;53.52;2.80
95256;141801;Przedszkole Integracyjne w Górze Kalwarii|Góra Kalwaria|Dominikańska 6a |05-530 Góra Kalwaria;1939;1076;1076;16;1060;55.49;1.49
95257;141801;Szkoła Podstawowa nr 2 w Górze Kalwarii|Góra Kalwaria|Kalwaryjska 3 |05-530 Góra Kalwaria;942;560;560;12;548;59.45;2.14
95258;141801;Zespół Szkół Zawodowych w Górze Kalwarii|Góra Kalwaria|Budowlanych 14 |05-530 Góra Kalwaria;1785;1042;1042;18;1024;58.38;1.73
95259;141801;Dom Pomocy Społecznej|Góra Kalwaria|Szpitalna 1 |05-530 Góra Kalwaria;439;81;81;13;68;18.45;16.05
95260;141802;Budynek Ochotniczej Straży Pożarnej|Konstancin-Jeziorna|ul.K.Pułaskiego 72 |05-510 Konstancin-Jeziorna;1520;1003;1003;9;994;65.99;0.90
95261;141802;Zespół Szkół Integracyjnych Nr 5|Konstancin-Jeziorna|ul.Szkolna 7 |05-520 Konstancin-Jeziorna;1658;1018;1018;11;1007;61.40;1.08
95262;141802;Zespół Szkół Nr 3|Konstancin-Jeziorna|ul. Bielawska 57 |05-520 Konstancin-Jeziorna;2295;1394;1394;20;1374;60.74;1.43
95263;141802;Konstanciński Dom Kultury|Konstancin-Jeziorna|ul.M.Jaworskiego 18 |05-520 Konstancin-Jeziornna;1739;1028;1028;20;1008;59.11;1.95
95264;141802;Lokal firmy „TIMED”|Konstancin-Jeziorna|ul. Wilanowska 1A |05-520 Konstancin-Jeziorna;1352;877;877;7;870;64.87;0.80
95265;141802;Spółdzielnia Mieszkaniowa Lokatorsko-Własnościowa|Konstancin-Jeziorna|ul. J. Sobieskiego 6 |05-510 Konstancin-Jeziorna;1441;907;907;13;894;62.94;1.43
95266;141802;Zespół Szkół Nr 2|Konstancin-Jeziorna|ul. S. Żeromskiego 15 |05-510 Konstancin-Jeziorna;1328;916;916;18;898;68.98;1.97
95267;141802;Zespół Szkół Nr 1|Konstancin-Jeziorna|ul. Wojewódzka 12 |05-510 Konstancin-Jeziorna;1596;957;957;12;945;59.96;1.25
95268;141802;Mazowieckie Centrum Rehabilitacji "STOCER" Sp. z o.o.|Konstancin-Jeziorna|ul. Długa 40/42 |05-510 Konstancin-Jeziorna;789;564;564;4;560;71.48;0.71
95269;141802;Dom Ludowy w Bielawie|Bielawa|ul. Wspólna 1/3 |05-520 Konstancin-Jeziorna;1263;834;834;7;827;66.03;0.84
95270;141802;Szkoła Podstawowa Nr 6 w Opaczy|Opacz| 6 |05-520 Konstancin-Jeziorna;1622;887;887;29;858;54.69;3.27
95271;141802;Gminne Przedszkole w Oborach|OBORY| 1 |05-520 Konstancin-Jeziorna;0;0;0;0;0;-99;-99
95272;141802;Zespół Szkół Nr 4 w Słomczynie|Słomczyn|ul. Wilanowska 218 |05-520 Konstancin-Jeziorna;1585;869;869;16;853;54.83;1.84
95273;141802;Ośrodek Pomocy Społecznej|Konstancin-Jeziorna|ul. Rycerska 13 |05-510 Konstancin-Jeziorna;578;418;418;4;414;72.32;0.96
95274;141802;LUX MED „TABITA”|Konstancin-Jeziorna|Długa 43 |05-510 ;163;86;86;4;82;52.76;4.65
95275;141802;Dom Pomocy Społecznej|Konstancin-Jeziorna|Potulickich 1 |05-510 ;30;17;17;3;14;56.67;17.65
95276;141802;Dom Rencisty Polskiej Akademii Nauk|Konstancin-Jeziorna|Chodkiewicza 3/5 |05-510 ;46;31;31;2;29;67.39;6.45
95277;141802;Centrum Kompleksowej Rehabilitacji|Konstancin-Jeziorna|Gąsiorowskiego 12/14 |05-510 ;180;164;164;7;157;91.11;4.27
95278;141802;Dom Artystów Weteranów Scen Polskich|Konstancin-Jeziorna|Pułaskiego 6 |05-510 ;62;40;40;1;39;64.52;2.50
95279;141802;Mazowieckie Centrum Rehabilitacji „STOCER” Sp. z o.o.|Konstancin-Jeziorna|Wierzejewskiego 12 |05-510 ;166;55;55;0;55;33.13;0.00
95280;141802;Dom Seniora „Willa Kalina”|Konstancin-Jeziorna|Fabryczna 3 |05-520 ;30;30;30;13;17;100.00;43.33
95281;141803;Zespół Szkół Publicznych holl|Mroków|ul.M.Świątkiewicz 2a |05-552 Magdalenka;1349;794;794;19;775;58.86;2.39
95282;141803;ZESPÓŁ SZKÓŁ PUBLICZNYCH Sala gimnastyczna|Mroków|ul. M. ŚWIĄTKIEWICZ 2A |05-552 MAGDALENKA;1270;716;716;12;704;56.38;1.68
95283;141803;ZESPÓŁ SZKÓŁ PUBLICZNYCH Sala gimnastyczna|Łazy|ul. Ks. Słojewskiego 1 |05-552 Magdalenka;1541;1019;1019;9;1010;66.13;0.88
95284;141803;Zespół Szkół|Łazy|ul. Ks.Słojewskiego 1 |05-552 Magdalenka;555;286;286;10;276;51.53;3.50
95285;141803;Centrum Integracji Społecznej|Magdalenka|ul. Lipowa 28 |05-506 Lesznowola;1015;790;790;6;784;77.83;0.76
95286;141803;Świetlica|Władysławów|ul.Wojska Polskiego 64 |05-506 Lesznowola;1388;965;965;6;959;69.52;0.62
95287;141803;Urząd Gminy|Lesznowola|ul. GRN 60 |05-506 Lesznowola;1174;770;770;14;756;65.59;1.82
95288;141803;budynek komunalny przy OSP|Nowa Wola|ul. Krasickiego 215 |05-500 Piaseczno;1134;779;779;8;771;68.69;1.03
95289;141803;Świetlica GOK|Stara Iwiczna|ul. Nowa 6 |05-500 Piaseczno;904;586;586;8;578;64.82;1.37
95290;141803;Zespół Szkół Publicznych Holl|Nowa Iwiczna|ul.Krasickiego 56 |05-515 Mysiadło;1424;1084;1084;12;1072;76.12;1.11
95291;141803;Zespół Szkół Publicznych Sala Gimnastyczna|Nowa Iwiczna|ul.I.Krasickiego 56 |05-515 Mysiadło;1378;1052;1052;7;1045;76.34;0.67
95292;141803;Świetlica|Zgorzała|ul.Postepu 99A |05-515 Mysiadło;946;687;687;11;676;72.62;1.60
95293;141803;Szkoła Podstawowa w Mysiadle|Mysiadło|ul.Kwiatowa 28 |05-500 Mysiadło;1546;1148;1150;5;1143;74.26;0.44
95294;141803;Filia Gminnego Ośrodka Ośrodka Kultury Mysiadło|Mysiadło|ul.Topolowa 2 106 (budynek MYSZKA)|05-500 Mysiadło;1198;731;731;12;719;61.02;1.64
95295;141804;Gimnazjum nr 1|Piaseczno|ul.Sikorskiego 20 |05-500 Piaseczno;1042;646;646;10;636;62.00;1.55
95296;141804;Gimnazjum nr 1|Piaseczno|ul.Sikorskiego 20 |05-500 Piaseczno;899;531;531;9;522;59.07;1.69
95297;141804;Gimnazjum Nr 1|Piaseczno|ul. Sikorskiego 20 |05-500 Piaseczno;1349;851;851;10;841;63.08;1.18
95298;141804;Gimnazjum Nr 1|Piaseczno|ul. Sikorskiego 20 |05-500 Piaseczno;1573;983;983;6;977;62.49;0.61
95299;141804;Gimnazjum nr 1|Piaseczno|ul.Sikorskiego 20 |05-500 Piaseczno;1576;1037;1037;24;1013;65.80;2.31
95300;141804;Szkoła Podstawowa nr 5|Piaseczno|ul.Szkolna 14 |05-500 Piaseczno;2138;1242;1242;24;1218;58.09;1.93
95301;141804;Szkoła Podstawowa nr 5|Piaseczno|ul.Szkolna 14 |05-500 Piaseczno;1208;727;727;11;716;60.18;1.51
95302;141804;Przedszkole nr 4|Piaseczno|ul.Fabryczna 13 |05-500 Piaseczno;1351;873;873;9;864;64.62;1.03
95303;141804;Przedszkole nr 4|Piaseczno|ul. Fabryczna 13 |05-500 Piaseczno;1829;1235;1235;12;1223;67.52;0.97
95304;141804;Przedszkole nr 4|Piaseczno|ul.Fabryczna 13 |05-500 Piaseczno;1718;1192;1192;1;1191;69.38;0.08
95305;141804;Przedszkole nr 11|Piaseczno|ul. Nefrytowa 14 |05-500 Piaseczno;1390;735;735;10;725;52.88;1.36
95306;141804;Przedszkole nr 11|Piaseczno|ul. Nefrytowa 14 |05-500 Piaseczno;1750;1371;1371;4;1367;78.34;0.29
95307;141804;Liceum Ogólnokształcące|Piaseczno|ul.Chyliczkowska 17 |05-500 Piaseczno;972;678;678;5;673;69.75;0.74
95308;141804;Liceum Ogólnokształcące|Piaseczno|ul.Chyliczkowska 17 |05-500 Piaseczno;1278;832;832;6;826;65.10;0.72
95309;141804;Liceum Ogólnokształcące|Piaseczno|ul.Chyliczkowska 17 |05-500 Piaseczno;1164;858;858;7;851;73.71;0.82
95310;141804;Liceum Ogólnokształcące|Piaseczno|ul.Chyliczkowska 17 |05-500 Piaseczno;1146;735;736;11;724;64.14;1.50
95311;141804;Centrum Kultury|Piaseczno|ul.Kościuszki 49 |05-500 Piaseczno;1867;1233;1233;9;1224;66.04;0.73
95312;141804;Szkoła Podstawowa nr 1|Piaseczno|ul.Świętojańska 18 |05-500 Piaseczno;1773;1146;1146;21;1125;64.64;1.83
95313;141804;Publiczne Przedszkole Radosne|Piaseczno|ul.Orężna 8a |05-500 Piaseczno;1091;746;746;18;728;68.38;2.41
95314;141804;Szkoła Podstawowa nr 2|Piaseczno|Aleja Kasztanów 12 |05-501 Piaseczno;1210;771;771;11;760;63.72;1.43
95315;141804;Szkoła Podstawowa nr 2|Piaseczno|Aleja Kasztanów 12 |05-501 Piaseczno;1260;872;872;11;861;69.21;1.26
95316;141804;Szkoła Podstawowa nr 2|Piaseczno|Aleja Kasztanów 12 |05-501 Piaseczno;1249;817;817;5;812;65.41;0.61
95317;141804;Zespół Szkół Publicznych|Piaseczno|Główna 50 |05-502 Piaseczno;1161;763;763;11;752;65.72;1.44
95318;141804;Zespół Szkół Publicznych|Piaseczno|ul.Główna 50 |05-502 Piaseczno;1004;658;658;6;652;65.54;0.91
95319;141804;Zespół Szkół Publicznych|Józefosław|ul.Kameralna 11 |05-500 Piaseczno;1654;1182;1182;10;1172;71.46;0.85
95320;141804;Zespół Szkół Publicznych|Józefosław|ul. Kameralna 11 |05-500 Piaseczno;1349;1059;1059;4;1055;78.50;0.38
95321;141804;Zespół Szkół Publicznych|Józefosław|ul.Kameralna 11 |05-500 Piaseczno;837;674;674;5;669;80.53;0.74
95322;141804;Zespół Szkół Publicznych|Józefosław|ul.Kameralna 11 |05-500 Piaseczno;1834;1333;1334;6;1327;72.68;0.45
95323;141804;Zespół Szkół Publicznych|Józefosław|ul.Kameralna 11 |05-500 Piaseczno;978;622;622;5;617;63.60;0.80
95324;141804;Zespół Szkół Publicznych|Chylice|ul.Dworska 2 |05-510 Konstancin-Jeziorna;1475;1049;1049;8;1041;71.12;0.76
95325;141804;Instytut Rybactwa Śródlądowego|Żabieniec|ul.Główna 48 |05-500 Piaseczno;1700;1019;1019;19;1000;59.94;1.86
95326;141804;Świetlica OSP Chojnów|Orzeszyn|ul.Klonowa 16 |05-532 Baniocha;625;408;408;8;400;65.28;1.96
95327;141804;Zespół Szkół Publicznych|Zalesie Górne|ul.Sarenki 20 |05-540 Zalesie Górne;1238;880;880;15;865;71.08;1.70
95328;141804;Zespół Szkół Publicznych|Zalesie Górne|ul.Sarenki 20 |05-540 Zalesie Górne;1421;1002;1005;17;985;70.51;1.70
95329;141804;Zespł Szkół Publicznych|Jazgarzew|ul.Szkolna 10 |05-502 Piaseczno;1356;892;892;11;881;65.78;1.23
95330;141804;Zespół Szkół Publicznych|Jazgarzew|ul.Szkolna 10 |05-502 Piaseczno;806;464;464;7;457;57.57;1.51
95331;141804;Zespół Szkół Publicznych|Piaseczno|ul.Główna 50 |05-502 Piaseczno;836;633;633;13;620;75.72;2.05
95332;141804;Zespół Szkół Publicznych|Piaseczno|ul.Główna 50 |05-502 Piaseczno;1394;911;911;12;899;65.35;1.32
95333;141804;Szkoła Podstawowa|Głosków|ul.Millenium 76 |05-503 Głosków;1911;1256;1256;14;1242;65.72;1.11
95334;141804;Świetlica|Wola Gołkowska|ul.Gościniec 35 |05-502 Piaseczno;847;538;538;15;523;63.52;2.79
95335;141804;Zespół Szkół Publicznych|Złotokłos|ul.Traugutta 10 |05-504 Złotokłos;388;160;160;11;149;41.24;6.88
95336;141804;Szkoła Podstawowa|Głosków|ul.Millenium 76 |05-503 Głosków;495;298;298;8;290;60.20;2.68
95337;141804;Zespół Szkół Publicznych|Złotokłos|ul.Traugutta 10 |05-504 Złotokłos;1564;975;975;10;965;62.34;1.03
95338;141804;Świetlica OSP|Bogatki|ul.Królewska 91 |05-502 Piaseczno;680;381;381;11;370;56.03;2.89
95339;141804;Szpital Świętej Anny|Piaseczno|Mickiewicza 39 |05-500 Piaseczno;64;19;19;2;17;29.69;10.53
95340;141805;Szkoła Podstawowa|Uwieliny|Szkolna 2 |05-540 Zalesie Górne;1531;812;812;30;782;53.04;3.69
95341;141805;Urząd Gminy|Prażmów|Piotra Czołchańskiego 1 |05-505 Prażmów;1451;771;771;17;754;53.14;2.20
95342;141805;Ochotnicza Straż Pożarna|Wągrodno|Słoneczna 2 |05-505 Prażmów;1377;715;715;26;689;51.92;3.64
95343;141805;Ochotnicza Straż Pożarna|Jeziórko|Kościelna 3 |05-540 Zalesie Górne;1809;1064;1064;18;1046;58.82;1.69
95344;141805;Publiczne Gimnazjum|Prażmów|Franciszka Ryxa 72 |05-505 Prażmów;1225;764;764;19;745;62.37;2.49
95345;141805;Publiczne Gimnazjum|Uwieliny|ul. Szkolna 2A |05-540 Zalesie Górne;648;319;319;13;306;49.23;4.08
95346;141806;Szkoła Podstawowa w Suchostrudze|Suchostruga|ul. Szkolna 20 |05-555 Tarczyn;482;238;238;7;231;49.38;2.94
95347;141806;Świetlica OSP w Suchodole|Suchodół|ul. Piękna 20 |05-555 Tarczyn;519;255;255;10;245;49.13;3.92
95348;141806;Świetlica Wiejska w Woli Przypkowskiej|Wola Przypkowska|ul. Piękna 33 |05-555 Tarczyn;715;425;425;9;416;59.44;2.12
95349;141806;Świetlica Wiejska w Kotorydzu|Kotorydz|ul. Tarczyńska 50 |05-555 Tarczyn;698;378;378;14;364;54.15;3.70
95350;141806;Przedszkole w Tarczynie|Tarczyn|ul. Kazimierza Dobrowolskiego 3 |05-555 Tarczyn;914;489;489;16;473;53.50;3.27
95351;141806;Zespół Szkół Ponadgimnazjalnych w Tarczynie|Tarczyn|ul. Księdza Czesława Oszkiela 3 |05-555 Tarczyn;1790;985;985;28;957;55.03;2.84
95352;141806;Szkoła Podstawowa w Tarczynie|Tarczyn|ul. Juliana Stępkowskiego 15 |05-555 Tarczyn;1264;748;748;25;723;59.18;3.34
95353;141806;Szkoła Podstawowa w Pamiątce|Kopana, Pamiątka|ul. Anieli i Wojciecha Górskich 3 |05-555 Tarczyn;1596;747;747;16;731;46.80;2.14
95354;141806;Szkoła Podstawowa w Pracach Małych|Prace Małe|ul. Dorzeczna 3 |05-555 Tarczyn;868;549;549;6;543;63.25;1.09
95355;141901;Zespół Szkół Nr 2|Ciachcin Nowy| 54 |09-230 Bielsk;1356;559;559;30;529;41.22;5.37
95356;141901;Szkoła Podstawowa|Bielsk|ul. Drobińska 19 |09-230 Bielsk;2112;1204;1204;48;1156;57.01;3.99
95357;141901;Szkoła Podstawowa|Bielsk|ul. Drobińska 19 |09-230 Bielsk;992;397;397;24;373;40.02;6.05
95358;141901;Budynek po Szkole Podstawowej|Śmiłowo| 23 |09-230 Bielsk;389;153;153;7;146;39.33;4.58
95359;141901;Zespół Szkół Nr 3|Zagroba| 40 |09-230 Bielsk;824;330;330;20;310;40.05;6.06
95360;141901;Zespół Szkół Nr 4|Zągoty| 11 |09-230 Bielsk;1416;595;595;38;557;42.02;6.39
95361;141901;Dom Pomocy Społecznej|Goślice| 66 |09-230 Bielsk;83;25;25;0;25;30.12;0.00
95362;141902;Zespół Placówek Oświatowych|Bodzanów|ul. Wyszogrodzka 1 |09-470 Bodzanów;1008;467;467;23;444;46.33;4.93
95363;141902;Urząd Gminy|Bodzanów|ul. Bankowa 7 |09-470 Bodzanów;659;214;214;8;206;32.47;3.74
95364;141902;Publiczne Gimnazjum|Bodzanów|ul. Wyszogrodzka 3 |09-470 Bodzanów;993;427;427;18;409;43.00;4.22
95365;141902;Publiczna Szkoła Podstawowa|Cieśle| 18 |09-470 Bodzanów;400;174;174;4;170;43.50;2.30
95366;141902;Publiczne Gimnazjum|Nowe Miszewo|ul. Szkolna 2a |09-470 Bodzanów;1299;581;581;21;560;44.73;3.61
95367;141902;Zespół Placówek Oświatowych|Nowe Miszewo|ul. Szkolna 2 |09-470 Bodzanów;1000;490;490;24;466;49.00;4.90
95368;141902;Niepubliczna Szkoła Podstawowa|Nowe Kanigowo| 17 |09-470 Bodzanów;665;250;250;10;240;37.59;4.00
95369;141902;Budynek po byłej Szkole Podstawowej|Łętowo| 12 |09-470 Bodzanów;572;230;230;14;216;40.21;6.09
95370;141902;Dom Pomocy Społecznej|Nowe Miszewo|ul. Pałacowa 2 |09-470 Bodzanów;136;103;103;7;96;75.74;6.80
95371;141903;Remiza Ochotniczej Straży Pożarnej w Turzy Małej|Turza Mała| 16 |09-414 Brudzeń Duży;438;168;168;4;164;38.36;2.38
95372;141903;Gimnazjum w Brudzeniu Dużym|Brudzeń Duży|ul. Szkolna 15 |09-414 Brudzeń Duży;801;320;320;9;311;39.95;2.81
95373;141903;Gimnazjum w Brudzeniu Dużym|Brudzeń Duży| ul.Szkolna 15 |09-414 Brudzeń Duży;862;445;445;15;430;51.62;3.37
95374;141903;Szkoła Podstawowa w Sikorzu|Sikórz| 85 |09-411 Biała k.Płocka;836;344;344;9;335;41.15;2.62
95375;141903;Szkoła Podstawowa w Sikorzu|Sikórz| 85 |09-411 Biała k/Płocka;777;347;347;17;330;44.66;4.90
95376;141903;Szkoła Podstawowa w Siecieniu|Siecień| 84 |09-411 Biała k. Płocka;621;242;242;16;226;38.97;6.61
95377;141903;Szkoła Podstawowa w Siecieniu|Siecień| 84 |09-411 Biała k. Płocka;869;452;452;21;431;52.01;4.65
95378;141903;Remiza Ochotniczej Straży Pożarnej w Sobowie|Sobowo| 36 |09-414 Brudzeń Duży;853;314;314;11;303;36.81;3.50
95379;141903;Budynek po Szkole Podstawowej w Myśliborzycach|Myśliborzyce| 26 |09-414 Brudzeń Duży;426;127;127;6;121;29.81;4.72
95380;141904;Urząd Gminy|Bulkowo-Kolonia|ul. Szkolna 1 |09-454 Bulkowo;779;366;366;18;348;46.98;4.92
95381;141904;Zespół Szkół Ogólnokształcących w Bulkowie|Bulkowo-Kolonia|Szkolna 2 |09-454 Bulkowo;804;262;262;18;244;32.59;6.87
95382;141904;Budynek byłej Szkoły Podstawowej|Nadułki| 44A |09-454 Bulkowo;692;258;258;10;248;37.28;3.88
95383;141904;Szkoła Podstawowa|Nowe Łubki| 7 |09-454 Bulkowo;692;300;300;21;279;43.35;7.00
95384;141904;Zespół Szkół Ogólnokształcących|Blichowo| 61A |09-454 Bulkowo;1047;456;456;23;433;43.55;5.04
95385;141904;Budynek byłej Szkoły Podstawowej|Worowice| 57A |09-454 Bulkowo;618;206;206;12;194;33.33;5.83
95386;141905;Zespół Szkół w Drobinie|Drobin|ul. Szkolna 3 |09-210 Drobin;1063;466;466;25;441;43.84;5.36
95387;141905;Miejsko-Gminne Przedszkole w Drobinie|Drobin|ul. Przyszłość 14 |09-210 Drobin;1329;497;498;40;457;37.40;8.05
95388;141905;Szkoła Podstawowa im. Miry Zimińskiej-Sygietyńskiej w Cieszewie|Cieszewo| 14 |09-210 Drobin;352;136;136;9;127;38.64;6.62
95389;141905;Szkoła Podstawowa w Rogotwórsku|Rogotwórsk| 4 |09-210 Drobin;721;236;236;13;223;32.73;5.51
95390;141905;Zespół Szkół w Drobinie|Drobin|ul. Szkolna 3 |09-210 Drobin;1197;511;511;26;485;42.69;5.09
95391;141905;Zespół Szkół w Łęgu Probostwie|Łęg Probostwo| 31/1 |09-210 Drobin;1767;641;641;37;604;36.28;5.77
95392;141906;Szkoła Podstawowa|Gąbin|ul. Aleja Jana Pawła II 16 |09-530 Gąbin;1388;674;674;25;649;48.56;3.71
95393;141906;Świetlica Ochotniczej Straży Pożarnej w Gąbinie|Gąbin|ul. Stary Rynek 15 |09-530 Gąbin;1075;548;548;23;525;50.98;4.20
95394;141906;Świetlica Ochotniczej Straży Pożarnej w Gąbinie|Gąbin|ul. Aleja Jana Pawła II 2 |09-530 Gąbin;969;510;510;12;498;52.63;2.35
95395;141906;Szkoła Podstawowa|Dobrzyków|Obrońców Dobrzykowa 65 |09-530 Gąbin;1679;868;868;33;835;51.70;3.80
95396;141906;Szkoła Podstawowa|Borki| 22B |09-530 Gąbin;528;277;277;16;261;52.46;5.78
95397;141906;Szkoła Podstawowa|Nowe Grabie| 11A |09-530 Gąbin;796;377;377;9;368;47.36;2.39
95398;141906;Szkoła Podstawowa|Czermno| 52 |09-530 Gąbin;1101;462;462;20;442;41.96;4.33
95399;141906;Dom Ludowy|Topólno| 49 |09-530 Gąbin;394;146;146;12;134;37.06;8.22
95400;141906;Szkoła Podstawowa|Nowy Kamień| 6 |09-530 Gąbin;578;247;247;12;235;42.73;4.86
95401;141906;Dom Pomocy Społecznej|Koszelew| 2 |09-530 Gąbin;529;193;193;13;180;36.48;6.74
95402;141907;Hala Sportowa|Łąck|ul. Gostynińska 2 |09-520 Łąck;1196;575;575;42;533;48.08;7.30
95403;141907;Gminny Ośrodek Kultury|Łąck|ul. Warszawska 39 |09-520 Łąck;918;469;469;9;460;51.09;1.92
95404;141907;Centrum Kultury Rekreacji i Sportu|Podlasie| 19 |09-520 Łąck;717;317;317;14;303;44.21;4.42
95405;141907;Przedszkole Niepubliczne Promyczek|Zaździerz| 33 |09-520 Łąck;712;362;362;9;353;50.84;2.49
95406;141907;Zielona Szkoła|Sendeń Mały| 2/2 |09-520 Łąck;390;166;166;11;155;42.56;6.63
95407;141907;Gminny Ośrodek Kultury|Grabina| 43 |09-520 Łąck;375;199;199;6;193;53.07;3.02
95408;141908;Szkoła Podstawowa w Podgórzu|Podgórze| 6 |09-460 Mała Wieś;1123;445;445;11;434;39.63;2.47
95409;141908;Gimnazjum w Małej Wsi|Mała Wieś|ul. Jana Kochanowskiego 17 |09-460 Mała Wieś;1024;350;350;18;332;34.18;5.14
95410;141908;Gimnazjum w Małej Wsi|Mała Wieś|ul. Jana Kochanowskiego 17 |09-460 Mała Wieś;1115;498;498;16;482;44.66;3.21
95411;141908;Niepubliczna Szkoła Podstawowa w Orszymowie|Orszymowo| 53 |09-460 Mała Wieś;1001;382;382;20;362;38.16;5.24
95412;141908;Szkoła Podstawowa w Dzierżanowie|Dzierżanowo| 53 |09-460 Mała Wieś;726;240;240;14;226;33.06;5.83
95413;141908;Dom Pomocy Społecznej w Zakrzewie Kościelnym|Zakrzewo Kościelne| |09-460 Mała Wieś;67;37;37;6;31;55.22;16.22
95414;141909;Szkoła Podstawowa|Nowy Duninów|ul. Gostynińska 1 |09-505 Nowy Duninów;899;419;419;29;390;46.61;6.92
95415;141909;Szkoła Podstawowa|Nowy Duninów|ul. Gostynińska 1 |09-505 Nowy Duninów;774;306;306;18;288;39.53;5.88
95416;141909;Szkoła Podstawowa|Lipianki| 28A |09-505 Nowy Duninów;287;114;114;6;108;39.72;5.26
95417;141909;Szkoła Podstawowa|Soczewka|ul. ks. Pawła Kwiatkowskiego 1 |09-506 Soczewka;528;241;241;12;229;45.64;4.98
95418;141909;Szkoła Podstawowa|Soczewka|ul. ks. Pawła Kwiatkowksiego 1 |09-506 Soczewka;758;342;342;18;324;45.12;5.26
95419;141910;Zespół Szkół w Radzanowie|Radzanowo|ul. Szkolna 16 |09-451 Radzanowo;970;540;540;18;522;55.67;3.33
95420;141910;Centrum Kultury i Sportu w Radzanowie|Radzanowo|ul. Szkolna 3 |09-451 Radzanowo;1131;497;497;16;481;43.94;3.22
95421;141910;Remiza Ochotniczej Straży Pożarnej w Woźnikach|Woźniki| 33 |09-451 Radzanowo;487;190;190;10;180;39.01;5.26
95422;141910;Szkoła Podstawowa w Ciółkówku|Ciółkówko| 30B |09-451 Radzanowo;1086;444;444;22;422;40.88;4.95
95423;141910;Przedszkole Niepubliczne "Małolatek" w Stróżewku|Stróżewko| 47/2 |09-410 Płock;1437;738;738;14;724;51.36;1.90
95424;141910;Szkoła Podstawowa im. Cz. Hińca w Rogozinie|Rogozino|ul. Mazowiecka 25 |09-410 Płock;1355;668;668;19;649;49.30;2.84
95425;141911;Szkoła Podstawowa w Świniarach|Wiączemin Polski| 4 |09-533 Słubice;511;191;191;15;176;37.38;7.85
95426;141911;Szkoła Podstawowa w Piotrkówku|Piotrkówek| 75 |09-533 Słubice;644;264;264;8;256;40.99;3.03
95427;141911;Remiza OSP w Juliszewie|Juliszew| 17 |09-533 Słubice;570;255;255;13;242;44.74;5.10
95428;141911;Remiza OSP w Łaziskach|Bończa| 28 |09-533 Słubice;447;177;177;14;163;39.60;7.91
95429;141911;Gminna Biblioteka Publiczna w Słubicach|Słubice|ul. Krakowska 2 |09-533 Słubice;798;402;402;18;384;50.38;4.48
95430;141911;Szkoła Podstawowa w Słubicach|Słubice|ul. Płocka 28 |09-533 Słubice;721;347;347;30;317;48.13;8.65
95431;141912;Świetlica Wiejska w Bielinie|Bielino| 23 |09-410 Płock;808;427;427;8;419;52.85;1.87
95432;141912;Szkoła Podstawowa w Liszynie|Liszyno|ul. Wawrzyńca Sikory 19 |09-410 Płock;589;262;262;14;248;44.48;5.34
95433;141912;Remiza OSP w Mijakowie|Mijakowo| 3 |09-472 Słupno;862;358;358;10;348;41.53;2.79
95434;141912;Świetlica Wiejska w Mirosławiu|Mirosław| 23 |09-472 Słupno;368;147;147;9;138;39.95;6.12
95435;141912;PTHT Izobud Nowe Gulczewo|Nowe Gulczewo|ul.Ketlinga 19 |09-410 Płock;471;338;338;0;338;71.76;0.00
95436;141912;Autoserwis Mazowsze Nowe Gulczewo|Nowe Gulczewo|ul.Skrzetuskiego 11 |09-410 Płock;417;283;283;4;279;67.87;1.41
95437;141912;Gminny Ośrodek Kultury Słupno z/s w Cekanowie|Cekanowo|ul.Królewska 28a |09-472 Słupno;647;453;453;3;450;70.02;0.66
95438;141912;Gminny Ośrodek Pomocy Społecznej w Słupnie|Słupno|ul.Warszawska 26a |09-472 Słupno;738;430;430;6;424;58.27;1.40
95439;141912;Urząd Gminy w Słupnie|Słupno|ul.Miszewska 8a |09-472 Słupno;717;483;483;10;473;67.36;2.07
95440;141913;Zespół Szkół|Maszewo Duże|ul.Szkolna 14 |09-400 Płock;1908;1006;1006;23;983;52.73;2.29
95441;141913;Zespół Szkół|Stare Proboszczewice|ul. Floriańska 4 |09-412 Biała;2062;932;932;29;903;45.20;3.11
95442;141913;Szkoła Podstawowa|Stara Biała| 53 |09-411 Biała;1175;640;640;17;623;54.47;2.66
95443;141913;Świetlica Wiejska|Bronowo-Zalesie| 66A |09-411 Biała;857;361;361;19;342;42.12;5.26
95444;141913;Zespół Szkolno-Przedszkolny|Wyszyna| 2 |09-411 Biała;1052;516;516;23;493;49.05;4.46
95445;141913;Remiza OSP|Maszewo| 20a |09-400 Płock;983;637;637;13;624;64.80;2.04
95446;141913;Szkoła Podstawowa|Stara Biała| 53 |09-411 Biała;713;343;343;16;327;48.11;4.66
95447;141913;Dom Pomocy Społecznej|Brwilno|ul. Płocka 90 |09-400 Płock;76;53;53;1;52;69.74;1.89
95448;141914;Szkoła Podstawowa w Staroźrebach|Staroźreby|ul. Szkolna 7 |09-440 Staroźreby;1256;605;605;24;581;48.17;3.97
95449;141914;Szkoła Podstawowa w Staroźrebach|Staroźreby|ul. Szkolna 7 |09-440 Staroźreby;887;395;395;11;384;44.53;2.78
95450;141914;Szkoła Podstawowa w Nowej Górze|Nowa Góra|ul. Szkolna 6 |09-440 Staroźreby;708;252;252;10;242;35.59;3.97
95451;141914;Szkoła Podstawowa w Nowej Górze|Nowa Góra|ul. Szkolna 6 |09-440 Staroźreby;916;369;369;20;349;40.28;5.42
95452;141914;Szkoła Podstawowa,Smardzewo 4|Smardzewo| 4 |09-440 Staroźreby;362;160;160;15;145;44.20;9.38
95453;141914;Remiza OSP,Sędek 18A|Sędek| 18A |09-440 Staroźreby;337;129;129;11;118;38.28;8.53
95454;141914;Szkoła Podstawowa,Przeciszewo 26|Przeciszewo| 26 |09-440 Staroźreby;317;89;89;0;89;28.08;0.00
95455;141914;Remiza OSP,Zdziar Wielki 3A|Zdziar Wielki| 3A |09-440 Staroźreby;700;222;222;11;211;31.71;4.95
95456;141914;Świetlica Wiejska,Nowa Wieś 7B|Nowa Wieś| 7B |09-440 Staroźreby;417;162;162;13;149;38.85;8.02
95457;141915;Sala Posiedzeń przy Hali Sportowej|Wyszogród|ul. Niepodległości 11 |09-450 Wyszogród;719;373;373;17;356;51.88;4.56
95458;141915;Gimnazjum w Wyszogrodzie|Wyszogród|ul. Niepodległości 11b |09-450 Wyszogród;692;261;262;6;255;37.72;2.30
95459;141915;Hala Sportowa|Wyszogród|ul. Niepodległości 11 |09-450 Wyszogród;764;322;322;11;311;42.15;3.42
95460;141915;Remiza OSP Drwały|Drwały| 20 |09-450 Wyszogród;794;281;281;8;273;35.39;2.85
95461;141915;Szkoła Podstawowa|Rębowo| 41 |09-450 Wyszogród;717;263;263;12;251;36.68;4.56
95462;141915;Szkoła Podstawowa|Kobylniki| 51 |09-450 Wyszogród;979;305;305;10;295;31.15;3.28
95463;141915;Dom Pomocy Społecznej|Wyszogród|ul. Niepodległości 5a |09-450 Wyszogród;23;15;15;2;13;65.22;13.33
95464;142001;Kasa Rolniczego Ubezpieczenia Społecznego Placówka Terenowa|Płońsk|ul. Zajazd 4 |09-100 Płońsk;795;417;417;12;405;52.45;2.88
95465;142001;Przedszkole Nr 1|Płońsk|ul. Kolejowa 5 |09-100 Płońsk;762;422;422;10;412;55.38;2.37
95466;142001;Zespół Szkól Nr 2 im. L. Rutkowskiego|Płońsk|ul. Związku Walki Młodych 10 |09-100 Płońsk;775;382;382;14;368;49.29;3.66
95467;142001;Przedsiębiorstwo Gospodarki Komunalnej Sp. z o.o. w Płońsku|Płońsk|ul. Mickiewicza 4 |09-100 Płońsk;779;427;427;9;418;54.81;2.11
95468;142001;Zakład Gospodarki Mieszkaniowej (Biblioteka Pedagogiczna)|Płońsk|ul. Warszawska 7 |09-100 Płońsk;675;249;249;2;247;36.89;0.80
95469;142001;Gimnazjum Publiczne Nr 2 im. Bolesława Chrobrego|Płońsk|ul. Wolności 4 |09-100 Płońsk;1605;707;707;21;686;44.05;2.97
95470;142001;Zespół Szkół Ogólnokształcących|Płońsk|ul. Płocka 56 |09-100 Płońsk;1674;891;891;13;878;53.23;1.46
95471;142001;Szkoła Podstawowa Nr 2|Płońsk|ul. Bronisławy Bronisława i Władysława Wieczorków 30 |09-100 Płońsk;1605;899;899;24;875;56.01;2.67
95472;142001;Punkt Profilaktyki Uzależnień i Pomocy Rodzinie|Płońsk|ul. Św. Maksymiliana Kolbe 9 |09-100 Płońsk;1951;962;962;14;948;49.31;1.46
95473;142001;Przedszkole nr 2 im. Przyjaciół Kubusia Puchatka|Płońsk|ul. Zacisze 6 |09-100 Płońsk;876;410;410;10;400;46.80;2.44
95474;142001;Spółdzielnia Mieszkaniowa|Płońsk|ul. Ks. R. Jaworskiego 2 |09-100 Płońsk;779;297;297;11;286;38.13;3.70
95475;142001;Szkoła Podstawowa nr 2|Płońsk|ul. Grunwaldzka 67B |09-100 Płońsk;850;358;358;17;341;42.12;4.75
95476;142001;Gimnazjum Nr 1 im. Papieża Jana Pawła II|Płońsk|ul. Ks. Romualda Jaworskiego 25 |09-100 Płońsk;904;494;494;12;482;54.65;2.43
95477;142001;Przedszkole nr 4 "Pod zielonym listkiem"|Płońsk|ul. Padlewskiego 3 |09-100 Płońsk;809;286;286;9;277;35.35;3.15
95478;142001;Zespół Szkół nr 1|Płońsk|ul. Henryka Sienkiewicza 8 |09-100 Płońsk;912;456;456;19;437;50.00;4.17
95479;142001;Towarzystwo Budownictwa Społecznego w Płońsku Sp. z o.o.|Płońsk|ul. Łąkowa 2 |09-100 Płońsk;906;474;474;8;466;52.32;1.69
95480;142001;Miejska Biblioteka Publiczna im. Henryka Sienkiewicza|Płońsk|ul. Północna 15B |09-100 Płońsk;932;492;492;6;486;52.79;1.22
95481;142001;Areszt Śledczy w Płońsku|Płońsk|ul. Warszawska 49 |09-100 Płońsk;110;54;54;8;46;49.09;14.81
95482;142001;Samodzielny Publiczny Zespół Zakładów Opieki Zdrowotnej w Płońsku|Płońsk|ul. Sienkiewicza 7 |09-100 Płońsk;37;7;7;0;7;18.92;0.00
95483;142001;Zakład Opiekuńczo-Leczniczy w Płońsku|Płońsk|ul. Ks. Romualda Jaworskiego 3 |09-100 Płońsk;53;21;21;0;21;39.62;0.00
95484;142002;Miejskie Centrum Kultury Sportu i Rekreacji w Raciążu|Raciąż|ul.Parkowa 14 |09-140 Raciąż;1275;578;578;23;555;45.33;3.98
95485;142002;Ochotnicza Straż Pożarna|Raciąż|ul. Kilińskiego 23 |09-140 Raciąż;1243;515;515;22;493;41.43;4.27
95486;142002;Gminna Spółdzielnia "SCh" w Raciążu|Raciąż|ul. Płocka 33 |09-140 Raciąż;1179;537;537;23;514;45.55;4.28
95487;142003;Hala Sportowa w Baboszewie|Baboszewo|ul. Jana i Antoniego Brodeckich 6A |09-130 Baboszewo;1445;553;553;14;539;38.27;2.53
95488;142003;Urząd Gminy w Baboszewie|Baboszewo|ul. Warszawska 9A |09-130 Baboszewo;1627;770;770;17;753;47.33;2.21
95489;142003;Świetlica Wiejska w Rzewinie|Rzewin| 34 |09-130 Baboszewo;714;225;225;10;215;31.51;4.44
95490;142003;Szkoła Podstawowa w Polesiu|Polesie| 9 |09-105 Dziektarzewo;858;344;344;19;325;40.09;5.52
95491;142003;Szkoła Podstawowa w Sarbiewie|Sarbiewo| 17 |09-130 Baboszewo;984;407;407;19;388;41.36;4.67
95492;142003;Szkoła Podstawowa w Mystkowie|Mystkowo| 52 |09-130 Baboszewo;770;258;258;14;244;33.51;5.43
95493;142004;Gminny Zespół Szkół w Czerwińsku nad Wisłą|Czerwińsk nad Wisłą|ul. Warszawska 1 |09-150 Czerwińsk nad Wisłą;2001;778;778;24;754;38.88;3.08
95494;142004;Szkoła Podstawowa w Nowym Radzikowie|Nowe Radzikowo| 36 |09-151 Czerwińsk nad Wisłą;836;261;261;8;253;31.22;3.07
95495;142004;Szkoła Podstawowa w Goławinie|Goławin| 49C |09-151 Czerwińsk nad Wisłą;1357;365;365;9;356;26.90;2.47
95496;142004;Szkoła Podstawowa w Chociszewie|Chociszewo| 47 |09-150 Czerwińsk nad Wisłą;1293;375;375;28;347;29.00;7.47
95497;142004;Świetlica OSP w Raszewie Włościańskim|Raszewo Włościańskie| 28A |09-150 Czerwińsk nad Wisłą;805;302;302;13;289;37.52;4.30
95498;142005;Zespół Szkół w Dzierzążni|Dzierzążnia| 57 |09-164 Dzierzążnia;1150;495;495;19;476;43.04;3.84
95499;142005;Zespół Szkół w Dzierzążni|Dzierzążnia| 57 |09-164 Dzierzążnia;792;296;296;9;287;37.37;3.04
95500;142005;Szkoła Podstawowa w Nowych Kucicach|Nowe Kucice| 46 |09-164 Dzierzążnia;1163;441;441;18;423;37.92;4.08
95501;142006;Zespół Szkół w Jońcu|Joniec| 69 |09-131 Joniec;945;420;420;26;394;44.44;6.19
95502;142006;Szkoła Podstawowa w Królewie|Królewo| 58 |09-131 Joniec;467;235;235;10;225;50.32;4.26
95503;142006;Budynek Remizy Ochotniczej Straży Pożarnej w Starej Wronie|Stara Wrona| 14 |09-131 Joniec;751;288;288;12;276;38.35;4.17
95504;142006;Palium Sp. z o.o. w Nowym Mieście Zakład Opiekuńczo-Leczniczy w Jońcu|Joniec| 51 |09-131 Joniec;37;23;23;1;22;62.16;4.35
95505;142007;Zespół Szkół w Naruszewie|Naruszewo| 17 |09-152 Naruszewo;1056;355;355;19;336;33.62;5.35
95506;142007;Szkoła Podstawowa w Radzyminku|Radzyminek| 17 |09-152 Naruszewo;1077;316;316;23;293;29.34;7.28
95507;142007;Szkoła Podstawowa w Zaborowie|Zaborowo| 77 |09-162 Naruszewo;553;170;170;14;156;30.74;8.24
95508;142007;Zespół Szkół w Nacpolsku|Nacpolsk| 18 |09-162 Naruszewo;1551;549;549;27;522;35.40;4.92
95509;142007;Remiza Ochotniczej Straży Pożarnej w Strzembowie|Strzembowo| 20C |09-152 Naruszewo;979;282;282;5;277;28.80;1.77
95510;142008;Szkoła Podstawowa w Gościminie Wielkim|Gościmin Wielki| 47 |09-120 Nowe Miasto;766;289;289;20;269;37.73;6.92
95511;142008;Remiza Ochotniczej Straży Pożarnej w Latonicach|Latonice| 3 |09-120 Nowe Miasto;1033;387;387;20;367;37.46;5.17
95512;142008;Zespół Szkół im. Integracji Europejskiej w Nowym Mieście|Nowe Miasto|ul. Ciechanowska 15 |09-120 Nowe Miasto;741;256;256;8;248;34.55;3.12
95513;142008;Hala Sportowa|Nowe Miasto|ul. Ciechanowska 15 |09-120 Nowe Miasto;1320;652;652;42;610;49.39;6.44
95514;142009;Sala konferencyjna Urzędu Gminy w Płońsku|Płońsk|ul. 19-go Stycznia 39 |09-100 Płońsk;992;446;446;11;435;44.96;2.47
95515;142009;Świetlica w Słoszewie|Słoszewo Kolonia| 14 a |09-100 Płońsk;438;175;175;6;169;39.95;3.43
95516;142009;Świetlica w Strachowie|Strachowo| 6a |09-100 Płońsk;556;249;249;11;238;44.78;4.42
95517;142009;Zespół Szkół w Lisewie|Lisewo| 48 |09-100 Płońsk;540;195;195;9;186;36.11;4.62
95518;142009;Filia Publicznej Szkoły Podstawowej w Siedlinie|Arcelin|ul. Bitwy Arcelińskiej 4 |09-100 Płońsk;366;142;142;8;134;38.80;5.63
95519;142009;Zespół Szkół im. Księdza Prymasa Kardynała Stefana Wyszyńskiego w Siedlinie|Siedlin|ul. Jana Pawła II 12 |09-100 Płońsk;1393;547;547;17;530;39.27;3.11
95520;142009;Świetlica w Skarżynie|Skarżyn|ul. Aleja Lipowa 16 |09-100 Płońsk;811;332;332;7;325;40.94;2.11
95521;142009;Świetlica w Szerominku|Szerominek|ul. Płońska 53 |09-100 Płońsk;511;196;196;13;183;38.36;6.63
95522;142009;Świetlica w Szerominie|Szeromin| 17a |09-100 Płońsk;528;194;194;2;192;36.74;1.03
95523;142010;Zespół Szkół w Starym Gralewie|Stare Gralewo| 13 |09-166 Gralewo;1820;639;639;44;595;35.11;6.89
95524;142010;Zespół Szkół w Uniecku|Unieck| 80 |09-140 Raciąż;1349;534;534;27;507;39.58;5.06
95525;142010;Zespół Szkół w Koziebrodach|Koziebrody| 5 |09-140 Raciąż;900;337;337;31;306;37.44;9.20
95526;142010;Zespół Szkół w Raciążu|Raciąż|ul. Kilińskiego 64 |09-140 Raciąż;1838;629;629;44;585;34.22;7.00
95527;142010;Zespół Szkół w Krajkowie|Krajkowo| 8 |09-140 Raciąż;865;352;352;20;332;40.69;5.68
95528;142010;Centrum Medyczne Grupa Zdrowie Kraszewo-Czubaki 23a|Kraszewo-Czubaki| 23a |09-140 Raciąż;350;83;83;8;75;23.71;9.64
95529;142011;Publiczny Zespół Szkół i Przedszkoli Samorządowych|Sochocin|ul. Szkolna 17 |09-110 Sochocin;1615;757;757;26;731;46.87;3.43
95530;142011;Gminny Ośrodek Kultury|Sochocin|ul. Guzikarzy 8A |09-110 Sochocin;1304;501;501;11;490;38.42;2.20
95531;142011;Szkoła Podstawowa|Smardzewo| 85 |09-110 Sochocin;811;276;276;7;269;34.03;2.54
95532;142011;Szkoła Podstawowa|Kołoząb| 31 |09-110 Sochocin;1071;431;431;18;413;40.24;4.18
95533;142012;Urząd Gminy w Załuskach|Załuski| 67 |09-142 Załuski;965;288;288;19;269;29.84;6.60
95534;142012;Szkoła Podstawowa im. Władysława St. Reymonta w Stróżewie|Stróżewo| 50 |09-142 Załuski;553;224;224;14;210;40.51;6.25
95535;142012;Zespół Szkół Ogólnokształcących w Szczytnie|Szczytno| 8 |09-142 Załuski;1055;417;417;17;400;39.53;4.08
95536;142012;Zespół Szkół Ogólnokształcących w Kroczewie|Kroczewo| 136 |09-142 Załuski;922;396;396;17;379;42.95;4.29
95537;142012;Szkoła Podstawowa im. Ks. Jana Twardowskiego w Kamienicy|Kamienica| 44A |09-142 Załuski;1029;318;318;23;295;30.90;7.23
95538;142101;Szkoła Podstawowa Nr 1|Piastów|ul. Józefa Brandta 22 |05-820 Piastów;2259;1574;1575;15;1559;69.68;0.95
95539;142101;Przedszkole nr. 3|Piastów|ul. Cypriana Godebskiego 21 |05-820 Piastów;1983;1225;1225;12;1213;61.78;0.98
95540;142101;Gimnazjum Nr 2|Piastów|Aleja Tysiąclecia 5 |05-820 Piastów;1908;1172;1172;15;1157;61.43;1.28
95541;142101;Przedszkole Nr 4|Piastów|ul. Żbikowska 5 |05-820 Piastów;1637;1035;1035;17;1018;63.23;1.64
95542;142101;Klub Novus|Piastów|ul. Ks.Ignacego Skorupki 2 |05-820 Piastów;1849;1213;1213;18;1195;65.60;1.48
95543;142101;Miejski Ośrodek Kultury|Piastów|ul. Warszawska 24 |05-820 Piastów;1553;1009;1009;18;991;64.97;1.78
95544;142101;Szkoła Podstawowa Nr 2|Piastów|Aleja Krakowska 20 |05-820 Piastów;1177;759;759;10;749;64.49;1.32
95545;142101;Szkoła Podstawowa Nr 4|Piastów|ul. Żbikowska 25 |05-820 Piastów;2065;1345;1345;20;1325;65.13;1.49
95546;142101;Gimnazjum Nr 1|Piastów|ul. Kazimierza Pułaskiego 6/8 |05-820 Piastów;2044;1313;1313;24;1289;64.24;1.83
95547;142101;Zespół Szkół|Piastów|ul. Karola Namysłowskiego 11 |05-820 Piastów;1718;1110;1110;17;1093;64.61;1.53
95548;142102;Społeczne Liceum Ogólnokształcące Nr 23|Pruszków, Żbików|ul. Polskiej Organizacji Wojskowej 10 |05-800 Pruszków;1876;1046;1046;25;1021;55.76;2.39
95549;142102;Szpital Kolejowy im.dr med. Włodzimierza Roeflera|Pruszków, Żbików|ul. Warsztatowa 1 |05-800 Pruszków;1518;942;942;16;926;62.06;1.70
95550;142102;Przedszkole Miejskie Nr 8|Pruszków, Żbików|ul. 3-go Maja 67 |05-800 Pruszków;1891;966;966;17;949;51.08;1.76
95551;142102;Szkoła Podstawowa nr 9|Pruszków, Żbików|ul. Mostowa 6 |05-800 Pruszków;1893;1239;1239;16;1223;65.45;1.29
95552;142102;Zespół Szkół nr 1|Pruszków, Gąsin|ul. Promyka 24/26 |05-800 Pruszków;1209;712;712;12;700;58.89;1.69
95553;142102;Miejskie Przedszkole Nr 14|Pruszków|ul. Jasna 2 |05-800 Pruszków;1283;763;763;15;748;59.47;1.97
95554;142102;Szkoła Podstawowa Nr 2|Pruszków|ul. Jasna 2 |05-800 Pruszków;2129;1302;1302;23;1279;61.16;1.77
95555;142102;Zespół Szkół Ogólnokształcących i Sportowych|Pruszków|ul. Gomulińskiego 2 |05-800 Pruszków;2049;1257;1257;15;1242;61.35;1.19
95556;142102;Miejski Ośrodek Pomocy Społecznej|Pruszków|ul. Helenowska 3a |05-800 Pruszków;2227;1414;1414;25;1389;63.49;1.77
95557;142102;Miejskie Przedszkole Nr 12|Pruszków, Wyględówek|ul. Andrzeja 12 |05-800 Pruszków;1808;1177;1177;14;1163;65.10;1.19
95558;142102;Szkoła Podstawowa Nr 1|Pruszków, Tworki|ul. Topolowa 10 |05-800 Pruszków;1963;1128;1128;17;1111;57.46;1.51
95559;142102;Przedszkole Niepubliczne "Jedynka"|Pruszków, Malichy|ul. Sadowa 62 |05-800 Pruszków;1467;1054;1054;9;1045;71.85;0.85
95560;142102;Dzienny Dom Pomocy Społecznej|Pruszków, Ostoja|ul. Księcia Józefa 1 |05-800 Pruszków;2104;1513;1513;14;1499;71.91;0.93
95561;142102;Liceum Ogólnokształcące im. Tadeusza Kościuszki|Pruszków,|ul. Kościuszki 34 |05-800 Pruszków;2032;1242;1242;11;1231;61.12;0.89
95562;142102;Liceum Ogólnokształcące im. Tomasza Zana|Pruszków|ul. I. Daszyńskiego 6 |05-800 Pruszków;1540;829;829;7;822;53.83;0.84
95563;142102;Szkoła Podstawowa Nr 8|Pruszków|ul. Obrońców Pokoju 44 |05-800 Pruszków;1667;898;898;13;885;53.87;1.45
95564;142102;Gimazjum Nr 3|Pruszków|Al. Wojska Polskiego 34 |05-800 Pruszków;1684;1024;1024;9;1015;60.81;0.88
95565;142102;Przedszkole Miejskie Nr 10|Pruszków|ul. Chopina 13 |05-800 Pruszków;2010;1235;1235;16;1219;61.44;1.30
95566;142102;Spółdzielczy Dom Kultury|Pruszków|ul. Hubala 5 |05-800 Pruszków;1804;1168;1168;5;1163;64.75;0.43
95567;142102;Gimnazjum Nr 3|Pruszków|Al. Wojska Polskiego 34 |05-800 Pruszków;2230;1369;1369;18;1351;61.39;1.31
95568;142102;Szkoła Podstawowa Nr 6|Pruszków|ul. Lipowa 31 |05-800 Pruszków;1939;1414;1414;16;1398;72.92;1.13
95569;142102;Gimnazjum Nr 4 im. Jana Pawła II|Pruszków|ul. Hubala 4 |05-800 Pruszków;1894;1065;1065;13;1052;56.23;1.22
95570;142102;Budynek Administracji PSM|Pruszków|Lalki 6/8 |05-800 Pruszków;1251;846;846;11;835;67.63;1.30
95571;142102;Przedszkole Miejskie Nr 13|Pruszków|ul. Antka 7 |05-800 Pruszków;1044;772;772;8;764;73.95;1.04
95572;142102;Szkoła Podstawowa nr 10|Pruszków, Gąsin|Pływacka 16 |05-800 Pruszków;1378;885;885;10;875;64.22;1.13
95573;142102;Miejskie Przedszkole nr 15|Pruszków|Dębowa 8 |05-800 Pruszków;1120;671;671;15;656;59.91;2.24
95574;142102;Przedszkole Miejskie Nr 7|Pruszków|ul. Słowackiego 1 |05-800 Pruszków;872;537;537;3;534;61.58;0.56
95575;142102;Obwód odrębny Mazowieckie Specjalistyczne Centrum Zdrowia im. prof. dr Jana Mazurkiewicza ul. Partyzantów 2/4|Pruszków Tworki|Partyzantów 2/4 |05-800 Pruszków;636;118;118;10;108;18.55;8.47
95576;142102;Obwód odrębny Szpital Kolejowy im. dr med. Włodzimierza Roeflera, ul. Warsztatowa 1|Pruszków|Warsztatowa 1 |05-800 Pruszków;147;46;46;0;46;31.29;0.00
95577;142102;Obwód odrębny Szpital Powiatowy, Al. Armii Krajowej 2/4|Pruszków|Al. Armii Krajowej 2/4 |05-800 Pruszków;27;23;23;1;22;85.19;4.35
95578;142103;Zespół Szkół nr 1 w Brwinowie|Brwinów|ul. Piłsudskiego 11 |05-840 Brwinów;1679;1006;1006;13;993;59.92;1.29
95579;142103;Zespół Szkół nr 1 w Brwinowie|Brwinów|ul. Piłsudskiego 11 |05-840 Brwinów;1004;600;600;6;594;59.76;1.00
95580;142103;Sala Konferencyjna na Stadionie Miejskim w Brwinowie|Brwinów|ul. Turystyczna 4 |05-840 Brwinów;834;487;487;5;482;58.39;1.03
95581;142103;Niepubliczne Przedszkole Integracyjne Sióstr Rodziny Maryi|Brwinów|ul. Szkolna 18 |05-840 Brwinów;1468;956;956;13;943;65.12;1.36
95582;142103;OSP w Brwinowie|Brwinów|ul. Pszczelińska 3 |05-840 Brwinów;1723;1130;1130;12;1118;65.58;1.06
95583;142103;Gminny Ośrodek Kultury w Brwinowie|Brwinów|ul. Wilsona 2 |05-840 Brwinów;960;671;671;11;660;69.90;1.64
95584;142103;Samorządowe Przedszkole nr 1 w Brwinowie|Brwinów|ul. Lilpopa 4 |05-840 Brwinów;1868;1293;1293;13;1280;69.22;1.01
95585;142103;Zespół Szkół Ogólnokształcących w Brwinowie|Brwinów|ul. Żwirowa 16 |05-840 Brwinów;950;631;631;2;629;66.42;0.32
95586;142103;OSP w Biskupicach|Biskupice| 51 |05-840 Brwinów;761;283;283;10;273;37.19;3.53
95587;142103;OSP w Mosznie|Moszna-Wieś| 100 |05-840 Brwinów;823;426;426;18;408;51.76;4.23
95588;142103;Dom Gościnny Zalewskich|Parzniew|ul. 36 pp Legii Akademickiej 1 |05-804 Pruszków;1323;824;824;11;813;62.28;1.33
95589;142103;Ośrodek Rekolekcyjny|Kanie|Nadarzyńska 21 |05-805 Otrębusy;1859;1363;1363;10;1353;73.32;0.73
95590;142103;Świetlica GOK w Otrębusach|Otrębusy|ul. Krótka 10 |05-805 Otrębusy;1022;748;748;12;736;73.19;1.60
95591;142103;Zespół Szkół w Otrębusach|Otrębusy|ul. Piaseckiego 2 |05-805 Otrębusy;1006;678;678;5;673;67.40;0.74
95592;142103;Świetlica GOK w Owczarni|Owczarnia|ul. Cyprysowa 4 |05-807 Podkowa Leśna;1067;668;668;9;659;62.61;1.35
95593;142103;OSP Żółwin|Żółwin|Nadarzyńska 25 |05-807 Podkowa Leśna;1219;751;751;13;738;61.61;1.73
95594;142104;Zespół Szkół w Michałowicach|Michałowice|ul. Szkolna 15 |05-816 MIchałowice;1224;889;889;10;879;72.63;1.12
95595;142104;Zespół Szkół w Michałowicach|Michałowice|ul.Szkolna 15 |05-816 Michałowice;1270;875;875;15;860;68.90;1.71
95596;142104;Zespół Szkół w Michałowicach|Michałowice|ul.Szkolna 15 |05-816 Michałowice;1575;1181;1181;12;1169;74.98;1.02
95597;142104;Urząd Gminy|Reguły|ul. Aleja Powstańców Warszawy 1 |05-816 Michałowice;1329;926;926;14;912;69.68;1.51
95598;142104;Świetlica wiejska|Pęcice|ul. Zaułek 7 |05-806 Komorów;937;637;637;10;627;67.98;1.57
95599;142104;Swietlica wiejska|Komorów|ul. Kaliszany 18 |05-806 Komorów;637;431;431;5;426;67.66;1.16
95600;142104;Zespół Szkół Ogólnokształcących|Komorów|Aleja Marii Dąbrowskiej 12/20 |05-806 Komorów;1065;840;840;5;835;78.87;0.60
95601;142104;Zespół Szkół Ogólnokształcących|Komorów|Aleja Marii Dąbrowskiej 12/20 |05-806 Komorów;952;691;691;5;686;72.58;0.72
95602;142104;Zespół Szkół Ogólnokształcących|Komorów|Aleja Marii Dąbrowskiej 12/20 |05-806 Komorów;907;671;671;6;665;73.98;0.89
95603;142104;Zespół Szkolno-Przedszkolny w Nowej Wsi|Nowa Wieś|ul. Główna 96 |05-806 Komorów;1592;1111;1111;12;1099;69.79;1.08
95604;142104;Świetlica wiejska|Nowa Wieś|ul. Główna 52a |05-806 Komorów;1703;1222;1222;19;1203;71.76;1.55
95605;142105;Szkoła Podstawowa w Nadarzynie|Nadarzyn|ul. Sitarskich 4 |05-830 Nadarzyn;1993;1292;1292;25;1267;64.83;1.93
95606;142105;Nadarzyński Ośrodek Kultury w Nadarzynie|Nadarzyn|Plac Poniatowskiego 42 |05-830 Nadarzyn;1967;1372;1372;18;1354;69.75;1.31
95607;142105;Remiza Ochotniczej Straży Pożarnej w Nadarzynie|Nadarzyn|ul. Warszawska 15 |05-830 Nadarzyn;2048;1312;1312;24;1288;64.06;1.83
95608;142105;Szkoła Podstawowa w Ruścu|Rusiec|ul. Osiedlowa 72 |05-830 Nadarzyn;1825;1100;1100;30;1070;60.27;2.73
95609;142105;Przedszkole Publiczne w Młochowie|Młochów|ul. Źódlana 1 |05-831 Młochów;2101;1272;1272;35;1237;60.54;2.75
95610;142106;Szkoła Podstawowa w Sękocinie|Słomin|ul. Wierzbowa 5 |05-090 Raszyn;939;594;594;7;587;63.26;1.18
95611;142106;Ochotnicza Straż Pożarna w Falentach|Falenty|Aleja Hrabska 2 |05-090 Raszyn;1787;1107;1107;20;1087;61.95;1.81
95612;142106;Szkoła Podstawowa w Ładach|Dawidy Bankowe|ul. Długa 49 |05-090 Raszyn;1227;831;831;14;817;67.73;1.68
95613;142106;Szkoła Podstawowa w Ładach|Dawidy Bankowe|Długa 49 |05-090 05-090;1033;713;713;9;704;69.02;1.26
95614;142106;Centrum Kultury Raszyn|Raszyn|Al. Krakowska 29 A |05-090 Raszyn;1531;964;966;17;947;62.97;1.76
95615;142106;Centrum Kultury Raszyn|Raszyn|Al. Krakowska 29 A |05-090 Raszyn;1815;1166;1166;19;1147;64.24;1.63
95616;142106;Przedszkole nr 1 w Raszynie|Raszyn|ul. Pruszkowska 21 C |05-090 Raszyn;1112;655;655;15;640;58.90;2.29
95617;142106;Gimnazjum Nr 1w Raszynie|Raszyn|ul. Unii Europejskiej 1 |05-090 Raszyn;1056;686;686;14;672;64.96;2.04
95618;142106;Szkoła Podstawowa w Raszynie|Raszyn|Szkolna 2 |05-090 05-090;1433;989;989;17;972;69.02;1.72
95619;142106;Świetlica Środowiskowa w Rybiu|Rybie|ul. Spokojna 23 |05-090 Raszyn;1349;826;826;21;805;61.23;2.54
95620;142106;Świetlica Środowiskowa w Rybiu|Rybie|ul. Spokojna 23 |05-090 Raszyn;1171;740;740;13;727;63.19;1.76
95621;142106;Świetlica Środowiskowa w Rybiu|Rybie|ul. Spokojna 23 |05-090 Raszyn;1473;956;956;7;949;64.90;0.73
95622;142106;Dom Rolnika w Jaworowej|Jaworowa|ul. Warszawska 95 |05-090 Raszyn;621;376;376;13;363;60.55;3.46
95623;142201;Zespół Szkół Ponadgimnazjalnych|Przasnysz|ul. Mazowiecka 25 |06-300 Przasnysz;1067;597;597;7;590;55.95;1.17
95624;142201;Zespół Szkół Ponadgimnazjalnych|Przasnysz|ul. Mazowiecka 25 |06-300 Przasnysz;869;408;408;11;397;46.95;2.70
95625;142201;Szkoła Podstawowa nr 2|Przasnysz|ul. J. Kilińskiego 1 |06-300 Przasnysz;787;394;394;8;386;50.06;2.03
95626;142201;Ośrodek Sportu i Rekreacji|Przasnysz|ul. Makowska 23 |06-300 Przasnysz;1196;595;595;10;585;49.75;1.68
95627;142201;Miejskie Przedszkole nr 2|Przasnysz|ul. Świerczewo 8 |06-300 Przasnysz;1385;637;637;20;617;45.99;3.14
95628;142201;Szkoła Podstawowa nr 1|Przasnysz|ul. Żwirki i Wigury 4 |06-300 Przasnysz;1188;602;602;17;585;50.67;2.82
95629;142201;Szkoła Podstawowa nr 1|Przasnysz|ul. Żwirki i Wigury 4 |06-300 Przasnysz;1036;560;560;11;549;54.05;1.96
95630;142201;Szkoła Podstawowa nr 1|Przasnysz|ul. Żwirki i Wigury 4 |06-300 Przasnysz;1108;647;647;9;638;58.39;1.39
95631;142201;Szkoła Podstawowa nr 1|Przasnysz|ul. Szkolna 2 |06-300 Przasnysz;884;466;466;15;451;52.71;3.22
95632;142201;Publiczne Gimnazjum|Przasnysz|ul. Orlika 48 |06-300 Przasnysz;805;347;347;7;340;43.11;2.02
95633;142201;Miejskie Przedszkole nr 1|Przasnysz|ul. Lipowa 8 |06-300 Przasnysz;1465;698;698;25;673;47.65;3.58
95634;142201;Publiczne Gimnazjum|Przasnysz|ul. Orlika 48 |06-300 Przasnysz;1564;816;816;16;800;52.17;1.96
95635;142201;Dom Pomocy Społecznej|Przasnysz|ul. Ruda 1 |06-300 Przasnysz;145;53;53;7;46;36.55;13.21
95636;142201;Samodzielny Publiczny Zespół Zakładów Opieki Zdrowotnej|Przasnysz|ul. Sadowa 9 |06-300 Przasnysz;195;66;66;4;62;33.85;6.06
95637;142201;Dom Pomocy Społecznej Zgromadzenia Sióstr Miłosierdzia św. Wincentego a Paulo|Przasnysz|ul. Świerczewo 9 |06-300 Przasnysz;94;59;59;5;54;62.77;8.47
95638;142202;Publiczne Gimnazjum w Chorzelach|Chorzele|Szkolna 4b |06-330 Chorzele;1074;512;512;13;499;47.67;2.54
95639;142202;Publiczne Gimnazjum w Chorzelach|Chorzele|Szkolna 4b |06-330 Chorzele;1235;545;545;9;536;44.13;1.65
95640;142202;Świetlica Wiejska w Nowej Wsi|Nowa Wieś| 14 |06-330 Chorzele;482;150;150;13;137;31.12;8.67
95641;142202;Zespół Szkół w Duczyminie|Duczymin| 15 |06-330 Chorzele;472;148;148;9;139;31.36;6.08
95642;142202;Zespół Szkół w Krzynowłodze Wielkiej|Krzynowłoga Wielka| 18 |06-330 Chorzele;486;172;172;12;160;35.39;6.98
95643;142202;Świetlica Wiejska w Bagienicach|Bagienice| 37 |06-330 Chorzele;402;161;161;6;155;40.05;3.73
95644;142202;Świetlica Ochotniczej Straży Pożarnej w Rycicach|Rycice| 50 |06-330 Chorzele;460;143;143;13;130;31.09;9.09
95645;142202;Publiczna Szkoła Podstawowa w Chorzelach|Chorzele| 4 |06-330 Chorzele;449;196;196;16;180;43.65;8.16
95646;142202;Punkt Przedszkolny w Łazie|Łaz| 77 |06-333 Zaręby;701;224;224;10;214;31.95;4.46
95647;142202;Zespół Szkół w Zarębach|Zaręby| 41 |06-333 Zaręby;692;259;259;11;248;37.43;4.25
95648;142202;Publiczna Szkoła Podstawowa w Pościeniu Wsi|Poścień-Wieś| 47 |00-000 06-330;594;191;191;8;183;32.15;4.19
95649;142202;Publiczna Szkoła Podstawowa w Krukowie|Krukowo| 87 |06-333 Zaręby;448;168;168;12;156;37.50;7.14
95650;142202;Świetlica Wiejska w Rzodkiewnicy|Rzodkiewnica| 6a |00-000 06-333;492;135;135;9;126;27.44;6.67
95651;142203;OSP Czernice Borowe|Czernice Borowe|ul. Stanisława Chełchowskiego 12 |06-415 Czernice Borowe;1078;458;458;15;443;42.49;3.28
95652;142203;Strażnica OSP Pawłowo Kościelne|Pawłowo Kościelne| 21 |06-415 Czernice Borowe;510;208;208;12;196;40.78;5.77
95653;142203;Strażnica OSP Rostkowo|Rostkowo| 38 |06-415 Czernice Borowe;840;388;388;17;371;46.19;4.38
95654;142203;OSP Węgra|Węgra| 26A |06-415 Czernice Borowe;693;307;307;8;299;44.30;2.61
95655;142204;Zespół Placówek Oświatowych w Jednorożcu, Przedszkole Samorządowe|Jednorożec|ul. Wintentego Witosa 4 |06-323 Jednorożec;1607;543;543;11;532;33.79;2.03
95656;142204;Ośrodek Zdrowia w Jednorożcu|Jednorożec|ul. Odrodzenia 12 |06-323 Jednorożec;1096;284;284;17;267;25.91;5.99
95657;142204;Świetlica wiejska w Małowidzu|Małowidz| 72a |06-323 Jednorożec;299;100;100;8;92;33.44;8.00
95658;142204;Lokal prywatny Pana Mieczysława Koszczaka|Kobylaki-Konopki| 1A |06-323 Jednorożec;203;73;73;4;69;35.96;5.48
95659;142204;Szkoła Podstawowa w Lipie|Lipa| 64 |06-323 Jednorożec;494;196;196;16;180;39.68;8.16
95660;142204;Szkoła Podstawowa w Parciakach|Parciaki| 22 |06-323 Jednorożec;628;284;284;15;269;45.22;5.28
95661;142204;Szkoła Podstawowa w Żelaznej Rządowej|Żelazna Rządowa| 27A |06-323 Jednorożec;443;157;157;15;142;35.44;9.55
95662;142204;Szkoła Podstawowa w Olszewce|Olszewka| 80 |06-323 Jednorożec;449;158;158;9;149;35.19;5.70
95663;142204;Budynek po byłej szkole podstawowej w Połoni|Połoń| 5 |06-323 Jednorożec;262;123;123;5;118;46.95;4.07
95664;142204;Remiza Strażacka w Budach Rządowych|Budy Rządowe| 29 |06-323 Jednorożec;164;72;72;6;66;43.90;8.33
95665;142205;Szkoła Podstawowa w Krasnem|Krasne|ul.Spółdzielcza 1 |06-408 Krasne;1681;679;679;32;647;40.39;4.71
95666;142205;Szkoła Podstawowa w Milewie-Szwejkach|Milewo-Szwejki| 19 |06-408 Krasne;541;172;172;16;156;31.79;9.30
95667;142205;Szkoła Podstawowa w Zielonej|Zielona| 3 |06-408 Krasne;834;333;333;19;314;39.93;5.71
95668;142206;Urząd Gminy|Krzynowłoga Mała|ul. Kościelna 3 |06-316 Krzynowłoga Mała;1305;658;658;23;635;50.42;3.50
95669;142206;Świetlica wiejska w Świniarach|Świniary| |06-316 Krzynowłoga Mała;182;85;85;1;84;46.70;1.18
95670;142206;Szkoła Podstawowa w Ulatowie-Adamach|Ulatowo-Adamy| 9 |06-316 Krzynowłoga Mała;383;133;133;1;132;34.73;0.75
95671;142206;Budynek byłej Szkoły Podstawowej w Grabowie-Rżańcach|Grabowo-Rżańce| |06-316 Krzynowłoga Mała;188;51;51;2;49;27.13;3.92
95672;142206;Budynek byłej Szkoły Podstawowej w Rudnie Jeziorowym|Rudno Jeziorowe| |06-316 Krzynowłoga Mała;209;95;95;3;92;45.45;3.16
95673;142206;Szkoła Podstawowa w Romanach-Seborach|Romany-Sebory| 7 |06-300 Przasnysz;369;154;154;6;148;41.73;3.90
95674;142206;Świetlica wiejska w budynku OSP w Kakach-Mroczkach|Kaki-Mroczki| |06-316 Krzynowłoga Mała;223;123;123;7;116;55.16;5.69
95675;142207;Szkoła Podstawowa w Obrębie|Obrąb| 44 |06-300 Przasnysz;435;186;186;13;173;42.76;6.99
95676;142207;Zespół Szkół w Lesznie|Leszno| 189 |06-300 Przasnysz;806;355;355;10;345;44.04;2.82
95677;142207;Gminna Biblioteka Publiczna w Bogatem|Bogate| 57a |06-300 Przasnysz;1199;484;484;16;468;40.37;3.31
95678;142207;Oddział Przedszkolny w Dobrzankowie|Dobrzankowo| 98 |06-300 Przasnysz;439;172;172;7;165;39.18;4.07
95679;142207;Świetlica OSP w Karwaczu|Karwacz| 8 |06-300 Przasnysz;672;267;267;15;252;39.73;5.62
95680;142207;Budynek po byłej Szkole Podstawowej w Bartnikach|Bartniki| 65a |06-300 Przasnysz;408;188;188;5;183;46.08;2.66
95681;142207;Zespół Szkół w Nowej Krępie|Nowa Krępa| 34a |06-300 Przasnysz;655;287;287;6;281;43.82;2.09
95682;142207;Świetlica OSP w Szli|Szla| 37a |06-300 Przasnysz;385;172;172;10;162;44.68;5.81
95683;142207;Szkoła Podstawowa w Mchowie|Mchowo| 41 |06-300 Przasnysz;780;318;318;8;310;40.77;2.52
95684;142301;Zespół Szkół Ogólnokształcących Borkowice|Borkowice|ul. Ks. Jana Wiśniewskiego 8 |26-422 Borkowice;901;422;422;20;402;46.84;4.74
95685;142301;Przedszkole Samorządowe Ninków|Ninków| 23 |26-422 Borkowice;469;153;153;10;143;32.62;6.54
95686;142301;Zespół Szkół Ogólnokształcących Rzuców|Rzuców|ul. Szkolna 33 |26-422 Borkowice;1006;391;391;16;375;38.87;4.09
95687;142301;Młodzieżowy Ośrodek Wychowawczy Rusinów|Rusinów| 32 |26-422 Borkowice;237;75;75;2;73;31.65;2.67
95688;142301;Gminny Ośrodek Kultury Borkowice|Borkowice|ul. Ks. Jana Wiśniewskiego 7 |26-422 Borkowice;1068;554;554;15;539;51.87;2.71
95689;142302;Urząd Gminy Gielniów|Gielniów|pl. Wolności 75 |26-434 Gielniów;1353;579;579;33;546;42.79;5.70
95690;142302;Publiczna Szkoła Podstawowa w Bielinach|Bieliny| 99 |26-434 Gielniów;725;388;388;19;369;53.52;4.90
95691;142302;Świetlica wiejska w Goździkowie|Goździków|ul. Główna 45 |26-434 Gielniów;677;321;321;7;314;47.42;2.18
95692;142302;Świetlica wiejska w Rozwadach|Rozwady| 89 |26-434 Gielniów;1106;500;500;31;469;45.21;6.20
95693;142303;Zespół Szkół Samorządowych w Klwowie|Klwów|ul. Przysuska 4 |26-415 Klwów;1023;641;641;27;614;62.66;4.21
95694;142303;Remiza OSP w Sulgostowie|Sulgostów| 59 |26-415 Klwów;425;258;258;9;249;60.71;3.49
95695;142303;Wiejskie Centrum Kultury w Przystałowicach Dużych|Przystałowice Duże| 18 |26-415 Klwów;439;275;275;12;263;62.64;4.36
95696;142303;Publiczna Szkoła Podstawowa w Kłudnie|Kłudno| 83 |26-415 Klwów;945;619;619;34;585;65.50;5.49
95697;142304;Publiczna Szkoła Podstawowa w Odrzywole|Odrzywół|ul. Warszawska 51 |26-425 Odrzywół;932;558;558;13;545;59.87;2.33
95698;142304;Młodzieżowy Ośrodek Wychowawczyw w Kolonii Ossie|Kolonia Ossa| 40 |26-425 Odrzywół;629;289;289;7;282;45.95;2.42
95699;142304;Publiczna Szkoła Podstawowa w Myślakowicach|Myślakowice| 1 |26-425 Odrzywół;414;205;205;12;193;49.52;5.85
95700;142304;Publiczna Szkoła Podstawowa w Odrzywole - Hala Sportowa w Odrzywole|Odrzywół|ul. Warszawska 51 |26-425 Odrzywół;1339;760;760;32;728;56.76;4.21
95701;142305;Urząd Gminy w Potworowie|Potworów|ul. Radomska 2A |26-414 Potworów;1204;595;595;33;562;49.42;5.55
95702;142305;Dom Strażaka w Potworowie|Potworów|ul. Radomska 2 |26-414 Potworów;1356;577;577;19;558;42.55;3.29
95703;142305;Świetlica Wiejska w Rdzuchowie|Rdzuchów| 50 |26-414 Potworów;314;136;136;8;128;43.31;5.88
95704;142305;Publiczna Szkoła Podstawowa w Wirze|Wir| 55 |26-414 Potworów;556;216;216;11;205;38.85;5.09
95705;142306;Dom Kultury w Przysusze|Przysucha|ul. Radomska 9 |26-400 Przysucha;1842;1001;1001;26;975;54.34;2.60
95706;142306;Szkoła Podstawowa Nr 2 w Przysusze Osiedle Południe|Przysucha|ul. Skowyry 41 |26-400 Przysucha;2212;1197;1197;34;1163;54.11;2.84
95707;142306;Szkoła Podstawowa Nr 1 w Przysusze|Przysucha|ul. Krakowska 76 |26-400 Przysucha;2231;1176;1176;17;1159;52.71;1.45
95708;142306;Budynek byłej Szkoły Podstawowej w Ruskim Brodzie|Ruski Bród|ul. Główna 51 |26-400 Przysucha;395;141;141;10;131;35.70;7.09
95709;142306;Szkoła Podstawowa w Skrzyńsku|Skrzyńsko|ul. Wjazdowa 9 |26-400 Przysucha;1666;729;729;19;710;43.76;2.61
95710;142306;Świetlica w Smogorzowie|Smogorzów|ul. Strażacka 1a |26-400 Przysucha;753;407;407;16;391;54.05;3.93
95711;142306;Świetlica w Janikowie|Janików|ul. Górna 2 |26-400 Przysucha;811;379;379;8;371;46.73;2.11
95712;142306;Świetlica w Dębinach|Dębiny|Stare Dębiny 53 |26-400 Przysucha;324;129;129;15;114;39.81;11.63
95713;142307;Świetlica Wiejska w Rusinowie|Rusinów|ul. Strażacka 7 |26-411 Rusinów;960;479;479;17;462;49.90;3.55
95714;142307;Niepubliczna Szkoła Podstawowa w Nieznamierowicach|Nieznamierowice| 3 |26-411 Rusinów;916;494;494;14;480;53.93;2.83
95715;142307;Zespół Szkół Ogólnokształcących w Rusinowie|Rusinów|Szkolna 47 |26-411 Rusinów;1176;502;502;16;486;42.69;3.19
95716;142307;Świetlicy Wiejskiej w Bąkowie|Bąków| 23A |26-411 Rusinów;540;327;327;13;314;60.56;3.98
95717;142308;Remiza OSP w Wieniawie|Wieniawa|ul. Kochanowskiego 78A |26-432 Wieniawa;1844;924;924;36;888;50.11;3.90
95718;142308;Budynek po byłej Publicznej Szkole Podstawowej w Skrzynnie|Skrzynno|ul. Kolejowa 1A |26-432 Wieniawa;1610;772;772;33;739;47.95;4.27
95719;142308;Budynek po byłej Publicznej Szkole Podstawowej w Brudnowie|Brudnów| 37 |26-432 Wieniawa;558;221;221;8;213;39.61;3.62
95720;142308;Świetlica wiejska w Koryciskach|Koryciska| 38 |26-432 Wieniawa;398;148;148;14;134;37.19;9.46
95721;142401;Świetlica Wiejska|Gzy| 8 |06-126 Gzy;702;305;305;9;296;43.45;2.95
95722;142401;Publiczna Szkoła Podstawowa|Przewodowo Poduchowne| 21 |06-126 Gzy;1108;558;558;15;543;50.36;2.69
95723;142401;Lokal Gminy Gzy|Stare Grochy| 8 |06-126 Gzy;284;162;162;4;158;57.04;2.47
95724;142401;Lokal Gminy Gzy|Szyszki Włościańskie| 18 |06-126 Gzy;947;431;431;23;408;45.51;5.34
95725;142401;Dom Pomocy Społecznej|Ołdaki-Stefanowo| 7 |06-126 Gzy;91;59;59;0;59;64.84;0.00
95726;142401;Zakład Opiekuńczo-Leczniczy|Tąsewy| 8 |06-120 Winnica;77;25;25;5;20;32.47;20.00
95727;142402;Publiczna Szkoła Podstawowa w Obrytem|Obryte| 114 |07-215 Obryte;1247;678;678;24;654;54.37;3.54
95728;142402;Publiczna Szkoła Podstawowa w Obrytem Filia Psary|Psary| 43 |07-215 Obryte;463;250;250;9;241;54.00;3.60
95729;142402;Szkoła Filialna w Gródku Rządowym|Gródek Rządowy| 34 |07-215 Obryte;575;307;307;19;288;53.39;6.19
95730;142402;Szkoła Filialna im. Jana Pawła II w Sokołowie Włościańskim|Sokołowo Włościańskie| 63 |07-215 Obryte;685;344;344;13;331;50.22;3.78
95731;142402;Szkoła Filialna im. Janusza Korczaka w Zambskach Kościelnych|Zambski Kościelne| 33 |07-215 Obryte;456;263;263;24;239;57.68;9.13
95732;142402;Dom Pomocy Społecznej w Obrytem|Obryte| 188 |07-215 Obryte;256;193;193;23;170;75.39;11.92
95733;142402;Gminny Dom Kultury we wsi Sadykierz|Sadykierz| 54 |07-215 Obryte;284;138;138;9;129;48.59;6.52
95734;142403;Publiczne Gimnazjum z Oddziałami Integracyjnymi w Dzierżeninie|Dzierżenin| 105 |06-114 Pokrzywnica;914;455;455;13;442;49.78;2.86
95735;142403;Publiczna Szkoła Podstawowa w Pobyłkowie Dużym|Pobyłkowo Duże| 15 |06-114 Pokrzywnica;556;252;252;5;247;45.32;1.98
95736;142403;Publiczna Szkoła Podstawowa w Pokrzywnicy|Pokrzywnica|al. Jana Pawła II 10 |06-121 Pokrzywnica;1044;490;490;41;449;46.93;8.37
95737;142403;Publiczna Szkoła Podstawowa w Nowym Niestępowie|Nowe Niestępowo| 7 |06-121 Pokrzywnica;970;413;413;21;392;42.58;5.08
95738;142403;Publiczna Szkoła Podstawowa w Gzowie|Gzowo| 5 |06-114 Pokrzywnica;496;234;234;8;226;47.18;3.42
95739;142404;Publiczna Szkoła Podstawowa w Bobach|Boby| 15a |06-100 Pułtusk;464;245;245;7;238;52.80;2.86
95740;142404;Zespół Szkolno - Przedszkolny w Przemiarowie|Przemiarowo| 33 |06-100 Pułtusk;513;263;263;8;255;51.27;3.04
95741;142404;Świetlica Wiejska w Trzcińcu|Trzciniec| 17 |06-100 Pułtusk;748;428;428;6;422;57.22;1.40
95742;142404;Galeria Sztuki "4 Strony Świata" w Pułtusku|Pułtusk|ul. Plac Teatralny 4 |06-100 Pułtusk;675;349;349;8;341;51.70;2.29
95743;142404;Publiczna Szkoła Podstawowa im. Błogosławionego Jana Pawła II w Płocochowie|Płocochowo| 72 |06-100 Pułtusk;866;425;425;9;416;49.08;2.12
95744;142404;Zespół Szkół Nr 2 z Oddziałami Integracyjnymi w Pułtusku|Pułtusk|ul. Polna 7 |06-100 Pułtusk;642;331;331;7;324;51.56;2.11
95745;142404;Zespół Szkół Nr 2 z Oddziałami Integracyjnymi w Pułtusku|Pułtusk|ul. Polna 7 |06-100 Pułtusk;1193;584;584;17;567;48.95;2.91
95746;142404;Zespół Szkół Nr 2 z Oddziałami Integracyjnymi w Pułtusku|Pułtusk|ul. Polna 7 |06-100 Pułtusk;1121;602;602;16;586;53.70;2.66
95747;142404;Publiczne Gimnazjum Nr 1 im. Klaudyny Potockiej w Pułtusku|Pułtusk|ul. Marii Konopnickiej 5 |06-100 Pułtusk;1072;558;558;17;541;52.05;3.05
95748;142404;Miejskie Centrum Kultury i Sztuki w Pułtusku|Pułtusk|ul. Plac Teatralny 4 |06-100 Pułtusk;957;506;506;9;497;52.87;1.78
95749;142404;Miejskie Centrum Kultury i Sztuki w Pułtusku|Pułtusk|ul. Plac Teatralny 4 |06-100 Pułtusk;954;447;447;7;440;46.86;1.57
95750;142404;Publiczna Szkoła Podstawowa Nr 3 z Oddziałami Integracyjnymi im. Tadeusza Kościuszki w Pułtusku|Pułtusk|ul. Aleja Tysiąclecia 14 |06-100 Pułtusk;750;430;430;6;424;57.33;1.40
95751;142404;Świetlica Osiedlowa|Pułtusk|ul. Na Skarpie 10 |06-100 Pułtusk;736;404;404;18;386;54.89;4.46
95752;142404;Publiczna Szkoła Podstawowa Nr 3 z Oddziałami Integracyjnymi im. Tadeusza Kościuszki w Pułtusku|Pułtusk|ul. Aleja Tysiąclecia 14 |06-100 Pułtusk;1001;574;574;14;560;57.34;2.44
95753;142404;Zespół Szkół Nr 4 w Pułtusku z Klasami Sportowymi|Pułtusk|ul. New Britain 1 |06-100 Pułtusk;811;390;390;15;375;48.09;3.85
95754;142404;Zespół Szkół Zawodowych im. Jana Ruszkowskiego w Pułtusku|Pułtusk|ul. Aleja Tysiąclecia 12 |06-100 Pułtusk;821;290;290;12;278;35.32;4.14
95755;142404;Przedszkole Miejskie Nr 5 w Pułtusku|Pułtusk|ul. 17 Stycznia 6 |06-100 Pułtusk;909;404;404;16;388;44.44;3.96
95756;142404;Żłobek Miejski w Pułtusku|Pułtusk|ul. 13 Pułku Piechoty 1 |06-100 Pułtusk;979;565;565;9;556;57.71;1.59
95757;142404;Specjalny Ośrodek Szkolno - Wychowawczy im. Anny Karłowicz w Pułtusku|Pułtusk|ul. Aleja Tysiąclecia 12 |06-100 Pułtusk;1146;673;673;15;658;58.73;2.23
95758;142404;Zespół Szkół Nr 4 w Pułtusku z Klasami Sportowymi|Pułtusk|ul. New Britain 1 |06-100 Pułtusk;805;359;359;20;339;44.60;5.57
95759;142404;Przedszkole Miejskie Nr 4 z Oddziałami Integracyjnymi w Pułtusku|Pułtusk|ul. Rafała Krajewskiego 3 |06-100 Pułtusk;1131;630;630;8;622;55.70;1.27
95760;142404;Publiczne Gimnazjum Nr 1 im. Klaudyny Potockiej w Pułtusku|Pułtusk|ul. Marii Konopnickiej 5 |06-100 Pułtusk;813;420;420;6;414;51.66;1.43
95761;142404;Szpital Powiatowy Gajda-Med Sp. z o.o. w Pułtusku|Pułtusk|ul. Teofila Kwiatkowskiego 19 |06-100 Pułtusk;58;26;26;1;25;44.83;3.85
95762;142405;Publiczne Gimnazjum w Świerczach|Świercze|ul. Pułtuska 26C |06-150 Świercze;926;447;447;20;427;48.27;4.47
95763;142405;Publiczna Szkoła Podstawowa w Świerczach|Świercze|ul. Pułtuska 26A |06-150 Świercze;851;278;278;8;270;32.67;2.88
95764;142405;Publiczna Szkoła Podstawowa w Strzegocinie|Strzegocin| 4 |06-150 Świercze;870;323;323;21;302;37.13;6.50
95765;142405;Świetlica Wiejska|Kowalewice Włościańskie| 42 |06-150 Świercze;649;229;229;13;216;35.29;5.68
95766;142405;Publiczna Szkoła Podstawowa w Świeszewie|Świeszewo| 8 |06-150 Świercze;519;195;195;10;185;37.57;5.13
95767;142406;Zespół Szkół CKR w Golądkowie|Golądkowo| 41F |06-120 Winnica;674;371;371;9;362;55.04;2.43
95768;142406;Publiczna Szkoła Podstawowa w Błędostowie|Błędostowo| 23 |06-120 Winnica;592;340;340;10;330;57.43;2.94
95769;142406;Urząd Gminy w Winnicy|Winnica|ul. Pułtuska 25 |06-120 Winnica;904;475;475;11;464;52.54;2.32
95770;142406;Zespół Placówek Oświatowych w Winnicy Publiczna Szkoła Podstawowa w Winnicy|Winnica|ul. Pułtuska 19 |06-120 Winnica;1075;671;671;16;655;62.42;2.38
95771;142407;Zespół Placówek Oświatowych|Zatory|ul. Jana Pawła II 69 |07-217 Zatory;810;403;403;27;376;49.75;6.70
95772;142407;Zespół Placówek Oświatowych|Zatory|ul. Jana Pawła II 69 |07-217 Zatory;713;337;337;24;313;47.27;7.12
95773;142407;Świetlica wiejska|Nowe Borsuki| 16A |07-217 Zatory;244;123;123;3;120;50.41;2.44
95774;142407;Szkoła Podstawowa|Ciski| 23 |07-217 Zatory;495;228;228;9;219;46.06;3.95
95775;142407;Zespół Szkół|Pniewo|ul. 18 Maja 6 |07-214 Zatory;1028;540;540;15;525;52.53;2.78
95776;142407;Samorządowy Punkt Przedszkolny|Gładczyn Rządowy| 17 |07-214 Zatory;610;268;268;14;254;43.93;5.22
95777;142501;Zespół Szkół im. J Śniadeckiego w Pionkach|Pionki|ul. Parkowa 4 |26-670 Pionki;962;479;479;6;473;49.79;1.25
95778;142501;Publiczne Gimnazjum Nr 2 w Pionkach|Pionki|ul. Słowackiego 4 |26-670 Pionki;1097;518;519;14;504;47.22;2.70
95779;142501;Przedszkole Nr 1 w Pionkach|Pionki|ul. Żeromskiego 8 |26-670 Pionki;998;451;451;14;437;45.19;3.10
95780;142501;Publiczna Szkoła Podstawowa Nr 1 w Pionkach|Pionki|ul. 15 Stycznia 3 |26-670 Pionki;1059;580;580;6;574;54.77;1.03
95781;142501;Publiczne Gimnazjum Nr 1 w Pionkach|Pionki|ul. Leśna 1 |26-670 Pionki;1047;489;489;13;476;46.70;2.66
95782;142501;Miejski Ośrodek Pomocy Społecznej w Pionkach|Pionki|ul. Leśna 5 |26-670 Pionki;957;419;419;6;413;43.78;1.43
95783;142501;Publiczne Gimnazjum Nr 1 w Pionkach|Pionki|ul. Leśna 1 |26-670 Pionki;1009;473;473;17;456;46.88;3.59
95784;142501;Warsztaty Terapii Zajęciowej w Pionkach|Pionki|ul. Leśna 3 |26-670 Pionki;1044;479;479;5;474;45.88;1.04
95785;142501;Liceum Ogólnokształcące w Pionkach|Pionki|ul. Aleje Lipowe 25 |26-670 Pionki;1090;493;493;18;475;45.23;3.65
95786;142501;Przedszkole Nr 2 w Pionkach|Pionki|ul. Aleje Lipowe 24A |26-670 Pionki;977;335;336;13;322;34.29;3.88
95787;142501;Liceum Ogólnokształcące w Pionkach|Pionki|ul. Aleje Lipowe 25 |26-670 Pionki;1116;548;548;16;532;49.10;2.92
95788;142501;Publiczna Szkoła Podstawowa Nr 5 w Pionkach|Pionki|ul. Targowa 9 |26-670 Pionki;1039;513;513;20;493;49.37;3.90
95789;142501;Publiczna Szkoła Podstawowa Nr 5 w Pionkach|Pionki|ul. Targowa 9 |26-670 Pionki;1022;565;565;8;557;55.28;1.42
95790;142501;Publiczna Szkoła Podstawowa Nr 2 w Pionkch|Pionki|ul. Kochanowskiego 12 |26-670 Pionki;1105;554;554;24;530;50.14;4.33
95791;142501;Centrum Kształcenia Zawodowego i Ustawicznego w Pionkach|Pionki|Aleja Jana Pawła II 7 |26-670 Pionki;1031;513;513;16;497;49.76;3.12
95792;142501;Oddział Rehabilitacji w Pionkach|Pionki|ul. Harcerska 1 |26-670 Pionki;26;12;12;0;12;46.15;0.00
95793;142501;Oddział Chirurgiczny w Pionkach|Pionki|15 Stycznia 1 |26-670 Pionki;32;2;2;0;2;6.25;0.00
95794;142502;Zespół Szkół w Goździe|Gózd|ul. Starowiejska 130 |26-634 Gózd;1562;765;765;34;731;48.98;4.44
95795;142502;Publiczna Szkoła Podstawowa w Kłonówku-Kolonii|Kłonówek-Kolonia| 13 |26-634 Gózd;677;333;333;21;312;49.19;6.31
95796;142502;Zespół Szkół w Kuczkach-Kolonii|Kuczki-Kolonia| 75 |26-634 Gózd;1139;582;582;22;560;51.10;3.78
95797;142502;Publiczna Szkoła Podstawowa w Klwatce Królewskiej|Klwatka Królewska| 31 |26-634 Gózd;1131;599;599;13;586;52.96;2.17
95798;142502;Publiczna Szkoła Podstawowa w Podgórze|Podgóra| 10 |26-634 Gózd;740;260;260;11;249;35.14;4.23
95799;142502;Zespół Szkół Ogólnokształcących w Małęczynie|Małęczyn|ul. Szkolna 64 |26-634 Gózd;1500;870;870;24;846;58.00;2.76
95800;142503;Liceum Ogólnokształcące w Iłży|Iłża|ul. Jakuba Starszego 6 |27-100 Iłża;1116;510;510;11;499;45.70;2.16
95801;142503;Publiczna Szkoła Podstawowa w Iłży|Iłża|ul. Wójtowska 5 |27-100 Iłża;1256;618;618;13;605;49.20;2.10
95802;142503;Zespół Szkół Ponadgimnazjalnych w Iłży|Iłża|ul. Błazińska 5 |27-100 Iłża;827;337;337;7;330;40.75;2.08
95803;142503;Publiczna Szkoła Podstawowa w Błazinach|Błaziny Dolne| 163 |27-100 Iłża;940;419;419;10;409;44.57;2.39
95804;142503;Szkoła Podstawowa w Maziarzach Starych|Maziarze Stare| 40 |27-100 Iłża;614;243;243;8;235;39.58;3.29
95805;142503;Wiejski Ośrodek Kultury w Prędocinie|Prędocin| 1 |27-100 Iłża;525;230;230;8;222;43.81;3.48
95806;142503;Publiczna Szkoła Podstawowa w Seredzicach|Seredzice| 109 |27-100 Iłża;1458;488;488;20;468;33.47;4.10
95807;142503;Publiczna Szkoła Podstawowa w Jasieńcu|Jasieniec Iłżecki Górny| 75 |27-100 Iłża;1465;515;515;18;497;35.15;3.50
95808;142503;Szkoła Podstawowa w Krzyżanowicach|Krzyżanowice| 145 |27-100 Iłża;822;313;313;16;297;38.08;5.11
95809;142503;Szkoła Podstawowa w Alojzowie|Alojzów| 6A |27-100 Iłża;444;178;178;9;169;40.09;5.06
95810;142503;Publiczna Szkoła Podstawowa w Pakosławiu|Pakosław| 54 |27-100 Iłża;779;327;327;8;319;41.98;2.45
95811;142503;Remiza OSP w Chwałowicach|Chwałowice| 78 |27-100 Iłża;430;138;138;8;130;32.09;5.80
95812;142503;Remiza OSP w Małomierzycach|Małomierzyce| 110 |27-100 Iłża;320;119;119;3;116;37.19;2.52
95813;142503;Warsztaty Terapii Zajęciowej w Jedlance Starej|Jedlanka Stara| 96 |27-100 Iłża;357;148;148;3;145;41.46;2.03
95814;142503;Publiczne Gimnazjum Gminne w Iłży|Iłża|ul. Bodzentyńska 45 |27-100 Iłża;968;455;455;10;445;47.00;2.20
95815;142503;Dom Pomocy Społecznej w Krzyżanowicach|Krzyżanowice| 219 |27-100 Iłża;115;49;49;2;47;42.61;4.08
95816;142503;SP ZZOZ SZPITAL W IŁŻY|IŁŻA|dr ANKI 4 |27-100 IŁŻA;79;21;21;3;18;26.58;14.29
95817;142504;Publiczna Szkoła Podstawowa w Bartodziejach|Bartodzieje| 17A |26-631 Jastrzębia;501;209;209;3;206;41.72;1.44
95818;142504;Publiczna Szkoła Podstawowa w Jastrzębi|Jastrzębia| 109 |26-631 Jastrzębia;1570;794;794;17;777;50.57;2.14
95819;142504;Publiczna Szkoła Podstawowa w Mąkosach Starych|Mąkosy Stare| 80 |26-631 Jastrzębia;599;300;300;10;290;50.08;3.33
95820;142504;Publiczna Szkoła Podstawowa w Woli Goryńskiej|Wola Goryńska| 45 |26-631 Jastrzębia;585;244;244;10;234;41.71;4.10
95821;142504;Publiczna Szkoła Podstawowa w Kozłowie|Kozłów| 84 |26-631 Jastrzębia;672;365;365;15;350;54.32;4.11
95822;142504;Publiczna Szkoła Podstawowa w Lesiowie|Lesiów| 47 |26-631 Jastrzębia;858;392;392;20;372;45.69;5.10
95823;142504;Niepubliczna Szkoła Podstawowa w Owadowie|Owadów| 130 |26-631 Jastrzębia;671;268;268;15;253;39.94;5.60
95824;142505;Publiczna Szkoła Podstawowa w Jedlińsku|Jedlińsk|ul. Konopnickiej 2 |26-660 Jedlińsk;1656;900;900;28;872;54.35;3.11
95825;142505;Publiczna Szkoła Podstawowa w Ludwikowie|Ludwików| 8 |26-660 Jedlińsk;922;406;406;8;398;44.03;1.97
95826;142505;Publiczna Szkoła Podstawowa w Jedlance|Jedlanka| 52 |26-660 Jedlińsk;949;393;393;26;367;41.41;6.62
95827;142505;Publiczna Szkoła Podstawowa w Bierwcach|Bierwce| 48 |26-660 Jedlińsk;1280;621;621;17;604;48.52;2.74
95828;142505;Zespół Szkół Publicznych we Wsoli|Wsola|ul. Szkolna 1 |26-660 Jedlińsk;1790;791;791;31;760;44.19;3.92
95829;142505;Publiczna Szkoła Podstawowa w Starych Zawadach|Stare Zawady| 30A |26-660 Jedlińsk;746;305;305;7;298;40.88;2.30
95830;142505;Zespół Szkół Publicznych w Wierzchowinach|Wierzchowiny| 30 |26-660 Jedlińsk;739;273;273;20;253;36.94;7.33
95831;142505;Dom Strażaka w Wielogórze|Wielogóra|ul. Kwiatowa 1 |26-660 Jedlińsk;1908;910;910;44;866;47.69;4.84
95832;142505;Świetlica Wiejska w Lisowie|Lisów| 38A |26-660 Jedlińsk;846;407;407;16;391;48.11;3.93
95833;142506;Zespół Szkół Ogólnokształcących w Jedlni-Letnisko|Jedlnia-Letnisko|ul. Słoneczna 5 |26-630 Jedlnia-Letnisko;1887;959;959;29;930;50.82;3.02
95834;142506;Publiczna Szkoła Podstawowa w Słupicy|Słupica| 84 |26-630 Jedlnia-Letnisko;794;321;321;14;307;40.43;4.36
95835;142506;Zespół Szkół Ogólnokształcących w Natolinie|Natolin| 59 |26-613 Radom 15;1652;948;948;18;930;57.38;1.90
95836;142506;Zespół Szkół Ogólnokształcących w Myśliszewicach|Myśliszewice| 15 |26-613 Radom 15;1210;648;648;12;636;53.55;1.85
95837;142506;Publiczna Szkoła Podstawowa w Myśliszewicach|Myśliszewice| 15 |26-630 Jedlnia-Letnisko;1901;965;965;20;945;50.76;2.07
95838;142506;Publiczna Szkoła Podstawowa w Gzowicach|Gzowice| 1 |26-630 Jedlnia-Letnisko;432;187;187;13;174;43.29;6.95
95839;142506;Strażnica Ochotniczej Straży Pożarnej w Jedlni-Letnisko|Jedlnia-Letnisko|ul. Radomska 43 |26-630 Jedlnia-Letnisko;2054;1177;1177;23;1154;57.30;1.95
95840;142507;Publiczna Szkoła Podstawowa w Kowali|Kowala-Stępocina| 103 |26-624 Kowala-Stępocina;1529;842;842;26;816;55.07;3.09
95841;142507;Publiczna Szkoła Podstawowa w Młodocinie Mniejszym|Młodocin Mniejszy| 47 |26-624 Kowala-Stępocina;1266;724;724;22;702;57.19;3.04
95842;142507;Publiczna Szkoła Podstawowa w Mazowszanach|Mazowszany| 6 |26-624 Kowala-Stępocina;1394;782;782;22;760;56.10;2.81
95843;142507;Publiczne Gimnazjum w Parznicach|Parznice| 53 |26-624 Kowala-Stępocina;1267;628;628;32;596;49.57;5.10
95844;142507;Publiczna Szkoła Podstawowa w Bardzicach|Bardzice| 2C |26-624 Kowala-Stępocina;570;288;288;14;274;50.53;4.86
95845;142507;Publiczna Szkoła Podstawowa w Kowali|Kowala-Stępocina| 103 |26-624 Kowala-Stępocina;1714;886;886;31;855;51.69;3.50
95846;142507;Świetlica Słoneczko w Trablicach|Trablice| 75F |26-624 Kowala-Stępocina;1346;723;723;33;690;53.71;4.56
95847;142508;Publiczna Szkoła Podstawowa w Czarnej|Czarna Wieś| 5 |26-670 Pionki;1457;529;529;24;505;36.31;4.54
95848;142508;Publiczna Szkoła Podstawowa w Augustowie|Augustów| 102 |26-670 Pionki;443;223;223;6;217;50.34;2.69
95849;142508;Gminne Centrum Kultury w Janusznie|Januszno| 72 |26-670 Pionki;420;173;173;9;164;41.19;5.20
95850;142508;Publiczna Szkoła Podstawowa w Laskach|Laski| 68 |26-670 Pionki;915;332;332;18;314;36.28;5.42
95851;142508;Publiczny Zespół Szkół w Jedlni|Jedlnia| 93 |26-670 Pionki;2130;1068;1068;22;1046;50.14;2.06
95852;142508;Publiczna Szkoła Podstawowa w Jaroszkach|Jaroszki| 21 |26-670 Pionki;535;221;221;10;211;41.31;4.52
95853;142508;Publiczny Zespół Szkół w Suskowoli|Suskowola| 74 |26-670 Pionki;1437;664;664;11;653;46.21;1.66
95854;142508;Publiczna Szkoła Podstawowa w Suchej|Sucha| 38A |26-670 Pionki;712;284;284;10;274;39.89;3.52
95855;142508;Oddział Zewnętrzny w Pionkach Zakładu Karnego w Żytkowicach|Pionki| |26-670 ;132;80;80;8;72;60.61;10.00
95856;142509;Publiczna Szkoła Podstawowa Przytyk|Przytyk|ul.Szkolna 3 |26-650 przytyk;1490;728;728;24;704;48.86;3.30
95857;142509;Publiczna Szkoła Podstawowa Przytyk|Przytyk|ul.Szkolna 3 |26-650 przytyk;1292;581;581;16;565;44.97;2.75
95858;142509;Remiza OSP Suków|Suków| 26 |26-650 przytyk;649;310;310;15;295;47.77;4.84
95859;142509;Publiczna Szkoła Podstawowa Wrzos|Wrzos| 6 |26-650 przytyk;1429;691;691;31;660;48.36;4.49
95860;142509;Publiczna Szkoła Podstawowa Wrzeszczów|Wrzeszczów| 47 |26-650 przytyk;827;402;402;23;379;48.61;5.72
95861;142510;Publiczna Szkoła Podstawowa w Skaryszewie|Skaryszew|ul.Wojska Polskiego 5 |26-640 Skaryszew;2007;1033;1033;24;1009;51.47;2.32
95862;142510;Samorządowe Przedszkole w Skaryszewie|Skaryszew|ul. Kochanowskiego 16G |26-640 Skaryszew;1977;1060;1060;45;1015;53.62;4.25
95863;142510;Zespół Edukacji Gimnazjalnej i Podstawowej w Makowcu|Makowiec|ul. Kościelna 2 |26-640 Skaryszew;1651;876;876;12;864;53.06;1.37
95864;142510;Publiczna Szkoła Podstawowa w Makowie|Maków|ul.Szkolna 6 |26-640 Skaryszew;888;466;466;8;458;52.48;1.72
95865;142510;Publiczna Szkoła Podstawowa w Odechowie|Odechów| 77 |26-640 Skaryszew;1460;606;606;19;587;41.51;3.14
95866;142510;Publiczna Szkoła Podstawowa w Modrzejowicach|Modrzejowice| 68 |26-640 Skaryszew;753;268;268;11;257;35.59;4.10
95867;142510;Publiczna Szkoła Podstawowa w Dzierzkówku Starym|Dzierzkówek Stary| 90 |26-640 Skaryszew;773;304;304;7;297;39.33;2.30
95868;142510;Publiczna Szkoła Podstawowa w Chomentówie-Puszcz|Chomentów-Puszcz|ul. Ogrodowa 1 |26-640 Skaryszew;649;326;326;25;301;50.23;7.67
95869;142510;Remiza Ochotniczej Staży Pożarnej w Gębarzowie|Gębarzów| 98 |26-640 Skaryszew;879;483;483;11;472;54.95;2.28
95870;142511;Remiza OSP w Wierzbicy|Wierzbica|Plac Jana Pawła II 11 |26-680 Wierzbica;1843;909;909;26;883;49.32;2.86
95871;142511;Gminny Ośrodek Kultury w Wierzbicy|Wierzbica, Osiedle|Janka Krasickiego 27 |26-680 Wierzbica;1724;771;771;28;743;44.72;3.63
95872;142511;Publiczna Szkoła Podstawowa w Rudzie Wielkiej|Ruda Wielka| 191B |26-680 Wierzbica;1196;401;401;22;379;33.53;5.49
95873;142511;Publiczna Szkoła Podstawowa w Łączanach|Łączany| 41A |26-680 Wierzbica;846;313;313;20;293;37.00;6.39
95874;142511;Publiczna Szkoła Podstawowa w Dąbrówce Warszawskiej|Dąbrówka Warszawska| 117A |26-680 Wierzbica;647;274;274;8;266;42.35;2.92
95875;142511;Publiczna Szkoła Podstawowa w Polanach|Polany| 141 |26-680 Wierzbica;880;436;436;19;417;49.55;4.36
95876;142511;Publiczna Szkoła Podstawowa w Zalesicach|Zalesice| 31B |26-680 Wierzbica;737;390;390;21;369;52.92;5.38
95877;142512;Urząd Gminy Wolanów|Wolanów|ul. Radomska 20 |26-625 Wolanów;1693;887;887;30;857;52.39;3.38
95878;142512;Publiczna Szkoła Podstawowa w Mniszku|Mniszek| 101 |26-625 Wolanów;1209;579;580;29;550;47.89;5.01
95879;142512;Publiczna Szkoła Podstawowa w Sławnie|Sławno| 49 |26-625 Wolanów;1532;773;773;30;743;50.46;3.88
95880;142512;Publiczna Szkoła Podstawowa w Bieniędzicach|Bieniędzice| 21 |26-625 Wolanów;466;206;206;11;195;44.21;5.34
95881;142512;Warsztaty Terapii Zajęciowej w Młodocinie Większym|Młodocin Większy| 25 |26-625 Wolanów;531;228;228;12;216;42.94;5.26
95882;142512;Zespół Szkół Ogólnokształcących w Wolanowie|Wolanów|ul. Kolejowa 17 |26-625 Wolanów;1305;616;616;16;600;47.20;2.60
95883;142513;Publiczna Szkoła Podstawowa w Zakrzewie|Zakrzew| 58D |26-652 Zakrzew;1131;635;635;19;616;56.15;2.99
95884;142513;Publiczna Szkoła Podstawowa w Zakrzewie|Zakrzew| 58D |26-652 Zakrzew;1048;548;548;33;515;52.29;6.02
95885;142513;Publiczna Szkoła Podstawowa w Woli Taczowskiej|Wola Taczowska| 11B |26-652 Zakrzew;987;529;529;24;505;53.60;4.54
95886;142513;Publiczna Szkoła Podstawowa w Cerekwi|Cerekiew|Wesoła 2 |26-652 Zakrzew;1825;967;967;45;922;52.99;4.65
95887;142513;Publiczna Szkoła Podstawowa w Dąbrówce Podłężnej|Dąbrówka Podłężna| 29B |26-652 Zakrzew;830;396;396;19;377;47.71;4.80
95888;142513;Publiczna Szkoła Podstawowa w Wacynie|Wacyn| 23 |26-600 Radom;1797;1034;1034;27;1007;57.54;2.61
95889;142513;Publiczna Szkoła Podstawowa w Wacynie|Wacyn| 23 |26-600 Radom;816;415;415;6;409;50.86;1.45
95890;142513;Publiczna Szkoła Podstawowa w Janiszewie|Janiszew| 41B |26-652 Zakrzew;1224;703;703;25;678;57.43;3.56
95891;142601;Wiejski Dom Kultury w Domanicach|Domanice| 52 |08-113 Domanice;638;303;303;13;290;47.49;4.29
95892;142601;Szkoła Podstawowa w Domanicach-Kolonii, Domanice-Kolonia, 08-113 Domanice|Domanice-Kolonia| 18 |08-113 Domanice;711;372;372;6;366;52.32;1.61
95893;142601;Szkoła Podstawowa w Olszycu Szlacheckim, Olszyc Szlachecki 25, 08-113 Domanice|Olszyc Szlachecki| 25 |08-113 Domanice;756;360;360;12;348;47.62;3.33
95894;142602;Szkoła Podstawowa w Nowym Bartkowie|Nowy Bartków| 19 |08-108 Korczew;594;227;227;9;218;38.22;3.96
95895;142602;Świetlica w Czaplach Górnych|Czaple Górne| 26b |08-108 Korczew;387;174;174;7;167;44.96;4.02
95896;142602;Zespół Placówek Oświatowych|Korczew|ul.Szkolna 4 |08-108 Korczew;828;368;368;15;353;44.44;4.08
95897;142602;Szkoła Podstawowa w Drażniewie|Drażniew| 53 |08-108 Korczew;531;217;217;7;210;40.87;3.23
95898;142603;Urząd Gminy w Kotuniu|Kotuń|Siedlecka 56C |08-130 Kotuń;1920;961;961;30;931;50.05;3.12
95899;142603;Świetlica Wiejska Żeliszew Podkościelny|Żeliszew Podkościelny| 11 |08-130 Kotuń;1213;490;490;23;467;40.40;4.69
95900;142603;Zespół Szkół Bojmie|Bojmie| 33 |08-130 Kotuń;776;328;328;7;321;42.27;2.13
95901;142603;Szkoła Podstawowa Koszewnica|Koszewnica| 36 |08-130 Kotuń;1073;472;472;18;454;43.99;3.81
95902;142603;Świetlica Wiejska Polaki|Polaki| 63B |08-130 Kotuń;584;254;254;12;242;43.49;4.72
95903;142603;Świetlica Wiejska Gręzów|Gręzów| 48 |08-130 Kotuń;849;418;418;14;404;49.23;3.35
95904;142603;Szkoła Podstawowa Cisie-Zagrudzie|Cisie-Zagrudzie| 42 |08-130 Kotuń;421;168;168;5;163;39.90;2.98
95905;142604;Urząd Gminy|Mokobody|Plac Chreptowicza 25 |08-124 Mokobody;1294;662;662;28;634;51.16;4.23
95906;142604;Zespół Szkolno-Przedszkolny Publiczna Szkoła Podstawowa|Niwiski|ul. Rynek 21 |08-124 Mokobody;1376;643;643;22;621;46.73;3.42
95907;142604;Gminny Ośrodek Kultury w Mokobodach z siedzibą w Skupiach|Skupie| 11 |08-124 Mokobody;487;253;253;9;244;51.95;3.56
95908;142604;Publiczna Szkoła Podstawowa w Mokobodach|Mokobody|ul. Szkolna 14 |08-124 Mokobody;945;472;472;17;455;49.95;3.60
95909;142605;Szkoła Podstawowa w Mordach|Mordy|ul. Kilińskiego 11 |08-140 Mordy;1493;706;706;19;687;47.29;2.69
95910;142605;Świetlica wiejska w Czepielinie|Czepielin| 10A |08-140 Mordy;661;317;317;5;312;47.96;1.58
95911;142605;Miejsko-Gminny Ośrodek Kultury w Mordach|Mordy|ul. Parkowa 9 |08-140 Mordy;679;296;296;7;289;43.59;2.36
95912;142605;Szkoła Podstawowa w Krzymoszach|Krzymosze| 43A |08-140 Mordy;778;308;308;12;296;39.59;3.90
95913;142605;Zespół Szkół w Radzikowie Wielkim|Radzików Wielki|ul. Szkolna 5 |08-140 Mordy;573;303;303;4;299;52.88;1.32
95914;142605;Świetlica Wiejska w Wojnowie|Wojnów| 7 |08-140 Mordy;769;314;314;10;304;40.83;3.18
95915;142606;Zespól Szkół w Paprotni|Paprotnia|ul. Jana Pawła II 5 |08-107 Paprotnia;580;316;316;11;305;54.48;3.48
95916;142606;Zespół Szkół w Paprotni|Paprotnia|Jana Pawła II 5 |08-107 Paprotnia;622;380;380;13;367;61.09;3.42
95917;142606;Zespół Szkolno - Przedszkolny w Hołubli|Hołubla|Unitów Podlaskich 35 |08-107 Paprotnia;462;264;264;14;250;57.14;5.30
95918;142606;Zespół Szkolno - Przedszkolny w Hołubli|Hołubla|Unitów Podlaskich 35 |08-107 Paprotnia;507;303;303;6;297;59.76;1.98
95919;142607;Budynek Wiejski Dąbrowa|Dąbrowa| 103 |08-109 Przesmyki;449;161;161;5;156;35.86;3.11
95920;142607;Świetlica Wiejska Kamianki Lackie|Kamianki Lackie| 67 |08-109 Przesmyki;394;154;154;5;149;39.09;3.25
95921;142607;Zespół Szkół Łysów|Łysów| 89 |08-109 Przesmyki;554;222;222;12;210;40.07;5.41
95922;142607;Gminny Ośrodek Kultury Przesmyki|Przesmyki|ul. 1 Maja 1 |08-109 Przesmyki;1014;523;523;24;499;51.58;4.59
95923;142607;Świetlica Wiejska Kukawki|Kukawki| 24 |08-109 Przesmyki;408;227;227;5;222;55.64;2.20
95924;142608;Zespół Oświatowy w Pruszynie|Pruszyn|Dolina Liwca 46 |08-110 Siedlce;1105;584;584;20;564;52.85;3.42
95925;142608;Zespół Oświatowy w Stoku Lackim|Stok Lacki|Siedlecka 135 |08-110 Siedlce;2120;1097;1097;18;1079;51.75;1.64
95926;142608;Zespół Oświatowo-Wychowawczy w Białkach|Białki| 95 |08-110 Siedlce;1984;1028;1028;14;1014;51.81;1.36
95927;142608;Zespół Oświatowy w Żelkowie-Kolonii|Żelków-Kolonia|Siedlecka 202 |08-110 Siedlce;2094;1057;1057;34;1023;50.48;3.22
95928;142608;Zespół Oświatowy w Nowych Iganiach|Nowe Iganie|Siedlecka 113 |08-103 Siedlce;2052;1055;1055;19;1036;51.41;1.80
95929;142608;Filia Biblioteczna w Nowym Opolu|Nowe Opole|ul.Spacerowa 1 |08-103 Siedlce;787;442;442;12;430;56.16;2.71
95930;142608;Zespół Oświatowo-Wychowawczy w Strzale|Chodów|Sokołowska 1 |08-110 Siedlce;2074;1144;1144;20;1124;55.16;1.75
95931;142608;Świetlica w Żaboklikach|Żabokliki|Korczewska 46 |08-110 Siedlce;1449;773;773;13;760;53.35;1.68
95932;142609;Gimnazjum w Skórcu|Skórzec|Siedlecka 9 |08-114 Skórzec;1147;553;553;15;538;48.21;2.71
95933;142609;Szkoła Podstawowa w Grali-Dąbrowiźnie|Grala-Dąbrowizna| 65 |08-114 Skórzec;1170;506;506;18;488;43.25;3.56
95934;142609;Zespół Oświatowy w Żelkowie Kolonii|Żelków|Siedlecka 202 |08-110 Siedlce;1027;482;482;7;475;46.93;1.45
95935;142609;Szkoła Podstawowa w Dąbrówce-Stanach|Dąbrówka-Stany| 152 |08-114 Skórzec;1339;614;614;10;604;45.86;1.63
95936;142609;Szkoła Podstawowa w Skórcu|Skórzec|Siedlecka 2 |08-114 Skórzec;836;397;397;13;384;47.49;3.27
95937;142609;Niepubliczna Szkoła Podstawowa w Gołąbku|Gołąbek|Szkolna 26 |08-114 Skórzec;465;240;240;3;237;51.61;1.25
95938;142610;Urząd Gminy|Suchożebry|Aleksandry Ogińskiej 11 |08-125 Suchożebry;1790;902;902;36;866;50.39;3.99
95939;142610;Szkoła Podstawowa|Krynica| 33 |08-125 Suchożebry;597;293;293;8;285;49.08;2.73
95940;142610;Szkoła Podstawowa|Krześlin| 67 |08-125 Suchożebry;593;269;269;15;254;45.36;5.58
95941;142610;Zespół Szkół Publicznych|Suchożebry|Siedlecka 8 |08-125 Suchożebry;777;340;340;17;323;43.76;5.00
95942;142611;Gminny Ośrodek Pielęgnacji Tradycji Kulinarnych w Wólce Wiśniewskiej|Wólka Wiśniewska| 60 |08-112 Wiśniew;890;429;429;6;423;48.20;1.40
95943;142611;Wiejski Dom Integracji w Borkach-Paduchach|Borki-Paduchy| 92 |08-112 Wiśniew;657;417;417;14;403;63.47;3.36
95944;142611;Gminny Ośrodek Kultury w Wiśniewie|Wiśniew|Bat. Chłopskich 2 |08-112 Wiśniew;1441;827;827;25;802;57.39;3.02
95945;142611;Zespół Oświatowy w Radomyśli|Radomyśl| 46 |08-112 Wiśniew;856;432;432;14;418;50.47;3.24
95946;142611;Zespół Oświatowy w Śmiarach|Śmiary| 68 |08-112 Wiśniew;726;466;466;7;459;64.19;1.50
95947;142612;Zespół Szkół w Wodyniach|Wodynie|ul. Siedlecka 7 |08-117 Wodynie;707;308;308;7;301;43.56;2.27
95948;142612;Zespół Szkół w Wodyniach|Wodynie|ul. Siedlecka 7 |08-117 Wodynie;562;184;184;13;171;32.74;7.07
95949;142612;Zespół Szkół w Seroczynie|Seroczyn|Siedlecka 11 |08-116 Seroczyn;854;434;434;10;424;50.82;2.30
95950;142612;Zespół Szkół w Seroczynie|Seroczyn|Siedlecka 11 |08-116 Seroczyn;662;296;296;9;287;44.71;3.04
95951;142612;Szkoła Podstawowa w Rudzie Wolińskiej|Ruda Wolińska| 44 |08-117 Wodynie;509;260;260;9;251;51.08;3.46
95952;142612;Pawilon turystyczny|Wola Wodyńska| 109A |08-117 Wodynie;401;199;199;3;196;49.63;1.51
95953;142613;Zespół Szkół w Zbuczynie|Zbuczyn|ul. Jana Pawła II 3 |08-106 Zbuczyn;1786;1042;1042;29;1013;58.34;2.78
95954;142613;Zespół Szkół w Zbuczynie|Zbuczyn|ul. Jana Pawła II 3 |08-106 Zbuczyn;954;497;497;10;487;52.10;2.01
95955;142613;Szkoła Podstawowa w Czuryłach|Cielemęc| 44 |08-106 Zbuczyn;909;510;510;11;499;56.11;2.16
95956;142613;Szkoła Podstawowa w Dziewulach|Dziewule|ul. Kościelna 10 |08-106 Zbuczyn;965;502;502;23;479;52.02;4.58
95957;142613;Szkoła Podstawowa w Izdebkach-Kosnach|Izdebki-Kosny| 38 |08-111 Krzesk-Królowa Niwa;561;304;304;10;294;54.19;3.29
95958;142613;Zespół Szkół w Krzesku-Królowa Niwa|Krzesk-Królowa Niwa| 23 |08-111 Krzesk-Królowa Niwa;1040;511;511;20;491;49.13;3.91
95959;142613;Zespół Szkół w Krzesku-Królowa Niwa|Krzesk-Królowa Niwa| 23 |08-111 Krzesk-Królowa Niwa;571;330;330;12;318;57.79;3.64
95960;142613;Szkoła Podstawowa w Ługach Wielkich|Ługi Wielkie| 39 |08-106 Zbuczyn;602;318;318;7;311;52.82;2.20
95961;142613;Zespół Szkół w Borkach-Kosach|Borki-Kosy| 24 |08-106 Zbuczyn;545;349;349;6;343;64.04;1.72
95962;142701;Zakład Energetyczny|Sierpc|ul. Reymonta 57 |09-200 Sierpc;997;439;439;16;423;44.03;3.64
95963;142701;Ratusz|Sierpc|ul. Pl.Kardynała Wyszyńskiego 1 |09-200 Sierpc;894;404;404;7;397;45.19;1.73
95964;142701;Spółdzielnia Usług Rolniczych|Sierpc|ul. Kościuszki 8 |09-200 Sierpc;1013;480;480;12;468;47.38;2.50
95965;142701;Miejskie Przedszkole Nr 2|Sierpc|ul. Narutowicza 9 |09-200 Sierpc;1041;544;544;19;525;52.26;3.49
95966;142701;Szkoła Podstawowa Nr 3|Sierpc|ul. Konstytucji 3 Maja 8 |09-200 Sierpc;954;490;490;10;480;51.36;2.04
95967;142701;Gimnazjum Miejskie|Sierpc|ul. Braci Tułodzieckich 2 |09-200 Sierpc;1101;536;536;8;528;48.68;1.49
95968;142701;Szkoła Podstawowa Nr 2|Sierpc|ul. Płocka 38 |09-200 Sierpc;1081;486;486;13;473;44.96;2.67
95969;142701;Miejskie Przedszkole Nr 4|Sierpc|ul. Kwiatowa 4 |09-200 Sierpc;769;352;352;9;343;45.77;2.56
95970;142701;Spółdzielnia Mieszkaniowa Lokatorsko-Własnościowa|Sierpc|ul. Piastowska 28 |09-200 Sierpc;941;445;445;13;432;47.29;2.92
95971;142701;MOPS|Sierpc|ul. Świętokrzyska 12 |09-200 Sierpc;1021;507;507;11;496;49.66;2.17
95972;142701;Zespół Szkół Nr 1|Sierpc|ul. Armii Krajowej 10 |09-200 Sierpc;932;401;401;3;398;43.03;0.75
95973;142701;Dom Kultury|Sierpc|ul. Piastowska 39 |09-200 Sierpc;984;424;424;16;408;43.09;3.77
95974;142701;Świetlica Osiedlowa|Sierpc|ul. Targowa 2 |09-200 Sierpc;988;495;495;16;479;50.10;3.23
95975;142701;L. O. w Sierpcu|Sierpc|ul. Sucharskiego 2 |09-200 Sierpc;1008;481;481;19;462;47.72;3.95
95976;142701;L. O. w Sierpcu|Sierpc|ul. Sucharskiego 2 |09-200 Sierpc;1066;555;555;9;546;52.06;1.62
95977;142701;Szpital Powiatowy|Sierpc|ul. Słowackiego 32 |09-200 Sierpc;52;29;29;5;24;55.77;17.24
95978;142702;Szkoła Podstawowa|Ostrowy| 2 |09-213 Gozdowo;572;226;226;18;208;39.51;7.96
95979;142702;Publiczne Gimnazjum|Gozdowo|ul. Krystyna Gozdawy 21 |09-213 Gozdowo;904;326;326;11;315;36.06;3.37
95980;142702;Urząd Gminy|Gozdowo|ul. Krystyna Gozdawy 19 |09-213 Gozdowo;884;394;394;19;375;44.57;4.82
95981;142702;Szkoła Podstawowa|Lelice|ul. Szkolna 1 |09-213 Gozdowo;781;339;339;10;329;43.41;2.95
95982;142702;Oddział Gimnazjalny|Lelice|ul. Szkolna 1 |09-213 Gozdowo;962;305;305;7;298;31.70;2.30
95983;142702;Remiza Ochotniczej Strazy Pożarnej|Rempin|ul. Szlachecka 18 |09-213 Gozdowo;719;271;271;18;253;37.69;6.64
95984;142703;Szkoła Podstawowa im. Adama Mickiewicza w Bożewie|Bożewo Nowe| 15 |09-215 Bożewo;721;349;349;28;321;48.40;8.02
95985;142703;Szkoła Podstawowa im. Adama Mickiewicza w Bożewie|Bożewo Nowe| 15 |09-215 Bożewo;697;259;259;14;245;37.16;5.41
95986;142703;Szkoła Podstawowa im. Jana Pawła II w Mochowie|Mochowo-Parcele| 31 |09-214 Mochowo;825;423;423;28;395;51.27;6.62
95987;142703;Szkoła Podstawowa im. Jana Pawła II w Mochowie|Mochowo-Parcele| 31 |09-214 Mochowo;741;256;256;19;237;34.55;7.42
95988;142703;Szkoła Podstawowa im. Powstańców Styczniowych w Ligowie|Ligowo| 35 |09-228 Ligowo;954;359;359;21;338;37.63;5.85
95989;142703;Szkoła Podstawowa im. Powstańców Styczniowych w Ligowie|Ligowo| 35 |09-228 Ligowo;976;310;310;24;286;31.76;7.74
95990;142704;Zespół Szkół Samorządowych w Rościszewie|Rościszewo|ul. Władysława Reymonta 4 |09-204 Rościszewo;684;305;305;14;291;44.59;4.59
95991;142704;Zespół Szkół Samorządowych w Rościszewie|Rościszewo|ul. Władysława Reymonta 4 |09-204 Rościszewo;750;243;243;14;229;32.40;5.76
95992;142704;Zespół Szkół Samorządowych w Rościszewie|Rościszewo|ul. Władysława Reymonta 4 |09-204 Rościszewo;758;334;334;23;311;44.06;6.89
95993;142704;Szkoła Podstawowa im. Tadeusza Kościuszki w Łukomiu|Łukomie| 53a |09-204 Rościszewo;636;261;261;9;252;41.04;3.45
95994;142704;Szkoła Podstawowa im. Tadeusza Kościuszki w Łukomiu|Łukomie| 53a |09-204 Rościszewo;610;226;226;6;220;37.05;2.65
95995;142705;Szkoła Podstawowa|Bledzewo| 11 |09-200 Sierpc;1158;451;452;13;438;38.95;2.88
95996;142705;Szkoła Podstawowa|Borkowo Kościelne|ul. Szkolna 2 |09-200 Sierpc;1323;526;526;13;513;39.76;2.47
95997;142705;Szkoła Podstawowa|Białyszewo|ul. Niepodległości 2 |09-200 Sierpc;1103;414;414;28;386;37.53;6.76
95998;142705;Gimnazjum|Susk| 35 |09-200 Sierpc;629;234;234;18;216;37.20;7.69
95999;142705;Publiczne Przedszkole w Studzieńcu|Studzieniec| 27 |09-200 Sierpc;751;275;275;12;263;36.62;4.36
96000;142705;Szkoła Podstawowa|Sudragi|ul. Szkolna 10 |09-200 Sierpc;566;232;232;18;214;40.99;7.76
96001;142706;Zespół Szkół Ogólnokształcących|Gójsk|ul. Lipnowska 3 B |09-227 Szczutowo;773;272;272;14;258;35.19;5.15
96002;142706;Zespół Szkół Ogólnokształcących|Gójsk|ul. Lipnowska 3B |09-227 Szczutowo;979;349;349;25;324;35.65;7.16
96003;142706;Gimnazjum|Szczutowo|ul. Lipowa 2 |09-227 Szczutowo;577;284;284;7;277;49.22;2.46
96004;142706;Gimnazjum|Szczutowo|ul. Lipowa 2 |09-227 Szczutowo;681;225;225;7;218;33.04;3.11
96005;142706;Szkoła Podstawowa (była)|Stara Wola| 13 |09-227 Szczutowo;484;171;171;10;161;35.33;5.85
96006;142706;Dom Pomocy Społecznej w Szczutowie|Szczutowo|3 Maja 116 |09-227 Szczutowo;56;27;27;1;26;48.21;3.70
96007;142707;Zespół Szkół Samorządowych|Zawidz Kościelny|ul. Mazowiecka 47 |09-226 Zawidz Kościelny;1072;530;530;17;513;49.44;3.21
96008;142707;Zespół Szkół Samorządowych|Zawidz Kościelny|ul. Mazowiecka 47 |09-226 Zawidz Kościelny;1121;451;451;17;434;40.23;3.77
96009;142707;Szkoła Podstawowa|Jeżewo| 59 |09-226 Zawidz Kościelny;1430;576;576;25;551;40.28;4.34
96010;142707;Szkoła Podstawowa|Osiek| 5 |09-226 Zawidz Kościelny;725;323;323;29;294;44.55;8.98
96011;142707;Szkoła Podstawowa|Słupia| 43 |09-226 Zawidz Kościelny;1154;457;457;28;429;39.60;6.13
96012;142801;Energop Sp. z o. o.|Sochaczew|ul. Inżynierska 32 |96-500 Sochaczew;1489;734;734;12;722;49.29;1.63
96013;142801;Sochaczewskie Centrum Kultury|Sochaczew|ul. 15 Sierpnia 83 |96-500 Sochaczew;1508;705;705;8;697;46.75;1.13
96014;142801;Szkoła Podstawowa Nr 2|Sochaczew|ul. 15 Sierpnia 44 |96-500 Sochaczew;1191;575;575;13;562;48.28;2.26
96015;142801;Przedszkole Nr 7|Sochaczew|ul. Franciszka Żwirki i Stanisława Wigury 15 |96-500 Sochaczew;1271;641;641;8;633;50.43;1.25
96016;142801;Zespół Szkół Ogólnokształcących|Sochaczew|ul. 15 Sierpnia 4 |96-500 Sochaczew;1399;795;795;12;783;56.83;1.51
96017;142801;Zakład Wodociągów i Kanalizacji Sp. Z o.o.|Sochaczew|ul. Rozlazłowska 7 |96-500 Sochaczew;1559;832;832;14;818;53.37;1.68
96018;142801;Środowiskowy Dom Samopomocy|Sochaczew|ul. Zamkowa 4 a |96-500 Sochaczew;1495;782;782;12;770;52.31;1.53
96019;142801;Spółdzielnia Mieszkaniowa Lokatorsko-Własnościowa|Sochaczew|ul. Marszałka Józefa Piłsudskiego 26 |96-500 Sochaczew;1432;792;792;11;781;55.31;1.39
96020;142801;Szkoła Podstawowa Nr 3|Sochaczew|ul. Hanki Sawickiej 5 |96-500 Sochaczew;1384;697;697;14;683;50.36;2.01
96021;142801;Hala Sportowa Miejskiego Ośrodka Sportu i Rekreacji|Sochaczew|ul. Janusza Kusocińskiego 2 |96-500 Sochaczew;1433;782;782;14;768;54.57;1.79
96022;142801;Sochaczewskie Centrum Kultury|Sochaczew|ul.Stefana Żeromskiego 8 |96-500 Sochaczew;1486;758;758;14;744;51.01;1.85
96023;142801;Przedszkole nr 3|Sochaczew|ul. Poprzeczna 9 |96-500 Sochaczew;1361;670;670;16;654;49.23;2.39
96024;142801;Szkoła Podstawowa nr 4|Sochaczew|ul. Stanisława Staszica 25 |96-500 Sochaczew;1489;889;889;19;870;59.70;2.14
96025;142801;Szkoła Podstawowa nr 4|Sochaczew|ul. Stanisława Staszica 25 |96-500 Sochaczew;1427;863;863;12;851;60.48;1.39
96026;142801;Dzienny Dom Pomocy Społecznej|Sochaczew|ul. Aleja 600-Lecia 90 |96-500 Sochaczew;1408;763;763;8;755;54.19;1.05
96027;142801;Gimnazjum nr 2|Sochaczew|ul. Stanisława Staszica 106 |96-500 Sochaczew;1450;800;800;10;790;55.17;1.25
96028;142801;Dzienny Dom Pomocy Społecznej|Sochaczew|ul. Aleja 600-Lecia 90 |96-500 Sochaczew;1379;677;677;5;672;49.09;0.74
96029;142801;Sochaczewskie Centrum Kultury|Sochaczew|ul. Fryderyka Chopina 101 |96-500 Sochaczew;1345;645;645;13;632;47.96;2.02
96030;142801;Filia Miejskiej Biblioteki Publicznej|Sochaczew|ul. Fryderyka Chopina 160 |96-500 Sochaczew;1323;604;604;16;588;45.65;2.65
96031;142801;Zespół Szkół|Sochaczew|Fryderyka Chopina 99 |96-500 Sochaczew;1427;651;651;9;642;45.62;1.38
96032;142801;Zespół Szkół im. Jarosława Iwaszkiewicza|Sochaczew|ul. Chodakowska 16 |96-500 Sochaczew;1324;486;486;9;477;36.71;1.85
96033;142801;Szpital Powiatowy|Sochaczew|Batalionów Chłopskich 3/7 |96-500 Sochaczew;109;48;48;1;47;44.04;2.08
96034;142801;Pawilon Psychiatryczny Szpitala Powiatowego|Sochaczew|Batalionów Chłopskich 3/7A |96-500 Sochaczew;62;28;28;3;25;45.16;10.71
96035;142801;Dom Kapłana Seniora|Sochaczew|ul. Stanisława Staszica 39 |96-500 Sochaczew;31;28;28;0;28;90.32;0.00
96036;142802;Szkoła Podstawowa|Brochów| 27 |05-088 Brochów;631;291;291;10;281;46.12;3.44
96037;142802;Urząd Gminy|Brochów| 125 |05-088 Brochów;878;336;336;27;309;38.27;8.04
96038;142802;Publiczne Gimnazjum|Lasocin| 3 |05-088 Brochów;1024;472;472;11;461;46.09;2.33
96039;142802;Szkoła Podstawowa|Śladów| 101 |05-088 Brochów;987;389;389;11;378;39.41;2.83
96040;142803;Gimnazjum im. Jana Pawła II|Iłów|Płocka 14 |96-520 Iłów;959;405;405;19;386;42.23;4.69
96041;142803;Gminny Ośrodek Kultury|Iłów|ul. Płocka 8 |96-520 Iłów;1227;654;654;11;643;53.30;1.68
96042;142803;Szkoła Podstawowa im. Bolesława Chrobrego|Kaptury| 5 |96-521 Brzozów Stary;674;290;290;8;282;43.03;2.76
96043;142803;Szkoła Podstawowa im. Cichociemnych|Brzozów Stary| 67 |96-521 Brzozów Stary;825;419;419;12;407;50.79;2.86
96044;142803;Szkoła Podstawowa im. Cichociemnych|Brzozów Stary| 67 |96-521 Brzozów Stary;579;259;259;11;248;44.73;4.25
96045;142803;Szkoła Podstawowa w Giżycach|Giżyce| 10A |96-521 Brzozów Stary;681;316;316;12;304;46.40;3.80
96046;142804;Gimnazjum w Młodzieszynie|Młodzieszyn|ul. Wspólna 13A |96-512 Młodzieszyn;911;411;411;10;401;45.12;2.43
96047;142804;Gminny Ośrodek Kultury w Młodzieszynie|Młodzieszyn|ul. Wyszogrodzka 25 |96-512 Młodzieszyn;1254;564;564;18;546;44.98;3.19
96048;142804;Szkoła Podstawowa w Kamionie|Kamion Poduchowny| 9 |96-512 Młodzieszyn;1065;454;454;9;445;42.63;1.98
96049;142804;Szkoła Podstawowa w Janowie|Janów| 71A |96-512 Młodzieszyn;602;230;230;7;223;38.21;3.04
96050;142804;Budynek po byłej Szkole Podstawowej w Mistrzewicach|Mistrzewice| 36 |96-512 Młodzieszyn;574;219;219;5;214;38.15;2.28
96051;142804;Dom Pomocy Społecznej w Młodzieszynie|Młodzieszyn|ul. Wyszogrodzka 101 |96-512 Młodzieszyn;77;33;33;4;29;42.86;12.12
96052;142805;Zespół Szkół w Kozłowie Szlacheckim|Kozłów Szlachecki| 54 |96-513 Nowa Sucha;963;399;399;10;389;41.43;2.51
96053;142805;Zespół Szkół|Kozłów Biskupi|ul. Olimpijska 1 |96-513 Nowa Sucha;1178;672;672;5;667;57.05;0.74
96054;142805;Zespół Szkół|Kozłów Biskupi|ul. Olimpijska 1 |96-513 Nowa Sucha;1010;441;441;14;427;43.66;3.17
96055;142805;Zespół Szkół|Nowa Sucha| 16 |96-513 Nowa Sucha;1166;549;549;15;534;47.08;2.73
96056;142805;Szkoła Podstawowa im.ks. Jana Twardowskiego|Kurdwanów| 35 |96-513 Nowa Sucha;865;377;378;13;364;43.58;3.45
96057;142806;Zespół Szkół w Erminowie|Erminów| 1 |96-514 Rybno;763;348;348;13;335;45.61;3.74
96058;142806;Zespół Szkół w Rybnie|Rybno|ul. Długa 11 |96-514 Rybno;703;316;316;6;310;44.95;1.90
96059;142806;Zespół Szkół w Rybnie|Rybno|ul. Długa 11 |96-514 Rybno;761;390;390;17;373;51.25;4.36
96060;142806;Ochotnicza Straż Pożarna w Wężykach|Wężyki| 29 |96-514 Rybno;531;225;225;4;221;42.37;1.78
96061;142807;Gimnazjum|Wymysłów| 17 |96-500 Sochaczew;447;245;245;15;230;54.81;6.12
96062;142807;Szkoła Podstawowa|Feliksów| 20 |96-500 Sochaczew;1208;570;570;19;551;47.19;3.33
96063;142807;Zespół Szkół|Wyczółki| 21A |96-500 Sochaczew;963;435;435;8;427;45.17;1.84
96064;142807;Świetlica Wiejska|Czyste| 11A |96-500 Sochaczew;1044;491;491;13;478;47.03;2.65
96065;142807;Zespół Szkół|Kąty| 74B |96-500 Sochaczew;1130;611;611;13;598;54.07;2.13
96066;142807;Szkoła Podstawowa|Żuków| 104A |96-500 Sochaczew;1109;529;529;17;512;47.70;3.21
96067;142807;Szkoła Podstawowa|Mokas| 26 |96-500 Sochaczew;570;222;222;13;209;38.95;5.86
96068;142807;Zespół Szkół|Kąty| 74B |96-500 Sochaczew;1555;801;801;15;786;51.51;1.87
96069;142808;Gimnazjum w Teresinie|Teresin|ul. Al. XX-lecia 2 |96-515 Teresin;1144;675;675;15;660;59.00;2.22
96070;142808;Gimnazjum w Teresinie|Teresin|ul. Al. XX-lecia 2 |96-515 Teresin;1204;672;672;12;660;55.81;1.79
96071;142808;Gimnazjum w Teresinie|Teresin|ul. Aleja XX-lecia 2 |96-515 Teresin;1139;667;667;16;651;58.56;2.40
96072;142808;Szkoła Podstawowa|Budki Piaseckie| 17 |96-516 Szymanów;853;316;316;26;290;37.05;8.23
96073;142808;Szkoła Podstawowa|Szymanów|ul.Szkolna 35 |96-516 Szymanów;1132;555;555;32;523;49.03;5.77
96074;142808;Szkoła Podstawowa|Paprotnia|Sochaczewska 10 |96-515 Teresin;1341;798;798;14;784;59.51;1.75
96075;142808;Szkoła Podstawowa|Paprotnia|Sochaczewska 10 |96-515 Teresin;1025;502;502;16;486;48.98;3.19
96076;142808;Szkoła Podstawowa|Paprotnia|Sochaczewska 10 |96-515 Teresin;1180;549;549;16;533;46.53;2.91
96077;142901;Publiczne Gimnazjum Nr 2|Sokołów Podlaski|Repkowska 3 |08-300 Sokołów Podlaski;1996;1047;1047;11;1036;52.45;1.05
96078;142901;Szkoła Podstawowa Nr 4|Sokołów Podlaski|Kupientyńska 15 |08-300 Sokołów Podlaski;2124;1303;1303;20;1283;61.35;1.53
96079;142901;Spółdzielnia Inwalidów "Chegos"|Sokołów Podlaski|Lipowa 52 |08-300 Sokołów Podlaski;2207;1306;1306;22;1284;59.18;1.68
96080;142901;Publiczne Gimnazjum Nr 1|Sokołów Podlaski|Skłodowskiej-Curie 16 |08-300 Sokołów Podlaski;1740;947;947;31;916;54.43;3.27
96081;142901;Sokołowski Ośrodek Kultury|Sokołów Podlaski|Wolności 27 |08-300 Sokołów Podlaski;2181;1320;1320;57;1263;60.52;4.32
96082;142901;Liceum Ogólnokształcące|Sokołów Podlaski|Sadowa 11 |08-300 Sokołów Podlaski;1889;1109;1109;23;1086;58.71;2.07
96083;142901;Spółdzielnia Mieszkaniowa|Sokołów Podlaski|Księdza Bosco 10 |08-300 Sokołów Podlaski;1107;645;645;10;635;58.27;1.55
96084;142901;Szkoła Podstawowa Nr 2|Sokołów Podlaski|Węgrowska 22 |08-300 Sokołów Podlaski;1841;1027;1027;16;1011;55.78;1.56
96085;142901;Szpital Powiatowy im. Zbigniewa Koprowskiego w Sokołowie Podlaskim|Sokołów Podlaski|Księdza Bosco 5 |08-300 Sokołów Podlaski;151;40;40;2;38;26.49;5.00
96086;142902;Sala konferencyjna Urzędu Gminy Bielany|Bielany-Żyłaki|ul. Słoneczna 5B |08-311 Bielany;1118;621;621;6;615;55.55;0.97
96087;142902;Budynek po byłej Szkole Podstawowej w Kożuchowie|Kożuchów| 56A |08-311 Bielany;487;314;314;4;310;64.48;1.27
96088;142902;Świetlica w Patrykozach|Patrykozy|ul. Długa 45A |08-311 Bielany;391;197;197;7;190;50.38;3.55
96089;142902;Zespół Oświatowy im. Sybiraków w Rozbitym Kamieniu|Rozbity Kamień|ul. Wiktora Szajkowskiego 7 |08-311 Bielany;1035;521;521;18;503;50.34;3.45
96090;142903;Zespół Szkół w Ceranowie|Ceranów| 206 |08-322 Ceranów;896;412;412;15;397;45.98;3.64
96091;142903;Remiza OSP w Rytelach - Olechnych|Rytele-Olechny| 65 |08-322 Ceranów;550;246;246;5;241;44.73;2.03
96092;142903;Remiza OSP w Długich Grzymkach|Długie Grzymki| 36 |08-322 Ceranów;514;244;244;6;238;47.47;2.46
96093;142904;Szkoła Podstawowa w Bujałach-Mikoszach|Bujały-Mikosze| 9 |08-304 Jabłonna Lacka;450;285;285;6;279;63.33;2.11
96094;142904;Niepubliczna Szkoła Podstawowa w Czekanowie|Czekanów| 20 |08-304 Jabłonna Lacka;484;228;228;16;212;47.11;7.02
96095;142904;Zespół Szkół w Dzierzbach Włościańskich|Dzierzby Włościańskie| 39 |08-304 Jabłonna Lacka;740;354;354;4;350;47.84;1.13
96096;142904;Remiza OSP Mołożew-Wieś|Mołożew-Wieś| 19 |08-304 Jabłonna Lacka;776;353;353;15;338;45.49;4.25
96097;142904;Samorządowe Przedszkole w Jabłonnie Lackiej|Jabłonna Lacka|ul. Kubusia Puchatka 1 |08-304 Jabłonna Lacka;1509;784;784;12;772;51.95;1.53
96098;142905;Miejsko-Gminny Ośrodek Kultury Kosów Lacki|Kosów Lacki|Słoneczna 4 |08-330 Kosów Lacki;1271;637;637;14;623;50.12;2.20
96099;142905;Publiczna Szkoła Podstawowa Kosów Lacki|Kosów Lacki|Polna 1 |08-330 Kosów Lacki;1057;580;580;10;570;54.87;1.72
96100;142905;Publiczne Gimnazjum Kosów Lacki|Kosów Lacki|Armii Krajowej 6 |08-330 Kosów Lacki;848;345;345;13;332;40.68;3.77
96101;142905;Publiczna Szkoła Podstawowa w Kosowie Lackim Filia Telaki|Telaki| 84 |08-330 Kosów Lacki;477;200;200;9;191;41.93;4.50
96102;142905;Świetlica wiejska Dybów|Dybów| 36 |08-330 Kosów Lacki;682;350;350;11;339;51.32;3.14
96103;142905;Świetlica wiejska Trzciniec Duży|Trzciniec Duży| 31 B |08-330 Kosów Lacki;597;245;245;7;238;41.04;2.86
96104;142905;Publiczna Szkoła Podstawowa w Kosowie Lackim Filia Rytele Święckie|Rytele Święckie| 111 |08-330 Kosów Lacki;295;158;158;12;146;53.56;7.59
96105;142906;Urząd Gminy Repki w Repkach|Repki|ul. Parkowa 7 |08-307 Repki;1417;740;742;18;722;52.22;2.43
96106;142906;Remiza OSP Rogów|Rogów| 21 |08-307 Repki;529;253;253;9;244;47.83;3.56
96107;142906;Zespół Szkół w Skrzeszewie|Skrzeszew| 98 |08-307 Repki;1234;568;568;18;550;46.03;3.17
96108;142906;Remiza OSP Wyrozęby-Podawce|Wyrozęby-Podawce| 15 |08-307 Repki;763;471;471;9;462;61.73;1.91
96109;142906;Remiza OSP Sawice-Wieś|Sawice-Wieś| 6 |08-307 Repki;572;374;374;11;363;65.38;2.94
96110;142906;SAWIMED Sp. z o.o.|Sawice-Wieś| 19 |08-307 Repki;50;39;39;3;36;78.00;7.69
96111;142907;Wiejski Dom Kultury w Kupientynie|Kupientyn| 98 |08-331 Sabnie;434;234;234;7;227;53.92;2.99
96112;142907;Szkoła Podstawowa w Sabniach|Sabnie|ul.Słoneczna 1 |08-331 Sabnie;1155;563;563;15;548;48.74;2.66
96113;142907;Szkoła Podstawowa w Zembrowie|Zembrów| 23 |08-331 Sabnie;1164;522;522;14;508;44.85;2.68
96114;142907;Niepubliczna Szkoła Podstawowa w Niecieczy Włościańskiej|Nieciecz Włościańska| 30 |08-331 Sabnie;461;262;262;10;252;56.83;3.82
96115;142908;Budynek Urzędu Gminy w Sokołowie Podlaskim|Sokołów Podlaski|Wolności 44 |08-300 Sokołów Podlaski;1011;483;483;7;476;47.77;1.45
96116;142908;Świetlica wiejska w Ząbkowie-Kolonii|Ząbków-Kolonia| 6 |08-300 Sokołów Podlaski;408;191;191;7;184;46.81;3.66
96117;142908;Zespół Oświatowy w Nowej Wsi|Nowa Wieś|Szkolna 2 |08-300 Sokołów Podlaski;734;333;333;12;321;45.37;3.60
96118;142908;Zespół Oświatowy w Skibniewie|Skibniew-Podawce|Szkolna 8 |08-300 Sokołów Podlaski;754;384;384;24;360;50.93;6.25
96119;142908;Zespół Oświatowy w Grochowie|Grochów Włościański|Władysława Rawicza 1 |08-300 Sokołów Podlaski;803;429;429;13;416;53.42;3.03
96120;142908;Niepubliczna Szkoła Podstawowa w Przywózkach|Przywózki|Szkolna 3 |08-300 Sokołów Podlaski;668;331;331;9;322;49.55;2.72
96121;142908;Oddział Zamiejscowy Publicznego Przedszkola oraz Filii Publicznej Szkoły Podstawowej w Grochowie|Czerwonka| 39 |08-300 Sokołów Podlaski;581;317;317;10;307;54.56;3.15
96122;142909;Zespół Szkół w Sterdyni|Sterdyń|ul.Wojska Polskiego 17 |08-320 Sterdyń;900;428;428;9;419;47.56;2.10
96123;142909;Zespół Szkół w Sterdyni|Sterdyń|ul.Wojska Polskiego 17 |08-320 Sterdyń;868;380;380;12;368;43.78;3.16
96124;142909;Szkoła Podstawowa w Łazowie|Łazów| 7 |08-320 Sterdyń;788;393;393;9;384;49.87;2.29
96125;142909;Remiza OSP w Kiełpińcu|Kiełpiniec| 47 |08-320 Sterdyń;576;269;269;18;251;46.70;6.69
96126;142909;Remiza OSP w Starym Ratyńcu|Stary Ratyniec| 4 |08-320 Sterdyń;399;212;212;5;207;53.13;2.36
96127;143001;Publiczna Szkoła Podstawowa w Chlewiskach|Chlewiska|ul. Szklona 6 |26-510 Chlewiska;1419;566;566;39;527;39.89;6.89
96128;143001;Świetlica Wiejska w Hucie|Huta| 45B |26-510 Chlewiska;504;210;210;18;192;41.67;8.57
96129;143001;Świetlica Wiejska w Stefankowie|Stefanków| 24B |26-510 Chlewiska;677;261;261;16;245;38.55;6.13
96130;143001;Świetlica Wiejska w Ostałowie|Ostałów| 65 |26-510 Chlewiska;715;255;255;15;240;35.66;5.88
96131;143001;Świetlica Wiejska w Pawłowie|Pawłów| 232 |26-510 Chlewiska;663;268;268;18;250;40.42;6.72
96132;143001;Publiczna Szkoła Podstawowa w Budkach|Budki II| 1 |26-500 Szydłowiec;548;190;190;13;177;34.67;6.84
96133;143001;Publiczna Szkoła Podstawowa w Cukrówce|Cukrówka| 57A |26-510 Chlewiska;683;307;307;21;286;44.95;6.84
96134;143002;Zespół Szkół Publicznych w Jastrzębiu|Jastrząb|ul. Kościuszki 51 b |26-502 Jastrząb;2302;1110;1110;44;1066;48.22;3.96
96135;143002;Publiczna Szkoła Podstawowa w Gąsawach Rządowych|Gąsawy Rządowe| 144 A |26-502 Jastrząb;983;466;466;18;448;47.41;3.86
96136;143002;Publiczna Szkoła Podstawowa w Woli Lipienieckiej Dużej|Wola Lipieniecka Duża| 41 |26-502 Jastrząb;932;348;348;8;340;37.34;2.30
96137;143003;Urząd Gminy Mirów|Mirów Stary| 27 |26-503 Mirów Stary;1240;539;539;42;497;43.47;7.79
96138;143003;Zespół Szkolno-Przedszkolny w Zbijowie Małym Nr 1|Zbijów Mały| 1 |26-503 Mirów Stary;572;291;291;19;272;50.87;6.53
96139;143003;Publiczna Szkoła Podstawowa w Bieszkowie Dolnym|Bieszków Dolny| 87 |26-503 Mirów Stary;1202;516;516;44;472;42.93;8.53
96140;143004;Publiczne Gimnazjum w Orońsku|Orońsko|ul. Szkolna 3 |26-505 Orońsko;2206;1055;1055;34;1021;47.82;3.22
96141;143004;Dom Pomocy Społecznej w Łaziskach|Łaziska| 15a |26-505 Orońsko;633;236;236;14;222;37.28;5.93
96142;143004;Publiczna Szkoła Podstawowa w Wałsnowie|Wałsnów| 22a |26-505 Orońsko;586;264;264;16;248;45.05;6.06
96143;143004;Świetlica w Tomaszowie|Tomaszów| 44b |26-505 Orońsko;371;199;199;5;194;53.64;2.51
96144;143004;Publiczna Szkoła Podstawowa w Guzowie|Guzów| 20a |26-505 Orońsko;879;400;400;29;371;45.51;7.25
96145;143005;Liceum Ogólnokształcące im. Henryka Sienkiewicza w Szydłowcu|Szydłowiec|ul. Zamkowa 1 |26-500 Szydłowiec;1840;983;983;27;956;53.42;2.75
96146;143005;Szydłowieckie Centrum Kultury i Sportu - Zamek|Szydłowiec|ul. Gen. Józefa Sowińskiego 2 |26-500 Szydłowiec;1812;821;821;31;790;45.31;3.78
96147;143005;Publiczne Gimnazjum Nr 2 im. Mikołaja Kopernika w Szydłowcu|Szydłowiec|ul. Folwarczna 4 |26-500 Szydłowiec;1743;887;887;23;864;50.89;2.59
96148;143005;Publiczna Szkoła Podstawowa Nr 1 z Oddziałami Integracyjnymi im. Jana III Sobieskiego w Szydłowcu|Szydłowiec|ul. Wschodnia 19 |26-500 Szydłowiec;1752;918;918;17;901;52.40;1.85
96149;143005;Zespół Szkół im. Jana Pawła II w Szydłowcu|Szydłowiec|ul. Wschodnia 57 |26-500 Szydłowiec;1601;789;789;21;768;49.28;2.66
96150;143005;Przedszkole Samorządowe Nr 2 w Szydłowcu|Szydłowiec|ul. Stanisława Staszica 3a |26-500 Szydłowiec;1774;844;844;28;816;47.58;3.32
96151;143005;Zespół Szkół im. KOP w Szydłowcu|Szydłowiec|ul. Tadeusza Kościuszki 39 |26-500 Szydłowiec;748;321;321;13;308;42.91;4.05
96152;143005;Zespół Szkół im. Jana Pawła II w Szydłowcu Filia w Zdziechowie|Zdziechów| 4 |26-500 Szydłowiec;777;370;370;11;359;47.62;2.97
96153;143005;Publiczna Szkoła Podstawowa im. Janusza Kusocińskiego w Sadku|Sadek| 170 |26-500 Szydłowiec;748;331;331;23;308;44.25;6.95
96154;143005;Publiczna Szkoła Podstawowa im. Gen. Stefana Roweckiego w Wysokiej|Wysoka| 37 |26-500 Szydłowiec;1008;397;397;15;382;39.38;3.78
96155;143005;Publiczna Szkoła Podstawowa im. Biskupa Jana Chrapka w Majdowie|Majdów| 30 |26-500 Szydłowiec;1432;589;589;33;556;41.13;5.60
96156;143201;LKS "Olymp"|Błonie|ul. Lesznowska 15A |05-870 Błonie;1323;813;813;13;800;61.45;1.60
96157;143201;Szkoła Podstawowa Nr 2 w Błoniu|Błonie|ul. Narutowicza 21 |05-870 Błonie;1784;977;977;23;954;54.76;2.35
96158;143201;Gimnazjum Nr 2 w Błoniu|Błonie|ul. Narutowicza 4 |05-870 Błonie;1865;1008;1009;15;993;54.05;1.49
96159;143201;Centrum Kultury w Błoniu|Błonie|ul. Jana Pawła II 1B |05-870 Błonie;1393;769;769;12;757;55.20;1.56
96160;143201;Przedszkole Publiczne Nr 2 w Błoniu|Błonie|ul. Piłsudskiego 25A |05-870 Błonie;1465;799;799;20;779;54.54;2.50
96161;143201;Szkoła Podstawowa Nr 1 w Błoniu|Błonie|ul. Poniatowskiego 19 |05-870 Błonie;1480;900;900;14;886;60.81;1.56
96162;143201;Zespół Szkół Nr 1 w Błoniu|Błonie, Łąki|ul. Łąki 2 |05-870 Błonie;634;419;421;8;411;66.09;1.91
96163;143201;Zespół Szkół Nr 1 w Błoniu|Błonie, Łąki|ul. Łąki 2 |05-870 Błonie;728;397;397;3;394;54.53;0.76
96164;143201;Dom Kultury w Radzikowie|Radzików|Nr 52 |05-870 Błonie;1410;794;794;23;771;56.31;2.90
96165;143201;Dom Pomocy Społecznej w Bramkach|Bramki|ul. Północna 18 |05-870 Błonie;854;436;436;11;425;51.05;2.52
96166;143201;OSP Górna Wieś|Górna Wieś|Nr 27 |05-870 Błonie;792;361;361;9;352;45.58;2.49
96167;143201;Zespół Szkół w Bieniewicach|Bieniewice|ul. Błońska 62 |05-870 Błonie;1189;665;665;8;657;55.93;1.20
96168;143201;Zespół Szkół w Bieniewicach|Bieniewice|ul. Błońska 62 |05-870 Błonie;1800;888;889;14;874;49.33;1.58
96169;143202;Gminne Przedszkole w Laskach|Laski|ul. 3 Maja 43 |05-080 Izabelin;2030;1302;1304;11;1291;64.14;0.84
96170;143202;Szkoła Podstawowa|Hornówek|ul. Wojska Polskiego 5 |05-080 Izabelin;842;610;610;6;604;72.45;0.98
96171;143202;Szkoła Podstawowa|Hornówek|ul. Wojska Polskiego 5 |05-080 Izabelin;1425;996;996;9;987;69.89;0.90
96172;143202;Centrum Kultury Izabelin|Izabelin C|ul. Matejki 21 |05-080 Izabelin;2165;1587;1587;15;1572;73.30;0.95
96173;143202;Szkoła Podstawowa|Izabelin C|ul. 3 Maja 49 |05-080 Izabelin;1696;990;990;13;977;58.37;1.31
96174;143203;Gimnazjum z Oddziałami Integracyjnymi w Kampinosie|Kampinos|Szkolna 5 |05-085 Kampinos;2056;1106;1106;26;1080;53.79;2.35
96175;143203;Remiza OSP|Zawady| 22 |05-085 Kampinos;1458;694;694;24;670;47.60;3.46
96176;143204;Urząd Gminy w Lesznie|Leszno|Aleja Wojska Polskiego 21 |05-084 Leszno;1504;758;758;20;738;50.40;2.64
96177;143204;Zespół Szkół Publicznych w Lesznie|Leszno|ul. Leśna 13 |05-084 Leszno;1511;819;819;21;798;54.20;2.56
96178;143204;Świetlica w Łubcu|Łubiec| 29a |05-084 Leszno;438;225;225;3;222;51.37;1.33
96179;143204;Przedszkole w Czarnowie|Czarnów| 8 |05-084 Leszno;1704;860;860;16;844;50.47;1.86
96180;143204;Przedszkole w Zaborowie|Zaborów|ul. Szkolna 6 |05-083 Zaborów;956;568;568;9;559;59.41;1.58
96181;143204;Ochotnicza Straż Pożarna w Zaborowie|Zaborów|ul. Stołeczna 180 |05-083 Zaborów;1627;940;940;21;919;57.78;2.23
96182;143205;Przedszkole Niepubliczne Zgromadzenia Sióstr NPNMP|Łomianki|ul. Jana III Sobieskiego 2 |05-092 Łomianki;1197;741;741;13;728;61.90;1.75
96183;143205;Budynek komunalny|Łomianki|ul. Akacjowa 20 |05-092 Łomianki;2013;1451;1455;9;1442;72.08;0.62
96184;143205;Przedszkole Samorządowe|Łomianki|ul. Kolejowa 51 |05-092 Łomianki;1696;1180;1180;16;1164;69.58;1.36
96185;143205;Szkoła Podstawowa nr 1|Łomianki|ul.Warszawska 73 |05-092 Łomianki;2101;1467;1467;20;1447;69.82;1.36
96186;143205;Integracyjne Centrum Dydaktyczno-Sportowe|Łomianki|ul. Stanisława Staszica 2 |05-092 Łomianki;1390;1025;1025;13;1012;73.74;1.27
96187;143205;Szkoła Podstawowa nr 1|Łomianki|ul. Warszawska 73 |05-092 Łomianki;1864;1343;1344;11;1332;72.05;0.82
96188;143205;Dom Kultury|Łomianki|ul.Wiejska 12a |05-092 Łomianki;1254;802;802;8;794;63.96;1.00
96189;143205;Dom Kultury|Łomianki|ul.Wiejska 12a |05-092 Łomianki;1649;1113;1113;8;1105;67.50;0.72
96190;143205;Biblioteka Publiczna|Łomianki|ul. Wiejska 12a |05-092 Łomianki;971;758;758;4;754;78.06;0.53
96191;143205;Inegracyjne Centrum Dydaktyczno-Sportowe|Łomianki|ul. Stanisława Staszica 2 |05-092 Łomianki;1299;909;909;15;894;69.98;1.65
96192;143205;Szkoła Podstawowa|Dziekanów Polski|ul.Rolnicza 435 |05-092 Łomianki;1704;1142;1142;19;1123;67.02;1.66
96193;143205;Szkoła Podstawowa|Dziekanów Leśny|ul. por. Francisa Akinsa 6 |05-092 Łomianki;1243;770;770;15;755;61.95;1.95
96194;143205;Szkoła Podstawowa|Sadowa|ul. Strzelecka 35 |05-092 Łomianki;657;360;361;23;337;54.79;6.39
96195;143206;Przedszkole Nr 1 w Ożarowie Mazowieckim|Ożarów Mazowiecki|ul. Ożarowska 34 /wejście A/ |05-850 Ożarów Mazowiecki;913;633;633;11;622;69.33;1.74
96196;143206;Gimnazjum w Ożarowie Mazowieckim|Ożarów Mazowiecki|Szkolna 2 |05-850 ;721;415;415;6;409;57.56;1.45
96197;143206;Przedszkole Nr 1|Ożarów Mazowiecki|ul. Ożarowska 34 |05-850 Ożarów Mazowiecki;840;475;475;8;467;56.55;1.68
96198;143206;Szkoła Podstawowa nr 1|Ożarów Mazowiecki|ul. Szkolna 2 |05-850 Ożarów Mazowiecki;660;470;470;7;463;71.21;1.49
96199;143206;Przedszkole /modułowe/|Ożarów Mazowiecki|ul. Szkolna 3 |05-850 Ożarów Mazowiecki;867;625;625;11;614;72.09;1.76
96200;143206;Dom Kultury ''UŚMIECH'' /sala widowiskowa/|Ożarów Mazowiecki|ul. Poznańska 165 |05-850 Ożarów Mazowiecki;746;406;406;11;395;54.42;2.71
96201;143206;Dom Kultury "Uśmiech" /sala klubowa 109/|Ożarów Mazowiecki|ul. Poznańska 165 |05-850 Ożarów Mazowiecki;531;362;362;9;353;68.17;2.49
96202;143206;Przedszkole Publiczne|Ożarów Mazowiecki|Mickiewicza 51 |05-850 Ożarów Mazowiecki;954;589;589;5;584;61.74;0.85
96203;143206;Szkoła Podstawowa Nr 2 /sala gimnastyczna/|Ożarów Mazowiecki|ul. Lipowa 11 |05-850 Ożarów Mazowiecki;953;608;608;8;600;63.80;1.32
96204;143206;Starostwo Powiatu Warszawskiego Zachodniego|Ożarów Mazowiecki|Poznańska 129/133 |05-850 Ożarów Mazowiecki;1077;561;561;13;548;52.09;2.32
96205;143206;Duchnice /Kuźnia/|Ożarów Mazowiecki|Ożarowska 28/30 |05-850 Ożarów Mazowiecki;864;555;555;11;544;64.24;1.98
96206;143206;Szkoła Podstawowa Nr 2 /szkolna stołówka/|Ożarów Mazowiecki|Lipowa 11 |05-850 Ożarów Mazowiecki;631;392;392;11;381;62.12;2.81
96207;143206;Przedszkole Niepubliczne|Macierzysz|Sochaczewska 89 |05-850 Ożarów Mazowiecki;1026;604;604;10;594;58.87;1.66
96208;143206;Filia D.K. Uśmiech Bronisze|Bronisze|ul. Przyparkowa 15 |05-850 Ożarów Mazowiecki;969;570;571;8;562;58.82;1.40
96209;143206;Szkoła Podstawowa|Umiastów|ul. Umiastowska 74 |05-850 Ożarów Mazowiecki;1240;600;600;10;590;48.39;1.67
96210;143206;Szkoła Podstawowa|Święcice|ul. Poznańska 541 |05-860 Płochocin;936;531;531;17;514;56.73;3.20
96211;143206;Szkoła Podstawowa w Święcicach /klasa lekcyjna - na lewo od wejścia/|Święcice|ul. Poznańska 541 |05-860 Płochocin;687;328;328;12;316;47.74;3.66
96212;143206;Filia Dom Kultury ''UŚMIECH'' /sala taneczno-widowiskowa nr 12/|Józefów|Fabryczna 15 |05-860 Płochocin;574;291;291;11;280;50.70;3.78
96213;143206;Filia Dom Kultury "Uśmiech'' /sala taneczno-widowiskowa nr 12/|Józefów|ul. Fabryczna 15 |05-860 Płochocin;508;214;214;7;207;42.13;3.27
96214;143206;Szkoła Podstawowa /od wejścia na lewo-szeroki korytarz/|Płochocin|ul. Lipowa 3 |05-860 Płochocin;909;573;573;13;560;63.04;2.27
96215;143206;Szkoła Podstawowa w Płochocinie /od wejścia na wprost -duży korytarz/|Płochocin|ul. Lipowa 3 |05-860 Płochocin;1027;583;583;13;570;56.77;2.23
96216;143206;Dom Opiekuńczo-Leczniczy w Pilaszkowie|Pilaszków|Nowowiejska 137 |05-860 Płochocin;64;54;54;2;52;84.38;3.70
96217;143207;Przedszkole Gminne|Blizne Jasińskiego|ul. Kościuszki 1 |05-082 Stare Babice;1653;1153;1153;21;1132;69.75;1.82
96218;143207;Urząd Gminy Stare Babice|Stare Babice|ul.Rynek 21 |05-082 Stare Babice;1815;1262;1262;24;1238;69.53;1.90
96219;143207;Szkoła Podstawowa|Stare Babice|ul. Polna 40 |05-082 Stare Babice;2284;1629;1629;17;1612;71.32;1.04
96220;143207;Szkoła Podstawowa|Stare Babice|ul.Polna 40 |05-082 Stare Babice;1760;1149;1149;19;1130;65.28;1.65
96221;143207;Szkoła Podstawowa Stare Babice|Stare Babice|ul.Polna 40 |05-082 Stare Babice;1251;808;808;9;799;64.59;1.11
96222;143207;Gimnazjum|Koczargi Stare|ul.Akacjowa 12 |05-080 Izabelin;1655;1042;1042;18;1024;62.96;1.73
96223;143207;Zespół Szkolno-Przedszkolny|Borzęcin Duży|ul. Warszawska 697 |05-083 Zaborów;1505;833;833;16;817;55.35;1.92
96224;143207;Zespół Szkolno-Przedszkolny|Borzęcin Duży|ul. Warszawska 697 |05-083 Zaborów;1579;809;809;15;794;51.23;1.85
96225;143301;Przedszkole Nr 1|Węgrów|Klonowa 4 |07-100 Węgrów;1998;1025;1025;19;1006;51.30;1.85
96226;143301;Urząd Stanu Cywilnego|Węgrów|Gdańska 2 |07-100 Węgrów;1603;914;914;27;887;57.02;2.95
96227;143301;Gimnazjum|Węgrów|Szamoty 35 |07-100 Węgrów;2354;1244;1244;38;1206;52.85;3.05
96228;143301;Szkoła Podstawowa|Węgrów|Kościuszki 16 |07-100 Węgrów;2126;1228;1228;38;1190;57.76;3.09
96229;143301;Węgrowski Ośrodek Kultury|Węgrów|Mickiewicza 4a |07-100 Węgrów;2264;1236;1236;21;1215;54.59;1.70
96230;143301;Szpital Powiatowy|Węgrów|Kościuszki 201 |07-100 Węgrów;41;25;25;0;25;60.98;0.00
96231;143302;Sala Konferencyjna Urzędu Gminy Grębków|Grębków|ul. Wspólna 5 |07-110 Grębków;1352;580;580;24;556;42.90;4.14
96232;143302;Szkoła Podstawowa im. Henryka Sienkiewicza w Grębkowie|Grębków|ul. Szkolna 1 |07-110 Grębków;907;421;421;23;398;46.42;5.46
96233;143302;Filia Gminnej Biblioteki Publicznej w Kopciach|Kopcie| 19 |07-110 Grębków;992;345;345;8;337;34.78;2.32
96234;143302;Remiza OSP Pobratymy|Pobratymy| 32 |07-110 Grębków;390;207;207;7;200;53.08;3.38
96235;143303;Szkoła Podstawowa w Korytnicy|Korytnica|ul.Henryka Sienkiewicza 14 |07-120 Korytnica;1719;863;863;31;832;50.20;3.59
96236;143303;Szkoła Podstawowa w Maksymilianowie|Maksymilianów| 30 |07-120 Korytnica;693;287;287;17;270;41.41;5.92
96237;143303;Szkoła Podstawowa w Sewerynowie|Sewerynów| 81 |07-120 Korytnica;691;262;262;8;254;37.92;3.05
96238;143303;Szkoła Podstawowa w Pniewniku|Pniewnik| 35 |07-120 Korytnica;1338;680;680;16;664;50.82;2.35
96239;143303;Szkoła Podstawowa w Górkach-Grubakach|Górki-Grubaki| 22a |07-120 Korytnica;747;304;304;17;287;40.70;5.59
96240;143304;Remiza Ochotniczej Straży Pożarnej w Liwie|Liw|Kozia 4 |07-100 Węgrów;1515;788;788;27;761;52.01;3.43
96241;143304;Samorządowa Szkoła Podstawowa w Jartyporach|Jartypory| 145 |07-100 Węgrów;603;261;261;8;253;43.28;3.07
96242;143304;Samorządowa Szkoła Podstawowa w Ruchnie|Ruchna| 73 |07-100 Węgrów;1317;602;602;39;563;45.71;6.48
96243;143304;Samorządowa Szkoła Podstawowa w Starejwsi|Starawieś|Szkolna 1 |07-100 Węgrów;1310;636;636;16;620;48.55;2.52
96244;143304;Samorządowa Szkoła Podstawowa w Wyszkowie|Wyszków| 29A |07-100 Węgrów;905;391;391;12;379;43.20;3.07
96245;143304;Publiczna Szkoła Podstawowa w Jarnicach|Jarnice| 124 |07-100 Węgrów;484;242;242;10;232;50.00;4.13
96246;143305;Zespół Szkół w Gwizdałach|Gwizdały| 89 |07-130 Łochów;1240;556;556;9;547;44.84;1.62
96247;143305;Świetlica wiejska w Łosiewicach|Łosiewice| 61 |07-130 Łochów;803;385;385;15;370;47.95;3.90
96248;143305;Zespół Szkół w Ostrówku|Ostrówek|Szkolna 2 |07-132 Ostówek;1318;710;710;22;688;53.87;3.10
96249;143305;Zespół Szkół w Kamionnie|Kamionna|Szkolna 18 |07-130 Łochów;2256;1131;1131;16;1115;50.13;1.41
96250;143305;Szkoła Podstawowa Nr 1 w Łochowie|Łochów|Żeromskiego 3 |07-130 Łochów;844;375;375;9;366;44.43;2.40
96251;143305;Szkoła Podstawowa Nr 3 w Łochowie|Łochów|1 maja 47 |07-130 Łochów;1375;749;749;11;738;54.47;1.47
96252;143305;Były sklep w Łochowie|Łochów|Fabryczna 11 |07-130 Łochów;724;358;358;18;340;49.45;5.03
96253;143305;Szkoła Podstawowa Nr 3 w Łochowie|Łochów|1 maja 47 |07-130 Łochów;1283;696;696;11;685;54.25;1.58
96254;143305;Gimnazjum Publiczne w Łochowie|Łochów|Wyspiańskiego 20 |07-130 Łochów;1002;428;428;11;417;42.71;2.57
96255;143305;Świetlica wiejska w Ogrodnikach|Ogrodniki| 59 |07-132 Ostrówek;733;328;328;23;305;44.75;7.01
96256;143305;Szkoła Podstawowa Nr 3 w Łochowie|Łochów|1-go Maja 47 |07-130 Łochów;1242;763;763;12;751;61.43;1.57
96257;143305;Liceum Ogólnokształcące w Łochowie|Łochów|Wyspiańskiego 18 |07-130 Łochów;770;422;422;8;414;54.81;1.90
96258;143305;Zespół Szkół w Ostrówku|Ostrówek|Szkolna 2 |07-132 Ostrówek;589;241;241;9;232;40.92;3.73
96259;143305;Samorządowy Dom "Pogodnej Starości w Ostrówku"|Ostrówek|Zaciszna 8 |07-132 Ostrówek;30;14;14;1;13;46.67;7.14
96260;143306;Sala klubowa w GBP w Miedznie|Miedzna|Plac Wolności 8 |07-106 Miedzna;1057;552;552;21;531;52.22;3.80
96261;143306;Sala kinowa w GBP w Miedznie|Miedzna|Plac Wolności 8 |07-106 Miedzna;465;260;260;4;256;55.91;1.54
96262;143306;Dom Ludowy we Wrotnowie|Wrotnów| 71A |07-106 Miedzna;615;235;235;9;226;38.21;3.83
96263;143306;Remiza OSP w Żeleźnikach|Żeleźniki| 31 |07-106 Miedzna;614;303;303;5;298;49.35;1.65
96264;143306;Remiza OSP w Międzylesiu|Międzyleś| 80A |07-106 Miedzna;615;274;274;13;261;44.55;4.74
96265;143307;GOK w Sadownem|Sadowne|ul. Kościuszki 35 |07-140 Sadowne;1062;575;575;18;557;54.14;3.13
96266;143307;Publiczne Gimnazjum w Sadownem|Sadowne|ul. Kościuszki 74 |07-140 Sadowne;1090;504;504;26;478;46.24;5.16
96267;143307;Szkoła Podstawowa w Grabinach|Grabiny| 11 |07-140 Sadowne;783;338;338;13;325;43.17;3.85
96268;143307;Szkoła Podstawowa w Kołodziążu|Kołodziąż| 82 |07-140 Sadowne;756;312;312;6;306;41.27;1.92
96269;143307;Była Szkoła Podstawowa w Morzyczynie|Morzyczyn Włościański| 65 |07-140 Sadowne;701;341;341;21;320;48.64;6.16
96270;143307;Szkoła Podstawowa w Orzełku|Orzełek| 13 |07-140 Sadowne;497;185;185;18;167;37.22;9.73
96271;143308;Szkoła Podstawowa w Grygrowie|Grygrów| 1b |07-104 Stoczek;780;365;365;15;350;46.79;4.11
96272;143308;Strażnica OSP w Mrozowej Woli|Mrozowa Wola| 27 b |07-104 Stoczek;675;271;271;11;260;40.15;4.06
96273;143308;Gimnazjum w Stoczku|Stoczek|ul. Armii Krajowej 1 |07-104 Stoczek;1119;448;448;14;434;40.04;3.12
96274;143308;Gimnazjum w Stoczku|Stoczek|Armii Krajowej 1 |07-104 Stoczek;1119;561;561;13;548;50.13;2.32
96275;143308;Szkoła Podstawowa w Toporze|Topór| 54 |07-104 Stoczek;421;221;221;12;209;52.49;5.43
96276;143308;Samorządowy Dom Pomocy Społecznej w Starych Lipkach|Stare Lipki| 65 |07-104 Stoczek;22;16;16;2;14;72.73;12.50
96277;143309;Zespół Szkół w Wierzbnie|Wierzbno| 48 |07-111 Wierzbno;603;290;290;15;275;48.09;5.17
96278;143309;Zespół Szkół w Krypach|Krypy| 59 |07-111 Wierzbno;589;313;313;15;298;53.14;4.79
96279;143309;Sala konferencyjna Urzędu Gminy w Wierzbnie|Wierzbno| 90 |07-111 Wierzbno;626;231;231;12;219;36.90;5.19
96280;143309;Świetlica wiejska w Czerwonce-Folwark|Czerwonka-Folwark| 25 |07-111 Wierzbno;606;240;240;15;225;39.60;6.25
96281;143401;Zespół Szkół Publicznych Nr 1|Kobyłka|ul. Jezuicka 1 |05-230 Kobyłka;1052;598;599;11;587;56.84;1.84
96282;143401;Zespół Szkół Publicznych Nr 1|Kobyłka|ul. Jezuicka 1 |05-230 Kobyłka;1469;857;857;13;844;58.34;1.52
96283;143401;Zespół Szkół Publicznych Nr 3|Kobyłka|ul. Ks. Marcina Załuskiego 57 |05-230 Kobyłka;1379;904;904;10;894;65.55;1.11
96284;143401;Zespół Szkół Publicznych Nr 3|Kobyłka|ul. Ks. Marcina Załuskiego 57 |05-230 Kobyłka;607;391;391;8;383;64.42;2.05
96285;143401;Zespół Szkół Publicznych Nr 3|Kobyłka|ul. Ks. Marcina Załuskiego 57 |05-230 Kobyłka;1261;839;839;9;830;66.53;1.07
96286;143401;Publiczne Przedszkole Nr 1|Kobyłka|ul. Gen. Tadeusza Kościuszki 6 |05-230 Kobyłka;726;460;460;6;454;63.36;1.30
96287;143401;Zespół Szkół Publicznych Nr 1|Kobyłka|ul. Jezuicka 1 |05-230 Kobyłka;873;524;524;7;517;60.02;1.34
96288;143401;Stadion Sportowy|Kobyłka|ul. Napoleona 2A |05-230 Kobyłka;819;524;524;9;515;63.98;1.72
96289;143401;Miejski Ośrodek Kultury|Kobyłka|ul. Aleja Jana Pawła II 22 |05-230 Kobyłka;1651;1093;1093;15;1078;66.20;1.37
96290;143401;Urząd Miasta|Kobyłka|ul. Wołomińska 1 |05-230 Kobyłka;1381;928;928;14;914;67.20;1.51
96291;143401;Stadion Sportowy|Kobyłka|ul. Napoleona 2A |05-230 Kobyłka;1583;958;958;14;944;60.52;1.46
96292;143401;Miejski Ośrodek Kultury|Kobyłka|ul. Aleja Jana Pawła II 22 |05-230 Kobyłka;1103;712;712;7;705;64.55;0.98
96293;143401;Zespół Szkół Publicznych Nr 2|Kobyłka|ul. Elizy Orzeszkowej 3/5 |05-230 Kobyłka;865;565;565;12;553;65.32;2.12
96294;143401;Zespół Szkół Publicznych Nr 2|Kobyłka|ul. Elizy Orzeszkowej 3/5 |05-230 Kobyłka;838;549;549;5;544;65.51;0.91
96295;143401;Zespół Szkół Publicznych Nr 2|Kobyłka|ul. Elizy Orzeszkowej 3/5 |05-230 Kobyłka;869;572;572;3;569;65.82;0.52
96296;143402;Szkoła Podstawowa Nr 2|Marki|ul. Szkolna 9 |05-270 Marki;1642;941;941;3;938;57.31;0.32
96297;143402;Szkoła Podstawowa Nr 2|Marki|ul. Szkolna 9 |05-270 Marki;1861;1124;1124;20;1104;60.40;1.78
96298;143402;Zespół Szkół nr 1|Marki|Al. Piłsudskiego 96 |05-270 Marki;1163;603;603;9;594;51.85;1.49
96299;143402;Zespól Szkół Nr 1|Marki|Al. Piłsudskiego 96 |05-270 Marki;1366;857;857;19;838;62.74;2.22
96300;143402;Szkoła Podstawowa Nr 4|Marki|ul.Duża 3 |05-270 Marki;1807;1009;1009;20;989;55.84;1.98
96301;143402;Szkoła Podstawowa Nr 4|Marki|ul.Duża 3 |05-270 Marki;1588;795;796;10;785;50.06;1.26
96302;143402;Zespół Szkół Nr 2|Marki|ul.Wczasowa 5 |05-270 Marki;1937;1250;1250;16;1234;64.53;1.28
96303;143402;Zespół Szkól Nr 2|Marki|ul.Wczasowa 5 |05-260 Marki;1394;864;864;7;857;61.98;0.81
96304;143402;Szkoła Podstawowa Nr 3|Marki|ul.Pomnikowa 21 |05-260 Marki;1441;878;878;10;868;60.93;1.14
96305;143402;Szkoła Podstawowa nr 3|Marki|ul. Pomnikowa 21 |05-260 Marki;2090;1150;1150;13;1137;55.02;1.13
96306;143402;Zespół Szkół Nr 1 - Dom Katolicki|Marki|al. Piłsudskiego 93 |05-270 Marki;1098;603;603;12;591;54.92;1.99
96307;143402;Zespół Szkół Nr 1 - Dom Katolicki|Marki|al.Piłsudskiego 93 |05-270 Marki;1521;910;912;10;900;59.83;1.10
96308;143402;Szkoła Podstawowa Nr 1|Marki|ul.Okólna 14 |05-270 Marki;1374;865;865;4;861;62.95;0.46
96309;143402;Szkoła Podstawowa Nr 1|Marki|ul.Okólna 14 |05-270 Marki;1599;959;959;13;946;59.97;1.36
96310;143403;Gimnazjum Publiczne Nr 2|Ząbki|Batorego 37 |05-091 Ząbki;1900;1220;1220;15;1205;64.21;1.23
96311;143403;Publiczna Szkoła Katolicka|Ząbki|11 Listopada 4 |05-091 Ząbki;2297;1496;1496;22;1474;65.13;1.47
96312;143403;Urząd Stanu Cywilnego|Ząbki|Wojska Polskiego 10 |05-091 Ząbki;1653;1076;1076;23;1053;65.09;2.14
96313;143403;Szkoła Podstawowa nr 2|Ząbki|Batorego 11 |05-091 Ząbki;2308;1460;1460;27;1433;63.26;1.85
96314;143403;Szkoła Podstawowa nr 1|Ząbki|Piłsudskiego 35 |05-091 Ząbki;2112;1210;1210;18;1192;57.29;1.49
96315;143403;Publiczne Przedszkole nr 3|Ząbki|Westerplatte 1/11 |05-091 Ząbki;1367;840;840;20;820;61.45;2.38
96316;143403;Miejski Ośrodek Sportu i Rekreacji|Ząbki|Słowackiego 21 |05-091 Ząbki;2278;1436;1437;19;1417;63.04;1.32
96317;143403;Gimnazjum Publiczne nr 1|Ząbki|Harcerska 9 |05-091 Ząbki;2035;1284;1286;14;1270;63.10;1.09
96318;143403;Szkoła Podstawowa Nr 3|Ząbki|Kościelna 2 |05-091 Ząbki;1228;715;715;14;701;58.22;1.96
96319;143403;Szkoła Podstawowa Nr 3|Ząbki|Kościelna 2 |05-091 Ząbki;1116;707;707;11;696;63.35;1.56
96320;143403;Filia Szkoły Podstawowej Nr 3|Ząbki|Powstańców 60 |05-091 Ząbki;1529;1037;1037;7;1030;67.82;0.68
96321;143403;Szkoła Podstawowa nr 3|Ząbki|Kościelna 2 |05-091 Ząbki;1249;745;745;12;733;59.65;1.61
96322;143403;Szkoła Podstawowa nr 3|Ząbki|Kościelna 2 |05-091 Ząbki;1214;767;767;10;757;63.18;1.30
96323;143403;Filia Szkoły Podstawowej nr 3|Ząbki|Powstańców 60 |05-091 Ząbki;1146;751;751;11;740;65.53;1.46
96324;143403;Mazowieckie Centrum Psychiatrii DREWNICA Sp.z o.o.|Ząbki|Rychlińskiego 1 |05-091 Ząbki;139;104;104;16;88;74.82;15.38
96325;143404;Miejskie Przedszkole Nr 5|Zielonka|ul. Wyszyńskiego 7 |05-220 Zielonka;1099;740;741;8;732;67.33;1.08
96326;143404;Szkoła Podstawowa Nr 3|Zielonka|ul. Wilsona 34/36 |05-220 Zielonka;903;612;612;4;608;67.77;0.65
96327;143404;Szkoła Podstawowa Nr 3|Zielonka|ul. Wilsona 34/36 |05-220 Zielonka;1826;1301;1301;19;1282;71.25;1.46
96328;143404;Szkoła Podstawowa Nr 1|Zielonka|ul. Staszica 56 |05-220 Zielonka;1624;1069;1069;14;1055;65.83;1.31
96329;143404;Miejski Ośrodek Zdrowia|Zielonka|ul. Mickiewicza 18 |05-220 Zielonka;833;587;587;9;578;70.47;1.53
96330;143404;Miejskie Gimnazjum|Zielonka|ul. Łukasińskiego 1/3 |05-220 Zielonka;1047;730;730;16;714;69.72;2.19
96331;143404;Urząd Miasta|Zielonka|ul. Lipowa 5 |05-220 Zielonka;1904;1213;1213;18;1195;63.71;1.48
96332;143404;Szkoła Podstawowa Nr 2|Zielonka|ul. Powstańców 3 |05-220 Zielonka;1610;943;943;19;924;58.57;2.01
96333;143404;Szkoła Podstawowa Nr 2|Zielonka|ul. Powstańców 3 |05-220 Zielonka;623;398;398;3;395;63.88;0.75
96334;143404;Zespół Szkół|Zielonka|Inżynierska 1 |05-220 Zielonka;1971;1228;1228;14;1214;62.30;1.14
96335;143404;Dom Pomocy Społecznej|Zielonka|Józefa Poniatowskiego 29 |05-220 Zielonka;59;36;36;5;31;61.02;13.89
96336;143405;Publiczna Szkoła Podstawowa|Dąbrówka|Tadeusza Kościuszki 20 |05-252 Dąbrówka;1210;685;685;15;670;56.61;2.19
96337;143405;Publiczna Szkoła Podstawowa|Guzowatka| 81 |05-252 Dąbrówka;855;411;411;21;390;48.07;5.11
96338;143405;Zespół Szkół|Józefów|Kościelna 2 |05-254 Dąbrówka;1203;665;665;21;644;55.28;3.16
96339;143405;Wiejski Ośrodek Zdrowia|Kuligów|Warszawska 5 |05-254 Dąbrówka;417;204;204;7;197;48.92;3.43
96340;143405;Publiczna Szkoła Podstawowa|Wszebory|Trakt Napoleoński 45 |05-252 Dąbrówka;835;425;425;14;411;50.90;3.29
96341;143405;Remiza OSP|Zaścienie| 24 |05-252 Dąbrówka;314;167;167;4;163;53.18;2.40
96342;143405;Publiczne Gimnazjum|Dąbrówka|Tadeusza Kościuszki 20A |05-252 Dąbrówka;1241;671;671;12;659;54.07;1.79
96343;143406;Publiczna Szkoła Podstawowa w Jadowie|Jadów|ul. 11 Listopada 15 |05-280 Jadów;796;348;348;10;338;43.72;2.87
96344;143406;Gimnazjum im. Andrzeja Zamoyskiego w Jadowie|Jadów|11-go Listopada 15 |05-280 Jadów;758;339;340;8;331;44.72;2.36
96345;143406;Publiczna Szkoła Podstawowa w Myszałach|Myszadła| 65 |05-280 Jadów;742;283;283;7;276;38.14;2.47
96346;143406;Gminna Biblioteka Publiczna w Jadowie Filia w Zawiszynie|Zawiszyn|ul. Szkolna 16 |05-280 Jadów;427;220;220;6;214;51.52;2.73
96347;143406;Zespół Szkolno - Przedszkolny w Urlach|Urle|ul. Żwirki i Wigury 4 |05-281 Jadów;913;439;439;15;424;48.08;3.42
96348;143406;Gminna Biblioteka Publiczna w Jadowie flia w Urlach|Urle|Poniatowskiego 11 |05-281 Jadów;702;333;333;11;322;47.44;3.30
96349;143406;Publiczna Szkoła Podstawowa w Nowinkach|Nowinki| 31 |05-280 Jadów;469;166;166;10;156;35.39;6.02
96350;143406;Publiczna Szkoła Podstawowa w Szewnicy|Szewnica|Kościelna 28 |05-281 Jadów;533;236;236;9;227;44.28;3.81
96351;143406;Gminna Biblioteka Publiczna w Jadowie filia w Sitnem|Sitne|Długa 1 |05-281 Jadów;458;199;199;5;194;43.45;2.51
96352;143406;Gminna Biblioteka Publiczna w Jadowie filia w Sulejowie|Sulejów|Kościelna 7 |05-280 Jadów;400;182;182;9;173;45.50;4.95
96353;143407;Zespół Szkół w Klembowie|Klembów|ul.Gen.Franciszka Żymirskiego 68 |05-205 Klembów;1217;593;593;22;571;48.73;3.71
96354;143407;Zespół Szkół w Ostrówku|Ostrówek|ul. Warszawska 1 |05-205 Klembów;1510;914;914;28;886;60.53;3.06
96355;143407;Zespół Szkół w Ostrówku|Ostrówek|ul. Warszawska 1 |05-205 Klembów;1081;503;503;11;492;46.53;2.19
96356;143407;Szkoła Podstawowa w Dobczynie|Dobczyn|ul. Mazowiecka 67 |05-205 Klembów;1535;741;741;21;720;48.27;2.83
96357;143407;Szkoła Podstawowa w Starym Kraszewie|Stary Kraszew|ul. Szkolna 5 |05-205 Klembów;490;254;254;9;245;51.84;3.54
96358;143407;Szkoła Podstawowa w Woli Rasztowskiej|Wola Rasztowska|ul.Szkolna 8 |05-205 Klembów;1098;611;611;12;599;55.65;1.96
96359;143407;Szkoła Podstawowa w Kruszu|Krusze| 34 |05-240 Klembów;460;217;217;11;206;47.17;5.07
96360;143407;Zakład Opiekuńczo-Leczniczy Psychiatryczny w Rasztowie|Rasztów|C.K Norwida 2 |05-205 Klembów;48;46;46;6;40;95.83;13.04
96361;143408;Szkoła Podstawowa w Międzylesiu|Międzyleś| 12A |05-326 Poświętne;587;241;241;28;213;41.06;11.62
96362;143408;Szkoła Podstawowa w Poświętnem|Poświętne| |05-326 Poświętne;1303;537;537;12;525;41.21;2.23
96363;143408;Szkoła Podstawowa w Nowych Ręczajach|Nowe Ręczaje| 20A |05-326 Poświętne;651;368;368;7;361;56.53;1.90
96364;143408;Ochotnicza Straż Pożarna w Woli Ręczajskiej|Wola Ręczajska| 40A |05-326 Poświętne;394;186;186;11;175;47.21;5.91
96365;143408;Szkoła Podstawowa w Zabrańcu|Zabraniec|ks. Wł. Skonieckiego 8 |05-079 Okuniew;766;416;416;17;399;54.31;4.09
96366;143408;Publiczne Gimnazjum w Poświętnem|Poświętne| |05-326 Poświętne;1125;606;606;20;586;53.87;3.30
96367;143409;Biblioteka Publiczna Miasta i Gminy Radzymin|Radzymin|ul. Konstytucji 3 Maja 15 |05-250 Radzymin;1608;879;879;18;861;54.66;2.05
96368;143409;Urząd Stanu Cywilnego w Radzyminie|Radzymin|ul. Konstytucj 3 Maja 19 |05-250 Radzymin;1689;890;890;17;873;52.69;1.91
96369;143409;Zespół Szkół im. Księżnej Eleonory Czartoryskiej|Radzymin|Konopnickiej 24 |05-250 Radzymin;1754;1077;1077;13;1064;61.40;1.21
96370;143409;Zespół Szkół Terenów Zieleni w Radzyminie|Radzymin|ul. Aleja Jana Pawła II 18 |05-250 Radzymin;2010;1164;1164;14;1150;57.91;1.20
96371;143409;Zasadnicza Szkoła Zawodowa ZDZ im. kpt. Stefana Pogonowskiego|Radzymin|ul. Komunalna 6 |05-250 Radzymin;1658;904;904;13;891;54.52;1.44
96372;143409;Ochotnicza Straż Pożarna w Radzyminie|Radzymin|ul. Konstytucji 3 Maja 8A |05-250 Radzymin;1755;944;944;21;923;53.79;2.22
96373;143409;Zespół Szkolno-Przedszkolny im. Janiny Januszewskiej w Ciemnem|Ciemne|Wołomińska 208 |05-250 Radzymin;1736;830;830;21;809;47.81;2.53
96374;143409;Zespół Szkół w Starych Załubicach Szkoła Podstawowa im. Armii Krajowej|Stare Załubice|Mazowiecka 40 |05-255 Stare Załubice;1878;1159;1159;33;1126;61.71;2.85
96375;143409;Szkoła Podstawowa Nr 2 w Słupnie|Słupno|ul. Szkolna 3 |05-250 Radzymin;1774;1027;1027;22;1005;57.89;2.14
96376;143409;Zespół Szkół w Słupnie Szkoła Podstawowa Nr 1 im. Marii Konopnickiej|Słupno|Aleja Jana Pawła II 14 |05-250 Radzymin;1493;854;854;16;838;57.20;1.87
96377;143409;Szkoła Podstawowa im. Prymasa Tysiąclecia w Nadmie|Nadma|Szkolna 7 |05-270 Marki;1379;875;875;20;855;63.45;2.29
96378;143409;Dom Pomocy Społecznej w Radzyminie|Radzymin|Konstytucji 3 Maja 7 |05-250 Radzymin;97;36;36;2;34;37.11;5.56
96379;143409;Centrum Medyczne im. Bitwy Warszawskiej 1920r. w Radzyminie-budynek szpitala|Radzymin|Konstytucji 3 Maja 17 17 |05-250 Radzymin;20;11;11;1;10;55.00;9.09
96380;143410;Budynek po byłej szkole|Krawcowizna| 85 |05-282 Strachówka;180;58;58;0;58;32.22;0.00
96381;143410;Budynek OSP|Borucza| 16A |05-282 Strachówka;379;136;136;5;131;35.88;3.68
96382;143410;Zespół Szkół im. Rzeczpospolitej Norwidowskiej|Strachówka|Stefana Kmiecińskiego 3 |05-282 Strachówka;346;139;139;8;131;40.17;5.76
96383;143410;Budynek OSP|Strachówka|ul. Jana Pawła II 24 |05-282 Strachówka;529;239;239;11;228;45.18;4.60
96384;143410;Szkoła Podstawowa|Rozalin| 29 |05-282 Strachówka;458;147;147;3;144;32.10;2.04
96385;143410;Świetlica Wiejska|Równe| 30 |05-282 Strachówka;394;168;168;10;158;42.64;5.95
96386;143410;Budynek prywatny|Kąty Czernickie| 43 |05-282 Strachówka;106;39;39;3;36;36.79;7.69
96387;143411;Przedszkole Samorządowe|Tłuszcz|ul. Adama Mickiewicza 7 |05-240 Tłuszcz;1444;779;779;22;757;53.95;2.82
96388;143411;Przedszkole Samorządowe|Tłuszcz|ul. Adama Mickiewicza 7 |05-240 Tłuszcz;641;253;253;6;247;39.47;2.37
96389;143411;Szkoła Podstawowa|Tłuszcz|ul. Kościelna 1 |05-240 Tłuszcz;1164;714;714;12;702;61.34;1.68
96390;143411;Szkoła Podstawowa|Tłuszcz|ul. Kościelna 1 |05-240 Tłuszcz;1262;709;709;22;687;56.18;3.10
96391;143411;Gimnazjum|Tłuszcz|ul. Radzymińska 2 |05-240 Tłuszcz;919;483;483;18;465;52.56;3.73
96392;143411;Gimnazjum|Tłuszcz|ul. Radzymińska 2 |05-240 Tłuszcz;788;406;406;16;390;51.52;3.94
96393;143411;Zespół Szkół|Jasienica|ul. Szkolna 8 |05-240 Tłuszcz;1232;625;625;15;610;50.73;2.40
96394;143411;Zespół Szkół|Jasienica|ul. Szkolna 8 |05-240 Tłuszcz;1339;634;634;22;612;47.35;3.47
96395;143411;Zespół Szkół|Miąse|ul. Kardynała Wyszyńskiego 44 |05-240 Tłuszcz;993;409;409;27;382;41.19;6.60
96396;143411;Zespół Szkół|Stryjki| 2 |05-240 Tłuszcz;809;350;350;17;333;43.26;4.86
96397;143411;Ochotnicza Straż Pożarna|Dzięcioły|ul. Irysowa 38 |05-240 Tłuszcz;726;336;336;12;324;46.28;3.57
96398;143411;Zespół Pałacowo-Parkowy|Chrzęsne|ul. Pałacowa 1 |05-240 Tłuszcz;897;421;423;15;406;46.93;3.56
96399;143411;Zespół Szkół|Mokra Wieś|ul. Marii Konopnickiej 12 |05-240 Tłuszcz;851;362;362;19;343;42.54;5.25
96400;143411;Zespół Szkół|Postoliska|Plac 3-go Maja 18 |05-240 Tłuszcz;886;396;396;23;373;44.70;5.81
96401;143411;Zespół Szkolno-Przedszkolny|Kozły| 27 |05-240 Tłuszcz;1398;616;616;16;600;44.06;2.60
96402;143412;Zespół Szkolno-Przedszkolny|Leśniakowizna|ul. Kasprzykiewicza 153 |05-200 Wołomim;1105;612;612;7;605;55.38;1.14
96403;143412;Zespół Szkół|Ossów|ul. Matarewicza 148 |05-230 Kobyłka;959;494;494;18;476;51.51;3.64
96404;143412;Zesół Szkół|Czarna|ul. Witosa 52 |05-200 Wołomin;976;525;525;9;516;53.79;1.71
96405;143412;Zespół Szkół|Duczki|ul. Szosa Jadowska 37 |05-200 Wołomin;1750;1091;1091;20;1071;62.34;1.83
96406;143412;Zespół Szkół|Duczki|ul. Szosa Jadowska 37 |05-200 Wołomin;787;509;509;13;496;64.68;2.55
96407;143412;Szkoła Podstawowa|Stare Grabie|ul. Cichorackiej 8 |05-200 Wołomin;558;288;288;8;280;51.61;2.78
96408;143412;Przedszkole im. Pszczółki Mai|Duczki|ul. Szosa Jadowska 37 |05-200 Wołomin;242;139;139;1;138;57.44;0.72
96409;143412;Szkoła Podstawowa|Zagościniec|ul. Szkolna 1 |05-200 Wołomin;1010;574;574;6;568;56.83;1.05
96410;143412;ZEC Sp. z o.o.|Wołomin|ul. Szosa Jadowska 49 |05-200 Wołomin;1123;678;678;14;664;60.37;2.06
96411;143412;Szkoła Podstawowa Nr 7|Wołomin|ul. Poprzeczna 6 |05-200 Wołomin;497;268;268;10;258;53.92;3.73
96412;143412;Szkoła Podstawowa|Zagościniec|Szkolna 1 |05-200 Wołomin;1033;518;518;12;506;50.15;2.32
96413;143412;Szkoła Podstawowa|Zagościniec|ul. Szkolna 1 |05-200 Wołomin;843;499;499;13;486;59.19;2.61
96414;143412;Przedszkole Nr 9 im. Jasia i Małgosi|Wołomin|ul.Piłsudskiego 15 |05-200 Wołomin;1770;1065;1065;18;1047;60.17;1.69
96415;143412;Zespół Szkół Nr 1|Wołomin|ul. Sasina 33 |05-200 Wołomin;1511;901;901;10;891;59.63;1.11
96416;143412;Zespół Szkół Nr 2|Wołomin|Aleja Armii krajowej 81 |05-200 Wołomin;1714;1117;1117;11;1106;65.17;0.98
96417;143412;P.E. i R. I. ELTOR Warszawa Sp. z o.o.|Wołomin|Aleja Armii Krajowej 110/112 |05-200 Wołomin;2249;1361;1361;23;1338;60.52;1.69
96418;143412;Przedszole Nr 10 im. Misia Uszatka|Wołomin|Aleja Armii Krajowej 56 |05-200 Wołomin;1034;599;599;4;595;57.93;0.67
96419;143412;OSIR HURAGAN|Wołomin|ul. Korsaka 4 |05-200 Wołomin;946;493;493;4;489;52.11;0.81
96420;143412;Miejska Biblioteka Publiczna|Wołomin|ul. Wileńska 32 |05-200 Wołomin;1032;441;441;7;434;42.73;1.59
96421;143412;Zespół Szkół Nr 5|Wołomin|ul. Lipińska 16 |05-200 Wołomin;1168;684;684;11;673;58.56;1.61
96422;143412;Zespół Szkół Nr 5|Wołomin|ul. Lipińska 16 |05-200 Wołomin;1769;1031;1031;17;1014;58.28;1.65
96423;143412;Zespół Szkół Nr 4|Wołomin|ul. 1 Maja 19 |05-200 Wołomin;480;279;279;1;278;58.13;0.36
96424;143412;Przedszkole Nr 2 im. Pyzy Wędrowniczki|Wołomin|ul. Polna 32 |05-200 Wołomin;1895;1080;1080;21;1059;56.99;1.94
96425;143412;Zespół Szkół nr 3|Wołomin|ul. Kazimierza Wielkiego 1 |05-200 Wołomin;1787;985;985;16;969;55.12;1.62
96426;143412;Zespół Szkół Nr 3|Wołomin|ul. Kazimierza Wielkiego 1 |05-200 Wołomin;1960;1237;1237;15;1222;63.11;1.21
96427;143412;Szkoła Podstawowa Nr 7|Wołomin|ul. Poprzeczna 6 |05-200 Wołomin;2141;1405;1405;22;1383;65.62;1.57
96428;143412;Przedszkole Nr 6 im. Bajka|Wołomin|ul. Kazimierza Wielkiego 1 |05-200 Wołomin;1514;913;913;14;899;60.30;1.53
96429;143412;Miejski Dom Kultury|Wołomin|ul. Mariańska 7 |05-200 Wołomin;1776;939;939;25;914;52.87;2.66
96430;143412;Zespół Szkół Nr 4|Wołomin|ul. 1 Maja 19 |05-200 Wołomin;1073;643;643;9;634;59.93;1.40
96431;143412;Zespół Szkół|Wołomin|ul. Legionów 85 |05-200 Wołomin;1218;814;814;3;811;66.83;0.37
96432;143412;Zespół Szkół|Wołomin|ul. Legionów 85 |05-200 Wołomin;1934;1209;1209;21;1188;62.51;1.74
96433;143412;Szpital Powiatowy w Wołominie - Samodzielny Zespół Publicznych Zakładów Opieki Zdrowotnej|Wołomin|Gdyńska 1/3 |05-200 Wołomin;50;41;41;1;40;82.00;2.44
96434;143501;Urząd Gminy w Brańszczyku|Brańszczyk|ul. Jana Pawła II 45 |07-221 Brańszczyk;1476;791;791;22;769;53.59;2.78
96435;143501;Publiczna Szkoła Podstawowa w Nowych Budach|Nowe Budy| 32 |07-221 Brańszczyk;593;233;233;12;221;39.29;5.15
96436;143501;Publiczna Szkoła Podstawowa w Trzciance|Trzcianka| 147 |07-221 Brańszczyk;932;414;414;21;393;44.42;5.07
96437;143501;Publiczna Szkoła Podstawowa w Turzynie|Turzyn| 95 |07-221 Brańszczyk;606;300;300;10;290;49.50;3.33
96438;143501;Publiczna Szkoła Podstawowa w Nowej Wsi|Nowa Wieś| 75 |07-210 Długosiodło;1226;458;458;10;448;37.36;2.18
96439;143501;Publiczna Szkoła Podstawowa w Porębie|Poręba Średnia| 18 |07-308 Poręba Średnia;1356;678;678;21;657;50.00;3.10
96440;143501;Świetlica DPS w Brańszczyku|Brańszczyk|Jana Pawła II 65 |07-221 Brańszczyk;163;39;39;10;29;23.93;25.64
96441;143501;Publiczna Szkoła Podstawowa w Knurowcu|Knurowiec| 1 |07-221 Brańszczyk;349;119;119;5;114;34.10;4.20
96442;143501;Dom Emeryta w Brańszczyku - pokój nr 1|Brańszczyk|Jana Pawła II 1 |07-221 Brańszczyk;37;29;29;3;26;78.38;10.34
96443;143502;Urząd Gminy Długosiodło|Długosiodło|ul. Kościuszki 2 |07-210 Długosiodło;2059;957;957;32;925;46.48;3.34
96444;143502;Publiczna Szkoła Podstawowa w Blochach|Blochy| 60 |07-210 Długosiodło;915;396;396;17;379;43.28;4.29
96445;143502;Zespół Szkół w Starym Bosewie|Stare Bosewo|ul. Rozwojowa 19 |07-210 Długosiodło;980;493;493;18;475;50.31;3.65
96446;143502;Publiczna Szkoła Podstawowa w Sieczychach|Sieczychy| 43 |07-211 Długosiodło;467;148;148;6;142;31.69;4.05
96447;143502;Publiczna Szkoła Podstawowa w Dalekiem|Dalekie| 69 |07-211 Długosiodło;796;300;300;17;283;37.69;5.67
96448;143502;Gminne Centrum Informacji Kultury Sportu i Rekreacji Punkt Biblioteczny w Chrzczance Włościańskiej|Chrzczanka Włościańska| 26 |07-210 Długosiodło;936;391;391;12;379;41.77;3.07
96449;143503;Urząd Gminy w Rząśniku|Rząśnik|Jesionowa 3 |07-205 Rząśnik;1354;717;717;32;685;52.95;4.46
96450;143503;Publiczna Szkoła Podstawowa w Komorowie|Komorowo| 34 |07-205 Rząśnik;633;339;339;12;327;53.55;3.54
96451;143503;Budynek po Szkole Podstawowej w Nowych Wielątkach|Nowe Wielątki| 31 |07-205 Rząśnik;501;252;252;11;241;50.30;4.37
96452;143503;Publiczna Szkoła Podstawowa w Porządziu|Porządzie| 93 |07-205 Rząśnik;579;330;330;12;318;56.99;3.64
96453;143503;Budynek Filii Gminnej Biblioteki Publicznej w Nowym Lubielu|Nowy Lubiel| 28 |07-207 Rząśnik;604;292;292;11;281;48.34;3.77
96454;143503;Publiczna Szkoła Podstawowa w Bielinie|Bielino| 32A |07-207 Rząśnik;654;326;326;27;299;49.85;8.28
96455;143503;Budynek Świetlicy Wiejskiej w Ochudnie|Ochudno| 45 |07-200 Wyszków;416;202;202;8;194;48.56;3.96
96456;143503;Budynek Domu Kultury w Dąbrowie|Dąbrowa| 39 |07-205 Rząśnik;397;183;183;5;178;46.10;2.73
96457;143503;Publiczna Szkoła Podstawowa w Starym Lubielu|Stary Lubiel| 22A |07-207 Rząśnik;326;118;118;8;110;36.20;6.78
96458;143504;Gminny Ośrodek Kultury w Somiance|Somianka| 21 |07-203 Somianka;1153;530;530;28;502;45.97;5.28
96459;143504;Publiczna Szkoła Podstawowa w Kręgach|Kręgi| 9 |07-200 Wyszków;275;144;144;1;143;52.36;0.69
96460;143504;Publiczna Szkoła Podstawowa w Popowie Kościelnym|Popowo Kościelne| 60 |07-203 Somianka;949;475;475;17;458;50.05;3.58
96461;143504;Publiczna Szkoła Podstawowa w Ulasku|Ulasek| 28a |07-203 Somianka;646;319;319;10;309;49.38;3.13
96462;143504;Nowe Wypychy 14a|Nowe Wypychy| 14a |07-206 Somianka;497;183;183;6;177;36.82;3.28
96463;143504;Publiczna Szkoła Podstawowa w Woli Mystkowskiej|Wola Mystkowska| 17 |07-206 Somianka;945;382;382;22;360;40.42;5.76
96464;143504;Oddział Zewnętrzny w Popowie|Popowo-Parcele|ul. Nadbużańska 39 |07-203 Somianka;136;136;136;23;113;100.00;16.91
96465;143505;Zakład Doskonalenia Zawodowego|Wyszków|ul. Komisji Edukacji Narodowej 2 |07-200 Wyszków;1476;826;826;19;807;55.96;2.30
96466;143505;Zespół Szkół /wejście A/|Wyszków|ul. Geodetów 45 |07-200 Wyszków;1528;872;872;14;858;57.07;1.61
96467;143505;Zespół Szkół /wejście B/|Wyszków|ul. Geodetów 45 |07-200 Wyszków;1511;862;862;14;848;57.05;1.62
96468;143505;WOSiR /hala sportowa/|Wyszków|ul. Geodetów 45 |07-200 Wyszków;1465;812;812;19;793;55.43;2.34
96469;143505;Przedszkole Nr 9|Wyszków|ul. Pułtuska 143 |00-000 Wyszków;1420;650;650;12;638;45.77;1.85
96470;143505;Przedszkole Nr 1|Wyszków|ul. Prosta 7a |07-202 Wyszków;1487;826;826;23;803;55.55;2.78
96471;143505;Szkoła Podstawowa Nr 2|Wyszków|ul. Jana Matejki 5 |07-200 Wyszków;1434;785;785;19;766;54.74;2.42
96472;143505;Powiatowy Urząd Pracy|Wyszków|ul. Tadeusza Kościuszki 15 |07-200 Wyszków;1237;600;600;15;585;48.50;2.50
96473;143505;Zespół Szkół Nr 1|Wyszków|ul. I Armii Wojska Polskiego 89 |07-202 Wyszków;1371;718;718;9;709;52.37;1.25
96474;143505;Wyszkowski Ośrodek Kultury /Hutnik/|Wyszków|ul. Prosta 7 |07-202 Wyszków;1424;718;718;14;704;50.42;1.95
96475;143505;Gimnazjum Nr 2|Wyszków|ul. Generała Józefa Sowińskiego 55 |07-200 Wyszków;1387;562;562;16;546;40.52;2.85
96476;143505;Przedszkole Nr 3|Wyszków|ul. 11 Listopada 23 |07-202 Wyszków;1450;842;842;12;830;58.07;1.43
96477;143505;Miejsko-Gminna Biblioteka Publiczna|Wyszków|ul. Generała Józefa Sowińskiego 80 |07-200 Wyszków;1409;708;708;10;698;50.25;1.41
96478;143505;Szkoła Podstawowa Nr 1|Wyszków|ul. 11 Listopada 62 |07-200 Wyszków;1389;762;762;12;750;54.86;1.57
96479;143505;Zespół Szkół "Rybienko Leśne" (wejście A)|Wyszków|ul. Stefana Batorego 6 |07-201 Wyszków;1235;700;700;8;692;56.68;1.14
96480;143505;Remiza OSP|Kamieńczyk|ul. Warszawska 6 |07-202 Wyszków;699;383;383;8;375;54.79;2.09
96481;143505;Szkoła Podstawowa|Skuszew|ul. Przejazdowa 81 |07-201 Wyszków;612;295;295;6;289;48.20;2.03
96482;143505;Szkoła Podstawowa (wejście A)|Lucynów|ul. Szkolna 12 |07-201 Wyszków;309;93;93;10;83;30.10;10.75
96483;143505;Szkoła Podstawowa /wejście B/|Lucynów|Szkolna 12 |07-201 Wyszków;1467;631;631;30;601;43.01;4.75
96484;143505;Zespół Szkół "Rybienko Leśne" /wejście B/|Wyszków|ul. Stefana Batorego 6 |07-201 Wyszków;543;242;242;9;233;44.57;3.72
96485;143505;Dom Samopomocy "SOTERIA" /budynek ZDZ/|Wyszków|ul. Komisji Edukacji Narodowej 2 |07-200 Wyszków;945;485;485;11;474;51.32;2.27
96486;143505;Budynek po byłej Szkole Podstawowej|Gulczewo|Szkolna 16 |07-200 Wyszków;423;227;227;2;225;53.66;0.88
96487;143505;Zespół Szkół|Rybno|ul. Wyszkowska 87 |07-200 Wyszków;1081;479;479;18;461;44.31;3.76
96488;143505;Szkoła Podstawowa /wejście A/|Leszczydół Stary| 38 |07-202 Wyszków;769;322;322;6;316;41.87;1.86
96489;143505;Szkoła Podstawowa|Olszanka| 39 |07-200 Wyszków;456;211;211;4;207;46.27;1.90
96490;143505;Szkoła Podstawowa|Łosinno|ul. Szkolna 12 |07-200 Wyszków;415;175;175;10;165;42.17;5.71
96491;143505;Zespół Szkół|Leszczydół-Nowiny|ul. Szkolna 26 |07-202 Wyszków;1251;561;561;10;551;44.84;1.78
96492;143505;Szkoła Podstawowa /wejście B/|Leszczydół Stary| 38 |07-200 Wyszków;290;135;135;4;131;46.55;2.96
96493;143505;SPZZOZ w Wyszkowie - Szpital|Wyszków|ul. Komisji Edukacji Narodowej 1 |07-200 Wyszków;83;22;22;0;22;26.51;0.00
96494;143506;Gminny Ośrodek Kultury w Zabrodziu|Zabrodzie|ul. Wł.St.Reymonta 2 |07-230 Zabrodzie;1115;598;598;15;583;53.63;2.51
96495;143506;DPS w Niegowie|Niegów|ul. Wierzbowa 4 |07-230 Zabrodzie;1112;551;551;17;534;49.55;3.09
96496;143506;Publiczna Szkoła Podstawowa w Dębinkach|Dębinki|ul. C. K. Norwida 26 |07-230 Zabrodzie;856;395;395;19;376;46.14;4.81
96497;143506;Publiczna Szkoła Podstawowa w Adelinie|Adelin| 46 |07-230 Zabrodzie;483;262;262;6;256;54.24;2.29
96498;143506;Budynek po Szkole Podstawowej w Kicinach|Kiciny| 52 |07-230 Zabrodzie;986;394;394;20;374;39.96;5.08
96499;143506;DPS w Gaju|Gaj|ul. Matki Wincenty Jaroszewskiej 5 |07-230 Zabrodzie;75;38;38;0;38;50.67;0.00
96500;143601;Publiczna Szkoła Podstawowa w Kazanowie|Kazanów|ul. Kościelna 52 |26-713 Kazanów;1221;633;633;21;612;51.84;3.32
96501;143601;Publiczna Szkoła Podstawowa w Kowalkowie|Kowalków-Kolonia| 17 |26-713 Kazanów;801;316;316;14;302;39.45;4.43
96502;143601;Publiczna Szkoła Podstawowa w Zakrzówku|Zakrzówek-Wieś| 7 |26-713 Kazanów;575;234;234;20;214;40.70;8.55
96503;143601;Budynek po Publicznej Szkołe Podstawowej w Ostrownicy|Ostrownica Wieś| 47 |26-713 Kazanów;345;113;113;3;110;32.75;2.65
96504;143601;Publiczna Szkoła Podstawowa w Niedarczowie|Niedarczów Dolny-Kolonia| 1 |26-713 Kazanów;444;159;159;10;149;35.81;6.29
96505;143601;Budynek po Publicznej Szkołe Podstawowej w Kroczowie Mniejszym|Kroczów Mniejszy| 21 |26-713 Kazanów;268;124;124;5;119;46.27;4.03
96506;143602;Urząd Gminy Policzna|Policzna|ul. Bolesława Prusa 11 |26-720 Policzna;1917;750;750;34;716;39.12;4.53
96507;143602;Zespół Szkolno-Przedszkolny w Czarnolesie|Czarnolas| 87 |26-720 Policzna;1192;486;486;14;472;40.77;2.88
96508;143602;Dom Pomocy Społecznej w Gródku|Gródek| 26A |26-720 Policzna;605;237;237;16;221;39.17;6.75
96509;143602;Świetlica Wiejska w Chechłach|Chechły| 29C |26-720 Policzna;503;241;241;9;232;47.91;3.73
96510;143602;Budynek po Publicznej Szkole Podstawowej w Wilczowoli|Wilczowola| 12 |26-720 Policzna;637;262;262;13;249;41.13;4.96
96511;143603;Dom Kultury w Rudkach|Rudki| 53A |26-704 Przyłęk;562;190;190;12;178;33.81;6.32
96512;143603;Samodzielny Publiczny Zakład Opieki Zdrowotnej w Przyłęku|Przyłęk| 30A |26-704 Przyłęk;896;325;325;24;301;36.27;7.38
96513;143603;Publiczna Szkoła Podstawowa w Grabowie nad Wisłą|Grabów nad Wisłą| 57A |26-704 Przyłęk;734;300;300;14;286;40.87;4.67
96514;143603;Remiza Ochotniczej Straży Pożarnej w Łagowie|Łagów| 31A |26-704 Przyłęk;806;323;323;12;311;40.07;3.72
96515;143603;Publiczna Szkoła Podstawowa w Łaguszowie|Łaguszów| 29 |26-704 Przyłęk;719;292;292;7;285;40.61;2.40
96516;143603;Publiczna Szkoła Podstawowa w Babinie|Babin| 38 |26-704 Przyłęk;945;351;351;16;335;37.14;4.56
96517;143603;Lokal po byłej PSP w Lucimi|Lucimia| 38A |26-704 Przyłęk;372;128;128;8;120;34.41;6.25
96518;143604;Zespół Szkół w Tczowie|Tczów| 113 |26-706 Tczów;1553;714;714;46;668;45.98;6.44
96519;143604;Publiczna Szkoła Podstawowa w Brzezinkach Starych|Brzezinki Stare| 41 |26-706 Tczów;737;315;315;18;297;42.74;5.71
96520;143604;Dom Ludowy w Bartodziejach|Bartodzieje| 64 |26-706 Tczów;447;188;188;10;178;42.06;5.32
96521;143604;Publiczna Szkoła Podstawowa w Rawicy|Rawica-Kolonia| 12 |26-706 Tczów;572;238;238;28;210;41.61;11.76
96522;143604;Publiczna Szkoła Podstawowa w Janowie|Janów| 28B |26-706 Tczów;503;203;203;9;194;40.36;4.43
96523;143605;Zespół Szkół Rolniczo-Technicznych w Zwoleniu wejście od ul. Sienkiewicza|Zwoleń|ul. Wojska Polskiego 78 |26-700 Zwoleń;1814;913;913;17;896;50.33;1.86
96524;143605;Publiczna Szkoła Podstawowa w Zwoleniu|Zwoleń|ul. Ludowa 35 |26-700 Zwoleń;2500;1303;1303;29;1274;52.12;2.23
96525;143605;Urząd Miejski w Zwoleniu|Zwoleń|Plac Kochanowskiego 1 |26-700 Zwoleń;1563;791;791;19;772;50.61;2.40
96526;143605;Publiczne Gimnazjum w Zwoleniu wejście od ul. Księdza Packa 8|Zwoleń|ul. Kościelna 7 |26-700 Zwoleń;1826;992;992;22;970;54.33;2.22
96527;143605;Remiza OSP w Mieczysławowie|Mieczysławów| 1 |26-700 Zwoleń;462;218;218;6;212;47.19;2.75
96528;143605;Obiekt po sali gimnastycznej w Linowie|Linów| 54 |26-700 Zwoleń;637;299;299;12;287;46.94;4.01
96529;143605;Publiczna Szkoła Podstawowa w Paciorkowej Woli Nowej|Paciorkowa Wola Nowa| 64 |26-700 Zwoleń;298;129;129;3;126;43.29;2.33
96530;143605;Publiczna Szkoła Podstawowa w Sycynie-Kolonii|Sycyna-Kolonia| 125 |26-700 Zwoleń;588;254;254;9;245;43.20;3.54
96531;143605;Świetlica wiejska w Jasieńcu-Kolonii|Jasieniec-Kolonia| 175 |26-700 Zwoleń;825;336;336;21;315;40.73;6.25
96532;143605;Świetlica Profilaktyczno-Wychowawcza w Strykowicach Górnych|Strykowice Górne| 144 |26-700 Zwoleń;588;269;269;11;258;45.75;4.09
96533;143605;Remiza OSP w Zielonce Nowej|Zielonka Nowa| 96 |26-700 Zwoleń;405;207;207;4;203;51.11;1.93
96534;143605;Publiczne Gimnazjum w Sydole|Sydół| 64 |26-700 Zwoleń;533;220;220;10;210;41.28;4.55
96535;143605;Świetlica Profilaktyczno-Wychowawcza w Strykowicach Błotnych|Strykowice Błotne| 42 |26-700 Zwoleń;362;142;142;6;136;39.23;4.23
96536;143605;Szpital Rejonowy w Zwoleniu|Zwoleń|Władysława Jagiełły 12 |26-700 Zwoleń;62;14;14;0;14;22.58;0.00
96537;143701;Liceum Ogólnokształcące|Bieżuń|ul. Warszawska 4 |09-320 Bieżuń;1545;647;647;21;626;41.88;3.25
96538;143701;Zespół Placówek Oświatowych|Bieżuń|ul. Gołębiowskiego 1 |09-320 Bieżuń;1641;654;654;17;637;39.85;2.60
96539;143701;Samorządowa Szkoła Podstawowa|Sławęcin| 63 |09-320 Bieżuń;1013;404;404;23;381;39.88;5.69
96540;143702;Zespół Placówek Oświatowych w Kuczborku-Osadzie|Kuczbork-Osada|ul. Adama Mickiewicza 6 |09-310 Kuczbork-Osada;1032;430;430;16;414;41.67;3.72
96541;143702;Zespół Placówek Oświatowych w Zielonej|Zielona|ul. Szkolna 2 |09-310 Kuczbork-Osada;1401;531;531;17;514;37.90;3.20
96542;143702;Szkoła Podstawowa w Sarnowie z siedzibą w Nowej Wsi|Nowa Wieś| 55 |09-310 Kuczbork-Osada;963;297;297;28;269;30.84;9.43
96543;143702;Szkoła Podstawowa w Gościszce|Gościszka| 82 |09-310 Kuczbork-Osada;567;204;204;12;192;35.98;5.88
96544;143703;Zespół Szkół w Lubowidzu|Lubowidz|ul. Jana Pawła II 46A |09-304 Lubowidz;1538;693;693;35;658;45.06;5.05
96545;143703;Zespół Szkół w Lubowidzu|Lubowidz|ul. Jana Pawła II 46A |09-304 Lubowidz;825;274;274;20;254;33.21;7.30
96546;143703;Zespół Szkół w Zieluniu|Zieluń-Osada|ul. Szkolna 7 |09-304 Zieluń;1415;508;508;31;477;35.90;6.10
96547;143703;Zespół Szkół w Syberii|Syberia| 49 |09-303 Syberia;1902;674;674;33;641;35.44;4.90
96548;143703;Dom Pomocy Społecznej w Bądzynie|Bądzyn| 75 |09-304 Bądzyn;56;27;27;8;19;48.21;29.63
96549;143704;Samorządowa Szkoła Podstawowa w Lutocinie|Lutocin|ul. Szkolna 14 |09-317 Lutocin;1298;560;560;21;539;43.14;3.75
96550;143704;Samorządowa Szkoła Podstawowa w Przeradzu Małym z/s Przeradz Nowy|Przeradz Nowy| 9 |09-317 Lutocin;786;256;256;10;246;32.57;3.91
96551;143704;Samorządowa Szkoła Podstawowa w Lutocinie Filia Chrapoń|Chrapoń| 11 |09-317 Lutocin;862;305;305;15;290;35.38;4.92
96552;143704;Samorządowa Szkoła Podstawowa w Swojęcinie Filia Jonne|Jonne| 57A |09-317 Lutocin;664;249;249;12;237;37.50;4.82
96553;143705;Szkoła Podstawowa|Łaszewo| 36 |09-135 Siemiątkowo;1036;309;309;33;276;29.83;10.68
96554;143705;Zespół Szkół w Siemiątkowie|Siemiątkowo|ul. Warszawska 3B |09-135 Siemiątkowo;1111;439;440;22;417;39.51;5.01
96555;143705;Świetlica Wiejska|Nowa Wieś| 16 |09-135 Siemiątkowo;741;263;263;10;253;35.49;3.80
96556;143706;Liceum Ogólnokształcące w Żurominie|Żuromin|ul. Wyzwolenia 61 |09-300 Żuromin;2459;1254;1254;31;1223;51.00;2.47
96557;143706;Zespół Szkół Ponadgimnazjalnych w Żurominie|Żuromin|ul. Lidzbarska 27 |09-300 Żuromin;1608;626;626;18;608;38.93;2.88
96558;143706;Zespół Szkół Nr 1 w Żurominie|Żuromin|ul. Wyzwolenia 12 |09-300 Żuromin;1572;688;688;18;670;43.77;2.62
96559;143706;Zespół Szkół Nr 2 w Żurominie|Żuromin|ul. Wiatraczna 16 |09-300 Żuromin;1676;919;919;20;899;54.83;2.18
96560;143706;Dom Ludowy w Olszewie|Olszewo|ul. Żuromińska 58 |09-300 Żuromin;1133;389;389;10;379;34.33;2.57
96561;143706;Samorządowa Szkoła Podstawowa w Poniatowie|Poniatowo|ul. Szkolna 4 |09-300 Żuromin;861;374;374;9;365;43.44;2.41
96562;143706;Samorządowa Szkoła Podstawowa w Raczynach|Raczyny|ul. Kopernika 54 |09-300 Żuromin;1011;368;368;15;353;36.40;4.08
96563;143706;Samorządowa Szkoła Podstawowa w Chamsku|Chamsk|ul. Szkolna 19 |09-300 Żuromin;818;403;403;26;377;49.27;6.45
96564;143706;Zespół Szkół Nr 1 w Żurominie|Żuromin|ul. Wyzwolenia 12 |09-300 Żuromin;672;263;263;12;251;39.14;4.56
96565;143706;Samodzielny Publiczny Zespół Zakładów Opieki Zdrowotnej w Żurominie|Żuromin|ul. Szpitalna 56 |09-300 Żuromin;99;31;31;0;31;31.31;0.00
96566;143801;Osiedlowy Dom Kultury|Żyrardów|ul. Ks. Ottona Wittenberga 5 |96-300 Żyrardów;1656;1003;1003;21;982;60.57;2.09
96567;143801;Miejskie Przedszkole nr 6 im. Krasnala Hałabały|Żyrardów|ul. Szarych Szeregów 5 |96-300 Żyrardów;1586;830;830;25;805;52.33;3.01
96568;143801;Hala Sportowa|Żyrardów|ul. Fryderyka Chopina 1 |96-300 Żyrardów;1267;641;641;13;628;50.59;2.03
96569;143801;Zespół Szkół Publicznych nr 7|Żyrardów|ul. Franklina Roosevelta 2 |96-300 Żyrardów;1113;633;633;13;620;56.87;2.05
96570;143801;Zespół Szkół Nr 2|Żyrardów|ul. Legionów Polskich 54/56 |96-300 Żyrardów;1309;784;784;21;763;59.89;2.68
96571;143801;Zespół Szkół Publicznych nr 4|Żyrardów|ul. Radziwiłłowska 16 |96-300 Żyrardów;1148;574;574;18;556;50.00;3.14
96572;143801;Miejski Ogród Jordanowski|Żyrardów|ul. Władysława Reymonta 13 |96-300 Żyrardów;1887;1117;1117;10;1107;59.19;0.90
96573;143801;Miejskie Przedszkole nr 9|Żyrardów|Plac Jana Pawła II nr 6 |96-300 Żyrardów;1772;838;838;18;820;47.29;2.15
96574;143801;Zespół Szkół Publicznych Nr 2|Żyrardów|ul. Gabriela Narutowicza 35 |96-300 Żyrardów;1708;677;677;23;654;39.64;3.40
96575;143801;Zespół Szkół Społecznych STO|Żyrardów|ul. Armii Krajowej 3 |96-300 Żyrardów;1540;543;543;22;521;35.26;4.05
96576;143801;Miejskie Przedszkole Nr 5|Żyrardów|ul. Leszno 19 |96-300 Żyrardów;2008;1060;1060;11;1049;52.79;1.04
96577;143801;Miejskie Przedszkole Nr 2|Żyrardów|ul. Parkingowa 32 |96-300 Żyrardów;1618;936;936;20;916;57.85;2.14
96578;143801;Miejskie Przedszkole Nr 8|Żyrardów|ul. Marii Nietrzebki 6 |96-300 Żyrardów;1393;788;788;12;776;56.57;1.52
96579;143801;Klub Osiedlowy Koliber|Żyrardów|ul. Filipa de Girarda 12 |96-300 Żyrardów;1679;1011;1011;16;995;60.21;1.58
96580;143801;Liceum Ogólnokształcące im. Stefana Żeromskiego|Żyrardów|ul. Janiny Jadwigi Kacperskiej 6A |96-300 Żyrardów;1510;928;928;26;902;61.46;2.80
96581;143801;"Aqua Żyrardów"|Żyrardów|ul. Stefana Jodłowskiego 25/27 |96-300 Żyrardów;1204;706;706;9;697;58.64;1.27
96582;143801;Zespół Szkół Publicznych Nr 6|Żyrardów|ul. Józefa Mireckiego 56 |96-300 Żyrardów;1328;523;523;25;498;39.38;4.78
96583;143801;Specjalny Ośrodek Szkolno Wychowawczy|Żyrardów|ul. Środkowa 36 |96-300 Żyrardów;1632;917;917;24;893;56.19;2.62
96584;143801;Młodzieżowy Dom Kultury|Żyrardów|ul. Stanisława Moniuszki 15 |96-300 Żyrardów;1431;744;744;24;720;51.99;3.23
96585;143801;Zespół Szkół Nr 1|Żyrardów|ul. Bohaterów Warszawy 4 |96-300 Żyrardów;1209;771;771;7;764;63.77;0.91
96586;143801;Ruukki Polska|Żyrardów|ul. Jaktorowska 13 |96-300 Żyrardów;1207;680;680;6;674;56.34;0.88
96587;143801;Centrum Zdrowia Mazowsza Zachodniego Sp. z o.o.|Żyrardów|ul. Bolesława Limanowskiego 30 |96-300 Żyrardów;180;39;39;1;38;21.67;2.56
96588;143801;Dom Pomocy Społecznej|Żyrardów|ul. Gen. Stanisława Sosabowskiego 23 |96-300 Zyrardów;77;36;36;1;35;46.75;2.78
96589;143801;Dom Pomocy Społecznej|Żyrardów|ul. Bolesława Limanowskiego 32b |96-300 Żyrardów;58;30;30;6;24;51.72;20.00
96590;143802;Urząd Miejski|Mszczonów|ul. Plac Piłsudskiego 1 |96-320 Mszczonów;577;333;333;19;314;57.71;5.71
96591;143802;Liceum Ogólnokształcące|Mszczonów|ul. Maklakiewicza 18 |96-320 Mszczonów;548;319;319;2;317;58.21;0.63
96592;143802;Gminne Centrum Informacji|Mszczonów|ul. Żyrardowska 4 |96-320 ;768;409;409;13;396;53.26;3.18
96593;143802;Spółdzielnia Mieszkaniowa|Mszczonów|ul. Dworcowa 1 |96-320 Mszczonów;976;487;487;25;462;49.90;5.13
96594;143802;Mszczonowski Ośrodek Kultury|Mszczonów|ul. Warszawska 33 |96-320 Mszczonów;1160;655;655;9;646;56.47;1.37
96595;143802;Miejskie Przedszkole|Mszczonów|ul. Tarczyńska 28 |96-320 Mszczonów;448;241;241;7;234;53.79;2.90
96596;143802;Szkoła Podstawowa|Mszczonów|ul. Warszawska 27 |96-320 Mszczonów;612;342;342;9;333;55.88;2.63
96597;143802;Izba Pamięci Rodziny Maklakiewiczów|Mszczonów|ul. Kościuszki 1 |96-320 Mszczonów;726;291;291;10;281;40.08;3.44
96598;143802;Szkoła Podstawowa|Piekary|ul. Piekarska 47 |96-323 Osuchów;694;295;295;14;281;42.51;4.75
96599;143802;Zespół Szkół Publicznych|Osuchów|ul. Szkolna 1 |96-323 Osuchów;583;221;221;4;217;37.91;1.81
96600;143802;Szkoła Podstawowa|Bobrowce|ul. Mszczonowska 5 |96-323 Osuchów;610;258;258;6;252;42.30;2.33
96601;143802;Zespół Szkół|Mszczonów|ul. Ługowa 13 |96-320 Mszczonów;678;316;316;19;297;46.61;6.01
96602;143802;Szkoła Podstawowa|Lutkówka|ul. Szkolna 1 |96-323 Osuchów;712;278;278;14;264;39.04;5.04
96603;143803;Budynek Gminny,tzw."dom kultury"|Puszcza Mariańska|ul. Króla Jana Sobieskiego 1 |96-330 Puszcza Mariańska;1567;783;783;17;766;49.97;2.17
96604;143803;Szkoła Podstawowa|Michałów| 39 |96-330 Puszcza Mariańska;845;317;317;10;307;37.51;3.15
96605;143803;Filia Szkoły Podstawowej w Puszczy Mariańskiej|Stary Łajszczew| 49A |96-330 Puszcza Mariańska;382;137;137;6;131;35.86;4.38
96606;143803;Niepubliczne Przedszkole Językowo-Artystyczne "Leśne Skrzaty"|Kamion| 85 |96-330 Puszcza Mariańska;328;134;134;6;128;40.85;4.48
96607;143803;Filia Szkoły Podstawowej w Puszczy Mariańskiej|Korabiewice| 50A |96-330 Puszcza Mariańska;473;205;205;9;196;43.34;4.39
96608;143803;Szkoła Podstawowa|Waleriany| 24 |96-330 Puszcza Mariańska;939;463;463;16;447;49.31;3.46
96609;143803;Zespół Szkolno-Gimnazjalny|Bartniki|ul. Miodowa 47 |96-332 Radziwiłłów;1457;758;758;39;719;52.02;5.15
96610;143803;Zespół Szkolno-Gimnazjalny|Bartniki|ul.Miodowa 47 |96-332 Radziwiłłów;776;415;415;14;401;53.48;3.37
96611;143803;Zakład Pielęgnacyjno - Opiekuńczy w Wycześniaku|Wycześniak| 22 |96-330 Puszcza Mariańska;113;16;16;3;13;14.16;18.75
96612;143804;Gimnazjum|Radziejowice|ul. Kubickiego 3A |96-325 Radziejowice;1203;653;653;11;642;54.28;1.68
96613;143804;Gimnazjum|Radziejowice|ul. Kubickiego 3A |96-325 Radziejowice;864;513;513;10;503;59.38;1.95
96614;143804;Szkoła Podstawowa|Korytów A|ul. Szkolna 3 |96-300 Żyrardów;903;479;479;17;462;53.05;3.55
96615;143804;Hala Sportowa|Korytów A|ul. Szkolna 3 |96-300 Żyrardów;638;310;310;8;302;48.59;2.58
96616;143804;Szkoła Podstawowa|Kuklówka Radziejowicka|ul. Szkolna 30 |96-325 Radziejowice;699;394;394;9;385;56.37;2.28
96617;143804;Dom Pomocy Społecznej|Tartak Brzózki|ul. Mszczonowska 1 |96-325 Radziejowice;56;19;19;3;16;33.93;15.79
96618;143805;Świetlica Wiejska w Starych Kozłowicach|Stare Kozłowice| 145 |96-315 Wiskitki;429;250;250;10;240;58.28;4.00
96619;143805;Ochotnicza Straż Pożarna|Nowe Kozłowice| 17 |96-315 Wiskitki;483;259;259;7;252;53.62;2.70
96620;143805;Ochotnicza Straż Pożarna|Jesionka|ul. Aleja Partyzantów 22 |96-315 Wiskitki;1005;459;459;18;441;45.67;3.92
96621;143805;Szkoła Podstawowa|Franciszków|ul. Dębowa 49 |96-315 Wiskitki;910;352;353;26;326;38.68;7.39
96622;143805;Szkoła Podstawowa|Guzów-Osada|ul. Rodu Łubieńskich 2 |96-317 Wiskitki;1409;648;648;16;632;45.99;2.47
96623;143805;Szkoła Podstawowa|Miedniewice| 86 |96-315 Wiskitki;1175;501;501;14;487;42.64;2.79
96624;143805;VITA-MED Sp. z. o. o.|Oryszew-Osada| 15 |96-317 Wiskitki;476;176;176;11;165;36.97;6.25
96625;143805;Szkoła Podstawowa|Wiskitki|Plac Wolności 34 |96-315 Wiskitki;836;401;401;8;393;47.97;2.00
96626;143805;Urząd Gminy|Wiskitki|ul. Kościuszki 1 |96-315 Wiskitki;1136;550;550;21;529;48.42;3.82
96627;146101;I Liceum Ogólnokształcące|Ostrołęka|ul. Romualda Traugutta 1 |07-410 Ostrołęka;2185;1082;1082;18;1064;49.52;1.66
96628;146101;Urząd Miasta Ostrołęki|Ostrołęka|Plac Gen. J. Bema 1 |07-410 Ostrołęka;1072;589;589;6;583;54.94;1.02
96629;146101;Przedszkole Miejskie Nr 10|Ostrołęka|ul. Mazowiecka 7 |07-410 Ostrołęka;1904;1048;1048;12;1036;55.04;1.15
96630;146101;Szkoła Podstawowa Nr 6|Ostrołęka|ul. Henryka Sienkiewicza 15 |07-410 Ostrołęka;1939;1025;1025;18;1007;52.86;1.76
96631;146101;Gimnazjum Nr 2|Ostrołęka|ul. Stefana Jaracza 5 |07-410 Ostrołęka;1781;854;854;17;837;47.95;1.99
96632;146101;Szkoła Podstawowa Nr 5|Ostrołęka|ul. Romualda Traugutta 2 |07-410 Ostrołęka;1898;781;781;16;765;41.15;2.05
96633;146101;Szkoła Podstawowa Nr 2|Ostrołęka|ul. Papiernicza 1 |07-410 Ostrołęka;1794;838;838;17;821;46.71;2.03
96634;146101;Ostrołęcka Spółdzielnia Mieszkaniowa|Ostrołęka|ul. Gen. Józefa Hallera 13 |07-410 Ostrołęka;1774;851;851;21;830;47.97;2.47
96635;146101;Przedszkole Miejskie Nr 13|Ostrołęka|ul. Dzieci Polskich 5 |07-410 Ostrołęka;1195;680;680;17;663;56.90;2.50
96636;146101;Przedszkole Miejskie Nr 5|Ostrołęka|ul. Piękna 12 |07-410 Ostrołęka;1649;689;689;34;655;41.78;4.93
96637;146101;Przedszkole Miejskie Nr 7|Ostrołęka|ul. dr. Józefa Psarskiego 24 |07-410 Ostrołęka;1480;703;703;17;686;47.50;2.42
96638;146101;Gimnazjum Nr 1|Ostrołęka|ul. Gen. Józefa Hallera 12 |07-410 Ostrołęka;753;315;315;13;302;41.83;4.13
96639;146101;Zespół Szkół Zawodowych Nr 1|Ostrołęka|ul. 11 Listopada 20 |07-410 Ostrołęka;1662;904;904;9;895;54.39;1.00
96640;146101;Szkoła Podstawowa Nr 1|Ostrołęka|ul. Gen. Armii Aleksandra Gorbatowa 4 6|07-410 Ostrołęka;1881;1000;1000;17;983;53.16;1.70
96641;146101;Przedszkole Miejskie Nr 16|Ostrołęka|ul. Powstańców 4 |07-410 Ostrołęka;1957;1052;1052;18;1034;53.76;1.71
96642;146101;Placówka Pieczy Zastępczej "Korczakówka"|Ostrołęka|ul. Poznańska 34 36|07-410 Ostrołęka;2002;1221;1221;18;1203;60.99;1.47
96643;146101;Przedszkole Miejskie Nr 1|Ostrołęka|ul. Rtm. Witolda Pileckiego 11A |07-410 Ostrołęka;1979;1067;1067;18;1049;53.92;1.69
96644;146101;Zespół Szkół Nr 5|Ostrołęka|ul. Gen. Zygmunta Berlinga 5 |07-410 Ostrołęka;1899;1088;1088;14;1074;57.29;1.29
96645;146101;Szkoła Podstawowa Nr 10|Ostrołęka|ul. Gen. Zygmunta Berlinga 16 |07-410 Ostrołęka;2174;1274;1274;16;1258;58.60;1.26
96646;146101;Klub Oczko OCK|Ostrołęka|ul. Gen. Władysława Sikorskiego 6 |07-410 Ostrołęka;2041;1023;1023;14;1009;50.12;1.37
96647;146101;Placówka Wsparcia Dziennego|Ostrołęka|Plac Dworcowy 4 |07-410 Ostrołęka;1901;1010;1010;21;989;53.13;2.08
96648;146101;Zespół Szkół Nr 3|Ostrołęka|ul. Ignacego Jerzego Skowrońskiego 8 |07-410 Ostrołęka;1357;733;733;4;729;54.02;0.55
96649;146101;Budynek Administracyjno-biurowy|Ostrołęka|ul. Gen. Armii Aleksandra Gorbatowa 15 |07-410 Ostrołęka;1243;740;740;8;732;59.53;1.08
96650;146101;Budynek socjalno - gospodarczy|Ostrołęka|ul. Sosnowa 5 |07-410 Ostrołęka;646;375;375;13;362;58.05;3.47
96651;146101;Budynek Hotelu dla Pielęgniarek|Ostrołęka|Al. Jana Pawła II 120 |07-410 Ostrołęka;1098;592;592;6;586;53.92;1.01
96652;146101;Dom Pomocy Społecznej|Ostrołęka|ul. Rolna 27 |07-410 Ostrołęka;185;116;116;14;102;62.70;12.07
96653;146101;Dom Pomocy Społecznej PCK|Ostrołęka|ul. I Armii Wojska Polskiego 32 |07-410 Ostrołęka;19;18;18;3;15;94.74;16.67
96654;146101;Mazowiecki Szpital Specjalistyczny w Ostrołęce im. dr. J. Psarskiego|Ostrołęka|Aleja Jana Pawła II 120A |07-410 Ostrołęka;225;87;87;7;80;38.67;8.05
96655;146101;Mazowiecki Szpital Specjalistyczny w Ostrołęce im. dr. J. Psarskiego|Ostrołęka|ul. Henryka Sienkiewicza 56 |07-410 Ostrołęka;34;4;4;0;4;11.76;0.00
96656;146201;Izba Wytrzeźwień|Płock|ul. Medyczna 1 |09-400 Płock;1247;752;752;17;735;60.30;2.26
96657;146201;Miejskie Przedszkole Nr 19|Płock|ul. Słowackiego 27 |09-400 Płock;863;385;385;11;374;44.61;2.86
96658;146201;Szkoła Podstawowa Nr 18 im. J. Z. Jakubowskiego|Płock|ul. Jasna 8 |09-400 Płock;1317;651;651;10;641;49.43;1.54
96659;146201;Zespół Szkół Budowlanych Nr 1 - budynek warsztatów szkolnych|Płock|ul. Prezydenta Ignacego Mościckiego 4 |09-400 Płock;2168;1051;1051;19;1032;48.48;1.81
96660;146201;Szkoła Podstawowa Nr 18 im. J. Z. Jakubowskiego|Płock|ul. Jasna 8 |09-400 Płock;1201;637;637;6;631;53.04;0.94
96661;146201;Szkoła Podstawowa Nr 17 im. Tadeusza Kościuszki|Płock|ul. Miodowa 13a |09-400 Płock;1348;636;636;18;618;47.18;2.83
96662;146201;Zespół Szkół Budowlanych Nr 1|Płock|ul. Prezydenta Ignacego Mościckiego 4 |09-400 Płock;1469;603;603;13;590;41.05;2.16
96663;146201;Gimnazjum Nr 4 im. Obrońców Płocka 1920 r.|Płock|ul. Miodowa 18 |09-400 Płock;1766;807;807;26;781;45.70;3.22
96664;146201;Miejskie Przedszkole Nr 10|Płock|ul. M. C. Skłodowskiej 2a |09-400 Płock;1096;446;446;8;438;40.69;1.79
96665;146201;Gimnazjum Nr 4 im. Obrońców Płocka 1920 r.|Płock|ul. Miodowa 18 |09-400 Płock;691;341;341;3;338;49.35;0.88
96666;146201;Miejskie Przedszkole Nr 14|Płock|ul. Miodowa 8/1 |09-400 Płock;1232;538;538;11;527;43.67;2.04
96667;146201;Zespół Szkół Ekonomiczno - Kupieckich im. L. Krzywickiego|Płock|ul. Abp. Nowowiejskiego 4 |09-400 Płock;988;524;524;9;515;53.04;1.72
96668;146201;Zespół Szkół Nr 3|Płock|ul. Łukasiewicza 11 |09-400 Płock;1593;935;935;16;919;58.69;1.71
96669;146201;Klub Osiedla Łukasiewicza Płockiej Spółdzielni Mieszkaniowej|Płock|ul. Łukasiewicza 28 |09-400 Płock;1715;949;949;17;932;55.34;1.79
96670;146201;Gimnazjum Nr 5 im. Zygmunta Padlewskiego (wejście od ul. Wolskiego)|Płock|ul. Królowej Jadwigi 4 |09-400 Płock;1546;877;877;14;863;56.73;1.60
96671;146201;Miejskie Przedszkole Nr 17 im. Małego Księcia|Płock|ul. Kossobudzkiego 10 |09-400 Płock;1477;896;896;19;877;60.66;2.12
96672;146201;Szkoła Podstawowa Nr 3 im. Kornela Makuszyńskiego|Płock|ul. Kossobudzkiego 7 |09-400 Płock;1609;906;906;10;896;56.31;1.10
96673;146201;Spółdzielczy Dom Kultury|Płock|ul. Bolesława Krzywoustego 3 |09-400 Płock;1291;704;704;12;692;54.53;1.70
96674;146201;Zespół Szkół Centrum Edukacji im. Ignacego Łukasiewicza|Płock|Al. Kobylińskiego 25 |09-400 Płock;543;287;287;4;283;52.85;1.39
96675;146201;Szkoła Podstawowa Nr 16 im. Mikołaja Kopernika|Płock|ul. Piasta Kołodzieja 7 |09-400 Płock;1174;680;680;18;662;57.92;2.65
96676;146201;Szkoła Podstawowa Nr 16 im. Mikołaja Kopernika - budynek Hali Gimnastycznej|Płock|ul. Piasta Kołodzieja 7 |09-400 Płock;1208;667;667;9;658;55.22;1.35
96677;146201;Zespół Szkół Zawodowych im. Marii Skłodowskiej - Curie|Płock|ul. Gwardii Ludowej 7 |09-400 Płock;1640;935;935;18;917;57.01;1.93
96678;146201;Szkoła Podstawowa Nr 13 im. Jana Brzechwy|Płock|ul. Sierpecka 15 |09-402 Płock;246;135;135;6;129;54.88;4.44
96679;146201;Szkoła Podstawowa Nr 1 im. Braci Jeziorowskich|Płock|Pasaż Vuka Karadzica 1 |09-400 Płock;1065;434;434;9;425;40.75;2.07
96680;146201;Liceum Ogólnokształcące im. Marsz. St. Małachowskiego|Płock|ul. Marsz. St. Małachowskiego 1 |09-400 Płock;1121;423;423;2;421;37.73;0.47
96681;146201;Płocki Ośrodek Kultury i Sztuki (wejście od ul. Sienkiewicza).|Płock|ul. Tumska 9 |09-402 Płock;663;196;196;6;190;29.56;3.06
96682;146201;Zespół Szkół Nr 6|Płock|ul. 3-go Maja 4 |09-402 Płock;1163;672;672;7;665;57.78;1.04
96683;146201;Centrum Kształcenia Ustawicznego im. Pokolenia Kolumbów|Płock|ul. Jakubowskiego 10 |09-402 Płock;1449;737;737;22;715;50.86;2.99
96684;146201;Państwowa Szkoła Muzyczna I i II st. im. Karola Szymanowskiego|Płock|ul. Kolegialna 23 |09-402 Płock;1342;634;634;14;620;47.24;2.21
96685;146201;Zespół Szkół Usług i Przedsiębiorczości im. Abpa. A. J. Nowowiejskiego|Płock|ul. Padlewskiego 2 |09-402 Płock;1957;1053;1053;19;1034;53.81;1.80
96686;146201;Miejskie Przedszkole Nr 11|Płock|ul. Bielska 26/1 |09-400 Płock;825;432;432;16;416;52.36;3.70
96687;146201;Klub Osiedla Kochanowskiego|Płock|ul. Obrońców Westerplatte 6a |09-400 Płock;1288;684;684;18;666;53.11;2.63
96688;146201;Szkoła Podstawowa z Oddziałami Integracyjnymi Nr 11 im. Bolesława Chrobrego|Płock|ul. Kochanowskiego 11 |09-402 Płock;1957;1119;1119;15;1104;57.18;1.34
96689;146201;Miejskie Przedszkole Nr 29|Płock|ul. Kochanowskiego 7 |09-400 Płock;1336;745;745;11;734;55.76;1.48
96690;146201;Gimnazjum Nr 6 im. prof. Władysława Szafera|Płock|Al. Jachowicza 20 |09-402 Płock;1859;1036;1036;26;1010;55.73;2.51
96691;146201;Miejskie Przedszkole Nr 27|Płock|ul. Mikołaja Reja 28 |09-402 Płock;1123;643;643;11;632;57.26;1.71
96692;146201;Miejskie Przedszkole Nr 21|Płock|ul. Mikołaja Reja 4 |09-402 Płock;1143;648;648;14;634;56.69;2.16
96693;146201;Zespół Szkół Nr 2|Płock|ul. Chopina 62 |09-402 Płock;1659;989;989;19;970;59.61;1.92
96694;146201;Specjalny Ośrodek Szkolno - Wychowawczy Nr 2|Płock|ul. Lasockiego 14 |09-402 Płock;1461;825;825;6;819;56.47;0.73
96695;146201;Zespół Szkół Technicznych|Płock|Al. Kilińskiego 4 |09-402 Płock;2118;1218;1218;17;1201;57.51;1.40
96696;146201;Szkoła Podstawowa Nr 12 im. Miry Zimińskiej - Sygietyńskiej|Płock|ul. Brzozowa 3 |09-402 Płock;1462;823;823;13;810;56.29;1.58
96697;146201;Urząd Miasta Płocka|Płock|Al. Marsz. J. Piłsudskiego 6 |09-407 Płock;1761;1043;1043;14;1029;59.23;1.34
96698;146201;Stacja Uzdatniania Wody|Płock|ul. Górna 56 |09-402 Płock;2031;1258;1258;18;1240;61.94;1.43
96699;146201;Zespół Szkół Nr 1|Płock|ul. Piaska 5 |09-407 Płock;1783;1129;1129;15;1114;63.32;1.33
96700;146201;Miejskie Przedszkole Nr 5|Płock|ul. Piaska 3 |09-407 Płock;1295;778;778;13;765;60.08;1.67
96701;146201;Miejskie Przedszkole Nr 5|Płock|ul. Dobrowolskiego 4 |09-407 Płock;1269;780;780;10;770;61.47;1.28
96702;146201;ENERGA Informatyka i Technologie Sp. z o. o.|Płock|al. marsz. J. Piłsudskiego 41 |09-407 Płock;1047;587;587;6;581;56.06;1.02
96703;146201;Biurowiec WEKTRA HOLDING Sp. z o. o.|Płock|ul. Otolińska 21 |09-407 Płock;1164;576;576;12;564;49.48;2.08
96704;146201;Szkoła Podstawowa z Oddziałami Integracyjnymi Nr 23 im. Armii Krajowej|Płock|ul. Walecznych 20 |09-410 Płock;1471;782;782;16;766;53.16;2.05
96705;146201;Szkoła Podstawowa z Odziałami Integracyjnymi Nr 23 im. Armii Krajowej|Płock|ul. Walecznych 20 |09-410 Płock;1792;989;989;8;981;55.19;0.81
96706;146201;Miejskie Przedszkole Nr 37|Płock|ul. Hubalczyków 5 |09-410 Płock;2143;1352;1352;26;1326;63.09;1.92
96707;146201;Zespół Szkół Nr 5 (wejście boczne - stołówka)|Płock|ul. Gen. T. Kutrzeby 2a |09-410 Płock;2034;1297;1297;10;1287;63.77;0.77
96708;146201;Zespół Szkół Nr 5 (wejście główne)|Płock|ul. Gen. T. Kutrzeby 2a |09-410 Płock;1841;1198;1198;10;1188;65.07;0.83
96709;146201;Szkoła Podstawowa z Oddziałami Integracyjnymi Nr 22 im. Janusza Korczaka|Płock|ul. Czwartaków 6 |09-410 Płock;1876;1044;1044;11;1033;55.65;1.05
96710;146201;Miejskie Przedszkole Nr 4 im. Jasia i Małgosi|Płock|ul. Czwartaków 18b |09-410 Płock;2363;1484;1484;14;1470;62.80;0.94
96711;146201;Pływalnia Miejska "Podolanka"|Płock|ul. Czwartaków 6 |09-410 Płock;2060;983;984;28;955;47.72;2.85
96712;146201;Miejskie Przedszkole Nr 34 im. Kubusia Puchatka i Jego Przyjaciół|Płock|ul. Harcerska 2 |09-410 Płock;2170;1335;1335;16;1319;61.52;1.20
96713;146201;Siedziba Rady Mieszkańców Osiedla "Borowiczki"|Płock|ul. Borowicka 3 |09-408 Płock;1728;887;887;17;870;51.33;1.92
96714;146201;Szkoła Podstawowa Nr 20 im. Wł. Broniewskiego|Płock|ul. Korczaka 10 |09-408 Płock;1354;796;796;15;781;58.79;1.88
96715;146201;CENTROMOST Stocznia Rzeczna w Płocku Sp. z o. o.|Płock|ul. Popłacińska 42 |09-402 Płock;1731;912;912;6;906;52.69;0.66
96716;146201;Gimnazjum Nr 3 im. Jana Pawła II|Płock|ul. Krakówka 4 |09-402 Płock;1569;825;825;13;812;52.58;1.58
96717;146201;Szkoła Podstawowa Nr 15|Płock|ul. Przyszkolna 22 |09-402 Płock;1264;695;695;19;676;54.98;2.73
96718;146201;Miejskie Przedszkole Nr 2|Płock|ul. Ciechomicka 68 |09-402 Płock;982;528;528;14;514;53.77;2.65
96719;146201;Szkoła Podstawowa z Oddziałami Integracyjnymi Nr 23 im. Armii Krajowej|Płock|ul. Walecznych 20 |09-410 Płock;1097;584;584;8;576;53.24;1.37
96720;146201;Szkoła Podstawowa z Oddziałami Integracyjnymi Nr 23 im. Armii Krajowej|Płock|ul. Walecznych 20 |09-410 Płock;1768;1077;1077;11;1066;60.92;1.02
96721;146201;Szkoła Podstwawowa z Oddziałami Integracynymi Nr 22 im. Janusza Korczaka|Płock|ul. Czwartaków 6 |09-410 Płock;1356;847;847;10;837;62.46;1.18
96722;146201;Miejskie Przedszkole Nr 19|Płock|ul. Słowackiego 27 |09-400 Płock;1444;634;634;29;605;43.91;4.57
96723;146201;Płocki Zakład Opieki Zdrowotnej Sp. z o. o.|Płock|ul. Kościuszki 28 -|09-402 Płock;103;63;63;5;58;61.17;7.94
96724;146201;Wojewódzki Szpital Zespolony im. M. Kacprzaka|Płock|ul. Medyczna 19 -|09-400 Płock;347;195;195;9;186;56.20;4.62
96725;146201;Zakład Karny|Płock|ul. Sienkiewicza 22 -|09-402 Płock;553;271;271;38;233;49.01;14.02
96726;146301;V Liceum Ogólnokształcące im. Romualda Traugutta z Oddziałami Dwujęzycznymi|Radom, Śródmieście|ul. Traugutta 52a |26-600 Radom;975;387;387;4;383;39.69;1.03
96727;146301;III Liceum Ogólnokształcące im. płk. Dionizego Czachowskiego|Radom, Śródmieście|ul. Traugutta 44 |26-600 Radom;997;496;496;10;486;49.75;2.02
96728;146301;Publiczna Szkoła Podstawowa Nr 13 im.Ks.Józefa Poniatowskiego|Radom, Śródmieście|ul. Sienkiewicza 30 |26-600 Radom;1241;637;637;7;630;51.33;1.10
96729;146301;Publiczna Szkoła Podstawowa Nr 7 im. Kazimierza Pułaskiego|Radom, Śródmieście|ul. Tybla 7/11 |26-600 Radom;1001;485;485;8;477;48.45;1.65
96730;146301;Publiczna Szkoła Podstawowa Nr 13 im. Ks. Józefa Poniatowskiego|Radom, Śródmieście|ul.Henryka Sienkiewicza 30 |26-600 Radom;1166;577;577;4;573;49.49;0.69
96731;146301;RTBS "Administrator"|Radom, Śródmieście|ul. Waryńskiego 16A |26-600 Radom;1111;581;581;8;573;52.30;1.38
96732;146301;Publiczna Szkoła Podstawowa Nr 7 im. Kazimierza Pułaskiego|Radom, Stare Miasto|ul. Tybla 7/11 |26-600 Radom;821;401;401;5;396;48.84;1.25
96733;146301;I Liceum Ogólnokształcące im. Mikołaja Kopernika|Radom, Śródmieście|ul. Żeromskiego 10 |26-600 Radom;772;340;340;10;330;44.04;2.94
96734;146301;Zespół Szkół Ogólnokształcących nr 7|Radom, Stare Miasto|ul. Staromiejska 11 |26-600 Radom;666;318;318;3;315;47.75;0.94
96735;146301;Publiczna Szkoła Podstawowa Nr 28 im. Adama Mickiewicza|Radom, Planty|ul. Jaracza 8 |26-600 Radom;1938;939;939;18;921;48.45;1.92
96736;146301;Zespół Szkół Budowlanych im. Kazimierza Wielkiego|Radom, Planty|ul. Kościuszki 7 |26-600 Radom;777;388;388;3;385;49.94;0.77
96737;146301;Wydział Sztuki Uniwersytetu Technologiczno - Humanistycznego im. Kazimierza Pułaskiego|Radom, Śródmieście|ul. Malczewskiego 22 |26-600 Radom;515;199;199;4;195;38.64;2.01
96738;146301;Publiczna Szkoła Podstawowa Nr 5 im. Marii Dąbrowskiej|Radom, Śródmieście|ul. Sowińskiego 1 |26-600 Radom;1660;907;907;13;894;54.64;1.43
96739;146301;Publiczna Szkoła Podstawowa Nr 5 im. Marii Dąbrowskiej|Radom, Śródmieście|ul Sowińskiego 1 |26-600 Radom;1958;1110;1110;21;1089;56.69;1.89
96740;146301;Przedszkole Publiczne Nr 2|Radom, Śródmieście|ul. Jasińskiego 4 |26-600 Radom;1189;665;665;14;651;55.93;2.11
96741;146301;Publiczna Szkoła Podstawowa Nr 34|Radom, Śródmieście|ul. Miła 18 |26-600 Radom;1845;1057;1057;12;1045;57.29;1.14
96742;146301;II Liceum Ogólnokształcące im. Marii Konopnickiej|Radom, Śródmieście|ul. Kusocińskiego 8 |26-600 Radom;1103;618;618;22;596;56.03;3.56
96743;146301;XI LO z Oddziałami Integracyjnymi im. Stanisława Staszica|Radom, Śródmieście|ul. 11-go Listopada 27 |26-600 Radom;1924;931;931;10;921;48.39;1.07
96744;146301;Przedszkole Publiczne Nr 15|Radom, Śródmieście|ul. Kusocińskiego 10a |26-600 Radom;1493;770;770;24;746;51.57;3.12
96745;146301;Zespół Szkół Ogólnokształcących Nr 6 im. Jana Kochanowskiego|Radom, Śródmieście|ul. Kilińskiego 25 |26-600 Radom;999;383;383;11;372;38.34;2.87
96746;146301;Zespół Szkół Ogólnokształcących Nr 6 im. Jana Kochanowskiego|Radom, Śródmieście|ul.Kilińskiego 25 |26-600 Radom;1074;534;534;11;523;49.72;2.06
96747;146301;Przedszkole Publiczne Nr. 4 im. Juliana Tuwima|Radom, Śródmieście|ul. Kilińskiego 23 |26-600 Radom;872;433;433;6;427;49.66;1.39
96748;146301;Publiczne Gimnazjum Nr 13 z Oddziałami Dwujęzycznymi im. Polskich Noblistów|Radom, Śródmieście|ul. 25 Czerwca 79 |26-600 Radom;1722;985;985;12;973;57.20;1.22
96749;146301;Publiczna Szkoła Podstawowa Nr 33 im. Kawalerów Orderu Uśmiechu|Radom, Śródmieście|ul. Kolberga 5 |26-600 Radom;1657;1018;1018;5;1013;61.44;0.49
96750;146301;Publiczna Szkoła Podstawowa Nr 33 im.Kawalerów Orderu Uśmiechu|Radom, Śródmieście|ul.Kolberga 5 - wejście od ulicy Siennej 7 |26-600 Radom;1773;992;992;19;973;55.95;1.92
96751;146301;Młodzieżowy Dom Kultury im. Heleny Stadnickiej|Radom, Śródmieście|ul.Słowackiego 17 |26-600 Radom;1809;965;965;21;944;53.34;2.18
96752;146301;Młodzieżowy Dom Kultury im. Heleny Stadnickiej|Radom, Śródmieście|ul.Słowackiego 17 |26-600 Radom;1506;710;710;10;700;47.14;1.41
96753;146301;Publiczna Szkoła Podstawowa Nr 6 im. Orła Białego|Radom, Gołębiów|ul. Rapackiego 24 |26-600 Radom;2064;1209;1209;20;1189;58.58;1.65
96754;146301;Publiczna Szkoła Podstawowa Nr 24 im.Kornela Makuszyńskiego|Radom, Gołębiów|ul. Powstańców Śląskich 4 |26-600 Radom;1705;1064;1064;8;1056;62.40;0.75
96755;146301;Przedszkole Publiczne Nr 1 im. Marii Konopnickiej|Radom, Śródmieście|ul. Zientarskiego 3 |26-600 Radom;1858;1132;1132;20;1112;60.93;1.77
96756;146301;Przedszkole Publiczne Nr 24 im. Janusza Korczaka|Radom, Gołębiów|ul.Powstańców Śląskich 9 |26-600 Radom;1862;1082;1082;17;1065;58.11;1.57
96757;146301;Zespół Szkół Elektronicznych im. Bohaterów Westerplatte|Radom, Gołębiów|ul. Sadkowska 19 |26-600 Radom;1395;855;855;8;847;61.29;0.94
96758;146301;Przedszkole Publiczne Nr 3 im. Janiny Porazińskiej|Radom, Gołębiów|ul. Olsztyńska 12 |26-600 Radom;2107;1251;1251;13;1238;59.37;1.04
96759;146301;Publiczne Gimnazjum Nr 6|Radom, Gołębiów|ul. Sadkowska 16 |26-600 Radom;1458;802;802;12;790;55.01;1.50
96760;146301;Wodociągi Miejskie Sp.z o.o.|Radom, Śródmieście|ul. Filtrowa 4 |26-600 Radom;1395;628;628;10;618;45.02;1.59
96761;146301;Przedszkole Publiczne Nr. 3 im. Janiny Porazińskiej|Radom, Śródmieście|ul. Olsztyńska 12 |26-600 Radom;2068;1079;1079;23;1056;52.18;2.13
96762;146301;Dom Pomocy Społecznej "Nad Potokiem"|Radom, Śródmieście|ul. Struga 88 |26-600 Radom;135;68;68;11;57;50.37;16.18
96763;146301;Tarnobrzeska Specjalna Strefa Ekonomiczna|Radom, Gołębiów|ul. Tarnobrzeska 8 |26-600 Radom;2030;1135;1135;9;1126;55.91;0.79
96764;146301;Publiczna Szkoła Podstawowa Nr 19 im. Edmunda Bakalarza|Radom, Stara Wola Gołębiowska|ul. Energetyków 10 |26-600 Radom;1345;654;654;21;633;48.62;3.21
96765;146301;Publiczna Szkoła Podstawowa Nr 1 z Oddziałami Integracyjnymi im. Ignacego Daszyńskiego|Radom, Glinice|ul. Odrodzenia 37 |26-600 Radom;1695;1030;1030;16;1014;60.77;1.55
96766;146301;Publiczna Szkoła Podstawowa Nr 1 z Oddziałami Integracyjnymi im. Ignacego Daszyńskiego|Radom, Glinice|ul. Odrodzenia 37 |26-600 Radom;1493;832;832;11;821;55.73;1.32
96767;146301;Przedszkole Publiczne Nr 9 im. Ewy Szelburg-Zarembiny|Radom, Glinice|ul. Kalińska 4 |26-600 Radom;1585;790;790;11;779;49.84;1.39
96768;146301;Publiczne Gimnazjumnr Nr 10 im. Lotników Polskich|Radom, Glinice|ul. Długojowska 6 |26-600 Radom;1931;1095;1095;29;1066;56.71;2.65
96769;146301;Zespół Szkół Plastycznych im. Józefa Brandta|Radom, Ustronie|aleja Grzecznarowskiego 13 |26-600 Radom;1306;585;585;9;576;44.79;1.54
96770;146301;Publiczna Szkoła Podstawowa Nr 31 im. Kardynała Stefana Wyszyńskiego|Radom, Idalin|ul. Biała 6 |26-600 Radom;1000;512;512;9;503;51.20;1.76
96771;146301;Publiczna Szkoła Podstawowa Nr 31 im. Kardynała Stefana Wyszyńskiego|Radom, Idalin|ul. Biała 6 |26-600 Radom;1932;1063;1066;20;1043;55.02;1.88
96772;146301;Publiczna Szkoła Podstawowa Nr 20 im. Obrońców Pokoju|Radom, Malenice|ul. Malenicka 29 |26-600 Radom;1950;1007;1007;20;987;51.64;1.99
96773;146301;Publiczna Szkoła Podstawowa Nr 4 im. Św.Kazimierza Jagiellończyka|Radom, Ustronie|ul. Wyścigowa 49 |26-600 Radom;2188;1241;1241;17;1224;56.72;1.37
96774;146301;Dom Kultury "Idalin"|Radom, Idalin|ul. Bluszczowa 4/8 |26-600 Radom;2148;1204;1204;24;1180;56.05;1.99
96775;146301;Publiczna Szkoła Podstawowa Nr 4 z Oddziałami Integracyjnymi im. Św. Kazimierza Jagiellończyka|Radom, Ustronie|ul. Wyścigowa 49 |26-600 Radom;2044;1123;1123;7;1116;54.94;0.62
96776;146301;Specjalny Ośrodek Szkolno-Wychowawczy im. Janusza Korczaka|Radom, Ustronie|aleja Grzecznarowskiego 15 |26-600 Radom;1500;886;886;22;864;59.07;2.48
96777;146301;Przedszkole Publiczne Nr 16|Radom, Ustronie|ul. Grenadierów 3 |26-600 Radom;974;527;527;7;520;54.11;1.33
96778;146301;Publiczne Gimnazjum Nr 2 im. Adama Jerzego Czartoryskiego|Radom, Ustronie|ul. Gagarina 19 |26-600 Radom;1695;1023;1023;17;1006;60.35;1.66
96779;146301;Publiczna Szkoła Podstawowa Nr 9 im. Henryka Sienkiewicza|Radom, Ustronie|ul. Sandomierska 19 |26-600 Radom;1295;802;802;17;785;61.93;2.12
96780;146301;Publiczna Szkoła Podstawowa Nr 9 im. Henryka Sienkiewicza|Radom, Ustronie|ul. Sandomierska 19 |26-600 Radom;1665;929;929;20;909;55.80;2.15
96781;146301;Przedszkole Publiczne Nr 10 im. Jana Brzechwy|Radom, Ustronie|ul. Osiedlowa 26 |26-600 Radom;1588;905;906;13;892;56.99;1.44
96782;146301;Zespół Szkół Ogólnokształcących Nr 4 z Oddziałami Sportowymi im. Polskich Olimpijczyków|Radom, Ustronie|ul. Osiedlowa 36 |26-600 Radom;1319;763;763;6;757;57.85;0.79
96783;146301;Zespół Szkół Ogólnokształcących Nr 4 z Oddziałami Sportowymi im. Polskich Olimpijczyków|Radom, Ustronie|ul. Osiedlowa 36 |26-600 Radom;1807;923;923;16;907;51.08;1.73
96784;146301;Przedszkole Publiczne Nr 14|Radom, Ustronie|ul. Jana Pawła II 3 |26-600 Radom;1114;613;613;3;610;55.03;0.49
96785;146301;Dom Pomocy Społecznej Weterana Walki i Pracy|Radom, Prędocinek|ul. Wyścigowa 16 |26-600 Radom;1839;1042;1042;26;1016;56.66;2.50
96786;146301;Zespół Szkół Spożywczych i Hotelarskich|Radom, Prędocinek|ul. Armii Ludowej 1 |26-600 Radom;2013;1116;1116;19;1097;55.44;1.70
96787;146301;Zespół Szkół Specjalnych i Placówek Oświatowych|Radom, Prędocinek|ul. Lipska 2 |26-600 Radom;1907;1103;1103;14;1089;57.84;1.27
96788;146301;Publiczna Szkoła Podstawowa Nr 23 im. Stefana Żeromskiego|Radom, Prędocinek|ul. Gajowa 60 |26-600 Radom;2226;1166;1166;17;1149;52.38;1.46
96789;146301;Publiczna Szkoła Podstawowa Nr 23 im. Stefana Żeromskiego|Radom, Prędocinek|ul. Gajowa 60 |26-600 Radom;2144;1232;1232;15;1217;57.46;1.22
96790;146301;Publiczna Szkoła Podstawowa Nr 17 im. Przyjaciół Dzieci|Radom, Żakowice|ul. Wierzbicka 89/93 |26-600 Radom;1572;874;875;18;856;55.60;2.06
96791;146301;Przedszkole Publiczne Nr 5 im. Tadeusza Kościuszki|Radom, Żakowice|ul. Czarnoleska 15 |26-600 Radom;1792;1047;1047;13;1034;58.43;1.24
96792;146301;Publiczne Gimnazjum Nr 3 im. Jana Kochanowskiego|Radom, Żakowice|ul. Czarnoleska 10 |26-600 Radom;2120;1139;1139;18;1121;53.73;1.58
96793;146301;Budynek po byłej PSP Nr 21|Radom, Młodzianów|ul. Sobótki 5 |26-600 Radom;1913;1030;1030;15;1015;53.84;1.46
96794;146301;Budynek po byłej PSP Nr 21|Radom, Młodzianów|ul. Sobótki 5 |26-600 Radom;1983;1117;1117;13;1104;56.33;1.16
96795;146301;Publiczna Szkoła Podstawowa Nr 21 im.Ks. Jana Twardowskiego|Radom, Żakowice|ul. Trojańska 5 |26-600 Radom;1919;1049;1049;27;1022;54.66;2.57
96796;146301;Publiczna Szkoła Podstawowa Nr 21 im. Ks. Jana Twardowskiego|Radom, Żakowice|ul. Trojańska 5 |26-600 Radom;1709;901;901;13;888;52.72;1.44
96797;146301;Publiczna Szkoła Podstawowa Nr 25|Radom, Jeżowa Wola|ul. Starokrakowska 124/128 |26-600 Radom;1091;600;600;13;587;55.00;2.17
96798;146301;Publiczna Szkoła Podstawowa Nr 32 im. Marszałka Józefa Piłsudskiego|Radom, Planty|ul. Jarzyńskiego 3 |26-600 Radom;1573;950;950;7;943;60.39;0.74
96799;146301;Zespół Szkół Technicznych im. Tadeusza Kościuszki|Radom, Śródmieście|ul. Limanowskiego 26/30 |26-600 Radom;1270;696;696;16;680;54.80;2.30
96800;146301;IV Liceum Ogólnokształcące im. dr.Tytusa Chałubińskiego|Radom, Śródmieście|ul. Mariacka 25 |26-600 Radom;1317;674;674;17;657;51.18;2.52
96801;146301;Powiatowy Urząd Pracy|Radom, Śródmieście|ul.Ks. Łukasika 3 |26-600 Radom;1261;570;570;12;558;45.20;2.11
96802;146301;Publiczne Gimnazjum Nr 11 im. Bolesława Prusa|Radom, Śródmieście|ul. Kujawska 19 |26-600 Radom;1473;712;712;16;696;48.34;2.25
96803;146301;Wydział Mechaniczny Uniwersytetu Technologiczno - Humanistycznego im. Kazimierza Pułaskiego|Radom, Borki|ul. Krasickiego 54 |26-600 Radom;1749;880;880;38;842;50.31;4.32
96804;146301;Publiczna Szkoła Podstawowa Nr 2 im. Hansa Chrystiana Andersena|Radom, Borki|ul. Batalionów Chłopskich 16 |26-600 Radom;1863;1017;1019;24;993;54.59;2.36
96805;146301;Przedszkole Publiczne Nr 19|Radom, Borki|ul. Batalionów Chłopskich 18 |26-600 Radom;1581;905;909;12;893;57.24;1.33
96806;146301;Publiczna Szkoła Podstawowa Nr 26|Radom, Wośniki|ul. Wośnicka 125 |26-600 Radom;1237;731;731;5;726;59.09;0.68
96807;146301;Publiczna Szkoła Podstawowa Nr 26|Radom, Wośniki|ul. Wośnicka 125 |26-600 Radom;787;432;432;3;429;54.89;0.69
96808;146301;Świetlica "Kocur"|Radom, Wośniki|ul. Wośnicka 32a |26-600 Radom;2196;1258;1258;24;1234;57.29;1.91
96809;146301;Poradnia Psychologiczno-Pedagogiczna Nr 3|Radom, Zamłynie|ul. Główna 3 |26-600 Radom;2100;1173;1173;17;1156;55.86;1.45
96810;146301;Mazowiecki Zarząd Dróg Wojewódzkich w Warszawie Rejon Drogowy w Radomiu|Radom, Wacyn|ul. Wolanowska 61 |26-600 Radom;1782;987;987;12;975;55.39;1.22
96811;146301;Publiczna Szkoła Podstawowa Nr 15 im. Władysława Syrokomli|Radom, Zamłynie|ul. Kielecka 2/6 |26-600 Radom;984;464;464;4;460;47.15;0.86
96812;146301;Filia Publicznej Szkoły Podstawowej Nr 15|Radom, Kierzków|ul. Kierzkowska 118 |26-600 Radom;1214;662;662;13;649;54.53;1.96
96813;146301;Publiczne Gimnazjum Nr 12 im. Mikołaja Reja|Radom, Zamłynie|ul. Krucza 2/10 |26-600 Radom;1384;732;732;14;718;52.89;1.91
96814;146301;Publiczna Szkoła Podstawowa nr 2 im. Hansa Chrystiana Andersena|Radom, Borki|ul. Batalionów Chłopskich 16 |26-600 Radom;1306;776;776;8;768;59.42;1.03
96815;146301;Publiczna Szkoła Podstawowa Nr 15 im. Władysława Syrokomli|Radom, Zamłynie|ul. Kielecka 2/6 |26-600 Radom;1940;1196;1196;7;1189;61.65;0.59
96816;146301;Publiczna Szkoła Podstawowa Nr 29 im. Władysława Broniewskiego|Radom, Wacyn|ul. Ceglana 14 |26-600 Radom;2081;1149;1149;18;1131;55.21;1.57
96817;146301;Zespół Szkół Ekonomicznych|Radom, Śródmieście|ul. Wernera 22 |26-600 Radom;1331;706;706;12;694;53.04;1.70
96818;146301;Bursa Szkolna Nr 3|Radom, Obozisko|ul. Śniadeckich 5 |26-600 Radom;1314;670;670;13;657;50.99;1.94
96819;146301;Miejski Ośrodek Kultury "Amfiteatr"|Radom, Obozisko|ul. Parkowa 1 |26-600 Radom;1282;728;728;8;720;56.79;1.10
96820;146301;Dom Studenta Nr 2 "Walet"|Radom, Gołębiów|ul. Akademicka 3 |26-600 Radom;2017;1239;1239;15;1224;61.43;1.21
96821;146301;Filia Publicznej Szkoły Podstawowej Nr 6|Radom, Gołębiów|ul. Paderewskiego 36 |26-600 Radom;1562;995;995;7;988;63.70;0.70
96822;146301;Przedszkole Publiczne Nr 6|Radom, Gołębiów|ul. Rapackiego 4 |26-600 Radom;1601;950;950;8;942;59.34;0.84
96823;146301;Publiczna Szkoła Podstawowa Nr 3 im. Jana Długosza|Radom, Michałów|ul. Sobieskiego (wejście od strony ul. Sobieskiego) 12 |26-600 Radom;2010;1190;1190;14;1176;59.20;1.18
96824;146301;Publiczna Szkoła Podstawowa Nr 3 im. Jana Długosza|Radom, Michałów|ul. Sobieskiego (wejście od strony ul. Jagiellońskiej) 12 |26-600 Radom;2130;1301;1301;21;1280;61.08;1.61
96825;146301;VIII Liceum Ogólnokształcące im. Jana III Sobieskiego|Radom, Michałów|ul. Sobieskiego 12 |26-600 Radom;1821;1070;1070;17;1053;58.76;1.59
96826;146301;Publiczne Gimnazjum nr 8 z Oddziałami Integracyjnymi i Dwujęzycznymi im. Królowej Jadwigi|Radom, Michałów|ul. Piastowska 17 |26-600 Radom;2021;1181;1181;13;1168;58.44;1.10
96827;146301;Publiczne Gimnazjum nr 8 z Oddziałami Integracyjnymi i Dwujęzycznymi im. Królowej Jadwigi|Radom, Michałów|ul. Piastowska 17 |26-600 Radom;2249;1333;1333;15;1318;59.27;1.13
96828;146301;Zespół Szkolno - Przedszkolny Nr 1|Radom, Wólka Klwatecka|ul. Ofiar Firleja 14 |26-600 Radom;2032;1020;1020;13;1007;50.20;1.27
96829;146301;Publiczna Szkoła Podstawowa Nr 25|Radom, Jeżowa Wola|ul. Starokrakowska 124/128 |26-600 Radom;1358;640;640;22;618;47.13;3.44
96830;146301;Zespół Szkolno - Przedszkolny Nr 1|Radom, Wólka Klwatecka|ul. Ofiar Firleja 14a |26-600 Radom;1212;653;653;9;644;53.88;1.38
96831;146301;Publiczne Gimnazjum Nr 22 im. Karola Wojtyłły|Radom, Gołębiów|ul.Rapackiego 24 |26-600 Radom;2186;1328;1328;15;1313;60.75;1.13
96832;146301;Przedszkole Publiczne Nr 13|Radom, Zamłynie|ul.Garbarska 59/67 |26-600 Radom;914;475;475;14;461;51.97;2.95
96833;146301;Dom Kultury "Idalin"|Radom, Idalin|ul. Bluszczowa 4/8 |26-600 Radom;792;386;386;7;379;48.74;1.81
96834;146301;Zespół Szkół Ekonomicznych|Radom, Kaptur|ul. Wernera 22 |26-600 Radom;1480;790;790;20;770;53.38;2.53
96835;146301;Radomski Szpital Specjalistyczny im.Dr T. Chałubińskiego|Radom|Tochtermana 1 |26-600 Radom;95;56;56;2;54;58.95;3.57
96836;146301;Samodzielny Wojewódzki Publiczny Zespół Zakładów Psychiatrycznej Opieki Zdrowotnej im. dr. Barbary Borzym|Radom|Krychnowicka 1 |26-600 Radom;48;41;41;1;40;85.42;2.44
96837;146301;Areszt Śledczy|Radom|Wolanowska 120 |26-600 Radom;792;311;311;35;276;39.27;11.25
96838;146301;Mazowiecki Szpital Specjalistyczny Sp. z o.o.|Radom|Aleksandrowicza 5 |26-600 Radom;242;193;193;3;190;79.75;1.55
96839;146301;Oddział Zewnętrzny Aresztu Śledczego|Radom|Witosa 62 |26-600 Radom;59;59;59;16;43;100.00;27.12
96840;146401;Miejskie Przedszkole Nr 3|Siedlce|ul. Batorego 4 |08-110 Siedlce;1410;792;792;9;783;56.17;1.14
96841;146401;Miejskie Przedszkole nr 20|Siedlce|ul. Osiedlowa 3 |08-110 Siedlce;1460;844;844;5;839;57.81;0.59
96842;146401;Osiedlowy Klub Kultury "Lech"|Siedlce|ul. Chrobrego 4 |08-110 ;1374;784;784;14;770;57.06;1.79
96843;146401;Zespół Szkół Ponadgimnazjalnych Nr 3|Siedlce|ul. Popiełuszki 8 |08-110 Siedlce;1797;1056;1056;11;1045;58.76;1.04
96844;146401;Miejskie Przedszkole Nr 14|Siedlce|ul. Mieszka I 12 |08-110 Siedlce;1542;890;890;15;875;57.72;1.69
96845;146401;Uniwersytet Przyrodniczo-Humanistyczny|Siedlce|ul. Żytnia 39 |08-110 Siedlce;1394;770;770;8;762;55.24;1.04
96846;146401;Zespół Szkół Nr 1|Siedlce|ul. Graniczna 1 |08-110 Siedlce;1666;938;938;10;928;56.30;1.07
96847;146401;Społeczna Szkoła Podstawowa|Siedlce|ul. Mireckiego 28 |08-110 Siedlce;1727;1090;1090;17;1073;63.12;1.56
96848;146401;II Liceum Ogólnokształcące z Oddziałami Dwujęzycznymi im. Św. Królowej Jadwigi|Siedlce|ul. Prusa 12 |08-110 Siedlce;1607;968;968;5;963;60.24;0.52
96849;146401;Szkoła Podstawowa Nr 7|Siedlce|ul. Starowiejska 23 |08-110 Siedlce;1504;851;851;8;843;56.58;0.94
96850;146401;Miejskie Przedszkole Nr 1|Siedlce|ul. Wiązowa 7 |08-110 Siedlce;1366;817;817;9;808;59.81;1.10
96851;146401;I Katolickie Liceum Ogólnokształcące|Siedlce|ul. Bpa Świrskiego 54 |08-110 Siedlce;1465;856;856;9;847;58.43;1.05
96852;146401;Zespół Szkół Ponadgimnazjalnych Nr 6|Siedlce|ul. Chopina 10 |08-110 Siedlce;1495;958;958;10;948;64.08;1.04
96853;146401;Powiatowy Urząd Pracy|Siedlce|ul. Pułaskiego 19/21 |08-110 Siedlce;1060;489;489;10;479;46.13;2.04
96854;146401;Siedlecka Spółdzielnia Mieszkaniowa|Siedlce|ul. 3-go Maja 28 |08-110 Siedlce;1790;995;995;16;979;55.59;1.61
96855;146401;Szkoła Podstawowa Nr 6|Siedlce|ul. Sienkiewicza 49 |08-110 Siedlce;1626;874;874;12;862;53.75;1.37
96856;146401;Publiczne Gimnazjum Nr 2|Siedlce|ul. Szkolna 2 |08-110 Siedlce;1648;745;745;22;723;45.21;2.95
96857;146401;I Liceum Ogólnokształcące im. B.Prusa|Siedlce|ul. Floriańska 10 |08-110 Siedlce;1488;857;857;5;852;57.59;0.58
96858;146401;Publiczne Gimnazjum Nr 3|Siedlce|ul. Sekulska 10 |08-110 Siedlce;1679;898;898;13;885;53.48;1.45
96859;146401;Miejskie Przedszkole Nr 17|Siedlce|ul. Wyszyńskiego 6 |08-110 Siedlce;1521;833;833;13;820;54.77;1.56
96860;146401;Miejskie Przedszkole Nr 17|Siedlce|ul. Wyszyńskiego 6 |08-110 Siedlce;1534;886;886;8;878;57.76;0.90
96861;146401;Centrum Kształcenia Zawodowego i Ustawicznego|Siedlce|ul. Młynarska 17 |08-110 Siedlce;1457;817;817;9;808;56.07;1.10
96862;146401;Miejskie Przedszkole Nr 1|Siedlce|ul. Wiązowa 7 |08-110 Siedlce;1099;710;710;9;701;64.60;1.27
96863;146401;Urząd Stanu Cywilnego|Siedlce|ul. Bpa Świrskiego 6 |08-110 Siedlce;1458;871;871;11;860;59.74;1.26
96864;146401;Miejskie Przedszkole Nr 21|Siedlce|ul. Żwirowa 20 |08-110 Siedlce;1412;843;843;14;829;59.70;1.66
96865;146401;Zespół Szkół Nr 2|Siedlce|ul. Orlicz-Dreszera 3 |08-110 Siedlce;2267;1421;1421;22;1399;62.68;1.55
96866;146401;Przedsiębiorstwo Wodociągów i Kanalizacji Sp z o.o.|Siedlce|ul. Leśna 8 |08-110 Siedlce;1852;1086;1086;7;1079;58.64;0.64
96867;146401;Szkoła Podstawowa Nr 12|Siedlce|ul. Unitów Podlaskich 16 |08-110 Siedlce;1786;1101;1101;11;1090;61.65;1.00
96868;146401;Szkoła Podstawowa Nr 12|Siedlce|ul. Unitów Podlaskich 16 |08-110 Siedlce;1718;1000;1000;7;993;58.21;0.70
96869;146401;Miejskie Przedszkole Nr 27|Siedlce|ul. Karpacka 2 |08-110 Siedlce;1457;851;851;7;844;58.41;0.82
96870;146401;Publiczne Gimnazjum Nr 4|Siedlce|ul. Pescantina 2 |08-110 Siedlce;1515;915;915;13;902;60.40;1.42
96871;146401;Policealne Studium Menedżerskie "NOVUM"|Siedlce|ul. Dylewicza 10 |08-110 Siedlce;1628;986;986;9;977;60.57;0.91
96872;146401;Szkoła Podstawowa Nr 10|Siedlce|ul. Mazurska 10 |08-110 Siedlce;1689;1101;1101;9;1092;65.19;0.82
96873;146401;Hotel "Hetman"|Siedlce|ul. Warszawska 133 |08-110 Siedlce;1586;957;957;21;936;60.34;2.19
96874;146401;Miejskie Przedszkole Nr 22|Siedlce|ul. Podlaska 8 |08-110 Siedlce;1563;898;898;8;890;57.45;0.89
96875;146401;Miejskie Przedszkole Nr 26|Siedlce|ul. Mazurska 6 |08-110 Siedlce;1395;843;843;8;835;60.43;0.95
96876;146401;Policealne Studium Menedżerskie "NOVUM"|Siedlce|ul. Dylewicza 10 |08-110 Siedlce;1733;939;939;22;917;54.18;2.34
96877;146401;Jednostka Ratowniczo-Gaśnicza Nr 2|Siedlce|ul. Składowa 7 |08-110 Siedlce;1308;781;781;16;765;59.71;2.05
96878;146401;Mazowiecki Szpital Wojewódzki Sp. z o.o.|Siedlce|Poniatowskiego 26 |08-110 Siedlce;562;125;125;4;121;22.24;3.20
96879;146401;Szpital Samodzielnego Publicznego Zakładu Opieki Zdrowotnej|Siedlce|Starowiejska 15 |08-110 Siedlce;311;60;60;4;56;19.29;6.67
96880;146401;Szpital Samodzielnego Publicznego Zakładu Opieki Zdrowotnej|Siedlce|Bema 22 |08-110 Siedlce;83;7;7;0;7;8.43;0.00
96881;146401;Dom Pomocy Społecznej|Siedlce|Poniatowskiego 32 |08-110 Siedlce;80;29;29;3;26;36.25;10.34
96882;146401;Zakład Karny|Siedlce|Piłsudskiego 47 |08-110 Siedlce;643;239;239;25;214;37.17;10.46
96883;146502;Zespół Szkół Nr 46|Bemowo|ul. Gen. Wiktora Thomme'ego 1 |01-491 Warszawa;1464;974;974;11;963;66.53;1.13
96884;146502;Szkoła Podstawowa Nr 357|Bemowo|ul. Zachodzącego Słońca 25 |01-495 Warszawa;1494;1176;1176;5;1171;78.71;0.43
96885;146502;Szkoła Podstawowa Nr 357|Bemowo|ul. Zachodzącego Słońca 25 |01-495 Warszawa;1395;1050;1050;12;1038;75.27;1.14
96886;146502;Szkoła Podstawowa Nr 357|Bemowo|ul. Zachodzącego Słońca 25 |01-495 Warszawa;2159;1618;1618;10;1608;74.94;0.62
96887;146502;Szkoła Podstawowa Nr 357|Bemowo|ul. Zachodzącego Słońca 25 |01-495 Warszawa;1838;1377;1377;6;1371;74.92;0.44
96888;146502;Szkoła Podstawowa Nr 357|Bemowo|ul. Zachodzącego Słońca 25 |01-495 Warszawa;1765;1304;1304;10;1294;73.88;0.77
96889;146502;Szkoła Podstawowa Nr 341|Bemowo|ul. Oławska 3 |01-494 Warszawa;1520;1048;1048;7;1041;68.95;0.67
96890;146502;Zespoł Szkól Nr 46|Bemowo|ul. Gen. Wiktora Thomme'ego 1 |01-491 Warszawa;957;685;685;2;683;71.58;0.29
96891;146502;Hala Sportowa OSiR|Bemowo|ul. Obrońców Tobruku 40 |01-494 Warszawa;1797;1335;1335;10;1325;74.29;0.75
96892;146502;Bemowski Ośrodek Piłki Nożnej|Bemowo|ul. Obrońców Tobruku 11 |01-494 Warszawa;1093;869;871;5;864;79.51;0.58
96893;146502;Bemowski Ośrodek Piłki Nożnej|Bemowo|ul. Obrońców Tobruku 11 |01-494 Warszawa;1701;1364;1364;5;1359;80.19;0.37
96894;146502;Szkoła Podstawowa Nr 341|Bemowo|ul. Oławska 3 |01-494 Warszawa;880;659;659;8;651;74.89;1.21
96895;146502;Szkoła Podstawowa Nr 321 w Zespole Szkolno-Przedszkolnym Nr 7|Bemowo|ul. ppłk. Wacława Szadkowskiego 3 |01-493 Warszawa;1672;1195;1195;8;1187;71.47;0.67
96896;146502;Szkoła Podstawowa Nr 321 w Zespole Szkolno-Przedszkolnym Nr 7|Bemowo|ul. ppłk. Wacława Szadkowskiego 3 |01-493 Warszawa;2042;1428;1428;16;1412;69.93;1.12
96897;146502;Szkoła Podstawowa Nr 321 w Zespole Szkolno-Przedszkolnym Nr 7|Bemowo|ul. ppłk. Wacława Szadkowskiego 3 |01-493 Warszawa;1684;1195;1195;9;1186;70.96;0.75
96898;146502;Przedszkole Nr 390|Bemowo|ul. Secemińska 1 |01-485 Warszawa;1880;1254;1254;20;1234;66.70;1.59
96899;146502;Gimnazjum Nr 83|Bemowo|ul. Michała Elwira Andriollego 1 |01-494 Warszawa;1504;1092;1100;11;1081;72.61;1.01
96900;146502;Szkoła Podstawowa Nr 341|Bemowo|ul. Oławska 3 |01-494 Warszawa;1646;1086;1086;8;1078;65.98;0.74
96901;146502;Gimnazjum Nr 83|Bemowo|ul. Michała Elwira Andriollego 1 |01-494 Warszawa;2121;1494;1494;6;1488;70.44;0.40
96902;146502;Gimnazjum Nr 83|Bemowo|ul. Michała Elwira Andriollego 1 |01-494 Warszawa;1918;1352;1357;6;1346;70.49;0.44
96903;146502;Przedszkole Nr 389 w Zespole Szkolno-Przedszkolnym Nr 7|Bemowo|ul. ppłk. Wacława Szadkowskiego 3 |01-493 Warszawa;1475;1108;1108;6;1102;75.12;0.54
96904;146502;Bemowskie Centrum Kultury|Bemowo|ul. Górczewska 201 |01-459 Warszawa;909;661;661;2;659;72.72;0.30
96905;146502;Szkoła Podstawowa Nr 316 w Zespole Szkolno-Przedszkolnym Nr 6|Bemowo|ul. Stanisława Szobera 1/3 |01-318 Warszawa;1408;967;967;6;961;68.68;0.62
96906;146502;Szkoła Podstawowa Nr 316 w Zespole Szkolno-Przedszkolnym Nr 6|Bemowo|ul. Stanisława Szobera 1/3 |01-318 Warszawa;2060;1392;1392;7;1385;67.57;0.50
96907;146502;Gimnazjum Nr 82|Bemowo|ul. Gen. Waleriana Czumy 8 |01-355 Warszawa;1712;1143;1155;9;1134;66.76;0.79
96908;146502;Szkoła Podstawowa Nr 316 w Zespole Szkolno-Przedszkolnym Nr 6|Bemowo|ul. Stanisława Szobera 1/3 |01-318 Warszawa;2016;1387;1387;18;1369;68.80;1.30
96909;146502;Gimnazjum Nr 82|Bemowo|ul. Gen. Waleriana Czumy 8 |01-355 Warszawa;1727;1141;1149;7;1134;66.07;0.61
96910;146502;Urząd Dzielnicy Bemowo m.st. Warszawy|Bemowo|ul. Powstańców Śląskich 70 |01-381 Warszawa;1839;1361;1361;9;1352;74.01;0.66
96911;146502;Przedszkole Nr 214|Bemowo|ul. Gen. Waleriana Czumy 6 |01-355 Warszawa;1979;1377;1377;17;1360;69.58;1.23
96912;146502;Zespół Szkól Nr 48 im. Armii Krajowej|Bemowo|ul. Karola Irzykowskiego 1A |01-317 Warszawa;1934;1362;1362;12;1350;70.42;0.88
96913;146502;Zespół Szkól Nr 48 im. Armii Krajowej|Bemowo|ul. Karola Irzykowskiego 1A |01-317 Warszawa;2039;1347;1347;9;1338;66.06;0.67
96914;146502;Zespół Szkól Nr 48 im. Armii Krajowej|Bemowo|ul. Karola Irzykowskiego 1A |01-317 Warszawa;1998;1329;1329;19;1310;66.52;1.43
96915;146502;Szkoła Podstawowa Nr 306|Bemowo|ul. Tkaczy 27 |01-346 Warszawa;1337;957;957;3;954;71.58;0.31
96916;146502;Zespół Szkolno-Przedszkolny Nr 2|Bemowo|ul. Brygadzistów 18 |01-384 Warszawa;1924;1249;1249;9;1240;64.92;0.72
96917;146502;Zespół Szkolno-Przedszkolny Nr 2|Bemowo|ul. Brygadzistów 18 |01-384 Warszawa;1614;1067;1067;10;1057;66.11;0.94
96918;146502;Zespoł Szkolno-Przedszkolny Nr 2|Bemowo|ul. Brygadzistów 18 |01-384 Warszawa;1768;1080;1080;4;1076;61.09;0.37
96919;146502;LXXVIII Liceum Ogólnokształcące|Bemowo|ul. Anieli Krzywoń 3 |01-391 Warszawa;1680;1192;1192;8;1184;70.95;0.67
96920;146502;LXXVIII Liceum Ogólnokształcące|Bemowo|ul. Anieli Krzywoń 3 |01-391 Warszawa;1889;1233;1233;7;1226;65.27;0.57
96921;146502;Gimnazjum Nr 81|Bemowo|ul. Rozłogi 10 |01-310 Warszawa;1915;1264;1264;15;1249;66.01;1.19
96922;146502;Szkoła Podstawowa Nr 306|Bemowo|ul. Tkaczy 27 |01-346 Warszawa;1814;1236;1236;14;1222;68.14;1.13
96923;146502;Gimnazjum Nr 81|Bemowo|ul. Rozłogi 10 |01-310 Warszawa;1975;1393;1393;20;1373;70.53;1.44
96924;146502;Gimnazjum Nr 81|Bemowo|ul. Rozłogi 10 |01-310 Warszawa;1533;1089;1089;11;1078;71.04;1.01
96925;146502;Biblioteka Glówna WAT|Bemowo|ul. Gen. Sylwestra Kaliskiego 19 |01-476 Warszawa;1641;1251;1251;7;1244;76.23;0.56
96926;146502;Klub Oficerski|Bemowo|ul. Gen. Sylwestra Kaliskiego 25 |01-476 Warszawa;2097;1559;1559;7;1552;74.34;0.45
96927;146502;Instytut Fizyki Plazmy i Laserowej Mikrosyntezy|Bemowo|ul. Hery 23 |01-497 Warszawa;1130;896;896;4;892;79.29;0.45
96928;146502;Przedszkole Nr 381 w Zespole Szkolno-Przedszkolnym Nr 6|Bemowo|ul. Stanisława Szobera 1/3 |01-318 Warszawa;2053;1512;1512;15;1497;73.65;0.99
96929;146502;TBS Bemowo|Bemowo|ul. Gen. Tadeusza Pełczyńskiego 30 |01-471 Warszawa;1865;1436;1436;6;1430;77.00;0.42
96930;146502;TBS Bemowo|Bemowo|ul. Gen. Tadeusza Pełczyńskiego 30 |01-471 Warszawa;2086;1551;1551;13;1538;74.35;0.84
96931;146502;Urząd Dzielnicy Bemowo m.st. Warszawy|Bemowo|ul. Powstańców Śląskich 70 |01-381 Warszawa;2114;1599;1599;6;1593;75.64;0.38
96932;146502;Urząd Dzielnicy Bemowo m.st. Warszawy|Bemowo|ul. Powstańców Śląskich 70 |01-381 Warszawa;2127;1480;1480;4;1476;69.58;0.27
96933;146502;Szkoła Podstawowa Nr 82|Bemowo|ul. Górczewska 201 |01-459 Warszawa;1968;1456;1456;16;1440;73.98;1.10
96934;146502;Bemowskie Centrum Kultury|Bemowo|ul. Górczewska 201 |01-459 Warszawa;1241;929;929;6;923;74.86;0.65
96935;146502;Szkoła Podstawowa Nr 82|Bemowo|ul. Górczewska 201 |01-459 Warszawa;1708;1282;1282;5;1277;75.06;0.39
96936;146502;Biblioteka Publiczna Dzielnicy Bemowo m.st. Warszawy|Warszawa|ul. Gen. Tadeusza Pełczyńskiego 28C |01-471 Warszawa;1167;807;807;3;804;69.15;0.37
96937;146502;Oddział Zewnętrzny Bemowo-Służba Więzienna|Warszawa|Antoniego Kocjana 3 |01-473 Warszawa;221;219;219;33;186;99.10;15.07
96938;146502;Dom Pomocy Społecznej " KOMBATANT"|Warszawa|Sternicza 125 |01-350 Warszawa;169;79;79;0;79;46.75;0.00
96939;146502;Dom Emeryta Wojskowego|Warszawa|Pirenejska 5 |01-493 Warszawa;73;46;46;2;44;63.01;4.35
96940;146503;Szkoła Podstawowa nr 356|Białołęka|Głębocka 66 |03-287 WARSZAWA;1838;1322;1322;11;1311;71.93;0.83
96941;146503;Szkoła Podstawowa Nr 118|Białołęka|Leszczynowa 5 |03-197 WARSZAWA;2116;1506;1509;14;1492;71.17;0.93
96942;146503;Gimnazjum Nr 122|Białołęka|ul. Van Gogha 1 |03-188 WARSZAWA;961;648;648;6;642;67.43;0.93
96943;146503;Szkoła Podstawowa Nr 314|Białołęka|Porajów 3 |03-188 WARSZAWA;1443;900;900;11;889;62.37;1.22
96944;146503;Gimnazjum Nr 122|Białołęka|ul. Van Gogha 1 |03-188 WARSZAWA;2034;1486;1486;2;1484;73.06;0.13
96945;146503;Gimnazjum Nr 122|Białołęka|ul. Van Gogha 1 |03-188 WARSZAWA;1023;733;733;5;728;71.65;0.68
96946;146503;Szkoła Podstawowa Nr 314|Białołęka|ul. Porajów 3 |03-188 WARSZAWA;951;654;654;3;651;68.77;0.46
96947;146503;Szkoła Podstawowa Nr 314|Białołęka|ul. Porajów 3 |03-188 WARSZAWA;1030;633;633;2;631;61.46;0.32
96948;146503;Szkoła Podstawowa Nr 314|Białołęka|Porajów 3 |03-188 WARSZAWA;1075;747;747;7;740;69.49;0.94
96949;146503;Szkoła Podstawowa nr 31|Białołęka|ul. Kobiałka 49 |03-044 WARSZAWA;1863;1245;1245;4;1241;66.83;0.32
96950;146503;Szkoła Podstawowa nr 231|Białołęka|ul. Juranda ze Spychowa 10 |03-257 WARSZAWA;2120;1607;1608;16;1591;75.80;1.00
96951;146503;Szkoła Podstawowa Nr 356|Białołęka|ul. Głębocka 66 |03-287 WARSZAWA;1357;941;941;11;930;69.34;1.17
96952;146503;Szkoła Podstawowa Nr 118|Białołęka|ul. Leszczynowa 5 |03-197 WARSZAWA;2072;1231;1231;17;1214;59.41;1.38
96953;146503;Szkoła Podstawowa Nr 112|Białołęka|ul. Zaułek 34 |03-289 WARSZAWA;1226;852;852;9;843;69.49;1.06
96954;146503;Szkoła Podstawowa Nr 314|Białołęka|ul. Porajów 3 |03-188 WARSZAWA;1351;907;907;10;897;67.14;1.10
96955;146503;Szkoła Podstawowa Nr 344|Białołęka|Erazma z Zakroczymia 15 |03-185 WARSZAWA;1311;890;890;1;889;67.89;0.11
96956;146503;Przedszkole nr 65|Białołęka|Pancera 3 |03-187 WARSZAWA;942;669;669;5;664;71.02;0.75
96957;146503;Przedszkole nr 65|Białołęka|ul. Pancera 3 |03-187 WARSZAWA;1200;856;856;1;855;71.33;0.12
96958;146503;Szkoła Podstawowa Nr 344|Białołęka|Erazma z Zakroczymia 15 |03-185 WARSZAWA;1608;1127;1127;14;1113;70.09;1.24
96959;146503;Szkoła Podstawowa Nr 344|Białołęka|Erazma z Zakroczymia 15 |03-185 WARSZAWA;1507;1022;1022;9;1013;67.82;0.88
96960;146503;Szkoła Podstawowa Nr 355|Białołęka|Ceramiczna 11 |03-126 WARSZAWA;1966;1512;1512;7;1505;76.91;0.46
96961;146503;Szkoła Podstawowa nr 257|Białołęka|ul. Podróżnicza 11 |03-111 WARSZAWA;2285;1667;1667;8;1659;72.95;0.48
96962;146503;Gimnazjum nr 124|Białołęka|ul. Przytulna 3 |03-083 WARSZAWA;1452;1168;1168;5;1163;80.44;0.43
96963;146503;Szkoła Podstawowa nr 110|Białołęka|ul. Bohaterów 41 |03-007 WARSZAWA;1266;830;830;6;824;65.56;0.72
96964;146503;Szkoła Podstawowa nr 110|Białołęka|ul. Bohaterów 41 |03-007 WARSZAWA;1321;1011;1011;7;1004;76.53;0.69
96965;146503;Ośrodek Pomocy Społecznej|Białołęka|ul. Marywilska 44C |03-042 WARSZAWA;595;408;408;3;405;68.57;0.74
96966;146503;Szkoła Podstawowa Nr 342|Białołęka|Strumykowa 21A |03-138 WARSZAWA;1516;1060;1060;11;1049;69.92;1.04
96967;146503;Szkoła Podstawowa Nr 342|Białołęka|ul. Strumykowa 21A |03-138 WARSZAWA;1934;1351;1351;9;1342;69.86;0.67
96968;146503;Szkoła Podstawowa Nr 342|Białołęka|ul. Strumykowa 21A |03-138 WARSZAWA;1929;1349;1349;15;1334;69.93;1.11
96969;146503;Gimnazjum nr 123|Białołęka|ul. Strumykowa 21 |03-138 WARSZAWA;1741;1240;1240;9;1231;71.22;0.73
96970;146503;Gimnazjum nr 123|Białołęka|Strumykowa 21 |03-138 WARSZAWA;1888;1436;1436;8;1428;76.06;0.56
96971;146503;Szkoła Podstawowa nr 154|Białołęka|Leśnej Polanki 63/65 |03-142 WARSZAWA;1879;1241;1248;11;1230;66.05;0.89
96972;146503;Filia Szkoły Podstawowej Nr 342|Białołęka|ul. Topolowa 15 |03-138 WARSZAWA;1304;972;972;1;971;74.54;0.10
96973;146503;Szkoła Podstawowa nr 154|Białołęka|Leśnej Polanki 63/65 |03-142 WARSZAWA;1691;1117;1117;8;1109;66.06;0.72
96974;146503;Gimnazjum nr 123|Białołęka|ul. Strumykowa 21 |03-138 WARSZAWA;1355;951;951;5;946;70.18;0.53
96975;146503;Szkoła Podstawowa nr 154|Białołęka|ul. Leśnej Polanki 63/65 |03-142 WARSZAWA;1795;1160;1161;13;1147;64.62;1.12
96976;146503;Szkoła Podstawowa Nr 257|Białołęka|ul. Podróżnicza 11 |03-111 WARSZAWA;952;640;640;3;637;67.23;0.47
96977;146503;Szkoła Podstawowa nr 231|Białołęka|ul. Juranda ze Spychowa 10 |03-257 WARSZAWA;2064;1493;1496;1;1492;72.34;0.07
96978;146503;Szkoła Podstawowa Nr 356|Białołęka|Głębocka 66 |03-287 WARSZAWA;1763;1272;1272;10;1262;72.15;0.79
96979;146503;Szkoła Podstawowa Nr 356|Białołęka|Głębocka 66 |03-287 WARSZAWA;1603;1148;1148;9;1139;71.62;0.78
96980;146503;Gimnazjum Nr 123|Białołęka|ul.Strumykowa 21 |03-138 WARSZAWA;1375;974;974;4;970;70.84;0.41
96981;146503;Szkoła Podstawowa nr 154|Białołęka|ul.Leśnej Polanki 63/65 |03-142 WARSZAWA;1416;951;951;8;943;67.16;0.84
96982;146503;Szkoła Podstawowa Nr 344|Białołęka|ul. Erazma z Zakroczymia 15 |03-185 WARSZAWA;1700;1261;1261;10;1251;74.18;0.79
96983;146503;Szkoła Podstawowa Nr 154|Białołęka|ul. Leśnej Polanki 63/65 |03-142 WARSZAWA;1703;1242;1242;8;1234;72.93;0.64
96984;146503;Szkoła Podstawowa Nr 112|Białołęka|Zaułek 34 |03-289 Warszawa;1671;1111;1111;8;1103;66.49;0.72
96985;146503;Szkoła Podstawowa Nr 31|Białołęka|Kobiałka 49 |03-044 Warszawa;1762;1270;1270;20;1250;72.08;1.57
96986;146503;Gimnazjum Nr 164|Białołęka|Ostródzka 175 |03-287 Warszawa;1105;805;805;3;802;72.85;0.37
96987;146503;Gimnazjum Nr 123|WARSZAWA|Strumykowa 21 |03-138 Warszawa;1319;940;940;6;934;71.27;0.64
96988;146503;Filia Szkoły Podstawowej Nr 342|WARSZAWA|Topolowa 15 |03-138 Warszawa;1109;804;806;3;801;72.50;0.37
96989;146503;Szkoła Podstawowa Nr 112|WARSZAWA|Zaułek 34 |03-289 Warszawa;1766;1129;1129;10;1119;63.93;0.89
96990;146503;Poradnia Psychologiczno-Pedagogiczna Nr 21|Warszawa|Marywilska 44 |03-042 WARSZAWA;728;425;425;8;417;58.38;1.88
96991;146503;Zakład Karny|Warszawa|Ciupagi 1B |03-016 Warszawa;407;186;186;40;146;45.70;21.51
96992;146503;Areszt Śledczy|Warszawa|Ciupagi 1 |03-016 Warszawa;1049;575;575;53;522;54.81;9.22
96993;146503;Zakład Opiekuńczo-Leczniczy|Warszawa|Mehoffera 72/74 |03-131 Warszawa;427;86;86;3;83;20.14;3.49
96994;146503;Dom Pomocy Społecznej ''Pod Brzozami"|Warszawa|Bohaterów 46/48 |03-007 Warszawa;74;29;29;3;26;39.19;10.34
96995;146504;Zespół Szkół nr 55|Warszawa|ul. Gwiaździsta 35 |01-651 Warszawa;1751;1357;1357;10;1347;77.50;0.74
96996;146504;Przedszkole nr 346|Warszawa|ul. Klaudyny 8 |01-684 Warszawa;1705;1296;1296;7;1289;76.01;0.54
96997;146504;Zespół Szkół nr 118|Warszawa|ul. Kiwerska 3 |01-682 Warszawa;1857;1432;1432;10;1422;77.11;0.70
96998;146504;Szkoła Podstawowa nr 53|Warszawa|ul. Rudzka 6 |01-689 Warszawa;1523;1134;1134;8;1126;74.46;0.71
96999;146504;Stowarzyszenie Kultury i Edukacji|Warszawa|ul. Kolektorska 9/11 |01-692 Warszawa;1143;843;843;8;835;73.75;0.95
97000;146504;Przedszkole nr 240|Warszawa|ul. Marymoncka 34 |01-813 Warszawa;1027;757;757;2;755;73.71;0.26
97001;146504;Przedszkole Specjalne nr 245|Warszawa|ul. K. Pruszyńskiego 1 |01-870 Warszawa;939;609;609;4;605;64.86;0.66
97002;146504;Budynek dawnego Wydziału Komunikacji|Warszawa|ul. B. Podczaszyńskiego 12 |01-867 Warszawa;1142;743;743;11;732;65.06;1.48
97003;146504;Zespół Szkół nr 119|Warszawa|ul. B. Zuga 16 |01-806 Warszawa;1716;1154;1154;14;1140;67.25;1.21
97004;146504;Przedszkole nr 97|Warszawa|ul.Twardowska 23 |01-810 Warszawa;1444;977;977;27;950;67.66;2.76
97005;146504;Szkoła Podstawowa nr 133|Warszawa|ul. A. Fontany 3 |01-835 Warszawa;1476;1066;1068;14;1052;72.22;1.31
97006;146504;Szkoła Podstawowa nr 133|Warszawa|ul. A. Fontany 3 |01-835 Warszawa;1396;929;929;10;919;66.55;1.08
97007;146504;Ośrodek Pomocy Społecznej|Warszawa|ul. S. Przybyszewskiego 80/82 |01-824 Warszawa;1573;1017;1017;18;999;64.65;1.77
97008;146504;Gimnazjum nr 75|Warszawa|ul. Wrzeciono 24 |01-947 Warszawa;1773;1004;1004;21;983;56.63;2.09
97009;146504;Zespół Szkół Nr 51|Warszawa|ul. L. Staffa 3/5 |01-891 Warszawa;1334;970;970;13;957;72.71;1.34
97010;146504;Zespół Szkół Nr 51|Warszawa|ul. L. Staffa 3/5 |01-891 Warszawa;1520;1100;1100;11;1089;72.37;1.00
97011;146504;Przedszkole nr 301|Warszawa|ul. L. Staffa 7B |01-891 Warszawa;1345;892;892;5;887;66.32;0.56
97012;146504;Szkoła Podstawowa nr 187|Warszawa|ul. L. Staffa 21 |01-891 Warszawa;1077;716;716;7;709;66.48;0.98
97013;146504;Zespół Szkół nr 10|Warszawa|ul. W. Perzyńskiego 10 |01-883 Warszawa;1296;824;824;9;815;63.58;1.09
97014;146504;Zespół Szkół nr 10|Warszawa|ul. W. Perzyńskiego 10 |01-883 Warszawa;1172;723;723;9;714;61.69;1.24
97015;146504;XXII Liceum Ogólnokształcące|Warszawa|ul. L. Staffa 111 |01-884 Warszawa;1669;1092;1092;13;1079;65.43;1.19
97016;146504;Zespół Szkół Nr 56|Warszawa|ul. A. Fontany 1 |01-835 Warszawa;1520;912;912;15;897;60.00;1.64
97017;146504;Przedszkole nr 307|Warszawa|ul. Księgarzy 9 |01-833 Warszawa;1700;1194;1194;17;1177;70.24;1.42
97018;146504;Gimnazjum nr 72|Warszawa|ul. S. Przybyszewskiego 45 |01-849 Warszawa;1439;1052;1052;6;1046;73.11;0.57
97019;146504;Przedszkole nr 318|Warszawa|ul. J. Kochanowskiego 9A |01-864 Warszawa;1235;833;833;12;821;67.45;1.44
97020;146504;Szkoła Podstawowa nr 293|Warszawa|ul. J. Kochanowskiego 8 |01-864 Warszawa;2155;1515;1515;24;1491;70.30;1.58
97021;146504;Przedszkole nr 105|Warszawa|ul. J. Kochanowskiego 10 |01-864 Warszawa;1881;1301;1301;15;1286;69.17;1.15
97022;146504;Szkoła Podstawowa nr 293|Warszawa|ul. J. Kochanowskiego 8 |01-864 Warszawa;2216;1577;1577;10;1567;71.16;0.63
97023;146504;Przedszkole nr 271|Warszawa|ul. W. Broniewskiego 93 |01-876 Warszawa;1321;858;858;14;844;64.95;1.63
97024;146504;Szkoła Podstawowa nr 289|Warszawa|ul. W. Broniewskiego 99A |01-876 Warszawa;1577;1009;1009;14;995;63.98;1.39
97025;146504;Przedszkole nr 308|Warszawa|al. W. Reymonta 8A |01-842 Warszawa;1292;925;925;4;921;71.59;0.43
97026;146504;I ŻSM|Warszawa|ul. J. Kochanowskiego 33A |01-864 Warszawa;1843;1451;1451;15;1436;78.73;1.03
97027;146504;S.B.M. "WARDOM"|Warszawa|ul. J. Kochanowskiego 49 |01-864 Warszawa;1480;1160;1160;14;1146;78.38;1.21
97028;146504;Szkoła Podstawowa nr 80|Warszawa|ul. Aspekt 48 |01-904 Warszawa;1830;1305;1305;7;1298;71.31;0.54
97029;146504;Szkoła Podstawowa nr 80|Warszawa|ul. Aspekt 48 |01-904 Warszawa;2054;1499;1499;8;1491;72.98;0.53
97030;146504;Zespół Szkół nr 124|Warszawa|ul. J. Conrada 6 |01-922 Warszawa;1174;778;778;13;765;66.27;1.67
97031;146504;Klub WSBM "Chomiczówka"|Warszawa|ul. P. Nerudy 1 |01-926 Warszawa;2367;1663;1663;10;1653;70.26;0.60
97032;146504;Przedszkole nr 327|Warszawa|ul. J. Conrada 10A |01-922 Warszawa;1294;922;922;10;912;71.25;1.08
97033;146504;Zespół Szkół nr 124|Warszawa|ul. J. Conrada 6 |01-922 Warszawa;1535;1056;1056;11;1045;68.79;1.04
97034;146504;Przedszkole nr 422|Warszawa|ul. Brązownicza 17 |01-929 Warszawa;1300;940;940;6;934;72.31;0.64
97035;146504;Przedszkole nr 422|Warszawa|ul. Brązownicza 17 |01-929 Warszawa;1258;948;948;18;930;75.36;1.90
97036;146504;Zespół Szkół Nr 52|Warszawa|ul. Szegedyńska 11 |01-957 Warszawa;1924;1120;1120;10;1110;58.21;0.89
97037;146504;Zespół Szkół Nr 52|Warszawa|ul. Szegedyńska 11 |01-957 Warszawa;1873;1165;1165;27;1138;62.20;2.32
97038;146504;Zespół Szkół Sportowych nr 50|Warszawa|ul. S. B. Lindego 20 |01-952 Warszawa;1700;1149;1149;12;1137;67.59;1.04
97039;146504;Zespół Szkół Sportowych nr 50|Warszawa|ul. S. B. Lindego 20 |01-952 Warszawa;1473;928;928;19;909;63.00;2.05
97040;146504;Przedszkole nr 268|Warszawa|ul. Przytyk 5A |01-962 Warszawa;1981;1081;1082;23;1058;54.57;2.13
97041;146504;Szkoła Podstawowa nr 247|Warszawa|ul. Wrzeciono 9 |01-951 Warszawa;1835;1057;1057;20;1037;57.60;1.89
97042;146504;Przedszkole nr 272|Warszawa|ul. T. Gajcego 9 |01-944 Warszawa;1650;972;972;26;946;58.91;2.67
97043;146504;Gimnazjum nr 75|Warszawa|ul. Wrzeciono 24 |01-963 Warszawa;1713;1005;1005;10;995;58.67;1.00
97044;146504;Gimnazjum nr 75|Warszawa|ul. Wrzeciono 24 |01-963 Warszawa;1669;877;877;27;850;52.55;3.08
97045;146504;Szkoła Podstawowa nr 273|Warszawa|ul. J. Balcerzaka 1 |01-944 Warszawa;1537;905;905;6;899;58.88;0.66
97046;146504;Szkoła Podstawowa nr 77|Warszawa|ul. Samogłoska 9 |01-980 Warszawa;1301;908;908;11;897;69.79;1.21
97047;146504;Szkoła Podstawowa nr 77|Warszawa|ul. Samogłoska 9 |01-980 Warszawa;1717;1340;1340;5;1335;78.04;0.37
97048;146504;Przedszkole nr 49|Warszawa|ul. Skalbmierska 12 |01-848 Warszawa;1558;1013;1014;12;1001;65.02;1.18
97049;146504;Szkoła Podstawowa nr 209|Warszawa|al. W. Reymonta 25 |01-840 Warszawa;1760;1232;1232;5;1227;70.00;0.41
97050;146504;MDK|Warszawa|ul. H. Ch. Andersena 4 |01-911 Warszawa;2243;1705;1705;14;1691;76.01;0.82
97051;146504;Przedszkole nr 341|Warszawa|ul. Wergiliusza 15 |01-915 Warszawa;1850;1332;1332;20;1312;72.00;1.50
97052;146504;Szkoła Podstawowa nr 209|Warszawa|al. W. Reymonta 25 |01-840 Warszawa;1419;1022;1022;5;1017;72.02;0.49
97053;146504;Przedszkole nr 409|Warszawa|ul. L. Tołstoja 2 |01-910 Warszawa;2420;1691;1691;11;1680;69.88;0.65
97054;146504;Zespół Szkół nr 49|Warszawa|ul. L. Tołstoja 2 |01-910 Warszawa;2418;1762;1762;11;1751;72.87;0.62
97055;146504;Przedszkole nr 340|Warszawa|ul. W. Bogusławskiego 8A |01-923 Warszawa;1944;1341;1341;18;1323;68.98;1.34
97056;146504;Przedszkole nr 340|Warszawa|ul. W. Bogusławskiego 8A |01-923 Warszawa;2170;1599;1603;9;1590;73.69;0.56
97057;146504;Klub WSBM "Chomiczówka"|Warszawa|ul. W. Bogusławskiego 6A |01-923 Warszawa;2229;1535;1535;11;1524;68.86;0.72
97058;146504;Szkoła Podstawowa nr 273 - Szkoła Filialna|Warszawa|ul. Arkuszowa 202 |01-934 Warszawa;2285;1546;1546;21;1525;67.66;1.36
97059;146504;Szpital Bielański im. ks. Jerzego Popiełuszki SPZOZ w Warszawie|Warszawa|Cegłowska 80 |01-809 Warszawa;445;148;148;3;145;33.26;2.03
97060;146504;Stołeczne Centrum Opiekuńczo-Lecznicze Sp. z o.o.|Warszawa|Szubińska 4 |01-958 Warszawa;98;23;23;1;22;23.47;4.35
97061;146505;Szkoła Podstawowa Nr 70 z Oddziałami Integracyjnymi|Warszawa|ul. J. Bruna 11 |02-594 Warszawa;2128;1652;1652;10;1642;77.63;0.61
97062;146505;Szkoła Podstawowa Nr 70 z Oddziałami Integracyjnymi|Warszawa|ul. J. Bruna 11 |02-594 Warszawa;2100;1644;1651;4;1640;78.29;0.24
97063;146505;Instytut Hematologii|Warszawa|ul. Chocimska 5 |00-791 Warszawa;1952;1299;1300;12;1287;66.55;0.92
97064;146505;Szkoła Podstawowa Nr 98 z Oddziałami Integracyjnymi|Warszawa|ul. A. Grottgera 22 |00-785 Warszawa;1827;1210;1210;6;1204;66.23;0.50
97065;146505;Szkoła Podstawowa Nr 157|Warszawa|ul. Kazimierzowska 16 |02-589 Warszawa;1263;879;879;5;874;69.60;0.57
97066;146505;Szkoła Podstawowa Nr 157|Warszawa|ul. Kazimierzowska 16 |02-589 Warszawa;1411;906;906;6;900;64.21;0.66
97067;146505;Zespół Szkół Odzieżowych, Fryzjerskich i Kosmetycznych Nr 22|Warszawa|ul. Kazimierzowska 60 |02-543 Warszawa;1319;878;878;8;870;66.57;0.91
97068;146505;Centrum "Łowicka" Dom Kultury w Dzielnicy Mokotów|Warszawa|ul. Łowicka 21 |02-502 Warszawa;1095;772;773;7;765;70.50;0.91
97069;146505;Centrum "Łowicka" Dom Kultury w Dzielnicy Mokotów|Warszawa|ul. Łowicka 21 |02-502 Warszawa;1489;1097;1097;9;1088;73.67;0.82
97070;146505;XLII Liceum Ogólnokształcące|Warszawa|ul. A. J. Madalińskiego 22 |02-513 Warszawa;1949;1331;1331;11;1320;68.29;0.83
97071;146505;XLII Liceum Ogólnokształcące|Warszawa|ul. A. J. Madalińskiego 22 |02-513 Warszawa;1751;1256;1256;7;1249;71.73;0.56
97072;146505;Szkoła Podstawowa Nr 85|Warszawa|ul. L. Narbutta 14 |02-541 Warszawa;1522;1018;1018;6;1012;66.89;0.59
97073;146505;Szkoła Podstawowa Nr 85|Warszawa|ul. L. Narbutta 14 |02-541 Warszawa;1393;875;875;0;875;62.81;0.00
97074;146505;Gimnazjum Nr 2|Warszawa|ul. L. Narbutta 65/71 |02-524 Warszawa;1629;1082;1082;11;1071;66.42;1.02
97075;146505;Gimnazjum Nr 2|Warszawa|ul. L. Narbutta 65/71 |02-524 Warszawa;1613;1123;1124;7;1116;69.62;0.62
97076;146505;Przedszkole Specjalne Nr 393|Warszawa|ul. Puławska 97 |02-595 Warszawa;780;543;543;5;538;69.62;0.92
97077;146505;Państwowy Instytut Geologiczny - Państwowy Instytut Badawczy|Warszawa|ul. Rakowiecka 4 |02-519 Warszawa;1196;820;820;3;817;68.56;0.37
97078;146505;Zespół Szkół Specjalnych nr 99|Warszawa|ul. Różana 22/24 |02-569 Warszawa;1611;1056;1056;11;1045;65.55;1.04
97079;146505;Zespół Szkół Specjalnych nr 99|Warszawa|ul. Różana 22/24 |02-569 Warszawa;1115;680;680;4;676;60.99;0.59
97080;146505;Zespół Szkół nr 61|Warszawa|ul. Wiktorska 30/32 |02-587 Warszawa;1775;1156;1156;6;1150;65.13;0.52
97081;146505;Szkoła Podstawowa Nr 69|Warszawa|ul. Wiktorska 73 |02-575 Warszawa;1278;909;912;16;893;71.13;1.76
97082;146505;XXVIII Liceum Ogólnokształcące|Warszawa|ul. Wiktorska 99 |02-582 Warszawa;1828;1196;1196;7;1189;65.43;0.59
97083;146505;LXVIII Liceum Ogólnokształcące|Warszawa|ul. L. Narbutta 31 |02-536 Warszawa;1211;822;822;7;815;67.88;0.85
97084;146505;Przedszkole Nr 330|Warszawa|Al. Niepodległości 17 |02-653 Warszawa;1324;977;977;2;975;73.79;0.20
97085;146505;Przedszkole Nr 330|Warszawa|Al. Niepodległości 17 |02-653 Warszawa;1446;1119;1119;13;1106;77.39;1.16
97086;146505;Gimnazjum Nr 5|Warszawa|Al. Niepodległości 27 |02-653 Warszawa;2020;1328;1328;8;1320;65.74;0.60
97087;146505;Gimnazjum Nr 5|Warszawa|Al. Niepodległości 27 |02-653 Warszawa;2088;1480;1480;8;1472;70.88;0.54
97088;146505;Zespół Szkół Nr 39|Warszawa|ul. Bełska 1/3 |02-638 Warszawa;1518;1143;1143;8;1135;75.30;0.70
97089;146505;Przedszkole Nr 199|Warszawa|ul. Bukietowa 10 |02-650 Warszawa;1807;1170;1171;17;1153;64.75;1.45
97090;146505;Szkoła Podstawowa Nr 202|Warszawa|ul. J. Bytnara „Rudego” 19 |02-645 Warszawa;1914;1225;1225;15;1210;64.00;1.22
97091;146505;Szkoła Podstawowa Nr 146|Warszawa|ul. Domaniewska 33 |02-672 Warszawa;1589;1120;1120;5;1115;70.48;0.45
97092;146505;Szkoła Podstawowa Nr 146|Warszawa|ul. Domaniewska 33 |02-672 Warszawa;1888;1375;1375;13;1362;72.83;0.95
97093;146505;XLIII Liceum Ogólnokształcące|Warszawa|ul. M. Gandhiego 13 |02-645 Warszawa;1770;1148;1148;11;1137;64.86;0.96
97094;146505;Przedszkole Nr 145|Warszawa|ul. S. Goszczyńskiego 17A |02-610 Warszawa;1078;725;725;8;717;67.25;1.10
97095;146505;Zespół Szkół Nr 3|Warszawa|ul. F. Joliot-Curie 13 |02-646 Warszawa;1910;1283;1284;18;1265;67.17;1.40
97096;146505;XLIX Liceum Ogólnokształcące|Warszawa|ul. F. Joliot-Curie 14 |02-646 Warszawa;1788;1160;1160;8;1152;64.88;0.69
97097;146505;Przedszkole Nr 189|Warszawa|ul. T. Lenartowicza 27 |02-614 Warszawa;1374;899;900;14;885;65.43;1.56
97098;146505;Mokotowskie Centrum Integracji Mieszkańców|Warszawa|ul. Woronicza 44A |02-640 Warszawa;1864;1173;1173;17;1156;62.93;1.45
97099;146505;Szkoła Podstawowa Nr 205|Warszawa|ul. Spartańska 4 |02-637 Warszawa;2133;1558;1560;8;1550;73.04;0.51
97100;146505;Szkoła Podstawowa Nr 205|Warszawa|ul. Spartańska 4 |02-637 Warszawa;1997;1429;1429;3;1426;71.56;0.21
97101;146505;Multimedialna Biblioteka dla Dzieci i Młodzieży nr XXXI|Warszawa|ul. Tyniecka 40 |02-621 Warszawa;1362;907;907;9;898;66.59;0.99
97102;146505;Szkoła Podstawowa Nr 191|Warszawa|ul. Bokserska 30 |02-682 Warszawa;1514;1066;1067;7;1059;70.41;0.66
97103;146505;Szkoła Podstawowa Nr 191|Warszawa|ul. Bokserska 30 |02-682 Warszawa;2076;1427;1427;13;1414;68.74;0.91
97104;146505;Przedszkole Nr 305|Warszawa|ul. Bryły 8 |02-685 Warszawa;2054;1258;1258;13;1245;61.25;1.03
97105;146505;Gimnazjum Nr 6|Warszawa|ul. P. Gruszczyńskiego 12 |02-693 Warszawa;1412;1105;1105;8;1097;78.26;0.72
97106;146505;ZGN Mokotów|Warszawa|ul. Irysowa 19 |02-660 Warszawa;1563;1076;1076;13;1063;68.84;1.21
97107;146505;Szkoła Podstawowa Nr 271|Warszawa|ul. Niegocińska 2 |02-698 Warszawa;1801;1166;1166;21;1145;64.74;1.80
97108;146505;Szkoła Podstawowa Nr 271|Warszawa|ul. Niegocińska 2 |02-698 Warszawa;1838;1183;1183;19;1164;64.36;1.61
97109;146505;Przedszkole Nr 244|Warszawa|ul. Niegocińska 9 |02-698 Warszawa;1799;1147;1147;13;1134;63.76;1.13
97110;146505;Gimnazjum Nr 11|Warszawa|ul. Podbipięty 2 |02-732 Warszawa;1434;1099;1099;9;1090;76.64;0.82
97111;146505;Gimnazjum Nr 11|Warszawa|ul. Podbipięty 2 |02-732 Warszawa;1509;1137;1138;3;1134;75.35;0.26
97112;146505;Służewski Dom Kultury|Warszawa|ul. J. S. Bacha 15 |02-743 Warszawa;1959;1436;1436;8;1428;73.30;0.56
97113;146505;Zespół Szkół nr 27|Warszawa|ul. W. Rzymowskiego 38 |02-697 Warszawa;2193;1379;1379;27;1352;62.88;1.96
97114;146505;Zespół Szkół nr 27|Warszawa|ul. W. Rzymowskiego 38 |02-697 Warszawa;1970;1168;1171;26;1142;59.29;2.23
97115;146505;DOM "Służewiec"|Warszawa|ul. M. Smoluchowskiego 2 |02-679 Warszawa;1991;1208;1209;16;1192;60.67;1.32
97116;146505;Przedszkole Nr 67|Warszawa|ul. Sonaty 6A |02-744 Warszawa;1305;927;927;10;917;71.03;1.08
97117;146505;Przedszkole Nr 67|Warszawa|ul. Sonaty 6A |02-744 Warszawa;1328;972;972;12;960;73.19;1.23
97118;146505;Szkoła Podstawowa Nr 46|Warszawa|ul. Wałbrzyska 5 |02-739 Warszawa;1575;1168;1172;11;1157;74.16;0.94
97119;146505;Szkoła Podstawowa Nr 46|Warszawa|ul. Wałbrzyska 5 |02-739 Warszawa;1095;805;806;5;800;73.52;0.62
97120;146505;Szkoła Podstawowa Nr 107|Warszawa|ul. Nowoursynowska 210/212 |02-787 Warszawa;1468;1056;1056;6;1050;71.93;0.57
97121;146505;Szkoła Podstawowa Nr 107|Warszawa|ul. Nowoursynowska 210/212 |02-787 Warszawa;1473;1081;1081;6;1075;73.39;0.56
97122;146505;Przedszkole Nr 326|Warszawa|ul. Bernardyńska 14 |02-904 Warszawa;1786;1203;1203;13;1190;67.36;1.08
97123;146505;Przedszkole Nr 326|Warszawa|ul. Bernardyńska 14 |02-904 Warszawa;2068;1442;1444;13;1429;69.73;0.90
97124;146505;Gimnazjum Nr 3|Warszawa|ul. Chełmska 23 |00-724 Warszawa;2085;1423;1423;20;1403;68.25;1.41
97125;146505;Szkoła Podstawowa Nr 33|Warszawa|ul. Cieszyńska 8 |02-716 Warszawa;1927;1455;1455;7;1448;75.51;0.48
97126;146505;Szkoła Podstawowa Nr 33|Warszawa|ul. Cieszyńska 8 |02-716 Warszawa;1789;1252;1252;17;1235;69.98;1.36
97127;146505;Przedszkole Nr 391|Warszawa|ul. Czerniakowska 20A |00-714 Warszawa;2223;1559;1559;12;1547;70.13;0.77
97128;146505;XLIV Liceum Ogólnokształcące|Warszawa|ul. Dolna 6 |00-774 Warszawa;2139;1426;1428;20;1406;66.67;1.40
97129;146505;Zespół Szkolno-Przedszkolny Nr 1|Warszawa|ul. Gościniec 53 |00-704 Warszawa;1212;891;891;9;882;73.51;1.01
97130;146505;Zespół Szkolno-Przedszkolny Nr 1|Warszawa|ul. Gościniec 53 |00-704 Warszawa;1927;1508;1509;6;1502;78.26;0.40
97131;146505;Szkoła Podstawowa Nr 103|Warszawa|ul. Jeziorna 5/9 |02-911 Warszawa;1391;1057;1057;6;1051;75.99;0.57
97132;146505;Zespół Szkół Hotelarsko-Turystyczno-Gastronomicznych nr 1|Warszawa|ul. Krasnołęcka 3 |00-734 Warszawa;2148;1355;1355;30;1325;63.08;2.21
97133;146505;Gimnazjum Nr 10|Mokotów|ul. B. Limanowskiego 9 |02-943 Warszawa;1117;764;766;3;761;68.40;0.39
97134;146505;Gimnazjum Nr 10|Warszawa|ul. B. Limanowskiego 9 |02-943 Warszawa;984;657;657;10;647;66.77;1.52
97135;146505;Przedszkole Nr 196|Warszawa|ul. L. Nabielaka 18A |00-743 Warszawa;1784;1196;1196;2;1194;67.04;0.17
97136;146505;Zespół Szkół Sportowych Nr 58|Warszawa|ul. Piaseczyńska 114/116 |00-765 Warszawa;1329;821;821;10;811;61.78;1.22
97137;146505;Zespół Szkół Sportowych Nr 58|Warszawa|ul. Piaseczyńska 114/116 |00-765 Warszawa;1159;820;820;0;820;70.75;0.00
97138;146505;Zespół Szkół Sportowych Nr 58|Warszawa|ul. Piaseczyńska 114/116 |00-765 Warszawa;1091;735;735;5;730;67.37;0.68
97139;146505;Przedszkole Nr 275|Warszawa|ul. J. F. Piwarskiego 5 |00-770 Warszawa;1062;645;645;12;633;60.73;1.86
97140;146505;Gimnazjum Nr 7 z Oddziałami Integracyjnymi " Przy Łazienkach Królewskich"|Warszawa|ul. Podchorążych 49/61 |00-722 Warszawa;1246;770;770;8;762;61.80;1.04
97141;146505;Gimnazjum Nr 7 z Oddziałami Integracyjnymi " Przy Łazienkach Królewskich"|Warszawa|ul. Podchorążych 49/61 |00-722 Warszawa;1341;863;866;8;855;64.35;0.93
97142;146505;Gimnazjum Nr 7 z Oddziałami Integracyjnymi " Przy Łazienkach Królewskich"|Warszawa|ul. Podchorążych 49/61 |00-722 Warszawa;1450;887;898;11;876;61.17;1.24
97143;146505;Szkoła Podstawowa Nr 260|Warszawa|ul. Zakrzewska 24 |00-737 Warszawa;1955;1271;1285;8;1263;65.01;0.63
97144;146505;Przedszkole Nr 294|Warszawa|ul. Czerniakowska 50a |00-717 Warszawa;1846;1214;1214;4;1210;65.76;0.33
97145;146505;Szkoła Podstawowa Nr 190|Warszawa|ul. Zwierzyniecka 10 |00-719 Warszawa;1307;917;919;8;909;70.16;0.87
97146;146505;Szkoła Podstawowa Nr 190|Warszawa|ul. Zwierzyniecka 10 |00-719 Warszawa;1211;866;866;37;829;71.51;4.27
97147;146505;X Liceum Ogólnokształcące|Warszawa|ul. J. P. Woronicza 8 |02-625 Warszawa;2089;1400;1400;8;1392;67.02;0.57
97148;146505;SM "ARBUZOWA" Klub Osiedlowy|Warszawa|ul. Arbuzowa 16 |02-747 Warszawa;1739;1323;1323;11;1312;76.08;0.83
97149;146505;Szkoła Podstawowa nr 307|Warszawa|ul. Barcelońska 8 |02-762 Warszawa;1761;1286;1286;13;1273;73.03;1.01
97150;146505;Szkoła Podstawowa Nr 307|Warszawa|ul. Barcelońska 8 |02-762 Warszawa;1515;1129;1131;7;1122;74.52;0.62
97151;146505;Szkoła Podstawowa Nr 307|Warszawa|ul. Barcelońska 8 |02-762 Warszawa;1296;925;925;12;913;71.37;1.30
97152;146505;Zespół Szkół Integracyjnych Nr 62|Warszawa|ul. Św. Bonifacego 10 |02-914 Warszawa;1150;860;860;10;850;74.78;1.16
97153;146505;Zespół Szkół Integracyjnych Nr 62|Warszawa|ul. Św. Bonifacego 10 |02-914 Warszawa;1393;996;996;6;990;71.50;0.60
97154;146505;Szkoła Podstawowa Nr 212|Warszawa|ul. Czarnomorska 3 |02-758 Warszawa;1986;1560;1560;5;1555;78.55;0.32
97155;146505;Szkoła Podstawowa Nr 212|Warszawa|ul. Czarnomorska 3 |02-758 Warszawa;1733;1231;1231;15;1216;71.03;1.22
97156;146505;Przedszkole Nr 284|Warszawa|ul. Jałtańska 8 |02-760 Warszawa;1875;1352;1352;13;1339;72.11;0.96
97157;146505;Przedszkole Nr 325|Warszawa|ul. Kaspijska 5 |02-760 Warszawa;1654;1122;1122;8;1114;67.84;0.71
97158;146505;Szkoła Podstawowa Nr 115|Warszawa|ul. Okrężna 80 |02-933 Warszawa;2068;1594;1594;7;1587;77.08;0.44
97159;146505;Przedszkole Nr 300|Warszawa|ul. Portofino 4 |02-764 Warszawa;1911;1372;1372;0;1372;71.79;0.00
97160;146505;Instytut Żywności i Żywienia|Warszawa|ul. Powsińska 61/63 |02-903 Warszawa;2053;1428;1428;6;1422;69.56;0.42
97161;146505;Przedszkole Nr 299|Warszawa|ul. Przy Bernardyńskiej Wodzie 13 |02-943 Warszawa;1698;1294;1310;6;1288;76.21;0.46
97162;146505;Przedszkole Nr 299|Warszawa|ul. Przy Bernardyńskiej Wodzie 13 |02-943 Warszawa;1561;1223;1231;12;1211;78.35;0.98
97163;146505;Zespół Szkół Nr 59|Warszawa|Jana III Sobieskiego 68 |02-930 Warszawa;1866;1292;1292;11;1281;69.24;0.85
97164;146505;Zespół Szkół Nr 59|Warszawa|Jana III Sobieskiego 68 |02-930 Warszawa;1911;1254;1254;7;1247;65.62;0.56
97165;146505;Przedszkole Nr 311|Warszawa|ul. Jana III Sobieskiego 72B |02-930 Warszawa;1779;1310;1310;5;1305;73.64;0.38
97166;146505;Gimnazjum Nr 6|Warszawa|ul. P. Gruszczyńskiego 12 |02-693 Warszawa;1359;895;895;6;889;65.86;0.67
97167;146505;Przedszkole Nr 349|Warszawa|ul. Barcelońska 8 |02-762 Warszawa;714;560;560;4;556;78.43;0.71
97168;146505;Centrum Alzheimera|Warszawa|al. Wilanowska 257 |02-730 Warszawa;92;28;28;2;26;30.43;7.14
97169;146505;Dom Lekarza Seniora|Warszawa|ul. Wołoska 139 |02-507 Warszawa;103;81;81;2;79;78.64;2.47
97170;146505;Szpital Czerniakowski SPZOZ|Warszawa|ul. Stępińska 19/25 |00-739 Warszawa;76;62;62;2;60;81.58;3.23
97171;146505;Instytut Psychiatrii i Neurologii|Warszawa|ul. Jana III Sobieskiego 9 |02-957 Warszawa;388;139;139;13;126;35.82;9.35
97172;146505;Centralny Szpital Kliniczny MSW w Warszawie|Warszawa|ul. Wołoska 137 |02-507 Warszawa;564;268;268;5;263;47.52;1.87
97173;146505;Szpital Specjalistyczny im. Świętej Rodziny SPZOZ|Warszawa|ul. A. J. Madalińskiego 25 |02-544 Warszawa;120;50;50;0;50;41.67;0.00
97174;146505;Narodowy Instytut Geriatrii, Reumatologii i Rehabilitacji im. prof. dr hab. med. Eleonory Reicher|Warszawa|ul. Spartańska 1 |02-637 Warszawa;190;123;123;3;120;64.74;2.44
97175;146505;Areszt Śledczy Warszawa Mokotów|Warszawa|ul. Rakowiecka 37 |02-517 Warszawa;657;359;359;18;341;54.64;5.01
97176;146506;Gimnazjum nr 14|Ochota|ul. Barska 32 |02-315 Warszawa;1436;899;900;11;888;62.60;1.22
97177;146506;Gimnazjum nr 14|Ochota|ul. Barska 32 |02-315 Warszawa;1210;802;802;8;794;66.28;1.00
97178;146506;Urząd Dzielnicy Ochota m.st. Warszawy|Ochota|ul. Grójecka 17A |02-021 Warszawa;1455;964;964;17;947;66.25;1.76
97179;146506;Szkoła Podstawowa nr 97|Ochota|ul. Spiska 1 |02-302 Warszawa;1880;1327;1327;15;1312;70.59;1.13
97180;146506;Szkoła Podstawowa nr 97|Ochota|ul. Spiska 1 |02-302 Warszawa;1519;998;998;17;981;65.70;1.70
97181;146506;Urząd Dzielnicy Ochota|Ochota|ul. Tarczyńska 19/21 |02-023 Warszawa;967;627;627;10;617;64.84;1.59
97182;146506;Szkoła Podstawowa nr 97|Ochota|ul. Spiska 1 |02-030 Warszawa;1553;1063;1063;17;1046;68.45;1.60
97183;146506;Szkoła Podstawowa nr 23|Ochota|ul. Wawelska 48 |02-034 Warszawa;2248;1746;1746;5;1741;77.67;0.29
97184;146506;Instytut Chemii UW|Ochota|ul. L. Pasteura 1 |02-093 Warszawa;1000;666;666;8;658;66.60;1.20
97185;146506;Ośrodek Kultury Ochota|Ochota|ul. Grójecka 75 |02-094 Warszawa;1411;910;910;12;898;64.49;1.32
97186;146506;Biuro Gospodarki Nieruchomościami|Ochota|Pl.Starynkiewicza 7/9 |02-015 Warszawa;1607;1109;1109;13;1096;69.01;1.17
97187;146506;Zespół Szkół nr 82|Ochota|ul. Nowowiejska 37A |02-010 Warszawa;1218;879;879;3;876;72.17;0.34
97188;146506;VII Liceum Ogólnokształcące im. Juliusza Słowackiego|Ochota|ul. Wawelska 46 |02-067 Warszawa;1425;1066;1066;7;1059;74.81;0.66
97189;146506;Prywatna Szkoła Podstawowa nr 51 im. Jana Brzechwy|Ochota|ul. Włodarzewska 45C |02-384 Warszawa;1113;816;816;6;810;73.32;0.74
97190;146506;Prywatna Szkoła Podstawowa nr 51 im. Jana Brzechwy|Ochota|ul. Włodarzewska 45C |02-384 Warszawa;1913;1445;1445;4;1441;75.54;0.28
97191;146506;XLVIII LO im Edwarda Dembowskiego|Ochota|ul. Szczęśliwicka 50/54 |02-353 Warszawa;1350;1051;1051;7;1044;77.85;0.67
97192;146506;XLVIII LO im Edwarda Dembowskiego|Ochota|ul. Szczęśliwicka 50/54 |02-353 Warszawa;1682;1216;1216;4;1212;72.29;0.33
97193;146506;Zespół Szkół nr 4|Ochota|ul. Szczęśliwicka 46 |02-353 Warszawa;1722;1151;1151;9;1142;66.84;0.78
97194;146506;SZPZLO|Ochota|ul. Szczęśliwicka 36 |02-353 Warszawa;1399;905;905;7;898;64.69;0.77
97195;146506;Szkoła Podstawowa z Oddziałami Integracyjnymi nr 61|Ochota|ul. Białobrzeska 27 |02-340 Warszawa;1966;1187;1187;10;1177;60.38;0.84
97196;146506;Szkoła Podstawowa z Oddziałami Integracyjnymi nr 61|Ochota|ul. Białobrzeska 27 |02-340 Warszawa;2321;1524;1524;15;1509;65.66;0.98
97197;146506;III Oddział Terenowy Straży Miejskiej|Ochota|ul. Przemyska 18 |02-361 Warszawa;1694;1047;1047;9;1038;61.81;0.86
97198;146506;Młodzieżowy Dom Kultury|Ochota|ul. Rokosowska 10 |02-348 Warszawa;1331;808;808;18;790;60.71;2.23
97199;146506;Szkoła Podstawowa nr 175|Ochota|ul. Trzech Budrysów 32 |02-381 Warszawa;2068;1396;1396;15;1381;67.50;1.07
97200;146506;Gimnazjum nr 16|Ochota|ul. S. Skarżyńskiego 8 |02-377 Warszawa;1106;717;717;2;715;64.83;0.28
97201;146506;Gimnazjum nr 16|Ochota|ul. S. Skarżyńskiego 8 |02-377 Warszawa;917;614;614;6;608;66.96;0.98
97202;146506;Dom Pomocy Społecznej dla Kombatantów|Ochota|ul. Dickensa 25 |02-382 Warszawa;1419;1006;1006;11;995;70.89;1.09
97203;146506;Zespół Szkół nr 26|Ochota|ul. Urbanistów 3 |02-397 Warszawa;1828;1174;1174;9;1165;64.22;0.77
97204;146506;Szkoła Podstawowa z Oddziałami Integracyjnymi nr 280|Ochota|ul. Gorlicka 3 |02-130 Warszawa;1490;1046;1046;6;1040;70.20;0.57
97205;146506;Szkoła Podstawowa z Oddziałami Integracyjnymi nr 280|Ochota|ul. Gorlicka 3 |02-130 Warszawa;1838;1305;1305;13;1292;71.00;1.00
97206;146506;Przedszkole nr 315|Ochota|ul. Sz. Grzeszczyka 2 |02-122 Warszawa;1427;949;949;10;939;66.50;1.05
97207;146506;Zespół Szkół nr 26|Ochota|ul. Urbanistów 3 |02-397 Warszawa;2164;1623;1623;8;1615;75.00;0.49
97208;146506;Szkoła Podstawowa nr 264|Ochota|ul. W. Skorochód Majewskiego 17 |02-104 Warszawa;1815;1112;1112;18;1094;61.27;1.62
97209;146506;Zespół Szkół nr 83|Ochota|ul. Powstańców Wielkopolskich 4 |02-398 Warszawa;1365;829;829;11;818;60.73;1.33
97210;146506;Szkoła Podstawowa nr 264|Ochota|ul. W. Skorochód Majewskiego 17 |02-104 Warszawa;1720;1082;1082;19;1063;62.91;1.76
97211;146506;Szkoła Podstawowa nr 10|Ochota|ul. Jasielska 49/53 |02-128 Warszawa;2178;1485;1485;25;1460;68.18;1.68
97212;146506;Gimnazjum nr 15|Ochota|ul. J. Siemieńskiego 6 |02-106 Warszawa;1752;1087;1087;13;1074;62.04;1.20
97213;146506;Przedszkole nr 241|Ochota|ul. Księcia Trojdena 5b |02-109 Warszawa;1582;1157;1160;14;1143;73.14;1.21
97214;146506;Dom Kultury Rakowiec|Ochota|ul. Wiślicka 8 |02-114 Warszawa;1135;801;801;8;793;70.57;1.00
97215;146506;Szkoła Podstawowa nr 10|Ochota|ul. Jasielska 49/53 |02-128 Warszawa;1585;1106;1106;14;1092;69.78;1.27
97216;146506;Przedszkole nr 255|Ochota|ul. W. Korotyńskiego 3 |02-121 Warszawa;1655;1221;1221;6;1215;73.78;0.49
97217;146506;Szkoła Podstawowa z Oddziałami Integracyjnymi nr 280|Ochota|ul. Gorlicka 3 |02-130 Warszawa;1613;1098;1098;17;1081;68.07;1.55
97218;146506;Klinika Onkologiczna Centrum Onkologii im. M. Skłodowskiej-Curie|Ochota|Wawelska 15 |02-061 Warszawa;61;41;41;1;40;67.21;2.44
97219;146506;Szpital Kliniczny Dzieciątka Jezus SPZOZ|Ochota|W. H. Lindleya 4 |02-005 Warszawa;109;109;109;2;107;100.00;1.83
97220;146506;Samodzielny Publiczny Centralny Szpital Kliniczny|Ochota|S. Banacha 1A |02-097 Warszawa;571;235;236;8;227;41.16;3.40
97221;146506;Wojewódzki Szpital Chirurgii Urazowej Św. Anny|Ochota|Barska 16/20 |02-315 Warszawa;109;66;66;0;66;60.55;0.00
97222;146506;Uniwersyteckie Centrum Zdrowia Kobiety i Noworodka Warszawsiego Uniwersytetu Medycznego Sp. z o.o.|Ochota|Pl. S. Starynkiewicza 1/3 |02-015 Warszawa;37;30;30;1;29;81.08;3.33
97223;146506;Dom Pomocy Społecznej "Chemik"|Ochota|W. Korotyńskiego 10 |02-121 Warszawa;91;53;53;3;50;58.24;5.66
97224;146507;LXXII Liceum Ogólnokształcące im. Jakuba Jasińskiego|Praga-Południe|ul. Grochowska 346/348 |03-838 Warszawa;1692;1124;1124;8;1116;66.43;0.71
97225;146507;LXXII Liceum Ogólnokształcące im. Jakuba Jasińskiego|Praga-Południe|ul. Grochowska 346/348 |03-838 Warszawa;810;507;507;5;502;62.59;0.99
97226;146507;Poradnia Psychologiczno-Pedagogiczna nr 4|Praga-Południe|ul. Mińska 1/5 |03-806 Warszawa;1896;1229;1229;13;1216;64.82;1.06
97227;146507;Szkoła Podstawowa nr 255|Praga-Południe|ul. Kamionkowska 36/44 |03-805 Warszawa;1608;1028;1028;6;1022;63.93;0.58
97228;146507;Zespół Szkół Specjalnych nr 91|Praga-Południe|ul. Weterynaryjna 3 |03-836 Warszawa;1428;954;954;8;946;66.81;0.84
97229;146507;XIX Liceum Ogólnokształcące im. Powstańców Warszawy|Praga-Południe|ul. Zbaraska 1 |04-414 Warszawa;1481;1083;1083;9;1074;73.13;0.83
97230;146507;Poradnia Psychologiczno-Pedagogiczna Nr 16|Praga-Południe|ul. Siennicka 40 |04-393 Warszawa;1445;885;885;16;869;61.25;1.81
97231;146507;Zespół Szkół nr 12|Praga-Południe|ul. Siennicka 15 |04-495 Warszawa;1349;764;764;6;758;56.63;0.79
97232;146507;Zespół Szkół nr 12|Praga-Południe|ul. Siennicka 15 |04-395 Warszawa;1082;662;662;17;645;61.18;2.57
97233;146507;Przedszkole nr 51|Praga-Południe|ul. W. Chrzanowskiego 7 |04-381 Warszawa;1408;809;809;9;800;57.46;1.11
97234;146507;Szkoła Podstawowa nr 72|Praga-Południe|ul. L.M. Paca 44 |04-386 Warszawa;905;532;532;11;521;58.78;2.07
97235;146507;Szkoła Podstawowa nr 72|Praga-Południe|ul. L.M. Paca 44 |04-386 Warszawa;1628;976;976;13;963;59.95;1.33
97236;146507;Ośrodek Pomocy Społecznej|Praga-Południe|ul. L.M. Paca 42 |04-386 Warszawa;1696;1044;1044;12;1032;61.56;1.15
97237;146507;Przedszkole nr 230 (wejście od ul. Romea i Julii)|Praga-Południe|ul. Szaserów 118A |04-349 Warszawa;1859;1126;1128;11;1115;60.57;0.98
97238;146507;Straż Miejska m.st. Warszawy VII Oddział Terenowy|Praga-Południe|ul. Kobielska 5 |04-359 Warszawa;1691;1144;1144;13;1131;67.65;1.14
97239;146507;Straż Miejska m.st. Warszawy VII Oddział Terenowy|Praga-Południe|ul. Kobielska 5 |04-359 Warszawa;1683;1227;1227;11;1216;72.91;0.90
97240;146507;Przedszkole nr 48|Praga-Południe|ul. Szaserów 119 |04-249 Warszawa;1829;1188;1188;14;1174;64.95;1.18
97241;146507;Młodzieżowy Ośrodek Socjoterapii nr 7|Praga-Południe|ul. Osowska 81 |04-351 Warszawa;1746;1130;1130;12;1118;64.72;1.06
97242;146507;Szkoła Podstawowa nr 141|Praga-Południe|ul. Szaserów 117 |04-349 Warszawa;1626;1106;1106;9;1097;68.02;0.81
97243;146507;Szkoła Podstawowa nr 141|Praga-Południe|ul. Szaserów 117 |04-349 Warszawa;1504;1057;1057;10;1047;70.28;0.95
97244;146507;Zespól Szkół nr 90|Praga-Południe|ul. A. Kordeckiego 54 |04-330 Warszawa;2108;1410;1410;35;1375;66.89;2.48
97245;146507;Gimnazjum nr 22|Praga-Południe|ul. Boremlowska 6/12 |04-309 Warszawa;1831;1245;1245;15;1230;68.00;1.20
97246;146507;AN nr 7|Praga-Południe|ul. Hetmańska 25 |04-305 Warszawa;1646;1020;1020;15;1005;61.97;1.47
97247;146507;Szkoła Podstawowa nr 215|Praga-Południe|ul. Kwatery Głównej 13 |04-294 Warszawa;1327;1006;1006;2;1004;75.81;0.20
97248;146507;Szkoła Podstawowa nr 215|Praga-Południe|ul. Kwatery Głównej 13 |04-294 Warszawa;1344;949;949;6;943;70.61;0.63
97249;146507;XXIII Liceum Ogólnokształcące im. Marii Skłodowskiej-Curie|Praga-Południe|ul. Naddnieprzańska 2/4 |04-205 Warszawa;2071;1516;1516;20;1496;73.20;1.32
97250;146507;Przedszkole nr 179|Praga-Południe|ul. Jarocińska 12/14 |04-171 Warszawa;1877;1288;1288;21;1267;68.62;1.63
97251;146507;Gimnazjum nr 23|Praga-Południe|ul. Tarnowiecka 4 |04-174 Warszawa;2035;1437;1437;10;1427;70.61;0.70
97252;146507;Przedszkole nr 177|Praga-Południe|ul. Tarnowiecka 4 |04-174 Warszawa;1402;950;950;14;936;67.76;1.47
97253;146507;Szkoła Podstawowa nr 163|Praga-Południe|ul. Osiecka 28/32 |04-173 Warszawa;1618;866;866;21;845;53.52;2.42
97254;146507;Przedszkole nr 397|Praga-Południe|ul. Komorska 6 |04-161 Warszawa;1409;960;960;10;950;68.13;1.04
97255;146507;Zespół Szkół Spożywczo-Gastronomicznych|Praga-Południe|ul. Komorska 17/23 |04-161 Warszawa;1410;943;943;9;934;66.88;0.95
97256;146507;Szkoła Podstawowa nr 163|Praga-Południe|ul. Osiecka 28/32 |04-173 Warszawa;1821;1238;1238;15;1223;67.98;1.21
97257;146507;Zespół Szkół Spożywczo-Gastronomicznych|Praga-Południe|ul. Komorska 17/23 |04-161 Warszawa;1543;1068;1068;8;1060;69.22;0.75
97258;146507;Gimnazjum nr 23|Praga-Południe|ul. Tarnowiecka 4 |04-174 Warszawa;1115;773;773;3;770;69.33;0.39
97259;146507;Zespół Szkół Gastronomiczno-Hotelarskich|Praga-Południe|ul. Majdańska 30/36 |04-110 Warszawa;1610;967;968;16;951;60.06;1.65
97260;146507;Zespół Szkół Gastronomiczno - Hotelarskich|Praga-Południe|ul. Majdańska 30/36 |04-110 Warszawa;1880;1384;1387;7;1377;73.62;0.51
97261;146507;Zespół Szkół nr 5|Praga-Południe|ul. Szczawnicka 1 |04-089 Warszawa;1797;1218;1218;12;1206;67.78;0.99
97262;146507;Zespół Szkół nr 5|Praga-Południe|ul. Szczawnicka 1 |04-089 Warszawa;1432;1078;1078;8;1070;75.28;0.74
97263;146507;Szkoła Podstawowa nr 246|Praga-Południe|ul. Białowieska 22 |04-063 Warszawa;1858;1222;1222;13;1209;65.77;1.06
97264;146507;Przedszkole nr 235|Praga-Południe|ul. Chroszczewska 3/5 |04-068 Warszawa;2083;1261;1261;21;1240;60.54;1.67
97265;146507;Szkoła Podstawowa nr 60|Praga-Południe|ul. Zbaraska 3 |04-014 Warszawa;1920;1238;1238;8;1230;64.48;0.65
97266;146507;Medyczna Szkoła Policealna nr 4|Praga-Południe|ul. Grenadierów 30A |04-062 Warszawa;1707;1089;1089;7;1082;63.80;0.64
97267;146507;XCIX Liceum Ogólnokształcące z Oddziałami Dwujęzycznymi im. Zbigniewa Herberta|Praga-Południe|ul. Fundamentowa 38/42 |04-036 Warszawa;1466;1091;1091;9;1082;74.42;0.82
97268;146507;XCIX Liceum Ogólnokształcące z Oddziałami Dwujęzycznymi im. Zbigniewa Herberta|Praga-Południe|ul. Fundamentowa 38/42 |04-036 Warszawa;1320;922;922;8;914;69.85;0.87
97269;146507;Przedszkole nr 220|Praga-Południe|ul. Walewska 7 |04-022 Warszawa;1522;940;940;11;929;61.76;1.17
97270;146507;Szkoła Podstawowa nr 120|Praga-Południe|ul. Międzyborska 64/70 |04-010 Warszawa;1146;725;727;4;721;63.26;0.55
97271;146507;XLVII Liceum Ogólnokształcące im. Stanisława Wyspiańskiego|Praga-Południe|ul. Międzyborska 64/70 |04-010 Warszawa;1327;769;769;6;763;57.95;0.78
97272;146507;Szkoła Podstawowa nr 279|Praga-Południe|ul. Cyrklowa 1 |04-044 Warszawa;1873;1424;1424;11;1413;76.03;0.77
97273;146507;Szkoła Podstawowa 279|Praga-Południe|ul. Cyrklowa 1 |04-044 Warszawa;1793;1177;1177;11;1166;65.64;0.93
97274;146507;Przedszkole nr 54|Praga-Południe|ul. Bracławska 8A |04-044 Warszawa;1897;1272;1272;10;1262;67.05;0.79
97275;146507;ZHR|Praga-Południe|ul. Jakubowska 18 |03-902 Warszawa;943;703;703;8;695;74.55;1.14
97276;146507;Gimnazjum nr 18|Praga-Południe|ul. Angorska 2 |03-913 Warszawa;1556;1024;1024;7;1017;65.81;0.68
97277;146507;Zespół Szkół nr 21|Praga-Południe|ul. Saska 78 |03-914 Warszawa;1807;1152;1157;17;1135;63.75;1.48
97278;146507;Zespół Szkół nr 21|Praga-Południe|ul. Saska 78 |03-914 Warszawa;1687;1219;1236;2;1217;72.26;0.16
97279;146507;Zespół Szkół nr 77|Praga-Południe|ul. Zwycięzców 7/9 |03-936 Warszawa;811;575;575;3;572;70.90;0.52
97280;146507;Zespół Szkół nr 77|Praga-Południe|ul. Zwycięzców 7/9 |03-936 Warszawa;1476;1045;1045;8;1037;70.80;0.77
97281;146507;Zespół Szkół nr 84|Praga-Południe|ul. Zwycięzców 44 |03-938 Warszawa;1515;1065;1065;11;1054;70.30;1.03
97282;146507;Zespół Szkół nr 84|Praga-Południe|ul. Zwycięzców 44 |03-938 Warszawa;1803;1236;1236;14;1222;68.55;1.13
97283;146507;Przedszkole nr 162 (wejście od ul. Francuskiej 34)|Praga-Południe|ul. Dąbrówki 3 |03-909 Warszawa;1164;791;791;8;783;67.96;1.01
97284;146507;IV Liceum Ogólnokształcące im. Adama Mickiewicza|Praga-Południe|ul. Saska 59 |03-914 Warszawa;1866;1388;1388;15;1373;74.38;1.08
97285;146507;IV Liceum Ogólnokształcące im. Adama Mickiewicza|Praga-Południe|Saska 59 |03-914 Warszawa;1564;1047;1047;12;1035;66.94;1.15
97286;146507;Szkoła Podstawowa nr 143|Praga-Południe|Al. Stanów Zjednoczonych 27 |03-947 Warszawa;1208;775;775;15;760;64.16;1.94
97287;146507;Prom Kultury Saska Kępa|Praga-Południe|Brukselska 23 |03-973 Warszawa;1237;873;873;3;870;70.57;0.34
97288;146507;Gimnazjum nr 20|Praga-Południe|ul. Afrykańska 11 |03-966 Warszawa;1718;1269;1269;17;1252;73.86;1.34
97289;146507;Zespół Szkół nr 37|Praga-Południe|Al. Stanów Zjednoczonych 24 |03-964 Warszawa;1052;715;715;8;707;67.97;1.12
97290;146507;Przedszkole nr 392|Praga-Południe|ul. Afrykańska 14 |03-966 Warszawa;1726;1183;1183;14;1169;68.54;1.18
97291;146507;Przedszkole 295|Praga-Południe|ul. Afrykańska 9 |03-966 Warszawa;1712;1183;1183;7;1176;69.10;0.59
97292;146507;Dom Pomocy Społecznej im. Matysiaków|Praga-Południe|ul. Arabska 3 |03-977 Warszawa;1509;1178;1178;3;1175;78.06;0.25
97293;146507;Szkoła Podstawowa nr 185|Praga-Południe|ul. gen. T. Bora-Komorowskiego 31 |03-982 Warszawa;2207;1529;1529;12;1517;69.28;0.78
97294;146507;Szkoła Podstawowa nr 185|Praga-Południe|ul. gen. T. Bora-Komorowskiego 31 |03-982 Warszawa;2129;1589;1589;11;1578;74.64;0.69
97295;146507;Przedszkole nr 384|Praga-Południe|ul. Meissnera 8B |03-982 Warszawa;1868;1302;1302;10;1292;69.70;0.77
97296;146507;Zespół Szkół Integracyjnych nr 75|Praga-Południe|ul. Bartosika 5 |03-982 Warszawa;2472;1809;1809;13;1796;73.18;0.72
97297;146507;Przedszkole nr 198|Praga-Południe|ul. Bartosika 5 |03-982 Warszawa;1382;966;966;14;952;69.90;1.45
97298;146507;Klub Kultury Gocław, filia Centrum Promocji Kultury|Praga-Południe|ul. gen. R. Abrahama 10 |03-982 Warszawa;1305;948;948;4;944;72.64;0.42
97299;146507;oddział zamiejscowy Przedszkola nr 198|Praga-Południe|ul. gen. R. Abrahama 10 |03-982 Warszawa;1814;1267;1267;14;1253;69.85;1.10
97300;146507;Gimnazjum nr 27|Praga-Południe|ul. gen. R. Abrahama 10 |03-982 Warszawa;1521;1042;1043;13;1029;68.51;1.25
97301;146507;Szkoła Podstawowa nr 312|Praga-Południe|ul. W. Umińskiego 12 |03-984 Warszawa;2028;1412;1412;9;1403;69.63;0.64
97302;146507;Szkoła Podstawowa nr 312|Praga-Południe|W.Umińskiego 12 |03-984 Warszawa;1812;1222;1222;9;1213;67.44;0.74
97303;146507;Szkoła Podstawowa nr 312|Praga-Południe|ul. W. Umińskiego 12 |03-984 Warszawa;1970;1421;1422;8;1413;72.13;0.56
97304;146507;Przedszkole nr 218|Praga-Południe|ul. Rechniewskiego 5B |03-984 Warszawa;1865;1360;1360;8;1352;72.92;0.59
97305;146507;Przedszkole nr 218|Praga-Południe|ul. T. Rechniewskiego 5B |03-980 Warszawa;1611;1103;1104;7;1096;68.47;0.63
97306;146507;Gimnazjum nr 28|Praga-Południe|ul. W. Umińskiego 11 |03-984 Warszawa;1648;1178;1179;15;1163;71.48;1.27
97307;146507;Gimnazjum nr 28|Praga-Południe|ul. W. Umińskiego 11 |03-984 Warszawa;1688;1190;1190;22;1168;70.50;1.85
97308;146507;Żłobek nr 33|Praga-Południe|ul. W. Umińskiego 9 |03-984 Warszawa;2189;1630;1630;5;1625;74.46;0.31
97309;146507;Przedszkole Nr 380|Praga-Południe|ul. gen. T. Bora-Komorowskiego 10A |03-982 Warszawa;2020;1364;1364;9;1355;67.52;0.66
97310;146507;Biblioteka Publiczna im. Zygmunta Jana Rumla w Dzielnicy Praga-Południe m.st. Warszawy|Praga-Południe|ul. J. Meissnera 5 |03-982 Warszawa;2368;1605;1606;13;1592;67.78;0.81
97311;146507;Areszt Śledczy Warszawa Grochów|Warszawa|ul. J. Chłopickiego 71A |04-275 Warszawa;546;268;268;14;254;49.08;5.22
97312;146507;Wojskowy Instytut Medyczny|Warszawa|ul. Szaserów 128 |04-349 Warszawa;305;212;212;6;206;69.51;2.83
97313;146507;Szpital Grochowski im. dr med. Rafała Masztaka sp.zo.o|Warszawa|ul. Grenadierów 51/59 |04-073 Warszawa;203;63;63;0;63;31.03;0.00
97314;146507;Dom Studencki Nr 3 Uniwersytetu Warszawskiego ul. Kickiego 9 i 12|Warszawa|Kickiego 12 |04-397 Warszawa;125;113;113;1;112;90.40;0.88
97315;146507;Dom Pomocy Społecznej im. Matysiaków|Warszawa|ul. Arabska 3 |03-977 Warszawa;93;58;58;2;56;62.37;3.45
97316;146508;Zespól Szkół Nr 40|Praga-Północ|ul. Jagiellońska 61 |03-301 Warszawa;1342;788;788;29;759;58.72;3.68
97317;146508;Liceum Ogólnokształcące nr. 1 im. R.Barbosa|Praga-Północ|ul. Burdzińskiego 4 |03-480 Warszawa;1187;712;712;7;705;59.98;0.98
97318;146508;Liceum Ogólnokształcące nr 1 im. R. Barbosa|Praga-Północ|ul. Burdzińskiego 4 |03-480 Warszawa;1316;837;837;16;821;63.60;1.91
97319;146508;Gimnazjum nr 30|Praga-Północ|ul. Szanajcy 17 |03-481 Warszawa;1341;821;821;5;816;61.22;0.61
97320;146508;Zespół Szkół Geodezyjnych|Praga-Północ|ul. Szanajcy 5 |03-481 Warszawa;1095;673;679;10;663;61.46;1.49
97321;146508;Zespół Szkół Geodezyjnych|Praga-Północ|ul. Szanajcy 5 |03-481 Warszawa;1015;650;650;4;646;64.04;0.62
97322;146508;Gimnazjum nr 30|Praga-Północ|ul. Szanajcy 17 |03-481 Warszawa;1053;631;631;7;624;59.92;1.11
97323;146508;Szkoła Muzyczna nr 2|Praga-Północ|ul. Namysłowska 4 |03-454 Warszawa;1352;900;900;2;898;66.57;0.22
97324;146508;Filia Szkoły Podstawowej Nr 258|Praga-Północ|ul. Namysłowska 1 |03-454 Warszawa;1209;760;761;5;755;62.86;0.66
97325;146508;Szkoła Podstawowa nr 127|Praga-Północ|ul.Kowieńska 12/20 |03-438 Warszawa;1521;946;946;8;938;62.20;0.85
97326;146508;Szkoła Podstawowa nr 127|Praga-Północ|Kowieńska 12/20 |03-438 Warszawa;1823;930;930;35;895;51.01;3.76
97327;146508;LXXVI Liceum Ogólnokształcące|Praga-Północ|ul. Kowelska 1 |03-432 Warszawa;1522;829;829;13;816;54.47;1.57
97328;146508;Filia Szkoły Podstawowej nr 258|Praga-Północ|ul. Namysłowska 1 |03-454 Warszawa;961;473;474;5;468;49.22;1.06
97329;146508;LXXVI Liceum Ogólnokształcące|Praga-Północ|ul. Kowelska 1 |03-432 Warszawa;849;365;365;10;355;42.99;2.74
97330;146508;Szkoła Podstawowa Nr 258|Praga-Północ|ul. B. Brechta 8 |03-472 Warszawa;1345;857;859;14;843;63.72;1.63
97331;146508;Zespół Szkół nr 11|Praga-Północ|ul. Ratuszowa 13 |03-450 Warszawa;1549;928;933;15;913;59.91;1.62
97332;146508;Zespół Szkół nr 11|Praga-Północ|ul. Ratuszowa 13 |03-450 Warszawa;1318;670;677;4;666;50.83;0.60
97333;146508;Sala Konferencyjna PKP PLK S.A.|Praga-Północ|ul. Targowa 74 |03-734 Warszawa;1520;785;786;9;776;51.64;1.15
97334;146508;Szkoła Podstawowa nr 127|Praga-Północ|ul. Kowieńska 12/20 |03-438 Warszawa;1743;820;823;18;802;47.05;2.20
97335;146508;Przedszkole nr 171|Praga-Północ|ul. Równa 2 |03-418 Warszawa;1596;895;895;27;868;56.08;3.02
97336;146508;A.O.M. Nr 3 Z.G.N.|Praga-Północ|ul. Tarchomińska 14 |03-746 Warszawa;2049;1387;1387;6;1381;67.69;0.43
97337;146508;Gimnazjum Nr 31|Praga-Północ|ul. Sierakowskiego 9 |03-709 Warszawa;1866;1164;1164;13;1151;62.38;1.12
97338;146508;Zakład Gospodarowania Nieruchomościami|Praga-Północ|ul.Jagiellońska 23 |03-719 Warszawa;1267;730;730;13;717;57.62;1.78
97339;146508;Szkoła Podstawowa nr 50|Praga-Północ|ul. Jagiellońska 7 |03-721 Warszawa;1599;945;945;13;932;59.10;1.38
97340;146508;Szkoła Podstawowa nr 50|Praga-Północ|ul. Jagiellońska 7 |03-721 Warszawa;1837;1181;1181;11;1170;64.29;0.93
97341;146508;Zespół Szkół Specjalnych Nr 97|Praga-Północ|Tarchomińska 4 |03-746 Warszawa;1171;705;706;9;696;60.20;1.28
97342;146508;Szkoła Podstawowa nr 30|Praga-Północ|ul.Kawęczyńska 2 |03-772 Warszawa;1523;998;998;9;989;65.53;0.90
97343;146508;Szkoła Podstawowa nr 30|Praga-Północ|ul. Kawęczyńska 2 |03-772 Warszawa;1687;1094;1094;6;1088;64.85;0.55
97344;146508;Szkoła Podstawowa Nr 30|Praga-Północ|ul. Kawęczyńska 2 |03-772 Warszawa;1624;752;752;14;738;46.31;1.86
97345;146508;Zespół Szkół Specjalnych Nr 97|Praga-Północ|ul. Tarchomińska 4 |03-746 Warszawa;1273;704;705;10;694;55.30;1.42
97346;146508;Gimnazjum Nr 32|Praga-Północ|ul. Otwocka 3 |03-750 Warszawa;1585;797;797;11;786;50.28;1.38
97347;146508;Gimnazjum nr 32|Praga-Północ|ul. Otwocka 3 |03-750 Warszawa;1714;844;844;17;827;49.24;2.01
97348;146508;Szkoła Muzyczna|Praga-Północ|ul. Kawęczyńska 23/25 |03-775 Warszawa;1596;915;915;26;889;57.33;2.84
97349;146508;Szkoła Podstawowa nr 73|Praga-Północ|ul. Białostocka 10/18 |03-741 Warszawa;1404;804;804;23;781;57.26;2.86
97350;146508;Szkoła Podstawowa nr 73|Praga-Północ|Białostocka 10/18 |03-741 Warszawa;1968;1095;1095;21;1074;55.64;1.92
97351;146508;Dom Dziennego Pobytu CPS|Praga-Północ|ul. Brzeska 4 |03-737 Warszawa;1130;524;524;11;513;46.37;2.10
97352;146508;Szpital Praski pod wezwaniem Przemienienia Pańskiego sp.z o.o|Warszawa|al. Solidarności 6 |03-401 Warszawa;242;85;85;4;81;35.12;4.71
97353;146509;Zespół Szkół Nr 74|Rembertów|ul. Niepołomicka 26 |04-243 Warszawa;1412;975;975;6;969;69.05;0.62
97354;146509;Państwowy Młodzieżowy Ośrodek Wychowawczy|Rembertów|ul. Strażacka 57/59 |04-408 Warszawa;734;467;467;15;452;63.62;3.21
97355;146509;Szkoła Podstawowa Nr 217|Rembertów|Ignacego Paderewskiego 45 |04-450 Warszawa;1019;657;657;13;644;64.47;1.98
97356;146509;LI Liceum Ogólnokształcące|Rembertów|ul. Kadrowa 5/15 |04-421 Warszawa;1377;881;881;5;876;63.98;0.57
97357;146509;Szkoła Podstawowa Nr 217|Rembertów|Ignacego Paderewskiego 45 |04-450 Warszawa;1556;1040;1040;9;1031;66.84;0.87
97358;146509;LI Liceum Ogólnokształcące|Rembertów|Kadrowa 5/15 |04-421 Warszawa;2064;1436;1436;8;1428;69.57;0.56
97359;146509;Przedszkole Nr 376|Rembertów|Admiralska 17 |00-910 Warszawa;1606;1193;1193;13;1180;74.28;1.09
97360;146509;Gimnazjum Nr 126|Rembertów|Ziemskieo "Wachnowskiego" 22 |04-408 Warszawa;1771;1107;1107;14;1093;62.51;1.26
97361;146509;Ośrodek Pomocy Społecznej Dzielnicy Rembertów m. st. Warszawy|Rembertów|Plutonowych 10 |04-404 Warszawa;835;591;591;4;587;70.78;0.68
97362;146509;Dom Kultury Rembertów|Rembertów|Aleja Komandosów 8 |04-485 Warszawa;1451;938;938;6;932;64.65;0.64
97363;146509;Zespół Szkół Nr 76|Rembertów|Dwóch Mieczy 5 |04-491 Warszawa;1658;1068;1070;8;1060;64.41;0.75
97364;146509;Przedszkole Nr 158|Rembertów|Dwóch Mieczy 30/36 |04-491 Warszawa;1051;688;689;13;675;65.46;1.89
97365;146509;Biblioteka Publiczna Dzielnicy Rembertów m. st. Warszawy im. Jana Pawła II|Rembertów|Gawędziarzy 6 |04-401 Warszawa;1546;1036;1036;8;1028;67.01;0.77
97366;146510;Zespół Szkół Licealnych i Ekonomicznych nr 1|Śródmieście|ul.Stawki 10 |00-178 Warszawa;2037;1645;1645;4;1641;80.76;0.24
97367;146510;Zespół Szkół Licealnych i Ekonomicznych nr 1|Śródmieście|ul.Stawki 10 |00-178 Warszawa;1590;1255;1255;7;1248;78.93;0.56
97368;146510;Gimnazjum nr 37|Śródmieście|ul. Niska 5 |00-179 Warszawa;1974;1292;1292;13;1279;65.45;1.01
97369;146510;Szkoła Podstawowa nr 32|Śródmieście|ul.J.Lewartowskiego 2 |00-190 Warszawa;1748;1159;1159;8;1151;66.30;0.69
97370;146510;Przedszkole nr 11|Śródmieście|ul.S.Dubois 3 |00-184 Warszawa;1375;900;900;4;896;65.45;0.44
97371;146510;Szkoła Podstawowa nr 32|Śródmieście|ul.J.Lewartowskiego 2 |00-190 Warszawa;1296;815;815;8;807;62.89;0.98
97372;146510;Szkoła Podstawowa nr 158|Śródmieście|ul.Ciasna 13 |00-232 Warszawa;1891;1225;1225;14;1211;64.78;1.14
97373;146510;Centrum Pomocy Społecznej Dzielnicy Śródmieście im. prof. Andrzeja Tymowskiego|Śródmieście|ul.Świętojerska 12A |00-236 Warszawa;1629;1123;1123;8;1115;68.94;0.71
97374;146510;Zespół Szkół Architektoniczno - Budowlanych i Licealnych|Śródmieście|ul.Przyrynek 9 |00-219 Warszawa;1736;1111;1111;11;1100;64.00;0.99
97375;146510;Szkoła Podstawowa nr 210|Śródmieście|ul.Karmelicka 13 |00-163 Warszawa;1472;960;960;8;952;65.22;0.83
97376;146510;Szkoła Podstawowa nr 210|Śródmieście|ul.Karmelicka 13 |00-163 Warszawa;1447;904;904;14;890;62.47;1.55
97377;146510;V Liceum Ogólnokształcące|Śródmieście|ul.Nowolipie 8 |00-150 Warszawa;1079;673;673;5;668;62.37;0.74
97378;146510;V Liceum Ogólnokształcące|Śródmieście|ul.Nowolipie 8 |00-150 Warszawa;1499;848;848;8;840;56.57;0.94
97379;146510;Zespół Szkół Specjalnych nr 105 im. Kazimierza Kierejczyka|Śródmieście|ul. Długa 9 |00-238 Warszawa;1866;1248;1248;4;1244;66.88;0.32
97380;146510;Pałac Ślubów|Śródmieście|Plac Zamkowy 6 |00-266 Warszawa;2075;1366;1366;13;1353;65.83;0.95
97381;146510;Zespół Szkół Specjalnych nr 85 im. Eunice Kennedy Shriver|Śródmieście|ul. Elektoralna 12/14 |00-139 Warszawa;1322;851;851;17;834;64.37;2.00
97382;146510;XVII Liceum Ogólnokształcące|Śródmieście|ul. Elektoralna 5/7 |00-137 Warszawa;1570;1096;1096;8;1088;69.81;0.73
97383;146510;Szkoła Podstawowa Nr 220|Śródmieście|al.Jana Pawła II 26A |00-133 Warszawa;1538;1111;1111;6;1105;72.24;0.54
97384;146510;Szkoła Podstawowa Nr 220|Śródmieście|al. Jana Pawła II 26A |00-133 Warszawa;1453;961;961;2;959;66.14;0.21
97385;146510;Szkoła Podstawowwa nr 75|Śródmieście|ul. Niecała 14 |00-098 Warszawa;1664;1142;1142;12;1130;68.63;1.05
97386;146510;Ogólnokształcąca Szkoła Baletowa im. Romana Turczynowicza|Śródmieście|ul. Moliera 2/4 |00-076 Warszawa;857;561;561;0;561;65.46;0.00
97387;146510;Przedszkole nr 7|Śródmieście|ul.Sowia 4 |00-318 Warszawa;902;607;607;4;603;67.29;0.66
97388;146510;Gimnazjum nr 42|Śródmieście|ul.Twarda 8/12 |00-105 Warszawa;1563;1204;1204;4;1200;77.03;0.33
97389;146510;Gimnazjum nr 42|Śródmieście|ul.Twarda 8/12 |00-105 Warszawa;1933;1217;1217;18;1199;62.96;1.48
97390;146510;Gimnazjum nr 38|Śródmieście|ul.Świętokrzyska 18A |00-052 Warszawa;1797;1144;1146;13;1131;63.66;1.14
97391;146510;Zespół Szkół nr 22|Śródmieście|ul.E.Konopczyńskiego 4 |00-335 Warszawa;1817;1187;1187;12;1175;65.33;1.01
97392;146510;Zespół Szkół nr 69|Śródmieście|ul.Drewniana 8 |00-345 Warszawa;1969;1460;1460;19;1441;74.15;1.30
97393;146510;PKiN, Pałac Młodzieży, wejście od ul. E. Plater/Świętokrzyskiej, baseny|Śródmieście|Plac Defilad 1 |00-110 Warszawa;1993;1340;1340;12;1328;67.24;0.90
97394;146510;Przedszkole nr 16|Śródmieście|ul.W.Górskiego 5 |00-033 Warszawa;1484;968;968;11;957;65.23;1.14
97395;146510;Szkoła Podstawowa nr 211|Śródmieście|ul.Nowy Świat 21A |00-029 Warszawa;1036;636;636;4;632;61.39;0.63
97396;146510;Szkoła Podstawowa nr 211|Śródmieście|ul.Nowy Świat 21A |00-029 Warszawa;1863;1210;1210;13;1197;64.95;1.07
97397;146510;Gimnazjum nr 44|Śródmieście|ul.Smolna 30 |00-375 Warszawa;724;475;475;4;471;65.61;0.84
97398;146510;XXXVII Liceum Ogólnokształcące|Śródmieście|ul.Świętokrzyska 1 |00-360 Warszawa;1426;949;961;9;940;66.55;0.95
97399;146510;Zespół Szkolno-Przedszkolny nr 8|Śródmieście|ul.L.Kruczkowskiego 12B |00-380 Warszawa;1406;980;980;11;969;69.70;1.12
97400;146510;Zespół Szkolno-Przedszkolny nr 8|Śródmieście|ul.L.Kruczkowskiego 12B |00-380 Warszawa;1097;817;817;4;813;74.48;0.49
97401;146510;Zespół Szkół nr 125, wejście od ul. Wspólnej|Śródmieście|ul.Hoża 88 |00-682 Warszawa;862;503;503;2;501;58.35;0.40
97402;146510;Zespół Szkół nr 125,wejście od ul. Hożej|Śródmieście|ul.Hoża 88 |00-682 Warszawa;1369;862;862;6;856;62.97;0.70
97403;146510;Szkoła Podstawowa nr 1|Śródmieście|ul.Wilcza 53 |00-679 Warszawa;1801;1230;1231;7;1223;68.30;0.57
97404;146510;Zespół Szkół Gastronomicznych|Śródmieście|ul.Poznańska 6/8 |00-679 Warszawa;1700;1082;1082;14;1068;63.65;1.29
97405;146510;Ministerstwo Rolnictwa i Rozwoju Wsi|Śródmieście|ul.Wspólna 30 |00-519 Warszawa;1279;767;767;4;763;59.97;0.52
97406;146510;Ministerstwo Infrastruktury i Rozwoju|Śródmieście|ul.Wspólna 2/4 |00-505 Warszawa;803;504;504;7;497;62.76;1.39
97407;146510;Szkoła Podstawowa nr 203|Śródmieście|ul.ks.I.Skorupki 8 |00-546 Warszawa;1738;1137;1138;14;1123;65.42;1.23
97408;146510;Szkoła Podstawowa nr 203|Śródmieście|ul.ks.I.Skorupki 8 |00-546 Warszawa;1005;598;621;13;585;59.50;2.17
97409;146510;Gimnazjum Nr 39|Śródmieście|ul.Hoża 11/15 |00-528 Warszawa;1072;690;690;2;688;64.37;0.29
97410;146510;Gimnazjum Nr 39|Śródmieście|ul. Hoża 11/15 |00-528 Warszawa;988;663;663;10;653;67.11;1.51
97411;146510;Politechnika Warszawska Wydział Elektroniki i Technik Informacyjnych|Śródmieście|ul.Nowowiejska 15/19 |00-665 Warszawa;1521;973;974;11;962;63.97;1.13
97412;146510;Zespół Szkół Gastronomicznych (wejście od sali restauracyjnej)|Śródmieście|ul. Poznańska 6/8 |00-654 Warszawa;1752;1087;1087;10;1077;62.04;0.92
97413;146510;Przedszkole nr 21|Śródmieście|ul.Marszałkowska 27/35a |00-639 Warszawa;1104;739;739;9;730;66.94;1.22
97414;146510;Biblioteka Publiczna m.st. Warszawy- Biblioteka Główna Województwa Mazowieckiego|Śródmieście|ul.Koszykowa 26/28 |00-553 Warszawa;1562;1056;1056;12;1044;67.61;1.14
97415;146510;Przedszkole nr 82|Śródmieście|ul.Natolińska 2 |00-568 Warszawa;1425;949;949;13;936;66.60;1.37
97416;146510;Zespół Szkół nr 60|Śródmieście|ul.S.Sempołowskiej 4 |00-574 Warszawa;1272;881;881;6;875;69.26;0.68
97417;146510;Szkoła Podstawowa nr 12|Śródmieście|ul.Górnośląska 45 |00-548 Warszawa;848;579;579;6;573;68.28;1.04
97418;146510;Szkoła Podstawowa nr 12|Śródmieście|ul.Górnośląska 45 |00-548 Warszawa;869;611;611;3;608;70.31;0.49
97419;146510;Stołeczne Centrum Sportu Aktywna Warszawa|Śródmieście|ul.Solec 71 |00-402 Warszawa;2149;1508;1508;15;1493;70.17;0.99
97420;146510;Przedszkole nr 5|Śródmieście|ul.Okrąg 6b |00-407 Warszawa;1524;1040;1040;8;1032;68.24;0.77
97421;146510;Przedszkole nr 44|Śródmieście|ul.Ludna 8 |00-406 Warszawa;1367;975;975;7;968;71.32;0.72
97422;146510;Zespół Szkół nr 66|Śródmieście|ul.Myśliwiecka 6 |00-459 Warszawa;1891;1296;1296;14;1282;68.54;1.08
97423;146510;Szkoła Podstawowa nr 29|Śródmieście|ul.Fabryczna 19 |00-446 Warszawa;1703;1200;1200;6;1194;70.46;0.50
97424;146510;Szkoła Podstawowa nr 29|Śródmieście|ul.Fabryczna 19 |00-446 Warszawa;1548;1159;1159;9;1150;74.87;0.78
97425;146510;Gimnazjum nr 36|Śródmieście|ul.Polna 7 |00-625 Warszawa;2075;1515;1515;5;1510;73.01;0.33
97426;146510;Zespół Szkół nr 67|Śródmieście|ul.Klonowa 16 |00-591 Warszawa;1951;1319;1319;11;1308;67.61;0.83
97427;146510;Zakład Gospodarowania Nieruchomościami w Dzielnicy Śródmieście m.st. Warszawy|Śródmieście|ul. Szwoleżerów 5 |00-464 Warszawa;1632;1031;1031;5;1026;63.17;0.48
97428;146510;Młodzieżowy Dom Kultury|Śródmieście|ul. Łazienkowska 7 |00-449 Warszawa;1592;956;956;14;942;60.05;1.46
97429;146510;Dom Pomocy Społecznej Wójtowska|Śródmiescie|Wójtowska 13 |00-224 Warszawa;107;62;62;11;51;57.94;17.74
97430;146510;Ośrodek Działalności Leczniczej Caritas Archidiecezji Warszawskiej|Śródmiescie|ul. Krakowskie Przedmieście 62 |00-322 Warszawa;136;37;37;0;37;27.21;0.00
97431;146510;Dom Pomocy Społecznej im. św. F. Salezego|Śródmieście|ul. Solec 36A |00-394 Warszawa;85;43;43;2;41;50.59;4.65
97432;146510;Szpital Kliniczny im. Księżnej Anny Mazowieckiej|Śródmieście|ul. Karowa 2 |00-315 Warszawa;43;23;23;1;22;53.49;4.35
97433;146510;Szpital Specjalistyczny "Inflancka" im. Krysi Niżyńskiej "Zakurzonej" - SPZOZ|Śródmieście|ul. Inflancka 6 |00-189 Warszawa;58;46;46;0;46;79.31;0.00
97434;146510;Samodzielny Wojewódzki Zespół Publicznych Zakładów Psychiatrynej Opieki Zdrowotnej|Śródmieście|ul. Nowowiejska 27 |00-665 Warszawa;240;112;112;15;97;46.67;13.39
97435;146510;Szpital "Solec" Sp. z.o.o.|Śródmiescie|ul. Solec 93 |00-382 Warszawa;81;46;46;0;46;56.79;0.00
97436;146510;Samodzielny Publiczny Szpital Kliniczny im. prof. Witolda Orłowskiego CMKP|Śródmiescie|ul. Czerniakowska 231 |00-416 Warszawa;225;128;128;3;125;56.89;2.34
97437;146510;Dom Geriatryczno-Rehabilitacyjny Bonifratrów ZOZ Konwentu Binifratrów p.w.św.Ryszarda Pampuri|Śródmieście|ul. Sapieżyńska 3 |00-152 Warszawa;82;59;59;0;59;71.95;0.00
97438;146511;Szkoła Podstawowa nr 52|Warszawa|ul. Samarytanka 11A |03-592 Warszawa;1552;1067;1086;5;1062;68.75;0.47
97439;146511;Szkoła Podstawowa Nr 52|Warszawa|ul. Samarytanka 11A |03-592 Warszawa;1902;1386;1386;8;1378;72.87;0.58
97440;146511;Dom Kultury "Zacisze"|Warszawa|ul.Blokowa 1 |03-641 Warszawa;1573;1166;1166;6;1160;74.13;0.51
97441;146511;Szkoła Podstawowa Nr 84|Warszawa|ul. Radzymińska 227 |03-674 Warszawa;2010;1341;1341;16;1325;66.72;1.19
97442;146511;Szkoła Podstawowa Nr 84|Warszawa|ul. Radzymińska 227 |03-674 Warszawa;1644;1139;1139;7;1132;69.28;0.61
97443;146511;Szkoła Podstawowa Nr 84|Warszawa|ul. Radzymińska 227 |03-674 Warszawa;1767;1251;1251;12;1239;70.80;0.96
97444;146511;Szkoła Podstawowa Nr 58|Warszawa|ul. Mieszka I 7 |03-886 Warszawa;1662;915;915;12;903;55.05;1.31
97445;146511;Szkoła Podstawowa Nr 84|Warszawa|ul. Radzymińska 227 |03-674 Warszawa;1951;1422;1431;14;1408;72.89;0.98
97446;146511;Szkoła Podstawowa Nr 52|Warszawa|ul. Samarytanka 11A |03-592 Warszawa;1728;1093;1093;33;1060;63.25;3.02
97447;146511;Szkoła Podstawowa Nr 52|Warszawa|ul. Samarytanka 11A |03-592 Warszawa;981;658;658;5;653;67.07;0.76
97448;146511;Klub Osiedlowy "Nasz Klub"|Warszawa|ul. Zamiejska 1 |03-580 Warszawa;1869;1255;1255;13;1242;67.15;1.04
97449;146511;Gimnazjum Nr 145|Warszawa|ul.Krasiczyńska 4/6 |03-379 Warszawa;1953;1357;1358;5;1352;69.48;0.37
97450;146511;Gimnazjum Nr 145|Warszawa|ul. Krasiczyńska 4/6 |03-379 Warszawa;2122;1504;1504;26;1478;70.88;1.73
97451;146511;Gimnazjum Nr 141|Warszawa|ul. Trocka 4 |03-563 Warszawa;1330;824;824;6;818;61.95;0.73
97452;146511;Szkoła Podstawowa Nr 28|Warszawa|ul. Gościeradowska 18/20 |03-535 Warszawa;1421;877;877;10;867;61.72;1.14
97453;146511;Klub "Kołatka|Warszawa|ul.Kołowa 2 |03-536 Warszawa;1227;816;816;9;807;66.50;1.10
97454;146511;Szkoła Podstawowa Nr 114|Warszawa|ul. Remiszewska 40 |03-550 Warszawa;2141;1363;1363;12;1351;63.66;0.88
97455;146511;Gimnazjum nr 141|Warszawa|ul. Trocka 4 |03-563 Warszawa;1637;938;938;9;929;57.30;0.96
97456;146511;Zespól Szkół Nr 113|Warszawa|ul. Olgierda 35/41 |03-536 Warszawa;1807;1094;1094;15;1079;60.54;1.37
97457;146511;Szkoła Podstawowa Nr 114|Warszawa|ul.Remiszewska 40 |03-550 Warszawa;2008;1161;1161;9;1152;57.82;0.78
97458;146511;Szkoła Podstawowa Nr 114|Warszawa|ul. Remiszewska 40 |03-550 Warszawa;1786;1133;1133;23;1110;63.44;2.03
97459;146511;Liceum Ogólnokształcące Nr 13|Warszawa|ul. Oszmiańska 23/25 |03-503 Warszawa;1924;1143;1144;20;1123;59.41;1.75
97460;146511;Liceum Ogólnokształcące Nr 13|Warszawa|ul. Oszmiańska 23/25 |03-503 Warszawa;1808;1032;1033;18;1014;57.08;1.74
97461;146511;Zespół Szkół Nr 113|Warszawa|ul. Olgierda 35/41 |03-536 Warszawa;1146;779;779;6;773;67.98;0.77
97462;146511;Klub "Pinokio"|Warszawa|ul. Goławicka 1 |03-550 Warszawa;1756;1115;1115;12;1103;63.50;1.08
97463;146511;Zespół Szkół Nr 41|Warszawa|ul.Bartnicza 2 |03-358 Warszawa;1640;1012;1012;11;1001;61.71;1.09
97464;146511;Gimnazjum Nr 143|Warszawa|ul. Bartnicza 8 |03-358 Warszawa;837;520;520;15;505;62.13;2.88
97465;146511;Gimnazjum Nr 143|Warszawa|ul.Bartnicza 8 |03-358 Warszawa;1786;1056;1056;7;1049;59.13;0.66
97466;146511;Szkoła Podstawowa Nr 298|Warszawa|ul.Krakusa 2 |03-390 Warszawa;1594;899;899;16;883;56.40;1.78
97467;146511;Dom Kultury "Świt"|Warszawa|ul.Wysockiego 11 |03-371 Warszawa;1820;1192;1192;14;1178;65.49;1.17
97468;146511;Zespół Szkół Nr 41|Warszawa|ul. Bartnicza 2 |03-358 Warszawa;1863;1214;1214;13;1201;65.16;1.07
97469;146511;Szkoła Podstawowa nr 275,|Warszawa|ul.Św.Hieronima 2 |03-243 Warszawa;1632;966;966;12;954;59.19;1.24
97470;146511;Szkoła Podstawowa Nr 275|Warszawa|ul.Św.Hieronima 2 |03-243 Warszawa;2005;1258;1258;22;1236;62.74;1.75
97471;146511;Szkoła PodstawowaNr 275|Warszawa|ul. Św.Hieronima 2 |03-243 Warszawa;1547;939;939;8;931;60.70;0.85
97472;146511;Szkoła Podstawowa Nr 298|Warszawa|ul. Krakusa 2 |03-390 Warszawa;853;479;479;6;473;56.15;1.25
97473;146511;Gimnazjum Nr 143|Warszawa|ul.Bartnicza 8 |03-358 Warszawa;1597;1036;1036;5;1031;64.87;0.48
97474;146511;Zespół Szkół Nr 41|Warszawa|ul.Bartnicza 2 |03-358 Warszawa;1196;774;774;7;767;64.72;0.90
97475;146511;Szkoła Podstawowa Nr 298|Warszawa|ul.Krakusa 2 |03-390 Warszawa;837;532;532;4;528;63.56;0.75
97476;146511;Gimnazjum Nr 143|Warszawa|ul. Bartnicza 8 |03-358 Warszawa;2265;1512;1512;32;1480;66.75;2.12
97477;146511;Szkoła Podstawowa Nr 42|Warszawa|ul.Balkonowa 4 |03-329 Warszawa;1711;1070;1070;85;985;62.54;7.94
97478;146511;Ośrodek Pomocy Społecznej świetlica,I piętro|Warszawa|ul.Św.Wincentego 87 |03-332 Warszawa;642;323;323;14;309;50.31;4.33
97479;146511;Przychodnia Rehabilitacyjna dla Dzieci i Młodzieży|Warszawa|ul. Balkonowa 4 |03-332 Warszawa;1938;1271;1271;10;1261;65.58;0.79
97480;146511;Szkoła Podstawowa Nr 42|Warszawa|ul.Balkonowa 4 |03-329 Warszawa;2038;1225;1225;19;1206;60.11;1.55
97481;146511;Liceum Ogólnokształcące|Warszawa|ul. Żuromińska 4 |03-341 Warszawa;1741;1074;1074;16;1058;61.69;1.49
97482;146511;Gimnazjum Nr 145|Warszawa|ul.Krasiczyńska 4/6 |03-379 Warszawa;1493;931;931;30;901;62.36;3.22
97483;146511;Gimnazjum Nr 145|Targówek|ul.Krasiczyńska 4/6 |03-379 Warszawa;1755;1092;1092;14;1078;62.22;1.28
97484;146511;Liceum Ogólnokształcące|Warszawa|ul. Żuromińska 4 |03-341 Warszawa;1711;1006;1006;12;994;58.80;1.19
97485;146511;Liceum Ogólokształcące|Warszawa|ul. Żuromińska 4 |03-341 Warszawa;1654;1241;1241;6;1235;75.03;0.48
97486;146511;Ośrodek Sportu i Rekreacji|Warszawa|ul.Łabiszyńska 20 |03-397 Warszawa;1835;1005;1005;15;990;54.77;1.49
97487;146511;Szkoła Podstawowa Nr 277|Warszawa|ul.Suwalska 29 |03-252 Warszawa;1959;1212;1212;8;1204;61.87;0.66
97488;146511;Szkoła Podstawowa nr 285|Warszawa|ul.Turmoncka 20 |03-254 Warszawa;2101;1347;1347;24;1323;64.11;1.78
97489;146511;Szkoła Podstawowa Nr 285|Warszawa|ul.Turmoncka 20 |03-254 Warszawa;1690;1126;1126;23;1103;66.63;2.04
97490;146511;Szkoła Podstawowa Nr 285|Warszawa|ul.Turmoncka 20 |03-254 Warszawa;1708;1134;1134;7;1127;66.39;0.62
97491;146511;Gimnazjum Nr 144|Warszawa|ul.Turmoncka 2 |03-254 Warszawa;1276;729;729;10;719;57.13;1.37
97492;146511;Szkoła Podstawowa nr 277|Warszawa|ul.Suwalska 29 |03-252 Warszawa;1567;994;994;8;986;63.43;0.80
97493;146511;Gimnazjum Nr 144|Warszawa|ul.Turmoncka 2 |03-254 Warszawa;1364;788;788;11;777;57.77;1.40
97494;146511;Przedszkole Nr 90|Warszawa|ul.Turmoncka 7 |03-254 Warszawa;945;588;588;9;579;62.22;1.53
97495;146511;Ośrodek Sportu i Rekreacji|Warszawa|ul.Łabiszyńska 20 |03-397 Warszawa;2093;1360;1360;22;1338;64.98;1.62
97496;146511;Szkoła Podstawowa Nr 277|Warszawa|ul.Suwalska 29 |03-252 Warszawa;1766;1103;1103;12;1091;62.46;1.09
97497;146511;Mazowiecki Szpital Bródnowski w Warszawie Sp. z o.o|Warszawa|L.Kondratowicza 8 |00-983 Warszawa;502;112;112;2;110;22.31;1.79
97498;146512;Gimnazjum nr 133|Ursus|Warszawska 63 |02-495 Warszawa;1549;1007;1007;2;1005;65.01;0.20
97499;146512;Gimnazjum nr 133|Ursus|Warszawska 63 |02-495 Warszawa;2050;1437;1437;5;1432;70.10;0.35
97500;146512;Przedszkole|Ursus|Zagłoby 27 |02-495 Warszawa;1655;1133;1133;19;1114;68.46;1.68
97501;146512;Dom Kultury "Miś"|Ursus|Zagłoby 17 |02-495 Warszawa;1693;1100;1100;8;1092;64.97;0.73
97502;146512;Przedszkole|Ursus|Zagłoby 11 |02-495 Warszawa;992;638;638;3;635;64.31;0.47
97503;146512;Szkoła Podstawowa Nr 11|Ursus|Keniga 20 |02-495 Warszawa;1808;1181;1181;13;1168;65.32;1.10
97504;146512;Szkoła Podstawowa Nr 11|Ursus|Keniga 20 |02-495 Warszawa;1948;1265;1265;17;1248;64.94;1.34
97505;146512;Zespół Szkół Nr 80|Ursus|Orłów Piastowskich 47 |02-496 Warszawa;1956;1439;1439;7;1432;73.57;0.49
97506;146512;Przychodnia Rejonowa|Ursus|Wojciechowskiego 58 |02-495 Warszawa;1029;660;660;6;654;64.14;0.91
97507;146512;OSP|Ursus|Rynkowa 8 |02-495 Warszawa;2052;1382;1382;10;1372;67.35;0.72
97508;146512;Filia SP Nr 4|Ursus|Konińska 2 |02-495 Warszawa;1995;1285;1285;13;1272;64.41;1.01
97509;146512;Szkoła Podstawowa Nr 4|Ursus|Walerego Sławka 9 |02-495 Warszawa;1265;742;742;19;723;58.66;2.56
97510;146512;Liceum Ogólnokształcące i Gmnazju nr 132|Ursus|Dzieci Warszawy 42 |02-495 Warszawa;2235;1560;1560;7;1553;69.80;0.45
97511;146512;Zakład Remontów i Konserwacji Dróg|Ursus|ul. Kompanii AK "Kordian" 44 |02-495 Warszawa;2127;1453;1454;11;1442;68.31;0.76
97512;146512;Gimnazjum nr 131|Ursus|ul. Drzymały 1 |02-495 Warszawa;1939;1355;1355;14;1341;69.88;1.03
97513;146512;Dom Kultury " Kolorowa"|Ursus|Sosnkowskiego 16 |02-495 Warszawa;2032;1299;1299;12;1287;63.93;0.92
97514;146512;ZGN|Ursus|Szancera 5 |02-495 Warszawa;1716;1279;1279;7;1272;74.53;0.55
97515;146512;Liceum Ogólnokształcące i Gimnazjum nr 132|Ursus|Dzieci Warszawy 42 |02-495 Warszawa;1816;1371;1371;5;1366;75.50;0.36
97516;146512;Przedszkole|Ursus|Górna Droga 10 |02-495 Warszawa;1091;790;790;10;780;72.41;1.27
97517;146512;Przedszkole|Ursus|Zagłoby 11 |02-495 Warszawa;1608;1033;1033;17;1016;64.24;1.65
97518;146512;Szkoła Podstawowa Nr 14|Ursus|ul. Sosnkowskiego 10 |02-495 Warszawa;2061;1493;1493;7;1486;72.44;0.47
97519;146512;Zespół Szkół|Ursus|Orłów Piastowskich 47 |02-496 Warszawa;1312;984;984;3;981;75.00;0.30
97520;146512;Liceum Ogólnokształcące i Gimnazjum nr 132|Ursus|Dzieci Warszawy 42 |02-495 Warszawa;1988;1469;1471;16;1453;73.89;1.09
97521;146512;"Acherówka"|Ursus|Walerego Sławka 2 |02-495 Warszawa;1982;1312;1313;6;1306;66.20;0.46
97522;146513;Gimnazjum nr 92|Ursynów|ul. Koncertowa 4 |02-787 Warszawa;2241;1600;1600;8;1592;71.40;0.50
97523;146513;Szkoła Podstawowa nr 303|Ursynów|ul. Koncertowa 8 |02-787 Warszawa;1854;1413;1413;19;1394;76.21;1.34
97524;146513;Przedszkole nr 126|Ursynów|ul. Wokalna 1 |02-787 Warszawa;1874;1431;1431;3;1428;76.36;0.21
97525;146513;Przedszkole nr 283|Ursynów|ul. Puszczyka 6 |02-785 Warszawa;1540;1114;1114;11;1103;72.34;0.99
97526;146513;Szkoła Podstawowa nr 81|Ursynów|ul. Puszczyka 6 |02-785 Warszawa;1958;1445;1445;6;1439;73.80;0.42
97527;146513;Szkoła Podstawowa nr 81|Ursynów|ul. Puszczyka 6 |02-785 Warszawa;1744;1238;1238;10;1228;70.99;0.81
97528;146513;Szkoła Podstawowa nr 313|Ursynów|ul. J. Cybisa 1 |02-784 Warszawa;1302;929;929;4;925;71.35;0.43
97529;146513;Gimnazjum nr 96|Ursynów|ul. Wokalna 1 |02-787 Warszawa;1916;1431;1431;11;1420;74.69;0.77
97530;146513;Gimnazjum nr 96|Ursynów|ul. Wokalna 1 |02-787 Warszawa;1297;973;973;6;967;75.02;0.62
97531;146513;Szkoła Podstawowa nr 319|Ursynów|ul. Związku Walki Młodych 10 |02-786 Warszawa;1797;1320;1320;12;1308;73.46;0.91
97532;146513;Szkoła Podstawowa nr 313|Ursynów|ul. Jana Cybisa 1 |02-784 Warszawa;1857;1369;1369;13;1356;73.72;0.95
97533;146513;Przedszkole nr 55|Ursynów|ul. J. Cybisa 1 |02-784 Warszawa;1661;1184;1184;11;1173;71.28;0.93
97534;146513;Liceum Ogólnokształcące nr LXX|Ursynów|ul. E. Dembowskiego 1 |02-784 Warszawa;2078;1572;1572;9;1563;75.65;0.57
97535;146513;Liceum Ogólnokształcące nr LXX|Ursynów|ul. E. Dembowskiego 1 |02-784 Warszawa;1501;1149;1149;9;1140;76.55;0.78
97536;146513;Szkoła Podstawowa nr 322|Ursynów|ul. E. Dembowskiego 9 |02-784 Warszawa;1502;1127;1127;3;1124;75.03;0.27
97537;146513;Przedszkole nr 385|Ursynów|ul. ZWM 10 |02-786 Warszawa;1382;973;973;2;971;70.41;0.21
97538;146513;Szkoła Podstawowa nr 319|Ursynów|ul. ZWM 10 |02-786 Warszawa;921;690;690;7;683;74.92;1.01
97539;146513;Szkoła Podstawowa nr 322|Ursynów|ul. E. Dembowskiego 9 |02-784 Warszawa;1693;1355;1355;8;1347;80.04;0.59
97540;146513;Liceum Ogólnokształcące Nr LXIII|Ursynów|ul. L. Hirszfelda 11 |02-776 Warszawa;1820;1322;1322;10;1312;72.64;0.76
97541;146513;Szkoła Podstawowa nr 310|Ursynów|ul. Hawajska 7 |02-776 Warszawa;1845;1389;1389;6;1383;75.28;0.43
97542;146513;Szkoła Podstawowa nr 310|Ursynów|ul. Hawajska 7 |02-776 Warszawa;2094;1475;1475;13;1462;70.44;0.88
97543;146513;Przedszkole nr 366|Ursynów|ul. Hawajska 7 |02-776 Warszawa;1840;1341;1341;14;1327;72.88;1.04
97544;146513;Przedszkole nr 352|Ursynów|ul. L. Teligi 3 |02-777 Warszawa;1396;990;990;8;982;70.92;0.81
97545;146513;Szkoła Podstawowa nr 318|Ursynów|ul. L. Teligi 3 |02-777 Warszawa;1990;1442;1442;15;1427;72.46;1.04
97546;146513;Szkoła Podstawowa nr 343|Ursynów|ul. S. Kopcińskiego 7 |02-777 Warszawa;2048;1787;1787;8;1779;87.26;0.45
97547;146513;Szkoła Podstawowa nr 343|Ursynów|ul. S. Kopcińskiego 7 |02-777 Warszawa;2021;1678;1680;5;1673;83.03;0.30
97548;146513;Liceum Ogólnokształcące nr LXIII|Ursynów|ul. L. Hirszfelda 11 |02-776 Warszawa;2082;1539;1539;9;1530;73.92;0.58
97549;146513;Liceum Ogólnokształcące CIX|Ursynów|ul. E. Warchałowskiego 4 |02-776 Warszawa;1869;1385;1385;12;1373;74.10;0.87
97550;146513;Liceum Ogólnokształcące CIX|Ursynów|ul. E. Warchałowskiego 4 |02-776 Warszawa;2052;1460;1460;2;1458;71.15;0.14
97551;146513;Gimnazjum nr 93|Ursynów|ul. S. Szolc-Rogozińskiego 2 |02-777 Warszawa;1263;937;937;6;931;74.19;0.64
97552;146513;Gimnazjum nr 93|Ursynów|ul. S. Szolc-Rogozińskiego 2 |02-777 Warszawa;1844;1322;1322;9;1313;71.69;0.68
97553;146513;Gimnazjum nr 93|Ursynów|ul. S. Szolc-Rogozińskiego 2 |02-777 Warszawa;1666;1180;1180;11;1169;70.83;0.93
97554;146513;Gimnazjum nr 93|Ursynów|ul. S. Szolc-Rogozińskiego 2 |02-777 Warszawa;1376;1027;1034;8;1019;74.64;0.78
97555;146513;Przedszkole nr 282|Ursynów|ul. Na Uboczu 7 |02-791 Warszawa;2082;1577;1577;13;1564;75.74;0.82
97556;146513;Gimnazjum nr 94|Ursynów|ul. Na Uboczu 9 |02-791 Warszawa;1459;1101;1101;8;1093;75.46;0.73
97557;146513;Przedszkole nr 395|Ursynów|ul. Na Uboczu 9 |02-791 Warszawa;1992;1449;1449;15;1434;72.74;1.04
97558;146513;Przedszkole nr 395|Ursynów|ul. Na Uboczu 9 |02-791 Warszawa;2118;1584;1584;7;1577;74.79;0.44
97559;146513;Przedszkole nr 395|Ursynów|ul. Na Uboczu 9 |02-791 Warszawa;1910;1209;1209;10;1199;63.30;0.83
97560;146513;Przedszkole nr 286|Ursynów|ul. Mandarynki 1 |02-796 Warszawa;2023;1587;1587;8;1579;78.45;0.50
97561;146513;Szkoła Podstawowa nr 330|Ursynów|ul. Mandarynki 1 |02-796 Warszawa;2023;1438;1438;7;1431;71.08;0.49
97562;146513;Szkoła Podstawowa nr 330|Ursynów|ul. Mandarynki 1 |02-796 Warszawa;1342;1026;1026;8;1018;76.45;0.78
97563;146513;Szkoła Podstawowa nr 330|Ursynów|ul. Mandarynki 1 |02-796 Warszawa;1729;1397;1397;6;1391;80.80;0.43
97564;146513;Przedszkole nr 267|Ursynów|ul. W. Małcużyńskiego 4 |02-793 Warszawa;1680;1391;1391;4;1387;82.80;0.29
97565;146513;Szkoła Podstawowa nr 336|Ursynów|ul. W. Małcużyńskiego 4 |02-793 Warszawa;2100;1664;1664;6;1658;79.24;0.36
97566;146513;Szkoła Podstawowa nr 336|Ursynów|ul. W. Małcużyńskiego 4 |02-793 Warszawa;1805;1398;1398;8;1390;77.45;0.57
97567;146513;Gimnazjum nr 95|Ursynów|ul. E. Lokajskiego 3 |02-793 Warszawa;2197;1670;1670;8;1662;76.01;0.48
97568;146513;Szkoła Podstawowa nr 340|Ursynów|ul. E. Lokajskiego 3 |02-793 Warszawa;2176;1717;1717;15;1702;78.91;0.87
97569;146513;Przedszkole nr 267|Ursynów|ul. W. Małcużyńskiego 4 |02-793 Warszawa;1879;1515;1515;10;1505;80.63;0.66
97570;146513;Szkoła Podstawowa nr 340|Ursynów|ul. E. Lokajskiego 3 |02-793 Warszawa;2329;1878;1880;6;1872;80.64;0.32
97571;146513;Przedszkole nr 400|Ursynów|ul. E. Lokajskiego 2 |02-793 Warszawa;2270;1687;1687;14;1673;74.32;0.83
97572;146513;Szkoła Podstawowa nr 16 budynek A|Ursynów|ul. Wilczy Dół 4 |02-798 Warszawa;1818;1534;1534;6;1528;84.38;0.39
97573;146513;Szkoła Podstawowa nr 16 budynek A|Ursynów|ul. Wilczy Dół 4 |02-798 Warszawa;2090;1699;1699;7;1692;81.29;0.41
97574;146513;Szkoła Podstawowa Nr 16 budynek A|Ursynów|ul. Wilczy Dół 4 |02-798 Warszawa;1894;1537;1566;17;1520;81.15;1.11
97575;146513;Prywatna Szkoła Podstawowa Nr 6|Ursynów|ul. J. Zaruby 2 |02-796 Warszawa;1995;1557;1557;13;1544;78.05;0.83
97576;146513;Prywatna Szkoła Podstawowa nr 6|Ursynów|ul. J. Zaruby 2 |02-796 Warszawa;2025;1695;1702;6;1689;83.70;0.35
97577;146513;Szkoła Podstawowa nr 96|Ursynów|ul. Sarabandy 16/22 |02-868 Warszawa;1937;1447;1447;9;1438;74.70;0.62
97578;146513;Gimnazjum nr 91|Ursynów|ul. Kajakowa 10 |02-838 Warszawa;1844;1384;1386;11;1373;75.05;0.79
97579;146513;Szkoła Podstawowa nr 100|Ursynów|ul. Taneczna 54/58 |02-829 Warszawa;1592;1240;1240;9;1231;77.89;0.73
97580;146513;Szkoła Podstawowa nr 100|Ursynów|ul. Taneczna 54/58 |02-829 Warszawa;2440;1546;1546;32;1514;63.36;2.07
97581;146513;Przedszkole nr 412|Ursynów|ul. Pala Telekiego 8 |02-793 Warszawa;1755;1515;1515;5;1510;86.32;0.33
97582;146513;Gimnazjum nr 91|Ursynów|ul. Kajakowa 10 |02-838 Warszawa;1685;1283;1283;8;1275;76.14;0.62
97583;146513;Szkoła Podstawowa nr 323|Ursynów|ul. L. Hirszfelda 11 |02-776 Warszawa;1059;854;854;2;852;80.64;0.23
97584;146513;Instytut Hematologii i Transfuzjologii|Ursynów|Indiry Gandhi 14 |02-776 Warszawa;173;89;89;1;88;51.45;1.12
97585;146513;Centrum Onkologii - Instytut im. Marii Skłodowskiej-Curie w Warszawie|Ursynów|Wilhelma Konrada Roentgena 5 |02-781 Warszawa;604;141;141;0;141;23.34;0.00
97586;146513;Areszt Śledczy Warszawa-Służewiec|Ursynów|Kłobucka 5 |02-699 Warszawa;827;465;465;25;440;56.23;5.38
97587;146514;Obiekt Sportowo-Rekreacyjny "Syrenka"|Wawer, Marysin Wawerski|ul. Starego Doktora 1 |04-551 Warszawa;2080;1334;1334;13;1321;64.13;0.97
97588;146514;Przedszkole nr 264|Wawer, Marysin Wawerski|ul. Korkowa 147/149 |04-551 Warszawa;1591;1022;1022;9;1013;64.24;0.88
97589;146514;Zespół Szkół Nr 115|Wawer, Marysin Wawerski|ul. Króla Maciusia 5 |04-526 Warszawa;1827;1138;1138;13;1125;62.29;1.14
97590;146514;C.S.Szkolenie i Doradztwo Sp.z.o.o.|Wawer, Marysin Wawerski|ul. Minerska 16 |04-506 Warszawa;1746;1245;1245;9;1236;71.31;0.72
97591;146514;Samodzielny Zespół Publicznych Zakładów Lecznictwa Otwartego Warszawa Wawer|Wawer, Marysin Wawerski|ul. Strusia 4/8 |04-564 Warszawa;1763;1231;1231;5;1226;69.82;0.41
97592;146514;Ośrodek Socjoterapeutyczny P.w. Matki Bożej Miłosierdzia|Wawer, Marysin Wawerski|ul. Azaliowa 10A |04-539 Warszawa;1490;1088;1088;7;1081;73.02;0.64
97593;146514;Szkoła Podstawowa nr 128|Wawer, Las|ul. Kadetów 15 |03-987 Warszawa;1210;842;842;6;836;69.59;0.71
97594;146514;Siedziba Rady Osiedla "Sadul"|Wawer, Sadul|ul. Lucerny 110 |04-687 Warszawa;1868;1437;1437;10;1427;76.93;0.70
97595;146514;Biblioteka Publiczna w Dzielnicy Wawer|Wawer, Wawer|ul.Błękitna 32 |04-648 Warszawa;1020;711;711;6;705;69.71;0.84
97596;146514;Zespół Szkół Nr 116|Wawer, Wawer|ul. Koryncka 33 |04-686 Warszawa;1816;1255;1255;11;1244;69.11;0.88
97597;146514;Wawerskie Centrum Kultury Filia "Zastów"|Wawer, Borków|ul. Lucerny 13 |04-687 Warszawa;1341;958;958;8;950;71.44;0.84
97598;146514;Szkoła Podstawowa nr 109|Wawer, Borków|ul. Przygodna 2 |03-991 Warszawa;2138;1632;1632;18;1614;76.33;1.10
97599;146514;Szkoła Podstawowa nr 109|Wawer, Kuligów|ul. Przygodna 2 |03-991 Warszawa;2068;1625;1625;14;1611;78.58;0.86
97600;146514;Młodzieżowy Ośodek Socjoterapii "Dom Na Trakcie"|Wawer, Kuligów|ul. Trakt Lubelski 40 |04-870 Warszawa;1319;919;919;8;911;69.67;0.87
97601;146514;Zespół Szkół Prywatnych|Wawer, Julianów|ul. Wał Miedzeszyński 141 |04-987 Warszawa;1623;1193;1193;5;1188;73.51;0.42
97602;146514;Szkoła Podstawowa nr 218|Wawer, Anin|ul. Kajki 80/82 |04-621 Warszawa;2296;1656;1656;11;1645;72.13;0.66
97603;146514;Zespół Szkół Nr 114|Wawer, Anin|ul. Alpejska 16 |04-628 Warszawa;2122;1535;1535;7;1528;72.34;0.46
97604;146514;Prywatna Szkoła Podstawowa Nr 92|Wawer, Międzylesie|ul. Patriotów 347 |04-760 Warszawa;1759;1251;1251;6;1245;71.12;0.48
97605;146514;Szkoła Podstawowa nr 138|Wawer, Międzylesie|ul. M.Pożaryskiego 2 |04-703 Warszawa;2270;1676;1676;8;1668;73.83;0.48
97606;146514;Szkoła Podstawowa nr 138|Wawer, Międzylesie|ul. Pożaryskiego 2 |04-703 Warszawa;2101;1494;1494;11;1483;71.11;0.74
97607;146514;Zespół Szkół nr 70|Wawer, Radość|ul. Bajkowa 17/21 |04-855 Warszawa;1128;791;791;14;777;70.12;1.77
97608;146514;Zespół Szkół nr 70|Wawer, Radość|ul. Bajkowa 17/21 |04-855 Warszawa;1603;1157;1157;6;1151;72.18;0.52
97609;146514;Dom Pomocy Społecznej "Na Bachusa"|Wawer, Radość|ul. Bachusa 7 |04-837 Warszawa;660;453;453;3;450;68.64;0.66
97610;146514;Szkoła Podstawowa nr 140|Wawer, Radość|ul. Wilgi 19 |04-831 Warszawa;1878;1390;1390;15;1375;74.01;1.08
97611;146514;Prywatna Szkoła Podstawowa Towarzystwa Edukacyjnego Vizja|Wawer, Radość|ul. Patriotów 148 |04-840 Warszawa;1878;1280;1280;11;1269;68.16;0.86
97612;146514;XXV Liceum Ogólnokształcące|Wawer, Miedzeszyn|ul. Halna 20 |04-961 Warszawa;1767;1201;1201;22;1179;67.97;1.83
97613;146514;Szkoła Podstawowa nr 216|Wawer, Miedzeszyn|ul. Wolna 36/38 |04-908 Warszawa;1392;938;938;13;925;67.39;1.39
97614;146514;Szkoła Podstawowa nr 216|Wawer, Falenica|ul. Wolna 36/38 |04-908 Warszawa;1788;1277;1277;4;1273;71.42;0.31
97615;146514;Wawerskie Centrum Kultury Filia "Aleksandrów"|Wawer, Aleksandrów Pierwszy|ul. Samorządowa 10 |04-965 Warszawa;1815;1266;1266;14;1252;69.75;1.11
97616;146514;Zespół Szkół nr 111|Wawer, Falenica|ul. Poezji 5 |04-984 Warszawa;1266;803;803;11;792;63.43;1.37
97617;146514;Hala Sportowa Zespołu Szkół Nr 111|Wawer, Falenica|ul. Poezji 5 |04-984 Warszawa;1630;1137;1137;23;1114;69.75;2.02
97618;146514;Szkoła Podstawowa nr 124|Wawer, Falenica|ul. Bartoszycka 45/47 |04-923 Warszawa;2096;1475;1475;8;1467;70.37;0.54
97619;146514;Przedszkole nr 348|Warszawa|Kadetów 15A |03-987 Warszawa;1168;912;912;10;902;78.08;1.10
97620;146514;Instytut Kardiologii im. Prymasa Tysiąclecia Stefana Kardynała Wyszyńskiego|Warszawa|Alpejska 42 |04-628 Warszawa;237;132;132;1;131;55.70;0.76
97621;146514;Międzyleski Szpital Specjalistyczny w Warszawie|Warszawa|Bursztynowa 2 |04-749 Warszawa;277;106;106;3;103;38.27;2.83
97622;146514;Zakład Opiekuńczo-Leczniczy|Warszawa|Olchy 8 |04-837 Warszawa;59;30;30;3;27;50.85;10.00
97623;146515;Szkoła Podstawowa nr 174|Warszawa|Plac Wojska Polskiego 28 |05-075 Warszawa;1455;933;933;14;919;64.12;1.50
97624;146515;Zespół Szkół nr 94 - budynek B|Warszawa|Krótka 1 |05-075 Warszawa;1946;1315;1315;15;1300;67.57;1.14
97625;146515;Szkoła Podstawowa nr 171|Warszawa|Armii Krajowej 39 |05-075 Warszawa;1776;1239;1239;17;1222;69.76;1.37
97626;146515;Ośrodek Kultury w Dzielnicy Wesoła m.st. Warszawy|Warszawa|Starzyńskiego 21 |05-075 Warszawa;1228;921;921;9;912;75.00;0.98
97627;146515;Zespół Szkół nr 94 - budynek A|Warszawa|Krótka 1 |05-075 Warszawa;2098;1457;1457;16;1441;69.45;1.10
97628;146515;Budynek Urzędu Dzielnicy Wesoła m.st. Warszawy|Warszawa|1. Praskiego Pułku 33 |05-075 Warszawa;1127;807;807;6;801;71.61;0.74
97629;146515;Szkoła Podstawowa nr 173|Warszawa|Trakt Brzeski 18 |05-077 Warszawa;2080;1623;1623;14;1609;78.03;0.86
97630;146515;Szkoła Podstawowa nr 173|Warszawa|Trakt Brzeski 18 |05-077 Warszawa;2007;1474;1474;11;1463;73.44;0.75
97631;146515;Gimnazjum nr 119|Warszawa|Klimatyczna 1 |05-077 Warszawa;2029;1556;1556;4;1552;76.69;0.26
97632;146515;Gimnazjum nr 119|Warszawa|Klimatyczna 1 |05-077 Warszawa;2043;1641;1642;7;1634;80.32;0.43
97633;146516;Zespół Szkół nr 2 im. Wandy Rutkiewicz|Wilanów|Gubinowska 28/30 |02-956 Warszawa;1021;774;774;6;768;75.81;0.78
97634;146516;Przedszkole nr 56|Wilanów|Gubinowska 28/30 |02-956 Warszawa;1268;943;943;15;928;74.37;1.59
97635;146516;Zespół Szkół Nr 2 im. Wandy Rutkiewicz|Wilanów|Gubinowska 28/30 |02-956 Warszawa;1613;1191;1191;9;1182;73.84;0.76
97636;146516;Zespół Szkół Nr 79 im. Stanisława Kostki Potockiego|Wilanów|Wiertnicza 26 |02-952 Warszawa;1800;1302;1306;7;1295;72.33;0.54
97637;146516;Przedszkole nr 416|Wilanów|Syta 123 |02-987 Warszawa;1859;1520;1520;9;1511;81.76;0.59
97638;146516;Zespół Szkolno-Przedszkolny Nr 3|Wilanów|Przyczółkowa 27 |02-968 Warszawa;972;702;702;6;696;72.22;0.85
97639;146516;Zespół Szkół nr 79|Wilanów|ul. Wiertnicza 26 |02-952 Warszawa;1352;1079;1079;6;1073;79.81;0.56
97640;146516;Zespół Szkół nr 123|Wilanów|Uprawna 9/17 |02-967 Warszawa;730;499;499;5;494;68.36;1.00
97641;146516;Instytut Papieża Jana Pawła II|Wilanów|Prymasa Augusta Hlonda 1 |02-972 Warszawa;1309;1029;1029;5;1024;78.61;0.49
97642;146516;Szpital Medicover|Warszawa|Aleja Rzeczypospolitej 5 |02-972 Warszawa;1032;814;814;3;811;78.88;0.37
97643;146516;Instytut Papieża Jana Pawał II|Warszawa|ul. ks. Prymasa Augusta Hlonda 1 |02-972 Warszawa;1659;1321;1321;11;1310;79.63;0.83
97644;146516;Przedszkole 416|Warszawa|Syta 123 |02-987 Warszawa;831;609;609;4;605;73.29;0.66
97645;146516;Zespół Szkół Nr 2|Warszawa|Gubinowska 28/30 |02-956 Warszawa;1694;1260;1260;5;1255;74.38;0.40
97646;146516;Zespół Szkolno-Przedszkolny nr 3|Warszawa|Przyczółkowa 27 |02-968 Warszawa;1110;869;869;4;865;78.29;0.46
97647;146516;Przedszkole nr 420|Warszawa|Św. Urszuli Ledóchowskiej 8 |02-972 Warszawa;2004;1612;1613;4;1608;80.44;0.25
97648;146516;Przedszkole nr 420|Warszawa|Św. Urszuli Ledóchowskiej 8 |02-972 Warszawa;988;836;837;1;835;84.62;0.12
97649;146516;Instytut Papieża Jana Pawła II|Warszawa|Prymasa Augusta Hlonda 1 |02-972 Warszawa;1134;889;889;5;884;78.40;0.56
97650;146517;Szkoła Muzyczna|Włochy|ul.Globusowa 24 |02-436 Warszawa;1501;1028;1028;16;1012;68.49;1.56
97651;146517;Biblioteka Publiczna|Włochy|ul. Ks. J. Chrościckiego 2 |02-421 Warszawa;1013;661;661;6;655;65.25;0.91
97652;146517;Zespół Szkół Ogólnokształcących nr 17|Włochy|ul. Promienista 12A |02-428 Warszawa;989;636;636;5;631;64.31;0.79
97653;146517;Szkoła Podstawowa nr 66|Włochy|ul. Przepiórki 16/18 |02-407 Warszawa;839;570;570;4;566;67.94;0.70
97654;146517;Artystyczny Dom Animacji ADA|Włochy|ul. Ks. J. Chrościckiego 14 |02-421 Warszawa;1769;1306;1306;8;1298;73.83;0.61
97655;146517;Gimnazjum Nr 112|Włochy|ul.Solipska 17/19 |02-482 Warszawa;1284;969;969;2;967;75.47;0.21
97656;146517;Gimnazjum Nr 112|Włochy|ul. Solipska 17/19 |02-479 Warszawa;1396;1093;1093;7;1086;78.30;0.64
97657;146517;Dom Kultury " Włochy"|Włochy|ul.Bolesława Chrobrego 27 |02-479 Warszawa;1378;975;975;0;975;70.75;0.00
97658;146517;Przedszkole Nr 71|Włochy|ul. Śląska 50/52 |02-462 Warszawa;1489;1004;1004;6;998;67.43;0.60
97659;146517;Ośrodek Pomocy Społecznej|Włochy|ul. Czereśniowa 118 |02-456 Warszawa;1478;1028;1028;15;1013;69.55;1.46
97660;146517;Szkoła Podstawowa Nr 94|Włochy|ul. Cietrzewia 22A |02-492 Warszawa;1834;1285;1285;9;1276;70.07;0.70
97661;146517;Ośrodek Pomocy Społecznej|Włochy|ul. Czereśniowa 35 |02-456 Warszawa;553;437;437;5;432;79.02;1.14
97662;146517;Ratusz|Włochy|Aleja Krakowska 257 |02-133 Warszawa;1164;787;787;6;781;67.61;0.76
97663;146517;Ośrodek Pomocy Społecznej - Filia|Włochy|ul. Robotnicza 15 |02-261 Warszawa;775;496;496;7;489;64.00;1.41
97664;146517;Szkoła Podstawowa Nr 87|Włochy|ul. Malownicza 31 |02-272 Warszawa;1442;812;813;17;795;56.31;2.09
97665;146517;Szkoła Podstawowa nr 87|Włochy|ul. Malownicza 31 |02-272 Warszawa;839;559;559;8;551;66.63;1.43
97666;146517;Zespoł Szkół im.Bohaterów Narwiku|Włochy|ul. Gładka 16 |02-172 Warszawa;840;472;472;6;466;56.19;1.27
97667;146517;Szkoła Podstawowa 227|Włochy|ul. Astronautów 17 |02-154 Warszawa;1131;772;772;13;759;68.26;1.68
97668;146517;Przedszkole nr 175|Włochy|ul.Astronautów 5 |02-154 Warszawa;1422;967;967;11;956;68.00;1.14
97669;146517;Ratusz|Włochy|Aleja Krakowska 257 |02-133 Warszawa;1547;1040;1040;6;1034;67.23;0.58
97670;146517;Przedszkole Nr 78|Włochy|ul. Radarowa 4A |02-137 Warszawa;922;613;613;8;605;66.49;1.31
97671;146517;Szkoła Podstawowa Nr 88|Włochy|ul. Radarowa 4B |02-137 Warszawa;1157;870;870;3;867;75.19;0.34
97672;146517;Szkoła Podstawowa nr 88|Włochy|ul. Radarowa 4B |02-137 Warszawa;1035;698;698;6;692;67.44;0.86
97673;146517;Przedszkole Nr 313|Włochy|ul. Sulmierzycka 1 |02-139 Warszawa;1499;1087;1087;15;1072;72.52;1.38
97674;146517;Przedszkole Integracyjne Nr 314|Włochy|ul. 1 Sierpnia 36A |02-134 Warszawa;1567;965;965;13;952;61.58;1.35
97675;146518;Zespół Szkół Zawodowych nr 32|Wola|ul. Ożarowska 71 |01-408 Warszawa;1784;1041;1041;13;1028;58.35;1.25
97676;146518;Zespół Szkół Zawodowych nr 32|Wola|ul. Ożarowska 71 |01-408 Warszawa;1871;1136;1136;12;1124;60.72;1.06
97677;146518;Szkoła Podstawowa nr 225|Wola|ul. Brożka 15 |01-451 Warszawa;2264;1527;1527;13;1514;67.45;0.85
97678;146518;Gimnazjum Nr 48|Wola|ul. Deotymy 25/33 |01-407 Warszawa;1898;1294;1294;20;1274;68.18;1.55
97679;146518;Zespół Szkół Integracyjnych Nr 71|Wola|ul. Deotymy 37 |01-409 Warszawa;1886;1163;1163;15;1148;61.66;1.29
97680;146518;Szkoła Podstawowa nr 225|Wola|ul. Brożka 15 |01-451 Warszawa;1997;1125;1125;16;1109;56.33;1.42
97681;146518;Zespół Szkół Integracyjnych Nr 71|Wola|ul. Deotymy 37 |01-409 Warszawa;1462;867;867;10;857;59.30;1.15
97682;146518;Szkoła Podstawowa nr 148|Wola|ul. Ożarowska 69 |01-408 Warszawa;1185;696;696;10;686;58.73;1.44
97683;146518;Zespół Szkół Nr 122|Wola|ul. Olbrachta 48/56 |01-111 Warszawa;1760;1191;1191;11;1180;67.67;0.92
97684;146518;Zespół Szkół Nr 122|Wola|ul. Olbrachta 48/56 |01-111 Warszawa;2343;1567;1567;13;1554;66.88;0.83
97685;146518;Przedszkole Nr 403|Wola|ul. Góralska 1 |01-112 Warszawa;1497;1044;1044;10;1034;69.74;0.96
97686;146518;Przedszkole Nr 273|Wola|ul. Jana Olbrachta 28 |01-111 Warszawa;1486;922;922;17;905;62.05;1.84
97687;146518;LXXXVI Liceum Ogólnokształcące|Wola|ul. Garbińskiego 1 |01-122 Warszawa;1272;775;775;5;770;60.93;0.65
97688;146518;"Klub Parasol"|Wola|ul. Batalionu AK Parasol 3a |01-120 Warszawa;1723;1004;1004;29;975;58.27;2.89
97689;146518;Szkoła Podstawowa nr 238|Wola|ul. Redutowa 37 |01-106 Warszawa;1730;1090;1090;10;1080;63.01;0.92
97690;146518;Szkoła Podstawowa nr 238|Wola|ul. Redutowa 37 Warszawa|01-106 Warszawa;1764;1026;1039;14;1012;58.16;1.36
97691;146518;LXXXVI Liceum Ogólnokształcące|Wola|ul. Garbińskiego 1 |01-122 Warszawa;1448;847;847;8;839;58.49;0.94
97692;146518;Szkoła Podstawowa nr 132|Wola|ul. Grabowska 1 |01-236 Warszawa;1454;979;979;9;970;67.33;0.92
97693;146518;Państwowe Przedszkole nr 253|Wola|ul. Antka Rozpylacza 2 |01-107 Warszawa;2173;1544;1544;19;1525;71.05;1.23
97694;146518;LXXXVI Liceum Ogólnokształcące|Wola|ul. Garbińskiego 1 |01-122 Warszawa;1632;1025;1030;16;1009;62.81;1.56
97695;146518;Szkoła Podstawowa nr 132|Wola|ul. Grabowska 1 |01-236 Warszawa;2431;1819;1819;13;1806;74.83;0.71
97696;146518;Szkoła Podstawowa nr 132|Wola|Grabowska 1 |01-236 Warszawa;2343;1513;1513;14;1499;64.58;0.93
97697;146518;Zespół szkół Nr 117|Wola|ul. Bema 76 |01-225 Warszawa;1758;1122;1122;24;1098;63.82;2.14
97698;146518;Zespół szkół Nr 117|Wola|ul. Bema 76 |01-225 Warszawa;1596;1075;1075;2;1073;67.36;0.19
97699;146518;Zespół Szkół Nr 36|Wola|ul. Kasprzaka 19/21 |01-211 Warszawa;2030;1314;1314;9;1305;64.73;0.68
97700;146518;Zespół Poradni Psychologiczna Pedagogicznych nr 1|Wola|ul. Zawiszy 13 |01-167 Warszawa;2283;1744;1744;8;1736;76.39;0.46
97701;146518;Zespół Poradni Psychologiczna Pedagogicznych nr 1|Wola|ul. Zawiszy 13 |01-167 Warszawa;1843;1242;1242;16;1226;67.39;1.29
97702;146518;Gimnazjum nr 47|Wola|ul. Grenady 16 |01-154 Warszawa;1966;1266;1266;9;1257;64.39;0.71
97703;146518;Gimnazjum nr 47|Wola|ul. Grenady 16 |01-154 Warszawa;1981;1141;1141;9;1132;57.60;0.79
97704;146518;Zespół Państwowych Ogólnokształcących Szkół Muzycznych nr 3|Wola|ul. Tyszkiewicza 42 |01-172 Warszawa;1665;1025;1025;12;1013;61.56;1.17
97705;146518;Przedszkole Nr 237|Wola|ul. Tyszkiewicza 33 |01-172 Warszawa;1614;917;917;15;902;56.82;1.64
97706;146518;Szkoła Podstawowa nr 63|Wola|ul. Płocka 30 |01-148 Warszawa;1724;1046;1046;5;1041;60.67;0.48
97707;146518;Szkoła Podstawowa nr 139|Wola|ul. Syreny 5/7 |01-132 Warszawa;2325;1490;1490;21;1469;64.09;1.41
97708;146518;Szkoła Podstawowa nr 139|Wola|ul. Syreny 5/7 |01-132 Warszawa;1677;977;977;12;965;58.26;1.23
97709;146518;Dom Kultury "Działdowska"|Wola|ul. Działdowska 6 |01-184 Warszawa;2031;1222;1222;14;1208;60.17;1.15
97710;146518;Teatr Dramatyczny - Scena na Woli|Wola|ul. Kasprzaka 22 |01-211 Warszawa;1602;1158;1158;8;1150;72.28;0.69
97711;146518;III Liceum Ogólnokształcące nr 3|Wola|ul. Rogalińska 2 |01-206 Warszawa;2180;1499;1499;9;1490;68.76;0.60
97712;146518;Zespół Szkół Mechanicznych im. M. Konarskiego|Wola|ul. Okopowa 55a |01-043 Warszawa;2067;1104;1104;20;1084;53.41;1.81
97713;146518;Szkoła Podstawowa nr 166|Wola|ul. Żytnia 40 |00-832 Warszawa;2343;1299;1302;28;1271;55.44;2.16
97714;146518;Szkoła Podstawowa nr 166|Wola|ul. Żytnia 40 |00-832 Warszawa;1870;1185;1185;13;1172;63.37;1.10
97715;146518;Zespół Szkół Specjalnych nr 101|Wola|ul. Karolkowa 56 |01-193 Warszawa;1444;947;947;6;941;65.58;0.63
97716;146518;Zespół Szkół Samochodowych i Licealnych nr 2|Wola|Al. Jana Pawła II 69 |01-038 Warszawa;1974;1320;1320;16;1304;66.87;1.21
97717;146518;Szkoła Podstawowa nr 222|Wola|ul. Esperanto 7a |01-049 Warszawa;1994;1367;1367;5;1362;68.56;0.37
97718;146518;Szkoła Podstawowa nr 222|Wola|ul. Esperanto 7a |01-049 Warszawa;1374;891;892;8;883;64.85;0.90
97719;146518;Gimnazjum nr 49|Wola|ul. Smocza 19 |01-051 Warszawa;1482;1018;1018;10;1008;68.69;0.98
97720;146518;Szkoła Podstawowa nr 234|Wola|ul. Esperanto 5 |01-049 Warszawa;1842;1188;1188;10;1178;64.50;0.84
97721;146518;Zespół Państwowych Szkół Sztuk Plastycznych|Wola|ul. Smocza 6 |01-009 Warszawa;1116;692;692;15;677;62.01;2.17
97722;146518;Zespół Państwowych Szkół Sztuk Plastycznych|Wola|ul. Smocza 6 |01-009 Warszawa;1110;700;700;8;692;63.06;1.14
97723;146518;XXX Liceum Ogólnokształcące nr 30|Wola|ul. Wolność 1/3 |01-018 Warszawa;2132;1445;1445;20;1425;67.78;1.38
97724;146518;XXX Liceum Ogólnokształcące nr 30|Wola|ul. Wolność 1/3 |01-018 Warszawa;2195;1483;1483;10;1473;67.56;0.67
97725;146518;Gimnazjum nr 45|Wola|ul. Żelazna 71 |00-871 Warszawa;1651;1117;1117;16;1101;67.66;1.43
97726;146518;Szkoła Podstawowa nr 221|Wola|ul. Ogrodowa 42/44 |00-876 Warszawa;1986;1274;1274;5;1269;64.15;0.39
97727;146518;Szkoła Podstawowa nr 221|Wola|ul. Ogrodowa 42/44 |00-876 Warszawa;1798;1141;1141;13;1128;63.46;1.14
97728;146518;Przedszkole nr 47|Wola|ul. Krochmalna 1 |00-864 Warszawa;1806;1155;1155;7;1148;63.95;0.61
97729;146518;Szkoła Podstawowa nr 25|Wola|ul. Grzybowska 35 |00-855 Warszawa;1847;1163;1163;12;1151;62.97;1.03
97730;146518;Szkoła Podstawowa nr 25|Wola|ul. Grzybowska 35 |00-855 Warszawa;1409;971;971;8;963;68.91;0.82
97731;146518;Szkoła Podstawowa nr 25|Wola|ul. Grzybowska 35 |00-855 Warszawa;1824;1268;1268;5;1263;69.52;0.39
97732;146518;XL Liceum Ogólnokształcące|Wola|ul. Platynowa 1 |00-808 Warszawa;1272;792;792;9;783;62.26;1.14
97733;146518;Szkoła Podstawowa nr 26|Wola|ul Miedziana 8 |00-814 Warszawa;1313;851;851;5;846;64.81;0.59
97734;146518;Szkoła Podstawowa nr 26|Wola|ul. Miedziana 8 |00-814 Warszawa;1491;890;890;3;887;59.69;0.34
97735;146518;Szkoła Podstawowa nr 26|Wola|ul. Miedziana 8 |00-814 Warszawa;1348;892;892;10;882;66.17;1.12
97736;146518;XL Liceum Ogólnokształcące|Wola|ul. Platynowa 1 |00-808 Warszawa;1603;1084;1084;17;1067;67.62;1.57
97737;146518;Dom Pomocy Społecznej "Budowlani"|Warszawa|Elekcyjna 6 Dom Pomocy Społecznej "Budowlani" |01-128 Warszawa;101;60;60;1;59;59.41;1.67
97738;146518;Dom Pracownika Służby Zdrowia|Warszawa|ul. Elekcyjna 37 ul. Elekcyjna 37 |01-119 Warszawa;22;18;19;2;16;81.82;11.11
97739;146518;Dom Pomocy Społecznej „Syrena”|Warszawa|ul. Syreny 26 ul. Syreny 26 |01-155 Warszawa;130;58;58;3;55;44.62;5.17
97740;146518;Instytut Gruźlicy i Chorób Płuc|Warszawa|ul. Płocka 26 ul. Płocka 26 |01-138 Warszawa;242;111;111;2;109;45.87;1.80
97741;146518;Wojewódzki Szpital Zakaźny|Warszawa|ul. Wolska 37 ul. Wolska 37 |01-201 Warszawa;110;83;83;2;81;75.45;2.41
97742;146518;Szpital Wolski im. dr Anny Gostyńskiej SPZOZ|Warszawa|ul. Kasprzaka 17 ul. Kasprzaka 17 |01-211 Warszawa;429;105;105;3;102;24.48;2.86
97743;146518;Centrum Medyczne „Żelazna” Sp. z o.o.|Warszawa|ul. Żelazna 90 ul. Żelazna 90 |01-004 01-004;71;61;61;0;61;85.92;0.00
97744;146518;Centrum Leczniczo Rehabilitacyjne i Medycyny Pracy „ATTIS” Sp. z o.o|Warszawa|ul. Górczewska 89 ul. Górczewska 89 |01-401 Warszawa;75;36;36;0;36;48.00;0.00
97745;146519;Specjalny Ośrodek Szkolno-Wychowawczy nr 9|Żoliborz|ul. J.Ch.Paska 10 |01-640 Warszawa;1738;1180;1180;9;1171;67.89;0.76
97746;146519;Szkoła Podstawowa nr 65|Żoliborz|ul. Mścisławska 1 |01-647 Warszawa;2086;1656;1656;12;1644;79.39;0.72
97747;146519;Szkoła Główna Służby Pożarniczej|Żoliborz|ul. H. Siemiradzkiego 2 |01-630 Warszawa;2086;1579;1579;11;1568;75.70;0.70
97748;146519;Szkoła Podstawowa nr 65|Żoliborz|ul. Mścisławska 1 |01-647 Warszawa;2236;1724;1724;13;1711;77.10;0.75
97749;146519;Klub "Promyk"|Żoliborz|Promyka 5 |01-604 Warszawa;2202;1546;1546;12;1534;70.21;0.78
97750;146519;Zespół Szkół Samochodowych i Licealnych nr 3|Żoliborz|ul. Włościańska 35 |01-710 Warszawa;1593;1150;1150;23;1127;72.19;2.00
97751;146519;Szkoła Podstawowa nr 267|Żoliborz|ul. Braci Załuskich 1 |01-773 Warszawa;1656;1208;1208;12;1196;72.95;0.99
97752;146519;Zespół Szkół Samochodowych i Licealnych nr 3|Żoliborz|ul. Włościańska 35 |01-710 Warszawa;1417;987;987;15;972;69.65;1.52
97753;146519;Przedszkole Nr 131|Żoliborz|ul. Sierpecka 9A |01-589 Warszawa;1382;988;991;10;978;71.49;1.01
97754;146519;Szkoła Podstawowa Nr 267|Żoliborz|ul. Braci Załuskich 1 |01-773 Warszawa;1220;891;891;2;889;73.03;0.22
97755;146519;Gimnazjum Nr 56|Żoliborz|ul. Filarecka 2 |01-582 Warszawa;1297;962;964;14;948;74.17;1.46
97756;146519;Zespół Szkół nr 53|Żoliborz|ul. ks. J. Popiełuszki 5 |01-786 Warszawa;2290;1741;1741;18;1723;76.03;1.03
97757;146519;Zespół Szkół nr 53|Żoliborz|ul. ks. J. Popiełuszki 5 |01-786 Warszawa;1052;745;747;6;739;70.82;0.81
97758;146519;Zespól Szkól nr 54|Żoliborz|ul. Elbląska 51 |01-737 Warszawa;1560;1028;1034;2;1026;65.90;0.19
97759;146519;Zespół Szkół nr 54|Żoliborz|ul. Elbląska 51 |01-737 Warszawa;2285;1576;1576;10;1566;68.97;0.63
97760;146519;Szkoła Podstawowa nr 92|Żoliborz|ul. Przasnyska 18A |01-756 Warszawa;2477;1769;1770;15;1754;71.42;0.85
97761;146519;Szkoła Podstawowa nr 92|Żoliborz|ul. Przasnyska 18A |01-756 Warszawa;1834;1307;1311;10;1297;71.26;0.77
97762;146519;Żoliborskie Centrum Integracji i Aktywizacji Seniorów|Żoliborz|ul. S. Wyspiańskiego 6/8 |01-577 Warszawa;972;641;641;5;636;65.95;0.78
97763;146519;I Liceum Ogólnokształcące z Oddziałami Integracyjnymi|Żoliborz|ul. A. Felińskiego 15 |01-513 Warszawa;1451;1018;1018;8;1010;70.16;0.79
97764;146519;I Liceum Ogólnokształcące z Oddziałami Integracyjnymi|Żoliborz|ul. A. Felińskiego 15 |01-513 Warszawa;944;647;647;8;639;68.54;1.24
97765;146519;Zespół Państwowych Szkół Muzycznych nr 4|Żoliborz|ul. Z. Krasińskiego 1 |01-530 Warszawa;1129;823;823;5;818;72.90;0.61
97766;146519;Szkoła Podstawowa z Oddziałami Integracyjnymi Nr 68|Żoliborz|ul. Or-Ota 5 |01-507 Warszawa;1701;1219;1219;5;1214;71.66;0.41
97767;146519;Zespół Szkół Elektronicznych i Licealnych|Żoliborz|ul. gen. J. Zajączka 7 |01-518 Warszawa;1233;891;891;4;887;72.26;0.45
97768;146519;Gimnazjum Nr 55 z Oddziałami Integracyjnymi|Żoliborz|al. Wojska Polskiego 1A |01-524 Warszawa;996;706;706;13;693;70.88;1.84
97769;146519;Gimnazjum Nr 55 z Oddziałami Integracyjnymi|Żoliborz|al. Wojska Polskiego 1A |01-524 Warszawa;1428;839;839;5;834;58.75;0.60
97770;146519;Gimnazjum Nr 55 z Oddziałami Integracyjnymi|Żoliborz|al. Wojska Polskiego 1A |01-524 Warszawa;-99;-99;839;-99;-99;-99;-99
97771;149901;Tirana, Ambasada RP|Tirane|Rr. Durresit 123 | ;29;27;27;0;27;93.10;0.00
97772;149901;Algier, Ambasada RP, Wydział Promocji, Handlu i Inwestycji|16606 El-Biar, Alger|4 ter, rue Rabah Bourbia – BP 148 | ;44;36;36;0;36;81.82;0.00
97773;149901;Luanda, Ambasada RP|CP. 1340, Alvalade, Luanda|Rua Damião de Góis 64 | ;56;52;52;1;51;92.86;1.92
97774;149901;Rijad, Ambasada RP|Riyadh 11693|Al-Warood Area 20, Abdullah Bin Dzafar Street | ;73;60;60;0;60;82.19;0.00
97775;149901;Buenos Aires, Ambasada RP|C 1425 CEB Buenos Aires|Alejandro Maria de Aguado 2870 | ;113;96;96;2;94;84.96;2.08
97776;149901;Erywań, Ambasada RP|0010 Yerevan|Hanrapetutyan 44a | ;38;37;37;2;35;97.37;5.41
97777;149901;Canberra, Ambasada RP|Yarralumla, ACT 2600|7 Turrana Street | ;179;156;157;2;154;87.15;1.28
97778;149901;Sydney, Konsulat Generalny RP|Woollahra, NSW 2025|10 Trelawney Street | ;925;808;817;2;806;87.35;0.25
97779;149901;Melbourne, Dom Polski Syrena|Rowville, VIC 3178|1325 Stud Rd | ;372;346;346;0;346;93.01;0.00
97780;149901;Wiedeń I, Ambasada RP|1130 Wien|Hietzinger Hauptstrasse 42c | ;1642;1451;1451;10;1441;88.37;0.69
97781;149901;Wiedeń II, Stałe Przedstawicielstwo RP przy Biurze Narodów Zjednoczonych i organizacjach międzynarodowych|1130 Wien|Hietzinger Hauptstrasse 42c | ;1615;1426;1426;7;1419;88.30;0.49
97782;149901;Linz, Konsulat Honorowy RP|4020 Linz|Mozartstrasse 20 | ;155;128;128;1;127;82.58;0.78
97783;149901;Baku, Ambasada RP|AZ 1000 Bakı|Kiçik Qala küç. 2 | ;29;29;29;0;29;100.00;0.00
97784;149901;Bruksela I, Ambasada RP|1000 Bruxelles|Rue Stevin 139 | ;1329;1234;1242;14;1220;92.85;1.13
97785;149901;Bruksela II, Ambasada RP (dawna siedziba)|1040 Bruxelles|Avenue des Gaulois 29 | ;1241;1165;1165;7;1158;93.88;0.60
97786;149901;Bruksela III, Wydział Konsularny Ambasady RP|1040 Bruxelles|Rue des Francs 28 | ;1126;1000;1008;8;992;88.81;0.80
97787;149901;Bruksela IV, Wydział Konsularny Ambasady RP|1040 Bruxelles|Rue des Francs 28 | ;1200;1071;1073;7;1064;89.25;0.65
97788;149901;Bruksela V, Polska Misja Katolicka|1060 Bruxelles|Rue Jourdan 80 | ;1515;1421;1421;6;1415;93.80;0.42
97789;149901;Antwerpia, Szkolny Punkt Konsultacyjny im. Gen. Maczka|2000 Antwerpen|Jodenstraat 15 | ;1626;1545;1545;17;1528;95.02;1.10
97790;149901;Mińsk, Ambasada RP|220034 Minsk|vulica Biaduli 11 | ;114;100;100;1;99;87.72;1.00
97791;149901;Brześć, Konsulat Generalny RP|224016 Brest|vulica Kujbyšava 34 | ;48;46;46;0;46;95.83;0.00
97792;149901;Grodno, Konsulat Generalny RP|230023 Hrodna|vulica Budzionnaha 48A | ;98;91;91;1;90;92.86;1.10
97793;149901;Sarajewo, Ambasada RP|71000 Sarajevo|Višnjik 20 | ;72;71;71;4;67;98.61;5.63
97794;149901;Brasilia, Ambasada RP|CEP 70.423.900, Brasília-DF|Av. das Nações, Lote 33, Quadra 809, Setor Embaixadas Sul – ASA Sul | ;42;39;39;0;39;92.86;0.00
97795;149901;Kurytyba, Konsulat Generalny RP|CEP 80-030-110, Curitiba - PR|Av. Agostinho Leão Júnior 234, Alto da Glória | ;87;72;74;4;68;82.76;5.56
97796;149901;Sofia, Ambasada RP|1000 Sofia|Chan Krum 46 | ;193;174;174;0;174;90.16;0.00
97797;149901;Warna, Szkolny Punkt Konsultacyjny przy Ambasadzie RP|9002 Varna|Marin Drinov 68 | ;45;42;42;0;42;93.33;0.00
97798;149901;Santiago, Ambasada RP|Providencia - Santiago|Calle Mar del Plata 2055 | ;86;76;76;1;75;88.37;1.32
97799;149901;Pekin, Ambasada RP|100600 Beijing|1 Ritan Lu, Jianguomenwai | ;323;286;286;3;283;88.54;1.05
97800;149901;Kanton, Konsulat Generalny RP|510130 Guangzhou|63 Shamian Dajie | ;167;142;142;1;141;85.03;0.70
97801;149901;Szanghaj, Konsulat Generalny RP|200031 Shanghai|618 Jianguo Xi Lu | ;256;218;218;2;216;85.16;0.92
97802;149901;Hongkong, Konsulat Generalny RP|Wan Chai, Hong Kong|Hopewell Centre, room 2506, 183 Queen’s Road East | ;175;152;152;1;151;86.86;0.66
97803;149901;Tajpej, Warszawskie Biuro Handlowe|Taipei 110|TWTC/ITB Suite 1601-1602, No. 333, Keelung Rd., Sec. 1 | ;101;91;92;2;89;90.10;2.20
97804;149901;Zagrzeb, Ambasada RP|10000 Zagreb|Krležin Gvozd 3 | ;163;153;153;0;153;93.87;0.00
97805;149901;Nikozja, Ambasada RP|1087 Nicosia|12-14 Kennedy Avenue, Office 601 | ;167;158;158;0;158;94.61;0.00
97806;149901;Podgorica, Ambasada RP|81 000 Podgorica|Stari Areodrom, Kozaracka 79 | ;30;29;29;0;29;96.67;0.00
97807;149901;Praga, Wydział Konsularny Ambasady RP|110 00 Praha 1|ul. Truhlářská 13-15 | ;1006;934;934;4;930;92.84;0.43
97808;149901;Ostrawa, Konsulat Generalny RP|701 00 Ostrava|Blahoslavova 4 | ;223;205;205;3;202;91.93;1.46
97809;149901;Kopenhaga, Ambasada RP|2900 Hellerup|Richelieus Allé 12 | ;2458;2176;2190;14;2162;88.53;0.64
97810;149901;Aarhus, Skt. Knuds Skole|8000 Aarhus C|Ryesgade 24 | ;571;488;489;5;483;85.46;1.02
97811;149901;Kair, Ambasada RP|Cairo|5 Aziz Osman Street, Zamalek | ;107;88;89;0;88;82.24;0.00
97812;149901;Tallinn, Ambasada RP|10140 Tallinn|Suur-Karja 1/Vana Turg 2/4 | ;108;102;102;3;99;94.44;2.94
97813;149901;Addis Abeba, Ambasada RP|27207/1000 Addis Ababa|Dej. Balay Zeleke Road, Gulele Sub City, Kebele 08, House no. 583 | ;39;35;35;1;34;89.74;2.86
97814;149901;Helsinki, Ambasada RP|00570 Helsinki|Armas Lindgrenin tie 21 | ;508;444;444;1;443;87.40;0.23
97815;149901;Paryż I, Ambasada RP|75007 Paris|57, rue Saint-Dominique | ;3428;2758;2762;20;2738;80.46;0.73
97816;149901;Paryż II, Wydział Promocji Handlu i Inwestycji Ambasady RP|75116 Paris|86, rue de la Faisanderie | ;1026;890;890;3;887;86.74;0.34
97817;149901;Paryż III, Instytut Polski|75008 Paris|31, rue Jean Goujon | ;1006;865;866;3;862;85.98;0.35
97818;149901;Aulnay-sous-Bois, Ecole Anatole France|93600 Aulnay-sous-Bois|43/45, rue Anatole France | ;439;402;402;11;391;91.57;2.74
97819;149901;Lille, La Halle aux Sucres|59000 Lille|1 rue de l’Entrepôt | ;186;171;171;1;170;91.94;0.58
97820;149901;Strasburg, Stałe Przedstawicielstwo RP przy Radzie Europy|67000 Strasbourg|2, rue Geiler | ;421;386;386;3;383;91.69;0.78
97821;149901;Lyon, Konsulat Generalny RP|69458 Lyon cedex 06|79, rue Crillon | ;1041;898;909;6;892;86.26;0.67
97822;149901;Tuluza, lokal Aldona Kaluza Consulting|31000 Toulouse|19, rue Héliot | ;157;143;143;2;141;91.08;1.40
97823;149901;Antibes, lokal Bohême Assurances|06600 Antibes|23 bv Marechal Foch | ;255;227;227;2;225;89.02;0.88
97824;149901;Ateny, Ambasada RP|154 52 Paleo Psichikο|Kontoleontos 1 | ;493;462;462;6;456;93.71;1.30
97825;149901;Heraklion, Konsulat Honorowy RP|712 01 Iraklio, Kriti|1821 Str. 39 | ;28;23;23;1;22;82.14;4.35
97826;149901;Saloniki, Konsulat Honorowy RP|546 22 Thessaloniki|Tsimiski 78 | ;63;52;52;2;50;82.54;3.85
97827;149901;Tbilisi, Europe House Georgia|Tbilisi 0105|2 Shalva Dadiani | ;143;143;143;0;143;100.00;0.00
97828;149901;Madryt, Ambasada RP|28035 Madrid|Avenida Miraflores, 50 | ;537;447;447;6;441;83.24;1.34
97829;149901;Madryt, Wydział Konsularny Ambasady RP|28001 Madrid|C/Goya 15 4° | ;693;620;620;6;614;89.47;0.97
97830;149901;Madryt, Instytut Polski|28014 Madrid|C/ Felipe IV, 12, bajo A | ;368;329;329;0;329;89.40;0.00
97831;149901;Walencja, Konsulat Honorowy RP|46015 Valencia|Avenida de las Cortes Valencianas nº26 esc. Der. planta 2ª, oficina 7 | ;213;186;187;1;185;87.32;0.54
97832;149901;Malaga, Konsulat Honorowy RP|29015 Malaga|C/ Cortina del Muelle nº5, 4º Derecha | ;313;289;289;2;287;92.33;0.69
97833;149901;Teneryfa, Wyspy Kanaryjskie|38678 Adeje|Centro Comercial San Eugenio 46A, Playa de Las Américas | ;188;188;188;0;188;100.00;0.00
97834;149901;Barcelona, Konsulat Generalny RP|08014 Barcelona|Av. Diagonal, 593-595 | ;1275;1122;1123;4;1118;88.00;0.36
97835;149901;New Delhi, Ambasada RP|110021 New Delhi|50M Shantipath, Chanakyapuri | ;72;60;60;1;59;83.33;1.67
97836;149901;Mumbaj, Konsulat  Generalny RP|Mumbai 400021|Nirmal Building 11 A,  11th Floor, 241/242  Backbay  Reclamation, Nariman Point | ;28;23;23;0;23;82.14;0.00
97837;149901;Dżakarta, Ambasada RP|Jakarta Selatan 12950|Jalan H.R Rasuna Said Kav. X Blok IV/3 | ;74;58;58;0;58;78.38;0.00
97838;149901;Teheran, Ambasada RP|19-174 Teheran|Nelson Mandela Blvd, Pirouz street no. 2, PO Box 11155-3489 | ;38;35;35;1;34;92.11;2.86
97839;149901;Dublin I, RDS – Royal Dublin Society|Dublin 4|Merrion Road, Ballsbridge | ;1922;1625;1625;8;1617;84.55;0.49
97840;149901;Dublin II, RDS – Royal Dublin Society|Dublin 4|Merrion Road, Ballsbridge | ;1911;1604;1604;3;1601;83.94;0.19
97841;149901;Dublin III, RDS – Royal Dublin Society|Dublin 4|Merrion Road, Ballsbridge | ;1910;1619;1619;13;1606;84.76;0.80
97842;149901;Dublin IV, RDS – Royal Dublin Society|Dublin 4|Merrion Road, Ballsbridge | ;1928;1646;1649;5;1641;85.37;0.30
97843;149901;Cork I, Cork City Hall|Cork|Millennium Hall Foyer, Eglinton Street | ;806;713;713;8;705;88.46;1.12
97844;149901;Cork II, Cork City Hall|Cork|Millennium Hall Foyer, Eglinton Street | ;808;718;718;4;714;88.86;0.56
97845;149901;Galway, Holy Trinity National School|Galway|Walter Macken Road, Mervue | ;1184;1075;1075;12;1063;90.79;1.12
97846;149901;Reykjavik, Ambasada RP|105 Reykjavík|Þórunnartún 2 | ;923;834;834;12;822;90.36;1.44
97847;149901;Tel Awiw, Ambasada RP|64-864 Tel Aviv|Soutine 16 | ;391;349;350;7;342;89.26;2.01
97848;149901;Tokio, Ambasada RP|153-0062 Tokyo|2-13-5 Mita, Meguro – ku | ;294;267;267;2;265;90.82;0.75
97849;149901;Amman, Ambasada RP|11194 Amman|3 Mahmoud Seif Al-Din Al-Irani Street | ;60;53;53;1;52;88.33;1.89
97850;149901;Ottawa, Ambasada RP|Ottawa, ON, K1N 6H3|443 Daly Avenue | ;336;298;298;5;293;88.69;1.68
97851;149901;Montreal, Konsulat RP|Montreal, QC H3G 2C8|3501, Avenue du Musee | ;473;424;431;5;419;89.64;1.18
97852;149901;Toronto I, Konsulat Generalny RP|Toronto, ON, M8V 1G5|2603 Lake Shore Boulevard West | ;1574;1338;1338;7;1331;85.01;0.52
97853;149901;Toronto II, Konsulat Generalny RP|Toronto, ON, M8V 1G5|2603 Lake Shore Boulevard West | ;1593;1444;1444;16;1428;90.65;1.11
97854;149901;Winnipeg, Konsulat Honorowy RP|Winnipeg, MB, R2H 0T5|219 Marion Street | ;95;86;86;1;85;90.53;1.16
97855;149901;Vancouver, Konsulat Generalny RP|Vancouver, BC, V6E 2K3|1600-1177 West Hastings Street | ;543;452;452;5;447;83.24;1.11
97856;149901;Edmonton, Konsulat Honorowy RP|Edmonton, AB, T6B 2V4|107-4990  92nd Avenue | ;276;249;249;1;248;90.22;0.40
97857;149901;Calgary, Konsulat Honorowy RP|Calgary, AB, T2C 1W3|6224  29th Street SE | ;361;296;296;5;291;81.99;1.69
97858;149901;Doha, Ambasada RP|PO Box 23380, Doha|Al-Qutaifiya 66, Str. No. 519, Saha 49 | ;174;155;155;1;154;89.08;0.65
97859;149901;Astana, Ambasada RP|010000 Astana|Saryarka 15, Business Center „Isker”, | ;61;59;59;0;59;96.72;0.00
97860;149901;Ałmaty, Konsulat Generalny RP|050059 Almaty|Dżarkentska/Iskanderova 9-11/13, Gornyj Gigant | ;59;55;55;0;55;93.22;0.00
97861;149901;Nairobi, Ambasada RP|00100 Nairobi, P.O. Box 30086|58 Red Hill Road (off Limuru Road) | ;105;74;74;2;72;70.48;2.70
97862;149901;Bogota, Ambasada RP|Bogotá|Carrera 21 bis No. 104 A – 15 | ;47;43;43;0;43;91.49;0.00
97863;149901;Seul, Ambasada RP|Seoul, 110-190|Samcheong-ro 20-1, Jongno-gu, | ;126;114;114;1;113;90.48;0.88
97864;149901;Pjongjang, Ambasada RP|Pyongyang|Taedonggang – Munsudong District, | ;17;17;17;0;17;100.00;0.00
97865;149901;Novo Selo, Camp Maréshal de Lattre de Tassigny|Novo Selo/Maxhunaj| | ;215;201;201;1;200;93.49;0.50
97866;149901;Hawana, Ambasada RP|Vedado, 10400 La Habana|Avenida de los Presidentes 452 | ;52;40;40;1;39;76.92;2.50
97867;149901;Kuwejt, Ambasada RP|13051 Kuwait|Al-Jabriya, Area 7, Street 3, Villa 20 | ;134;122;123;2;120;91.04;1.64
97868;149901;Bejrut, Ambasada RP|Baabda|Av. President Suleiman Frangieh 52 | ;124;120;120;4;116;96.77;3.33
97869;149901;Wilno, Ambasada RP|LT-10323 Vilnius|Smėlio 20a | ;224;206;206;0;206;91.96;0.00
97870;149901;Luksemburg, Ambasada RP|L-2522 Luxembourg|24, rue Guillaume Schneider | ;1171;1071;1072;8;1063;91.46;0.75
97871;149901;Ryga, Ambasada RP|LV 1010 Rīga, |Mednieku iela 6b | ;117;108;108;5;103;92.31;4.63
97872;149901;Skopje, Ambasada RP|1000 Skopje|Dimitar Pandilov 2a | ;52;43;43;0;43;82.69;0.00
97873;149901;Kuala Lumpur, Ambasada RP|55000 Kuala Lumpur|No 10 Lorong Damai 9, Off Jalan Damai | ;110;103;103;0;103;93.64;0.00
97874;149901;Rabat, Ambasada RP|10 000 Rabat - Agdal|23, Avenue Oqbah, BP. 425 | ;61;47;47;3;44;77.05;6.38
97875;149901;Agadir, Konsulat Honorowy RP|80 001 Agadir|Imm. Mayouhal, Avenue Hassan II, BP. 240 | ;34;26;26;0;26;76.47;0.00
97876;149901;Meksyk, Ambasada RP|01000 Ciudad De Mexico|c. Cracovia 40, Colonia San Ángel, Delegación Álvaro Obregón | ;106;79;80;1;78;74.53;1.27
97877;149901;Kiszyniów, Wydział Konsularny Ambasady RP|MD-2019 Chişinău|V. Alecsandri 101 | ;55;50;50;2;48;90.91;4.00
97878;149901;Haga I, Ambasada RP|2514 JM Den Haag|Alexanderstraat 25 | ;1786;1536;1536;17;1519;86.00;1.11
97879;149901;Haga II, Ambasada RP|2514 JM Den Haag|Alexanderstraat 25 | ;1807;1531;1531;7;1524;84.73;0.46
97880;149901;Amsterdam, Niderlandzki Dom Polski|1016 DW Amsterdam|Keizersgracht 174-176 | ;1870;1630;1630;10;1620;87.17;0.61
97881;149901;Breda, Polska Parafia przy Kościele Laurentius|4835 ND Breda|Ginnekenweg 333 | ;1312;1138;1140;16;1122;86.74;1.41
97882;149901;Berlin I, Ambasada RP|14193 Berlin|Lassenstr. 19 – 21 | ;1647;1465;1465;0;1465;88.95;0.00
97883;149901;Berlin II, Ambasada RP|14193 Berlin|Richard-Strauss-Str. 11 | ;1080;900;900;1;899;83.33;0.11
97884;149901;Berlin III, Instytut Polski|10178 Berlin|Burgstrasse 27 | ;2056;1838;1838;7;1831;89.40;0.38
97885;149901;Berlin IV, Centrum Badań Historycznych PAN|13156 Berlin|Majakowskiring 47 | ;357;308;308;0;308;86.27;0.00
97886;149901;Lipsk, Instytut Polski w Berlinie, filia w Lipsku|04109 Leipzig|Markt 10 | ;262;238;238;1;237;90.84;0.42
97887;149901;Hamburg I, Konsulat Generalny RP|22309 Hamburg|Gründgensstrasse 20 | ;1401;1223;1223;6;1217;87.29;0.49
97888;149901;Hamburg II, Konsulat Generalny RP|22309 Hamburg|Gründgensstrasse 20 | ;1113;974;974;5;969;87.51;0.51
97889;149901;Hamburg III, Konsulat Generalny RP|22309 Hamburg|Gründgensstrasse 20 | ;1086;950;950;2;948;87.48;0.21
97890;149901;Kolonia I, Konsulat Generalny RP|50670 Köln|Im MediaPark 5 c | ;1480;1256;1256;3;1253;84.86;0.24
97891;149901;Kolonia II, Konsulat Generalny RP|50670 Köln|Im MediaPark 5 c | ;1476;1238;1238;2;1236;83.88;0.16
97892;149901;Kolonia III, Konsulat Generalny RP|50670 Köln|Im MediaPark 5 c | ;1453;1221;1221;5;1216;84.03;0.41
97893;149901;Dortmund, Polska Misja Katolicka|44147 Dortmund|Rheinische Str. 174 | ;867;785;785;13;772;90.54;1.66
97894;149901;Wiesbaden, Polska Misja Katolicka|65189 Wiesbaden|Lessingstr. 19 | ;1190;1040;1041;5;1035;87.39;0.48
97895;149901;Düsseldorf, Instytut Polski|40213 Düsseldorf|Citadellstraße 7 | ;1450;1292;1292;12;1280;89.10;0.93
97896;149901;Monachium I, Konsulat Generalny RP|81679 München|Röntgenstrasse 5 | ;2108;2083;2083;22;2061;98.81;1.06
97897;149901;Monachium II, Konsulat Generalny RP|81679 München|Röntgenstrasse 5 | ;2140;1855;1858;1;1854;86.68;0.05
97898;149901;Monachium III, Konsulat Generalny RP|81679 München|Röntgenstrasse 5 | ;1401;1209;1227;0;1209;86.30;0.00
97899;149901;Abudża, Ambasada RP|Maitama, Abuja|8, River Niger St., off Danube St. | ;24;23;23;1;22;95.83;4.35
97900;149901;Oslo I, Wydział Konsularny Ambasady RP|0277 Oslo|Drammensveien 169-171 | ;2552;2159;2159;11;2148;84.60;0.51
97901;149901;Oslo II, Wydział Promocji Handlu i Inwestycji Ambasady RP|0351 Oslo|Uranienborg terrasse 11 | ;2542;2084;2087;10;2074;81.98;0.48
97902;149901;Bergen, Szkoła Katolicka Św. Pawła|5015 Bergen|Christies gate 16 | ;1359;1226;1226;1;1225;90.21;0.08
97903;149901;Stavanger, Bekkefaret bydelhus|4019 Stavanger|Hjalmar Johansens gate 4 | ;1582;1398;1398;11;1387;88.37;0.79
97904;149901;Trondheim, Omega Accounting AS & Polish Connection|7010 Trondheim|Kjøpmannsgata 52 | ;520;482;482;3;479;92.69;0.62
97905;149901;Tromsø, Parafia katolicka NMP|9008 Tromsø|Storgata 94 | ;131;123;123;0;123;93.89;0.00
97906;149901;Wellington, Ambasada RP|Wellington|Level 9, City Chambers, 142-144 Featherston Street | ;106;77;77;0;77;72.64;0.00
97907;149901;Islamabad, Ambasada RP|44000 Islamabad, P.O. Box 1032|Diplomatic Enclave II, Str. 24, G-5/4, | ;24;20;20;0;20;83.33;0.00
97908;149901;Lima, Ambasada RP|Jesús María - Lima 11|Avenida Salaverry 1978 | ;77;61;61;0;61;79.22;0.00
97909;149901;Lizbona, Ambasada RP|1400-092 Lisboa|Avenida das Descobertas 2 | ;852;718;718;3;715;84.27;0.42
97910;149901;Pretoria, Ambasada RP|Colbyn 0083|14 Amos Street | ;213;209;209;5;204;98.12;2.39
97911;149901;Durban, Konsulat Honorowy RP|Westville 3629|3 Chase Place | ;57;52;52;1;51;91.23;1.92
97912;149901;Kapsztad, Nazareth House|Vredehoek 8001|1 Derry Street | ;71;64;64;0;64;90.14;0.00
97913;149901;Moskwa, Wydział Konsularny Ambasady RP|115127 Moskva|Klimashkina 4 | ;353;312;313;0;312;88.39;0.00
97914;149901;Irkuck, Konsulat Generalny RP|664003 Irkutsk|Suche-Batora 18 | ;41;36;36;0;36;87.80;0.00
97915;149901;Kaliningrad, Konsulat Generalny RP|236000 Kaliningrad|Kashtanovaya Alleya51 | ;45;39;39;0;39;86.67;0.00
97916;149901;Sankt Petersburg, Konsulat Generalny RP|191036 Sankt-Peterburg|5 Sovietskaya 12/14 | ;99;89;89;0;89;89.90;0.00
97917;149901;Smoleńsk, Agencja Konsularna RP|214014 Smolensk|Mira 1 | ;26;24;24;2;22;92.31;8.33
97918;149901;Bukareszt, Ambasada RP|011821, sector 1, București|Aleea Alexandru 23 | ;221;203;203;2;201;91.86;0.99
97919;149901;Belgrad, Ambasada RP|11000 Beograd|Kneza Miloša 38 | ;92;80;80;4;76;86.96;5.00
97920;149901;Singapur, Ambasada RP|Singapore 238877|435 Orchard Road, #17-02/03 Wisma Atria | ;292;261;261;1;260;89.38;0.38
97921;149901;Bratysława, Ambasada RP|814 91 Bratislava|Hummelova 4 | ;240;210;212;2;208;87.50;0.95
97922;149901;Lublana, Ambasada RP|1000 Ljubljana|Bežigrad 10 | ;172;158;158;1;157;91.86;0.63
97923;149901;Waszyngton, Ambasada RP – Wydział Konsularny|Washington, DC 20008|2224 Wyoming Avenue NW | ;774;616;618;4;612;79.59;0.65
97924;149901;Pompano Beach, Polska Misja Katolicka|Pompano Beach, FL 33062|2400 NE 12th Street | ;262;225;225;4;221;85.88;1.78
97925;149901;Lavrenceville, Parafia St. Marguerite D`Youville|Lavrenceville, GA 30044|Gloster Rd NW 85 | ;107;89;89;2;87;83.18;2.25
97926;149901;Clearwater, Polskie Centrum im. Jana Pawła II|Clearwater, FL 33755|1521 N Saturn Avenue | ;169;148;148;3;145;87.57;2.03
97927;149901;Nowy Jork I, Konsulat Generalny RP|New York, NY 10016|233 Madison Avenue (Jan Karski Corner) | ;1869;1497;1497;16;1481;80.10;1.07
97928;149901;Nowy Jork II, Centrum Polsko-Słowiańskie|Brooklyn, NY 11222|177 Kent Street | ;2801;2549;2550;20;2529;91.00;0.78
97929;149901;Nowy Jork III, Parafia Matki Bożej Pocieszenia|Brooklyn, NY 11249|184 Metropolitan Avenue | ;348;302;302;3;299;86.78;0.99
97930;149901;Nowy Jork IV, Centrum Parafialne Parafii Św. Alojzego|Ridgewood, NY 11385|18-17 Stanhope Street | ;925;828;828;11;817;89.51;1.33
97931;149901;Passaic, Sanktuarium Św. Jana Pawła II|Passaic, NJ 07055|6 Wall Street | ;1645;1495;1495;8;1487;90.88;0.54
97932;149901;Clark, Polska Fundacja Kulturalna|Clark, NJ 07066|177 Broadway | ;599;543;543;7;536;90.65;1.29
97933;149901;New Britain, Haller Post|New Britain, CT 06053|112 Grove Street | ;693;624;624;8;616;90.04;1.28
97934;149901;Filadelfia, Stowarzyszenie Domu Polskiego|Philadelphia, PA 19114|9150 Academy Road | ;449;388;388;2;386;86.41;0.52
97935;149901;Boston, Parafia Matki Boskiej Częstochowskiej|South Boston, MA 02127|655 Dorchester Ave | ;341;279;279;1;278;81.82;0.36
97936;149901;Los Angeles, Konsulat Generalny RP|Los Angeles, CA 90025|12400 Wilshire Blvd, Suite 555 | ;912;777;777;1;776;85.20;0.13
97937;149901;San Francisco, Konsulat Honorowy RP|San Francisco, CA 94103|785 Market Street, 15th Floor | ;395;306;306;3;303;77.47;0.98
97938;149901;Houston, Parafia pod wezwaniem Matki Boskiej Częstochowskiej|Houston, TX 77080|1731 Blalock Road | ;173;146;146;2;144;84.39;1.37
97939;149901;Phoenix, Polska Parafia pod wezwaniem Matki Bożej Częstochowskiej|Phoenix, AZ 85053|2828 W Country Gables Drive | ;141;118;118;1;117;83.69;0.85
97940;149901;Seattle, Towarzystwo Domu Polskiego|Seattle, WA 98122|1714 18th Avenue | ;229;201;201;1;200;87.77;0.50
97941;149901;Denver, Polska Szkoła w Denver przy Kościele Świętego Józefa|Denver, CO 80216|525 E 46th Avenue | ;139;125;125;1;124;89.93;0.80
97942;149901;Chicago I, Konsulat Generalny RP|Chicago, IL 60610|1530 North Lake Shore Drive | ;714;604;615;2;602;84.59;0.33
97943;149901;Chicago II, Dom Podhalan ZPPA|Chicago, IL 60632|4808 S. Archer Ave. | ;1974;1860;1860;13;1847;94.22;0.70
97944;149901;Chicago III, Związek Narodowy Polski|Chicago, IL 60646|6100 N. Cicero Ave. | ;853;793;793;0;793;92.97;0.00
97945;149901;Chicago IV, Parafia Św. Ferdynanda 1|Chicago, IL 60634|3131 N. Mason Ave. | ;1486;1400;1400;8;1392;94.21;0.57
97946;149901;Chicago V, Parafia Św. Ferdynanda 2|Chicago, IL 60634|5900 W. Barry Ave. | ;1514;1396;1397;6;1390;92.21;0.43
97947;149901;Chicago VI, Parafia Św. Konstancji|Chicago, IL 60630|5836 W. Ainslie St. | ;2376;2228;2228;8;2220;93.77;0.36
97948;149901;Chicago VII, Bazylika Św. Jacka|Chicago, IL 60618|3636 W. Wolfram St. | ;1445;1364;1364;8;1356;94.39;0.59
97949;149901;Chicago VIII, Polska Misja Ojców Cystersów|Willow Springs, IL 60480|116 Hilton St. | ;1356;1279;1281;17;1262;94.32;1.33
97950;149901;Chicago IX, Polska Katolicka Misja pw. Miłosierdzia Bożego|Lombard, IL 60148|21W411 Sunset Ave. | ;802;742;742;10;732;92.52;1.35
97951;149901;Chicago X, Parafia Św. Trójcy|Chicago, IL 60642|1118 N. Noble St. | ;514;464;467;3;461;90.27;0.65
97952;149901;Chicago XI, Parafia Św. Cyryla i Metodego|Lemont, IL 60439|608 Sobieski St. | ;316;302;302;3;299;95.57;0.99
97953;149901;Chicago XII, Polsko–Słowiańska Federalna Unia Kredytowa|Mt. Prospect, IL 60056|1044 Mt. Prospect Plaza | ;925;864;864;9;855;93.41;1.04
97954;149901;Detroit, Polsko-Amerykańskie Centrum Kulturalne|Troy, MI 48083|2975 E. Maple Road | ;330;304;304;3;301;92.12;0.99
97955;149901;Berno, Ambasada RP|3006 Bern|Elfenstrasse 20a | ;2707;2394;2401;6;2388;88.44;0.25
97956;149901;Genewa, Stałe Przedstawicielstwo RP przy Biurze Narodów Zjednoczonych w Genewie|1218 Grand-Saconnex|L’Ancienne Route 15 | ;566;518;519;2;516;91.52;0.39
97957;149901;Sztokholm I, Wydział Konsularny Ambasady RP|172 32 Sundbyberg|Prästgårdsgatan 5 | ;1672;1514;1528;3;1511;90.55;0.20
97958;149901;Sztokholm II, Ambasada RP|114 31 Stockholm|Karlavägen 35 | ;1474;1290;1290;22;1268;87.52;1.71
97959;149901;Malmö, Limhamns Folkets Hus|216 14 Malmö-Limhamn|Linnégatan 61 | ;719;660;660;2;658;91.79;0.30
97960;149901;Göteborg, Polonia Center/Związek Polskich Katolików|415 05 Göteborg|Säveåns Strandgata 4 | ;663;616;616;3;613;92.91;0.49
97961;149901;Bangkok, Ambasada RP|Huaykwang, Bangkok 10310|100/81-82 Vongvanij Building B, Rama 9 Road | ;207;158;158;1;157;76.33;0.63
97962;149901;Tunis, Ambasada RP|2045 Les Berges du Lac II|le Grand Boulevard de la Corniche | ;153;138;138;4;134;90.20;2.90
97963;149901;Ankara, Ambasada RP|06650 Ankara|Atatürk Bulvarı 241, Kavaklıdere, PK-20 | ;107;94;94;0;94;87.85;0.00
97964;149901;Antalya, Konsulat Honorowy RP|07160 Antalya|Fener Mahallesi, 1969 Sokak 32/4 | ;69;63;63;0;63;91.30;0.00
97965;149901;Stambuł, Konsulat Generalny RP|34398 Maslak, İstanbul|Giz  2000 Plaza, Ayazağa Köyü Yolu No: 7, K. 5 | ;171;152;152;4;148;88.89;2.63
97966;149901;Izmir, Konsulat Honorowy RP|Alsancak/İzmir|1377 Sokak, Aydıner Apartmanı No: 3/19A | ;37;35;35;0;35;94.59;0.00
97967;149901;Kijów, Wydział Konsularny Ambasady RP|01901 Kyiv|Bohdana Chmielnickiego 60 | ;258;237;237;0;237;91.86;0.00
97968;149901;Charków, Konsulat Generalny RP|61002 Kharkiv|Artioma 16 | ;47;44;44;3;41;93.62;6.82
97969;149901;Odessa, Konsulat Generalny RP|65014 Odesa|Uspenska 2/1 | ;62;60;60;0;60;96.77;0.00
97970;149901;Lwów, Konsulat Generalny RP|79011 Lviv|Ivana Franka 108 | ;350;320;320;3;317;91.43;0.94
97971;149901;Łuck, Konsulat Generalny RP|43010 Lutsk|Dubniwska 22b | ;52;51;51;1;50;98.08;1.96
97972;149901;Winnica, Konsulat Generalny RP|21050 Vinnytsia|Kozytskoho 51, | ;76;66;66;0;66;86.84;0.00
97973;149901;Taszkent, Ambasada RP|100084, Toshkent|Firdavsiy ko’ch., 66 | ;31;27;27;0;27;87.10;0.00
97974;149901;Caracas, Ambasada RP|1060 Caracas|Avenida Nicolás Copérnico, Quinta Ambar, Sector Valle Arriba, Urbanizacion Las Mercedes | ;50;40;40;2;38;80.00;5.00
97975;149901;Budapeszt, Ambasada RP|1068 Budapest|Városligeti fasor 16 | ;642;589;591;3;586;91.74;0.51
97976;149901;Londyn I, Polski Ośrodek Społeczno-Kulturalny|London W6 0RF|238-246 Kings Street | ;2332;2057;2057;4;2053;88.21;0.19
97977;149901;Londyn II, Polska Parafia na Wimbledon-Putney|London SW15 6AW|7 St. John's Hall, Ravenna Road | ;1449;1307;1307;9;1298;90.20;0.69
97978;149901;Londyn III, Apostolat Miłosierdzia Bożego|London W13 0EY|1 Courtfield Gardens | ;822;700;700;3;697;85.16;0.43
97979;149901;Londyn IV, Windsor Hall przy Polskiej Parafii na Ealingu|London W5 5PD|2 Windsor Road | ;3532;3208;3208;31;3177;90.83;0.97
97980;149901;Londyn V, Klub Orła Białego|London, SW17 7BQ|211 Balham High Road | ;2873;2579;2579;18;2561;89.77;0.70
97981;149901;Londyn VI, Ambasada RP|London W1B 1JH|47 Portland Place | ;3641;2833;2833;10;2823;77.81;0.35
97982;149901;Londyn VII, Ambasada RP|London W1B 1JH|47 Portland Place | ;3174;2779;2779;48;2731;87.56;1.73
97983;149901;Londyn VIII, Wydział Konsularny (stara siedziba)|London W1W 6LS|73 New Cavendish Street | ;2192;1723;1723;4;1719;78.60;0.23
97984;149901;Londyn IX, Wydział Konsularny (stara siedziba)|London W1W 6LS|73 New Cavendish Street | ;1634;1431;1431;2;1429;87.58;0.14
97985;149901;Londyn X, Wydział Konsularny (nowa siedziba)|London EC4Y 8AX|10 Bouverie Street | ;3838;3124;3124;7;3117;81.40;0.22
97986;149901;Londyn XI, Dom Parafialny Lokalnej Polskiej Misji Katolickiej w Ilford|Goodmayers, Ilford IG3 9XE|2 Ashgrove Road | ;1607;1392;1392;8;1384;86.62;0.57
97987;149901;Slough, Lokalna Polska Misja Katolicka w Slough|Slough SL1 3XH|48 Pitts Road | ;1899;1703;1703;18;1685;89.68;1.06
97988;149901;Peterborough, Parafia pod wezwaniem Św. Jana Chrzciciela przy Kościele Our Lady of Lourdes|Peterborough PE1 3SR|2 Cedar Grove | ;936;840;840;14;826;89.74;1.67
97989;149901;Southampton, Polski Klub|Southampton SO17 2TH|507 Portswood Road | ;2094;1869;1869;35;1834;89.26;1.87
97990;149901;Birmingham I, Klub Polski Millenium House|Birmingham B5 5PH|Bordesley Street | ;1227;1067;1067;7;1060;86.96;0.66
97991;149901;Birmingham II, Klub Polski Millenium House|Birmingham B5 5PH|Bordesley Street | ;1225;1072;1072;12;1060;87.51;1.12
97992;149901;Bristol, Klub Polski SPK|Bristol BS8 1LP|50 St. Paul's Road | ;1829;1551;1551;17;1534;84.80;1.10
97993;149901;Cambridge, Dom Polonia|Cambridge CB4 1AS|231 Chesterton Road | ;1534;1333;1333;6;1327;86.90;0.45
97994;149901;Coventry, Dom Parafialny The Presbytery|Coventry CV1 4GR|Springfield Road | ;1650;1467;1467;8;1459;88.91;0.55
97995;149901;Northampton, Polski Klub w Northampton|Northampton NN1 3EZ|Craven Street | ;1746;1552;1552;8;1544;88.89;0.52
97996;149901;Manchester I, Konsulat Generalny RP|Manchester M1 3LD|51 Portland Street | ;2787;2224;2231;8;2216;79.80;0.36
97997;149901;Manchester II, Konsulat Generalny RP|Manchester M1 3LD|51 Portland Street | ;2793;2253;2270;15;2238;80.67;0.67
97998;149901;Manchester III, Ośrodek Polski przy Parafii Miłosierdzia Bożego|Manchester M14 4QB|196 Lloyd Street North | ;1256;1102;1103;3;1099;87.74;0.27
97999;149901;Liverpool, The Academy of St. Francis of Assisi|Liverpool L6 7UR|Gardens Drive | ;531;452;452;1;451;85.12;0.22
98000;149901;Leeds, Polskie Centrum|Leeds LS7 4JE|Newton Hill Road | ;1952;1718;1718;9;1709;88.01;0.52
98001;149901;Nottingham, Ośrodek Polski przy Parafii Matki Bożej Częstochowskiej|Nottingham NG7 6JN|2 Sherwood Rise | ;1512;1340;1340;9;1331;88.62;0.67
98002;149901;Spalding, Polskie Centrum Edukacji|Spalding PE11 1AY|2 Abbey Path | ;367;326;326;5;321;88.83;1.53
98003;149901;Cardiff, Dom Polski|Cardiff CF24 1DL|174 Newport Road | ;690;618;618;4;614;89.57;0.65
98004;149901;Leicester, Ośrodek Polski przy Parafii Świętego Pawła|Leicester LE5 4WD|Wakerley Road | ;1081;959;959;6;953;88.71;0.63
98005;149901;Newcastle upon Tyne, Ośrodek Polski przy Parafii Matki Bożej Częstochowskiej|Newcastle upon Tyne NE4 7SF|2 Maple Terrace | ;558;511;511;8;503;91.58;1.57
98006;149901;Sheffield, Polska Misja Katolicka|Sheffield S11 8PY|518-520 Ecclesall Road | ;563;495;495;4;491;87.92;0.81
98007;149901;Edynburg I, Konsulat Generalny RP|Edinburgh EH3 5PE|2 Kinnear Road | ;1708;1485;1485;10;1475;86.94;0.67
98008;149901;Edynburg II, Dom SPK|Edinburgh  EH3 6 PJ|11 Drummond Place | ;881;721;723;4;717;81.84;0.55
98009;149901;Edynburg III, Dom SPK|Edinburgh  EH3 6 PJ|11 Drummond Place | ;871;736;736;5;731;84.50;0.68
98010;149901;Edynburg IV, Polskie Centrum Kultury i Edukacji im. Fryderyka Chopina|Edinburgh EH6 7EP|11 John's Place | ;882;715;715;0;715;81.07;0.00
98011;149901;Aberdeen, Stowarzyszenie Polskie w Aberdeen|Aberdeen AB11 5BN|35A Union Street | ;1177;1013;1013;19;994;86.07;1.88
98012;149901;Glasgow I, Dom Sikorskiego|Glasgow G3 7SD|5 Parkgrove Terrace | ;730;660;661;0;660;90.41;0.00
98013;149901;Glasgow II, Dom Sikorskiego|Glasgow G3 7SD|5 Parkgrove Terrace | ;709;644;644;11;633;90.83;1.71
98014;149901;Belfast I, Chinese Welfare Association|Belfast BT7 1GB|1 Stranmillis Embankment | ;505;452;452;6;446;89.50;1.33
98015;149901;Belfast II, Chinese Welfare Association|Belfast BT7 1GB|1 Stranmillis Embankment | ;494;449;449;5;444;90.89;1.11
98016;149901;Hanoi, Ambasada RP|Ba Đình, Hà Nội|5 Bà Huyện Thanh Quan | ;87;74;74;0;74;85.06;0.00
98017;149901;Rzym, Ambasada RP|00197 Roma|Via Pietro Paolo Rubens 20 | ;2234;1994;1994;15;1979;89.26;0.75
98018;149901;Mediolan, Konsulat Generalny RP|20149 Milano|via Monte Rosa 6 | ;1199;1028;1028;7;1021;85.74;0.68
98019;149901;Abu Zabi, Ambasada RP|Abu Dhabi, P.O. Box 2334|Building 3, corner of 13 Delma Street and 14 Karamah Street | ;399;305;305;2;303;76.44;0.66
98020;160101;Miejski Ośrodek Sportu i Rekreacji - Hala Sportowa|Brzeg|ul. Oławska 2 |49-300 Brzeg;1204;499;499;23;476;41.45;4.61
98021;160101;Ratusz|Brzeg|Rynek |49-300 Brzeg;1319;532;532;6;526;40.33;1.13
98022;160101;Przedszkole Publiczne nr 6|Brzeg|ul. Wysoka 1 |49-300 Brzeg;1506;570;570;24;546;37.85;4.21
98023;160101;Brzeskie Centrum Kultury|Brzeg|ul. Mleczna 2 |49-300 Brzeg;1153;551;551;15;536;47.79;2.72
98024;160101;Publiczna Szkoła Podstawowa nr 3|Brzeg|ul. Kamienna 2 |49-300 Brzeg;1494;585;585;20;565;39.16;3.42
98025;160101;Zespół Szkół Budowlanych|Brzeg|ul. Kamienna 3 |49-300 Brzeg;1455;668;668;11;657;45.91;1.65
98026;160101;Publiczna Szkoła Podstawowa nr 3|Brzeg|ul. Kamienna 2 |49-300 Brzeg;840;360;360;1;359;42.86;0.28
98027;160101;Przedszkole Publiczne nr 5|Brzeg|ul. Boh. Monte Cassino 1 |49-300 Brzeg;1049;549;549;18;531;52.34;3.28
98028;160101;Publiczne Gimnazjum nr 3|Brzeg|ul. Boh. Monte Cassino 14 |49-300 Brzeg;2118;1087;1087;24;1063;51.32;2.21
98029;160101;Przedszkole Publiczne nr 10|Brzeg|ul. Ks. Makarskiego 5 |49-300 Brzeg;1592;889;889;14;875;55.84;1.57
98030;160101;Zespół Szkół nr 1 z Oddziałami Sportowymi|Brzeg|ul. Poprzeczna 1 |49-300 Brzeg;1435;752;752;12;740;52.40;1.60
98031;160101;Klub Spółdzielni Mieszkaniowej "ZGODA"|Brzeg|ul. Brzechwy 3 |49-300 Brzeg;906;467;467;14;453;51.55;3.00
98032;160101;Klub Spółdzielni Mieszkaniowej "SAWA"|Brzeg|ul. Chocimska 7 |49-300 Brzeg;2006;1057;1057;12;1045;52.69;1.14
98033;160101;Miejski Ośrodek Sportu i Rekreacji - Stadion Miejski|Brzeg|ul. Sportowa 1 |49-300 Brzeg;1260;753;753;7;746;59.76;0.93
98034;160101;Zespół Szkół nr 2 z Oddziałami Integracyjnymi|Brzeg|ul. Lompy 1 |49-300 Brzeg;1628;891;891;15;876;54.73;1.68
98035;160101;Zespół Szkół Zawodowych nr 1|Brzeg|ul. Słowiańska 18 |49-300 Brzeg;1419;746;746;13;733;52.57;1.74
98036;160101;Dzienny Dom Pomocy Społecznej|Brzeg|ul. Piastowska 29 |49-300 Brzeg;963;426;426;5;421;44.24;1.17
98037;160101;II Liceum Ogólnokształcące|Brzeg|ul. 1 Maja 7 |49-300 Brzeg;1434;776;776;8;768;54.11;1.03
98038;160101;Publiczna Szkoła Podstawowa nr 5|Brzeg|ul. Robotnicza 22 |49-300 Brzeg;1349;651;651;9;642;48.26;1.38
98039;160101;Zespół Szkół nr 1 z Oddziałami Sportowymi|Brzeg|ul. Poprzeczna 1 |49-300 Brzeg;1383;728;728;7;721;52.64;0.96
98040;160101;I Liceum Ogólnokształcące|Brzeg|ul. Armii Krajowej 7 |49-300 Brzeg;1527;707;707;7;700;46.30;0.99
98041;160101;Zakład Karny Brzeg|Brzeg|ul. Chrobrego 29 |49-300 Brzeg;358;184;184;13;171;51.40;7.07
98042;160101;Brzeskie Centrum Medyczne Brzeg|Brzeg|ul. Mossora 1 |49-300 Brzeg;98;35;35;3;32;35.71;8.57
98043;160101;Brzeskie Centrum Medyczne|Brzeg|ul. Nysańska 4-6 |49-300 Brzeg;35;10;10;2;8;28.57;20.00
98044;160101;Całodobowy Dom Opieki "Alma Portus" w Brzegu|Brzeg|Piastowska 14 |49-300 ;27;8;8;0;8;29.63;0.00
98045;160102;Dom Ludowy|Zwanowice| 44 |49-300 Brzeg;454;205;205;3;202;45.15;1.46
98046;160102;Dom Ludowy|Kruszyna| 84 |49-300 Brzeg;403;190;190;5;185;47.15;2.63
98047;160102;Świetlica wiejska|Pawłów|ul. Wesoła 11 |49-300 Brzeg;383;193;193;6;187;50.39;3.11
98048;160102;Budynek byłego Zespołu Szkół Rolniczych w Żłobiźnie|Żłobizna|ul. Jaśminowa 1 (hala sportowa)|49-305 Brzeg;484;280;280;11;269;57.85;3.93
98049;160102;Dom Ludowy|Zielęcice|ul. Klonowa 7 |49-318 Skarbimierz;288;156;156;5;151;54.17;3.21
98050;160102;Gminne Gimnazjum w Skarbimierzu-Osiedle|Skarbimierz-Osiedle|ul. Akacjowa 27 |49-318 Skarbimierz;1664;828;828;15;813;49.76;1.81
98051;160102;Przedszkole|Małujowice| 65 |49-318 Skarbimierz;348;144;144;3;141;41.38;2.08
98052;160102;Dom Ludowy|Łukowice Brzeskie| 88a |49-318 Skarbimierz;586;238;238;14;224;40.61;5.88
98053;160102;Dom Ludowy|Pępice| 63 |49-317 Skarbimierz;316;158;158;4;154;50.00;2.53
98054;160102;Przedszkole|Brzezina| 64 |49-300 Skarbimierz;446;211;211;3;208;47.31;1.42
98055;160102;Dom Ludowy|Lipki| 32 |49-300 Brzeg;532;228;228;6;222;42.86;2.63
98056;160103;Gimnazjum Publiczne Nr 1|Grodków|ul. Powstańców Śl. 24 |49-200 Grodków;1183;502;502;13;489;42.43;2.59
98057;160103;Miejska i Gminna Biblioteka Publiczna|Grodków|ul. Rynek 1 |49-200 Grodków;1023;422;422;16;406;41.25;3.79
98058;160103;Centrum Kształcenia Praktycznego Zespołu Szkół Rolniczych|Grodków|ul. Krakowska 20 |49-200 Grodków;1111;537;537;8;529;48.33;1.49
98059;160103;Gimnazjum Publiczne Nr 2|Grodków|ul. Mickiewicza 13 |49-200 Grodków;1115;425;425;15;410;38.12;3.53
98060;160103;Hala Sportowa przy Liceum Ogólnokształcącym|Grodków|ul. Sienkiewicza 29A |49-200 Grodków;1001;453;453;8;445;45.25;1.77
98061;160103;Publiczna Szkoła Podstawowa Nr 3|Grodków|ul. Morcinka 2 |49-200 Grodków;835;457;457;6;451;54.73;1.31
98062;160103;Publiczna Szkoła Podstawowa Nr 3|Grodków|ul. Morcinka 2 |49-200 Grodków;931;468;468;9;459;50.27;1.92
98063;160103;Publiczna Szkoła Podstawowa|Kopice| 32B |49-200 Grodków;1010;377;377;22;355;37.33;5.84
98064;160103;Świetlica Wiejska|Żelazna| 15 |49-200 Grodków;681;245;245;11;234;35.98;4.49
98065;160103;Świetlica Wiejska|Tarnów Grodkowski| 90B |49-200 Grodków;650;231;231;3;228;35.54;1.30
98066;160103;Publiczna Szkoła Podstawowa|Lipowa| 19 |49-200 Grodków;620;250;250;8;242;40.32;3.20
98067;160103;Remiza Strażacka|Wierzbnik| 35A |49-200 Grodków;459;171;171;10;161;37.25;5.85
98068;160103;Publiczna Szkoła Podstawowa|Kolnica| 105 |49-200 Grodków;1413;537;537;9;528;38.00;1.68
98069;160103;Publiczna Szkoła Podstawowa|Gnojna| 119 |49-200 Grodków;830;278;278;16;262;33.49;5.76
98070;160103;Szkoła Podstawowa|Gałązczyce| 78 |49-200 Grodków;814;242;242;16;226;29.73;6.61
98071;160103;Publiczny Zespół Szkół|Jędrzejów| 63 |49-200 Grodków;750;234;234;13;221;31.20;5.56
98072;160103;Świetlica Wiejska|Kobiela| 21 |49-200 Grodków;949;258;258;11;247;27.19;4.26
98073;160103;Dom Pomocy Społecznej|Grodków|ul. Mickiewicza 13 |49-200 Grodków;49;24;24;2;22;48.98;8.33
98074;160103;Zakład Opiekuńczo - Leczniczy|Grodków|ul. Szpitalna 13 |49-200 Grodków;43;5;5;0;5;11.63;0.00
98075;160103;Oddział Zewnętrzny w Grodkowie Zakładu Karnego w Brzegu|Grodków|ul. Sienkiewicza 23 |49-200 Grodków;92;40;40;4;36;43.48;10.00
98076;160104;Świetlica Terapeutyczna|Lewin Brzeski|ul. Moniuszki 41 A |49-340 Lewin Brzeski;2164;1027;1027;45;982;47.46;4.38
98077;160104;Sala Ślubów USC|Lewin Brzeski|ul. Rynek 26 |49-340 Lewin Brzeski;1368;705;705;22;683;51.54;3.12
98078;160104;Sala gimnastyczna Publicznej Szkoły Podstawowej|Lewin Brzeski|ul. Mickiewicza 6 |49-340 Lewin Brzeski;1356;606;606;21;585;44.69;3.47
98079;160104;Świetlica Ochotniczej Straży Pożarnej|Łosiów|ul. Główna 30 |49-330 Łosiów;2045;928;928;32;896;45.38;3.45
98080;160104;Gimnazjum|Skorogoszcz|ul. Ks. Jerzego Popiełuszki 8 |49-345 Skorogoszcz;2111;826;826;34;792;39.13;4.12
98081;160104;Świetlica Wiejska|Przecza| 50 |49-345 Skorogoszcz;715;287;287;13;274;40.14;4.53
98082;160104;Gimnazjum|Lewin Brzeski|ul. Zamkowa 3 |49-340 Lewin Brzeski;717;276;276;8;268;38.49;2.90
98083;160105;Dom Ludowy|Lubsza|ul. Kukurydziana 1A |49-313 Lubsza;1190;501;501;25;476;42.10;4.99
98084;160105;Publiczna Szkoła Podstawowa|Czepielowice| 31 |49-314 Pisarzowice;968;416;416;10;406;42.98;2.40
98085;160105;Publiczne Gimnazjum|Kościerzyce| 31 |49-314 Pisarzowice;847;352;352;9;343;41.56;2.56
98086;160105;Dom Ludowy|Pisarzowice|ul. Brzeska 21 |49-314 Pisarzowice;662;311;311;6;305;46.98;1.93
98087;160105;Dom Ludowy|Michałowice| 1a |49-314 Pisarzowice;606;322;322;4;318;53.14;1.24
98088;160105;Publiczna Szkoła Podstawowa|Mąkoszyce|ul. Pocztowa 4 |49-315 Mąkoszyce;758;320;320;9;311;42.22;2.81
98089;160105;Świetlica Wiejska|Szydłowice| 92 |49-312 Szydłowice;492;243;243;11;232;49.39;4.53
98090;160105;Świetlica Wiejska|Błota| 85 |49-312 Szydłowice;321;129;129;9;120;40.19;6.98
98091;160105;Publiczna Szkoła Podstawowa|Dobrzyń| 35 |49-312 Szydłowice;458;219;219;9;210;47.82;4.11
98092;160105;Świetlica Wiejska|Rogalice| 48a |49-315 Mąkoszyce;481;194;194;6;188;40.33;3.09
98093;160105;Świetlica Wiejska|Tarnowiec| 37 |49-315 Mąkoszyce;448;173;173;4;169;38.62;2.31
98094;160106;Świetlica Wiejska w Pogorzeli|Pogorzela| 35a |49-332 Olszanka;692;368;368;11;357;53.18;2.99
98095;160106;Świetlica Wiejska w Michałowie|Michałów| 112 |49-332 Olszanka;729;326;326;14;312;44.72;4.29
98096;160106;Świetlica Wiejska w Przylesiu|Przylesie| 122 |49-351 Olszanka;844;407;407;16;391;48.22;3.93
98097;160106;Budynek byłej Szkoły Podstawowej|Krzyżowice| 73 |49-332 Olszanka;470;216;216;11;205;45.96;5.09
98098;160106;Remiza OSP Olszanka|Olszanka| 36a |49-332 Olszanka;643;342;342;10;332;53.19;2.92
98099;160106;Szkoła Podstawowa w Jankowicach Wielkich|Jankowice Wielkie| 15 |49-332 Olszanka;611;262;262;12;250;42.88;4.58
98100;160201;Gminny Ośrodek Kultury w Baborowie|Baborów|ul. Rynek 17 |48-120 Baborów;1068;474;474;18;456;44.38;3.80
98101;160201;Urząd Miejski|Baborów|ul. Dąbrowszczaków 2a |48-120 Baborów;1104;397;397;13;384;35.96;3.27
98102;160201;Zespół Szkolno-Przedszkolny|Baborów|ul. Wiejska 5a |48-120 Baborów;1085;378;378;11;367;34.84;2.91
98103;160201;Strażacki Dom Ludowy|Sucha Psina| 28 |48-133 Nowa Cerekwia;952;303;303;12;291;31.83;3.96
98104;160201;Centrum Kształcenia|Raków| 75 |48-120 Baborów;918;265;265;11;254;28.87;4.15
98105;160202;Zespół Gimnazjalno-Szkolny, Szkoła Podstawowa|Branice|ul. Szkolna 8 |48-140 Branice;1176;420;420;17;403;35.71;4.05
98106;160202;Świetlica Wiejska w Wysokiej|Wysoka| 18 |48-140 Branice;644;225;225;19;206;34.94;8.44
98107;160202;Szkoła Podstawowa we Włodzieninie|Włodzienin| 50 |48-140 Branice;811;251;251;16;235;30.95;6.37
98108;160202;Szkoła Podstawowa w Uciechowicach|Uciechowice| 46 |48-140 Branice;712;271;271;13;258;38.06;4.80
98109;160202;Świetlica Wiejska w Bliszczycach|Bliszczyce| 112 |48-140 Branice;393;162;162;11;151;41.22;6.79
98110;160202;Świetlica Wiejska w Lewicach|Lewice| 25B |48-140 Branice;487;189;189;7;182;38.81;3.70
98111;160202;Zespół Gimnazjalno-Szkolny, Gimnazjum|Branice|ul. Słoneczna 8 |48-140 Branice;1058;417;417;9;408;39.41;2.16
98112;160202;Dom Pomocy Społecznej|Dzbańce-Osiedle| 1 |48-140 Branice;126;50;50;10;40;39.68;20.00
98113;160202;Dom Pomocy Społecznej|Boboluszki| 71 |48-140 Branice;43;25;25;10;15;58.14;40.00
98114;160202;Samodzielny Wojewódzki Szpital w Branicach|Branice|ul. Szpitalna 18 |48-140 Branice;356;101;101;8;93;28.37;7.92
98115;160202;Dom Pomocy Społecznej|Bliszczyce| 76 |48-140 Branice;52;20;20;7;13;38.46;35.00
98116;160202;Regionalny Ośrodek Psychiatrii Sądowej|Branice|ul. Szpitalna 19 |48-140 Branice;38;17;17;2;15;44.74;11.76
98117;160203;Gimnazjum Nr 1|Głubczyce|ul. Kochanowskiego 31 |48-100 Głubczyce;1849;953;953;15;938;51.54;1.57
98118;160203;Świetlica Zarządu Oświaty, Kultury i Sportu|Głubczyce|ul. Olimpijska 1 |48-100 Głubczyce;1602;820;820;10;810;51.19;1.22
98119;160203;Zespól Szkól Centrum Kształcenia Rolniczego|Głubczyce|ul. Niepodległości 2 |48-100 Głubczyce;869;361;361;11;350;41.54;3.05
98120;160203;Szkoła Podstawowa Nr 1|Głubczyce|ul. Dworcowa 2 |48-100 Głubczyce;925;423;423;8;415;45.73;1.89
98121;160203;Miejski Ośrodek Kultury|Głubczyce|ul. Kościuszki 24 |48-100 Głubczyce;874;422;422;9;413;48.28;2.13
98122;160203;Szkoła Podstawowa Nr 2|Głubczyce|ul. Kochanowskiego 2 |48-100 Głubczyce;836;316;316;11;305;37.80;3.48
98123;160203;Internat Specjalnego Ośrodka Szkolno-Wychowawczego|Głubczyce|ul. Raciborska 19 |48-100 Głubczyce;840;390;390;7;383;46.43;1.79
98124;160203;Ratusz|Głubczyce|ul. Rynek 1 |48-100 Głubczyce;1752;848;848;24;824;48.40;2.83
98125;160203;Szkoła Podstawowa Nr 1|Głubczyce|ul. Dworcowa 2 |48-100 Głubczyce;585;292;292;4;288;49.91;1.37
98126;160203;Szkoła Podstawowa|Gołuszowice| 34 |48-100 Głubczyce;501;270;270;8;262;53.89;2.96
98127;160203;Szkoła Podstawowa|Grobniki|ul. św.Jana 13 |48-100 Głubczyce;921;370;370;8;362;40.17;2.16
98128;160203;Szkoła Podstawowa|Bogdanowice|ul. Konopnickiej 15 |48-100 Głubczyce;883;433;433;4;429;49.04;0.92
98129;160203;Środowiskowy Dom Samopomocy|Nowe Gołuszowice| 18 |48-100 Głubczyce;851;290;290;11;279;34.08;3.79
98130;160203;Zespół Szkół|Pietrowice| 9 |48-100 Głubczyce;441;178;178;10;168;40.36;5.62
98131;160203;Świetlica Wiejska|Zubrzyce|ul. Długa 32 |48-100 Głubczyce;451;213;213;8;205;47.23;3.76
98132;160203;Świetlica Wiejska|Równe| 120 |48-100 Głubczyce;913;299;299;9;290;32.75;3.01
98133;160203;Świetlica Wiejska|Pomorzowice| 1 |48-100 Głubczyce;742;235;235;6;229;31.67;2.55
98134;160203;Szkoła Podstawowa|Klisino| 68 |48-100 Głubczyce;677;230;230;10;220;33.97;4.35
98135;160203;Świetlica Wiejska|Głubczyce-Sady| 1 |48-100 Głubczyce;757;244;244;13;231;32.23;5.33
98136;160203;Zespół Szkół|Lisięcice|ul. Szkolna 5 |48-100 Głubczyce;785;269;269;9;260;34.27;3.35
98137;160203;Świetlica Domu Pomocy Społecznej|Klisino| 100 |48-100 Głubczyce;72;43;43;15;28;59.72;34.88
98138;160203;Świetlica Domu Pomocy Społecznej|Radynia| 40 |48-100 Głubczyce;32;13;13;1;12;40.62;7.69
98139;160203;Szpital Powiatowy|Głubczyce|ul. Skłodowskiej 26 |48-100 Głubczyce;124;17;17;1;16;13.71;5.88
98140;160203;Świetlica Zakładu Karnego|Głubczyce|ul. Kochanowskiego 3 |48-100 Głubczyce;259;122;122;8;114;47.10;6.56
98141;160203;Placówka Opieki Całodobowej "Spokojna Przystań"|Chomiąża| 46a |48-100 Głubczyce;34;11;11;2;9;32.35;18.18
98142;160204;Miejski Dom Kultury w Kietrzu|Kietrz|ul. Wojska Polskiego 20 |48-130 Kietrz;2039;900;900;30;870;44.14;3.33
98143;160204;Urząd Stanu Cywilnego w Kietrzu|Kietrz|ul. Głubczycka 22 |48-130 Kietrz;1856;775;775;31;744;41.76;4.00
98144;160204;Publiczne Przedszkole w Kietrzu|Kietrz|ul. Długa 16 |48-130 Kietrz;1139;507;507;12;495;44.51;2.37
98145;160204;Szkoła Podstawowa w Nowej Cerekwi|Nowa Cerekwia|ul. Rogożańska 4 |48-130 Kietrz;664;297;297;7;290;44.73;2.36
98146;160204;Wiejski Dom Kultury w Nasiedlu|Nasiedle|ul. Świerczewskiego 7A |48-130 Kietrz;627;279;279;14;265;44.50;5.02
98147;160204;Szkoła Podstawowa w Dzierżysławiu|Dzierżysław|ul. Szkolna 4 |48-130 Kietrz;464;211;211;11;200;45.47;5.21
98148;160204;Świetlica Wiejska w Lubotyniu|Lubotyń| 30 |48-130 Kietrz;422;131;131;1;130;31.04;0.76
98149;160204;Szkoła Podstawowa w Pilszczu|Pilszcz|ul. Owsiana 3 |48-130 Kietrz;580;209;209;7;202;36.03;3.35
98150;160204;Świetlica Wiejska w Wojnowicach|Wojnowice|ul. Okrężna 27 |48-130 Kietrz;565;210;210;9;201;37.17;4.29
98151;160204;Szkoła Podstawowa w Ściborzycach Wielkich|Ściborzyce Wielkie| 105 |48-130 Kietrz;609;184;184;13;171;30.21;7.07
98152;160204;Dom Pomocy Społecznej w Klisinie filia Kietrz|Kietrz|Plac Biskupa Konrada 1 |38-130 Kietrz;35;13;13;1;12;37.14;7.69
98153;160301;Publiczna Szkoła Podstawowa Nr 12|Kędzierzyn-Koźle|ul. Piastowska 30 |47-200 Kędzierzyn-Koźle;2158;1094;1094;12;1082;50.70;1.10
98154;160301;Publiczna Szkoła Podstawowa Nr 12|Kędzierzyn-Koźle|ul. Piastowska 30 |47-200 Kędzierzyn-Koźle;2445;1328;1328;14;1314;54.31;1.05
98155;160301;Publiczne Gimnazjum Nr 1|Kędzierzyn-Koźle|ul. Grzegorza Piramowicza 30 |47-200 Kędzierzyn-Koźle;1423;605;605;19;586;42.52;3.14
98156;160301;Zespół Szkół Nr 1 im. Powstańców Śląskich|Kędzierzyn-Koźle|ul. Skarbowa 2 |47-200 Kędzierzyn-Koźle;1447;615;615;17;598;42.50;2.76
98157;160301;Zespół Szkół Miejskich Nr 2 (Publiczna Szkoła Podstawowa Nr 15)|Kędzierzyn-Koźle|ul. Karola Szymanowskiego 19 |47-206 Kędzierzyn-Koźle;1697;641;641;26;615;37.77;4.06
98158;160301;Zespół Szkół Specjalnych|Kędzierzyn-Koźle|ul. Ignacego Krasickiego 10 |47-206 Kędzierzyn-Koźle;1666;828;828;14;814;49.70;1.69
98159;160301;Publiczna Szkoła Podstawowa Nr 5|Kędzierzyn-Koźle|ul. Tadeusza Kościuszki 41 |47-224 Kędzierzyn-Koźle;1924;850;850;30;820;44.18;3.53
98160;160301;Publiczne Gimnazjum Nr 3|Kędzierzyn-Koźle|ul. Piotra Skargi 11 |47-224 Kędzierzyn-Koźle;2060;941;941;29;912;45.68;3.08
98161;160301;Publiczna Szkoła Podstawowa Nr 11|Kędzierzyn-Koźle|Aleja Partyzantów 30 |47-224 Kędzierzyn-Koźle;1854;945;945;17;928;50.97;1.80
98162;160301;Publiczna Szkoła Podstawowa Nr 5|Kędzierzyn-Koźle|ul. Tadeusza Kościuszki 41 |47-224 Kędzierzyn-Koźle;1975;858;858;28;830;43.44;3.26
98163;160301;Publiczne Przedszkole Nr 23|Kędzierzyn-Koźle|ul. Wierzbowa 4 |47-224 Kędzierzyn-Koźle;1572;901;901;19;882;57.32;2.11
98164;160301;II Liceum Ogólnokształcące|Kędzierzyn-Koźle|ul. Jana Matejki 19 |47-220 Kędzierzyn-Koźle;1695;683;683;32;651;40.29;4.69
98165;160301;Publiczne Gimnazjum Nr 4|Kędzierzyn-Koźle|ul. 1 Maja 3 |47-220 Kędzierzyn-Koźle;2284;1108;1108;28;1080;48.51;2.53
98166;160301;Dom Kultury "Chemik"|Kędzierzyn-Koźle|Aleja Jana Pawła II 27 |47-220 Kędzierzyn-Koźle;2083;1095;1095;14;1081;52.57;1.28
98167;160301;Publiczna Szkoła Podstawowa Nr 6|Kędzierzyn-Koźle|ul. Pawła Stalmacha 20 |47-220 Kędzierzyn-Koźle;2010;929;929;35;894;46.22;3.77
98168;160301;Publiczne Przedszkole Nr 22|Kędzierzyn-Koźle|ul. 9 Maja 4 |47-220 Kędzierzyn-Koźle;2343;1192;1192;28;1164;50.87;2.35
98169;160301;Publiczne Przedszkole Nr 24|Kędzierzyn-Koźle|ul. Leszka Białego 7 |47-232 Kędzierzyn-Koźle;2103;1142;1142;15;1127;54.30;1.31
98170;160301;Budynek Wojewódzkiego Zakładu Doskonalenia Zawodowego|Kędzierzyn-Koźle|ul. Kazimierza Wielkiego 17 |47-232 Kędzierzyn-Koźle;406;226;226;3;223;55.67;1.33
98171;160301;Zespół Szkół Miejskich Nr 1 (Publiczna Szkoła Podstawowa Nr 19)|Kędzierzyn-Koźle|ul. Mieszka I 4 |47-232 Kędzierzyn-Koźle;1749;915;915;18;897;52.32;1.97
98172;160301;Zespół Szkół Miejskich Nr 1 (Publiczne Gimnazjum nr 5)|Kędzierzyn-Koźle|ul. Mieszka I 4 |47-232 Kędzierzyn-Koźle;784;383;383;7;376;48.85;1.83
98173;160301;Budynek Administracji Osiedla Nr 5 - klub "Kajtek"|Kędzierzyn-Koźle|ul. Królowej Jadwigi 10 |47-232 Kędzierzyn-Koźle;2106;1213;1213;24;1189;57.60;1.98
98174;160301;Dom Kultury "Lech"|Kędzierzyn-Koźle|ul. Wyzwolenia 7b |47-225 Kędzierzyn-Koźle;2137;849;849;30;819;39.73;3.53
98175;160301;Zespół Szkół Miejskich Nr 3 (Publiczna Szkoła Podstawowa Nr 10)|Kędzierzyn-Koźle|ul. Szkolna 3 |47-225 Kędzierzyn-Koźle;419;147;147;7;140;35.08;4.76
98176;160301;Budynek byłego ŚHP|Kędzierzyn-Koźle|ul. Nowowiejska 8 |47-225 Kędzierzyn-Koźle;335;145;145;8;137;43.28;5.52
98177;160301;Zespół Szkół Miejskich Nr 4 (Publiczna Szkoła Podstawowa Nr 16)|Kędzierzyn-Koźle|ul. Sławięcicka 96 |47-230 Kędzierzyn-Koźle;2141;832;832;30;802;38.86;3.61
98178;160301;Strażnica Ochotniczej Straży Pożarnej Miejsce Kłodnickie|Kędzierzyn-Koźle|ul. Szpaków 11 |47-230 Kędzierzyn-Koźle;297;101;101;6;95;34.01;5.94
98179;160301;Osiedlowy Dom Kultury "Kubiczek"|Kędzierzyn-Koźle|ul. Główna 54 |47-200 Kędzierzyn-Koźle;1000;357;357;4;353;35.70;1.12
98180;160301;Dom Kultury "Koźle"|Kędzierzyn-Koźle|ul. Skarbowa 10 |47-200 Kędzierzyn-Koźle;604;273;273;8;265;45.20;2.93
98181;160301;Zespół Szkół Miejskich Nr 5 (Publiczna Szkoła Podstawowa Nr 3)|Kędzierzyn-Koźle|ul. Przodowników Pracy 14 |47-223 Kędzierzyn-Koźle;1498;658;658;20;638;43.93;3.04
98182;160301;Zespół Szkolno - Przedszkolny Nr 1 (Publiczna Szkoła Podstawowa Nr 18)|Kędzierzyn-Koźle|ul. Jana Brzechwy 80 |47-230 Kędzierzyn-Koźle;1497;464;464;11;453;31.00;2.37
98183;160301;Siedziba Rady Osiedla "Kuźniczka"|Kędzierzyn-Koźle|ul. Grunwaldzka 83 |47-220 Kędzierzyn-Koźle;915;521;521;7;514;56.94;1.34
98184;160301;Szpital Zespolony|Kędzierzyn-Koźle|ul. Doktora Judyma 4 |47-220 Kędzierzyn-Koźle;33;12;12;2;10;36.36;16.67
98185;160301;Szpital Zespolony|Kędzierzyn-Koźle|ul. Franklina Delano Roosevelta 2 |47-200 Kędzierzyn-Koźle;111;28;28;0;28;25.23;0.00
98186;160301;Dom Pomocy Społecznej|Kędzierzyn-Koźle|ul. Dąbrowszczaków 1 |47-230 Kędzierzyn-Koźle;48;44;44;0;44;91.67;0.00
98187;160301;Areszt Śledczy|Kędzierzyn-Koźle|ul. Racławicka 10 |47-200 Kędzierzyn-Koźle;104;62;62;8;54;59.62;12.90
98188;160302;Szkoła Podstawowa|Stare Koźle|ul. Szkolna 5 |47-223 Kędzierzyn-Koźle;1171;454;454;16;438;38.77;3.52
98189;160302;Publiczne Gimnazjum|Bierawa|ul. Kościelna 1 |47-240 Bierawa;1290;537;537;24;513;41.63;4.47
98190;160302;Świetlica wiejska|Lubieszów|ul. Bierawska 37 |47-244 Dziergowice;438;158;158;14;144;36.07;8.86
98191;160302;Szkoła Podstawowa|Dziergowice|ul. Kozielska 8 |47-244 Kotlarnia;1367;484;484;37;447;35.41;7.64
98192;160302;Dwujęzyczna Szkoła Podstawowa|Solarnia|ul. Raciborska 42 |47-244 Dziergowice;415;133;133;10;123;32.05;7.52
98193;160302;Wiejski Dom Kultury|Stara Kuźnia|ul. Brzozowa 33 |47-246 Stara Kuźnia;933;331;331;3;328;35.48;0.91
98194;160302;Świetlica wiejska|Kotlarnia|ul. Gliwicka 34 |47-246 Kotlarnia;631;309;309;17;292;48.97;5.50
98195;160303;Gminny Ośrodek Kultury|Cisek|ul. Planetorza 30 |47-253 Cisek;1843;672;672;37;635;36.46;5.51
98196;160303;Wiejski Dom Kultury|Nieznaszyn|ul. Wiejska 25 |47-260 Polska Cerekiew;802;273;273;6;267;34.04;2.20
98197;160303;Szkoła Podstawowa|Łany|ul. Główna 98a |47-253 Cisek;1594;533;533;28;505;33.44;5.25
98198;160303;Dom Strażaka|Roszowicki Las|ul. Kochanowskiego 63 |47-253 Cisek;414;141;141;6;135;34.06;4.26
98199;160304;Remiza OSP|Pawłowiczki|ul. Wyzwolenia 67 |47-280 Pawłowiczki;1426;518;518;30;488;36.33;5.79
98200;160304;Świetlica Wiejska|Ostrożnica|ul. Kościelna 3 |47-280 Pawłowiczki;920;259;259;5;254;28.15;1.93
98201;160304;Remiza OSP|Maciowakrze|ul. Spółdzielcza 6 |47-280 Pawłowiczki;468;154;154;7;147;32.91;4.55
98202;160304;Zespół Szkolno-Przedszkolny|Jakubowice| 2c |47-280 Pawłowiczki;1135;314;314;30;284;27.67;9.55
98203;160304;Wiejski Dom Kultury|Gościęcin|ul. Kozielska 1 |47-270 Pawłowiczki;1613;562;562;17;545;34.84;3.02
98204;160304;Publiczna Szkoła Podstawowa|Naczęsławice|ul. Główna 19 |47-270 Pawłowiczki;755;227;227;15;212;30.07;6.61
98205;160304;Dom Opieki|Jakubowice| 15A |47-280 Pawłowiczki;40;11;11;2;9;27.50;18.18
98206;160305;Urząd Gminy|Polska Cerekiew|ul. Raciborska 4 |47-260 Polska Cerekiew;1075;554;554;60;494;51.53;10.83
98207;160305;Świetlica Wiejska|Grzędzin|ul. Kościelna 32 |47-260 Polska Cerekiew;527;248;248;25;223;47.06;10.08
98208;160305;Caritas|Zakrzów|ul. Chopina 54 |47-260 Polska Cerekiew;796;368;368;34;334;46.23;9.24
98209;160305;Centrum Kultury|Polska Cerekiew|ul. Kozielska 3 |47-260 Polska Cerekiew;640;287;287;24;263;44.84;8.36
98210;160305;Szkoła Podstawowa|Wronin|ul. Kościelna 1 |47-260 Polska Cerekiew;495;211;211;21;190;42.63;9.95
98211;160306;Szkoła Podstawowa|Mechnica|ul. Kwiatowa 4 |47-214 Poborszów;1198;336;336;14;322;28.05;4.17
98212;160306;Świetlica Wiejska|Większyce|ul. Kozielska 5 |47-208 Reńska Wieś;1369;512;512;15;497;37.40;2.93
98213;160306;Urząd Gminy|Reńska Wieś|ul. Pawłowicka 1 |47-208 Reńska Wieś;1292;532;532;16;516;41.18;3.01
98214;160306;Szkoła Podstawowa|Długomiłowice|ul. Parkowa 8 |47-208 Reńska Wieś;1622;446;446;17;429;27.50;3.81
98215;160306;Świetlica OSP|Pokrzywnica|ul. 1Maja 12a |47-208 Reńska Wieś;667;236;236;4;232;35.38;1.69
98216;160306;Szkoła Podstawowa|Łężce|ul. Kościelna 7 |47-208 Reńska Wieś;570;171;171;9;162;30.00;5.26
98217;160401;Ośrodek Kultury|Byczyna|ul. Borkowska 1 |46-220 Byczyna;1215;511;511;15;496;42.06;2.94
98218;160401;Ratusz|Byczyna|ul. Rynek 1 |46-220 Byczyna;664;278;278;19;259;41.87;6.83
98219;160401;Publiczna Szkoła Podstawowa|Byczyna|ul. Poznańska 6 |46-220 Byczyna;1568;721;721;13;708;45.98;1.80
98220;160401;Świetlica Wiejska|Dobiercice|ul. Sienkiewicza 3A |46-220 Byczyna;480;193;193;9;184;40.21;4.66
98221;160401;Przedszkole Publiczne w Byczynie - Oddział w Nasalach|Nasale| 47 |46-220 Byczyna;522;135;135;3;132;25.86;2.22
98222;160401;Publiczna Szkoła Podstawowa|Roszkowice| 88 |46-220 Byczyna;550;168;168;4;164;30.55;2.38
98223;160401;Publiczna Szkoła Podstawowa|Kostów| 10 |46-220 Byczyna;717;274;274;17;257;38.21;6.20
98224;160401;Świetlica Wiejska|Polanowice| 33 |46-220 Byczyna;935;366;366;7;359;39.14;1.91
98225;160401;Publiczna Szkoła Podstawowa|Biskupice| 22 |46-220 Byczyna;865;301;301;9;292;34.80;2.99
98226;160402;Zespół Szkół Ogólnokształcących|Kluczbork|ul. Mickiewicza 10 |46-200 Kluczbork;930;366;366;14;352;39.35;3.83
98227;160402;Ratusz|Kluczbork|Rynek 1 |46-200 Kluczbork;1464;525;525;13;512;35.86;2.48
98228;160402;Zespół Szkół Licealno-Technicznych|Kluczbork|ul. Sienkiewicza 20 |46-200 Kluczbork;1851;949;949;22;927;51.27;2.32
98229;160402;Kluczborski Dom Kultury|Kluczbork|ul. Mickiewicza 5 |46-200 Kluczbork;1013;425;425;11;414;41.95;2.59
98230;160402;Zespół Szkół Ponadgimnazjalnych Nr 2 CKU|Kluczbork|ul. Byczyńska 7 |46-200 Kluczbork;1681;821;821;17;804;48.84;2.07
98231;160402;Publiczne Przedszkole Nr 8|Kluczbork|ul. Ossowskiego 3 |46-203 Kluczbork;1400;723;723;13;710;51.64;1.80
98232;160402;Budynek Szkolny|Kluczbork|ul. Ligonia 12 |46-203 Kluczbork;1788;949;949;11;938;53.08;1.16
98233;160402;Publiczna Szkoła Podstawowa Nr 2|Kluczbork|ul. Wolności 17 |46-203 Kluczbork;1786;912;912;21;891;51.06;2.30
98234;160402;Publiczna Szkoła Podstawowa Nr 2|Kluczbork|ul. Wolności 19 |46-203 Kluczbork;2279;1217;1217;24;1193;53.40;1.97
98235;160402;Publiczne Gimnazjum Nr 3|Kluczbork|ul. Wolności 18 |46-200 Kluczbork;1732;827;827;19;808;47.75;2.30
98236;160402;Zespół Szkół Ponadgimnazjalnych Nr 1|Kluczbork|ul. Skłodowskiej-Curie 13 |46-200 Kluczbork;2147;984;984;18;966;45.83;1.83
98237;160402;Publiczne Przedszkole Nr 5|Kluczbork|ul. Dąbrowskiego 10 |46-200 Kluczbork;1355;677;677;11;666;49.96;1.62
98238;160402;Świetlica Wiejska|Bąków|ul. Braci Bassy 16 |46-233 Bąków;769;276;276;7;269;35.89;2.54
98239;160402;Publiczna Szkoła Podstawowa z Oddziałem Przedszkolnym|Biadacz| 103 |46-233 Bąków;516;184;184;6;178;35.66;3.26
98240;160402;Publiczne Przedszkole Nr 8|Ligota Górna|ul. Gorzowska 4 |46-200 Kluczbork;747;362;362;9;353;48.46;2.49
98241;160402;Publiczna Szkoła Podstawowa z Oddziałem Przedszkolnym|Łowkowice|ul. Rigola 33 |46-211 Kujakowice Górne;906;301;301;11;290;33.22;3.65
98242;160402;Publiczne Gimnazjum Nr 4|Kujakowice Górne|ul. XXX-lecia 37 |46-211 Kujakowice Górne;915;334;334;4;330;36.50;1.20
98243;160402;Publiczna Szkoła Podstawowa z Oddziałami Przedszkolnymi|Kuniów| 74 |46-200 Kluczbork;836;299;299;13;286;35.77;4.35
98244;160402;Publiczna Szkoła Podstawowa|Bogacica|ul. Szkolna 10 |46-243 Bogacica;1689;540;540;24;516;31.97;4.44
98245;160402;Świetlica Wiejska|Borkowice|ul. Wiejska 48 |46-243 Bogacica;710;215;215;14;201;30.28;6.51
98246;160402;Publiczne Przedszkole|Bażany|ul. Wiejska 19 |46-243 Bogacica;583;169;169;3;166;28.99;1.78
98247;160402;Publiczne Przedszkole Nr 5 z Oddziałami Zamiejscowymi|Krasków| 59 |46-200 Kluczbork;484;191;191;9;182;39.46;4.71
98248;160402;Świetlica Wiejska|Ligota Dolna|ul. Wołczyńska 73 |46-200 Kluczbork;524;247;247;7;240;47.14;2.83
98249;160402;Publiczne Przedszkole Nr 8|Smardy Górne|ul. Kościelna 10 |46-200 Kluczbork;839;328;328;12;316;39.09;3.66
98250;160402;Świetlica Wiejska|Gotartów| 19c |46-211 Kujakowice Górne;406;145;145;4;141;35.71;2.76
98251;160402;Dom Pomocy Społecznej|Kluczbork|ul. Wołczyńska 25 |46-200 Kluczbork;129;40;40;2;38;31.01;5.00
98252;160402;Powiatowe Centrum Zdrowia S.A. NZOZ Szpital Powiatowy|Kluczbork|ul. Skłodowskiej - Curie 23 |46-200 Kluczbork;58;27;27;2;25;46.55;7.41
98253;160402;Zakład Karny|Kluczbork|ul. Katowicka 4 |46-200 Kluczbork;396;167;167;21;146;42.17;12.57
98254;160403;Zespół Gimnazjalno-Szkolno-Przedszkolny|Chocianowice| 78 |46-280 Lasowice Wielkie;929;292;292;14;278;31.43;4.79
98255;160403;Sala OSP|Ciarka| 28C |46-280 Lasowice Wielkie;355;123;123;5;118;34.65;4.07
98256;160403;Zespół Szkolno-Przedszkolny|Gronowice| 58 |46-280 Lasowice Wielkie;390;120;120;4;116;30.77;3.33
98257;160403;Sala OSP|Lasowice Małe|ul. Odrodzenia 34 |46-280 Lasowice Wielkie;436;158;158;12;146;36.24;7.59
98258;160403;Zespół Szkolno-Przedszkolny|Jasienie|ul. Zwycięstwa 15 |46-280 Lasowice Wielkie;709;205;205;7;198;28.91;3.41
98259;160403;Sala Wiejska|Tuły| 39a |46-282 Lasowice Wielkie;261;72;72;2;70;27.59;2.78
98260;160403;Przedszkole Samorządowe|Laskowice|ul. Szkolna 20 |46-282 Lasowice Wielkie;777;138;138;6;132;17.76;4.35
98261;160403;Świetlica Wiejska|Lasowice Wielkie| 81 |46-282 Lasowice Wielkie;795;307;307;3;304;38.62;0.98
98262;160403;Zespół Szkolno-Przedszkolny|Chudoba| 142 |46-275 Lasowice Wielkie;792;255;255;5;250;32.20;1.96
98263;160403;Sala Wiejska|Wędrynia| 66 |46-275 Lasowice Wielkie;370;125;125;6;119;33.78;4.80
98264;160404;Wołczyński Ośrodek Kultury|Wołczyn|ul. Opolska 2 |46-250 Wołczyn;1410;639;639;21;618;45.32;3.29
98265;160404;Wołczyński Ośrodek Kultury|Wołczyn|ul. Opolska 2 |46-250 Wołczyn;810;396;396;11;385;48.89;2.78
98266;160404;Świetlica przy Szkole Podstawowej Nr 1|Wołczyn|ul. Rzeczna 7 |46-250 Wołczyn;1531;614;614;25;589;40.10;4.07
98267;160404;Przedsiębiorstwo Gospodarki Komunalnej i Mieszkaniowej Sp. zo.o.|Wołczyn|ul. Rzeczna 3 |46-250 Wołczyn;1276;590;590;4;586;46.24;0.68
98268;160404;Szkoła Podstawowa|Wierzbica Górna| 39 a |46-255 Wołczyn;1022;358;358;16;342;35.03;4.47
98269;160404;Szkoła Podstawowa|Komorzno|ul. Główna 31 |46-264 Wołczyn;698;235;235;10;225;33.67;4.26
98270;160404;Świetlica Wiejska|Krzywiczyny|ul. Wołczyńska 41 |46-264 Wołczyn;487;196;196;4;192;40.25;2.04
98271;160404;Szkoła Podstawowa|Szymonków|ul. Wołczyńska 3 |46-250 Wołczyn;460;202;202;5;197;43.91;2.48
98272;160404;Świetlica Wiejska|Wierzbica Dolna| 26 |46-255 Wołczyn;519;189;189;7;182;36.42;3.70
98273;160404;Remiza Ochotniczej Straży Pożarnej|Gierałcice|ul. Opolska 36 |46-250 Wołczyn;655;277;277;19;258;42.29;6.86
98274;160404;Oddział Przedszkolny Szkoły Podstawowej w Wąsicach|Wąsice|ul. Główna 14 a |46-250 Wołczyn;404;142;142;6;136;35.15;4.23
98275;160404;Świetlica Wiejska|Wierzchy| 76 |46-250 Wołczyn;640;145;145;9;136;22.66;6.21
98276;160404;Świetlica Wiejska|Brzezinki| 25 |46-250 Wołczyn;300;99;99;5;94;33.00;5.05
98277;160404;Szkoła Podstawowa|Skałągi|ul. Wołczyńska 23 |46-262 Wołczyn;407;174;174;5;169;42.75;2.87
98278;160404;Budynek byłej Szkoły Podstawowej|Rożnów| 1 |46-262 Wołczyn;349;138;138;12;126;39.54;8.70
98279;160501;Zespół Szkół|Gogolin|ul. Szkolna 27 |47-320 Gogolin;1819;689;689;19;670;37.88;2.76
98280;160501;Publiczna Szkoła Podstawowa Nr 2|Gogolin|ul. Strzelecka 39 |47-320 Gogolin;1769;544;544;24;520;30.75;4.41
98281;160501;Publiczna Szkoła Podstawowa Nr 3|Gogolin|ul. Krapkowicka 141 |47-320 Gogolin;1246;533;533;7;526;42.78;1.31
98282;160501;Przedszkole|Górażdże|ul. Dworcowa 3 |47-316 Górażdże;698;239;239;17;222;34.24;7.11
98283;160501;Publiczna Szkoła Podstawowa - świetlica|Malnia|ul. Podgórna 3 |47-316 Górażdże;570;187;187;2;185;32.81;1.07
98284;160501;Filia Publicznej Szkoły Podstawowej Nr 3 w Gogolinie|Zakrzów|ul. Mickiewicza 3 |47-330 Zdzieszowice;511;130;130;8;122;25.44;6.15
98285;160501;Publiczna Szkoła Podstawowa|Kamień Śląski|ul. Klasztorna 2 |47-325 Gogolin;1153;387;387;22;365;33.56;5.68
98286;160501;DSS Święta Barbara|Kamionek|ul. Polna 24 |47-325 Gogolin;567;173;173;14;159;30.51;8.09
98287;160501;Remiza Strażacka|Obrowiec|ul. Łąkowa 1 |47-320 Gogolin;428;125;125;2;123;29.21;1.60
98288;160501;Centrum Aktywacji Wiejskiej|Odrowąż|ul. Wiejska 58A |47-316 Górażdże;484;163;163;4;159;33.68;2.45
98289;160501;Świetlica|Gogolin|ul. Plebiscytowa 1 |47-320 Gogolin;405;98;98;7;91;24.20;7.14
98290;160501;Centrum Aktywacji Wiejskiej|Chorula|ul. Opolska 66 |47-316 Górażdże;484;147;147;14;133;30.37;9.52
98291;160502;Zespół Szkół Zawodowych|Krapkowice|ul. Zamkowa 5 |47-300 Krapkowice;802;300;300;5;295;37.41;1.67
98292;160502;Publiczna Szkoła Podstawowa Nr 1|Krapkowice|ul. Szkolna 3 |47-300 Krapkowice;948;459;459;12;447;48.42;2.61
98293;160502;Publiczne Gimnazjum Nr 2|Krapkowice|ul. Kwiatowa 7 |47-300 Krapkowice;904;409;409;12;397;45.24;2.93
98294;160502;Zespół Szkół Zawodowych|Krapkowice|ul. Zamkowa 5 |47-300 Krapkowice;970;248;248;7;241;25.57;2.82
98295;160502;Zespół Szkół im. Jana Kilińskiego|Krapkowice|ul. Księdza Duszy 7 |47-303 Krapkowice;868;396;396;8;388;45.62;2.02
98296;160502;Przedszkole Publiczne Nr 6|Krapkowice|ul. Buczka 11 |47-303 Krapkowice;930;365;365;10;355;39.25;2.74
98297;160502;Środowiskowy Dom Samopomocy|Krapkowice|Osiedle XXX lecia 23 |47-303 Krapkowice;603;293;293;5;288;48.59;1.71
98298;160502;Zespół Szkół Sportowych Nr 1|Krapkowice|Osiedle XXX lecia 24 |47-303 Krapkowice;1025;488;488;8;480;47.61;1.64
98299;160502;Urząd Miasta i Gminy w Krapkowicach|Krapkowice|ul. 3 Maja 17 |47-303 Krapkowice;906;379;379;8;371;41.83;2.11
98300;160502;Zespół Szkolno-Przedszkolny Nr 4 w Krapkowicach|Krapkowice|ul. Żeromskiego 34 |47-303 Krapkowice;925;446;446;9;437;48.22;2.02
98301;160502;Zespół Szkolno-Przedszkolny Nr 4 w Krapkowicach|Krapkowice|ul. Żeromskiego 34 |47-303 Krapkowice;882;434;434;8;426;49.21;1.84
98302;160502;Zespół Szkół Sportowych Nr 1|Krapkowice|ul. Osiedle XXX lecia 24 |47-303 Krapkowice;1077;506;506;11;495;46.98;2.17
98303;160502;Miejska i Gminna Biblioteka Publiczna w Krapkowicach, Filia Nr 2|Krapkowice|ul. Mickiewicza 1 |47-303 Krapkowice;952;402;402;10;392;42.23;2.49
98304;160502;Publiczna Szkoła Podstawowa Nr 1|Krapkowice|ul. Szkolna 3 |47-300 Krapkowice;863;359;359;7;352;41.60;1.95
98305;160502;Publiczne Gimnazjum Nr 2|Krapkowice|ul. Kwiatowa 7 |47-300 Krapkowice;923;417;417;15;402;45.18;3.60
98306;160502;Publiczna Szkoła Podstawowa|Dąbrówka Górna|ul. Opolska 64 |47-300 Krapkowice;734;278;278;6;272;37.87;2.16
98307;160502;Publiczna Szkoła Podstawowa|Rogów Opolski|ul. Chrobrego 15 |47-300 Krapkowice;884;299;299;19;280;33.82;6.35
98308;160502;Publiczna Szkoła Podstawowa|Żywocice|ul. Średnia 48 |47-300 Krapkowice;986;400;400;10;390;40.57;2.50
98309;160502;Świetlica OSP|Pietna|ul. Łąkowa 1 |47-300 Krapkowice;392;147;147;3;144;37.50;2.04
98310;160502;Szkoła Podstawowa Stowarzyszenia na Rzecz Rozwoju Wsi Żużela|Żużela|ul. Szkolna 3 |47-341 Żużela;467;192;192;4;188;41.11;2.08
98311;160502;Zespół Szkolno-Przedszkolny w Kórnicy|Kórnica|ul. Główna 2 |47-300 Krapkowice;648;197;197;8;189;30.40;4.06
98312;160502;Świetlica OSP|Ściborowice|ul. Szkolna 3 |47-300 Krapkowice;318;60;60;4;56;18.87;6.67
98313;160502;Stowarzyszeniowa Publiczna Szkoła Podstawowa w Steblowie|Steblów|ul. Szkolna 2 |47-300 Krapkowice;818;278;278;6;272;33.99;2.16
98314;160502;Krapkowickie Centrum Zdrowia Spółka z o.o|Krapkowice|Osiedle XXX-lecia 21 |47-303 Krapkowice;25;6;6;0;6;24.00;0.00
98315;160503;Gminny Ośrodek Kultury|Strzeleczki|Rynek 4 |47-364 Strzeleczki;1309;464;464;24;440;35.45;5.17
98316;160503;Szkoła Podstawowa|Racławiczki|ul. Szkolna 6 |47-370 Zielina;1525;507;507;13;494;33.25;2.56
98317;160503;Szkoła Podstawowa|Zielina|ul. Prudnicka 8 |47-370 Zielina;1372;420;420;16;404;30.61;3.81
98318;160503;Szkoła Podstawowa|Komorniki|ul. Szkolna 4 |47-364 Strzeleczki;1246;316;316;15;301;25.36;4.75
98319;160503;Szkoła Podstawowa|Dobra|ul. Szkolna 37 |47-364 Strzeleczki;646;238;238;9;229;36.84;3.78
98320;160503;Centrum Terapii Nerwic|Moszna|ul. Zamkowa 1A |47-370 Strzeleczki;101;71;71;1;70;70.30;1.41
98321;160504;Publiczna Szkoła Podstawowa|Walce|ul. Lipowa 2 |47-344 Walce;1097;323;323;7;316;29.44;2.17
98322;160504;Publiczna Szkoła Podstawowa|Brożec|ul. Reymonta 65 |47-341 Żużela;1053;372;372;8;364;35.33;2.15
98323;160504;Budynek Wielofunkcyjny|Rozkochów|ul. Wiejska 19 a |47-344 Walce;458;111;111;8;103;24.24;7.21
98324;160504;Remiza OSP|Stradunia|ul. Opolska 31 |47-341 Żużela;717;236;236;9;227;32.91;3.81
98325;160504;Budynek Gminny - świetlica wiejska|Dobieszowice|ul. Główna 22 |47-344 Walce;399;95;95;3;92;23.81;3.16
98326;160504;Gminny Ośrodek Kultury|Walce|ul. Opolska 23a |47-344 Walce;931;296;296;5;291;31.79;1.69
98327;160505;Publiczna Szkoła Podstawowa Nr 1 - sala gimnastyczna|Zdzieszowice|ul. Bolesława Chrobrego 36 |47-330 Zdzieszowice;1266;472;472;26;446;37.28;5.51
98328;160505;Publiczna Szkoła Podstawowa Nr 2|Zdzieszowice|ul. Plac 1 Maja 1 |47-330 Zdzieszowice;1684;705;705;21;684;41.86;2.98
98329;160505;Publiczne Gimnazjum|Zdzieszowice|ul. Nowa 3 |47-330 Zdzieszowice;1869;644;644;39;605;34.46;6.06
98330;160505;Zespół Szkół im. Jana Pawła II|Zdzieszowice|ul. Góry św. Anny 21a |47-330 Zdzieszowice;1614;753;753;41;712;46.65;5.44
98331;160505;Ośrodek Profilaktyki i Wspierania Rodziny|Zdzieszowice|ul. Bolesława Chrobrego 18 |47-330 Zdzieszowice;1221;499;499;34;465;40.87;6.81
98332;160505;Publiczne Przedszkole Nr 6 im. Jana Brzechwy|Zdzieszowice|ul. Piastów 6 |47-330 Zdzieszowice;1461;541;541;23;518;37.03;4.25
98333;160505;Publiczna Szkoła Podstawowa|Januszkowice|ul. Lesiańska 6 |47-330 Zdzieszowice;861;315;315;12;303;36.59;3.81
98334;160505;Remiza Ochotniczej Straży Pożarnej|Rozwadza|ul. Szkolna 36 |47-330 Zdzieszowice;791;274;274;18;256;34.64;6.57
98335;160505;Publiczna Szkoła Podstawowa|Żyrowa|ul. Wojska Polskiego 4 |47-330 Zdzieszowice;1114;390;390;32;358;35.01;8.21
98336;160505;Publiczna Szkoła Podstawowa|Krępna|ul. Zdzieszowicka 35 |47-330 Zdzieszowice;604;153;153;12;141;25.33;7.84
98337;160601;Zespół Gimnazjalno-Szkolny w Domaszowicach|Domaszowice|ul. Kolejowa 3 3|46-146 Domaszowice;833;410;410;21;389;49.22;5.12
98338;160601;Świetlica Parafialna we Włochach|Włochy| 62 |46-146 Domaszowice;312;148;148;9;139;47.44;6.08
98339;160601;Świetlica Wiejska w Strzelcach|Strzelce| 52 4|46-146 Domaszowice;604;267;267;16;251;44.21;5.99
98340;160601;Szkoła Podstawowa w Polkowskiem|Polkowskie| 52 |46-146 Domaszowice;410;190;190;19;171;46.34;10.00
98341;160601;Świetlica Wiejska w Gręboszowie|Gręboszów| 29 5|46-146 Domaszowice;266;136;136;7;129;51.13;5.15
98342;160601;Świetlica Wiejska w Siemysłowie|Siemysłów| 11a |46-146 Domaszowice;319;161;161;15;146;50.47;9.32
98343;160601;Strażnica OSP w Wielołęce|Wielołęka| 23a |46-146 Domaszowice;216;93;93;3;90;43.06;3.23
98344;160602;Biblioteka Publiczna|Namysłów|ul. Bohaterów Warszawy 5 |46-100 Namysłów;831;348;348;2;346;41.88;0.57
98345;160602;Namysłowski Ośrodek Kultury|Namysłów|Plac Powstańców Śląskich 2 |46-100 Namysłów;932;453;453;11;442;48.61;2.43
98346;160602;Świetlica Osiedlowa (dworzec)|Namysłów|ul. Dworcowa 7 |46-100 Namysłów;1004;369;369;7;362;36.75;1.90
98347;160602;Przedszkole Integracyjne|Namysłów|ul. Parkowa 3 |46-100 Namysłów;1420;778;778;8;770;54.79;1.03
98348;160602;Przedszkole Nr 1|Namysłów|ul. Partyzantów 2 |46-100 Namysłów;792;429;429;4;425;54.17;0.93
98349;160602;Szkoła Podstawowa Nr 3|Namysłów|ul. Łączańska 1 |46-100 Namysłów;900;476;476;8;468;52.89;1.68
98350;160602;Liceum Ogólnokształcące|Namysłów|ul. A. Mickiewicza 12 |46-100 Namysłów;1037;517;517;11;506;49.86;2.13
98351;160602;Przedszkole Nr 3|Namysłów|ul. Partyzantów 3 |46-100 Namysłów;804;331;331;8;323;41.17;2.42
98352;160602;Przedszkole Nr 5|Namysłów|ul. Słoneczna 1 |46-100 Namysłów;687;427;427;5;422;62.15;1.17
98353;160602;Szkoła Podstawowa Nr 4|Namysłów|ul. W. S. Reymonta 56 |46-100 Namysłów;1024;543;543;12;531;53.03;2.21
98354;160602;Przedszkole Nr 4|Namysłów|ul. W. S. Reymonta 5b |46-100 Namysłów;1129;612;612;15;597;54.21;2.45
98355;160602;Gimnazjum Nr 2|Namysłów|ul. W. S. Reymonta 5 |46-100 Namysłów;1104;557;557;5;552;50.45;0.90
98356;160602;Hala Sportowa "ORZEŁ"|Namysłów|ul. Kolejowa 1 |46-100 Namysłów;1340;736;736;13;723;54.93;1.77
98357;160602;Szkoła Podstawowa|Kamienna| 26 |46-100 Namysłów;451;239;239;3;236;52.99;1.26
98358;160602;Świetlica Wiejska|Kowalowice|ul. Szkolna 3 |46-100 Namysłów;566;239;239;8;231;42.23;3.35
98359;160602;Zespół Szkolno-Przedszkolny|Głuszyna|ul. Główna 115 |46-100 Namysłów;748;289;289;11;278;38.64;3.81
98360;160602;Przedszkole|Bukowa Śląska| 7b |46-100 Namysłów;1021;355;355;10;345;34.77;2.82
98361;160602;Zespół Szkolno-Przedszkolny|Jastrzębie|ul. Opolska 68 |46-100 Namysłów;547;228;228;5;223;41.68;2.19
98362;160602;Zespół Szkolno-Przedszkolny|Smarchowice Wielkie|ul. Brzegowa 58 |46-100 Namysłów;684;280;280;8;272;40.94;2.86
98363;160602;Zespół Szkolno-Przedszkolny|Ligota Książęca| 87b |46-100 Namysłów;913;358;358;9;349;39.21;2.51
98364;160602;Świetlica Wiejska|Smarchowice Śląskie|ul. M. R. Żymierskiego 24 |46-100 Namysłów;912;363;363;12;351;39.80;3.31
98365;160602;Hala Sportowa|Namysłów|Plac Powstańców Śląskich 1 |46-100 Namysłów;365;139;139;3;136;38.08;2.16
98366;160602;Zespół Placówek Oświatowych|Smogorzów|ul. Główna 69 |46-100 Namysłów;473;172;172;7;165;36.36;4.07
98367;160602;Świetlica Wiejska|Minkowskie| 60b |46-100 Namysłów;482;150;150;7;143;31.12;4.67
98368;160602;Świetlica Wiejska|Ziemiełowice| 11b |46-100 Namysłów;443;174;174;7;167;39.28;4.02
98369;160602;Namysłowskie Centrum Zdrowia S.A.|Namysłów|ul. Oleśnicka 4 |46-100 Namysłów;42;5;5;0;5;11.90;0.00
98370;160602;Ośrodek Leczenia Odwykowego|Woskowice Małe| 15 |46-100 Namysłów;70;30;30;0;30;42.86;0.00
98371;160602;Dom Pomocy Społecznej „Promyk”|Kamienna| 22 |46-100 Namysłów;41;29;29;1;28;70.73;3.45
98372;160603;budynek byłej Szkoły Podstawowej|Ładza|ul. Reymonta 3 |46-034 Pokój;415;138;138;8;130;33.25;5.80
98373;160603;Ochotnicza Straż Pożarna|Pokój|ul. Wojska Polskiego 26 |46-034 Pokój;618;287;287;6;281;46.44;2.09
98374;160603;sala narad Urząd Gminy|Pokój|ul. Sienkiewicza 8 |46-034 Pokój;608;271;271;4;267;44.57;1.48
98375;160603;Szkoła Podstawowa|Domaradz| 3 |46-034 Pokój;531;144;144;15;129;27.12;10.42
98376;160603;Świetlica Wiejska|Domaradzka Kuźnia|Opolska 12 |46-034 Pokój;568;148;148;9;139;26.06;6.08
98377;160603;Świetlica Wiejska|Zawiść|ul. Odrodzenia Polski 2 |46-034 Pokój;403;126;126;5;121;31.27;3.97
98378;160603;Świetlica Wiejska|Zieleniec| 26A |46-034 Pokój;764;280;280;9;271;36.65;3.21
98379;160603;Świetlica Wiejska|Fałkowice| 61 |46-034 Pokój;433;120;120;9;111;27.71;7.50
98380;160603;Szpital w Pokoju|Pokój|ul. Namysłowska 22 |46-034 Pokój;70;59;59;6;53;84.29;10.17
98381;160604;Szkoła Podstawowa|Bąkowice|ul. Szkolna 6 |46-112 Świerczów;686;297;297;8;289;43.29;2.69
98382;160604;Publiczne Gimnazjum|Świerczów|ul. Brzeska 28 |46-112 Świerczów;637;310;310;10;300;48.67;3.23
98383;160604;Szkoła Podstawowa|Dąbrowa|ul. Parkowa 4 |46-112 Świerczów;535;220;220;7;213;41.12;3.18
98384;160604;Sołecki Dom Spotkań|Starościn|ul. Opolska 6a |46-112 Świerczów;416;162;162;5;157;38.94;3.09
98385;160604;Wiejskie Centrum Kultury i Rekreacji|Biestrzykowice|ul. Główna 7 |46-112 Świerczów;586;249;249;14;235;42.49;5.62
98386;160605;Szkoła Podstawowa|Bukowie|ul. Lipowa 54 |46-115 Bukowie;530;179;179;1;178;33.77;0.56
98387;160605;Kaplica|Lubska| 25a |46-113 Wilków;430;139;139;10;129;32.33;7.19
98388;160605;Szkoła Podstawowa|Idzikowice| 24a |46-113 Wilków;783;319;319;12;307;40.74;3.76
98389;160605;Świetlica|Krzyków| 28 |46-113 Wilków;201;61;61;6;55;30.35;9.84
98390;160605;Świetlica|Pągów|ul. Główna 19 |46-113 Wilków;517;173;173;8;165;33.46;4.62
98391;160605;Dom Kultury|Wilków|ul. Wrocławska 16 |46-113 Wilków;891;402;402;12;390;45.12;2.99
98392;160605;Świetlica|Wojciechów| 31a |46-113 Wilków;245;83;83;8;75;33.88;9.64
98393;160701;Fabryka Armatur "Głuchołazy" S.A.|Głuchołazy|ul. Wrocławska 1a |48-340 Głuchołazy;917;432;432;9;423;47.11;2.08
98394;160701;Polski Komitet Pomocy Społecznej|Głuchołazy|Rynek 31 |48-340 Głuchołazy;1083;392;392;23;369;36.20;5.87
98395;160701;Gminny Ośrodek Sportu i Rekreacji|Głuchołazy|ul. Curie-Skłodowskiej 32 |48-340 Głuchołazy;999;336;336;9;327;33.63;2.68
98396;160701;Centrum Kultury|Głuchołazy|ul. Bohaterów Warszawy 7 |48-340 Głuchołazy;1003;338;338;12;326;33.70;3.55
98397;160701;Gminna Świetlica Socjoterapeutyczna przy PKPS|Głuchołazy|Aleja Jana Pawła II 24 |48-340 Głuchołazy;1138;478;478;17;461;42.00;3.56
98398;160701;Międzyzakładowa Spółdzielnia Mieszkaniowa|Głuchołazy|ul. Wieniawskiego 5 |48-340 Głuchołazy;1101;608;608;4;604;55.22;0.66
98399;160701;Publiczne Gimnazjum Nr 2|Głuchołazy|ul. Słowackiego 1 |48-340 Głuchołazy;911;380;380;2;378;41.71;0.53
98400;160701;Publiczne Gimnazjum Nr 1|Głuchołazy|ul. Kraszewskiego 30 |48-340 Głuchołazy;794;398;398;13;385;50.13;3.27
98401;160701;Centrum Informacji Turystycznej|Głuchołazy|Plac Basztowy 4A |48-340 Głuchołazy;946;367;367;9;358;38.79;2.45
98402;160701;Zakład Usługowo Produkcyjny "Komunalnik" Spółka z o.o.|Głuchołazy|ul. Gen. Andersa 4 |48-340 Głuchołazy;964;371;371;14;357;38.49;3.77
98403;160701;Publiczne Gimnazjum Nr 1|Głuchołazy|ul. Kraszewskiego 30 |48-340 Głuchołazy;900;419;419;6;413;46.56;1.43
98404;160701;Publiczne Gimnazjum Nr 1|Głuchołazy|ul. Kraszewskiego 30 |48-340 Głuchołazy;752;327;327;8;319;43.48;2.45
98405;160701;Świetlica Wiejska w Konradowie|Konradów| 51 |48-340 Głuchołazy;999;405;405;7;398;40.54;1.73
98406;160701;Publiczna Szkoła Podstawowa Stowarzyszenia Edukacyjnego "Przyjazna szkoła"|Gierałcice| 154 |48-340 Głuchołazy;701;308;308;4;304;43.94;1.30
98407;160701;Publiczna Szkoła Podstawowa Stowarzyszenia Rozwoju Wsi Burgrabice|Burgrabice| 140 |48-355 Burgrabice;562;208;208;16;192;37.01;7.69
98408;160701;Świetlica Wiejska w Sławniowicach|Sławniowice| 49 |48-355 Burgrabice;420;143;143;7;136;34.05;4.90
98409;160701;Świetlica Wiejska w Biskupowie|Biskupów| 71 |48-340 Burgrabice;822;274;274;13;261;33.33;4.74
98410;160701;Publiczna Szkoła Podstawowa Stowarzyszenia Rozwoju Wsi, Markowice, Polski Świętów, Sucha Kamienica|Polski Świętów| 74a |48-330 Nowy Świętów;518;200;200;5;195;38.61;2.50
98411;160701;Publiczna Szkoła Podstawowa w Nowym Świętowie|Nowy Świętów| 65 |48-330 Nowy Świętów;958;415;415;10;405;43.32;2.41
98412;160701;Publiczna Szkoła Podstawowa Stowarzyszenia Rozwoju Wsi Stary Las|Stary Las| 56a |48-340 Głuchołazy;521;191;191;6;185;36.66;3.14
98413;160701;Świetlica Wiejska w Charbielinie|Charbielin| 27 |48-340 Głuchołazy;1030;371;371;6;365;36.02;1.62
98414;160701;Publiczna Szkoła Podstawowa w Bodzanowie|Bodzanów| 83 |48-340 Głuchołazy;1193;480;480;18;462;40.23;3.75
98415;160701;Publiczna Szkoła Podstawowa Stowarzyszenia Rozwoju Wsi Jarnołtówek|Jarnołtówek| 109 |48-267 Jarnołtówek;858;339;339;3;336;39.51;0.88
98416;160701;Szpital Nr 1 Samodzielny Publiczny Zakład Opieki Zdrowotnej|Głuchołazy|ul. Curie Skłodowskiej 16 |48-340 Głuchołazy;61;11;11;1;10;18.03;9.09
98417;160701;Szpital Nr 2 Samodzielny Publiczny Zakład Opieki Zdrowotnej|Głuchołazy|ul. Lompy 2 |48-340 Głuchołazy;125;70;70;5;65;56.00;7.14
98418;160701;Zakład Opiekuńczo- Leczniczy Samodzielnego Publicznego Zakładu Opieki Zdrowotnej w Głuchołazach|Głuchołazy|ul. Parkowa 9 |48-340 Głuchołazy;68;8;8;1;7;11.76;12.50
98419;160701;Samodzielny Publiczny Zakład Opieki Zdrowotnej Szpital Specjalistyczny Ministerstwa Spraw Wewnętrznych|Głuchołazy|ul. Karłowicza 40 |48-340 Głuchołazy;155;122;122;8;114;78.71;6.56
98420;160702;Zespół Szkół Ogólnokształcących|Kamiennik|ul. 1 Maja 28 |48-388 Kamiennik;755;292;292;20;272;38.68;6.85
98421;160702;Zespół Szkolno-Przedszkolny|Lipniki| 109 |48-388 Kamiennik;510;197;197;5;192;38.63;2.54
98422;160702;Zespół Szkolno-Przedszkolny|Karłowice Wielkie| 52 |48-388 Kamiennik;428;167;167;9;158;39.02;5.39
98423;160702;Świetlica Wiejska|Szklary| 132a |48-388 Kamiennik;438;193;193;13;180;44.06;6.74
98424;160702;Świetlica Wiejska|Goworowice| 55 |48-388 Kamiennik;342;125;125;9;116;36.55;7.20
98425;160702;Zespół Szkolno-Przedszkolny|Karłowice Wielkie| 52 |48-388 Kamiennik;419;128;128;4;124;30.55;3.12
98426;160703;Miejsko Gminny Ośrodek Kultury Sportu i Rekreacji|Korfantów|Rynek 10 |48-317 Korfantów;1524;675;675;23;652;44.29;3.41
98427;160703;Gimnazjum w Korfantowie|Korfantów|ul. Adama Mickiewicza 1 |48-317 Korfantów;1682;535;535;30;505;31.81;5.61
98428;160703;Świetlica Wiejska|Kuźnica Ligocka| 29 |48-317 Korfantów;505;130;130;8;122;25.74;6.15
98429;160703;Zespół Szkolno-Przedszkolny|Przechód| 239 |48-317 Korfantów;625;140;140;6;134;22.40;4.29
98430;160703;Świetlica Wiejska|Rzymkowice| 152 a |48-317 Korfantów;461;111;111;2;109;24.08;1.80
98431;160703;Świetlica Wiejska|Przydroże Małe| 55 |48-325 Korfantów;454;128;128;3;125;28.19;2.34
98432;160703;Ścinawski Ośrodek Integracji Społecznej|Ścinawa Mała|ul. Rynek 45c |48-325 Korfantów;616;227;227;10;217;36.85;4.41
98433;160703;Wiejski Dom Kultury|Ścinawa Nyska|ul. Nyska 21 |48-325 Korfantów;1138;312;312;20;292;27.42;6.41
98434;160703;Szkoła Podstawowa|Włodary|ul. Szkolna 1 |48-317 Korfantów;580;212;212;7;205;36.55;3.30
98435;160703;Dom Pomocy Społecznej "Maria"|Korfantów|ul. 3 Maja 2 |38-317 Korfantów;54;15;15;3;12;27.78;20.00
98436;160703;Opolskie Centrum Rehabilitacji|Korfantów|ul. Wyzwolenia 11 |48-317 Korfantów;163;92;92;4;88;56.44;4.35
98437;160704;Sala Konferencyjna w Urzędzie Gminy|Łambinowice|ul. Gen. Zawadzkiego 29 |48-316 Łambinowice;823;342;342;12;330;41.56;3.51
98438;160704;Zespół Szkół|Łambinowice|Szkolna 2 |48-316 Łambinowice;1216;626;626;20;606;51.48;3.19
98439;160704;Zespół Szkolno-Przedszkolny w Jasienicy Dolnej|Jasienica Dolna| 156 |48-315 Jasienica Dolna;801;292;292;9;283;36.45;3.08
98440;160704;Publiczna Szkoła Podstawowa w Mańkowicach|Mańkowice| 113 |48-315 Jasienica Dolna;514;183;183;7;176;35.60;3.83
98441;160704;Publiczna Szkoła Podstawowa w Bielicach|Bielice| 102 |48-316 Łambinowice;1019;329;329;18;311;32.29;5.47
98442;160704;Świetlica Wiejska w Wierzbiu|Wierzbie| 108 |48-316 Łambinowice;743;270;270;7;263;36.34;2.59
98443;160704;Publiczna Szkoła Podstawowa w Lasocicach|Lasocice| 82 |48-315 Jasienica Dolna;650;235;235;16;219;36.15;6.81
98444;160704;Świetlica Wiejska w Sowinie|Sowin| 87 |48-316 Łambinowice;409;103;103;7;96;25.18;6.80
98445;160705;PWSZ Nysa|Nysa|ul. Armii Krajowej 7 |48-300 Nysa;2273;1122;1122;20;1102;49.36;1.78
98446;160705;Miejska i Gminna Biblioteka Publiczna|Nysa|ul. Sukiennicza 2 |48-300 Nysa;2233;1117;1117;25;1092;50.02;2.24
98447;160705;Szkoła Podstawowa Nr 1|Nysa|ul. Bohaterów Warszawy 7 |48-300 Nysa;2172;1022;1022;20;1002;47.05;1.96
98448;160705;Szkoła Podstawowa Nr 5|Nysa|ul. Gierczak 8 |48-300 Nysa;2066;850;850;22;828;41.14;2.59
98449;160705;Klub Nyskiego Domu Kultury|Nysa|ul.Moniuszki 5 |48-300 Nysa;1774;773;773;24;749;43.57;3.10
98450;160705;Gimnazjum Nr 2|Nysa|ul. Bolesława Prusa 14 |48-303 Nysa;1409;718;718;10;708;50.96;1.39
98451;160705;Zespół Szkół i Placówek Oświatowych im. Emila Godlewskiego|Nysa|ul. Rodziewiczówny 1 |48-304 Nysa;1654;900;900;11;889;54.41;1.22
98452;160705;Zespół Szkół i Placówek Oświatowych im. Emila Godlewskiego|Nysa|ul. Rodziewiczówny 1 |48-304 Nysa;1539;859;859;16;843;55.82;1.86
98453;160705;Zespół Szkół i Placówek Oświatowych im. Emila Godlewskiego|Nysa|ul. Rodziewiczówny 1 |48-304 Nysa;2138;1081;1081;21;1060;50.56;1.94
98454;160705;Szkoła Podstawowa Nr 10|Nysa|ul. 11 Listopada 6 |48-303 Nysa;2229;1258;1258;18;1240;56.44;1.43
98455;160705;Ośrodek Pomocy Społecznej|Nysa|ul. Komisji Edukacji Narodowej 1a |48-303 Nysa;2356;1116;1116;21;1095;47.37;1.88
98456;160705;Ośrodek Inicjatyw Twórczych INVENTUS|Nysa|ul. Rodziewiczówny 18b |48-304 Nysa;1832;905;905;17;888;49.40;1.88
98457;160705;Szkoła Podstawowa Nr 3|Nysa|ul. Krawiecka 6 |48-303 Nysa;2173;836;836;24;812;38.47;2.87
98458;160705;Hala Sportowa|Nysa|ul. Głuchołaska 12 |48-303 Nysa;889;441;441;5;436;49.61;1.13
98459;160705;Świetlica Pracowniczych Ogródków Działkowych|Nysa|ul. Władysława Jagiełły 23a |48-300 Nysa;966;485;485;5;480;50.21;1.03
98460;160705;Caritas Diecezji Opolskiej Rejon Nysa|Nysa|ul. Grodkowska 26 |48-300 Nysa;2189;1029;1029;26;1003;47.01;2.53
98461;160705;Zespół Szkół Sportowych|Nysa|ul. Bramy Grodkowskiej 4 |48-300 Nysa;1868;897;897;11;886;48.02;1.23
98462;160705;Powiatowy Urząd Pracy|Nysa|ul. Słowiańska 19 |48-300 Nysa;2220;928;928;21;907;41.80;2.26
98463;160705;Zespół Szkół Ekonomicznych|Nysa|Plac Sikorskiego 1 |48-300 Nysa;2167;1136;1136;13;1123;52.42;1.14
98464;160705;Zespół Szkolno-Przedszkolny, Biała Nyska|Biała Nyska|ul. Nyska 11 |48-303 Nysa;1747;739;739;25;714;42.30;3.38
98465;160705;Zespół Szkolno-Przedszkolny, Koperniki|Koperniki| 16a |48-303 Nysa;791;302;302;21;281;38.18;6.95
98466;160705;Świetlica Wiejska, Hajduki Nyskie|Hajduki Nyskie| 36 |48-303 Nysa;579;261;261;14;247;45.08;5.36
98467;160705;Świetlica Wiejska, Kępnica|Kępnica| 79b |48-303 Nysa;537;218;218;8;210;40.60;3.67
98468;160705;Świetlica Wiejska, Wyszków Śląski|Wyszków Śląski| 45 |48-303 Nysa;1031;426;426;9;417;41.32;2.11
98469;160705;Świetlica Wiejska, Domaszkowice|Domaszkowice| 120a |48-303 Nysa;508;209;209;6;203;41.14;2.87
98470;160705;Zespół Szkolno-Przedszkolny, Niwnica|Niwnica| 127 |48-303 Nysa;620;320;320;7;313;51.61;2.19
98471;160705;Świetlica Wiejska, Wierzbięcice|Wierzbięcice| 110 |48-303 Nysa;744;293;293;5;288;39.38;1.71
98472;160705;Zespół Szkolno-Przedszkolny, Goświnowice|Goświnowice|ul. Kolejowa 5 |48-300 Nysa;1067;445;445;18;427;41.71;4.04
98473;160705;Świetlica Wiejska, Jędrzychów|Jędrzychów|ul. Wiśniowa 1 |48-300 Nysa;861;465;465;9;456;54.01;1.94
98474;160705;Świetlica Wiejska, Radzikowice|Radzikowice| 70 |48-300 Nysa;428;191;191;6;185;44.63;3.14
98475;160705;Świetlica Wiejska, Skorochów|Skorochów| |48-300 Nysa;401;203;203;2;201;50.62;0.99
98476;160705;Świetlica Wiejska, Złotogłowice|Złotogłowice| 169 |48-300 Nysa;1325;462;462;12;450;34.87;2.60
98477;160705;Szpital Miejski w Nysie|Nysa|ul. Bohaterów Warszawy 23 |48-300 Nysa;103;53;53;2;51;51.46;3.77
98478;160705;Zakład Karny w Nysie|Nysa|ul. Kościuszki 4a |48-300 Nysa;650;297;308;39;258;45.69;13.13
98479;160706;Publiczne Przedszkole|Otmuchów|ul. Władysława Łokietka 10 |48-385 Otmuchów;1122;573;573;11;562;51.07;1.92
98480;160706;Urząd Miejski|Otmuchów|ul. Zamkowa 6 |48-385 Otmuchów;828;459;459;22;437;55.43;4.79
98481;160706;Kino|Otmuchów|ul. Rynek 7 |48-385 Otmuchów;1075;490;490;30;460;45.58;6.12
98482;160706;Publiczne Przedszkole-Żłobek|Otmuchów|ul. Władysława Jagiełły 3 |48-385 Otmuchów;1130;548;548;16;532;48.50;2.92
98483;160706;Świetlica Wiejska|Maciejowice| 15 |48-385 Otmuchów;951;339;339;13;326;35.65;3.83
98484;160706;Szkoła Podstawowa|Ligota Wielka| 10 |48-385 Otmuchów;852;315;315;14;301;36.97;4.44
98485;160706;Szkoła Podstawowa|Grądy| 32 |48-385 Otmuchów;843;338;338;7;331;40.09;2.07
98486;160706;Remiza OSP świetlica|Wójcice| 145a |48-385 Otmuchów;662;316;316;11;305;47.73;3.48
98487;160706;Szkoła Podstawowa|Meszno| 69 |48-385 Otmuchów;684;304;304;16;288;44.44;5.26
98488;160706;Szkoła Podstawowa|Kałków| 61a |48-364 Otmuchów;687;345;345;17;328;50.22;4.93
98489;160706;Publiczne Przedszkole|Jasienica Górna| 36 |48-385 Otmuchów;549;198;198;11;187;36.07;5.56
98490;160706;Świetlica wiejska|Łąka| 65a |48-385 Otmuchów;471;189;189;12;177;40.13;6.35
98491;160706;Budynek byłej szkoły świetlica wiejska|Buków| 92 |48-385 Otmuchów;749;332;332;23;309;44.33;6.93
98492;160706;Świetlica wiejska|Jarnołtów| 92 |48-385 Otmuchów;735;303;303;20;283;41.22;6.60
98493;160707;Przedszkole Publiczne Nr 3|Paczków|ul. Młyńska 23 |48-370 Paczków;1354;578;578;14;564;42.69;2.42
98494;160707;Zespół Szkół|Paczków|ul. Kołłątaja 9 |48-370 Paczków;1408;513;513;26;487;36.43;5.07
98495;160707;Dom Plastyka|Paczków|ul. Rynek 20 |48-370 Paczków;1369;521;521;19;502;38.06;3.65
98496;160707;Przedszkole Publiczne Nr 2|Paczków|ul. Wojska Polskiego 43 |48-370 Paczków;2120;1043;1043;25;1018;49.20;2.40
98497;160707;Przedszkole Publiczne|Dziewiętlice| 78 |48-370 Paczków;433;200;200;6;194;46.19;3.00
98498;160707;Przedszkole Publiczne|Gościce| 37 |48-370 Paczków;377;163;163;9;154;43.24;5.52
98499;160707;Publiczna Szkoła Podstawowa z Oddziałem Przedszkolnym|Kamienica| 94 |48-370 Paczków;640;267;267;16;251;41.72;5.99
98500;160707;Przedszkole Publiczne|Stary Paczków| 108a |48-370 Paczków;659;262;262;7;255;39.76;2.67
98501;160707;Wiejski Dom Kultury|Trzeboszowice| 11 |48-370 Paczków;848;383;383;4;379;45.17;1.04
98502;160707;Świetlica Wiejska|Ujeździec| 52a |48-370 Paczków;329;137;137;6;131;41.64;4.38
98503;160707;Przedszkole Publiczne|Unikowice| 21 |48-370 Paczków;345;124;124;4;120;35.94;3.23
98504;160707;Wiejski Dom Ludowy|Kozielno| 38 |48-370 Paczków;252;70;70;6;64;27.78;8.57
98505;160707;Wiejski Dom Kultury|Kamienica| 92 |48-370 Paczków;363;182;182;3;179;50.14;1.65
98506;160707;Zespół Opieki Zdrowotnej Nysa - Szpital Paczków|Paczków|ul. Staszica 3 |48-370 Paczków;70;28;28;0;28;40.00;0.00
98507;160708;Gminna Biblioteka Publiczna w Pakosławicach|Pakosławice| 38 |48-314 Pakosławice;442;246;246;1;245;55.66;0.41
98508;160708;Świetlica w Biechowie|Biechów|Biechów 8a |48-314 Pakosławice;490;176;176;7;169;35.92;3.98
98509;160708;Świetlica we Frączkowie|Frączków| 1B |48-314 Pakosławice;729;267;267;13;254;36.63;4.87
98510;160708;Szkoła Podstawowa w Prusinowicach|Prusinowice|ul. Szkolna 9 |48-314 Pakosławice;601;247;247;7;240;41.10;2.83
98511;160708;Szkoła Podstawowa w Nowakach|Nowaki| 45 |48-314 Pakosławice;305;110;110;2;108;36.07;1.82
98512;160708;Gminna Biblioteka Publiczna w Pakosławicach|Pakosławice| 38 |48-314 Pakosławice;447;202;202;4;198;45.19;1.98
98513;160709;Szkoła Podstawowa w Skoroszycach|Skoroszyce|ul. Braterstwa Broni 9 |48-320 ;763;288;288;14;274;37.75;4.86
98514;160709;Szkoła Podstawowa w Chróścinie|Chróścina|ul. Szkolna 1 |48-320 ;885;260;260;16;244;29.38;6.15
98515;160709;Szkoła Podstawowa w Sidzinie|Sidzina|ul. Radziechowska 3 |48-320 ;999;411;411;16;395;41.14;3.89
98516;160709;Szkoła Podstawowa w Makowicach|Makowice| 61 |48-320 Skoroszyce;472;142;142;12;130;30.08;8.45
98517;160709;Szkoła Podstawowa w Chróścinie|Chróścina|ul. Szkolna 1 |48-320 ;782;297;297;3;294;37.98;1.01
98518;160709;Szkoła Podstawowa w Skoroszycach|Skoroszyce|ul. Braterstwa Broni 9 |48-320 ;1162;504;504;28;476;43.37;5.56
98519;160801;Zespół Szkół Ponadgimnazjalnych|Dobrodzień|ul. Oleska 7 |46-380 Dobrodzień;1414;549;549;29;520;38.83;5.28
98520;160801;Publiczne Gimnazjum|Dobrodzień|ul. Piastowska 17 |46-380 Dobrodzień;1035;339;339;21;318;32.75;6.19
98521;160801;Publiczna Szkoła Podstawowa|Dobrodzień|ul. Piastowska 49 |46-380 Dobrodzień;1555;492;492;33;459;31.64;6.71
98522;160801;Publiczna Szkoła Podstawowa|Pludry|ul. Aleja Wyzwolenia 4b |46-375 Dobrodzień;1735;639;639;58;581;36.83;9.08
98523;160801;Publiczna Szkoła Podstawowa|Szemrowice|ul. Wiejska 2 |46-380 Dobrodzień;646;183;183;7;176;28.33;3.83
98524;160801;Budynek byłej Szkoły Podstawowej|Rzędowice|ul. Dobrodzieńska 8 |46-380 Dobrodzień;774;231;231;5;226;29.84;2.16
98525;160801;Publiczna Szkoła Podstawowa|Turza|ul. Kolejowa 27 |46-380 Dobrodzień;988;226;226;12;214;22.87;5.31
98526;160802;Budynek w Gorzowie Śląskim|Gorzów Śląski|ul. Kluczborska 5 |46-310 Gorzów Śląski;435;140;140;7;133;32.18;5.00
98527;160802;Miejsko-Gminny Ośrodek Kultury w Gorzowie Śląskim - sala widowiskowa|Gorzów Śląski|ul. Rynek 4 |46-310 Gorzów Śląski;1297;564;564;21;543;43.48;3.72
98528;160802;Miejsko- Gminny Ośrodek Kultury w Gorzowie Śląskim - świetlica|Gorzów Śląski|ul. Rynek 4 |46-310 Gorzów Śląski;775;349;349;11;338;45.03;3.15
98529;160802;Budynek Publicznego Przedszkola|Jastrzygowice| 23 |46-310 Gorzów Śląski;506;172;172;9;163;33.99;5.23
98530;160802;Publiczna Szkoła Podstawowa|Kozłowice|ul. Nowa 2 |46-310 Gorzów Śląski;1217;508;508;34;474;41.74;6.69
98531;160802;Publiczna Szkoła Podstawowa|Uszyce| 35 |46-310 Gorzów Śląski;725;229;229;17;212;31.59;7.42
98532;160802;Publiczne Przedszkole|Zdziechowice| 98 |46-310 Gorzów Śląski;1097;339;339;14;325;30.90;4.13
98533;160803;Publiczne Gimnazjum Nr 1|Olesno|ul. Pieloka 12 |46-300 Olesno;1909;777;777;16;761;40.70;2.06
98534;160803;Szkoła Podstawowa Nr 3|Olesno|ul. Krasickiego 25 |46-300 Olesno;1192;610;610;20;590;51.17;3.28
98535;160803;Szkoła Podstawowa Nr 3|Olesno|ul. Krasickiego 25 |46-300 Olesno;1789;839;839;21;818;46.90;2.50
98536;160803;Miejski Dom Kultury - Mała Sala|Olesno|ul. Wielkie Przedmieście 31 |46-300 Olesno;1210;565;565;13;552;46.69;2.30
98537;160803;Miejski Dom Kultury - Sala Kominkowa|Olesno|ul. Wielkie Przedmieście 31 |46-300 Olesno;1683;737;737;13;724;43.79;1.76
98538;160803;Szkoła Podstawowa|Bodzanowice|ul. Szkolna 1 |46-312 Bodzanowice;976;283;283;11;272;29.00;3.89
98539;160803;Szkoła Podstawowa|Borki Wielkie|ul. Młyńska 8 |46-300 Olesno;927;373;373;15;358;40.24;4.02
98540;160803;Publiczne Przedszkole|Borki Małe|ul. Szkolna 1 |46-300 Olesno;371;130;130;5;125;35.04;3.85
98541;160803;DFK|Świercze|ul. Zapłocie 1 |46-300 Olesno;698;272;272;11;261;38.97;4.04
98542;160803;Remiza OSP|Łomnica|ul. Strażacka 3 |46-300 Olesno;621;149;149;8;141;23.99;5.37
98543;160803;Szkoła Podstawowa|Sowczyce|ul. Długa 8 |46-300 Olesno;567;162;162;6;156;28.57;3.70
98544;160803;Szkoła Podstawowa|Wachów|ul. Polna 17 |46-300 Olesno;645;209;209;5;204;32.40;2.39
98545;160803;Remiza OSP|Wysoka| 39 a |46-300 Olesno;349;76;76;4;72;21.78;5.26
98546;160803;Szkoła Podstawowa|Wojciechów|ul. Kluczborska 37 |46-300 Olesno;702;254;254;9;245;36.18;3.54
98547;160803;Publiczne Przedszkole|Łowoszów|ul. Opolska 64 |46-300 Olesno;420;146;146;4;142;34.76;2.74
98548;160803;Wiejskie Centrum Kultury|Stare Olesno|ul. Kluczborska 3 |46-300 Olesno;397;101;101;5;96;25.44;4.95
98549;160803;Remiza OSP|Boroszów| 44 |46-300 Olesno;220;100;100;4;96;45.45;4.00
98550;160803;Zespół Opieki Zdrowotnej|Olesno|ul. Klonowa 1 |46-300 Olesno;98;23;23;1;22;23.47;4.35
98551;160804;Klub Abstynenta|Praszka|Plac Grunwaldzki 9 |46-320 Praszka;1300;694;694;20;674;53.38;2.88
98552;160804;Publiczne Gimnazjum im. Ojca Świętego Jana Pawła II|Praszka|ul. Listopadowa 18 |46-320 Praszka;2135;1114;1114;51;1063;52.18;4.58
98553;160804;Publiczne Przedszkole Nr 1|Praszka|ul. Mickiewicza 28 |46-320 Praszka;1381;806;806;44;762;58.36;5.46
98554;160804;I Liceum Ogólnokształcące im.Powstańców Śląskich|Praszka|ul. Kaliska 38 |46-320 Praszka;821;457;457;20;437;55.66;4.38
98555;160804;Remiza Ochotniczej Straży Pożarnej|Wygiełdów| 22 |46-310 Gorzów Śląski;845;375;375;6;369;44.38;1.60
98556;160804;Środowiskowy Dom Samopomocy|Gana| 28 |46-320 Praszka;1005;467;467;27;440;46.47;5.78
98557;160804;Zespół Szkolno-Przedszkolny|Strojec|ul. Szkolna 8 |46-320 Praszka;866;414;414;14;400;47.81;3.38
98558;160804;Publiczna Szkoła Podstawowa|Przedmość|ul. Główna 22 |46-320 Praszka;642;311;311;17;294;48.44;5.47
98559;160804;Publiczna Szkoła Podstawowa im. Wincentego Witosa|Kowale|ul. Szkolna 1 |46-320 Praszka;781;400;400;15;385;51.22;3.75
98560;160804;Publiczna Szkoła Podstawowa Stowarzyszenie Przyjaciół Szkół Katolickich|Wierzbie| 44 |46-320 Praszka;601;253;253;10;243;42.10;3.95
98561;160804;Publiczne Przedszkole Nr 1|Praszka|ul. Mickiewicza 28 |46-320 Praszka;929;520;520;13;507;55.97;2.50
98562;160805;Publiczne Gimnazjum w Radłowie|Radłów|Oleska 1 |46-331 Radłów;700;231;231;19;212;33.00;8.23
98563;160805;Publiczne Gimnazjum w Radłowie|Radłów|Oleska 1 |46-331 Radłów;694;215;215;9;206;30.98;4.19
98564;160805;Publiczna Szkoła Podstawowa w Sternalicach|Sternalice| 8 |46-333 Sternalice;366;128;128;5;123;34.97;3.91
98565;160805;Publiczna Szkoła Podstawowa w Sternalicach|Sternalice| 8 |46-333 Sternalice;625;182;182;13;169;29.12;7.14
98566;160805;Budynek Gminny, Biskupice|Biskupice| 13 |46-331 Radłów;589;202;202;7;195;34.30;3.47
98567;160805;Publiczna Szkoła Podstawowa Pomnik 1000-Lecia w Kościeliskach|Kościeliska| 28 |46-324 Kościeliska;571;181;181;1;180;31.70;0.55
98568;160806;Szkoła Podstawowa im. Tadeusza Kościuszki|Cieciułów| 19 |46-325 Rudniki;1198;420;420;15;405;35.06;3.57
98569;160806;Szkoła Podstawowa im. Marszałka Józefa Piłsudskiego|Żytniów| 29 |46-325 Rudniki;1114;399;399;14;385;35.82;3.51
98570;160806;Gimnazjum Publiczne im. Andrzeja Wajdy|Rudniki|ul. Wieluńska 6 |46-325 Rudniki;1399;707;707;28;679;50.54;3.96
98571;160806;Szkoła Podstawowa im. Jana Pawła II|Dalachów| 217 |46-325 Rudniki;1628;827;827;31;796;50.80;3.75
98572;160806;Szkoła Podstawowa im. Mikołaja Kopernika|Mirowszczyzna| 43 |46-325 Rudniki;1508;628;628;14;614;41.64;2.23
98573;160807;Dom Spotkań|Zębowice|ul. Izydora Murka 1 |46-048 Zębowice;870;275;275;12;263;31.61;4.36
98574;160807;Ochotnicza Straż Pożarna|Kadłub Wolny|ul. Szkolna 5 |46-048 Zębowice;623;177;177;16;161;28.41;9.04
98575;160807;Szkoła Podstawowa|Radawie|ul. Szkolna 22 |46-048 Zębowice;873;223;223;12;211;25.54;5.38
98576;160807;Dom Spotkań|Zębowice|ul. Izydora Murka 1 |46-048 Zębowice;693;249;249;7;242;35.93;2.81
98577;160901;Publiczna Szkoła Podstawowa|Chrząstowice|ul. Szkolna 1 |46-053 Chrząstowice;1119;466;466;10;456;41.64;2.15
98578;160901;Publiczna Szkoła Podstawowa|Dębska Kuźnia|ul. Wiejska 53 |46-053 Chrząstowice;1256;520;520;14;506;41.40;2.69
98579;160901;Publiczna Szkoła Podstawowa|Dębie|ul. Wiejska 18 |46-053 Chrząstowice;893;299;299;9;290;33.48;3.01
98580;160901;Klub Wiejski|Daniec|ul. Dąbrowicka 4 |46-053 Chrząstowice;1029;299;299;20;279;29.06;6.69
98581;160901;Świetlica Wiejska|Suchy Bór|ul. Szkolna 2 |46-053 Chrząstowice;1255;626;626;9;617;49.88;1.44
98582;160902;Remiza OSP|Dąbrowa|ul. Ks. prof. J. Sztonyka 19 |49-120 Dąbrowa;1063;551;551;15;536;51.83;2.72
98583;160902;Zespół Szkół|Chróścina|ul. Niemodlińska 8d |46-073 Chróścina;1303;509;509;19;490;39.06;3.73
98584;160902;Publiczna Szkoła Podstawowa|Narok|ul. Szkolna 19 |49-120 Dąbrowa;956;325;325;16;309;34.00;4.92
98585;160902;Publiczna Szkoła Podstawowa|Sławice|ul. Opolska 34 |49-120 Dąbrowa;713;332;332;15;317;46.56;4.52
98586;160902;Świetlica wiejska|Ciepielowice|ul. Długa 18a |49-120 Dąbrowa;940;427;427;16;411;45.43;3.75
98587;160902;Budynek socjalno-administracyjny|Prądy|ul. Sportowa 18 |49-120 Dąbrowa;354;166;166;3;163;46.89;1.81
98588;160902;Pawilon sportowy|Mechnice|ul. Strażacka 6a |46-073 Chróścina;914;369;369;17;352;40.37;4.61
98589;160902;Świetlica wiejska|Karczów|ul. Szkolna 2 |49-120 Dąbrowa;540;268;268;9;259;49.63;3.36
98590;160902;Budynek wielofunkcyjny|Wrzoski|ul. Wrocławska 8 |46-073 Chrościna;449;178;178;10;168;39.64;5.62
98591;160902;Świetlica wiejska|Żelazna|ul. Opolska 58 |49-120 Dąbrowa;514;238;238;3;235;46.30;1.26
98592;160903;Zespół Szkół|Czarnowąsy|ul. Kani 1 |46-020 Czarnowąsy;757;339;339;7;332;44.78;2.06
98593;160903;Sala przy OSP|Chróścice|ul. Powstańców Śląskich 11 |46-080 Chróścice;822;286;286;13;273;34.79;4.55
98594;160903;Szkoła Zawodowa|Dobrzeń Mały|ul. Opolska 85 |46-081 Dobrzeń Wielki;793;316;316;13;303;39.85;4.11
98595;160903;Gminny Ośrodek Kultury|Dobrzeń Wielki|ul. Namysłowska 20 |46-081 Dobrzeń Wielki;1346;528;528;15;513;39.23;2.84
98596;160903;Zespół Szkolno-Przedszkolny|Kup|ul. 1 Maja 6a |46-082 Kup;996;391;391;14;377;39.26;3.58
98597;160903;Sala Wiejska|Świerkle|ul. Mickiewicza 2 |46-020 Czarnowąsy;482;188;188;7;181;39.00;3.72
98598;160903;Sala przy OSP|Chróścice|ul. Powstańców Śląskich 11 |46-080 Chróścice;1556;488;488;14;474;31.36;2.87
98599;160903;Zespół Szkół|Dobrzeń Wielki|ul. Namysłowska 94 |46-081 Dobrzeń Wielki;1506;611;611;20;591;40.57;3.27
98600;160903;Zespół Szkół - stara szkoła|Czarnowąsy|ul. Kani 1 |46-020 Czarnowąsy;869;432;432;10;422;49.71;2.31
98601;160903;Sala Wiejska|Borki|ul. Szkolna 12 |46-020 Czarnowąsy;455;187;187;8;179;41.10;4.28
98602;160903;Publiczne Przedszkole|Czarnowąsy|ul. Kani 1 |46-020 Czarnowąsy;384;208;208;5;203;54.17;2.40
98603;160903;Szkoła Podstawowa|Dobrzeń Wielki|ul. Kościelna 3 |46-081 Dobrzeń Wielki;711;440;440;14;426;61.88;3.18
98604;160903;Zespół Szkół - stołówka|Czarnowąsy|ul. Kani 1 |46-020 Czarnowąsy;1024;471;471;12;459;46.00;2.55
98605;160903;Dom Pomocy Społecznej|Dobrzeń Wielki|ul. Kościelna 11 |46-084 Dobrzeń Wielki;59;40;40;0;40;67.80;0.00
98606;160903;Szpital w Kup|Kup|ul. Miarki 14 |46-082 Kup;69;44;44;3;41;63.77;6.82
98607;160904;Urząd Gminy|Komprachcice|ul. Kolejowa 3 |46-070 Komprachcice;1118;441;441;10;431;39.45;2.27
98608;160904;Publiczna Szkoła Podstawowa|Chmielowice|ul. Nyska 1 |46-070 Komprachcice;1670;980;980;17;963;58.68;1.73
98609;160904;Publiczna Stowarzyszeniowa Szkoła Podstawowa|Ochodze|ul. Opolska 34 |46-070 Komprachcice;975;369;369;17;352;37.85;4.61
98610;160904;Publiczna Szkoła Podstawowa|Domecko|ul. Opolska 52 |46-070 Komprachcice;1043;369;369;8;361;35.38;2.17
98611;160904;Publiczna Szkoła Podstawowa|Polska Nowa Wieś|ul. Lipowa 56 |46-070 Komprachcice;1459;577;577;29;548;39.55;5.03
98612;160904;Publiczna Szkoła Podstawowa|Wawelno|ul. Nowowiejska 14 |46-070 Komprachcice;921;328;328;11;317;35.61;3.35
98613;160904;Świetlica|Osiny|ul. Opolska 20 |46-070 Komprachcice;671;304;304;6;298;45.31;1.97
98614;160904;Samorządowy Ośrodek Kultury|Komprachcice|ul. Niemodlińska 2 |46-070 Komprachcice;1148;474;474;21;453;41.29;4.43
98615;160905;Szkoła Podstawowa|Brynica|ul. Powstańców Śląskich 47 |46-024 Łubniany;1056;330;330;16;314;31.25;4.85
98616;160905;Szkoła Podstawowa|Jełowa|ul. Wolności 15 |46-024 Łubniany;1857;533;533;26;507;28.70;4.88
98617;160905;Gimnazjum Publiczne|Biadacz|ul. Szeroka 10 |46-022 Luboszyce;575;218;218;9;209;37.91;4.13
98618;160905;Szkoła Podstawowa|Luboszyce|ul. Szkolna 4 |46-022 Luboszyce;1895;930;930;23;907;49.08;2.47
98619;160905;Świetlica Wiejska|Kolanowice|ul. Sportowa 1 |46-024 Łubniany;436;177;177;4;173;40.60;2.26
98620;160905;Szkoła Podstawowa|Łubniany|ul. Opolska 51 |46-024 Łubniany;1990;703;703;26;677;35.33;3.70
98621;160906;Świetlica Wiejska|Dębiniec|ul. Wiejska 36 |46-030 Murów;510;131;131;10;121;25.69;7.63
98622;160906;Publiczna Szkoła Podstawowa - świetlica szkolna|Murów|ul. Wolności 22 |46-030 Murów;585;157;157;7;150;26.84;4.46
98623;160906;Publiczna Szkoła Podstawowa - stołówka szkolna|Murów|ul. Wolności 22 |46-030 Murów;818;328;328;14;314;40.10;4.27
98624;160906;Świetlica Wiejska|Zagwiździe|ul. Lipowa 1 |46-030 Murów;676;241;241;15;226;35.65;6.22
98625;160906;Świetlica Wiejska|Radomierowice|ul. Wolności 24 |46-030 Murów;378;103;103;16;87;27.25;15.53
98626;160906;Publiczna Szkoła Podstawowa - świetlica szkolna|Stare Budkowice|ul. Wołczyńska 14 |46-030 Murów;1087;284;284;20;264;26.13;7.04
98627;160906;Publiczna Szkoła Podstawowa - sala gimnastyczna|Stare Budkowice|ul. Wołczyńska 14 |46-030 Murów;559;147;147;18;129;26.30;12.24
98628;160907;Sala Obrad Rady Miejskiej|Niemodlin|ul. Bohaterów Powstań Śląskich 34a |49-100 Niemodlin;676;280;280;18;262;41.42;6.43
98629;160907;Szkoła Podstawowa Nr 2|Niemodlin|ul. Szkolna 5 |49-100 Niemodlin;598;240;240;7;233;40.13;2.92
98630;160907;Publiczne Przedszkole Nr 1 "Bajka"|Niemodlin|ul. Kilińskiego 31 |49-100 Niemodlin;752;252;252;5;247;33.51;1.98
98631;160907;Ośrodek Kultury|Niemodlin|ul. Mikołaja Reja 1 |49-100 Niemodlin;664;332;332;11;321;50.00;3.31
98632;160907;Szkoła Podstawowa Nr 1|Niemodlin|ul. Reymonta 9 |49-100 Niemodlin;629;318;318;5;313;50.56;1.57
98633;160907;Ośrodek Sportu i Rekreacji|Niemodlin|ul. Reymonta 11 |49-100 Niemodlin;569;336;336;4;332;59.05;1.19
98634;160907;Szkoła Podstawowa Nr 1|Niemodlin|ul. Reymonta 9 |49-100 Niemodlin;642;309;309;6;303;48.13;1.94
98635;160907;Zespół Szkół|Niemodlin|ul. Opolska 34 |49-100 Niemodlin;756;365;365;17;348;48.28;4.66
98636;160907;Remiza OSP|Grabin|ul. Nyska 80 |49-100 Niemodlin;749;315;315;23;292;42.06;7.30
98637;160907;Szkoła Podstawowa|Rogi| 10a |49-156 Gracze;852;266;266;13;253;31.22;4.89
98638;160907;Publiczne Gimnazjum|Gracze|ul. Niemodlińska 21 |49-156 Gracze;706;296;296;12;284;41.93;4.05
98639;160907;Szkoła Podstawowa|Gracze|ul. Niemodlińska 21 |49-156 Gracze;925;384;384;23;361;41.51;5.99
98640;160907;Świetlica wiejska|Rzędziwojowice| 29a |49-100 Niemodlin;891;349;349;11;338;39.17;3.15
98641;160907;Świetlica wiejska|Grodziec| 13a |49-100 Niemodlin;496;221;221;8;213;44.56;3.62
98642;160907;Świetlica RSP|Wydrowice| 7 |49-100 Niemodlin;648;256;256;13;243;39.51;5.08
98643;160908;Dom Kultury|Ozimek|ul. Ostapa Dłuskiego 4 |46-040 Ozimek;1275;433;433;33;400;33.96;7.62
98644;160908;Przedszkole Publiczne Nr 4|Ozimek|ul. XX - lecia 1 |46-040 Ozimek;1306;447;447;10;437;34.23;2.24
98645;160908;Zespół Szkół w Ozimku|Ozimek|ul. Częstochowska 24 |46-040 Ozimek;1092;481;481;18;463;44.05;3.74
98646;160908;Gimnazjum Nr 1|Ozimek|ul. Janusza Korczaka 12 |46-040 Ozimek;1953;989;989;17;972;50.64;1.72
98647;160908;Szkoła Podstawowa Nr 2|Ozimek|ul. Daniecka 12a |46-040 Ozimek;761;207;207;11;196;27.20;5.31
98648;160908;Szkoła Podstawowa|Antoniów|ul. Powstańców Śląskich 17 |46-040 Ozimek;1083;333;333;5;328;30.75;1.50
98649;160908;Świetlica Wiejska|Biestrzynnik|ul. Ozimska 18 |46-043 Dylaki;552;114;114;6;108;20.65;5.26
98650;160908;Szkoła Podstawowa|Dylaki|ul. Szkolna 5 |46-043 Dylaki;1026;235;235;8;227;22.90;3.40
98651;160908;Szkoła Podstawowa|Grodziec|ul. Tartaczna 1 |46-040 Ozimek;1462;678;678;35;643;46.37;5.16
98652;160908;Szkoła Podstawowa|Krasiejów|ul. Szkolna 5 |46-040 Ozimek;1735;519;519;11;508;29.91;2.12
98653;160908;Budynek Ochotniczej Straży Pożarnej|Schodnia|ul. Ks. Piotra Gołąba 19 |46-040 Ozimek;708;225;225;13;212;31.78;5.78
98654;160908;Świetlica Wiejska|Szczedrzyk|Plac 1 Maja 9 |46-042 Ozimek;1239;409;409;14;395;33.01;3.42
98655;160908;Budynek Byłej Szkoły Podstawowej|Pustków|ul. Ozimska 11a |46-040 Ozimek;409;136;136;10;126;33.25;7.35
98656;160908;Przedszkole Publiczne Nr 1|Ozimek|ul. Ostapa Dłuskiego 13 |46-040 Ozimek;1116;512;512;16;496;45.88;3.12
98657;160908;Świetlica Wiejska|Krzyżowa Dolina|ul. Powstańców Śląskich 29 |46-040 Ozimek;609;147;147;9;138;24.14;6.12
98658;160908;EMC Instytut Medyczny S.A. Szpital Św. Rocha w Ozimku|Ozimek|ul. Częstochowska 31 |46-040 Ozimek;73;18;18;1;17;24.66;5.56
98659;160909;Świetlica Wiejska|Lubienia|ul. Wiejska 38 |46-090 Popielów;576;160;160;4;156;27.78;2.50
98660;160909;Samorządowe Centrum Kultury, Turystyki i Rekreacji|Popielów|ul. Powstańców 34 |46-090 Popielów;896;318;318;19;299;35.49;5.97
98661;160909;Samorządowe Centrum Kultury, Turystyki i Rekreacji|Popielów|ul. Powstańców 34 |46-090 Popielów;915;341;341;11;330;37.27;3.23
98662;160909;Publiczna Szkoła Podstawowa|Stare Siołkowice|ul. Michała 2 |46-083 Stare Siołkowice;793;265;265;14;251;33.42;5.28
98663;160909;Publiczna Szkoła Podstawowa|Stare Siołkowice|ul. Michała 2 |46-083 Stare Siołkowice;1142;376;376;14;362;32.92;3.72
98664;160909;Publiczna Szkoła Podstawowa|Karłowice|ul. Kolejowa 9 |46-037 Karłowice;1005;457;457;21;436;45.47;4.60
98665;160909;Publiczna Szkoła Podstawowa|Karłowice|ul. Kolejowa 9 |46-037 Karłowice;502;199;199;9;190;39.64;4.52
98666;160909;Świetlica wiejska|Stobrawa|ul. Jakuba Kani 11 |46-090 Popielów;775;364;364;18;346;46.97;4.95
98667;160910;Salka Parafialna|Chrząszczyce|ul. Opolska 32 |46-060 Prószków;1167;453;453;16;437;38.82;3.53
98668;160910;Ośrodek Kultury i Sportu|Prószków|ul. Daszyńskiego 6 |46-060 Prószków;1150;501;501;9;492;43.57;1.80
98669;160910;Publiczna Szkoła Podstawowa|Ligota Prószkowska|ul. Szkolna 25 |46-060 Prószków;683;229;229;7;222;33.53;3.06
98670;160910;Zespół Szkolno-Przedszkolny|Boguszyce|ul. Opolska 17 |46-061 Prószków;1077;443;443;15;428;41.13;3.39
98671;160910;Świetlica Wiejska|Zimnice Wielkie|ul. Opolska 47 |46-061 Prószków;974;351;351;15;336;36.04;4.27
98672;160910;Świetlica Wiejska|Winów|ul. Szkolna 14 |46-060 Prószków;580;284;284;7;277;48.97;2.46
98673;160910;Sala przy Stacji Caritas|Przysiecz|ul. Szkolna 14 |46-060 Prószków;489;175;175;4;171;35.79;2.29
98674;160910;Świetlica Wiejska|Złotniki|ul. Opolska 40 |46-060 Prószków;670;232;232;9;223;34.63;3.88
98675;160910;Sala Gminnego Zarządu TSKN Prószków|Prószków|ul. Zamkowa 2 |46-060 Prószków;1005;360;360;15;345;35.82;4.17
98676;160910;Dom Pomocy Społecznej|Prószków|ul. Zamkowa 8 |46-060 Prószków;111;52;52;19;33;46.85;36.54
98677;160911;Szkoła Podstawowa|Kąty Opolskie|ul. Szkolna 8 |46-050 Tarnów Opolski;744;257;257;12;245;34.54;4.67
98678;160911;Gminny Ośrodek Kultury - Filia Przywory|Przywory|ul. Wiejska 83 |46-050 Tarnów Opolski;921;390;390;10;380;42.35;2.56
98679;160911;Gminny Ośrodek Kultury - Filia Miedziana|Miedziana|ul. Wiejska 68 |46-050 Tarnów Opolski;507;200;200;7;193;39.45;3.50
98680;160911;Remiza OSP|Kosorowice|ul. Opolska 9a |46-050 Tarnów Opolski;773;274;274;6;268;35.45;2.19
98681;160911;Remiza OSP|Tarnów Opolski|ul. Księdza Klimasa 9 |46-050 Tarnów Opolski;1022;413;413;13;400;40.41;3.15
98682;160911;Publiczna Szkoła Podstawowa|Tarnów Opolski|ul. Kopernika 10 |46-050 Tarnów Opolski;988;415;415;11;404;42.00;2.65
98683;160911;Gminny Ośrodek Kultury|Tarnów Opolski|ul. Osiedle Zakładowe 7 |46-050 Tarnów Opolski;968;416;416;7;409;42.98;1.68
98684;160911;Szkoła Podstawowa|Nakło|ul. Strzelecka 51 |46-050 Tarnów Opolski;1199;342;342;8;334;28.52;2.34
98685;160911;Remiza OSP|Raszowa|ul. Ozimska 39 |46-050 Tarnów Opolski;627;200;200;8;192;31.90;4.00
98686;160912;Świetlica Wiejska w Szydłowie|Szydłów|ul. Kościelna 2 |49-130 Tułowice;357;148;148;10;138;41.46;6.76
98687;160912;Świetlica Wiejska w Skarbiszowicach|Skarbiszowice| 17 |49-130 Tułowice;177;81;81;8;73;45.76;9.88
98688;160912;Świetlica Wiejska w Goszczowicach|Goszczowice| 43a |49-130 Tułowice;221;96;96;11;85;43.44;11.46
98689;160912;Zespół Szkół w Tułowicach|Tułowice|ul. Zamkowa 15 |49-130 Tułowice;1049;540;540;14;526;51.48;2.59
98690;160912;Tułowicki Ośrodek Kultury w Tułowicach|Tułowice|ul. Generała Świerczewskiego 8 |49-130 Tułowice;1095;444;444;29;415;40.55;6.53
98691;160912;Gminny Zespół Szkół w Tułowicach|Tułowice|ul. Generała Świerczewskiego 21 |49-130 Tułowice;1343;634;634;27;607;47.21;4.26
98692;160913;Szkoła Podstawowa|Bierdzany|ul. Szkolna 1 |46-046 Ligota Turawska;776;177;177;3;174;22.81;1.69
98693;160913;Szkoła Podstawowa|Kadłub Turawski|ul. Główna 12 |46-046 Ligota Turawska;743;186;186;5;181;25.03;2.69
98694;160913;Budynek byłej Szkoły Podstawowej|Kotórz Mały|ul. 1 Maja 6 |46-045 Turawa;1094;480;480;19;461;43.88;3.96
98695;160913;Szkoła Podstawowa|Ligota Turawska|ul. Główna 32 |46-046 Ligota Turawska;609;139;139;8;131;22.82;5.76
98696;160913;Szkoła Podstawowa|Osowiec|ul. Fabryczna 1 |46-023 Osowiec;1148;442;442;9;433;38.50;2.04
98697;160913;Urząd Gminy|Turawa|ul. Opolska 39c |46-045 Turawa;957;462;462;11;451;48.28;2.38
98698;160913;Budynek byłej Szkoły Podstawowej|Zakrzów Turawski|ul. Główna 20 |46-046 Ligota Turawska;533;93;93;8;85;17.45;8.60
98699;160913;Szkoła Podstawowa|Zawada|ul. Kolanowska 4 |46-022 Luboszyce;1239;557;557;8;549;44.96;1.44
98700;160913;Remiza Ochotniczej Straży Pożarnej|Węgry|ul. Opolska 11a |46-023 Osowiec;813;370;370;14;356;45.51;3.78
98701;160913;Oddział Zewnętrzny Aresztu Śledczego w Opolu|Turawa|ul. Spacerowa 14 |46-045 Turawa;86;24;24;0;24;27.91;0.00
98702;161001;Publiczne Gimnazjum|Biała|ul. Tysiąclecia 16 |48-210 Biała;754;313;313;3;310;41.51;0.96
98703;161001;Urząd Miejski|Biała|ul. Rynek 10 |48-210 Biała;625;242;242;12;230;38.72;4.96
98704;161001;Gminne Centrum Kultury|Biała|ul. Prudnicka 35 |48-210 Biała;658;285;285;7;278;43.31;2.46
98705;161001;Wiejskie Centrum Kultury i Rekreacji|Chrzelice| 177 |48-220 Łącznik;516;164;164;8;156;31.78;4.88
98706;161001;Publiczne Gimnazjum|Łącznik|ul. Świerczewskiego 79 d |48-220 Łącznik;1179;460;460;15;445;39.02;3.26
98707;161001;Remiza OSP|Pogórze| 160a |48-220 Łącznik;957;230;230;7;223;24.03;3.04
98708;161001;Remiza OSP|Grabina| 62 |48-210 Biała;477;148;148;7;141;31.03;4.73
98709;161001;Sala Samorządu Mieszkańców|Ligota Bialska| 60 |48-210 Biała;754;174;174;8;166;23.08;4.60
98710;161001;Szkoła Podstawowa|Śmicz| 106 |48-210 Biała;492;191;191;5;186;38.82;2.62
98711;161001;Sala Samorządu Mieszkańców|Olbrachcice| 69 a |48-210 Biała;373;128;128;2;126;34.32;1.56
98712;161001;Szkoła Podstawowa|Gostomia| 46 a |48-210 Biała;349;116;116;6;110;33.24;5.17
98713;161001;Rolnicza Spółdzielnia Produkcyjna|Rostkowice| 38 |48-210 Biała;330;111;111;7;104;33.64;6.31
98714;161001;Remiza OSP|Nowa Wieś Prudnicka| 51 b |48-210 Biała;535;133;133;2;131;24.86;1.50
98715;161001;Sala Samorządu Mieszkańców|Solec| 36 |48-210 Biała;269;110;110;0;110;40.89;0.00
98716;161001;Sala Samorządu Mieszkańców|Prężyna| 70 a |48-210 Biała;238;63;63;3;60;26.47;4.76
98717;161001;Sala Samorządu Mieszkańców|Kolnowice| 76 |48-210 Biała;276;107;107;5;102;38.77;4.67
98718;161001;Dom Pomocy Społecznej|Grabina| 72 |48-210 Biała;48;12;12;2;10;25.00;16.67
98719;161001;Szpital w Białej|Biała|ul. Moniuszki 8 |48-120 Biała;51;35;35;7;28;68.63;20.00
98720;161002;Świetlica Oracze|Głogówek|ul. Głubczycka 45A |48-250 Głogówek;941;310;310;10;300;32.94;3.23
98721;161002;Miejsko-Gminny Ośrodek Kultury|Głogówek|ul. Batorego 10 |48-250 Głogówek;1470;607;607;27;580;41.29;4.45
98722;161002;Zespół Szkół|Głogówek|ul. Powstańców 34 |48-250 Głogówek;783;328;328;8;320;41.89;2.44
98723;161002;Straż Pożarna|Głogówek|ul. Dworcowa 9 |48-250 Głogówek;1403;480;480;15;465;34.21;3.12
98724;161002;Zespół Szkół|Racławice Śląskie|ul. Zwycięstwa 21 |48-250 Głogówek;1143;507;507;15;492;44.36;2.96
98725;161002;Straż Pożarna|Dzierżysławice| 21 |48-250 Głogówek;295;84;84;3;81;28.47;3.57
98726;161002;Świetlica Wiejska|Mochów| 84 |48-250 Głogówek;526;189;189;9;180;35.93;4.76
98727;161002;Straż Pożarna|Wierzch| 107 |48-250 Głogówek;500;183;183;12;171;36.60;6.56
98728;161002;Przedszkole|Zawada| 15 |48-250 Głogówek;340;77;77;0;77;22.65;0.00
98729;161002;Świetlica|Kierpień| 80A |48-250 Głogówek;493;119;119;6;113;24.14;5.04
98730;161002;Przedszkole|Szonów| 33 |48-250 Głogówek;504;197;197;13;184;39.09;6.60
98731;161002;Świetlica Wiejska|Kazimierz| 99 |48-250 Głogówek;389;136;136;9;127;34.96;6.62
98732;161002;Szkoła Podstawowa|Biedrzychowice| 110 |48-250 Głogówek;601;173;173;7;166;28.79;4.05
98733;161002;Przedszkole|Stare Kotkowice|ul. Sudecka 27 |48-250 Głogówek;321;110;110;0;110;34.27;0.00
98734;161002;Świetlica Wiejska|Wróblin| 47a |48-250 Głogówek;335;92;92;10;82;27.46;10.87
98735;161002;RSP Twardawa|Twardawa|ul. Spółdzielcza 16 |47-340 Twardawa;864;270;270;9;261;31.25;3.33
98736;161003;Niepubliczna Szkoła Podstawowa w Dytmarowie|Dytmarów| 1a 1|48-231 Lubrza;409;195;195;4;191;47.68;2.05
98737;161003;Świetlica Wiejska|Jasiona| 2A |48-200 Prudnik;207;99;99;4;95;47.83;4.04
98738;161003;Klub w Krzyżkowicach|Krzyżkowice| 49 6|48-231 Lubrza;166;67;67;3;64;40.36;4.48
98739;161003;Świetlica Wiejska w Laskowicach|Laskowice| 23 |48-231 Lubrza;150;65;65;1;64;43.33;1.54
98740;161003;Urząd Gminy w Lubrzy- świetlica na parterze|Lubrza|ul. Wolności 73 |48-231 Lubrza;788;386;386;15;371;48.98;3.89
98741;161003;Remiza Ochotniczej Straży Pożarnej|Nowy Browiniec| 10 |48-231 Lubrza;359;124;124;4;120;34.54;3.23
98742;161003;Wiejski Dom Kultury|Olszynka| 36b |48-231 Lubrza;216;73;73;4;69;33.80;5.48
98743;161003;Wiejski Dom Kultury|Prężynka| 2 |48-231 Lubrza;278;131;131;3;128;47.12;2.29
98744;161003;Wiejski Dom Kultury|Skrzypiec| 34 |48-231 Lubrza;320;144;144;3;141;45.00;2.08
98745;161003;Remiza Ochotniczej Straży Pożarnej|Trzebina| 125 |48-200 Prudnik;628;282;282;15;267;44.90;5.32
98746;161004;Centrum Tradycji Tkackich|Prudnik|ul. Królowej Jadwigi 23 |48-200 Prudnik;971;399;399;4;395;41.09;1.00
98747;161004;Publiczne Gimnazjum Nr 1|Prudnik|ul. Armii Krajowej 1 |48-200 Prudnik;904;326;326;16;310;36.06;4.91
98748;161004;Zespół Szkół Medycznych|Prudnik|ul. Piastowska 26 |48-200 Prudnik;1090;526;526;14;512;48.26;2.66
98749;161004;Szkoła Podstawowa Nr 4|Prudnik|ul. Dąbrowskiego 2 |48-200 Prudnik;1017;523;523;10;513;51.43;1.91
98750;161004;Publiczne Przedszkole Nr 7|Prudnik|ul. Ogrodowa 1 |48-200 Prudnik;856;290;290;7;283;33.88;2.41
98751;161004;Powiatowe Centrum Pomocy Rodzinie|Prudnik|ul. Kościuszki 55A |48-200 Prudnik;1177;671;671;5;666;57.01;0.75
98752;161004;Szkolne Schronisko Młodzieżowe|Prudnik|ul. Dąbrowskiego 26 |48-200 Prudnik;1037;568;568;6;562;54.77;1.06
98753;161004;Świetlica Spółdzielni Mieszkaniowej|Prudnik|ul. Wyszyńskiego 1a |48-200 Prudnik;1119;582;582;11;571;52.01;1.89
98754;161004;Zespół Szkół Ogólnokształcących Nr 1|Prudnik|ul. Gimnazjalna 2 |48-200 Prudnik;829;327;327;5;322;39.45;1.53
98755;161004;Specjalny Ośrodek Szkolno-Wychowawczy|Prudnik|ul. Młyńska 1 |48-200 Prudnik;995;358;358;20;338;35.98;5.59
98756;161004;Muzeum Ziemi Prudnickiej|Prudnik|ul. Chrobrego 5 |48-200 Prudnik;1128;414;414;10;404;36.70;2.42
98757;161004;Powiatowe Centrum Kształcenia Praktycznego|Prudnik|ul. Prężyńska 3-5-7 |48-200 Prudnik;1142;514;514;11;503;45.01;2.14
98758;161004;Centrum Kształcenia Zawodowego i Ustawicznego|Prudnik|ul. Podgórna 5 |48-200 Prudnik;1068;566;566;6;560;53.00;1.06
98759;161004;Żłobek|Prudnik|ul. Podgórna 9a |48-200 Prudnik;1210;636;636;11;625;52.56;1.73
98760;161004;Publiczne Przedszkole Nr 6|Prudnik|ul. Podgórna 9a |48-200 Prudnik;1219;622;622;16;606;51.03;2.57
98761;161004;Szkoła Podstawowa Nr 1|Prudnik|ul. Podgórna 9 |48-200 Prudnik;1232;647;647;13;634;52.52;2.01
98762;161004;Szkoła Podstawowa|Łąka Prudnicka|ul. Głuchołaska 13 |48-200 Prudnik;1149;562;562;14;548;48.91;2.49
98763;161004;Szkoła Podstawowa|Moszczanka| 166 |48-200 Prudnik;867;428;428;10;418;49.37;2.34
98764;161004;Wiejski Dom Kultury|Czyżowice| 57 |48-200 Prudnik;238;126;126;1;125;52.94;0.79
98765;161004;Publiczne Przedszkole|Niemysłowice| 37 |48-200 Prudnik;535;267;267;8;259;49.91;3.00
98766;161004;Wiejski Dom Kultury|Mieszkowice| 145 |48-200 Prudnik;362;152;152;2;150;41.99;1.32
98767;161004;Wiejski Dom Kultury|Piorunkowice| 53 |48-200 Prudnik;169;78;78;5;73;46.15;6.41
98768;161004;Szkoła Podstawowa|Rudziczka| 266 |48-200 Prudnik;685;312;312;9;303;45.55;2.88
98769;161004;Szkoła Podstawowa|Szybowice| 72 |48-200 Prudnik;809;372;372;4;368;45.98;1.08
98770;161004;Wiejski Dom Kultury|Wierzbiec| 5 |48-200 Prudnik;166;58;58;2;56;34.94;3.45
98771;161004;Prudnickie Centrum Medyczne|Prudnik|ul. Piastowska 64 |48-200 Prudnik;49;25;25;0;25;51.02;0.00
98772;161004;Dom Pomocy Społecznej|Prudnik|ul. Młyńska 11 |48-200 Prudnik;74;50;50;4;46;67.57;8.00
98773;161004;Areszt Śledczy|Prudnik|ul. Kościuszki 7 |48-200 Prudnik;131;84;84;9;75;64.12;10.71
98774;161101;Zespół Szkół Gminy Izbicko Szkoła Podstawowa w Izbicku|Izbicko|ul. 15-go Grudnia 32 |47-180 Izbicko;722;333;333;16;317;46.12;4.80
98775;161101;Zespół Szkół Gminy Izbicko Szkoła Podstawowa w Krośnicy|Krośnica|ul. Szkolna 18 |47-180 Izbicko;1039;417;417;23;394;40.13;5.52
98776;161101;Klub przy OSP w Siedlcu|Siedlec|ul. Wiejska 30 |47-180 Izbicko;687;211;211;13;198;30.71;6.16
98777;161101;Zespół Szkół Gminy Izbicko Szkoła Podstawowa w Otmicach|Otmice|ul. Zawadzkiego 28 |47-180 Izbicko;951;348;348;7;341;36.59;2.01
98778;161101;Klub Wiejski w Suchodańcu|Suchodaniec|ul. Buczka 2 |47-180 Izbicko;401;148;148;2;146;36.91;1.35
98779;161101;Zespół Szkół Gminy Izbicko Szkoła Podstawowa w Izbicku|Izbicko|15-go Grudnia 32 |47-180 Izbicko;630;257;257;11;246;40.79;4.28
98780;161102;Publiczna Szkoła Podstawowa|Jemielnica|ul. Szkolna 2 |47-133 Jemielnica;1229;401;401;10;391;32.63;2.49
98781;161102;Publiczne Gimnazjum|Jemielnica|ul. Szkolna 2a |47-133 Jemielnica;1693;549;549;21;528;32.43;3.83
98782;161102;Publiczna Szkoła Podstawowa|Piotrówka|ul. Kościuszki 98 |47-133 Jemielnica;1086;387;387;21;366;35.64;5.43
98783;161102;Świetlica Wiejska|Centawa|ul. Powstańców Śląskich 13 |47-134 Błotnica Strzelecka;431;145;145;10;135;33.64;6.90
98784;161102;Świetlica Wiejska|Barut|ul. Wiejska 65 |47-133 Jemielnica;447;109;109;7;102;24.38;6.42
98785;161102;Świetlica Wiejska|Gąsiorowice|ul. Szkolna 17 |47-133 Jemielnica;562;179;179;6;173;31.85;3.35
98786;161102;Świetlica Wiejska|Łaziska|ul. Strzelecka 37 |47-133 Jemielnica;512;160;160;3;157;31.25;1.88
98787;161103;Szkoła Podstawowa|Kolonowskie|ul. 1Maja 5 |47-110 Kolonowskie;966;379;379;14;365;39.23;3.69
98788;161103;Świetlica OSP|Kolonowskie|ul. Leśna 6b |47-110 Kolonowskie;980;348;348;13;335;35.51;3.74
98789;161103;Szkoła Podstawowa|Kolonowskie|ul. Jana Pawła II 4 |47-113 Kolonowskie;781;261;261;8;253;33.42;3.07
98790;161103;Dom Aktywności Wiejskiej|Spórok|ul. Guznera 3 |47-175 Kadłub;485;128;128;4;124;26.39;3.12
98791;161103;Szkoła Podstawowa|Staniszcze Małe|ul. Szkolna 1 |47-113 Kolonowskie;905;323;323;17;306;35.69;5.26
98792;161103;Publiczne Przedszkole|Staniszcze Wielkie|ul. Kościelna 15 |47-113 Kolonowskie;843;269;269;11;258;31.91;4.09
98793;161104;Urząd Miejski|Leśnica|ul. 1 Maja 9 |47-150 Leśnica;1293;555;555;31;524;42.92;5.59
98794;161104;Szkoła Podstawowa|Leśnica|ul. Zdzieszowicka 23 |47-150 Leśnica;976;452;452;22;430;46.31;4.87
98795;161104;Remiza OSP|Wysoka|ul. Strzelecka 67 |47-150 Leśnica;662;324;324;10;314;48.94;3.09
98796;161104;Publiczne Przedszkole w Leśnicy - Oddział Zamiejscowy w Dolnej|Dolna|ul. Wiejska 30 |47-100 Strzelce Opolskie;391;126;126;7;119;32.23;5.56
98797;161104;Klub Wiejski|Kadłubiec|ul. Wiejska 93 |47-150 Leśnica;328;106;106;6;100;32.32;5.66
98798;161104;Zespół Szkolno-Przedszkolny|Zalesie Śląskie|ul. Dworcowa 4 |47-150 Leśnica;1374;463;463;21;442;33.70;4.54
98799;161104;Zespół Szkolno-Przedszkolny|Raszowa|ul. Góry Świętej Anny 91 |47-150 Leśnica;1360;468;468;22;446;34.41;4.70
98800;161104;Dom Pomocy Społecznej w Strzelcach Opolskich - Filia w Leśnicy|Leśnica|ul. Szpitalna 20 |47-150 Leśnica;57;33;33;2;31;57.89;6.06
98801;161105;Centrum Kształcenia Zawodowego i Ustawicznego|Strzelce Opolskie|ul. Powstańców Śląskich 3 |47-100 Strzelce Opolskie;1200;538;538;14;524;44.83;2.60
98802;161105;Strzelecki Ośrodek Kultury|Strzelce Opolskie|Plac Stefana Żeromskiego 7 |47-100 Strzelce Opolskie;1120;483;483;12;471;43.12;2.48
98803;161105;Stołówka OPS|Strzelce Opolskie|ul. Jarosława Dąbrowskiego 10 |47-100 Strzelce Opolskie;463;178;178;7;171;38.44;3.93
98804;161105;Publiczne Gimnazjum Nr 2|Strzelce Opolskie|ul. Kozielska 34 |47-100 Strzelce Opolskie;644;272;272;7;265;42.24;2.57
98805;161105;Zespół Szkół Ogólnokształcących|Strzelce Opolskie|ul. Krakowska 38 |47-100 Strzelce Opolskie;1153;562;562;10;552;48.74;1.78
98806;161105;Państwowa Szkoła Muzyczna I-go stopnia|Strzelce Opolskie|ul. Jana Matejki 1 |47-100 Strzelce Opolskie;425;111;111;3;108;26.12;2.70
98807;161105;Świetlica Wiejska|Szczepanek|ul. Strzelecka 101 |47-100 Strzelce Opolskie;599;250;250;3;247;41.74;1.20
98808;161105;Publiczna Szkoła Podstawowa Nr 2|Strzelce Opolskie|ul. Wawrzyńca Świerzego 3 |47-100 Strzelce Opolskie;1058;427;427;8;419;40.36;1.87
98809;161105;Publiczna Szkoła Podstawowa Nr 1|Strzelce Opolskie|ul. Marka Prawego 19 |47-100 Strzelce Opolskie;1148;540;540;7;533;47.04;1.30
98810;161105;Publiczne Gimnazjum Nr 1|Strzelce Opolskie|ul. Sosnowa 3 |47-100 Strzelce Opolskie;1215;557;557;8;549;45.84;1.44
98811;161105;Publiczne Gimnazjum Nr 1|Strzelce Opolskie|ul. Sosnowa 3 |47-100 Strzelce Opolskie;1120;436;436;7;429;38.93;1.61
98812;161105;Publiczna Szkoła Podstawowa Nr 7|Strzelce Opolskie|ul. Kardynała Stefana Wyszyńskiego 2 |47-100 Strzelce Opolskie;1259;704;704;11;693;55.92;1.56
98813;161105;Publiczne Przedszkole Nr 8|Strzelce Opolskie|ul. Kardynała Stefana Wyszyńskiego 6 |47-100 Strzelce Opolskie;1270;473;473;10;463;37.24;2.11
98814;161105;Żłobek|Strzelce Opolskie|ul. Kardynała Stefana Wyszyńskiego 14 |47-100 Strzelce Opolskie;1205;621;621;18;603;51.54;2.90
98815;161105;Publiczne Przedszkole Nr 9|Strzelce Opolskie|ul. Kardynała Stefana Wyszyńskiego 12 |47-100 Strzelce Opolskie;1193;586;586;14;572;49.12;2.39
98816;161105;Publiczna Szkoła Podstawowa|Dziewkowice|ul. Strzelecka 3 |47-100 Strzelce Opolskie;1199;435;435;13;422;36.28;2.99
98817;161105;Przedszkole Publiczne w Dziewkowicach Oddział Zamiejscowy|Warmątowice|ul. Błotnicka 6 |47-100 Strzelce Opolskie;481;170;170;1;169;35.34;0.59
98818;161105;Publiczna Szkoła Podstawowa|Błotnica Strzelecka|ul. Toszecka 19 |47-100 Strzelce Opolskie;951;316;316;11;305;33.23;3.48
98819;161105;Niepubliczna Szkoła Podstawowa|Grodzisko|ul. Główna 35 |47-100 Strzelce Opolskie;563;190;190;10;180;33.75;5.26
98820;161105;Zespół Placówek Oświatowych w Kadłubie Przedszkole Publiczne|Osiek|ul. Strzelecka 1 |47-100 Strzelce Opolskie;342;107;107;6;101;31.29;5.61
98821;161105;Zespół Placówek Oświatowych Publiczna Szkoła Podstawowa|Kalinowice|ul. Szkolna 1 |47-100 Strzelce Opolskie;800;247;247;9;238;30.88;3.64
98822;161105;Publiczna Szkoła Podstawowa|Szymiszów|ul. Wolności 1 |47-100 Strzelce Opolskie;632;218;218;4;214;34.49;1.83
98823;161105;Świetlica Wiejska|Rożniątów|ul. Wolności 28 |47-100 Strzelce Opolskie;718;234;234;10;224;32.59;4.27
98824;161105;Publiczna Szkoła Podstawowa|Sucha|ul. Kościelna 40 |47-100 Strzelce Opolskie;563;225;225;9;216;39.96;4.00
98825;161105;Publiczne Gimnazjum|Szymiszów|ul. Szkolna 2 |47-100 Strzelce Opolskie;816;270;270;14;256;33.09;5.19
98826;161105;Publiczna Szkoła Podstawowa|Rozmierka|ul. Szkolna 3 |47-100 Strzelce Opolskie;917;260;260;6;254;28.35;2.31
98827;161105;Świetlica Wiejska|Rozmierz|ul. Wyzwolenia 10 |47-100 Strzelce Opolskie;372;142;142;7;135;38.17;4.93
98828;161105;Zespół Placówek Oświatowych Publiczna Szkoła Podstawowa|Kadłub|ul. Powstańców Śląskich 26 |47-100 Strzelce Opolskie;1208;341;341;5;336;28.23;1.47
98829;161105;Dom Pomocy Społecznej w Strzelcach Opolskich|Strzelce Opolskie|ul. Strażacka 8 |47-100 Strzelce Opolskie;50;21;21;2;19;42.00;9.52
98830;161105;Dom Pomocy Społecznej w Strzelcach Opolskich Filia w Szymiszowie|Szymiszów|ul. Strzelecka 2 |47-100 Strzelce Opolskie;106;43;43;7;36;40.57;16.28
98831;161105;Szpital Powiatowy w Strzelcach Opolskich|Strzelce Opolskie|ul. Opolska 36 |47-100 Strzelce Opolskie;104;22;22;3;19;21.15;13.64
98832;161105;Zakład Karny Nr 1|Strzelce Opolskie|ul. Karola Miarki 1 |47-100 Strzelce Opolskie;952;342;342;48;294;35.92;14.04
98833;161105;Zakład Karny Nr 2|Strzelce Opolskie|ul. Gen. Karola Świerczewskiego 3 |47-100 Strzelce Opolskie;563;188;188;20;168;33.39;10.64
98834;161106;Sala Posiedzeń Urzędu Miejskiego|Ujazd|ul. Sławięcicka 19 |47-143 Ujazd;1388;636;636;29;607;45.82;4.56
98835;161106;Szkoła Podstawowa|Olszowa|ul. Szkolna 7 |47-143 Ujazd;395;118;118;4;114;29.87;3.39
98836;161106;Szkoła Podstawowa|Jaryszów|ul. Stawowa 1 |47-143 Ujazd;861;342;342;16;326;39.72;4.68
98837;161106;Filialna Szkoła Podstawowa|Zimna Wódka|ul. Strzelecka 2 |47-143 Ujazd;748;222;222;12;210;29.68;5.41
98838;161106;Świetlica Wiejska|Sieroniowice|ul. Strzelecka 29 |47-143 Ujazd;736;248;248;8;240;33.70;3.23
98839;161106;Filialna Szkoła Podstawowa|Stary Ujazd|ul. Szkolna 3 |47-143 Ujazd;492;195;195;18;177;39.63;9.23
98840;161106;Budynek Kulturalno - Oświatowy|Niezdrowice|ul. Wiejska 34 |47-143 Ujazd;483;196;196;7;189;40.58;3.57
98841;161107;Kinoteatr|Zawadzkie|ul. Dworcowa 3a |47-120 Zawadzkie;1840;578;578;17;561;31.41;2.94
98842;161107;Ośrodek Pomocy Społecznej|Zawadzkie|ul. Dębowa 11 |47-120 Zawadzkie;1891;734;734;23;711;38.82;3.13
98843;161107;Przedszkole Publiczne Nr 2 z Oddziałem Integracyjnym|Zawadzkie|ul. Paderewskiego 1 |47-120 Zawadzkie;1312;614;614;7;607;46.80;1.14
98844;161107;Publiczne Gimnazjum Nr 1|Zawadzkie|ul. Opolska 47 |47-120 Zawadzkie;1142;376;376;29;347;32.92;7.71
98845;161107;Zespół Szkolno-Gimnazjalny|Żędowice|ul. Strzelecka 35 |47-120 Zawadzkie;1974;672;672;38;634;34.04;5.65
98846;161107;Zabytkowa Chata|Kielcza|ul. Dobrego Pasterza 35 |47-126 Kielcza;1580;568;568;30;538;35.95;5.28
98847;166101;Remiza OSP|Opole|ul. Wrocławska 190 |45-834 Opole;443;264;264;5;259;59.59;1.89
98848;166101;Publiczna Szkoła Podstawowa Nr 9|Opole|ul. Cmentarna 7 |45-834 Opole;1127;637;637;14;623;56.52;2.20
98849;166101;Publiczna Szkoła Podstawowa Nr 9|Opole|Cmentarna 7 |45-834 Opole;1478;970;970;3;967;65.63;0.31
98850;166101;Publiczna Szkoła Podstawowa Nr 14 (wejście od strony sali gimnastycznej)|Opole|ul. Szymona Koszyka 21 |45-720 Opole;764;476;476;3;473;62.30;0.63
98851;166101;Publiczna Szkoła Podstawowa Nr 14 (wejście główne)|Opole|ul. Szymona Koszyka 21 |45-720 Opole;1306;846;846;2;844;64.78;0.24
98852;166101;Zespół Szkół Budowlanych|Opole|ul. Niemodlińska 40 |45-710 Opole;1091;694;694;7;687;63.61;1.01
98853;166101;Publiczna Szkoła Podstawowa Nr 8|Opole|ul. Księdza Norberta Bonczyka 13 |45-705 Opole;1880;986;995;17;969;52.45;1.72
98854;166101;Publiczna Szkoła Podstawowa Nr 8|Opole|ul. Księdza Norberta Bonczyka 13 |45-705 Opole;1607;856;887;11;845;53.27;1.29
98855;166101;Zespół Szkół Ogólnokształcących Nr I|Opole|ul. Licealna 3 |45-706 Opole;1470;796;796;15;781;54.15;1.88
98856;166101;Zespół Szkół Specjalnych|Opole|ul. Książąt Opolskich 21 |45-005 Opole;1531;809;809;13;796;52.84;1.61
98857;166101;Oddział Przedszkola Publicznego Nr 8|Opole|ul. Gminna 1 |45-128 Opole;722;325;325;8;317;45.01;2.46
98858;166101;Publiczna Szkoła Podstawowa Nr 7|Opole|ul. Budowlanych 40 |45-123 Opole;1122;509;509;13;496;45.37;2.55
98859;166101;Publiczne Gimnazjum Nr 7|Opole|ul. Oleska 68 |45-222 Opole;1853;1136;1136;12;1124;61.31;1.06
98860;166101;Zespół Szkół Ogólnokształcących Nr II|Opole|ul. Generała Kazimierza Pułaskiego 3 |45-048 Opole;1290;661;661;14;647;51.24;2.12
98861;166101;Przedszkole Publiczne Integracyjne Nr 51|Opole|ul. Jana Bytnara "Rudego" 1 |45-265 Opole;1460;949;949;21;928;65.00;2.21
98862;166101;Przedszkole Publiczne Nr 26|Opole|ul. Chabrów 56 |45-222 Opole;1336;821;821;13;808;61.45;1.58
98863;166101;Publiczna Szkoła Podstawowa Nr 11|Opole|ul. Chabrów 65 |45-221 Opole;1911;1129;1129;18;1111;59.08;1.59
98864;166101;Publiczna Szkoła Podstawowa Nr 25|Opole|ul. Wiejska 77 |45-240 Opole;1426;743;743;13;730;52.10;1.75
98865;166101;Przedszkole Publiczne Nr 56|Opole|ul. Sieradzka 7 |45-304 Opole;1911;1115;1115;20;1095;58.35;1.79
98866;166101;Przedszkole Publiczne Nr 56|Opole|ul. Sieradzka 7 |45-304 Opole;1668;1014;1014;15;999;60.79;1.48
98867;166101;Przedszkole Publiczne Nr 4|Opole|ul. Bielska 23 |45-401 Opole;1798;1172;1172;3;1169;65.18;0.26
98868;166101;Przedszkole Publiczne Nr 4|Opole|ul. Bielska 23 |45-401 Opole;2045;1315;1315;18;1297;64.30;1.37
98869;166101;Przedszkole Publiczne Nr 37 "Elemelek"|Opole|ul. Jesionowa 8 |45-409 Opole;1603;964;964;14;950;60.14;1.45
98870;166101;Publiczna Szkoła Podstawowa Nr 20|Opole|ul. Grudzicka 48 |45-432 Opole;1972;1180;1180;12;1168;59.84;1.02
98871;166101;Publiczna Szkoła Podstawowa Nr 20|Opole|ul. Grudzicka 48 |45-432 Opole;1522;868;868;14;854;57.03;1.61
98872;166101;Publiczna Szkoła Podstawowa Nr 15|Opole|ul. Małopolska 20 |45-301 Opole;1167;766;766;2;764;65.64;0.26
98873;166101;Miejski Ośrodek Pomocy Rodzinie w Opolu|Opole|ul. Armii Krajowej 36 |45-071 Opole;1763;941;941;11;930;53.37;1.17
98874;166101;Publiczna Szkoła Podstawowa Nr 26|Opole|ul. Groszowicka 12 |45-517 Opole;2433;1414;1414;26;1388;58.12;1.84
98875;166101;Filia Przedszkola Publicznego Nr 33|Opole|ul. Olimpijska 2 |45-681 Opole;1017;398;398;15;383;39.13;3.77
98876;166101;Narodowe Centrum Polskiej Piosenki - Klub Osiedlowy "METALCHEM"|Opole|ul. Oświęcimska 90 |45-641 Opole;1381;680;680;13;667;49.24;1.91
98877;166101;Przedszkole Publiczne Nr 44|Opole|ul. Oświęcimska 94 |45-641 Opole;1186;602;602;8;594;50.76;1.33
98878;166101;Publiczna Szkoła Podstawowa Nr 24|Opole|ul. Wiktora Gorzołki 4 |45-627 Opole;1259;466;466;9;457;37.01;1.93
98879;166101;Publiczna Szkoła Podstawowa Nr 24|Opole|ul. Wiktora Gorzołki 4 |45-627 Opole;1108;463;463;10;453;41.79;2.16
98880;166101;Zespół Szkolno-Przedszkolny Nr 2|Opole|ul. Zofii Nałkowskiej 16 |45-558 Opole;2309;1107;1107;11;1096;47.94;0.99
98881;166101;Filia Młodzieżowego Domu Kultury Nr 3|Opole|Al. Przyjaźni 12 |45-573 Opole;1182;577;577;14;563;48.82;2.43
98882;166101;Publiczna Szkoła Podstawowa Nr 1|Opole|ul. Władysława Reymonta 43 |45-072 Opole;1785;911;911;16;895;51.04;1.76
98883;166101;Zespół Szkół Elektrycznych|Opole|ul. Tadeusz Kościuszki 39-41 |45-062 Opole;2005;1083;1083;7;1076;54.01;0.65
98884;166101;Publiczne Gimnazjum Nr 5|Opole|ul. Ozimska 48A |45-368 Opole;2005;1084;1084;10;1074;54.06;0.92
98885;166101;Publiczne Gimnazjum Nr 4|Opole|ul. 1 Maja 151 |45-356 Opole;1995;957;957;17;940;47.97;1.78
98886;166101;Zespół Szkolno-Przedszkolny Nr 1|Opole|ul. Bogumiła Wyszomirskiego 6 |45-776 Opole;1020;467;467;15;452;45.78;3.21
98887;166101;Publiczna Szkoła Podstawowa Nr 10|Opole|ul. Walerego Wróblewskiego 7 |45-760 Opole;1334;742;742;11;731;55.62;1.48
98888;166101;Publiczna Szkoła Podstawowa Nr 10|Opole|ul. Walerego Wróblewskiego 7 |45-760 Opole;1253;832;832;9;823;66.40;1.08
98889;166101;Publiczne Gimnazjum Nr 8|Opole|ul. Joachima Lelewela 9 |45-856 Opole;1817;1096;1096;16;1080;60.32;1.46
98890;166101;Publiczne Gimnazjum Nr 8|Opole|ul. Joachima Lelewela 9 |45-856 Opole;1594;870;870;16;854;54.58;1.84
98891;166101;Zespół Szkół Technicznych i Ogólnokształcących|Opole|ul. Józefa Hallera 6 |45-867 Opole;1561;967;967;8;959;61.95;0.83
98892;166101;Przedszkole Publiczne Nr 43|Opole|ul. Prószkowska 5A |45-710 Opole;1190;772;772;11;761;64.87;1.42
98893;166101;Centrum Nauk Przyrodniczych w Publicznym Gimnazjum Nr 6|Opole|ul. Powstańców Śląskich 19 |45-086 Opole;1300;824;824;12;812;63.38;1.46
98894;166101;Publiczna Szkoła Podstawowa Nr 1|Opole|ul. Władysława Reymonta 43 |45-072 Opole;1146;590;590;9;581;51.48;1.53
98895;166101;Zespół Szkół Mechanicznych|Opole|ul. Edmunda Osmańczyka 22 |45-027 Opole;1529;804;804;11;793;52.58;1.37
98896;166101;Urząd Miasta Opola - Wydział Oświaty|Opole|ul. Henryka Sienkiewicza 6 |45-037 Opole;1717;954;954;11;943;55.56;1.15
98897;166101;Zespół Szkół Elektrycznych|Opole|ul. Tadeusza Kościuszki 39-41 |45-062 Opole;2051;1171;1171;8;1163;57.09;0.68
98898;166101;Zespół Szkół Ogólnokształcących Nr II|Opole|ul. Generała Kazimierza Pułaskiego 3 |45-048 Opole;1422;868;868;8;860;61.04;0.92
98899;166101;Publiczne Gimnazjum Nr 5|Opole|ul. Ozimska 48A |45-368 Opole;1504;827;827;9;818;54.99;1.09
98900;166101;Przedszkole Publiczne Nr 21|Opole|ul. Wojciecha Drzymały 28 |45-342 Opole;1372;745;745;13;732;54.30;1.74
98901;166101;Zespół Szkół z Oddziałami Integracyjnymi Publiczna Szkoła Podstawowa Nr 5|Opole|ul. Majora "Hubala" 2 |45-267 Opole;1535;980;980;11;969;63.84;1.12
98902;166101;Publiczne Przedszkole Nr 54 w Opolu|Opole|ul. Majora ''Hubala'' 19 |45-266 Opole;980;552;552;6;546;56.33;1.09
98903;166101;Publiczne Przedszkole Nr 54|Opole|ul. Majora "Hubala'' 19 |45-266 Opole;1878;1061;1061;10;1051;56.50;0.94
98904;166101;MOPR - Dom Dziennego Pobytu|Opole|ul. Majora "Hubala" 4 |45-267 Opole;1566;1024;1024;8;1016;65.39;0.78
98905;166101;Zespół Szkół z Oddziałami Integracyjnymi Publiczne Gimnazjum Nr 1|Opole|ul. Majora "Hubala" 2 |45-267 Opole;976;600;600;3;597;61.48;0.50
98906;166101;Filia Młodzieżowego Domu Kultury Nr 1|Opole|ul. Skautów Opolskich 10 |45-287 Opole;1386;883;883;14;869;63.71;1.59
98907;166101;Publiczna Szkoła Podstawowa Nr 15|Opole|ul. Małopolska 20 |45-301 Opole;1365;827;827;7;820;60.59;0.85
98908;166101;Publiczna Szkoła Podstawowa Nr 15|Opole|ul. Małopolska 20 |45-301 Opole;1493;985;985;24;961;65.97;2.44
98909;166101;Publiczna Szkoła Podstawowa Nr 29|Opole|ul. Szarych Szeregów 1 |45-284 Opole;1590;1012;1012;22;990;63.65;2.17
98910;166101;Centrum Ginekologii, Położnictwa i Neonatologii w Opolu|Opole|ul. Władysława Reymonta 8 |45-066 Opole;48;37;37;1;36;77.08;2.70
98911;166101;Publiczny Samodzielny Zakład Opieki Zdrowotnej - Wojewódzkie Centrum Medyczne|Opole|Al. Wincentego Witosa 26 |45-418 Opole;129;44;44;1;43;34.11;2.27
98912;166101;Szpital Wojewódzki|Opole|ul. Augustyna Kośnego 52 |45-372 Opole;270;69;69;2;67;25.56;2.90
98913;166101;Wojewódzki Specjalistyczny Zespół Neuropsychiatryczny|Opole|ul. Wodociągowa 4 |45-221 Opole;167;20;20;0;20;11.98;0.00
98914;166101;Samodzielny Publiczny Zakład Opieki Zdrowotnej Ministerstwa Spraw Wewnętrznych w Opolu|Opole|ul. Krakowska 44 |45-075 Opole;36;17;17;0;17;47.22;0.00
98915;166101;Dom Pomocy Społecznej dla Kombatantów|Opole|ul. Chmielowicka 6 |45-738 Opole;132;72;72;9;63;54.55;12.50
98916;166101;Zakład Karny|Opole|ul. Partyzancka 72 |45-853 Opole;110;52;52;4;48;47.27;7.69
98917;166101;Areszt Śledczy|Opole|ul. Sądowa 4 |45-733 Opole;295;136;136;32;104;46.10;23.53
98918;166101;Samodzielny Publiczny Zakład Opieki Zdrowotnej - Opolskie Centrum Onkologii|Opole|ul. Katowicka 66A |45-060 Opole;67;38;38;0;38;56.72;0.00
98919;166101;Dom Studencki "Niechcic"|Opole|Katowicka 87B |45-061 Opole;76;70;70;2;68;92.11;2.86
98920;180103;Urząd Gminy w Czarnej - sala posiedzeń|Czarna Górna| 74 |38-710 Czarna;1014;387;387;8;379;38.17;2.07
98921;180103;Świetlica wiejska w Czarnej Dolnej|Czarna Dolna| 32 |38-710 Czarna;303;95;95;3;92;31.35;3.16
98922;180103;Świetlica wiejska w Polanie|Polana| 33 |38-710 Czarna;311;157;157;4;153;50.48;2.55
98923;180103;Remizo-świetlica w Michniowcu|Michniowiec| 4 |38-710 Czarna;328;92;92;6;86;28.05;6.52
98924;180105;Gminny Ośrodek Kultury w Lutowiskach|Lutowiska| 74A |38-713 Lutowiska;797;308;308;9;299;38.64;2.92
98925;180105;Szkolne Schronisko Młodzieżowe w Stuposianach|Stuposiany| 9 |38-713 Lutowiska;452;215;215;6;209;47.57;2.79
98926;180105;Remiza Strażacka w Dwerniku|Dwernik| 34 |38-713 Lutowiska;216;88;88;1;87;40.74;1.14
98927;180105;Świetlica wiejska w Chmielu|Chmiel| 16A |38-713 Lutowiska;331;89;89;4;85;26.89;4.49
98928;180108;Przedszkole Nr 2|Ustrzyki Dolne|ul. 29 Listopada 49 |38-700 Ustrzyki Dolne;885;364;364;9;355;41.13;2.47
98929;180108;Szkoła Podstawowa Nr 1|Ustrzyki Dolne|ul. 29 Listopada 21 |38-700 Ustrzyki Dolne;827;364;364;20;344;44.01;5.49
98930;180108;Świetlica Nadleśnictwa Ustrzyki Dolne|Ustrzyki Dolne|ul. Rynek 6 |38-700 Ustrzyki Dolne;1023;411;411;14;397;40.18;3.41
98931;180108;Szkoła Podstawowa Nr 2|Ustrzyki Dolne|ul. Dobra 6 |38-700 Ustrzyki Dolne;1055;520;520;8;512;49.29;1.54
98932;180108;Bieszczadzki Zespół Placówek Szkolno-Wychowawczych|Ustrzyki Dolne|ul. Witolda Gombrowicza 37 |38-700 Ustrzyki Dolne;924;450;450;16;434;48.70;3.56
98933;180108;Zespół Basenów "Delfin"|Ustrzyki Dolne|ul. Witolda Gombrowicza 49 |38-700 Ustrzyki Dolne;730;294;294;12;282;40.27;4.08
98934;180108;Przedszkole Nr 1|Ustrzyki Dolne|Pionierska 8 |38-700 Ustrzyki Dolne;1263;623;623;14;609;49.33;2.25
98935;180108;Kawiarnia "Orlik"|Ustrzyki Dolne|PCK 22 |38-700 Ustrzyki Dolne;872;343;343;10;333;39.33;2.92
98936;180108;Szkoła Podstawowa w Łobozewie Dolnym|Łobozew Dolny| 61A |38-700 Ustrzyki Dolne;649;196;196;5;191;30.20;2.55
98937;180108;Szkoła Podstawowa w Ustjanowej Górnej|Ustjanowa Górna| 84 |38-700 Ustrzyki Dolne;829;340;340;8;332;41.01;2.35
98938;180108;Budynek byłej Szkoły Podstawowej w Równi|Równia| 53 |38-700 Ustrzyki Dolne;520;204;204;11;193;39.23;5.39
98939;180108;Filia ZSP Nr 1 w Bandrowie Narodowym|Bandrów Narodowy| 52 |38-700 Ustrzyki Dolne;338;106;106;7;99;31.36;6.60
98940;180108;Szkoła Podstawowa w Hoszowie|Hoszów| 31 |38-700 Ustrzyki Dolne;553;244;245;7;237;44.12;2.87
98941;180108;Dom Pomocy Społecznej w Moczarach|Moczary| 41 |38-700 Ustrzyki Dolne;211;39;39;3;36;18.48;7.69
98942;180108;Świetlica w Brzegach Dolnych|Brzegi Dolne| 46 |38-700 Ustrzyki Dolne;327;153;153;8;145;46.79;5.23
98943;180108;Szkoła Podstawowa w Łodynie|Łodyna| 41 |38-700 Ustrzyki Dolne;482;171;171;4;167;35.48;2.34
98944;180108;Budymek byłej Szkoły Podstawowej w Krościenku|Krościenko| 198 |38-700 Ustrzyki Dolne;608;177;177;9;168;29.11;5.08
98945;180108;Gimnazjum w Wojtkówce|Wojtkówka| 26 |38-712 Wojtkowa;404;156;156;4;152;38.61;2.56
98946;180108;Szkoła Podstawowa w Wojtkowej|Wojtkowa| 40 |38-712 Wojtkowa;511;196;196;8;188;38.36;4.08
98947;180108;Szkoła Podstawowa w Ropience|Ropienka| 111 |38-711 Ropienka;902;394;394;15;379;43.68;3.81
98948;180108;Świetlica w Brelikowie|Brelików| 38 |38-711 Ropienka;250;90;90;3;87;36.00;3.33
98949;180108;Szpital Ogólny SP ZOZ w Ustrzykach Dolnych|Ustrzyki Dolne|29 Listopada 57 |38-700 Ustrzyki Dolne;70;40;40;1;39;57.14;2.50
98950;180201;Urząd Miejski w Brzozowie (I piętro, pok. nr 117)|Brzozów|ul. Armii Krajowej 1 |36-200 Brzozów;2173;1032;1032;33;999;47.49;3.20
98951;180201;Ratusz Miejski (I piętro)|Brzozów|ul. Rynek 10 |36-200 Brzozów;1909;890;890;17;873;46.62;1.91
98952;180201;Budynek Administracyjny Szpitala Specjalistycznego w Brzozowie (świetlica)|Brzozów|ul. Ks. J. Bielawskiego 18 |36-200 Brzozów;1998;1011;1011;29;982;50.60;2.87
98953;180201;Zespół Szkół Nr 2 w Humniskach|Humniska| 877 |36-206 Humniska;1292;553;553;13;540;42.80;2.35
98954;180201;Zespół Szkół Nr 1 w Humniskach|Humniska| 264 |36-206 Humniska;1587;689;689;19;670;43.42;2.76
98955;180201;Zespół Szkół Nr 1 w Humniskach|Humniska| 264 |36-206 Humniska;800;335;335;10;325;41.88;2.99
98956;180201;Dom Strażaka w Grabownicy Starzeńskiej (parter)|Grabownica Starzeńska| 749 |36-207 Grabownica Starzeńska;1304;603;603;20;583;46.24;3.32
98957;180201;Dom Strażaka w Grabownicy Starzeńskiej (Ipiętro)|Grabownica Starzeńska| 749 |36-207 Grabownica Starzeńska;1210;501;501;23;478;41.40;4.59
98958;180201;Zespół Szkół w Górkach|Górki| 78 |36-200 Brzozów;1243;510;510;20;490;41.03;3.92
98959;180201;Zespół Szkół w Turzym Polu|Turze Pole| 152 |36-200 Brzozów;840;363;363;12;351;43.21;3.31
98960;180201;Szkoła Podstawowa w Zmiennicy|Zmiennica| 29 |36-200 Brzozów;961;424;424;16;408;44.12;3.77
98961;180201;Zespół Szkół w Starej Wsi|Stara Wieś| 790 |36-200 Brzozów;1729;875;875;25;850;50.61;2.86
98962;180201;Zespół Szkół w Starej Wsi|Stara Wieś| 790 |36-200 Brzozów;959;548;548;13;535;57.14;2.37
98963;180201;Zespół Szkół Nr 1 w Przysietnicy|Przysietnica| 198 |36-200 Brzozów;2008;960;960;35;925;47.81;3.65
98964;180201;Zespół Szkół Nr 2 w Przysietnicy|Przysietnicy| 540 |36-200 Brzozów;1011;483;483;14;469;47.77;2.90
98965;180201;Budynek Szpitala|Brzozów|Ks. J. Bielawskiego 18 |36-200 Brzozów;154;66;66;8;58;42.86;12.12
98966;180201;Dom Pomocy Społecznej w Brzozowie|Brzozów|W. Witosa 13 |36-200 Brzozów;77;53;53;1;52;68.83;1.89
98967;180202;Zespół Szkół w Baryczy|Barycz| 238 |36-230 Domaradz;785;412;412;29;383;52.48;7.04
98968;180202;Szkoła Podstawowa Nr 2 w Domaradzu|Domaradz| 651 |36-230 Domaradz;681;366;366;13;353;53.74;3.55
98969;180202;Zespół Szkół w Domaradzu|Domaradz| 349 |36-230 Domaradz;1515;699;699;23;676;46.14;3.29
98970;180202;Dom Strażaka Domaradz-Poręby|Domaradz| 897 A |36-230 Domaradz;224;102;102;3;99;45.54;2.94
98971;180202;Zespół Szkół w Golcowej|Golcowa| 456 |36-231 Domaradz;1030;461;461;17;444;44.76;3.69
98972;180202;Szkoła Podstawowa Nr 2 w Golcowej|Golcowa| 284 |36-231 Domaradz;614;298;298;21;277;48.53;7.05
98973;180203;Zespół Szkół w Dydni|Dydnia| 221 |36-204 Dydnia;1239;515;515;26;489;41.57;5.05
98974;180203;Dom Ludowy w Grabówce|Grabówka| 66 |36-207 Brzozów;435;179;179;9;170;41.15;5.03
98975;180203;Dom Ludowy w Jabłonce|Jabłonka| 47 |36-204 Dydnia;840;377;377;8;369;44.88;2.12
98976;180203;Dom Ludowy w Witryłowie|Witryłów| 21 |36-204 Dydnia;449;136;136;11;125;30.29;8.09
98977;180203;Dom Ludowy w Krzemiennej|Krzemienna| 46 |36-204 Dydnia;360;167;167;6;161;46.39;3.59
98978;180203;Dom Strażaka w Temeszowie|Temeszów| 27 |36-204 Dydnia;272;117;117;2;115;43.01;1.71
98979;180203;Szkoła Podstawowa w Niewistce|Niewistka| 37 |36-204 Dydnia;248;101;101;3;98;40.73;2.97
98980;180203;Szkoła Podstawowa w Obarzymie|Obarzym| 36A |36-204 Dydnia;277;95;95;3;92;34.30;3.16
98981;180203;Dom Ludowy w Krzywem|Krzywe| 68 |36-204 Dydnia;326;159;159;9;150;48.77;5.66
98982;180203;Dom Ludowy w Końskiem|Końskie| 39 |36-204 Dydnia;373;134;134;9;125;35.92;6.72
98983;180203;Dom Ludowy w Niebocku|Niebocko| 148 |36-207 Brzozów;1234;488;488;13;475;39.55;2.66
98984;180203;Szkoła Podstawowa w Wydrnej|Wydrna| 132 |36-204 Dydnia;466;175;175;11;164;37.55;6.29
98985;180204;Szkoła Podstawowa w Haczowie - świetlica na parterze|Haczów| 593 |36-213 Haczów;1029;494;494;11;483;48.01;2.23
98986;180204;Szkoła Podstawowa w Haczowie - sala gimnastyczna|Haczów| 593 |36-213 Haczów;1594;788;788;16;772;49.44;2.03
98987;180204;Zespół Szkół w Trześniowie|Trześniów| 107 |36-212 Trześniów;982;439;439;20;419;44.70;4.56
98988;180204;Dom Ludowy w Bukowie|Buków| 91 |36-212 Trześniów;277;147;147;6;141;53.07;4.08
98989;180204;Zespół Szkół w Jasionowie|Jasionów| 195 |36-211 Jasionów;1113;423;423;22;401;38.01;5.20
98990;180204;Zespół Szkół we Wzdowie|Wzdów| 121 |36-211 Jasionów;759;322;322;9;313;42.42;2.80
98991;180204;Zespół Szkół w Malinówce|Malinówka| 42 |36-213 Haczów;770;403;403;20;383;52.34;4.96
98992;180204;Zespół Szkół w Jabłonicy Polskiej|Jabłonica Polska| 178 |36-213 Haczów;867;480;480;9;471;55.36;1.88
98993;180205;Gminny Ośrodek Pomocy Społecznej Jasienica Rosielna|Jasienica Rosielna| 240 |36-220 Jasienica Rosielna;1756;1070;1070;32;1038;60.93;2.99
98994;180205;Zespół Szkół Blizne|Blizne| 439A |36-221 Blizne;1282;748;748;10;738;58.35;1.34
98995;180205;Zespół Szkół Blizne|Blizne| 439A |36-221 Blizne;1298;799;799;21;778;61.56;2.63
98996;180205;Zespół Szkół Orzechówka|Orzechówka| 5 |36-220 Jasienica Rosielna;1194;706;706;14;692;59.13;1.98
98997;180205;Szkoła Podstawowa Wola Jasienicka|Wola Jasienicka| 108 |36-220 Jasienica Rosielna;525;321;321;16;305;61.14;4.98
98998;180206;Zespół Szkół w Nozdrzcu|Nozdrzec| 227A |36-245 Nozdrzec;1084;538;538;24;514;49.63;4.46
98999;180206;Zespół Szkół w Hłudnie|Hłudno| 89 |36-245 Nozdrzec;741;346;346;11;335;46.69;3.18
99000;180206;Zespół Szkół w Warze|Wara| 247 |36-245 Nozdrzec;892;450;450;15;435;50.45;3.33
99001;180206;Szkoła Podstawowa w Siedliskach|Siedliska| 36 |36-245 Nozdrzec;358;141;141;5;136;39.39;3.55
99002;180206;Dom Strażaka w Hucie Poręby|Huta Poręby| 30B |36-245 Nozdrzec;146;65;65;5;60;44.52;7.69
99003;180206;Gimnazjum Nr 1 w Izdebkach|Izdebki| 362 |36-203 Izdebki;996;355;355;18;337;35.64;5.07
99004;180206;Gimnazjum Nr 1 w Izdebkach|Izdebki| 362 |36-203 Izdebki;887;330;330;10;320;37.20;3.03
99005;180206;Dom Strażaka w Izdebkach Rudawcu|Izdebki| 714A |36-203 Izdebki;286;146;146;10;136;51.05;6.85
99006;180206;Zespół Szkół w Wesołej|Wesoła| 401 |36-233 Wesoła;1041;429;429;28;401;41.21;6.53
99007;180206;Dom Strażaka w Wesołej Magierowie|Wesoła| 555 |36-233 Wesoła;63;29;29;1;28;46.03;3.45
99008;180206;Szkoła Podstawowa Nr 2 w Wesołej|Wesoła| 607 |36-233 Wesoła;277;148;148;6;142;53.43;4.05
99009;180301;Dom Kultury MORS|Dębica|ul. Sportowa 28 |39-200 Dębica;1719;959;959;23;936;55.79;2.40
99010;180301;Zespół Szkół Nr 1|Dębica|ul. Paderewskiego 4 |39-200 Dębica;1766;910;910;13;897;51.53;1.43
99011;180301;Przedszkole Miejskie Nr 8|Dębica|ul. Szkolna 4 |39-200 Dębica;1495;789;789;14;775;52.78;1.77
99012;180301;Miejskie Przedsiębiorstwo Energetyki Cieplnej sp. z o. o.|Dębica|ul. Rzeczna 1A |39-200 Dębica;2041;1129;1129;26;1103;55.32;2.30
99013;180301;Przedszkole Miejskie Nr 12|Dębica|ul. Cmentarna 56 |39-200 Dębica;1474;787;787;10;777;53.39;1.27
99014;180301;Przedszkole Miejskie Nr 9|Dębica|ul. Sienkiewicza 6B |39-200 Dębica;1538;844;844;16;828;54.88;1.90
99015;180301;Miejskie Gimnazjum Nr 4|Dębica|ul. Wyrobka 9 |39-200 Dębica;1710;945;945;9;936;55.26;0.95
99016;180301;Szkoła Podstawowa Nr 9|Dębica|ul. Grottgera 3 |39-200 Dębica;1737;906;906;13;893;52.16;1.43
99017;180301;Miejskie Gimnazjum Nr 1|Dębica|ul. Cmentarna 1 |39-200 Dębica;1425;810;810;24;786;56.84;2.96
99018;180301;Zespół Szkół Ogólnokształcących|Dębica|ul. Słowackiego 9 |39-200 Dębica;1915;923;923;8;915;48.20;0.87
99019;180301;Przedszkole Miejskie Nr 2 Integracyjne|Dębica|ul. Księdza Konarskiego 14 |39-200 Dębica;1853;1013;1013;17;996;54.67;1.68
99020;180301;Szkoła Podstawowa Nr 3|Dębica|ul. Kraszewskiego 37 |39-200 Dębica;1211;646;646;6;640;53.34;0.93
99021;180301;Przedszkole Miejskie Nr 10|Dębica|ul. Księdza Kołłątaja 8 |39-200 Dębica;1627;885;885;14;871;54.39;1.58
99022;180301;Szkoła Podstawowa Nr 10|Dębica|ul. Huberta Wagnera 4 |39-200 Dębica;2182;1217;1217;28;1189;55.77;2.30
99023;180301;Szkoła Podstawowa Nr 12|Dębica|ul. Gajowa 9 |39-200 Dębica;2028;1260;1260;20;1240;62.13;1.59
99024;180301;Przedszkole Miejskie nr 6|Dębica|ul. Osiedle Matejki 19 |39-200 Dębica;1686;755;755;24;731;44.78;3.18
99025;180301;Miejskie Gimnazjum Nr 2|Dębica|ul. Łysogórska 25 |39-200 Dębica;1981;1107;1107;19;1088;55.88;1.72
99026;180301;Szkoła Podstawowa Nr 2|Dębica|ul. Ogrodowa 22 |39-200 Dębica;2128;1227;1227;12;1215;57.66;0.98
99027;180301;Szkoła Podstawowa Nr 11|Dębica|ul. Szkotnia 14 |39-200 Dębica;1994;1081;1081;14;1067;54.21;1.30
99028;180301;Zespół Szkół Zawodowych Nr 1|Dębica|ul. Rzeszowska 78 |39-200 Dębica;1279;832;832;9;823;65.05;1.08
99029;180301;Szkoła Podstawowa Nr 8|Dębica|ul. Wielopolska 162 |39-200 Dębica;2105;1161;1161;25;1136;55.15;2.15
99030;180301;Dom Pomocy Społecznej|Dębica|ul. 23 Sierpnia 3 |39-200 Dębica;62;22;22;1;21;35.48;4.55
99031;180301;Zespół Opieki Zdrowotnej|Dębica|ul. Krakowska 91 |39-200 Dębica;92;30;30;1;29;32.61;3.33
99032;180301;Zakład Karny|Dębica|ul. Sandomierska 41 |39-200 Dębica;491;159;159;20;139;32.38;12.58
99033;180302;Szkoła Podstawowa w Brzostku|Brzostek|ul. Szkolna 13 |39-230 Brzostek;1432;719;719;25;694;50.21;3.48
99034;180302;Szkoła Podstawowa w Brzostku|Brzostek|ul. Szkolna 13 |39-230 Brzostek;1057;527;527;11;516;49.86;2.09
99035;180302;Dom Ludowy w Kleciach|Klecie| 126 |39-230 Brzostek;523;247;247;16;231;47.23;6.48
99036;180302;Dom Ludowy w Bukowej|Bukowa| 114 |39-230 Brzostek;392;159;159;8;151;40.56;5.03
99037;180302;Dom Ludowy w Opacionce|Opacionka| 61 |39-230 Brzostek;1013;475;475;19;456;46.89;4.00
99038;180302;Zespół Szkół w Nawsiu Brzosteckim|Nawsie Brzosteckie| 206 |39-230 Brzostek;1062;480;480;25;455;45.20;5.21
99039;180302;Szkoła Podstawowa w Kamienicy Górnej|Kamienica Górna| 172 |39-232 Grudna Dolna;819;396;396;15;381;48.35;3.79
99040;180302;Szkoła Podstawowa w Grudnej Górnej|Grudna Górna| 85 |39-232 Grudna Dolna;720;327;327;22;305;45.42;6.73
99041;180302;Dom Strażaka w Siedliskach-Bogusz|Siedliska-Bogusz| 255A |39-231 Siedliska-Bogusz;1504;662;662;35;627;44.02;5.29
99042;180302;Szkoła Podstawowa w Gorzejowej|Gorzejowa| 174A |39-231 Siedliska-Bogusz;540;220;220;9;211;40.74;4.09
99043;180302;Szkoła Podstawowa w Kamienicy Dolnej|Kamienica Dolna| 118 |39-230 Brzostek;415;214;214;12;202;51.57;5.61
99044;180302;Szkoła Podstawowa w Przeczycy|Przeczyca| 84 |39-230 Brzostek;872;436;436;18;418;50.00;4.13
99045;180303;Zespół Szkół Czarna|Czarna|ul. Konarskliego 23 |39-215 Czarna;887;408;408;12;396;46.00;2.94
99046;180303;Zespół Szkół Czarna|Czarna|ul. Konarskiego 23 |39-215 Czarna;864;492;492;13;479;56.94;2.64
99047;180303;Zespół Szkół Czarna|Czarna|ul. Konarskiego 23 |39-215 Czarna;806;417;417;18;399;51.74;4.32
99048;180303;Wiejskie Centrum Kultury Jaźwiny|Jaźwiny| 106B |39-215 Czarna;511;296;296;3;293;57.93;1.01
99049;180303;Dom Kultury Stara Jastrząbka|Stara Jastrząbka| 42 |39-216 Stara Jastrząbka;955;525;525;12;513;54.97;2.29
99050;180303;Dom Kultury Podlesie|Podlesie| 46 |39-216 Stara Jastrząbka;305;165;165;6;159;54.10;3.64
99051;180303;Remiza OSP Przeryty Bór|Przeryty Bór| 13A |39-216 Stara Jastrząbka;111;44;44;1;43;39.64;2.27
99052;180303;Szkoła Podstawowa Róża|Róża| 69 |39-216 Stara Jastrząbka;1037;497;497;13;484;47.93;2.62
99053;180303;Wiejskie Centrum Kultury Borowa|Borowa, Środek| 112A |39-215 Czarna;614;324;324;11;313;52.77;3.40
99054;180303;Wiejskie Centrum Kultury Głowaczowa|Głowaczowa| 53C |39-217 Grabiny;622;281;281;12;269;45.18;4.27
99055;180303;Wiejskie Centrum Kultury Grabiny|Grabiny| 61D |39-217 Grabiny;1628;832;832;25;807;51.11;3.00
99056;180303;Osiedlowe Centrum Kultury Przyborów|Przyborów| 141 |39-217 Grabiny;558;251;251;7;244;44.98;2.79
99057;180303;Zespół Szkół Chotowa|Chotowa| 59 |39-217 Grabiny;593;327;327;5;322;55.14;1.53
99058;180303;Wiejskie Centrum Kultury Żdżary|Żdżary, Nowa Wieś| 72A |39-215 Czarna;743;307;307;12;295;41.32;3.91
99059;180304;Zespół Szkół w Pustyni|Pustynia| 160 |39-200 Dębica;1201;657;657;10;647;54.70;1.52
99060;180304;Zespół Szkół w Zawadzie|Zawada| 154 |39-200 Dębica;1131;577;577;12;565;51.02;2.08
99061;180304;Zespół Szkół w Stasiówce|Stasiówka| 130 |39-200 Dębica;1008;512;512;19;493;50.79;3.71
99062;180304;Zespół Szkół w Stobiernej|Stobierna| 38 |39-200 Dębica;744;380;380;13;367;51.08;3.42
99063;180304;Zespół Szkół w Gumniskach|Gumniska| 120 |39-208 Gumniska;971;476;476;20;456;49.02;4.20
99064;180304;Zespół Szkół w Latoszynie|Latoszyn| 23 |39-200 Dębica;1119;566;566;17;549;50.58;3.00
99065;180304;Zespół Szkół w Gumniskach|Gumniska| 120 |39-208 Gumniska;641;354;354;10;344;55.23;2.82
99066;180304;Zespół Szkół w Głobikowej|Głobikowa| 81 |39-208 Głobikowa;444;211;211;24;187;47.52;11.37
99067;180304;Remiza OSP w Kozłowie|Kozłów| 73B |39-200 Dębica;804;455;455;5;450;56.59;1.10
99068;180304;Zespół Szkół w Podgrodziu|Podgrodzie| 56A |39-200 Podgrodzie;1262;670;670;13;657;53.09;1.94
99069;180304;Zespół Szkół w Paszczynie|Paszczyna| 241 |39-207 Brzeźnica;1094;496;496;20;476;45.34;4.03
99070;180304;Zespół Szkół w Pustkowie - Osiedlu|Pustków-Osiedle| 34 1|39-206 Pustków - Osiedle;940;401;401;10;391;42.66;2.49
99071;180304;Zespół Szkół w Pustkowie - Osiedlu|Pustków-Osiedle| 34 2|39-206 Pustków-Osiedle;978;471;471;13;458;48.16;2.76
99072;180304;Remiza OSP w Kochanówce|Paszczyna, Kochanówka| 30 |39-206 Pustków-Osiedle;276;124;124;3;121;44.93;2.42
99073;180304;Remiza OSP Pustkowie-Krownicach|Pustków, Krownice| 449 |39-205 Pustków;473;212;212;10;202;44.82;4.72
99074;180304;Zespół Szkół w Pustkowie|Pustków| 94 1|39-205 Pustków;664;301;301;12;289;45.33;3.99
99075;180304;Zespół Szkół w Pustkowie|Pustków| 94 2|39-205 Pustków;1228;606;606;24;582;49.35;3.96
99076;180304;Zespół Szkół w Nagawczynie|Nagawczyna| 109E 1|39-200 Dębica;979;628;628;10;618;64.15;1.59
99077;180304;Zespół Szkół w Nagawczynie|Nagawczyna| 109E 2|39-200 Dębica;979;582;582;17;565;59.45;2.92
99078;180304;Centrum Kultury i Bibliotek Gminy Dębica z/s w Pustkowie-Osiedlu|Pustków-Osiedle| 26A |39-206 Pustków-Osiedle;792;463;463;7;456;58.46;1.51
99079;180304;Zespół Szkół w Brzeźnicy|Brzeźnica|Szkolna 1 1|39-207 Brzeźnica;902;459;459;14;445;50.89;3.05
99080;180304;Zespół Szkół w Brzeźnicy|Brzeźnica|Szkolna 1 2|39-207 Brzeźnica;1067;542;542;14;528;50.80;2.58
99081;180305;Sala Gimnastyczna w Jodłowej|Jodłowa| 4 |39-225 Jodłowa;1081;442;442;23;419;40.89;5.20
99082;180305;Zespół Szkół Nr 1 w Jodłowej|Jodłowa| 5 |39-225 Jodłowa;941;401;401;23;378;42.61;5.74
99083;180305;Szkoła Podstawowa Nr 2 im.Marii Konopnickiej w Jodłowej|Jodłowa| 347 |39-225 Jodłowa;767;353;354;11;342;46.02;3.12
99084;180305;Szkoła Podstawowa Nr 3 w Jodłowej|Jodłowa| 798 |39-225 Jodłowa;348;111;111;11;100;31.90;9.91
99085;180305;Szkoła Podstawowa w Dęborzynie|Dęborzyn| 25 |39-225 Jodłowa;793;394;394;15;379;49.68;3.81
99086;180305;Szkoła Podstawowa im.Partyzantów Armii Krajowej|Dębowa| 81 |39-225 Jodłowa;433;177;177;12;165;40.88;6.78
99087;180306;Szkoła Podstawowa w Pilźnie|Pilzno|ul. Mickiewicza 1 |39-220 Pilzno;2030;1146;1146;26;1120;56.45;2.27
99088;180306;Szkoła Podstawowa w Pilźnie|Pilzno|ul. Mickiewicza 1 |39-220 Pilzno;1771;982;982;22;960;55.45;2.24
99089;180306;Budynek szkolny|Bielowy| 44 |39-223 Strzegocice;395;234;234;7;227;59.24;2.99
99090;180306;Zespół Szkół w Strzegocicach|Strzegocice| 54 |39-223 Strzegocice;768;408;408;13;395;53.12;3.19
99091;180306;Zespół Szkół w Dobrkowie|Dobrków| 68a |39-220 Pilzno;977;581;582;18;563;59.47;3.10
99092;180306;Zespół Szkół w Dobrkowie|Dobrków| 68a |39-220 Pilzno;232;98;98;6;92;42.24;6.12
99093;180306;Budynek szkolny|Gębiczyna| 78 |39-220 Pilzno;350;144;144;11;133;41.14;7.64
99094;180306;Zespół Szkół w Jaworzu Górnym|Jaworze Górne| 55 |39-223 Strzegocice;558;261;261;13;248;46.77;4.98
99095;180306;Zespół Szkół w Lipinach|Lipiny| 1 |39-220 Pilzno;1117;598;598;33;565;53.54;5.52
99096;180306;Zespół Szkół w Łękach Dolnych|Łęki Dolne| 112a |39-221 Łęki Górne;1297;646;646;17;629;49.81;2.63
99097;180306;Zespół Szkół w Łękach Górnych|Łęki Górne| 205 |39-221 Łęki Górne;1181;612;612;39;573;51.82;6.37
99098;180306;Zespół Szkół w Machowej|Machowa| 75 |39-220 Pilzno;628;326;326;7;319;51.91;2.15
99099;180306;Remiza Ochotniczej Straży Pożarnej|Podlesie| 53 |39-221 Łęki Górne;257;128;128;7;121;49.81;5.47
99100;180306;Zespół Szkół w Parkoszu|Parkosz| 60 |39-220 Pilzno;787;498;498;14;484;63.28;2.81
99101;180306;Zespół Szkół w Słotowej|Słotowa| 159 |39-223 Strzegocice;842;486;486;22;464;57.72;4.53
99102;180306;Zespół Szkół w Zwierniku|Zwiernik| 256 |39-223 Łęki Górne;915;473;473;22;451;51.69;4.65
99103;180306;Dom Pomocy Społecznej w Parkoszu|Parkosz| 26 |39-220 Pilzno;82;34;34;4;30;41.46;11.76
99104;180307;Zespół Szkół Publicznych w Żyrakowie|Żyraków| 77 |39-204 Żyraków;1285;769;769;28;741;59.84;3.64
99105;180307;Centrum Kultury i Promocji w Woli Żyrakowskiej|Wola Żyrakowska| 73A |39-204 Żyraków;595;359;359;7;352;60.34;1.95
99106;180307;Zespół Szkół Publicznych w Bobrowej|Bobrowa| 131 |39-203 Nagoszyn;1179;556;556;29;527;47.16;5.22
99107;180307;Zespół Szkół Publicznych w Korzeniowie|Korzeniów| 77A |39-203 Nagoszyn;588;270;270;10;260;45.92;3.70
99108;180307;Świetlica Wiejska w Bobrowej Woli|Bobrowa Wola| 21 |39-203 Nagoszyn;307;144;144;5;139;46.91;3.47
99109;180307;Zespół Szkół Publicznych w Nagoszynie|Nagoszyn| 93 |39-203 Nagoszyn;1271;576;576;5;571;45.32;0.87
99110;180307;Publiczna Szkoła Podstawowa w Mokrem|Mokre| 136 |39-209 Zasów;500;227;227;13;214;45.40;5.73
99111;180307;Zespół Szkół Publicznych w Zasowie|Zasów| 207 |39-209 Zasów;689;278;278;7;271;40.35;2.52
99112;180307;Zespół Szkół Publicznych w Wiewiórce|Wiewiórka| 122 |39-209 Zasów;746;446;446;11;435;59.79;2.47
99113;180307;Zespół Szkół Publicznych w Górze Motycznej|Góra Motyczna| 31 |39-204 Żyraków;844;454;454;14;440;53.79;3.08
99114;180307;Zespół Szkół Publicznych w Straszęcinie|Straszęcin| 115 |39-218 Straszęcin;1624;834;834;25;809;51.35;3.00
99115;180307;Publiczna Szkoła Podstawowa w Woli Wielkiej|Wola Wielka| 31A |39-218 Straszęcin;482;262;262;9;253;54.36;3.44
99116;180307;Świetlica Betoniarni w Zawierzbiu|Zawierzbie| 67 |39-204 Żyraków;761;456;456;10;446;59.92;2.19
99117;180307;Zespół Opieki Zdrowotnej w Dębicy - Oddziały w Straszęcinie|Straszęcin| 295 |39-218 Straszęcin;116;41;41;1;40;35.34;2.44
99118;180401;Szkoła Podstawowa Nr 6|Jarosław|ul. Spytka z Jarosławia 2 |37-500 Jarosław;1465;579;579;21;558;39.52;3.63
99119;180401;Zespół Szkół Ogólnokształcących|Jarosław|ul. Ignacego Kraszewskiego 39 |37-500 Jarosław;1439;729;729;25;704;50.66;3.43
99120;180401;Przedsiębiorstwo Wodociągów i Kanalizacji Sp. z o.o|Jarosław|ul. Hetmana Jana Tarnowskiego 28 |37-500 Jarosław;1420;654;654;12;642;46.06;1.83
99121;180401;Miejski Zakład Komunikacji Sp. z o.o. w Jarosławiu|Jarosław|ul. Zamkowa 1 |37-500 Jarosław;1368;643;643;17;626;47.00;2.64
99122;180401;Zespół Szkół Budowlanych i Ogólnokształcących|Jarosław|ul. Józefa Poniatowskiego 23 |37-500 Jarosław;1545;743;743;15;728;48.09;2.02
99123;180401;Publiczne Gimnazjum Nr 1|Jarosław|ul. 3-go Maja 30 |37-500 Jarosław;1541;741;741;15;726;48.09;2.02
99124;180401;Szkoła Podstawowa Nr 10|Jarosław|os. Słoneczne 7 |37-500 Jarosław;1527;793;793;20;773;51.93;2.52
99125;180401;Zespół Placówek Oświatowo - Wychowawczych|Jarosław|ul. Władysława Reymonta 1 |37-500 Jarosław;1632;824;824;16;808;50.49;1.94
99126;180401;Miejskie Przedszkole Nr 8|Jarosław|os. Słoneczne 6 |37-500 Jarosław;1245;657;657;16;641;52.77;2.44
99127;180401;Miejskie Przedszkole Nr 10|Jarosław|os. Kombatantów 22 |37-500 Jarosław;1310;700;700;11;689;53.44;1.57
99128;180401;Miejskie Przedszkole Nr 10|Jarosław|os. Kombatantów 22 |37-500 Jarosław;1058;502;502;12;490;47.45;2.39
99129;180401;Zespól Szkół im. Jana Pawła II|Jarosław|ul. Romualda Traugutta 15 |37-500 Jarosław;1452;837;837;15;822;57.64;1.79
99130;180401;Zespół Szkół im. Jana Pawła II|Jarosław|ul. Romualda Traugutta 15 |37-500 Jarosław;1485;882;882;16;866;59.39;1.81
99131;180401;Szkoła Podstawowa Nr 11|Jarosław|ul. Ignacego Kraszewskiego 1 |37-500 Jarosław;1535;774;774;13;761;50.42;1.68
99132;180401;Publiczne Gimnazjum Nr 2|Jarosław|ul. Jana Pawła II 26 |37-500 Jarosław;1592;833;833;13;820;52.32;1.56
99133;180401;Ośrodek Rehabilitacyjno-Edukacyjno-Wychowawczy|Jarosław|os. im. Wincentego Witosa 18 |37-500 Jarosław;1597;811;811;20;791;50.78;2.47
99134;180401;Szkoła Podstawowa Nr 4|Jarosław|ul. Żeromskiego 4 |37-500 Jarosław;1632;833;833;13;820;51.04;1.56
99135;180401;Zespół Szkół Ogólnokształcących|Jarosław|ul. Ignacego Kraszewskiego 39 |37-500 Jarosław;1509;754;754;14;740;49.97;1.86
99136;180401;Specjalny Ośrodek Szkolno-Wychowawczy|Jarosław|ul. Jana Pawła II 30 |37-500 Jarosław;1600;835;835;20;815;52.19;2.40
99137;180401;Miejskie Przedszkole Nr 12|Jarosław|Aleja im. pułkownika Wojciecha Szczepańskiego 2 |37-500 Jarosław;1431;739;739;16;723;51.64;2.17
99138;180401;Szkoła Podstawowa Nr 7|Jarosław|ul. Dolnoleżajska 16 |37-500 Jarosław;1462;732;732;8;724;50.07;1.09
99139;180401;Centrum Opieki Medycznej|Jarosław|ul.3-go Maja 70 |37-500 Jarosław;152;40;40;1;39;26.32;2.50
99140;180401;Specjalistyczny Psychiatryczny ZOZ|Jarosław|ul. Tadeusza Kościuszki 18 |37-500 Jarosław;431;108;108;9;99;25.06;8.33
99141;180402;Szkoła Podstawowa im.Bohaterów Września 1939r.|Radymno|ul.Sienkiewicza 1 |37-550 Radymno;1490;720;720;24;696;48.32;3.33
99142;180402;Zespół Szkół Ogólnokształcących,Zawodowych i Rolniczych|Radymno|ul.Złota Góra 13 |37-550 Radymno;872;426;426;12;414;48.85;2.82
99143;180402;Przedszkole Samorządowe|Radymno|ul.Kazimierza Wielkiego 4 |37-550 Radymno;2102;1065;1065;32;1033;50.67;3.00
99144;180403;Świetlica Wiejska Chłopice|Chłopice| 149C |37-561 Chłopice;784;410;410;21;389;52.30;5.12
99145;180403;Świetlica Wiejska Łowce - Bojanówka|Łowce - Bojanówka| 102 |37-554 Łowce;1232;523;523;29;494;42.45;5.54
99146;180403;Świetlica Wiejska Dobkowice|Dobkowice| 185A |37-554 Łowce;701;371;371;25;346;52.92;6.74
99147;180403;Świetlica Wiejska Boratyn|Boratyn| 172 |37-561 Chłopice;739;342;342;30;312;46.28;8.77
99148;180403;Świetlica Wiejska Jankowice|Jankowice| 176 |37-561 Chłopice;642;356;356;10;346;55.45;2.81
99149;180403;Świetlica Wiejska Zamiechów|Zamiechów| 111 |37-554 Łowce;465;160;160;6;154;34.41;3.75
99150;180404;Świetlica w Koniaczowie|Koniaczów| 47 |37-500 Jarosław;491;271;271;3;268;55.19;1.11
99151;180404;Świetlica w Kostkowie|Kostków| |37-511 Wólka Pełkińska;503;205;205;10;195;40.76;4.88
99152;180404;Szkoła Podstawowa w Makowisku|Makowisko| 17 |37-500 Jarosław;975;389;389;10;379;39.90;2.57
99153;180404;Świetlico-remiza w Morawsku|Morawsko| 203 a |37-514 Munina;860;411;411;18;393;47.79;4.38
99154;180404;Świetlica przy Szkole Podstawowej w Muninie|Munina|Szkolna 3 |37-514 Munina;1673;866;866;20;846;51.76;2.31
99155;180404;Dom Kultury w Pełkiniach|Pełkinie| 143 |37-511 Wólka Pełkińska;1494;759;759;20;739;50.80;2.64
99156;180404;Świetlica w Sobiecinie|Sobiecin| 25A |37-500 Jarosław;533;286;286;16;270;53.66;5.59
99157;180404;Szkoła Podstawowa w Surochowie|Surochów| 67A |37-500 Jarosław;822;345;345;15;330;41.97;4.35
99158;180404;Szkoła Podstawowa w Tuczempach|Tuczempy|Jana Pawła II 11 |37-514 Munina;1334;655;655;14;641;49.10;2.14
99159;180404;Świetlica w Woli Buchowskiej|Wola Buchowska| 53 |37-511 Wólka Pełkińska;593;230;230;12;218;38.79;5.22
99160;180404;Szkoła Podstawowa w Wólce Pełkińskiej|Wólka Pełkińska| 137B |37-511 Wólka Pełkińska;1131;558;558;21;537;49.34;3.76
99161;180405;Świetlica Wiejska Bobrówka|Bobrówka| 21 |37-543 Laszki;484;176;176;6;170;36.36;3.41
99162;180405;Świetlica RZS Charytany|Charytany| 16 |37-543 Laszki;270;116;116;9;107;42.96;7.76
99163;180405;Szkoła Podstawowa Korzenica|Korzenica| 1 |37-543 Laszki;508;196;196;14;182;38.58;7.14
99164;180405;Świetlica Wiejska Laszki|Laszki| 39 |37-543 Laszki;725;423;423;11;412;58.34;2.60
99165;180405;Zespół Szkół Laszki|Laszki| 280 |37-543 Laszki;737;348;348;9;339;47.22;2.59
99166;180405;Szkoła Podstawowa Miękisz Nowy|Miękisz Nowy| 100 |37-543 Laszki;624;279;279;10;269;44.71;3.58
99167;180405;Szkoła Podstawowa Miękisz Stary|Miękisz Stary| 19a |37-543 Laszki;414;213;213;7;206;51.45;3.29
99168;180405;Świetlica Wiejska Tuchla|Tuchla| 22 |37-543 Laszki;275;133;133;3;130;48.36;2.26
99169;180405;Świetlica Wiejska Wietlin|Wietlin| 31a |37-543 Laszki;612;274;274;14;260;44.77;5.11
99170;180405;Świetlica Wiejska Wietlin Trzeci|Wietlin Trzeci| |37-543 Laszki;354;133;133;7;126;37.57;5.26
99171;180405;Świetlica Wiejska Wysocko|Wysocko| 40A |37-543 Laszki;441;154;154;15;139;34.92;9.74
99172;180405;Dom Pomocy Społecznej w Wysocku|Wysocko| 2B |37-543 Laszki;70;35;35;8;27;50.00;22.86
99173;180406;Świetlica Wiejska w Pawłosiowie|Pawłosiów| 88 |37-500 Jarosław;1543;852;852;29;823;55.22;3.40
99174;180406;Zespół Szkół w Pawłosiowie|Pawłosiów| 87 |37-500 Jarosław;1119;625;625;8;617;55.85;1.28
99175;180406;Dom Kultury w Kidałowicach|Kidałowice| 67 |37-500 Jarosław;543;236;236;8;228;43.46;3.39
99176;180406;Dom Kultury w Maleniskach|Maleniska| 26 |37-500 Jarosław;459;272;272;5;267;59.26;1.84
99177;180406;Świetlica Wiejska w Szczytnej|Szczytna| 12 |37-500 Jarosław;259;143;143;5;138;55.21;3.50
99178;180406;Szkoła Podstawowa w Tywoni|Tywonia| 30 |37-500 Jarosław;501;269;269;9;260;53.69;3.35
99179;180406;Świetlica Wiejska w Cieszacinie Wielkim|Cieszacin Wielki| |37-500 Jarosław;719;359;359;9;350;49.93;2.51
99180;180406;Remizo - Świetlica w Cieszacinie Małym|Cieszacin Mały| 57 |37-205 Zarzecze;234;97;97;4;93;41.45;4.12
99181;180406;Zespół Szkół w Wierzbnej|Wierzbna| 2 |37-500 Jarosław;1067;454;454;18;436;42.55;3.96
99182;180406;Centrum Kultury w Ożańsku|Ożańsk| 30 |37-500 Jarosław;388;200;200;0;200;51.55;0.00
99183;180407;Świetlica wiejska w Hawłowicach|Hawłowice| 55 |37-560 PRUCHNIK;368;153;153;5;148;41.58;3.27
99184;180407;Szkoła Podstawowa w Jodłówce|Jodłówka| 222 |37-560 PRUCHNIK;1114;622;622;28;594;55.83;4.50
99185;180407;Szkoła Podstawowa w Kramarzówce|Kramarzówka| 98 |37-560 PRUCHNIK;1303;665;665;35;630;51.04;5.26
99186;180407;Centrum Kultury, Sportu i Turystyki w Pruchniku|Pruchnik|ul. Księdza Bronisława Markiewicza 20 |37-560 PRUCHNIK;1885;987;987;38;949;52.36;3.85
99187;180407;Szkoła Podstawowa nr 2 w Pruchniku Górnym|Pruchnik|Świętego Floriana 17 |37-560 PRUCHNIK;598;330;330;14;316;55.18;4.24
99188;180407;Zespół Szkół w Rozborzu Długim|Rozbórz Długi| 101 |37-560 PRUCHNIK;629;288;288;24;264;45.79;8.33
99189;180407;Szkoła Podstawowa w Świebodnej|Świebodna| 19 |37-560 PRUCHNIK;391;180;180;8;172;46.04;4.44
99190;180407;Szkoła Filialna w Rzeplinie|Rzeplin| 111 |37-560 Pruchnik;316;120;120;4;116;37.97;3.33
99191;180407;Remiza Ochotniczej Straży Pożarnej w Jodłówce Parcelacji|Jodłówka| 358 a |37-560 Pruchnik;312;131;131;12;119;41.99;9.16
99192;180407;Remiza Ochotniczej Straży Pożarnej w Rozborzu Okrągłym|Rozbórz Okrągły| 60 |37-560 Pruchnik;346;142;142;7;135;41.04;4.93
99193;180407;Szkoła Podstawowa nr 1 w Pruchniku Dolnym|Pruchnik|ul. Księdza Bronisława Markiewicza 22 |37-560 Pruchnik;536;259;259;7;252;48.32;2.70
99194;180408;Zespół Szkół w Chotyńcu|Chotyniec| 114 |37-552 Młyny;712;254;254;18;236;35.67;7.09
99195;180408;Budynek Szkoły w Młynach Zespołu Szkół w Korczowej|Młyny| 57 |37-552 Młyny;371;149;149;9;140;40.16;6.04
99196;180408;Zespół Szkół w Duńkowicach|Duńkowice| 20 |37-550 Radymno;786;332;332;18;314;42.24;5.42
99197;180408;Świetlica Wiejska w Michałówce|Michałówka| 14 |37-550 Radymno;346;122;122;6;116;35.26;4.92
99198;180408;Zespół Szkół w Korczowej|Korczowa| 54 |37-552 Młyny;476;175;175;13;162;36.76;7.43
99199;180408;Zespół Szkół w Łazach|Łazy| 53 |37-550 Radymno;720;340;340;13;327;47.22;3.82
99200;180408;Zespół Szkół w Nienowicach|Nienowice| 122 |37-550 Radymno;650;198;198;17;181;30.46;8.59
99201;180408;Zespół Szkół w Ostrowie|Ostrów| 139 |37-550 Radymno;1303;750;750;37;713;57.56;4.93
99202;180408;Zespół Szkół w Skołoszowie|Skołoszów|ul. Franciszkańska 53 |37-550 Radymno;1197;594;594;22;572;49.62;3.70
99203;180408;Zespół Szkół w Sośnicy|Sośnica|Kolejowa 1 |37-555 Sośnica;1035;451;451;21;430;43.57;4.66
99204;180408;Zespół Szkół w Świętem|Święte| 30 |37-555 Sośnica;821;467;467;30;437;56.88;6.42
99205;180408;Budynek Szkoły w Zabłotcach Zespołu Szkół w Skołoszowie|Zabłotce| 74 |37-550 Radymno;482;227;227;13;214;47.10;5.73
99206;180408;Dom Pomocy Społecznej w Moszczanach|Moszczany| 1 |37-543 Laszki;63;22;22;2;20;34.92;9.09
99207;180408;Dom Pomocy Społecznej w Sośnicy|Sośnica|Zamkowa 10 |37-555 Sośnica;50;19;19;1;18;38.00;5.26
99208;180409;Szkoła Podstawowa w Czelatycach|Czelatyce| 2 |37-562 Rokietnica;551;228;228;8;220;41.38;3.51
99209;180409;Szkoła Podstawowa w Rokietnicy|Rokietnica| 108 |37-562 Rokietnica;1222;608;608;35;573;49.75;5.76
99210;180409;Świetlica Wiejska Tapin|Tapin| 132 |37-562 Rokietnica;394;156;156;7;149;39.59;4.49
99211;180409;Szkoła Podstawowa w Tuligłowach|Tuligłowy| 19A |37-562 Rokietnica;568;227;227;17;210;39.96;7.49
99212;180409;Szkoła Podstawowa w Rokietnicy Woli|Sołectwo Rokietnica Wola| 525 |37-562 Rokietnica;802;346;346;7;339;43.14;2.02
99213;180410;Centrum Kształcenia na Odległość na Wsi w Roźwienicy (stara Szkoła Podstawowa)|Roźwienica| 89 |37-565 Roźwienica;788;387;387;8;379;49.11;2.07
99214;180410;Wiejski Dom Kultury w Rudołowicach|Rudołowice| 21a |37-565 Roźwienica;934;467;467;19;448;50.00;4.07
99215;180410;Wiejski Dom Kultury w Woli Roźwienickiej|Wola Roźwienicka| 49A |37-565 Roźwienica;424;199;199;10;189;46.93;5.03
99216;180410;Wiejski Dom Kultury w Cząstkowicach|Cząstkowice| 106 |37-565 Roźwienica;554;205;205;13;192;37.00;6.34
99217;180410;Wiejski Dom Kultury w Bystrowicach|Bystrowice| 78A |37-565 Roźwienica;591;266;266;15;251;45.01;5.64
99218;180410;Wiejski Dom Kultury w Tyniowicach|Tyniowice| 1 |37-565 Roźwienica;634;319;319;16;303;50.32;5.02
99219;180410;Szkoła Podstawowa w Węgierce|Węgierka| 220 |37-560 Pruchnik;638;303;303;14;289;47.49;4.62
99220;180410;Wiejski Dom Kultury w Woli Węgierskiej|Wola Węgierska| 122 |37-560 Pruchnik;446;223;223;13;210;50.00;5.83
99221;180411;Dom Kultury w Wiązownicy|Wiązownica| 208 |37-522 Wiązownica;1567;867;867;29;838;55.33;3.34
99222;180411;Świetlica Wiejska w Manasterzu|Manasterz| 59 |37-522 Wiązownica;581;292;292;8;284;50.26;2.74
99223;180411;Świetlica Wiejska w Radawie|Radawa| 46 |37-523 Radawa;362;216;216;11;205;59.67;5.09
99224;180411;Świetlica Wiejska w Cetuli|Cetula| 61 |37-523 Radawa;417;235;235;5;230;56.35;2.13
99225;180411;Świetlica Wiejska w Mołodyczu|Mołodycz| 84 |37-523 Radawa;454;239;239;10;229;52.64;4.18
99226;180411;Dom Kultury w Zapałowie|Zapałów| 134 |37-544 Zapałów;1243;467;467;28;439;37.57;6.00
99227;180411;Świetlica Wiejska w Ryszkowej Woli|Ryszkowa Wola| 59 |37-544 Zapałów;616;273;273;6;267;44.32;2.20
99228;180411;Dom Kultury w Piwodzie|Piwoda| 82 |37-522 Wiązownica;927;512;512;32;480;55.23;6.25
99229;180411;Dom Kultury w Szówsku|Szówsko|Sportowa 5 |37-522 Wiązownica;2014;1089;1089;28;1061;54.07;2.57
99230;180411;Świetlica Środowiskowa przy Kościele pw.św.Brata Alberta w Szówsku|Szówsko|Zamojska 6 |37-500 Jarosław;659;347;347;13;334;52.66;3.75
99231;180411;Dom Kultury w Nielepkowicach|Nielepkowice| 71 |37-522 Wiązownica;325;178;178;12;166;54.77;6.74
99232;180501;Urząd Miasta w Jaśle, Sala Posiedzeń RMJ, I piętro|Jasło|ul. Rynek 12 |38-200 Jasło;1372;716;716;9;707;52.19;1.26
99233;180501;Szkoła Podstawowa Nr 2 w Jaśle|Jasło|ul. Koralewskiego 9 |38-200 Jasło;1202;593;593;17;576;49.33;2.87
99234;180501;Gimnazjum Nr 1 w Jaśle|Jasło|Czackiego 2 |38-200 Jasło;1379;687;687;7;680;49.82;1.02
99235;180501;Zespół Szkół Miejskich Nr 3 w Jaśle|Jasło|ul. Szkolna 38 |38-200 Jasło;1605;856;856;14;842;53.33;1.64
99236;180501;Zespół Szkół Miejskich Nr 3 w Jaśle|Jasło|ul. Szkolna 38 |38-200 Jasło;1608;817;817;16;801;50.81;1.96
99237;180501;Zespół Szkół Miejskich Nr 3 w Jaśle|Jasło|ul. Szkolna 38 |38-200 Jasło;1630;874;874;16;858;53.62;1.83
99238;180501;I Liceum Ogółnokształcące w Jaśle|Jasło|ul. Czackiego 4 |38-200 Jasło;1477;705;705;15;690;47.73;2.13
99239;180501;Dom Ludowy Bryły|Jasło, Bryły|ul. Mickiewicza 115 |38-200 Jasło;637;383;383;11;372;60.13;2.87
99240;180501;Dom Ludowy Kaczorowy|Jasło, Kaczorowy|ul. Kaczorowy 55 |38-200 Jasło;530;280;280;10;270;52.83;3.57
99241;180501;Klub Osiedlowy Gamrat|Jasło, Gamrat|ul. Mickiewicza 108 |38-200 Jasło;1168;527;527;26;501;45.12;4.93
99242;180501;Dom Ludowy Krajowice|Jasło, Krajowice|ul. Okrężna 1 |38-200 Jasło;568;264;264;5;259;46.48;1.89
99243;180501;Szkoła Podstawowa Nr 2 w Jaśle|Jasło, Ulaszowice|ul. Koralewskiego 9 |38-200 Jasło;512;252;252;3;249;49.22;1.19
99244;180501;Niepubliczne Przedszkole "Smyk" w Jaśle|Jasło, Ulaszowice|ul. Na Kotlinę 3 |38-200 Jasło;2061;1130;1130;25;1105;54.83;2.21
99245;180501;Szkoła Podstawowa Nr 10 w Jaśle|Jasło, Brzyszczki|ul. Lwowska 36 |38-200 Jasło;803;456;456;8;448;56.79;1.75
99246;180501;Dom Ludowy Hankówka|Jasło, Hankówka|ul. Hankówka 109 |38-200 Jasło;841;421;421;10;411;50.06;2.38
99247;180501;Szkoła Podstawowa Nr 7 w Jaśle|Jasło, Nowy Żółków|ul. Św. Jana z Dukli 94 |38-200 Jasło;802;433;433;2;431;53.99;0.46
99248;180501;Zespół Szkół Miejskich Nr 5 w Jaśle|Jasło, Sobniów|ul. Sobniowska 58 |38-200 Jasło;1527;879;879;18;861;57.56;2.05
99249;180501;Zespół Szkół Technicznych w Jaśle|Jasło, Górka|ul. Staszica 30 |38-200 Jasło;1420;868;868;19;849;61.13;2.19
99250;180501;Szkoła Podstawowa Nr 4 w Jaśle|Jasło|ul. Wincentego Pola 9 |38-200 Jasło;1324;723;723;2;721;54.61;0.28
99251;180501;Zespół Szkół Technicznych w Jaśle|Jasło|ul. Staszica 30 |38-200 Jasło;634;290;290;4;286;45.74;1.38
99252;180501;MOSiR w Jaśle|Jasło|ul. Sikorskiego 15 |38-200 Jasło;671;370;370;8;362;55.14;2.16
99253;180501;Szkoła Podstawowa Nr 4 w Jaśle|Jasło|ul. Kopernika 8a |38-200 Jasło;1301;639;639;16;623;49.12;2.50
99254;180501;Szkoła Podstawowa Nr 4 w Jaśle|Jasło|ul. Kopernika 8a |38-200 Jasło;887;450;450;11;439;50.73;2.44
99255;180501;Zespół Szkół Technicznych w Jaśle|Jasło|ul. Staszica 30 |38-200 Jasło;961;434;434;10;424;45.16;2.30
99256;180501;Zespół Szkół Miejskich Nr 1 w Jaśle|Jasło, Gądki|ul. Rafineryjna 3a |38-200 Jasło;861;415;415;17;398;48.20;4.10
99257;180501;Zespół Szkół Miejskich Nr 1 w Jaśle|Jasło|ul. Rafineryjna 3a |38-200 Jasło;1046;498;498;6;492;47.61;1.20
99258;180501;Dom Ludowy Niegłowice|Jasło, Niegłowice|ul. Niegłowicka 27 |38-200 Jasło;443;233;233;9;224;52.60;3.86
99259;180501;Szpital Specjalistyczny w Jaśle|Jasło|Lwowska 22 |38-200 Jasło;208;37;37;2;35;17.79;5.41
99260;180501;Szpital Specjalistyczny w Jaśle|Jasło|Za Bursą 1 |38-200 Jasło;35;6;6;1;5;17.14;16.67
99261;180502;Szkoła Podstawowa-świetlica|Błażkowa| 125 |38-212 Brzyska;622;312;312;27;285;50.16;8.65
99262;180502;Szkoła Podstawowa- sala lekcyjna|Błażkowa| 125 |38-212 Brzyska;620;262;262;7;255;42.26;2.67
99263;180502;Szkoła Podstawowa-sala lekcyjna|Brzyska| 348 |38-212 Brzyska;954;501;501;31;470;52.52;6.19
99264;180502;Szkoła Podstawowa-świetlica|Brzyska| 348 |38-212 Brzyska;1091;458;458;23;435;41.98;5.02
99265;180502;Dom Ludowy|Ujazd| 26 |38-212 Brzyska;374;183;183;10;173;48.93;5.46
99266;180502;Dom Ludowy|Wróblowa| 129 |38-212 Brzyska;516;256;256;10;246;49.61;3.91
99267;180502;Dom Ludowy|Dąbrówka| 118 |38-211 Jasło;941;509;509;19;490;54.09;3.73
99268;180503;Szkoła Podstawowa w Cieklinie|Cieklin| 337 |38-222 Dębowiec;1447;792;792;20;772;54.73;2.53
99269;180503;Dom Ludowy w Radości|Radość| 61 |38-222 Dębowiec;478;232;232;10;222;48.54;4.31
99270;180503;Szkoła Podstawowa w Łazach Dębowieckich|Łazy Dębowieckie| 202 |38-220 Dębowiec;538;262;262;9;253;48.70;3.44
99271;180503;Urząd Gminy Dębowiec|Dębowiec| 101 |38-220 Dębowiec;1690;833;833;24;809;49.29;2.88
99272;180503;Dom Ludowy w Majscowej|Majscowa| 171 |38-220 Dębowiec;415;184;184;7;177;44.34;3.80
99273;180503;Szkoła Podstawowa w Zarzeczu|Zarzecze| 143 |38-220 Dębowiec;850;447;447;14;433;52.59;3.13
99274;180503;Szkoła Podstawowa w Woli Dębowieckiej|Wola Dębowiecka| 33 |38-220 Dębowiec;541;258;258;5;253;47.69;1.94
99275;180503;Szkoła Podstawowa w Dobryni|Dobrynia| 53 |38-222 Dębowiec;387;198;198;3;195;51.16;1.52
99276;180503;Szkoła Podstawowa w Foluszu|Folusz| 53 |38-222 Dębowiec;359;131;131;5;126;36.49;3.82
99277;180503;Dom Pomocy Społecznej Folusz|Folusz| 56 |38-222 Dębowiec;117;41;41;4;37;35.04;9.76
99278;180504;Dom Świetlicowy w Kowalowach|Kowalowy| 122 |38-200 Jasło;406;241;241;4;237;59.36;1.66
99279;180504;Dom Ludowy w Gorajowicach|Gorajowice| 33 |38-200 Jasło;243;138;138;2;136;56.79;1.45
99280;180504;Zespół Szkół w Warzycach|Warzyce| 205 |38-200 Jasło;737;434;434;9;425;58.89;2.07
99281;180504;Zespół Szkół w Warzycach|Warzyce| 205 |38-200 Jasło;646;367;367;7;360;56.81;1.91
99282;180504;Dom Ludowy w Zimnej Wodzie|Zimna Woda| 13 |38-203 Szebnie;316;184;184;3;181;58.23;1.63
99283;180504;Dom Ludowy w Bierówce|Bierówka| 171 |38-203 Szebnie;455;271;271;6;265;59.56;2.21
99284;180504;Dom Ludowy w Niepli|Niepla| 199 |38-203 Szebnie;462;212;212;11;201;45.89;5.19
99285;180504;Budynek Rekreacyjno-Sportowy w Chrząstówce|Chrząstówka| |38-203 Szebnie;269;126;126;0;126;46.84;0.00
99286;180504;Dom Ludowy w Szebniach|Szebnie| 46 |38-203 Szebnie;807;446;446;4;442;55.27;0.90
99287;180504;Dom Ludowy w Wolicy|Wolica| 97 |38-200 Jasło;654;346;346;5;341;52.91;1.45
99288;180504;Dom Strażaka w Łaskach|Łaski| 126 |38-200 Jasło;795;383;383;16;367;48.18;4.18
99289;180504;Budynek Rekreacyjno Sportowy w ŻÓŁKOWIE|Żółków| |38-200 Jasło;600;295;295;6;289;49.17;2.03
99290;180504;Dom Ludowy w Niegłowicach|Niegłowice| 248 |38-200 Jasło;757;395;395;8;387;52.18;2.03
99291;180504;Dom Ludowy w Brzyściu|Brzyście| 3 |38-200 Jasło;300;168;168;6;162;56.00;3.57
99292;180504;Szkoła Podstawowa Nr 2 w Osobnicy|Osobnica| 162 |38-241 Osobnica;906;419;419;7;412;46.25;1.67
99293;180504;Dom Ludowy w Osobnicy|Osobnica| 102 |38-241 Osobnica;928;403;403;10;393;43.43;2.48
99294;180504;Zespół Szkół w Osobnicy|Osobnica| |38-241 Osobnica;988;452;452;9;443;45.75;1.99
99295;180504;Zespół Szkół w Trzcinicy|Trzcinica| 72 |38-207 Przysieki;896;428;428;16;412;47.77;3.74
99296;180504;Dom Ludowy w Trzcinicy|Trzcinica| 141 |38-207 Przysieki;998;526;526;12;514;52.71;2.28
99297;180504;Szkoła Podstawowa w Jareniówce|Jareniówka| 60 |38-200 Jasło;625;272;272;10;262;43.52;3.68
99298;180504;Dom Ludowy w Opaciu|Opacie| 154 |38-200 Jasło;461;221;221;1;220;47.94;0.45
99299;180504;Zakład Karny w Warzycach|Warzyce| 467 |38-200 Jasło;176;84;84;11;73;47.73;13.10
99300;180505;Gminne Przedszkole|Kołaczyce|ul.Rynek 13 |38-213 Kołaczyce;1136;581;581;16;565;51.14;2.75
99301;180505;Zespół Szkół Społecznych|Krajowice| 33 |38-211 Jasło 4;324;163;163;3;160;50.31;1.84
99302;180505;Zespół Szkoły Podstawowej i Gimnazjum|Bieździedza| 98 |38-214 Bieździedza;1139;529;529;16;513;46.44;3.02
99303;180505;Zespół Szkoły Podstawowej i Gimnazjum|Bieździedza| 98 |38-214 Bieździedza;1109;503;503;16;487;45.36;3.18
99304;180505;Zespół Szkół Społecznych|Lublica| 79 |38-214 Bieździedza;486;242;242;6;236;49.79;2.48
99305;180505;Zespół Szkół Społecznych|Sieklówka| 173 |38-214 Bieździedza;821;385;385;20;365;46.89;5.19
99306;180505;Zespół Szkół Społecznych im. Jana Pawła II|Sowina| 1 |38-213 Kołaczyce;740;274;274;14;260;37.03;5.11
99307;180505;Zespół Szkoły Podstawowej i Gimnazjum|Kołaczyce|Szkolna 7 |38-213 Kołaczyce;1350;715;715;17;698;52.96;2.38
99308;180506;Budynek Byłej Szkoły Podstawowej|Grab| 22 |38-232 Krempna;222;50;50;5;45;22.52;10.00
99309;180506;Publiczne Gimnazjum|Krempna| 45 |38-232 Krempna;668;301;301;19;282;45.06;6.31
99310;180506;Budynek Byłej Szkoły Podstawowej|Myscowa| 41 |38-232 Krempna;202;105;105;2;103;51.98;1.90
99311;180506;Remiza OSP|Polany| 44 |38-232 Krempna;211;73;73;10;63;34.60;13.70
99312;180506;Dom Ludowy|Świątkowa Wielka| 49 |38-232 Krempna;277;68;68;2;66;24.55;2.94
99313;180507;Gminny Ośrodek Kultury w Nowym Żmigrodzie|Nowy Żmigród|ul. Mickiewicza 9 |38-230 Nowy Żmigród;1148;622;622;28;594;54.18;4.50
99314;180507;Dom Ludowy w Mytarzy|Mytarz| 137 |38-230 Nowy Żmigród;570;344;344;12;332;60.35;3.49
99315;180507;Dom Ludowy w Tokach|Toki| 137 |38-230 Nowy Żmigród;531;213;213;7;206;40.11;3.29
99316;180507;Szkoła Podstawowa w Kątach|Kąty| 183 |38-230 Nowy Żmigród;806;375;375;17;358;46.53;4.53
99317;180507;Dom Ludowy w Nienaszowie|Nienaszów| 301 |38-230 Nowy Żmigród;1011;476;476;16;460;47.08;3.36
99318;180507;Dom Ludowy w Łysej Górze|Łysa Góra| 222 |38-230 Nowy Żmigród;524;248;248;5;243;47.33;2.02
99319;180507;Zespół Szkół w Łężynach|Łężyny| 144 |38-230 Nowy Żmigród;736;368;368;11;357;50.00;2.99
99320;180507;Dom Ludowy w Gorzycach|Gorzyce| 139 |38-230 Nowy Żmigród;415;184;184;7;177;44.34;3.80
99321;180507;Dom Ludowy w Starym Żmigrodzie|Stary Żmigród| 151 |38-230 Nowy Żmigród;576;312;312;5;307;54.17;1.60
99322;180507;Dom Ludowy w Skalniku|Skalnik| 65 |38-230 Nowy Żmigród;532;270;270;7;263;50.75;2.59
99323;180507;Dom Ludowy w Makowiskach|Makowiska| 155 |38-230 Nowy Żmigród;358;145;145;10;135;40.50;6.90
99324;180507;Dom Ludowy w Desznicy|Desznica| 74 |38-230 Nowy Żmigród;316;159;159;8;151;50.32;5.03
99325;180508;Gminny Ośrodek Kultury w Osieku Jasielskim|Osiek Jasielski| 9 |38-223 Osiek Jasielski;1059;537;537;18;519;50.71;3.35
99326;180508;Zespół Szkół Integracyjnych w Samoklęskach|Samoklęski| 206 |38-223 Osiek Jasielski;1451;646;646;27;619;44.52;4.18
99327;180508;Remiza OSP w Załężu|Załęże| 195 |38-223 Osiek Jasielski;526;277;277;9;268;52.66;3.25
99328;180508;Dom Ludowy w Pielgrzymce|Pielgrzymka| 185 |38-223 Osiek Jasielski;598;276;276;22;254;46.15;7.97
99329;180508;Dom Ludowy w Zawadce Osieckiej|Zawadka Osiecka| 61 |38-223 Osiek Jasielski;637;248;248;19;229;38.93;7.66
99330;180509;Gminny Ośrodek Kultury w Skołyszynie|Skołyszyn| 283 |38-242 Skołyszyn;1622;816;816;19;797;50.31;2.33
99331;180509;Dom Ludowy w Jabłonicy|Jabłonica| 126 |38-200 Jasło;608;292;292;16;276;48.03;5.48
99332;180509;Zespół Szkół w Bączalu Dolnym|Bączal Dolny| 101 |38-242 Skołyszyn;1017;420;420;10;410;41.30;2.38
99333;180509;Dom Ludowy w Przysiekach|Przysieki| 429 |38-207 Przysieki;1293;754;754;22;732;58.31;2.92
99334;180509;Dom Ludowy w Harklowej|Harklowa| 501 |38-243 Harklowa;1290;556;556;18;538;43.10;3.24
99335;180509;Zespół Szkół Publicznych w Święcanach|Święcany| 529 |38-242 Skołyszyn;1742;880;880;17;863;50.52;1.93
99336;180509;Dom Ludowy w Lipnicy Górnej|Lipnica Górna| 136 |38-211 Jasło;374;181;181;8;173;48.40;4.42
99337;180509;Szkoła Podstawowa w Lisowie|Lisów| 76 |38-242 Skołyszyn;712;283;283;13;270;39.75;4.59
99338;180509;Dom Ludowy w Siepietnicy|Siepietnica| 84 |38-340 Biecz;388;207;207;4;203;53.35;1.93
99339;180509;Zespół Szkół w Kunowej|Kunowa| 89 |38-243 Harklowa;363;171;171;4;167;47.11;2.34
99340;180509;Dom Ludowy w Siedliskach Sławęcińskich|Siedliska Sławęcińskie| 103 |38-242 Skołyszyn;448;216;216;8;208;48.21;3.70
99341;180509;Dom Ludowy w Pustej Woli|Pusta Wola| 77 |38-243 Harklowa;219;92;92;3;89;42.01;3.26
99342;180511;Dom Ludowy|Tarnowiec| 30 |38-204 Tarnowiec;1057;560;560;18;542;52.98;3.21
99343;180511;Dom Ludowy|Czeluśnica| |38-204 Tarnowiec;1082;578;578;20;558;53.42;3.46
99344;180511;Dom Ludowy- świetlica|Glinik Polski| 77 |38-204 Tarnowiec;471;250;250;8;242;53.08;3.20
99345;180511;Zespół Szkół Publicznych|Łubno Szlacheckie| 109 |38-204 Tarnowiec;875;350;350;15;335;40.00;4.29
99346;180511;Zespół Szkół Publicznych|Tarnowiec| 230 |38-204 Tarnowiec;1024;426;426;11;415;41.60;2.58
99347;180511;Dom Ludowy|Sądkowa| BN |38-204 Tarnowiec;803;403;403;12;391;50.19;2.98
99348;180511;Dom Ludowy|Nowy Glinik| 89 |38-204 Tarnowiec;532;282;282;9;273;53.01;3.19
99349;180511;Dom Ludowy|Łajsce| |38-204 Tarnowiec;467;201;201;11;190;43.04;5.47
99350;180511;Dom Ludowy|Umieszcz| |38-204 Tarnowiec;534;273;273;2;271;51.12;0.73
99351;180511;Dom Ludowy|Wrocanka| 35 |38-204 Tarnowiec;624;279;279;6;273;44.71;2.15
99352;180601;Samorządowy Ośrodek Kultury w Cmolasie|Cmolas| 212a |36-105 Cmolas;917;482;482;25;457;52.56;5.19
99353;180601;Zespół Szkół w Cmolasie|Cmolas| 269a |36-105 Cmolas;1372;713;713;26;687;51.97;3.65
99354;180601;Zespół Szkół w Trzęsówce|Trzęsówka| 231 |36-106 Trzęsówka;1082;616;616;18;598;56.93;2.92
99355;180601;Centrum Edukacji Ekologicznej "Puszcza Sandomierska" w Ostrowach Tuszowskich|Ostrowy Tuszowskie| 100a |36-105 Cmolas;804;350;350;14;336;43.53;4.00
99356;180601;Niepubliczna Szkoła Podstawowa w Ostrowach Baranowskich|Ostrowy Baranowskie| 106 |36-105 Cmolas;490;198;198;4;194;40.41;2.02
99357;180601;Dom Strażaka w Jagodniku|Jagodnik| 84b |36-105 Cmolas;376;202;202;5;197;53.72;2.48
99358;180601;Dom Strażaka w Hadykówce|Hadykówka| 104 |36-105 Cmolas;623;325;325;17;308;52.17;5.23
99359;180601;Szkoła Podstawowa w Porębach Dymarskich|Poręby Dymarskie| 157b |36-105 Cmolas;652;261;261;19;242;40.03;7.28
99360;180601;Dom Pomocy Społecznej im. Ks. Wojciecha Borowiusza w Cmolasie (obwód odrębny)|Cmolas| 274 |36-105 Cmolas;41;29;29;6;23;70.73;20.69
99361;180602;Miejski Dom Kultury w Kolbuszowej|Kolbuszowa|Obrońcow Pokoju 66 |36-100 Kolbuszowa;892;484;484;7;477;54.26;1.45
99362;180602;Miejski Dom Kultury w Kolbuszowej|Kolbuszowa|Obrońców Pokoju 66 |36-100 Kolbuszowa;1485;748;748;18;730;50.37;2.41
99363;180602;Zespół Szkół Technicznych w Kolbuszowej|Kolbuszowa|Janka Bytnara 2 |36-100 Kolbuszowa;1546;821;821;11;810;53.10;1.34
99364;180602;Miejska i Powiatowa Blblioteka Publiczna w Kolbuszowej|Kolbuszowa|Józefa Piłsudskiego 7 |36-100 Kolbuszowa;940;468;468;9;459;49.79;1.92
99365;180602;Miejska i Powiatowa Bibloteka Publiczna w Kolbuszowej|Kolbuszowa|Józefa Piłsudskiego 7 |36-100 Kolbuszowa;1132;586;586;7;579;51.77;1.19
99366;180602;Zespół Szkół Nr 1 w Kolbuszowej|Kolbuszowa|Tadeusza Kościuszki 1 |36-100 Kolbuszowa;1363;682;682;11;671;50.04;1.61
99367;180602;Zespół Szkoł Nr 1 w Kolbuszowej|Kolbuszowa Dolna|Tadeusza Kościuszki 1 |36-100 Kolbuszowa;900;445;445;8;437;49.44;1.80
99368;180602;Zespół Szkół Specjalnych w Kolbuszowej Dolnej|Kolbuszowa Dolna|Wiejska 90 |36-100 Kolbuszowa;856;429;429;10;419;50.12;2.33
99369;180602;Szkoła Podstawowa w Zarębkach|Zarębki| 73 |36-100 Kolbuszowa;691;388;388;7;381;56.15;1.80
99370;180602;Dom Ludowy w Weryni|Werynia| 105 |36-100 Kolbuszowa;1192;631;631;17;614;52.94;2.69
99371;180602;Filia Miejskiego Domu Kultury w Kolbuszowej Górnej|Kolbuszowa Górna| 380 |36-100 Kolbuszowa;1246;693;693;9;684;55.62;1.30
99372;180602;Filia Miejskiego Domu Kultury w Kolbuszowej Górnej|Kolbuszowa Górna| 380 |36-100 Kolbuszowa;993;498;498;16;482;50.15;3.21
99373;180602;Szkoła Podstawowa w Bukowcu|Bukowiec| 37 |36-100 Kolbuszowa;293;157;157;6;151;53.58;3.82
99374;180602;Remiza OSP w Hucie Przedborskiej|Huta Przedborska| 19 |36-100 Kolbuszowa;229;132;132;6;126;57.64;4.55
99375;180602;Budynek byłej Szkoły Podstawowej w Kłapówce|Kłapówka| 41 |36-145 Widełka;169;65;65;1;64;38.46;1.54
99376;180602;Remiza OSP w Porębach Kupieńskich|Poręby Kupieńskie| 47 |36-100 Kolbuszowa;210;94;94;3;91;44.76;3.19
99377;180602;Budynek byłej Szkoły Podstawowej w Świerczowie|Świerczów| 39 |36-100 Kolbuszowa;461;219;219;9;210;47.51;4.11
99378;180602;Zespół Szkół w Widełce|Widełka| 191 |36-145 Widełka;983;439;439;7;432;44.66;1.59
99379;180602;Zespół Szkół w Widełce|Widełka| 191 |36-145 Widełka;920;428;428;13;415;46.52;3.04
99380;180602;Zespół Szkół w Kupnie|Kupno| 81 |36-145 Widełka;1226;528;528;9;519;43.07;1.70
99381;180602;Szkoła Podstawowa w Domatkowie|Domatków| 198 |36-100 Kolbuszowa;795;373;373;18;355;46.92;4.83
99382;180602;Szkoła Podstawowa w Przedborzu|Przedbórz| 153 |36-100 Kolbuszowa;716;341;341;11;330;47.63;3.23
99383;180602;Remiza OSP w Nowej Wsi|Nowa Wieś| 92 |36-100 Kolbuszowa;579;264;264;11;253;45.60;4.17
99384;180602;Szpital SP ZOZ w Kolbuszowej|Kolbuszowa|Grunwaldzka 4 |36-100 Kolbuszowa;183;58;58;0;58;31.69;0.00
99385;180603;Urząd Gminy Majdan Królewski|Majdan Królewski|ul. Rynek 1A |36-110 Majdan Królewski;2167;1020;1020;17;1003;47.07;1.67
99386;180603;Publiczna Szkoła Podstawowa w Krzątce|Krzątka| 27 |36-110 Majdan Królewski;1140;481;481;12;469;42.19;2.49
99387;180603;Publiczna Szkoła Podstawowa w Klatkach|Krzątka| 202 |36-110 Majdan Królewski;583;279;279;12;267;47.86;4.30
99388;180603;Remiza OSP Rusinów|Rusinów| 24A |36-110 Majdan Królewski;183;128;128;0;128;69.95;0.00
99389;180603;Publiczna Szkoła Podstawowa w Brzostowej Górze|Brzostowa Góra| 110 |36-110 Majdan Królewski;746;354;354;7;347;47.45;1.98
99390;180603;Publiczna Szkoła Podstawowa w Woli Rusinowskiej|Wola Rusinowska| 69 |36-110 Majdan Królewski;744;373;373;8;365;50.13;2.14
99391;180603;Publiczna Szkoła Podstawowa w Komorowie|Komorów| 116 |36-110 Majdan Królewski;1149;525;525;20;505;45.69;3.81
99392;180603;Publiczna Szkoła Podstawowa w Hucie Komorowskiej|Huta Komorowska| 102 |36-110 Majdan Królewski;1141;500;500;17;483;43.82;3.40
99393;180604;Urząd Gminy Niwiska|Niwiska| 430 |36-147 Niwiska;1222;538;538;22;516;44.03;4.09
99394;180604;Szkoła Podstawowa w Hucinie|Hucina|Wspólna 54 |36-147 Niwiska;351;175;175;1;174;49.86;0.57
99395;180604;Szkoła Podstawowa w Przyłęku|Przyłęk| 216 |36-107 Przyłęk;585;316;316;3;313;54.02;0.95
99396;180604;Szkoła Podstawowa w Kosowach|Kosowy|Szkolna 108 |36-147 Niwiska;633;308;308;8;300;48.66;2.60
99397;180604;Szkoła Podstawowa w Siedlance|Siedlanka| 72 |36-147 Niwiska;559;317;317;12;305;56.71;3.79
99398;180604;Szkoła Podstawowa w Trześni|Trześń| 173 |36-147 Niwiska;511;247;247;10;237;48.34;4.05
99399;180604;Szkoła Podstawowa w Hucisku|Hucisko| 51 |36-147 Niwiska;347;150;150;5;145;43.23;3.33
99400;180604;Świetlica Wiejska w Leszczach|Leszcze| 62A |36-147 Niwiska;217;129;129;9;120;59.45;6.98
99401;180604;Świetlica Wiejska w Zapolu|Zapole| 24 |36-147 Niwiska;250;81;81;11;70;32.40;13.58
99402;180605;Szkoła Podstwowa w Raniżowie|Raniżów|Grunwaldzka 2 |36-130 Raniżów;1779;959;959;27;932;53.91;2.82
99403;180605;Szkoła Podstawowa w Woli Raniżowskiej|Wola Raniżowska| 317 |36-125 Wola Raniżowska;1494;674;674;21;653;45.11;3.12
99404;180605;Szkoła Podstawowa w Mazurach|Mazury| 128 |36-130 Raniżow;665;354;354;14;340;53.23;3.95
99405;180605;Szkoła Podstawowa w Zielonce|Zielonka| 85 |36-130 Raniżów;503;252;252;9;243;50.10;3.57
99406;180605;Dom Ludowy w Staniszewskiem|Staniszewskie| 153 |36-130 Raniżów;470;235;235;12;223;50.00;5.11
99407;180605;Remiza OSP w Korczowiskach|Korczowiska| 94 |36-130 Raniżów;233;96;96;4;92;41.20;4.17
99408;180605;Remiza OSP w Posuchach|Zielonka| 161 |36-130 Raniżów;214;104;104;5;99;48.60;4.81
99409;180605;Środowiskowy Dom Samopomocy w Porębach Wolskich|Wola Raniżowska| 586 |36-130 Raniżów;256;137;137;1;136;53.52;0.73
99410;180606;Samorządowe Centrum Kultury w Dzikowcu|Dzikowiec|Ks. S. Sudoła 11 |36-122 Dzikowiec;1436;601;601;8;593;41.85;1.33
99411;180606;Zespół Szkolno-Przedszkolny nr 1 w Mechowcu|Mechowiec| 78 |36-122 Dzikowiec;525;208;208;9;199;39.62;4.33
99412;180606;Szkoła Podstawowa w Kopciach|Kopcie| 77 |36-121 Wilcza Wola;632;314;314;19;295;49.68;6.05
99413;180606;Publiczna Szkoła Podstawowa w Spiach|Wilcza Wola| 29a |36-121 Wilcza Wola;587;279;279;9;270;47.53;3.23
99414;180606;Zespół Szkół im. Jana Pawła II w Wilczej Woli|Wilcza Wola|Rzeszowska 1 |36-121 Wilcza Wola;1031;383;383;4;379;37.15;1.04
99415;180606;Szkoła Podstawowa w Lipnicy|Lipnica| 279 |36-123 Lipnica;987;364;364;9;355;36.88;2.47
99416;180701;Dom Ludowy|Bóbrka| 137 |38-458 Chorkówka;670;283;283;10;273;42.24;3.53
99417;180701;Urząd Gminy (sala narad)|Chorkówka| 175 |38-458 Chorkówka;673;312;312;18;294;46.36;5.77
99418;180701;Szkoła Podstawowa|Draganowa| 30 |38-458 Chorkówka;434;181;181;9;172;41.71;4.97
99419;180701;Szkoła Podstawowa|Faliszówka| 174 |38-458 Chorkówka;619;251;251;13;238;40.55;5.18
99420;180701;Szkoła Podstawowa|Kobylany| 187 |38-458 Chorkówka;827;419;419;20;399;50.67;4.77
99421;180701;Zespół Szkół Publicznych|Kopytowa| 59 |38-458 Chorkówka;1048;434;434;8;426;41.41;1.84
99422;180701;Szkoła Podstawowa|Leśniówka| 85 |38-458 Chorkówka;417;163;163;8;155;39.09;4.91
99423;180701;Dom Ludowy|Machnówka| 102 |38-458 Chorkówka;221;114;114;5;109;51.58;4.39
99424;180701;Dom Strażaka|Poraj| 74 |38-458 Chorkówka;244;100;100;5;95;40.98;5.00
99425;180701;Dom Strażaka|Sulistrowa| 36 |38-458 Chorkówka;298;107;107;3;104;35.91;2.80
99426;180701;Zespół Szkół|Świerzowa Polska|Szkolna 50 |38-458 Chorkówka;1686;869;869;23;846;51.54;2.65
99427;180701;Szkoła Podstawowa|Szczepańcowa| 85 |38-458 Chorkówka;982;481;481;8;473;48.98;1.66
99428;180701;Szkoła Podstawowa|Zręcin|Łukasiewicza 31 |38-458 Chorkówka;1705;913;913;17;896;53.55;1.86
99429;180701;Szkoła Podstawowa|Żeglce| 242 |38-458 Chorkówka;834;371;371;9;362;44.48;2.43
99430;180702;Zespół Szkół Nr 1 w Dukli|Dukla|ul. Kościuszki 13 |38-450 Dukla;990;477;477;13;464;48.18;2.73
99431;180702;Zespół Karpackich Parków Krajobrazowych w Krośnie, Dukla|Dukla|ul. Trakt Węgierski 8a |38-450 Dukla;899;420;420;10;410;46.72;2.38
99432;180702;Miejski Osrodek Sportu i Rekreacji w Dukli, Dukla|Dukla|ul. Armii Krajowej 1a |38-450 Dukla;808;391;391;10;381;48.39;2.56
99433;180702;Dom Ludowy w Teodorówce|Teodorówka| 69a |38-450 Dukla;851;397;397;12;385;46.65;3.02
99434;180702;Dom Ludowy w Iwli|Iwla| 20 |38-450 Dukla;689;236;236;11;225;34.25;4.66
99435;180702;Szkoła Podstawowa w Głojscach|Głojsce|Szkolna 7 |38-450 Dukla;621;297;297;12;285;47.83;4.04
99436;180702;Zespół Szkół Publicznych w Łękach Dukielskich|Łęki Dukielskie| 74 |38-456 Łęki Dukielskie;627;249;249;7;242;39.71;2.81
99437;180702;Zespół Szkół Publicznych w Łękach Dukielskich|Łęki Dukielskie| 74 |38-456 Łęki Dukielskie;689;326;326;8;318;47.31;2.45
99438;180702;Szkoła Podstawowa w Wietrznie|Wietrzno| 222 |38-451 Równe;659;306;306;19;287;46.43;6.21
99439;180702;Zespół Szkół Publicznych w Równem|Równe|Długa 41 |38-451 Równe;805;322;322;6;316;40.00;1.86
99440;180702;Zespół Szkól Publicznych w Równem|Równe|Długa 41 |38-451 Równe;691;280;280;15;265;40.52;5.36
99441;180702;Dom Ludowy w Cergowej|Cergowa| 157 |38-450 Dukla;1087;518;518;14;504;47.65;2.70
99442;180702;Zespół Szkół Publicznych w Jasionce|Jasionka| 74 |38-450 Dukla;954;415;415;21;394;43.50;5.06
99443;180702;Dom Ludowy w Trzcianie|Trzciana| 24a |38-450 Dukla;509;131;131;8;123;25.74;6.11
99444;180702;Zespół Szkół Publicznych w Tylawie|Tylawa| 151 |38-454 Tylawa;874;308;308;15;293;35.24;4.87
99445;180703;Kino "Wczasowicz"|Iwonicz-Zdrój|Pl. Dietla 2 |38-440 Iwonicz-Zdrój;1834;1079;1079;26;1053;58.83;2.41
99446;180703;Dom Parafialny|Iwonicz|ul. Długa 33 |38-440 Iwonicz-Zdrój;1733;868;868;23;845;50.09;2.65
99447;180703;Szkoła Podstawowa|Iwonicz|ul. Zagrodniki 21 |38-440 Iwonicz-Zdrój;1640;866;866;16;850;52.80;1.85
99448;180703;Dom Ludowy|Lubatówka| 98 |38-440 Iwonicz-Zdrój;899;366;366;13;353;40.71;3.55
99449;180703;Remiza OSP|Lubatowa| 290B |38-440 Iwonicz-Zdrój;1361;625;625;21;604;45.92;3.36
99450;180703;Szkoła Podstawowa|Lubatowa| 284 |38-440 Iwonicz-Zdrój;1396;651;651;35;616;46.63;5.38
99451;180703;Szpital Uzdrowiskowo-Rehabilitacyjny "EXCELSIOR"|Iwonicz-Zdrój|AL. Partyzantów 2 |38-440 Iwonicz-Zdrój;149;136;136;6;130;91.28;4.41
99452;180703;Sanatorium Uzdrowiskowe "STOMIL ZIEMOWIT"|Iwonicz-Zdrój|ul. Kulczyńskiego 7 |38-440 Iwonicz-Zdrój;165;124;124;3;121;75.15;2.42
99453;180704;Zespół Szkół Publicznych Jedlicze|Jedlicze|Tokarskich 5 1|38-460 Jedlicze;1078;535;535;16;519;49.63;2.99
99454;180704;Zespół Szkół Publicznych Jedlicze|Jedlicze|Tokarskich 5 2|38-460 Jedlicze;857;439;439;5;434;51.23;1.14
99455;180704;Zespół Szkół Publicznych Jedlicze|Jedlicze|Tokarskich 5 3|38-460 Jedlicze;1043;549;549;15;534;52.64;2.73
99456;180704;Sala Domu Ludowego Jedlicze|Jedlicze|Sikorskiego 2 4|38-460 Jedlicze;713;354;354;5;349;49.65;1.41
99457;180704;Sala Domu Ludowego Jedlicze|Jedlicze|Sikorskiego 2 5|38-460 Jedlicze;508;204;204;7;197;40.16;3.43
99458;180704;Sala Domu Ludowego Jedlicze|Jedlicze|Kurkowskiego 19 6|38-460 Jedlicze;483;244;244;3;241;50.52;1.23
99459;180704;Sala Domu Ludowego Chlebna|Chlebna| 55 7|38-460 Jedlicze;906;357;357;9;348;39.40;2.52
99460;180704;Sala Domu Ludowego Długie|Długie| 113 8|38-460 Jedlicze;550;198;198;7;191;36.00;3.54
99461;180704;Sala Domu Ludowego Dobieszyn|Dobieszyn| 103 9|38-460 Jedlicze;1199;542;542;12;530;45.20;2.21
99462;180704;Sala Domu Ludowego Jaszczew|Jaszczew| 131 10|38-460 Jedlicze;1130;514;514;15;499;45.49;2.92
99463;180704;Sala Domu Ludowego Moderówka|Moderówka| 134 11|38-460 Jedlicze;1048;405;405;13;392;38.65;3.21
99464;180704;Sala Domu Ludowego Piotrówka|Piotrówka| 116 12|38-459 Kopytowa;659;237;237;13;224;35.96;5.49
99465;180704;Zespół Szkół - Szkoła Podstawowa i Gimnazjum Potok|Potok| 73 13|38-404 Krosno;688;310;310;7;303;45.06;2.26
99466;180704;Zespół Szkół - Szkoła Podstawowa i Gimnazjum Potok|Potok| 73 14|38-404 Krosno;700;304;304;8;296;43.43;2.63
99467;180704;Zespół Szkolno-Przedszkolny Żarnowiec|Żarnowiec| 137 15|38-460 Jedlicze;881;379;379;7;372;43.02;1.85
99468;180705;Budynek Gminnego Ośrodka Kultury w Korczynie|Korczyna|ul. Spółdzielcza 20 /parter/|38-420 Korczyna;1903;992;992;21;971;52.13;2.12
99469;180705;Budynek Gminnego Ośrodka Kultury w Korczynie|Korczyna|ul. Spółdzielcza 20 /I piętro/|38-420 Korczyna;1768;874;874;27;847;49.43;3.09
99470;180705;Budynek Zespołu Szkół w Korczynie|Korczyna|ul. Fredry 2 |38-420 Korczyna;961;487;487;9;478;50.68;1.85
99471;180705;Budynek Domu Ludowego w Korczynie - Sporne|Korczyna|Sporne 17 |38-420 Korczyna;286;156;156;7;149;54.55;4.49
99472;180705;Budynek Szkoły Podstawowej w Czarnorzekach|Czarnorzeki| 1 |38-420 Korczyna;295;111;111;4;107;37.63;3.60
99473;180705;Budynek Zespołu Szkół w Iskrzyni|Iskrzynia|Szkolna 4 |38-422 Krościenko Wyżne;970;523;523;12;511;53.92;2.29
99474;180705;Budynek Domu Strażaka w Komborni|Kombornia| 63 |38-420 Korczyna;1170;549;549;23;526;46.92;4.19
99475;180705;Budynek Szkoły Podstawowej w Krasnej|Krasna| 108 |38-420 Korczyna;596;254;254;8;246;42.62;3.15
99476;180705;Budynek Zespołu Szkół w Węglówce|Węglówka| 81 |38-420 Korczyna;678;278;278;13;265;41.00;4.68
99477;180705;Budynek Domu Ludowego w Woli Komborskiej|Wola Komborska| 17 |38-420 Korczyna;333;191;191;6;185;57.36;3.14
99478;180706;Publiczna Szkoła Podstawowa|Krościenko Wyżne|Szkolna 34 |38-422 Krościenko Wyżne;1129;575;575;14;561;50.93;2.43
99479;180706;Publiczna Szkoła Podstawowa|Krościenko Wyżne|Szkolna 34 |38-422 Krościenko Wyżne;1227;618;618;13;605;50.37;2.10
99480;180706;Samorządowe Przedszkole|Krościenko Wyżne|Południowa 11 |38-422 Krościenko Wyżne;1130;659;659;13;646;58.32;1.97
99481;180706;Ochotnicza Straż Pożarna|Pustyny|Centralna 17 |38-422 Krościenko Wyżne;876;505;505;9;496;57.65;1.78
99482;180707;Stary Dom Ludowy w Głowience (filia GOK)|Głowienka|Szkolna 1 |38-455 Miejsce Piastowe;1875;1047;1047;24;1023;55.84;2.29
99483;180707;Szkoła Podstawowa w Łężanach|Łężany|Tadeusza Kościuszki 2 |38-423 Miejsce Piastowe;1436;837;837;23;814;58.29;2.75
99484;180707;Zespół Szkół Publicznych w Miejscu Piastowym|Miejsce Piastowe|ul. Szkolna 24 |38-430 Miejsce Piastowe;1670;909;909;12;897;54.43;1.32
99485;180707;Dom Ludowy w Niżnej Łące|Niżna Łąka|O.Hieronima Longawy 51 |38-455 Miejsce Piastowe;255;124;124;3;121;48.63;2.42
99486;180707;Dom Ludowy w Rogach|Rogi|Ks. Henryka Domino 54 |38-430 Miejsce Piastowe;1979;841;841;23;818;42.50;2.73
99487;180707;Szkoła Podstawowa w Targowiskach|Targowiska|Ks. Macieja Suchodolskiego 38 |38-423 Miejsce Piastowe;1819;957;957;33;924;52.61;3.45
99488;180707;Dom Ludowy w Widaczu|Widacz| 34 |38-423 Miejsce Piastowe;547;319;319;15;304;58.32;4.70
99489;180707;Dom Ludowy we Wrocance|Wrocanka|Nadrzeczna 1 |38-455 Miejsce Piastowe;968;522;522;14;508;53.93;2.68
99490;180707;Dom Ludowy w Zalesiu|Targowiska, Zalesie| 43 |38-423 Miejsce Piastowe;378;177;177;8;169;46.83;4.52
99491;180708;Gminny Ośrodek Kultury|Rymanów|ul. Grunwaldzka 11 |38-480 Rymanów;2107;1184;1184;26;1158;56.19;2.20
99492;180708;Dom Ludowy (Posada Dolna)|Rymanów|ul. Mickiewicza 46 |38-480 Rymanów;909;521;521;11;510;57.32;2.11
99493;180708;Zespół Szkół Publicznych w Klimkówce|Klimkówka|ul. Zdrojowa 49 |38-480 Rymanów;1507;813;813;18;795;53.95;2.21
99494;180708;Zespół Szkół Publicznych we Wróbliku Szlacheckim|Wróblik Szlachecki|ul. Szkolna 5 |38-483 Wróblik Szlachecki;799;376;376;7;369;47.06;1.86
99495;180708;Dom Ludowy w Bziance|Bzianka| 191a |38-483 Wróblik Szlachecki;468;240;240;10;230;51.28;4.17
99496;180708;Hala Sportowa w Sieniawie|Sieniawa|ul. Kwiatowa 10 |38-480 Rymanów;902;348;348;14;334;38.58;4.02
99497;180708;Galeria "Zdrój" w Rymanowie-Zdroju|Rymanów-Zdrój|ul. Zdrojowa 40 |38-481 Rymanów-Zdrój;1225;722;722;9;713;58.94;1.25
99498;180708;Zespół Szkół Publicznych w Milczy|Milcza|ul. Szkolna 16 |38-483 Wróblik Szlachecki;996;491;491;20;471;49.30;4.07
99499;180708;Szkoła Podstawowa w Głębokiem|Głębokie| 68 |38-480 Rymanów;839;308;308;16;292;36.71;5.19
99500;180708;Zespół Szkół Publicznych w Króliku Polskim|Królik Polski|ul. Bieszczadzka 137 |38-481 Rymanów-Zdrój;713;329;329;11;318;46.14;3.34
99501;180708;Zespół Szkół Publicznych w Posadzie Górnej|Posada Górna|ul. 3 Maja 164 |38-481 Rymanów-Zdrój;1283;708;708;30;678;55.18;4.24
99502;180708;Dom Ludowy w Ladzinie|Ladzin|ul. Rzeszowska 155 |38-480 Rymanów;385;172;172;3;169;44.68;1.74
99503;180708;Dom Ludowy w Wróbliku Królewskim|Wróblik Królewski|ul. Jana Pawła II 15 |38-483 Wróblik Szlachecki;620;251;251;15;236;40.48;5.98
99504;180708;Szpital Uzdrowiskowy "Eskulap" w Rymanowie-Zdroju|Rymanów-Zdrój|Parkowa 5 |38-481 Rymanów-Zdrój;163;128;128;4;124;78.53;3.12
99505;180708;Szpital Uzdrowiskowy "Zimowit" w Rymanowie -Zdroju|Rymanów-Zdrój|Leśna 4 |38-481 Rymanów-Zdrój;245;151;151;7;144;61.63;4.64
99506;180708;Szpital Uzdrowiskowy "Polonia" w Rymanowie-Zdroju|Rymanów-Zdrój|Anny i Jana Potockich 1 |38-481 Rymanów-Zdrój;105;85;85;2;83;80.95;2.35
99507;180709;Dom Kultury|Odrzykoń|ul. Władysława Jagiełły 1 |38-406 Odrzykoń;2008;909;909;30;879;45.27;3.30
99508;180709;Szkoła Podstawowa|Bratkówka| 19 |38-406 Odrzykoń;520;227;227;5;222;43.65;2.20
99509;180709;Dom Ludowy|Wojaszówka| 115 |38-471 Wojaszówka;554;267;267;16;251;48.19;5.99
99510;180709;Szkoła Podstawowa|Łęki Strzyżowskie| 87 |38-471 Wojaszówka;863;303;303;16;287;35.11;5.28
99511;180709;Szkoła Podstawowa|Ustrobna| 1 |38-406 Odrzykoń;962;395;395;15;380;41.06;3.80
99512;180709;Gimnazjum|Przybówka| 189 |38-471 Wojaszówka;651;321;321;14;307;49.31;4.36
99513;180709;Dom Ludowy|Bajdy| 138 |38-471 Wojaszówka;529;229;229;13;216;43.29;5.68
99514;180709;Dom Ludowy|Wojkówka| 33 |38-471 Wojaszówka;242;126;126;2;124;52.07;1.59
99515;180709;Dom Ludowy|Łączki Jagiellońskie| 89 |38-471 Wojaszówka;258;100;100;4;96;38.76;4.00
99516;180709;Oddział Przedszkolny|Pietrusza Wola| 51 |38-471 Wojaszówka;360;88;88;2;86;24.44;2.27
99517;180709;Dom Ludowy|Odrzykoń - Głębokie|ul. Mikołaja Kamienieckiego 131 |38-406 Odrzykoń;421;214;214;3;211;50.83;1.40
99518;180710;Dom Ludowy|Jaśliska, Za Murami| 30 |38-485 Jaśliska;1593;739;739;43;696;46.39;5.82
99519;180801;Szkoła Podstawowa Nr 1 im. Mikołaja Kopernika|Leżajsk|ul. Grunwaldzka 1 |37-300 Leżajsk;1532;840;840;8;832;54.83;0.95
99520;180801;Szkoła Podstawowa Nr 1 im. Mikołaja Kopernika|Leżajsk|ul. Grunwaldzka 1 |37-300 Leżajsk;1537;746;746;7;739;48.54;0.94
99521;180801;Szkoła Podstawowa Nr 2 im Władysława Broniewskiego|Leżajsk|ul. Mickiewicza 51 |37-300 Leżajsk;1462;734;734;10;724;50.21;1.36
99522;180801;Miejskie Centrum Kultury|Leżajsk|ul. Mickiewicza 61 |37-300 Leżajsk;1442;704;704;16;688;48.82;2.27
99523;180801;Gimnazjum Miejskie im. Władysława Jagiełły|Leżajsk|ul. Skłodowskiej 8 |37-300 Leżajsk;1403;679;679;10;669;48.40;1.47
99524;180801;Zespół Szkół Technicznych im. Tadeusza Kościuszki|Leżajsk|ul. Mickiewicza 67 |37-300 Leżajsk;1630;857;857;10;847;52.58;1.17
99525;180801;Szkoła Podstawowa Nr 3 im. Stefana Wyszyńskiego|Leżajsk|ul. 11-Listopada 8 |37-300 Leżajsk;1600;851;851;27;824;53.19;3.17
99526;180801;Szkoła Podstawowa Nr 3 im. Stefana Wyszyńskiego|Leżajsk|ul. 11-go Listopada 8 |37-300 Leżajsk;881;528;528;4;524;59.93;0.76
99527;180801;Szpital Powiatowy w Leżajsku|Leżajsk|Leśna 22 |37-300 Leżajsk;202;63;63;1;62;31.19;1.59
99528;180802;Zespół Szkół im. Jana Pawła II w Grodzisku Dolnym|Grodzisko Dolne| 150 |37-306 Grodzisko Dolne;1350;721;721;27;694;53.41;3.74
99529;180802;Dom Wiejski w Grodzisku Nowym|Grodzisko Nowe| 274 |37-306 Grodzisko Dolne;634;323;323;10;313;50.95;3.10
99530;180802;Szkoła Podstawowa w Chodaczowie|Chodaczów| 59A |37-306 Grodzisko Dolne;745;342;342;11;331;45.91;3.22
99531;180802;Szkoła Podstawowa w Opaleniskach|Opaleniska| 82A |37-306 Grodzisko Dolne;972;430;430;9;421;44.24;2.09
99532;180802;Szkoła Podstawowa w Wólce Grodziskiej|Wólka Grodziska| 116B |37-306 Grodzisko Dolne;625;306;306;3;303;48.96;0.98
99533;180802;Zespół Szkół im. prof. Franciszka Leji w Grodzisku Górnym|Grodzisko Górne| 503 |37-306 Grodzisko Dolne;1540;792;792;25;767;51.43;3.16
99534;180802;Ośrodek Kultury w Grodzisku Dolnym|Grodzisko Dolne, Miasto| 332 |37-306 Grodzisko Dolne;673;345;345;13;332;51.26;3.77
99535;180803;Gminny Ośrodek Kultury w Kuryłówce|Kuryłówka| 527 |37-303 Kuryłówka;1836;816;816;32;784;44.44;3.92
99536;180803;Szkoła Podstawowa w Brzyskiej Woli|Brzyska Wola| 169 |37-304 Brzyska Wola;1233;629;629;25;604;51.01;3.97
99537;180803;Szkoła Podstawowa w Jastrzębcu|Jastrzębiec| 47 |37-304 Brzyska Wola;218;121;121;1;120;55.50;0.83
99538;180803;Szkoła Podstawowa w Dąbrowicy|Dąbrowica| 6a |37-303 Kuryłówka;506;189;189;13;176;37.35;6.88
99539;180803;Szkoła Podstawowa w Kulnie|Kulno| 104 |37-303 Kuryłówka;451;190;190;8;182;42.13;4.21
99540;180803;Wiejski Dom Kultury w Kolonii Polskiej|Kolonia Polska| 21 |37-303 Kuryłówka;346;89;89;5;84;25.72;5.62
99541;180804;Zespół Szkół w Wierzawicach|Wierzawice| 396 |37-300 Leżajsk;1374;693;693;25;668;50.44;3.61
99542;180804;Zespół Szkół w Wierzawicach|Wierzawice| 396 |37-300 Leżajsk;1311;629;629;20;609;47.98;3.18
99543;180804;Zespół Szkół w Dębnie|Dębno| 200A |37-305 Dębno;1092;469;469;18;451;42.95;3.84
99544;180804;Zespół Szkół w Giedlarowej|Giedlarowa| 320 |37-300 Leżajsk;1644;792;792;35;757;48.18;4.42
99545;180804;Zespół Szkół w Giedlarowej|Giedlarowa| 320 |37-300 Leżajsk;1594;913;913;13;900;57.28;1.42
99546;180804;Zespół Szkół w Brzózie Królewskiej|Brzóza Królewska| 484 |37-307 Brzóza Królewska;1470;795;795;25;770;54.08;3.14
99547;180804;Zespół Szkół w Brzózie Królewskiej|Brzóza Królewska| 484 |37-307 Brzóza Królewska;1283;665;665;10;655;51.83;1.50
99548;180804;Szkoła Podstawowa w Hucisku|Hucisko| 153 |37-311 Wola Zarczycka;614;319;319;7;312;51.95;2.19
99549;180804;Szkoła Podstawowa w Maleniskach|Maleniska| 75 |37-307 Brzóza Królewska;252;133;133;3;130;52.78;2.26
99550;180804;Szkoła Podstawowa w Przychojcu|Przychojec| 159 |37-300 Leżajsk;762;287;287;9;278;37.66;3.14
99551;180804;Zespół Szkół w Starym Mieście|Stare Miasto| 177a |37-300 Leżajsk;1340;554;554;16;538;41.34;2.89
99552;180804;Szkoła Podstawowa w Chałupkach Dębniańskich|Chałupki Dębniańskie| 105 |37-305 Dębno;732;351;351;14;337;47.95;3.99
99553;180804;Zespół Szkół w Piskorowicach|Piskorowice| 106 |37-300 Leżajsk;1232;451;451;13;438;36.61;2.88
99554;180804;Szkoła Podstawowa w Biedaczowie|Biedaczów| 72 |37-110 Żołynia;1085;610;610;12;598;56.22;1.97
99555;180805;Miejsko-Gminna Biblioteka Publiczna w Nowej Sarzynie|Nowa Sarzyna|ul. Jana Matejki 5 |37-310 Nowa Sarzyna;1671;808;808;10;798;48.35;1.24
99556;180805;Szkoła Podstawowa w Nowej Sarzynie|Nowa Sarzyna|ul. Komisji Edukacji Narodowej 5 |37-310 Nowa Sarzyna;1592;777;777;8;769;48.81;1.03
99557;180805;Szkoła Podstawowa w Nowej Sarzynie|Nowa Sarzyna|ul. Komisji Edukacji Narodowej 5 |37-310 Nowa Sarzyna;842;436;436;16;420;51.78;3.67
99558;180805;Ośrodek Kultury w Nowej Sarzynie|Nowa Sarzyna|ul. 1 Maja 1 |37-310 Nowa Sarzyna;654;355;355;6;349;54.28;1.69
99559;180805;Zespół Szkół w Sarzynie|Sarzyna| 1265 |37-310 ;1592;849;849;20;829;53.33;2.36
99560;180805;Zespół Szkół w Sarzynie|Sarzyna| 1265 |37-310 Nowa Sarzyna;1467;700;700;13;687;47.72;1.86
99561;180805;Szkoła Podstawowa w Rudzie Łańcuckiej|Ruda Łańcucka| 99 |37-310 Nowa Sarzyna;678;402;402;6;396;59.29;1.49
99562;180805;Dom Strażaka w Łukowej|Łukowa| 93 |37-310 Nowa Sarzyna;524;280;280;14;266;53.44;5.00
99563;180805;Szkoła Podstawowa w Jelnej|Jelna| 142 a |37-310 Nowa Sarzyna;1302;715;715;10;705;54.92;1.40
99564;180805;Filia Ośrodka Kultury w sołectwie Judaszówka|Jelna| 328 |37-310 Nowa Sarzyna;315;198;198;2;196;62.86;1.01
99565;180805;Szkoła Podstawowa w Woli Zarczyckiej|Wola Zarczycka| 128 |37-311 Wola Zarczycka;1374;801;801;13;788;58.30;1.62
99566;180805;Szkoła Podstawowa w Woli Zarczyckiej|Wola Zarczycka| 128 |37-311 Wola Zarczycka;1589;928;928;12;916;58.40;1.29
99567;180805;Szkoła Podstawowa w Wólce Łętowskiej|Wólka Łętowska| 4 |37-312 Łętownia;465;286;286;5;281;61.51;1.75
99568;180805;Szkoła Podstawowa w Łętowni|Łętownia| 286 |37-312 Łętownia;1108;615;615;5;610;55.51;0.81
99569;180805;Gimnazjum w Majdanie Łętowskim|Łętownia| 118 |37-312 Łętownia;613;365;365;3;362;59.54;0.82
99570;180805;Filia Ośrodka Kultury w sołectwie Gościniec|Łętownia| 510a |37-312 Łętownia;454;252;252;3;249;55.51;1.19
99571;180805;Szkoła Podstawowa w Tarnogórze|Tarnogóra| 212 |37-310 Nowa Sarzyna;668;362;362;7;355;54.19;1.93
99572;180901;Przedszkole Nr 2|Lubaczów|ul. Marii Konopnickiej 9 |37-600 Lubaczów;1582;681;681;15;666;43.05;2.20
99573;180901;Szkoła Podstawowa Nr 1|Lubaczów|ul. Konopnickiej 5 |37-600 Lubaczów;1540;794;794;19;775;51.56;2.39
99574;180901;Liceum Ogólnokształcące|Lubaczów|ul. Kościuszki 26 |37-600 Lubaczów;2274;1094;1094;25;1069;48.11;2.29
99575;180901;Szkoła Podstawowa Nr 2|Lubaczów|ul. Słowackiego 9 |37-600 Lubaczów;1779;858;858;24;834;48.23;2.80
99576;180901;Miejski Dom Kultury|Lubaczów|ul. Konopnickiej 2 |37-600 Lubaczów;1680;806;806;11;795;47.98;1.36
99577;180901;SP ZOZ Szpital Powiatowy|Lubaczów|ul. Mickiewicza 168 |37-600 Lubaczów;1179;629;629;14;615;53.35;2.23
99578;180901;SP ZOZ Szpital Powiatowy|Lubaczów|Adama Mickiewicza 168 |37-600 Lubaczów;136;32;32;2;30;23.53;6.25
99579;180902;Dom Strażaka w Chotylubiu|Chotylub| 64 |37-611 Cieszanów;401;180;180;10;170;44.89;5.56
99580;180902;Centrum Kultury i Sportu w Cieszanowie|Cieszanów|ul. Kościuszki 4 |37-611 Cieszanów;1209;494;494;14;480;40.86;2.83
99581;180902;Centrum Edukacji Ekologicznej w Cieszanowie|Cieszanów|Jana III Sobieskiego 8 |37-611 Cieszanów;849;377;377;9;368;44.41;2.39
99582;180902;Wiejski Dom Kultury w Dachnowie|Dachnów| 84 |37-611 Cieszanów;1126;523;523;19;504;46.45;3.63
99583;180902;Szkoła Podstawowa w Kowalówce|Kowalówka| 7 |37-611 Cieszanów;445;190;190;4;186;42.70;2.11
99584;180902;Szkoła Podstawowa w Niemstowie|Niemstów| 76 |37-611 Cieszanów;635;258;258;15;243;40.63;5.81
99585;180902;Szkoła Podstawowa w Nowym Siole|Nowe Sioło| 103 |37-611 Cieszanów;555;248;248;12;236;44.68;4.84
99586;180902;Wiejski Dom Kultury w Starym Lublińcu|Stary Lubliniec| 45 |37-611 Cieszanów;823;301;301;10;291;36.57;3.32
99587;180903;Szkoła Podstawowa w Horyńcu-Zdroju|Horyniec-Zdrój|ul.Sobieskiego 8 |37-620 Horyniec-Zdrój;926;493;493;14;479;53.24;2.84
99588;180903;Gimnazjum w Horyńcu-Zdroju|Horyniec-Zdrój|ul.Jana III Sobieskiego 2A |37-620 Horyniec-Zdrój;1036;480;480;20;460;46.33;4.17
99589;180903;Szkoła Podstawowa w Werchracie|Werchrata| 45 |37-622 Werchrata;656;196;196;19;177;29.88;9.69
99590;180903;Świetlica wiejska w Nowym Brusnie|Nowe Brusno| 89 |37-620 Horyniec-Zdrój;480;175;175;9;166;36.46;5.14
99591;180903;Świetlica wiejska w Wólce Horynieckiej|Wólka Horyniecka| 33 |37-620 Horyniec-Zdrój;275;105;105;3;102;38.18;2.86
99592;180903;Świetlica wiejska w Horyńcu-Zdroju|Horyniec-Zdrój|Jana III Sobieskiego 9d |37-620 Horyniec-Zdrój;727;270;270;5;265;37.14;1.85
99593;180903;Podemszczyzna Zakład Opiekuńczo-Leczniczy"Ostoja"|Podemszczyzna| 18 |37-620 Horyniec-Zdrój;58;33;33;10;23;56.90;30.30
99594;180904;Gminny Ośrodek Kultury w Baszni Dolnej|Basznia Dolna|ul. Jana III Sobieskiego 11 |37-621 Basznia Dolna;1445;539;539;17;522;37.30;3.15
99595;180904;Świetlica Wiejska w Baszni Górnej|Basznia Górna| 71 |37-621 Basznia Dolna;431;169;169;9;160;39.21;5.33
99596;180904;Gminny Ośrodek Kultury w Krowicy Samej|Krowica Sama| 183 |37-625 Krowica Sama;1209;433;433;12;421;35.81;2.77
99597;180904;Zespół Szkół Publicznych w Młodowie|Młodów|ul.Szkolna 48 |37-600 Lubaczów;984;455;455;14;441;46.24;3.08
99598;180904;Zespół Szkolno-Przedszkolny w Lisich Jamach|Lisie Jamy|ul.Lwowska 45 |37-600 Lubaczów;1513;701;701;23;678;46.33;3.28
99599;180904;Świetlica Wiejska w Dąbkowie|Dąbków| 101 |37-600 Lubaczów;1104;479;479;26;453;43.39;5.43
99600;180904;Gminny Ośrodek Kultury w Załużu|Załuże| 202 |37-600 Lubaczów;717;283;283;14;269;39.47;4.95
99601;180905;Budynek Urzędu Miasta i Gminy Narol|Narol|ul. Rynek 1 |37-610 Narol;1731;729;729;21;708;42.11;2.88
99602;180905;Budynek byłej Szkoly Podstawowej w Lipsku|Lipsko|ul. Mogiłek 1 |37-610 Narol;1331;508;508;12;496;38.17;2.36
99603;180905;Budynek Zespołu Szkół w Łukawicy|Łukawica| 9 |37-610 Narol;957;345;345;16;329;36.05;4.64
99604;180905;Budynek świetlicy wiejskiej w Płazowie|Płazów|ul. Szkolna 1 |37-614 Płazów;342;144;144;1;143;42.11;0.69
99605;180905;Budynek Zespółu Szkół w Rudzie Różanieckiej|Ruda Różaniecka| 187 |37-613 Ruda Różaniecka;824;290;290;8;282;35.19;2.76
99606;180905;Budynek byłej Szkoły Podstawowowej w Łówczy|Łówcza| 46 |37-614 Płazów;392;129;129;14;115;32.91;10.85
99607;180905;Budynek Schroniska Turystycznego w Hucie Różanieckiej|Huta Różaniecka| 57 |37-613 Ruda Różaniecka;308;145;145;5;140;47.08;3.45
99608;180905;Budynek Gminnego Ośrodka Kultury w Narolu|Narol|ul. Warszawska 27 |37-610 Narol;673;283;283;13;270;42.05;4.59
99609;180905;Dom Pomocy Społecznej w Rudzie Różanieckiej|Ruda Różaniecka| 53 |37-613 Ruda Różaniecka;145;52;52;18;34;35.86;34.62
99610;180906;Świetlica wiejska w Futorach|Futory| 40 |37-630 Oleszyce;448;229;229;6;223;51.12;2.62
99611;180906;Sala gimnastyczna Domu Dziecka w Nowej Grobli|Nowa Grobla| 83 |37-631 Nowa Grobla;309;143;143;6;137;46.28;4.20
99612;180906;Sala gimnastyczna Szkoły Podstawowej w Oleszycach|Oleszyce|Mickiewicza 1 |37-630 Oleszyce;1296;639;639;20;619;49.31;3.13
99613;180906;Zespół Szkół w Oleszycach|Oleszyce|Zielona 1A |37-630 Oleszyce;1188;582;582;14;568;48.99;2.41
99614;180906;Remiza Strażacka w Starych Oleszycach|Stare Oleszyce|Wiejska 116 |37-630 Oleszyce;807;359;359;11;348;44.49;3.06
99615;180906;Dom Strażaka w Starym Siole|Stare Sioło| 98 |37-630 Oleszyce;517;207;207;9;198;40.04;4.35
99616;180906;Świetlica wiejska w Zalesiu|Zalesie| 68 |37-630 Oleszyce;524;212;212;7;205;40.46;3.30
99617;180906;Świetlica wiejska w Borchowie|Borchów| 22 |37-630 Oleszyce;185;88;88;4;84;47.57;4.55
99618;180907;Sala rekreacyjna w budynku użyteczności publicznej w Starym Dzikowie|Stary Dzików|ul. Kościuszki 86 |37-632 Stary Dzików;1038;415;415;27;388;39.98;6.51
99619;180907;Zespół Szkół w Cewkowie|Cewków| 81 |37-632 Stary Dzików;726;263;263;10;253;36.23;3.80
99620;180907;Świetlica wiejska w Cewkowie-Woli|Cewków| 186 |37-632 Stary Dzików;498;177;177;6;171;35.54;3.39
99621;180907;Świetlica wiejska w Moszczanicy|Moszczanica| 46B |37-632 Stary Dzików;408;181;181;5;176;44.36;2.76
99622;180907;Szkoła Podstawowa w Ułazowie|Ułazów| 109 |37-632 Stary Dzików;431;160;160;10;150;37.12;6.25
99623;180907;Świetlica wiejska w Nowym Dzikowie|Nowy Dzików| 88A |37-632 Stary Dzików;512;213;213;4;209;41.60;1.88
99624;180908;Świetlica w Kobylnicy Wołoskiej|Kobylnica Wołoska| 4 |37-627 Wielkie Oczy;260;115;115;14;101;44.23;12.17
99625;180908;Gimnazjum nr 2 w Łukawcu|Łukawiec| 84 |37-626 Łukawiec;699;287;287;11;276;41.06;3.83
99626;180908;Wiejski Dom Kultury w Łukawcu|Łukawiec| 115 |37-626 Łukawiec;551;192;219;8;184;34.85;4.17
99627;180908;Świetlica OSP w Wielkich Oczach|Wielkie Oczy|Leśna 1 |37-627 Wielkie Oczy;343;170;170;4;166;49.56;2.35
99628;180908;Świetlica w Wielkich Oczach|Wielkie Oczy|Leśna 2 |37-627 Wielkie Oczy;721;322;322;8;314;44.66;2.48
99629;180908;Świetlica w Bihalach|Bihale| 49 |37-631 Nowa Grobla;246;117;117;6;111;47.56;5.13
99630;180908;Świetlica po byłej Szkole Podstawowej w Kobylnicy Ruskiej|Kobylnica Ruska| 38A |37-627 Wielkie Oczy;191;75;75;3;72;39.27;4.00
99631;181001;Szkoła Podstawowa Nr 2|Łańcut|ul. Tadeusza Kościuszki 17 |37-100 Łańcut;1792;1061;1061;18;1043;59.21;1.70
99632;181001;Miejska Biblioteka Publiczna w Łańcucie|Łańcut|ul. Stanisława Moniuszki 2 |37-100 Łańcut;1010;575;575;3;572;56.93;0.52
99633;181001;Miejski Dom Kultury /prawa strona/|Łańcut|ul. Tadeusza Kościuszki 15 |37-100 Łańcut;1023;605;605;16;589;59.14;2.64
99634;181001;Miejski Dom Kultury /lewa strona/|Łańcut|ul. Tadeusza Kościuszki 15 |37-100 Łańcut;1014;619;619;7;612;61.05;1.13
99635;181001;Publiczne Gimnazjum Nr 1 /sala gimnastyczna - wejście od ul. Adama Mickiewicza/|Łańcut|ul. Józefa Piłsudskiego 7 |37-100 Łańcut;1088;568;568;11;557;52.21;1.94
99636;181001;Powiatowe Centrum Kształcenia Praktycznego i Edukacji Zawodowej /wjazd od ulicy Potockich naprzeciw Starej Likierni/|Łańcut|ul. Armii Krajowej 51a |37-100 Łańcut;1146;718;718;4;714;62.65;0.56
99637;181001;Powiatowe Centrum Kształcenia Praktycznego i Edukacji Zawodowej /wjazd od ulicy Potockich naprzeciw Starej Likierni/|Łańcut|ul. Armii Krajowej 51a |37-100 Łańcut;1074;644;644;9;635;59.96;1.40
99638;181001;Publiczne Gimnazjum Nr 1 /wejście - od ul. Józefa Piłsudskiego/|Łańcut|ul. Józefa Piłsudskiego 7 |37-100 Łańcut;1702;941;941;18;923;55.29;1.91
99639;181001;Szkoła Podstawowa Nr 3 /klasa lekcyjna/|Łańcut|ul. 29 Listopada 21 |37-100 Łańcut;1005;604;604;8;596;60.10;1.32
99640;181001;Szkoła Podstawowa Nr 3 /sala gimnastyczna/|Łańcut|ul. 29 Listopada 21 |37-100 Łańcut;956;583;583;14;569;60.98;2.40
99641;181001;Zespół Szkół Nr 1 /Publiczne Gimnazjum Nr 2 w Łańcucie/|Łańcut|ul. Jana Kochanowskiego 6 |37-100 Łańcut;934;528;528;9;519;56.53;1.70
99642;181001;Zespół Szkół Nr 1 /Szkoła Podstawowa Nr 4 im. Jana Pawła II w Łańcucie/|Łańcut|ul. Jana Kochanowskiego 6 |37-100 Łańcut;1542;829;829;15;814;53.76;1.81
99643;181001;Centrum Medyczne w Łańcucie Sp. z o.o.|Łańcut|Ignacego Paderewskiego 5 |37-100 Łańcut;184;30;30;1;29;16.30;3.33
99644;181001;Dom Pomocy Społecznej dla Osób w Podeszłym Wieku oraz dla Osób Niepełnosprawnych Fizycznie w Łańcucie|Łańcut|Józefa Piłsudskiego 72 |37-100 Łańcut;64;34;34;3;31;53.12;8.82
99645;181002;Gminny Ośrodek Kultury i Czytelnictwa w Białobrzegach|Białobrzegi| 1 |37-114 Białobrzegi;1958;978;978;23;955;49.95;2.35
99646;181002;Dom Kultury w Woli Dalszej|Wola Dalsza| 149 |37-100 Łańcut;1541;753;753;22;731;48.86;2.92
99647;181002;Dom Kultury w Korniaktowie Północnym|Korniaktów Północny| 33a |37-114 Białobrzegi;1345;752;752;25;727;55.91;3.32
99648;181002;Dom Kultury w Korniaktowie Południowym|Korniaktów Południowy| 2 |37-114 Białobrzegi;1071;530;530;17;513;49.49;3.21
99649;181002;Dom Kultury w Dębinie|Dębina| 122b |37-100 Łańcut;744;368;368;6;362;49.46;1.63
99650;181003;Gminny Ośrodek Kultury i Rekreacji w Czarnej|Czarna| 795 |37-125 Czarna;1409;805;805;16;789;57.13;1.99
99651;181003;Zespół Szkół w Woli Małej|Wola Mała| 160 |37-100 Łańcut;698;410;410;14;396;58.74;3.41
99652;181003;Zespół Szkół w Dąbrówkach|Dąbrówki| 211 |37-100 Łańcut;1287;698;698;15;683;54.23;2.15
99653;181003;Zespół Szkół w Krzemienicy|Krzemienica| 631 |37-127 Krzemienica;1153;690;690;15;675;59.84;2.17
99654;181003;Zespół Szkół w Medyni Głogowskiej|Medynia Głogowska| 426 |37-126 Medynia Głogowska;1664;922;922;24;898;55.41;2.60
99655;181003;Zespół Szkół w Medyni Łańcuckiej|Medynia Łańcucka| 105 |37-126 Medynia Głogowska;1084;636;636;14;622;58.67;2.20
99656;181003;Zespół Szkół w Zalesiu|Zalesie| 123 |37-126 Medynia Głogowska;557;312;312;14;298;56.01;4.49
99657;181003;Zespół Szkół w Krzemienicy|Krzemienica| 631 |37-127 Krzemienica;1165;772;772;16;756;66.27;2.07
99658;181004;Zespół Szkół w Albigowej|Albigowa| 489 |37-122 Albigowa;1146;615;615;11;604;53.66;1.79
99659;181004;Zespół Szkół w Albigowej|Albigowa| 489 |37-122 Łańcut;1145;672;672;17;655;58.69;2.53
99660;181004;Zespół Szkół w Cierpiszu|Cierpisz| 110a |37-124 Kraczkowa;661;384;384;10;374;58.09;2.60
99661;181004;Zespół Szkół w Głuchowie|Głuchów| 443 |37-100 Łańcut;1382;771;771;38;733;55.79;4.93
99662;181004;Szkoła Podstawowa w Handzlówce|Handzlówka| 264 |37-123 Handzlówka;1239;562;562;21;541;45.36;3.74
99663;181004;Dom Kultury w Kosinie|Kosina| 966 |37-112 Kosina;1433;823;823;17;806;57.43;2.07
99664;181004;Dom Kultury w Kosinie|Kosina| 966 |37-112 Kosina;1433;814;814;32;782;56.80;3.93
99665;181004;Dom Ludowy w Kraczkowej|Kraczkowa| 882 |37-124 Kraczkowa;1465;875;875;14;861;59.73;1.60
99666;181004;Przedszkole Publiczne w Kraczkowej|Kraczkowa| 882 |37-124 Kraczkowa;1428;854;854;9;845;59.80;1.05
99667;181004;Zespół Szkół w Rogóżnie|Rogóżno| 374 |37-112 Kosina;940;539;539;19;520;57.34;3.53
99668;181004;Zespół Szkół w Soninie|Sonina| 168 |37-100 Łańcut;1207;665;665;15;650;55.10;2.26
99669;181004;Zespół Szkół w Soninie|Sonina| 168 |37-100 Łańcut;1216;723;723;11;712;59.46;1.52
99670;181004;Dom Kultury w Wysokiej|Wysoka| 81 |37-100 Łańcut;2081;1268;1268;23;1245;60.93;1.81
99671;181005;Centrum Kultury Gminy Markowa w Markowej|Markowa| 1491 |37-120 Markowa;1658;901;901;14;887;54.34;1.55
99672;181005;Zespół Szkół w Markowej|Markowa| 1351 |37-120 Markowa;1666;836;836;14;822;50.18;1.67
99673;181005;Zespół Szkół im. Jana Raka w Husowie|Husów| 27 |37-121 Husów;1534;703;703;20;683;45.83;2.84
99674;181005;Centrum Kultury Gminy Markowa Filia w Tarnawce|Tarnawka| 282 |37-121 Husów;383;171;171;6;165;44.65;3.51
99675;181006;Zespół Szkół Tekstylno-Gospodarczych w Rakszawie|Rakszawa| 325 |37-111 Rakszawa;1362;820;820;12;808;60.21;1.46
99676;181006;Szkoła Podstawowa Nr 1 w Rakszawie|Rakszawa| 347 |37-111 Rakszawa;1246;681;684;27;654;54.65;3.96
99677;181006;Szkoła Podstawowa Nr 2 w Rakszawie|Rakszawa| 677 |37-111 Rakszawa;924;474;474;22;452;51.30;4.64
99678;181006;Szkoła Podstawowa Nr 3 w Rakszawie|Rakszawa| 946 |37-111 Rakszawa;874;405;405;16;389;46.34;3.95
99679;181006;Szkoła Podstawowa w Wydrzu|Wydrze| 259 |37-110 Żołynia;509;262;262;9;253;51.47;3.44
99680;181006;Dom Ludowy Rakszawa Kąty|Rakszawa| 1225 |37-111 Rakszawa;447;224;224;11;213;50.11;4.91
99681;181006;Szkoła Podstawowa w Węgliskach|Węgliska| 171 |37-111 Rakszawa;343;185;185;2;183;53.94;1.08
99682;181007;Zespół Szkół im. Adama Mickiewicza w Żołyni (hala sportowa liceum ogólnokształcącego)|Żołynia|ul. Górska 2 |37-110 Żołynia;1348;631;631;16;615;46.81;2.54
99683;181007;Zespół Szkół im. Adama Mickiewicza w Żołyni (hol liceum ogólnokształcącego)|Żołynia|ul. Górska 2 |37-110 Żołynia;1550;815;815;11;804;52.58;1.35
99684;181007;Dom Kultury w Smolarzynach|Smolarzyny| 103 |37-110 Żołynia;422;218;218;4;214;51.66;1.83
99685;181007;Dom Kultury w Brzózie Stadnickiej|Brzóza Stadnicka| 103 |37-110 Żołynia;921;522;522;8;514;56.68;1.53
99686;181007;Zespół Szkół im. Adama Mickiewicza w Żołyni (hala sportowa zespołu szkół))|Żołynia|ul. Górska 2 |37-110 Żołynia;1252;634;634;14;620;50.64;2.21
99687;181007;Zakład Pielęgnacyjno-Opiekuńczy|Żołynia|Górska 8 |37-110 Żołynia;61;25;25;1;24;40.98;4.00
99688;181101;Przedszkole Miejskie Nr 8|Mielec|ul. Tańskiego 5 |39-300 Mielec;1393;804;804;8;796;57.72;1.00
99689;181101;Warsztat Terapii Zajęciowej|Mielec|ul. Kocjana 15 |39-300 Mielec;1454;757;757;7;750;52.06;0.92
99690;181101;Szkoła Podstawowa Nr 9|Mielec|ul. Drzewieckiego 11 |39-300 Mielec;1392;738;738;6;732;53.02;0.81
99691;181101;Zespół Szkół Ogólnokształcących Nr 1|Mielec|ul. Tańskiego 3 |39-300 Mielec;1354;679;679;7;672;50.15;1.03
99692;181101;Zespół Szkół Ogólnokształcących Nr 1|Mielec|ul.Tańskiego 3 |39-300 Mielec;1557;758;758;12;746;48.68;1.58
99693;181101;Przedszkole Miejskie Nr 9|Mielec|ul. Pisarka 23 |39-300 Mielec;1303;657;657;12;645;50.42;1.83
99694;181101;Żłobek Miejski Nr 3|Mielec|ul. Pisarka 9 |39-300 Mielec;1162;651;651;10;641;56.02;1.54
99695;181101;Szkoła Podstawowa Nr 1|Mielec|ul. Kilińskiego 37 |39-300 Mielec;1837;1124;1124;12;1112;61.19;1.07
99696;181101;Szkoła Podstawowa Nr 1|Mielec|ul. Kilińskiego 37 |39-300 Mielec;1819;973;973;8;965;53.49;0.82
99697;181101;Szkoła Podstawowa Nr 2|Mielec|ul. Kościuszki 4 |39-300 Mielec;1843;1034;1034;10;1024;56.10;0.97
99698;181101;Dom Strażaka|Mielec|ul. Cyranowska 66 |39-300 Mielec;1603;893;893;16;877;55.71;1.79
99699;181101;Klub Integracji Społecznej MOPS|Mielec|ul. Pogodna 2 |39-300 Mielec;251;118;118;6;112;47.01;5.08
99700;181101;Zespół Szkół Nr 2|Mielec|ul. Łąkowa 6 |39-300 Mielec;1256;714;714;5;709;56.85;0.70
99701;181101;Zespół Szkół Nr 2|Mielec|ul. Łąkowa 6 |39-300 Mielec;1222;708;708;4;704;57.94;0.56
99702;181101;Przedszkole Miejskie Nr 16|Mielec|ul. Chałubińskiego 1 |39-300 Mielec;1189;645;645;7;638;54.25;1.09
99703;181101;Żłobek Miejski Nr 7|Mielec|ul.Botaniczna 6 |39-300 Mielec;1388;753;753;13;740;54.25;1.73
99704;181101;Szkoła Podstawowa Nr 6|Mielec|ul. Solskiego 8 |39-300 Mielec;1840;971;971;20;951;52.77;2.06
99705;181101;Samorządowe Centrum Kultury|Mielec|ul. Aleja Niepodległości 7 |39-300 Mielec;1566;759;759;14;745;48.47;1.84
99706;181101;Przedszkole Miejskie Nr 4|Mielec|ul. Spółdzielcza 2 |39-300 Mielec;2106;1154;1154;18;1136;54.80;1.56
99707;181101;Przedszkole Miejskie Nr 6|Mielec|ul. Księdza Skargi 15 |39-300 Mielec;1656;913;913;4;909;55.13;0.44
99708;181101;Gimnazjum Nr 2|Mielec|ul. Grunwaldzka 7 |39-300 Mielec;1937;1083;1083;15;1068;55.91;1.39
99709;181101;Przedszkole Miejskie Nr 7|Mielec|ul. Pułaskiego 3 |39-300 Mielec;1433;775;775;12;763;54.08;1.55
99710;181101;Przedszkole Miejskie Nr 12|Mielec|ul. Konopnickiej 4 |39-300 Mielec;2241;1029;1029;20;1009;45.92;1.94
99711;181101;Zamiejscowy Ośrodek Dydaktyczny AGH Kraków w Mielcu|Mielec|ul. Skłodowskiej-Curie 4 |39-300 Mielec;2162;892;892;9;883;41.26;1.01
99712;181101;Szkoła Podstawowa Nr 3|Mielec|ul. Żeromskiego 30 |39-300 Mielec;854;447;447;2;445;52.34;0.45
99713;181101;Miejskie Przedsiębiorstwo Gospodarki Komunalnej Sp. z o.o.|Mielec|ul. Wolności 44 |39-300 Mielec;1690;1037;1037;7;1030;61.36;0.68
99714;181101;Specjalny Ośrodek Szkolno-Wychowawczy|Mielec|ul. Królowej Jadwigi 1 |39-300 Mielec;1577;968;968;7;961;61.38;0.72
99715;181101;Szkoła Podstawowa Nr 11|Mielec|ul. Władysława Warneńczyka 2 |39-300 Mielec;1584;880;880;15;865;55.56;1.70
99716;181101;Przedszkole Miejskie Nr 20|Mielec|ul. Władysława Warneńczyka 2 |39-300 Mielec;1413;699;699;12;687;49.47;1.72
99717;181101;Dom Pomocy Społecznej|Mielec|ul. Kardynała Wyszyńskiego 16 |39-300 Mielec;2158;1230;1230;28;1202;57.00;2.28
99718;181101;Polskie Stowarzyszenie na Rzecz Osób z Upośledzeniem Umysłowym Koło w Mielcu|Mielec|ul. Wojsławska 278 |39-300 Mielec;1663;935;935;10;925;56.22;1.07
99719;181101;Szkoła Podstawowa Nr 12|Mielec|ul. Wandy 11 |39-300 Mielec;764;421;421;4;417;55.10;0.95
99720;181101;Szpital Powiatowy w Mielcu|Mielec|ul. Żeromskiego 22 |39-300 Mielec;235;110;110;3;107;46.81;2.73
99721;181101;Dom Pomocy Społecznej w Mielcu|Mielec|ul. Kardynała Wyszyńskiego 16 |39-300 Mielec;133;50;50;6;44;37.59;12.00
99722;181102;Szkoła Podstawowa w Borowej|Borowa| 248 |39-305 Borowa;1304;726;726;24;702;55.67;3.31
99723;181102;Publiczne Gimnazjum w Pławie|Pławo| 73A |39-305 Borowa;460;226;226;16;210;49.13;7.08
99724;181102;Budynek szkoły w Woli Pławskiej|Wola Pławska| 36 |39-305 Borowa;198;99;99;1;98;50.00;1.01
99725;181102;Niepubliczny Zespół Szkół w Górkach|Górki| 29 |39-306 Górki;413;202;202;6;196;48.91;2.97
99726;181102;Budynek szkoły w Glinach Wielkich|Gliny Wielkie| 47 |39-305 Borowa;275;133;133;11;122;48.36;8.27
99727;181102;Dom Ludowy w Łysakówku|Łysakówek| 62 |39-306 Górki;245;119;119;7;112;48.57;5.88
99728;181102;Zespół Szkół Społecznych w Glinach Małych|Gliny Małe| 99 |39-305 Borowa;530;267;267;6;261;50.38;2.25
99729;181102;Dom Strażaka w Surowej|Surowa| 44 |39-306 Górki;218;98;98;2;96;44.95;2.04
99730;181102;Dom Wiejsko-Strażacki w Orłowie|Orłów| 6A |39-305 Borowa;209;90;90;4;86;43.06;4.44
99731;181102;Niepubliczna Szkoła Podstawowa w Sadkowej Górze|Sadkowa Góra| 148 |39-305 Borowa;644;326;326;19;307;50.62;5.83
99732;181103;Szkoła Podstawowa w Czerminie|Czermin| 454 |39-304 Czermin;1724;894;894;24;870;51.86;2.68
99733;181103;Szkoła Podstawowa w Trzcianie|Trzciana| 289 |39-304 Czermin;1392;633;633;23;610;45.47;3.63
99734;181103;Szkoła Podstawowa w Brniu Osuchowskim|Breń Osuchowski| 64 |39-304 Czermin;410;170;170;8;162;41.46;4.71
99735;181103;Szkoła Podstawowa w Ziempniowie|Ziempniów| 91 |39-304 Czermin;431;162;162;5;157;37.59;3.09
99736;181103;Szkoła Podstawowa w Otałęży|Otałęż| 15 |39-305 Borowa;931;368;368;15;353;39.53;4.08
99737;181103;Szkoła Podstawowa w Łysakowie|Łysaków| 191 |39-304 Czermin;640;266;266;10;256;41.56;3.76
99738;181104;Zespół Szkolno-Gimnazjalny w Gawłuszowicach|Gawłuszowice| 5 |39-307 Gawłuszowice;394;221;221;9;212;56.09;4.07
99739;181104;Dom Strażaka w Krzemienicy|Krzemienica| 76 |39-307 Gawłuszowice;340;177;177;6;171;52.06;3.39
99740;181104;Dom Strażaka w Młodochowie|Młodochów| 28 |39-307 Gawłuszowice;223;119;119;7;112;53.36;5.88
99741;181104;Dom Ludowy w Brzyściu|Brzyście| 123 |39-307 Gawłuszowice;234;142;142;5;137;60.68;3.52
99742;181104;Dom Strażaka w Kliszowie|Kliszów| 108 |39-307 Gawłuszowice;492;256;256;14;242;52.03;5.47
99743;181104;Dom Strażaka w Woli Zdakowskiej|Wola Zdakowska| 99 |39-307 Gawłuszowice;370;183;183;7;176;49.46;3.83
99744;181104;Dom Strażaka w Ostrówku|Ostrówek| 34A |39-307 Gawłuszowice;157;62;62;4;58;39.49;6.45
99745;181105;Zespół Szkół w Trześni|Trześń| 87 |39-331 Chorzelów;1497;767;767;21;746;51.24;2.74
99746;181105;Samorządowy Ośrodek Kultury i Sportu Gminy Mielec z/s w Chorzelowie|Chorzelów| 307 |39-331 Chorzelów;2249;1179;1179;35;1144;52.42;2.97
99747;181105;Szkoła Podstawowa w Chrząstowie|Chrząstów| 156 |39-331 Chorzelów;573;248;248;11;237;43.28;4.44
99748;181105;Szkoła Podstawowa w Książnicach|Książnice| 91 |39-300 Mielec;915;462;462;15;447;50.49;3.25
99749;181105;Szkoła Podstawowa w Podleszanach|Podleszany| 127 |39-300 Mielec;1631;825;825;30;795;50.58;3.64
99750;181105;Zespół Szkół w Woli Mieleckiej|Wola Mielecka| 406 |39-300 Mielec;1640;931;931;17;914;56.77;1.83
99751;181105;Szkoła Podstawowa w Rzędzianowicach|Rzędzianowice| 186 |39-300 Mielec;1081;527;527;23;504;48.75;4.36
99752;181105;Społeczna Szkoła Podstawowa w Złotnikach|Złotniki| 61 |39-300 Mielec;768;438;438;7;431;57.03;1.60
99753;181106;Publiczna Szkoła Podstawowa w Padwi Narodowej|Padew Narodowa|ul Jana Pawła II 2 |39-340 Padew Narodowa;1025;532;532;17;515;51.90;3.20
99754;181106;Publiczna Szkoła Podstawowa w Padwi Narodowej - Filia w Zarówniu|Zarównie| 43 |39-340 Padew Narodowa;453;245;245;10;235;54.08;4.08
99755;181106;Budynek wiejski w Piechotach|Piechoty| 49A |39-340 Padew Narodowa;186;100;100;1;99;53.76;1.00
99756;181106;Budynek wiejski w Babulach|Babule| 36a |39-340 Padew Narodowa;172;83;83;2;81;48.26;2.41
99757;181106;Budynek wiejski w Rożniatach|Rożniaty| 17B |39-340 Padew Narodowa;298;130;130;5;125;43.62;3.85
99758;181106;Świetlica wiejska w Przykopie|Przykop| 47A |39-340 Padew Narodowa;246;128;128;8;120;52.03;6.25
99759;181106;Wiejski Dom Kultury w Wojkowie|Wojków| 91a |39-340 Padew Narodowa;314;158;158;1;157;50.32;0.63
99760;181106;Budynek wiejski w Domacynach|Domacyny| 33 |39-340 Padew Narodowa;193;91;91;2;89;47.15;2.20
99761;181106;Publiczna Szkoła Podstawowa w Padwi Narodowej|Padew Narodowa|ul. Jana Pawła II 2 |39-340 Padew Narodowa;903;452;452;9;443;50.06;1.99
99762;181106;Budynek wiejski w Kębłowie|Kębłów| 62B |39-340 Padew Narodowa;285;147;147;7;140;51.58;4.76
99763;181106;Dom Wielofukcyjny w Zadusznikach|Zaduszniki| 11A |39-340 Padew Narodowa;186;84;84;5;79;45.16;5.95
99764;181107;Szkoła Podstawowa w Przecławiu|Przecław|ul. Rynek 8 |39-320 Przecław;1317;678;678;25;653;51.48;3.69
99765;181107;Szkoła Podstawowa w Kiełkowie|Kiełków| 57a |39-320 Przecław;660;314;314;14;300;47.58;4.46
99766;181107;Szkoła Podstawowa w Rzemieniu|Rzemień| 257 |39-322 Rzemień;1069;533;533;16;517;49.86;3.00
99767;181107;Szkoła Podstawowa w Tuszymie|Tuszyma| 482 |39-321 Tuszyma;1959;956;956;26;930;48.80;2.72
99768;181107;Szkoła Podstawowa w Łączkach Brzeskich|Łączki Brzeskie| 136 |39-320 Przecław;824;439;439;11;428;53.28;2.51
99769;181107;Szkoła Podstawowa w Dobryninie|Dobrynin| 217 |39-322 Rzemień;727;347;347;3;344;47.73;0.86
99770;181107;Białoborski Dom Kultury|Biały Bór| 139 |39-321 Tuszyma;729;286;286;14;272;39.23;4.90
99771;181107;Dom Ludowy w Podolu|Podole| 147 |39-320 Przecław;819;434;434;12;422;52.99;2.76
99772;181107;Budynek Komunalny Stadion-Przecław|Przecław|ul. Wenecka 10 |39-320 Przecław;587;259;259;7;252;44.12;2.70
99773;181107;Budynek po byłej Szkole Podstawowej w Zaborczu|Zaborcze| 57 |39-320 Przecław;388;168;168;6;162;43.30;3.57
99774;181108;Szkoła Podstawowa w Radomyślu Wielkim|Radomyśl Wielki|ul.Ogrodowa 1 |39-310 Radomyśl Wielki;1123;611;611;13;598;54.41;2.13
99775;181108;Szkoła Podstawowa w Partyni|Partynia| 66 |39-310 Radomyśl Wielki;883;481;481;9;472;54.47;1.87
99776;181108;Szkoła Podstawowa w Podborzu|Podborze| 101 |39-308 Wadowice Górne;563;274;274;5;269;48.67;1.82
99777;181108;Szkoła Podstawowa w Rudzie|Ruda| 124 |39-315 Ruda;1212;494;494;19;475;40.76;3.85
99778;181108;Szkoła Podstawowa w Dąbrówce Wisłockiej|Dąbrówka Wisłocka| 115 |39-315 Ruda;544;239;239;9;230;43.93;3.77
99779;181108;Szkoła Podstawowa w Zdziarcu|Zdziarzec| 116 |39-311 Zdziarzec;736;305;305;9;296;41.44;2.95
99780;181108;Szkoła Podstawowa w Dąbiu|Dąbie| 100 |39-311 Zdziarzec;760;330;330;10;320;43.42;3.03
99781;181108;Szkoła Podstawowa w Żarówce|Żarówka| 64 |39-312 Żarówka;685;276;276;12;264;40.29;4.35
99782;181108;Szkoła Podstawowa w Janowcu|Janowiec| 10 |39-312 Janowiec;548;234;234;9;225;42.70;3.85
99783;181108;Szkoła Podstawowa w Dulczy Wielkiej|Dulcza Wielka|ul.Ks.Kalinowskiego 212/1 |39-312 Żarówka;1362;558;558;15;543;40.97;2.69
99784;181108;Szkoła Podstawowa w Dulczy Małej|Dulcza Mała| 40 |39-310 Radomyśl Wielki;643;272;272;14;258;42.30;5.15
99785;181108;Agronomówka w Zgórsku|Zgórsko| 41 |39-308 Wadowice Górne;358;190;190;2;188;53.07;1.05
99786;181108;Gimnazjum Publiczne w Radomyślu Wielkim|Radomyśl Wielki|ul.Klonowa 2 |39-310 Radomyśl Wielki;1344;720;720;20;700;53.57;2.78
99787;181108;Dom Strażaka w Pniu|Pień| 41a |39-310 Radomyśl Wielki;253;135;135;11;124;53.36;8.15
99788;181109;Szkoła Podstawowa w Tuszowie Narodowym|Tuszów Narodowy| 218 |39-332 Tuszów Narodowy;927;560;560;14;546;60.41;2.50
99789;181109;Szkoła Podstawowa w Maliniu|Malinie| 220 |39-331 Chorzelów;1361;735;735;23;712;54.00;3.13
99790;181109;Samorządowe Przedszkole w Ławnicy|Ławnica| 118 |39-331 Chorzelów;603;299;299;13;286;49.59;4.35
99791;181109;Szkoła Podstawowa w Borkach Nizińskich|Borki Nizińskie| 18 |39-307 Gawłuszowice;590;327;327;10;317;55.42;3.06
99792;181109;Dom Ludowy Jaślany|Jaślany| 279 |39-332 Tuszów Narodowy;1079;671;671;28;643;62.19;4.17
99793;181109;Szkoła Podstawowa w Czajkowej|Czajkowa| 60 |39-332 Tuszów Narodowy;502;273;273;7;266;54.38;2.56
99794;181109;Dom Strażaka w Sarnowie|Sarnów| 43 |39-333 Sarnów;484;290;290;6;284;59.92;2.07
99795;181109;Wiejski Dom Kultury i Rekreacji w Grochowem|Grochowe| 87 |39-332 Tuszów Narodowy;759;427;427;8;419;56.26;1.87
99796;181110;Zespół Szkolno-Przedszkolny w Wadowicach Górnych|Wadowice Górne| 111 |39-308 Wadowice Górne;1250;647;647;18;629;51.76;2.78
99797;181110;Szkoła Podstawowa w Woli Wadowskiej|Wola Wadowska| 44 |39-308 Wadowice Górne;862;360;360;19;341;41.76;5.28
99798;181110;Szkoła Podstawowa w Jamach|Jamy| 81 |39-308 Wadowice Górne;747;341;341;10;331;45.65;2.93
99799;181110;Samorządowy Ośrodek Kultury i Rekreacji Gminy Wadowice Górne|Wadowice Dolne| 69 |39-308 Wadowice Górne;753;331;331;10;321;43.96;3.02
99800;181110;Szkoła Podstawowa w Wampierzowie|Wampierzów| 81 |39-308 Wadowice Górne;923;409;409;26;383;44.31;6.36
99801;181110;Szkoła Podstawowa w Izbiskach|Izbiska| 71 |39-308 Wadowice Górne;550;247;247;3;244;44.91;1.21
99802;181110;Dom Ludowy w Piątkowcu|Piątkowiec| 50A |39-308 Wadowice Górne;285;170;170;3;167;59.65;1.76
99803;181110;Szkoła Podstawowa w Zabrniu|Zabrnie| 85 |39-308 Wadowice Górne;329;140;140;3;137;42.55;2.14
99804;181110;Dom Strażaka w Grzybowie|Grzybów| 18 |39-308 Wadowice Górne;167;87;87;5;82;52.10;5.75
99805;181201;Zespół Szkół w Harasiukach|Harasiuki| 106 |37-413 Harasiuki;924;345;345;7;338;37.34;2.03
99806;181201;Publiczna Szkoła Podstawowa w Hucisku|Hucisko| 76 A |37-413 Harasiuki;745;296;296;18;278;39.73;6.08
99807;181201;Zespół Szkół w Hucie Krzeszowskiej|Huta Krzeszowska|ul.Długa 6 |37-413 Harasiuki;1218;500;500;19;481;41.05;3.80
99808;181201;Publiczna Szkoła Podstawowa w Krzeszowie Górnym|Krzeszów Górny| 109 |37-413 Harasiuki;634;243;243;3;240;38.33;1.23
99809;181201;Publiczna Szkoła Podstawowa w Goździe|Gózd| 46 A |37-413 Harasiuki;718;325;325;2;323;45.26;0.62
99810;181201;Świetlica w Łazorach I|Łazory| 97 A |37-413 Harasiuki;832;377;377;7;370;45.31;1.86
99811;181202;Gminny Ośrodek Kultury Sportu Turystyki i Rekreacji w Jarocinie|Jarocin| 114 |37-405 Jarocin;1042;389;389;12;377;37.33;3.08
99812;181202;Publiczna Szkoła Podstawowa w Domostawie|Domostawa| 79 |37-405 Jarocin;1011;373;373;17;356;36.89;4.56
99813;181202;Szkoła Podstawowa Fundacji "ELEMENTARZ" z Oddziałem Przedszkolnym w Golcach|Golce| 37 |37-405 Jarocin;292;144;144;4;140;49.32;2.78
99814;181202;Budynek Świetlicy Wiejskiej w Majdanie Golczańskim|Majdan Golczański| 61 |37-405 Jarocin;548;232;232;1;231;42.34;0.43
99815;181202;Publiczna Szkoła Podstawowa Mostkach-Sokalach|Mostki| 48 |37-405 Jarocin;513;216;216;5;211;42.11;2.31
99816;181202;Publiczna Szkoła Podstawowa w Szyperkach|Szyperki| 59B |37-405 Jarocin;441;196;196;6;190;44.44;3.06
99817;181202;Publiczna Szkoła Podstawowa w Zdziarach|Zdziary| 1E |37-405 Jarocin;592;213;213;4;209;35.98;1.88
99818;181203;Szkoła Podstawowa Jeżowe Centrum|Jeżowe| 135 |37-430 Jeżowe;1292;682;682;25;657;52.79;3.67
99819;181203;Szkoła Podstawowa Jeżowe Podgórze|Jeżowe| 412A |37-430 Jeżowe;1485;882;882;19;863;59.39;2.15
99820;181203;Świetlica wiejska Jeżowe Błądki|Jeżowe| 688 |37-430 Jeżowe;681;383;383;14;369;56.24;3.66
99821;181203;Szkoła Podstawowa Jeżowe-Kameralne|Jeżowe| 812D |37-430 Jeżowe;555;261;261;13;248;47.03;4.98
99822;181203;Szkoła Podstawowa w Groblach|Groble| 37 |37-430 Jeżowe;697;346;346;10;336;49.64;2.89
99823;181203;Świetlica OSP w Krzywdach|Krzywdy| 177B |37-430 Jeżowe;417;240;240;6;234;57.55;2.50
99824;181203;Remiza OSP w Jacie|Jata| 33A |37-430 Jeżowe;489;261;261;10;251;53.37;3.83
99825;181203;Klub Wiejski w Sójkowej|Sójkowa| 57 |37-430 Jeżowe;399;206;206;3;203;51.63;1.46
99826;181203;Świetlica wiejska w Zalesiu|Zalesie| 40 |37-430 Jeżowe;399;218;218;7;211;54.64;3.21
99827;181203;Szkoła Podstawowa w Cholewianej Górze|Cholewiana Góra|Młynarze 23 |37-430 Jeżowe;780;402;402;14;388;51.54;3.48
99828;181203;Świetlica OSP w Nowym Narcie|Nowy Nart| 41 |37-430 Jeżowe;398;187;187;5;182;46.98;2.67
99829;181203;Szkoła Podstawowa w Starym Narcie|Stary Nart| 57B |37-430 Jeżowe;295;124;124;5;119;42.03;4.03
99830;181204;Gminny Ośrodek Kultury|Krzeszów|ul. Rynek 9 |37-418 Krzeszów;946;423;423;6;417;44.71;1.42
99831;181204;Remiza OSP|Kamionka Górna| 29A |37-418 Krzeszów;596;277;277;7;270;46.48;2.53
99832;181204;Szkoła Podstawowa|Bystre| 72A |37-418 Krzeszów;942;352;352;9;343;37.37;2.56
99833;181204;Świetlica Wiejska|Koziarnia| 117A |37-418 Krzeszów;523;245;245;1;244;46.85;0.41
99834;181204;Remiza OSP|Podolszynka Ordynacka| 24 |37-418 Krzeszów;470;209;209;4;205;44.47;1.91
99835;181205;Publiczna Szkoła Podstawowa Nr 1|Nisko|ul. Słowackiego 10 |37-400 Nisko;1488;821;821;14;807;55.17;1.71
99836;181205;Biblioteka Miejska|Nisko|ul. Kościuszki 1a |37-400 Nisko;650;262;262;9;253;40.31;3.44
99837;181205;Gimnazjum Nr 1|Nisko|ul. Szopena 31 |37-400 Nisko;1659;823;823;12;811;49.61;1.46
99838;181205;Publiczna Szkoła Podstawowa Nr 3 Nisko-Warchoły|Nisko|ul. Piaskowa 15 |37-400 Nisko;1638;768;768;20;748;46.89;2.60
99839;181205;Gimnazjum Nr 3|Nisko|ul. Piaskowa 15 |37-400 Nisko;768;330;330;10;320;42.97;3.03
99840;181205;Publiczna Szkoła Podstawowa Nr 4 Nisko-Podwolina|Nisko|ul. Dąbrowskiego 8 |37-400 Nisko;744;328;328;10;318;44.09;3.05
99841;181205;Publiczna Szkoła Podstawowa nr 6 Nisko-Malce|Nisko|ul. Sandomierska 114 |37-400 Nisko;1121;600;600;13;587;53.52;2.17
99842;181205;Miejski Zakład Komunalny Nisko|Nisko|ul. Szklarniowa 1 |37-400 Nisko;1261;595;595;6;589;47.18;1.01
99843;181205;Publiczna Szkoła Podstawowa Nr 5|Nisko|ul. Tysiąclecia 12a |37-400 Nisko;1120;486;486;13;473;43.39;2.67
99844;181205;Gimnazjum Nr 2|Nisko|ul. Tysiąclecia 12a |37-400 Nisko;1823;863;863;14;849;47.34;1.62
99845;181205;Szkoła Racławice|Racławice|ul. Rudnicka 81 |37-400 Nisko;1779;846;846;14;832;47.55;1.65
99846;181205;Publiczna Szkoła Podstawowa w Zarzeczu|Zarzecze|Mickiewicza 45 |37-400 Nisko;726;372;372;4;368;51.24;1.08
99847;181205;Gimnazjum w Zarzeczu|Zarzecze|Mickiewicza 45 |37-400 Nisko;1599;690;690;19;671;43.15;2.75
99848;181205;Zespół Szkół Nowosielec|Nowosielec| 134 |37-400 Nisko;1548;754;754;31;723;48.71;4.11
99849;181205;Szpital Powiatowy im. PCK|Nisko|ul. Kościuszki 1 |37-400 Nisko;153;51;51;6;45;33.33;11.76
99850;181205;Areszt Śledczy|Nisko|Plac Wolności 15 |37-400 Nisko;77;33;33;7;26;42.86;21.21
99851;181206;Publiczna Szkoła Podstawowa Nr 1 im. Jana Pawła II|Rudnik nad Sanem|ul. Kończycka 3 |37-420 Rudnik nad Sanem;1224;514;514;21;493;41.99;4.09
99852;181206;Warsztaty Terapii Zajęciowej|Rudnik nad Sanem|ul. Rzeszowska 35 |37-420 Rudnik nad Sanem;859;385;385;24;361;44.82;6.23
99853;181206;Publiczne Gimnazjum im. Orląt|Rudnik nad Sanem|ul. Piłsudskiego 7 |37-420 Rudnik nad Sanem;1215;524;524;27;497;43.13;5.15
99854;181206;Miejski Ośrodek Sportu i Rekreacji|Rudnik nad Sanem|ul. Mickiewicza 44 |37-420 Rudnik nad Sanem;975;445;445;18;427;45.64;4.04
99855;181206;Posterunek Energetyczny|Rudnik nad Sanem|ul. Szpitalna 1 |37-420 Rudnik nad Sanem;851;387;387;15;372;45.48;3.88
99856;181206;Publiczna Szkoła Podstawowa Nr 3|Rudnik nad Sanem|ul. Konopnickiej 58 |37-420 Rudnik nad Sanem;733;330;330;16;314;45.02;4.85
99857;181206;Publiczna Szkoła Podstawowa|Przędzel|ul. Mickiewicza 149 |37-420 Rudnik nad Sanem;1483;589;589;19;570;39.72;3.23
99858;181206;Publiczna Szkoła Podstawowa|Kopki|ul.Podborze 2 |37-420 Rudnik nad Sanem;1022;425;425;10;415;41.59;2.35
99859;181207;Budynek typu muzealnego w Ulanowie|Ulanów|ul.Rynek 4 |37-410 Ulanów;1219;554;554;17;537;45.45;3.07
99860;181207;Szkoła Podstawowa w Wólce Tanewskiej|Wólka Tanewska|ul. Główna 61 |37-410 Ulanów;1118;449;449;12;437;40.16;2.67
99861;181207;Dom Ludowy w Hucie Deręgowskiej|Huta Deręgowska| 58A |37-410 Ulanów;572;198;198;3;195;34.62;1.52
99862;181207;Szkoła Podstawowa w Dąbrówce|Dąbrówka| 15E |37-410 Ulanów;603;260;260;10;250;43.12;3.85
99863;181207;Zespół Szkół w Kurzynie Średniej|Kurzyna Średnia| 35A |37-410 Ulanów;877;393;393;13;380;44.81;3.31
99864;181207;Szkoła Podstawowa w Bielinach|Bieliny|ul. Świętego Wojciecha 6 |37-410 Ulanów;987;415;415;16;399;42.05;3.86
99865;181207;Dom Ludowy w Bukowinie|Bukowina| 93A |37-410 Ulanów;264;126;126;4;122;47.73;3.17
99866;181207;Dom Ludowy w Bielińcu|Bieliniec| 40B |37-410 Ulanów;391;152;152;11;141;38.87;7.24
99867;181207;Dom Ludowy w Gliniance|Glinianka|ul. Łączki 8 |37-410 Ulanów;409;174;174;7;167;42.54;4.02
99868;181207;Remiza OSP w Dąbrowicy|Dąbrowica| 68 |37-410 Ulanów;315;125;125;4;121;39.68;3.20
99869;181207;Budynek byłej Szkoły Podstawowej w Borkach|Borki| 11 |37-410 Ulanów;247;108;108;3;105;43.72;2.78
99870;181301;Publiczne Gimnazjum nr 1 w Birczy|Bircza|Ojca Św. Jana Pawła II 10 |37-740 Bircza;981;419;419;28;391;42.71;6.68
99871;181301;Publiczne Gimnazjum nr 1 w Birczy|Bircza|Ojca Św. Jana Pawła II 10 |37-740 Bircza;1450;518;518;24;494;35.72;4.63
99872;181301;Świetlica wiejska w Leszczawie Dolnej|Leszczawa Dolna| |37-740 Bircza;844;375;375;13;362;44.43;3.47
99873;181301;Szkoła Podstawowa w Kuźminie|Kuźmina| |37-744 Bircza;408;175;175;7;168;42.89;4.00
99874;181301;Szkoła Podstawowa w Lipie|Lipa| |37-751 Bircza;395;117;117;7;110;29.62;5.98
99875;181301;Świetlica wiejska w Brzeżawie|Brzeżawa| |37-751 Bircza;237;80;80;9;71;33.76;11.25
99876;181301;Szkoła Podstawowa w Żohatynie|Żohatyn| |37-751 Bircza;323;119;119;4;115;36.84;3.36
99877;181301;Świetlica wiejska w Hucie Brzuskiej|Huta Brzuska| |37-740 Bircza;237;94;94;6;88;39.66;6.38
99878;181301;Szkoła Podstawowa w Sufczynie|Sufczyna| |37-740 Bircza;628;244;244;21;223;38.85;8.61
99879;181302;Szkoła Podstawowa w Bachórcu|Bachórzec| 188A |37-752 Dubiecko;764;282;282;22;260;36.91;7.80
99880;181302;Szkoła Podstawowa w Drohobyczce|Drohobyczka| 52 |37-753 Dubiecko;704;281;281;16;265;39.91;5.69
99881;181302;Urząd Gminy w Dubiecku|Dubiecko|ul. Przemyska 10 |37-750 Dubiecko;1351;566;566;24;542;41.89;4.24
99882;181302;Szkoła Podstawowa Nr 1 w Nienadowej|Nienadowa| 373 |37-750 Dubiecko;1777;686;686;22;664;38.60;3.21
99883;181302;Była Szkoła Podstawowa w Sielnicy|Sielnica| 31 |37-750 Dubiecko;280;81;81;5;76;28.93;6.17
99884;181302;Remiza OSP w Tarnawce|Tarnawka| |37-750 Dubiecko;586;206;206;9;197;35.15;4.37
99885;181302;Remiza OSP w Kosztowej|Kosztowa| 65 |37-752 Dubiecko;316;118;118;6;112;37.34;5.08
99886;181302;Szkoła Podstawowa w Hucisku Nienadowskim|Hucisko Nienadowskie| 129 |37-750 Dubiecko;394;126;126;13;113;31.98;10.32
99887;181302;Szkoła Podstawowa w Przedmieściu Dubieckim|Przedmieście Dubieckie| 140 |37-750 Dubiecko;997;397;397;9;388;39.82;2.27
99888;181302;Była Szkoła Podstawowa w Śliwnicy|Śliwnica| 125A |37-750 Dubiecko;464;180;180;12;168;38.79;6.67
99889;181303;Remiza OSP w Fredropolu|Fredropol| 40 |37-734 Fredropol;548;218;218;10;208;39.78;4.59
99890;181303;Świetlica Wiejska w Sierakoścach|Sierakośce| 63 |37-743 Fredropol;489;149;149;5;144;30.47;3.36
99891;181303;Szkoła Podstawowa w Kniażycach|Kniażyce| 108A |37-734 Fredropol;339;143;143;2;141;42.18;1.40
99892;181303;Świetlica Wiejska w Huwnikach|Huwniki| 82 |37-743 Fredropol;553;238;238;11;227;43.04;4.62
99893;181303;Świetlica Wiejska w Kalwarii Pacławskiej|Kalwaria Pacławska| 60 |37-743 Fredropol;269;142;142;3;139;52.79;2.11
99894;181303;Szkoła Filialna w Rybotyczach|Rybotycze| 121 |37-742 Fredropol;342;149;149;0;149;43.57;0.00
99895;181303;Świetlica Wiejska w Aksmanicach|Aksmanice| |37-734 Fredropol;388;128;128;6;122;32.99;4.69
99896;181303;Świetlica Wiejska w Darowicach|Darowice| 67 |37-734 Fredropol;237;109;109;3;106;45.99;2.75
99897;181303;Świetlica Wiejska w Nowych Sadach|Nowe Sady| |37-743 Fredropol;247;74;74;2;72;29.96;2.70
99898;181303;Świetlica Wiejska w Młodowicach|Młodowice| 72 |37-734 Fredropol;293;136;136;7;129;46.42;5.15
99899;181303;Świetlica Wiejska w Kupiatyczach|Kupiatycze| 38 |37-734 Fredropol;437;181;181;7;174;41.42;3.87
99900;181303;Świetlica Wiejska w Makowej|Makowa| 10 |37-742 Fredropol;276;121;121;5;116;43.84;4.13
99901;181303;Dom Pomocy Społecznej w Huwnikach|Huwniki| 127 |37-734 Fredropol;69;22;22;5;17;31.88;22.73
99902;181304;Gminny Ośrodek Kultury w Krasiczynie|Krasiczyn| 180 |37-741 Krasiczyn;1158;599;599;19;580;51.73;3.17
99903;181304;Świetlica Wiejska w Prałkowcach|Prałkowce| 253 |37-700 Przemyśl;720;410;410;11;399;56.94;2.68
99904;181304;Świetlica Wiejska w Olszanach|Olszany| 11A |37-741 Krasiczyn;1245;501;501;22;479;40.24;4.39
99905;181304;Świetlica Wiejska w Korytnikach|Korytniki| 9B |37-741 Krasiczyn;505;197;197;12;185;39.01;6.09
99906;181304;Świetlica Wiejska w Tarnawcach|Tarnawce| 25 |37-741 Krasiczyn;411;142;142;6;136;34.55;4.23
99907;181305;Świetlica Wiejska w Babicach|Babice| 10 |37-754 Krzywcza;699;293;293;21;272;41.92;7.17
99908;181305;Świetlica Wiejska w Bachowie|Bachów| 68A |37-754 Krzywcza;592;197;197;11;186;33.28;5.58
99909;181305;Świetlica Wiejska w Krzywczy|Krzywcza| 97 |37-755 Krzywcza;420;228;228;6;222;54.29;2.63
99910;181305;Świetlica Wiejska w Kupnej|Kupna| 19A |37-741 Krasiczyn;200;57;57;1;56;28.50;1.75
99911;181305;Świetlica Wiejska w Reczpolu|Reczpol| |37-755 Krzywcza;623;316;316;7;309;50.72;2.22
99912;181305;Świetlica Wiejska w Ruszelczycach|Ruszelczyce| 55 |37-755 Krzywcza;474;220;220;3;217;46.41;1.36
99913;181305;Świetlica Wiejska w Skopowie|Skopów| 103A |37-754 Babice;376;140;140;13;127;37.23;9.29
99914;181305;Świetlica Wiejska w Średniej|Średnia| 29A |37-755 Krzywcza;183;48;48;4;44;26.23;8.33
99915;181305;Świetlica Wiejska w Woli Krzywieckiej|Wola Krzywiecka| 70A |37-755 Krzywcza;406;164;164;6;158;40.39;3.66
99916;181306;Szkoła Podstawowa w Hureczku|Hureczko| 100 |37-705 Przemyśl 7;364;190;190;8;182;52.20;4.21
99917;181306;Remiza OSP w Hurku|Hurko| 35 |37-705 Przemyśl 7;465;187;187;5;182;40.22;2.67
99918;181306;Świetlica Wiejska w Jaksmanicach|Jaksmanice| 76 |37-705 Przemyśl 7;411;163;163;10;153;39.66;6.13
99919;181306;Świetlica Wiejska w Lesznie|Leszno| 73 |37-723 Stubno;520;190;190;10;180;36.54;5.26
99920;181306;Hala Sportowa w Medyce|Medyka| |37-732 Medyka;1089;567;567;13;554;52.07;2.29
99921;181306;Hala Sportowa w Medyce|Medyka| |37-732 Medyka;994;450;450;22;428;45.27;4.89
99922;181306;Szkoła Podstawowa w Siedliskach|Siedliska| 115 |37-705 Przemyśl 7;565;240;240;12;228;42.48;5.00
99923;181306;Szkoła Podstawowa w Torkach|Torki| 29 |37-732 Medyka;691;288;288;12;276;41.68;4.17
99924;181306;Zakład Karny w Medyce|Medyka| 404B |37-732 Medyka;227;129;129;9;120;56.83;6.98
99925;181307;Dom Ludowy w Orłach|Orły|Przemyska 2 |37-716 Orły;974;465;465;7;458;47.74;1.51
99926;181307;Dom Ludowy w Zadąbrowiu|Zadąbrowie| 80B |37-716 Orły;764;310;310;17;293;40.58;5.48
99927;181307;Dom Ludowy w Nizinach|Niziny| 202 |37-716 Orły;781;311;311;18;293;39.82;5.79
99928;181307;Ośrodek Społeczno - Kulturalny i Rekreacyjno - Sportowy w Małkowicach|Małkowice| 102 |37-716 Orły;734;367;367;13;354;50.00;3.54
99929;181307;Dom Ludowy w Walawie|Walawa| 83 |37-716 Orły;604;293;293;12;281;48.51;4.10
99930;181307;Dom Ludowy w Duńkowiczkach|Duńkowiczki| 160 |37-716 Orły;316;167;167;10;157;52.85;5.99
99931;181307;Dom Ludowy w Drohojowie|Drohojów| 36 |37-716 Orły;392;178;178;11;167;45.41;6.18
99932;181307;Dom Ludowy w Hnatkowicach|Hnatkowice| 182 |37-717 Kaszyce;338;181;181;8;173;53.55;4.42
99933;181307;Dom Ludowy w Wacławicach|Wacławice| 55 |37-717 Kaszyce;809;362;362;11;351;44.75;3.04
99934;181307;Sala sportowa przy Szkole Podstawowej w Kaszycach|Kaszyce| 213A |37-717 Kaszyce;648;323;323;15;308;49.85;4.64
99935;181307;Dom Ludowy w Ciemięrzowicach|Ciemięrzowice| 74 |37-717 Kaszyce;240;121;121;7;114;50.42;5.79
99936;181307;Dom Ludowy w Olszynce|Olszynka| 97 |37-717 Kaszyce;318;124;124;5;119;38.99;4.03
99937;181308;Zespół Szkół w Krównikach|Krówniki| 168A |37-700 Przemyśl;485;247;247;8;239;50.93;3.24
99938;181308;Świetlica Wiejska w Łuczycach|Łuczyce| 31 |37-705 Przemyśl;567;211;211;8;203;37.21;3.79
99939;181308;Świetlica Wiejska w Hermanowicach|Hermanowice| 34 |37-733 Pikulice;792;354;354;20;334;44.70;5.65
99940;181308;Zespół Szkół w Nehrybce|Nehrybka| 188a |37-733 Pikulice;857;396;396;10;386;46.21;2.53
99941;181308;Świetlica Wiejska w Pikulicach|Pikulice| 23 |37-733 Pikulice;427;201;201;6;195;47.07;2.99
99942;181308;Zespół Szkół w Grochowcach|Grochowce| 27 |37-733 Pikulice;648;370;370;7;363;57.10;1.89
99943;181308;Świetlica Wiejska w Witoszyńcach|Witoszyńce| 72a |37-733 Pikulice;340;138;138;4;134;40.59;2.90
99944;181308;Świetlica Wiejska w Wapowcach|Wapowce| 5a |37-700 Przemyśl;392;193;193;16;177;49.23;8.29
99945;181308;Świetlica Wiejska w Łętowni|Łętownia| 61 |37-700 Przemyśl;551;281;281;12;269;51.00;4.27
99946;181308;Świetlica Wiejska w Kuńkowcach|Kuńkowce| 135 |37-700 Przemyśl;526;250;250;5;245;47.53;2.00
99947;181308;Zespół Szkół w Ostrowie|Ostrów| 29 |37-700 Przemyśl;1836;1017;1018;11;1006;55.39;1.08
99948;181308;Zespół Szkół w Ujkowicach|Ujkowice| 159 |37-713 Maćkowice;822;347;347;14;333;42.21;4.03
99949;181309;Swietlica Wiejska w Gajach|Hruszowice| 64 |37-724 Kalników;261;103;103;2;101;39.46;1.94
99950;181309;Szkoła Podstawowa w Kalnikowie|Kalników| 88 |37-724 Kalników;928;294;294;14;280;31.68;4.76
99951;181309;Świetlica wiejska w Nakle|Nakło| 61 |37-723 Stubno;601;193;193;12;181;32.11;6.22
99952;181309;Sala Narad Urzędu Gminy Stubno|Stubno| 69A |37-723 Stubno;1034;400;400;16;384;38.68;4.00
99953;181309;Świetlica Wiejska w Stubienku|Stubienko| 47 |37-723 Stubno;381;155;155;6;149;40.68;3.87
99954;181310;Dom Ludowy w Batyczach|Batycze| 120 |37-713 Maćkowice;247;122;122;13;109;49.39;10.66
99955;181310;Szkoła Podstawowa w Bolestraszycach|Bolestraszyce| 156 |37-722 Wyszatyce;1358;686;686;34;652;50.52;4.96
99956;181310;Szkoła Podstawowa w Buszkowicach|Buszkowice| 138 |37-710 Żurawica;701;367;367;8;359;52.35;2.18
99957;181310;Dom Ludowy w Buszkowiczkach|Buszkowiczki| 38 |37-710 Żurawica;524;296;296;6;290;56.49;2.03
99958;181310;Dom Ludowy w Kosienicach|Kosienice| 103B |37-713 Maćkowice;712;296;296;16;280;41.57;5.41
99959;181310;Budynek OSP Maćkowice|Maćkowice| 8 |37-713 Maćkowice;812;317;317;21;296;39.04;6.62
99960;181310;Dom Ludowy w Orzechowcach|Orzechowce| 85 |37-712 Orzechowce;809;369;369;13;356;45.61;3.52
99961;181310;Zespół Szkół w Wyszatycach|Wyszatyce| 162A |37-722 Wyszatyce;1127;511;511;15;496;45.34;2.94
99962;181310;Polski Dom Katolicki w Żurawicy|Żurawica|ul. Wojska Polskiego 1 |37-710 Żurawica;1333;687;687;20;667;51.54;2.91
99963;181310;Urząd Gminy Żurawica|Żurawica|ul. Ojca Św. Jana Pawla II 1 |37-710 Żurawica;1343;763;763;24;739;56.81;3.15
99964;181310;Szkoła Podstawowa Nr 2 w Żurawicy|Żurawica|Kardynała Stefana Wyszyńskiego 3 |37-710 Żurawica;1292;636;636;17;619;49.23;2.67
99965;181310;Wojewódzki Podkarpacki Szpital Psychiatryczny w Żurawicy|Żurawica|Różana 9 |37-710 Żurawica;159;37;37;7;30;23.27;18.92
99966;181401;Środowiskowy Dom Samopomocy|Przeworsk|ul. Niepodległości 9 |37-200 Przeworsk;850;475;475;12;463;55.88;2.53
99967;181401;Zespół Szkół Ogólnokształcących i Zawodowych|Przeworsk|ul. Szkolna 6 |37-200 Przeworsk;745;401;401;3;398;53.83;0.75
99968;181401;Zespół Szkół Ogólnokształcących i Zawodowych|Przeworsk|ul. Szkolna 6 |37-200 Przeworsk;838;450;450;9;441;53.70;2.00
99969;181401;Urząd Miasta Przeworska|Przeworsk|ul. Jagiellońska 10 |37-200 Przeworsk;958;504;504;13;491;52.61;2.58
99970;181401;Szkoła Podstawowa Nr 1|Przeworsk|ul. Konopnickiej 5 |37-200 Przeworsk;1763;904;904;22;882;51.28;2.43
99971;181401;Szkoła Podstawowa Nr 2|Przeworsk|ul. Lwowska 11 |37-200 Przeworsk;928;455;455;9;446;49.03;1.98
99972;181401;Wyższa Szkoła Społeczno-Gospodarcza|Przeworsk|ul. Gimnazjalna 35 |37-200 Przeworsk;959;558;558;7;551;58.19;1.25
99973;181401;Miejski Klub Kultury|Przeworsk|ul. Wiejska 68 |37-200 Przeworsk;876;466;466;8;458;53.20;1.72
99974;181401;Gimnazjum Nr 1|Przeworsk|ul. Misiągiewicza 10 |37-200 Przeworsk;940;503;503;10;493;53.51;1.99
99975;181401;Gimnazjum Nr 1|Przeworsk|Misiągiewicza 10 |37-200 Przeworsk;952;533;533;11;522;55.99;2.06
99976;181401;Zespół Szkół Zawodowych|Przeworsk|Ignacego Krasickiego 9 |37-200 Przeworsk;1513;853;853;12;841;56.38;1.41
99977;181401;Szkoła Podstawowa Nr 1|Przeworsk|Marii Konopnickiej 5 |37-200 Przeworsk;803;418;418;8;410;52.05;1.91
99978;181401;Szkoła Podstawowa Nr 3|Przeworsk|Gorliczyńska 148 |37-200 Przeworsk;573;304;304;13;291;53.05;4.28
99979;181401;Samodzielny Publiczny Zakład Opieki Zdrowotnej|Przeworsk|Szpitalna 16 |37-200 Przeworsk;110;69;69;2;67;62.73;2.90
99980;181402;Gimnazjum im. Anny Jenke w Adamówce|Adamówka| 180 |37-534 Adamówka;960;412;412;22;390;42.92;5.34
99981;181402;Świetlica Wiejska w Cieplicach|Cieplice| 46 |37-534 Adamówka;653;277;277;9;268;42.42;3.25
99982;181402;Szkoła Podstawowa im Bł. Ks. Jerzego Popiełuszki w Majdanie Sieniawskim|Majdan Sieniawski| 197 |37-534 Adamówka;1151;590;590;35;555;51.26;5.93
99983;181402;Świetlica Wiejska w Krasnem|Krasne| 30 |37-534 Adamówka;578;222;222;11;211;38.41;4.95
99984;181403;Gminny Ośrodek Kultury w Gaci|Gać| 275A |37-207 Gać;1245;595;595;26;569;47.79;4.37
99985;181403;Dom Ludowy w Białobokach|Białoboki| 4 |37-207 Gać;559;307;307;13;294;54.92;4.23
99986;181403;Szkoła Podstawowa w Ostrowie|Ostrów| 5A |37-207 Gać;501;199;199;10;189;39.72;5.03
99987;181403;Świetlica wiejska w Mikulicach (budynek byłej remizy OSP)|Mikulice| 113A |37-220 Kańczuga;401;155;155;5;150;38.65;3.23
99988;181403;Zespół Szkół w Dębowie|Dębów| 47 |37-220 Przeworsk;984;502;502;19;483;51.02;3.78
99989;181404;Sala narad Urzędu Gminy Jawornik Polski|Jawornik Polski| 30 |37-232 Jawornik Polski;1696;762;762;49;713;44.93;6.43
99990;181404;Remiza OSP Hadle Szklarskie|Hadle Szklarskie| 62 |37-232 Jawornik Polski;687;303;303;16;287;44.10;5.28
99991;181404;Nowa Szkoła Hucisko Jawornickie|Hucisko Jawornickie| 251 |37-230 Kańczuga;331;155;155;7;148;46.83;4.52
99992;181404;Zespół Szkół Nr 2 w Manasterzu|Manasterz| 575 |37-230 Kańczuga;1155;441;441;24;417;38.18;5.44
99993;181405;Ośrodek Kultury Miasta i Gminy w Kańczudze|Kańczuga|ul. Parkowa 1A |37-220 Kańczuga;1331;597;597;27;570;44.85;4.52
99994;181405;Zespół Szkolno - Gimnazjalny w Krzeczowicach|Krzeczowice| 56A |37-220 Kańczuga;951;400;400;14;386;42.06;3.50
99995;181405;Dom Kultury w Łopuszce Wielkiej|Łopuszka Wielka| 134 |37-222 Kańczuga;1270;517;517;34;483;40.71;6.58
99996;181405;Zespół Szkolno - Gimnazjalny w Pantalowicach|Pantalowice| 158 |37-224 Kańczuga;938;338;338;17;321;36.03;5.03
99997;181405;Zespół Szkolno - Gimnazjalny w Rączynie|Rączyna| 146 |37-223 Kańczuga;830;306;306;17;289;36.87;5.56
99998;181405;Dom Strażaka w Sieteszy|Sietesz| 286 |37-206 Kańczuga;1527;544;544;12;532;35.63;2.21
99999;181405;Zespół Szkolno - Gimnazjalny w Siedleczce|Siedleczka| 179 |37-225 Kańczuga;864;368;368;12;356;42.59;3.26
